InvoiceNo,InvoiceDate,StockCode,Description,Cost_Price,UnitPrice,Profit,Quantity,CustomerID,Country
622157,2023-02-20,1008,Makeup Remover,80,160,80,1,00001,India
622157,2023-02-20,1005,Nail Polish,50,100,50,1,00001,India
186701,2023-02-20,1008,Makeup Remover,80,160,80,1,00002,India
186701,2023-02-20,1004,Eyeliner,100,200,100,1,00002,India
614044,2023-02-20,1009,Moisturizer,250,500,250,2,00003,India
614044,2023-02-20,1003,Foundation,300,600,300,1,00003,India
991613,2023-02-20,1012,Body Lotion,200,400,200,2,00004,India
241506,2023-02-20,1004,Eyeliner,100,200,100,1,00005,India
241506,2023-02-20,1012,Body Lotion,200,400,200,2,00005,India
241506,2023-02-20,1001,Lipstick,150,300,150,1,00005,India
942837,2023-02-20,1012,Body Lotion,200,400,200,2,00006,India
250039,2023-02-20,1003,Foundation,300,600,300,1,00007,India
959705,2023-02-20,1004,Eyeliner,100,200,100,1,00008,India
959705,2023-02-20,1002,Mascara,200,400,200,1,00008,India
146366,2023-02-20,1007,Eyeshadow,200,400,200,1,00009,India
535694,2023-02-20,1004,Eyeliner,100,200,100,1,00010,India
554039,2023-02-20,1001,Lipstick,150,300,150,1,00011,India
554039,2023-02-20,1012,Body Lotion,200,400,200,2,00011,India
155299,2023-02-20,1002,Mascara,200,400,200,1,00012,India
155299,2023-02-20,1009,Moisturizer,250,500,250,2,00012,India
155299,2023-02-20,1012,Body Lotion,200,400,200,2,00012,India
172210,2023-02-20,1007,Eyeshadow,200,400,200,1,00013,India
172210,2023-02-20,1004,Eyeliner,100,200,100,1,00013,India
172210,2023-02-20,1006,Blush,150,300,150,1,00013,India
172210,2023-02-20,1012,Body Lotion,200,400,200,2,00013,India
178953,2023-02-20,1012,Body Lotion,200,400,200,2,00014,India
178953,2023-02-20,1008,Makeup Remover,80,160,80,1,00014,India
178953,2023-02-20,1009,Moisturizer,250,500,250,2,00014,India
525448,2023-02-20,1002,Mascara,200,400,200,1,00015,India
525448,2023-02-20,1004,Eyeliner,100,200,100,1,00015,India
525448,2023-02-20,1007,Eyeshadow,200,400,200,1,00015,India
147505,2023-02-20,1001,Lipstick,150,300,150,1,00016,India
147505,2023-02-20,1004,Eyeliner,100,200,100,1,00016,India
631084,2023-02-20,1007,Eyeshadow,200,400,200,1,00017,India
704936,2023-02-20,1009,Moisturizer,250,500,250,2,00018,India
704936,2023-02-20,1004,Eyeliner,100,200,100,1,00018,India
704936,2023-02-20,1001,Lipstick,150,300,150,1,00018,India
704936,2023-02-20,1007,Eyeshadow,200,400,200,1,00018,India
876332,2023-02-20,1003,Foundation,300,600,300,1,00019,India
876332,2023-02-20,1006,Blush,150,300,150,1,00019,India
876332,2023-02-20,1002,Mascara,200,400,200,1,00019,India
472004,2023-02-20,1002,Mascara,200,400,200,1,00020,India
472004,2023-02-20,1008,Makeup Remover,80,160,80,1,00020,India
472004,2023-02-20,1006,Blush,150,300,150,1,00020,India
297067,2023-02-20,1006,Blush,150,300,150,1,00021,India
297067,2023-02-20,1005,Nail Polish,50,100,50,1,00021,India
297067,2023-02-20,1009,Moisturizer,250,500,250,2,00021,India
297067,2023-02-20,1003,Foundation,300,600,300,1,00021,India
879737,2023-02-20,1005,Nail Polish,50,100,50,1,00022,India
879737,2023-02-20,1004,Eyeliner,100,200,100,1,00022,India
879737,2023-02-20,1002,Mascara,200,400,200,1,00022,India
836175,2023-02-20,1009,Moisturizer,250,500,250,2,00023,India
836175,2023-02-20,1003,Foundation,300,600,300,1,00023,India
836175,2023-02-20,1012,Body Lotion,200,400,200,2,00023,India
836175,2023-02-20,1005,Nail Polish,50,100,50,1,00023,India
643615,2023-02-20,1002,Mascara,200,400,200,1,00024,India
643615,2023-02-20,1004,Eyeliner,100,200,100,1,00024,India
643615,2023-02-20,1001,Lipstick,150,300,150,1,00024,India
643615,2023-02-20,1007,Eyeshadow,200,400,200,1,00024,India
415846,2023-02-20,1005,Nail Polish,50,100,50,1,00025,India
595537,2023-02-20,1008,Makeup Remover,80,160,80,1,00026,India
595537,2023-02-20,1005,Nail Polish,50,100,50,1,00026,India
595537,2023-02-20,1007,Eyeshadow,200,400,200,1,00026,India
595537,2023-02-20,1002,Mascara,200,400,200,1,00026,India
872682,2023-02-20,1007,Eyeshadow,200,400,200,1,00027,India
872682,2023-02-20,1002,Mascara,200,400,200,1,00027,India
766454,2023-02-20,1009,Moisturizer,250,500,250,2,00028,India
963356,2023-02-20,1006,Blush,150,300,150,1,00029,India
884458,2023-02-20,1009,Moisturizer,250,500,250,2,00030,India
951558,2023-02-20,1006,Blush,150,300,150,1,00031,India
951558,2023-02-20,1008,Makeup Remover,80,160,80,1,00031,India
951558,2023-02-20,1002,Mascara,200,400,200,1,00031,India
667583,2023-02-20,1003,Foundation,300,600,300,1,00032,India
667583,2023-02-20,1002,Mascara,200,400,200,1,00032,India
667583,2023-02-20,1004,Eyeliner,100,200,100,1,00032,India
667583,2023-02-20,1012,Body Lotion,200,400,200,2,00032,India
667583,2023-02-20,1008,Makeup Remover,80,160,80,1,00032,India
271789,2023-02-20,1008,Makeup Remover,80,160,80,1,00033,India
271789,2023-02-20,1005,Nail Polish,50,100,50,1,00033,India
716829,2023-02-20,1012,Body Lotion,200,400,200,2,00034,India
716829,2023-02-20,1004,Eyeliner,100,200,100,1,00034,India
769333,2023-02-20,1006,Blush,150,300,150,1,00035,India
769333,2023-02-20,1009,Moisturizer,250,500,250,2,00035,India
769333,2023-02-20,1004,Eyeliner,100,200,100,1,00035,India
157781,2023-02-20,1005,Nail Polish,50,100,50,1,00036,India
157781,2023-02-20,1002,Mascara,200,400,200,1,00036,India
157781,2023-02-20,1001,Lipstick,150,300,150,1,00036,India
626850,2023-02-20,1005,Nail Polish,50,100,50,1,00037,India
969643,2023-02-20,1005,Nail Polish,50,100,50,1,00038,India
969643,2023-02-20,1003,Foundation,300,600,300,1,00038,India
611717,2023-02-20,1001,Lipstick,150,300,150,1,00039,India
611717,2023-02-20,1003,Foundation,300,600,300,1,00039,India
611717,2023-02-20,1002,Mascara,200,400,200,1,00039,India
114049,2023-02-20,1008,Makeup Remover,80,160,80,1,00040,India
114049,2023-02-20,1002,Mascara,200,400,200,1,00040,India
440107,2023-02-20,1003,Foundation,300,600,300,1,00041,India
440107,2023-02-20,1006,Blush,150,300,150,1,00041,India
440107,2023-02-20,1004,Eyeliner,100,200,100,1,00041,India
173723,2023-02-20,1004,Eyeliner,100,200,100,1,00042,India
173723,2023-02-20,1003,Foundation,300,600,300,1,00042,India
878034,2023-02-20,1001,Lipstick,150,300,150,1,00043,India
878034,2023-02-20,1008,Makeup Remover,80,160,80,1,00043,India
878034,2023-02-20,1003,Foundation,300,600,300,1,00043,India
714482,2023-02-20,1002,Mascara,200,400,200,1,00044,India
714482,2023-02-20,1005,Nail Polish,50,100,50,1,00044,India
714482,2023-02-20,1004,Eyeliner,100,200,100,1,00044,India
714482,2023-02-20,1006,Blush,150,300,150,1,00044,India
284772,2023-02-20,1007,Eyeshadow,200,400,200,1,00045,India
284772,2023-02-20,1003,Foundation,300,600,300,1,00045,India
284772,2023-02-20,1008,Makeup Remover,80,160,80,1,00045,India
135069,2023-02-20,1004,Eyeliner,100,200,100,1,00046,India
135069,2023-02-20,1002,Mascara,200,400,200,1,00046,India
135069,2023-02-20,1012,Body Lotion,200,400,200,2,00046,India
483183,2023-02-20,1007,Eyeshadow,200,400,200,1,00047,India
483183,2023-02-20,1002,Mascara,200,400,200,1,00047,India
483183,2023-02-20,1009,Moisturizer,250,500,250,2,00047,India
483183,2023-02-20,1003,Foundation,300,600,300,1,00047,India
483183,2023-02-20,1006,Blush,150,300,150,1,00047,India
303912,2023-02-21,1012,Body Lotion,200,400,200,2,00048,India
303912,2023-02-21,1002,Mascara,200,400,200,1,00048,India
230479,2023-02-21,1007,Eyeshadow,200,400,200,1,00049,India
230479,2023-02-21,1001,Lipstick,150,300,150,1,00049,India
972339,2023-02-21,1006,Blush,150,300,150,1,00050,India
972339,2023-02-21,1012,Body Lotion,200,400,200,2,00050,India
185802,2023-02-21,1003,Foundation,300,600,300,1,00051,India
185802,2023-02-21,1007,Eyeshadow,200,400,200,1,00051,India
758765,2023-02-21,1006,Blush,150,300,150,1,00052,India
992855,2023-02-21,1007,Eyeshadow,200,400,200,1,00053,India
992855,2023-02-21,1008,Makeup Remover,80,160,80,1,00053,India
992855,2023-02-21,1001,Lipstick,150,300,150,1,00053,India
762654,2023-02-21,1005,Nail Polish,50,100,50,1,00054,India
762654,2023-02-21,1009,Moisturizer,250,500,250,2,00054,India
538446,2023-02-21,1006,Blush,150,300,150,1,00055,India
538446,2023-02-21,1001,Lipstick,150,300,150,1,00055,India
538446,2023-02-21,1009,Moisturizer,250,500,250,2,00055,India
538446,2023-02-21,1004,Eyeliner,100,200,100,1,00055,India
538446,2023-02-21,1012,Body Lotion,200,400,200,2,00055,India
584053,2023-02-21,1001,Lipstick,150,300,150,1,00056,India
584053,2023-02-21,1007,Eyeshadow,200,400,200,1,00056,India
584053,2023-02-21,1009,Moisturizer,250,500,250,2,00056,India
584053,2023-02-21,1003,Foundation,300,600,300,1,00056,India
584053,2023-02-21,1005,Nail Polish,50,100,50,1,00056,India
928287,2023-02-21,1008,Makeup Remover,80,160,80,1,00057,India
928287,2023-02-21,1005,Nail Polish,50,100,50,1,00057,India
226157,2023-02-21,1004,Eyeliner,100,200,100,1,00058,India
226157,2023-02-21,1008,Makeup Remover,80,160,80,1,00058,India
959970,2023-02-21,1006,Blush,150,300,150,1,00059,India
959970,2023-02-21,1001,Lipstick,150,300,150,1,00059,India
959970,2023-02-21,1004,Eyeliner,100,200,100,1,00059,India
775180,2023-02-21,1002,Mascara,200,400,200,1,00060,India
775180,2023-02-21,1008,Makeup Remover,80,160,80,1,00060,India
775180,2023-02-21,1003,Foundation,300,600,300,1,00060,India
775180,2023-02-21,1009,Moisturizer,250,500,250,2,00060,India
873190,2023-02-21,1006,Blush,150,300,150,1,00061,India
873190,2023-02-21,1009,Moisturizer,250,500,250,2,00061,India
873190,2023-02-21,1004,Eyeliner,100,200,100,1,00061,India
203373,2023-02-21,1006,Blush,150,300,150,1,00062,India
203373,2023-02-21,1012,Body Lotion,200,400,200,2,00062,India
203373,2023-02-21,1005,Nail Polish,50,100,50,1,00062,India
784875,2023-02-21,1002,Mascara,200,400,200,1,00063,India
784875,2023-02-21,1007,Eyeshadow,200,400,200,1,00063,India
397255,2023-02-21,1001,Lipstick,150,300,150,1,00064,India
397255,2023-02-21,1006,Blush,150,300,150,1,00064,India
422542,2023-02-21,1009,Moisturizer,250,500,250,2,00065,India
301216,2023-02-21,1002,Mascara,200,400,200,1,00066,India
301216,2023-02-21,1007,Eyeshadow,200,400,200,1,00066,India
103004,2023-02-21,1002,Mascara,200,400,200,1,00067,India
103004,2023-02-21,1008,Makeup Remover,80,160,80,1,00067,India
103004,2023-02-21,1003,Foundation,300,600,300,1,00067,India
575401,2023-02-21,1012,Body Lotion,200,400,200,2,00068,India
575401,2023-02-21,1004,Eyeliner,100,200,100,1,00068,India
567675,2023-02-21,1001,Lipstick,150,300,150,1,00069,India
567675,2023-02-21,1006,Blush,150,300,150,1,00069,India
842525,2023-02-21,1007,Eyeshadow,200,400,200,1,00070,India
842525,2023-02-21,1004,Eyeliner,100,200,100,1,00070,India
208897,2023-02-21,1005,Nail Polish,50,100,50,1,00071,India
208897,2023-02-21,1008,Makeup Remover,80,160,80,1,00071,India
337917,2023-02-21,1009,Moisturizer,250,500,250,2,00072,India
337917,2023-02-21,1005,Nail Polish,50,100,50,1,00072,India
337917,2023-02-21,1002,Mascara,200,400,200,1,00072,India
337917,2023-02-21,1003,Foundation,300,600,300,1,00072,India
463156,2023-02-21,1005,Nail Polish,50,100,50,1,00073,India
463156,2023-02-21,1007,Eyeshadow,200,400,200,1,00073,India
463156,2023-02-21,1008,Makeup Remover,80,160,80,1,00073,India
247159,2023-02-21,1002,Mascara,200,400,200,1,00074,India
247159,2023-02-21,1001,Lipstick,150,300,150,1,00074,India
247159,2023-02-21,1005,Nail Polish,50,100,50,1,00074,India
632176,2023-02-21,1001,Lipstick,150,300,150,1,00075,India
632176,2023-02-21,1009,Moisturizer,250,500,250,2,00075,India
545102,2023-02-21,1004,Eyeliner,100,200,100,1,00076,India
545102,2023-02-21,1006,Blush,150,300,150,1,00076,India
545102,2023-02-21,1009,Moisturizer,250,500,250,2,00076,India
545102,2023-02-21,1003,Foundation,300,600,300,1,00076,India
666567,2023-02-21,1009,Moisturizer,250,500,250,2,00077,India
666567,2023-02-21,1002,Mascara,200,400,200,1,00077,India
666567,2023-02-21,1012,Body Lotion,200,400,200,2,00077,India
846126,2023-02-21,1008,Makeup Remover,80,160,80,1,00078,India
846126,2023-02-21,1002,Mascara,200,400,200,1,00078,India
846126,2023-02-21,1009,Moisturizer,250,500,250,2,00078,India
846126,2023-02-21,1004,Eyeliner,100,200,100,1,00078,India
846126,2023-02-21,1005,Nail Polish,50,100,50,1,00078,India
939697,2023-02-21,1008,Makeup Remover,80,160,80,1,00079,India
939697,2023-02-21,1001,Lipstick,150,300,150,1,00079,India
939697,2023-02-21,1005,Nail Polish,50,100,50,1,00079,India
768553,2023-02-21,1008,Makeup Remover,80,160,80,1,00080,India
768553,2023-02-21,1006,Blush,150,300,150,1,00080,India
581570,2023-02-21,1009,Moisturizer,250,500,250,2,00081,India
581570,2023-02-21,1007,Eyeshadow,200,400,200,1,00081,India
581570,2023-02-21,1001,Lipstick,150,300,150,1,00081,India
581570,2023-02-21,1003,Foundation,300,600,300,1,00081,India
581570,2023-02-21,1004,Eyeliner,100,200,100,1,00081,India
176887,2023-02-21,1001,Lipstick,150,300,150,1,00082,India
176887,2023-02-21,1012,Body Lotion,200,400,200,2,00082,India
176887,2023-02-21,1006,Blush,150,300,150,1,00082,India
176887,2023-02-21,1002,Mascara,200,400,200,1,00082,India
176887,2023-02-21,1003,Foundation,300,600,300,1,00082,India
767937,2023-02-21,1012,Body Lotion,200,400,200,2,00083,India
767937,2023-02-21,1005,Nail Polish,50,100,50,1,00083,India
767937,2023-02-21,1009,Moisturizer,250,500,250,2,00083,India
962177,2023-02-21,1009,Moisturizer,250,500,250,2,00084,India
962177,2023-02-21,1012,Body Lotion,200,400,200,2,00084,India
962177,2023-02-21,1006,Blush,150,300,150,1,00084,India
962177,2023-02-21,1002,Mascara,200,400,200,1,00084,India
974089,2023-02-22,1002,Mascara,200,400,200,1,00085,India
974089,2023-02-22,1012,Body Lotion,200,400,200,2,00085,India
974089,2023-02-22,1006,Blush,150,300,150,1,00085,India
685363,2023-02-22,1007,Eyeshadow,200,400,200,1,00086,India
685363,2023-02-22,1003,Foundation,300,600,300,1,00086,India
357442,2023-02-22,1006,Blush,150,300,150,1,00087,India
357442,2023-02-22,1001,Lipstick,150,300,150,1,00087,India
357442,2023-02-22,1004,Eyeliner,100,200,100,1,00087,India
130738,2023-02-22,1007,Eyeshadow,200,400,200,1,00088,India
797774,2023-02-22,1007,Eyeshadow,200,400,200,1,00089,India
784077,2023-02-22,1007,Eyeshadow,200,400,200,1,00090,India
784077,2023-02-22,1009,Moisturizer,250,500,250,2,00090,India
450297,2023-02-22,1005,Nail Polish,50,100,50,1,00091,India
450297,2023-02-22,1001,Lipstick,150,300,150,1,00091,India
450297,2023-02-22,1007,Eyeshadow,200,400,200,1,00091,India
818183,2023-02-22,1012,Body Lotion,200,400,200,2,00092,India
818183,2023-02-22,1001,Lipstick,150,300,150,1,00092,India
818183,2023-02-22,1007,Eyeshadow,200,400,200,1,00092,India
822556,2023-02-22,1005,Nail Polish,50,100,50,1,00093,India
822556,2023-02-22,1004,Eyeliner,100,200,100,1,00093,India
533911,2023-02-22,1009,Moisturizer,250,500,250,2,00094,India
235297,2023-02-22,1009,Moisturizer,250,500,250,2,00095,India
235297,2023-02-22,1001,Lipstick,150,300,150,1,00095,India
623876,2023-02-22,1012,Body Lotion,200,400,200,2,00096,India
623876,2023-02-22,1004,Eyeliner,100,200,100,1,00096,India
623876,2023-02-22,1001,Lipstick,150,300,150,1,00096,India
794197,2023-02-22,1002,Mascara,200,400,200,1,00097,India
794197,2023-02-22,1003,Foundation,300,600,300,1,00097,India
794197,2023-02-22,1008,Makeup Remover,80,160,80,1,00097,India
874573,2023-02-22,1001,Lipstick,150,300,150,1,00098,India
874573,2023-02-22,1005,Nail Polish,50,100,50,1,00098,India
874573,2023-02-22,1012,Body Lotion,200,400,200,2,00098,India
559513,2023-02-22,1001,Lipstick,150,300,150,1,00099,India
559513,2023-02-22,1012,Body Lotion,200,400,200,2,00099,India
919472,2023-02-22,1009,Moisturizer,250,500,250,2,00100,India
919472,2023-02-22,1002,Mascara,200,400,200,1,00100,India
919472,2023-02-22,1004,Eyeliner,100,200,100,1,00100,India
919472,2023-02-22,1003,Foundation,300,600,300,1,00100,India
843903,2023-02-22,1007,Eyeshadow,200,400,200,1,00101,India
843903,2023-02-22,1005,Nail Polish,50,100,50,1,00101,India
843903,2023-02-22,1004,Eyeliner,100,200,100,1,00101,India
312584,2023-02-22,1001,Lipstick,150,300,150,1,00102,India
312584,2023-02-22,1007,Eyeshadow,200,400,200,1,00102,India
312584,2023-02-22,1002,Mascara,200,400,200,1,00102,India
151558,2023-02-22,1003,Foundation,300,600,300,1,00103,India
151558,2023-02-22,1007,Eyeshadow,200,400,200,1,00103,India
151558,2023-02-22,1002,Mascara,200,400,200,1,00103,India
812671,2023-02-22,1007,Eyeshadow,200,400,200,1,00104,India
812671,2023-02-22,1001,Lipstick,150,300,150,1,00104,India
724052,2023-02-22,1004,Eyeliner,100,200,100,1,00105,India
724052,2023-02-22,1001,Lipstick,150,300,150,1,00105,India
724052,2023-02-22,1002,Mascara,200,400,200,1,00105,India
149895,2023-02-22,1007,Eyeshadow,200,400,200,1,00106,India
149895,2023-02-22,1006,Blush,150,300,150,1,00106,India
149895,2023-02-22,1003,Foundation,300,600,300,1,00106,India
141667,2023-02-22,1003,Foundation,300,600,300,1,00107,India
141667,2023-02-22,1002,Mascara,200,400,200,1,00107,India
141667,2023-02-22,1009,Moisturizer,250,500,250,2,00107,India
141667,2023-02-22,1004,Eyeliner,100,200,100,1,00107,India
187145,2023-02-22,1009,Moisturizer,250,500,250,2,00108,India
187145,2023-02-22,1012,Body Lotion,200,400,200,2,00108,India
369081,2023-02-22,1005,Nail Polish,50,100,50,1,00109,India
369081,2023-02-22,1003,Foundation,300,600,300,1,00109,India
369081,2023-02-22,1006,Blush,150,300,150,1,00109,India
369081,2023-02-22,1007,Eyeshadow,200,400,200,1,00109,India
528556,2023-02-22,1005,Nail Polish,50,100,50,1,00110,India
528556,2023-02-22,1008,Makeup Remover,80,160,80,1,00110,India
528556,2023-02-22,1001,Lipstick,150,300,150,1,00110,India
528556,2023-02-22,1012,Body Lotion,200,400,200,2,00110,India
399123,2023-02-22,1007,Eyeshadow,200,400,200,1,00111,India
399123,2023-02-22,1012,Body Lotion,200,400,200,2,00111,India
399123,2023-02-22,1008,Makeup Remover,80,160,80,1,00111,India
399123,2023-02-22,1004,Eyeliner,100,200,100,1,00111,India
399123,2023-02-22,1003,Foundation,300,600,300,1,00111,India
976037,2023-02-22,1009,Moisturizer,250,500,250,2,00112,India
976037,2023-02-22,1004,Eyeliner,100,200,100,1,00112,India
698067,2023-02-22,1006,Blush,150,300,150,1,00113,India
698067,2023-02-22,1005,Nail Polish,50,100,50,1,00113,India
698067,2023-02-22,1007,Eyeshadow,200,400,200,1,00113,India
698067,2023-02-22,1004,Eyeliner,100,200,100,1,00113,India
698067,2023-02-22,1001,Lipstick,150,300,150,1,00113,India
806067,2023-02-22,1002,Mascara,200,400,200,1,00114,India
843322,2023-02-22,1007,Eyeshadow,200,400,200,1,00115,India
510380,2023-02-22,1004,Eyeliner,100,200,100,1,00116,India
510380,2023-02-22,1006,Blush,150,300,150,1,00116,India
124685,2023-02-22,1008,Makeup Remover,80,160,80,1,00117,India
124685,2023-02-22,1003,Foundation,300,600,300,1,00117,India
683000,2023-02-22,1002,Mascara,200,400,200,1,00118,India
683000,2023-02-22,1012,Body Lotion,200,400,200,2,00118,India
683000,2023-02-22,1007,Eyeshadow,200,400,200,1,00118,India
683000,2023-02-22,1009,Moisturizer,250,500,250,2,00118,India
323070,2023-02-22,1001,Lipstick,150,300,150,1,00119,India
323070,2023-02-22,1012,Body Lotion,200,400,200,2,00119,India
323070,2023-02-22,1002,Mascara,200,400,200,1,00119,India
323070,2023-02-22,1003,Foundation,300,600,300,1,00119,India
711565,2023-02-22,1006,Blush,150,300,150,1,00120,India
711565,2023-02-22,1009,Moisturizer,250,500,250,2,00120,India
711565,2023-02-22,1002,Mascara,200,400,200,1,00120,India
623059,2023-02-22,1003,Foundation,300,600,300,1,00121,India
623059,2023-02-22,1007,Eyeshadow,200,400,200,1,00121,India
623059,2023-02-22,1001,Lipstick,150,300,150,1,00121,India
623059,2023-02-22,1009,Moisturizer,250,500,250,2,00121,India
820149,2023-02-22,1004,Eyeliner,100,200,100,1,00122,India
820149,2023-02-22,1002,Mascara,200,400,200,1,00122,India
588651,2023-02-22,1007,Eyeshadow,200,400,200,1,00123,India
588651,2023-02-22,1008,Makeup Remover,80,160,80,1,00123,India
322454,2023-02-22,1001,Lipstick,150,300,150,1,00124,India
322454,2023-02-22,1008,Makeup Remover,80,160,80,1,00124,India
270864,2023-02-22,1007,Eyeshadow,200,400,200,1,00125,India
270864,2023-02-22,1005,Nail Polish,50,100,50,1,00125,India
270864,2023-02-22,1012,Body Lotion,200,400,200,2,00125,India
830416,2023-02-22,1002,Mascara,200,400,200,1,00126,India
245255,2023-02-22,1012,Body Lotion,200,400,200,2,00127,India
245255,2023-02-22,1004,Eyeliner,100,200,100,1,00127,India
245255,2023-02-22,1006,Blush,150,300,150,1,00127,India
245255,2023-02-22,1003,Foundation,300,600,300,1,00127,India
837951,2023-02-23,1012,Body Lotion,200,400,200,2,00128,India
837951,2023-02-23,1003,Foundation,300,600,300,1,00128,India
837951,2023-02-23,1007,Eyeshadow,200,400,200,1,00128,India
506368,2023-02-23,1009,Moisturizer,250,500,250,2,00129,India
819535,2023-02-23,1003,Foundation,300,600,300,1,00130,India
819535,2023-02-23,1009,Moisturizer,250,500,250,2,00130,India
819535,2023-02-23,1007,Eyeshadow,200,400,200,1,00130,India
819535,2023-02-23,1006,Blush,150,300,150,1,00130,India
819535,2023-02-23,1001,Lipstick,150,300,150,1,00130,India
939523,2023-02-23,1004,Eyeliner,100,200,100,1,00131,India
939523,2023-02-23,1003,Foundation,300,600,300,1,00131,India
939523,2023-02-23,1002,Mascara,200,400,200,1,00131,India
978597,2023-02-23,1006,Blush,150,300,150,1,00132,India
978597,2023-02-23,1008,Makeup Remover,80,160,80,1,00132,India
978597,2023-02-23,1007,Eyeshadow,200,400,200,1,00132,India
494905,2023-02-23,1003,Foundation,300,600,300,1,00133,India
494905,2023-02-23,1001,Lipstick,150,300,150,1,00133,India
641365,2023-02-23,1001,Lipstick,150,300,150,1,00134,India
641365,2023-02-23,1004,Eyeliner,100,200,100,1,00134,India
851285,2023-02-23,1003,Foundation,300,600,300,1,00135,India
851285,2023-02-23,1005,Nail Polish,50,100,50,1,00135,India
851285,2023-02-23,1007,Eyeshadow,200,400,200,1,00135,India
851285,2023-02-23,1004,Eyeliner,100,200,100,1,00135,India
543635,2023-02-23,1008,Makeup Remover,80,160,80,1,00136,India
221352,2023-02-23,1003,Foundation,300,600,300,1,00137,India
221352,2023-02-23,1004,Eyeliner,100,200,100,1,00137,India
221352,2023-02-23,1007,Eyeshadow,200,400,200,1,00137,India
221352,2023-02-23,1012,Body Lotion,200,400,200,2,00137,India
221352,2023-02-23,1002,Mascara,200,400,200,1,00137,India
257599,2023-02-23,1008,Makeup Remover,80,160,80,1,00138,India
257599,2023-02-23,1007,Eyeshadow,200,400,200,1,00138,India
257599,2023-02-23,1002,Mascara,200,400,200,1,00138,India
257599,2023-02-23,1012,Body Lotion,200,400,200,2,00138,India
305468,2023-02-23,1009,Moisturizer,250,500,250,2,00139,India
305468,2023-02-23,1002,Mascara,200,400,200,1,00139,India
841486,2023-02-23,1002,Mascara,200,400,200,1,00140,India
841486,2023-02-23,1003,Foundation,300,600,300,1,00140,India
108557,2023-02-23,1001,Lipstick,150,300,150,1,00141,India
108557,2023-02-23,1012,Body Lotion,200,400,200,2,00141,India
108557,2023-02-23,1003,Foundation,300,600,300,1,00141,India
155737,2023-02-23,1005,Nail Polish,50,100,50,1,00142,India
155737,2023-02-23,1009,Moisturizer,250,500,250,2,00142,India
155737,2023-02-23,1006,Blush,150,300,150,1,00142,India
294341,2023-02-23,1004,Eyeliner,100,200,100,1,00143,India
294341,2023-02-23,1008,Makeup Remover,80,160,80,1,00143,India
342658,2023-02-23,1009,Moisturizer,250,500,250,2,00144,India
342658,2023-02-23,1006,Blush,150,300,150,1,00144,India
342658,2023-02-23,1007,Eyeshadow,200,400,200,1,00144,India
858782,2023-02-23,1003,Foundation,300,600,300,1,00145,India
858782,2023-02-23,1005,Nail Polish,50,100,50,1,00145,India
858782,2023-02-23,1006,Blush,150,300,150,1,00145,India
858782,2023-02-23,1007,Eyeshadow,200,400,200,1,00145,India
891868,2023-02-23,1009,Moisturizer,250,500,250,2,00146,India
891868,2023-02-23,1002,Mascara,200,400,200,1,00146,India
891868,2023-02-23,1006,Blush,150,300,150,1,00146,India
135249,2023-02-23,1009,Moisturizer,250,500,250,2,00147,India
135249,2023-02-23,1001,Lipstick,150,300,150,1,00147,India
135249,2023-02-23,1002,Mascara,200,400,200,1,00147,India
780300,2023-02-23,1003,Foundation,300,600,300,1,00148,India
780300,2023-02-23,1004,Eyeliner,100,200,100,1,00148,India
780300,2023-02-23,1001,Lipstick,150,300,150,1,00148,India
508816,2023-02-23,1006,Blush,150,300,150,1,00149,India
472429,2023-02-23,1004,Eyeliner,100,200,100,1,00150,India
472429,2023-02-23,1008,Makeup Remover,80,160,80,1,00150,India
992011,2023-02-23,1007,Eyeshadow,200,400,200,1,00151,India
992011,2023-02-23,1003,Foundation,300,600,300,1,00151,India
992011,2023-02-23,1012,Body Lotion,200,400,200,2,00151,India
992011,2023-02-23,1006,Blush,150,300,150,1,00151,India
521791,2023-02-23,1008,Makeup Remover,80,160,80,1,00152,India
521791,2023-02-23,1007,Eyeshadow,200,400,200,1,00152,India
123232,2023-02-23,1006,Blush,150,300,150,1,00153,India
798199,2023-02-23,1008,Makeup Remover,80,160,80,1,00154,India
599589,2023-02-23,1006,Blush,150,300,150,1,00155,India
333642,2023-02-23,1007,Eyeshadow,200,400,200,1,00156,India
333642,2023-02-23,1005,Nail Polish,50,100,50,1,00156,India
333642,2023-02-23,1003,Foundation,300,600,300,1,00156,India
379755,2023-02-23,1004,Eyeliner,100,200,100,1,00157,India
555198,2023-02-23,1001,Lipstick,150,300,150,1,00158,India
555198,2023-02-23,1008,Makeup Remover,80,160,80,1,00158,India
555198,2023-02-23,1006,Blush,150,300,150,1,00158,India
555198,2023-02-23,1012,Body Lotion,200,400,200,2,00158,India
555198,2023-02-23,1002,Mascara,200,400,200,1,00158,India
555749,2023-02-24,1012,Body Lotion,200,400,200,2,00159,India
866868,2023-02-24,1004,Eyeliner,100,200,100,1,00160,India
866868,2023-02-24,1012,Body Lotion,200,400,200,2,00160,India
866868,2023-02-24,1008,Makeup Remover,80,160,80,1,00160,India
630386,2023-02-24,1002,Mascara,200,400,200,1,00161,India
206243,2023-02-24,1012,Body Lotion,200,400,200,2,00162,India
196570,2023-02-24,1005,Nail Polish,50,100,50,1,00163,India
196570,2023-02-24,1009,Moisturizer,250,500,250,2,00163,India
328129,2023-02-24,1005,Nail Polish,50,100,50,1,00164,India
328129,2023-02-24,1009,Moisturizer,250,500,250,2,00164,India
328129,2023-02-24,1006,Blush,150,300,150,1,00164,India
551797,2023-02-24,1007,Eyeshadow,200,400,200,1,00165,India
229630,2023-02-24,1001,Lipstick,150,300,150,1,00166,India
229630,2023-02-24,1004,Eyeliner,100,200,100,1,00166,India
229630,2023-02-24,1006,Blush,150,300,150,1,00166,India
645140,2023-02-24,1004,Eyeliner,100,200,100,1,00167,India
645140,2023-02-24,1006,Blush,150,300,150,1,00167,India
645140,2023-02-24,1007,Eyeshadow,200,400,200,1,00167,India
902034,2023-02-24,1012,Body Lotion,200,400,200,2,00168,India
902034,2023-02-24,1005,Nail Polish,50,100,50,1,00168,India
351279,2023-02-24,1003,Foundation,300,600,300,1,00169,India
351279,2023-02-24,1006,Blush,150,300,150,1,00169,India
667486,2023-02-24,1008,Makeup Remover,80,160,80,1,00170,India
667486,2023-02-24,1007,Eyeshadow,200,400,200,1,00170,India
392814,2023-02-24,1006,Blush,150,300,150,1,00171,India
132766,2023-02-24,1002,Mascara,200,400,200,1,00172,India
132766,2023-02-24,1004,Eyeliner,100,200,100,1,00172,India
132766,2023-02-24,1012,Body Lotion,200,400,200,2,00172,India
454563,2023-02-24,1002,Mascara,200,400,200,1,00173,India
454563,2023-02-24,1005,Nail Polish,50,100,50,1,00173,India
675372,2023-02-24,1012,Body Lotion,200,400,200,2,00174,India
675372,2023-02-24,1005,Nail Polish,50,100,50,1,00174,India
637578,2023-02-24,1003,Foundation,300,600,300,1,00175,India
637578,2023-02-24,1004,Eyeliner,100,200,100,1,00175,India
637578,2023-02-24,1001,Lipstick,150,300,150,1,00175,India
904556,2023-02-24,1007,Eyeshadow,200,400,200,1,00176,India
904556,2023-02-24,1008,Makeup Remover,80,160,80,1,00176,India
904556,2023-02-24,1006,Blush,150,300,150,1,00176,India
904556,2023-02-24,1003,Foundation,300,600,300,1,00176,India
843892,2023-02-24,1009,Moisturizer,250,500,250,2,00177,India
359046,2023-02-24,1005,Nail Polish,50,100,50,1,00178,India
761928,2023-02-24,1001,Lipstick,150,300,150,1,00179,India
427149,2023-02-24,1006,Blush,150,300,150,1,00180,India
911080,2023-02-24,1009,Moisturizer,250,500,250,2,00181,India
911080,2023-02-24,1001,Lipstick,150,300,150,1,00181,India
911080,2023-02-24,1004,Eyeliner,100,200,100,1,00181,India
400792,2023-02-24,1012,Body Lotion,200,400,200,2,00182,India
400792,2023-02-24,1008,Makeup Remover,80,160,80,1,00182,India
400792,2023-02-24,1006,Blush,150,300,150,1,00182,India
435618,2023-02-24,1012,Body Lotion,200,400,200,2,00183,India
685686,2023-02-24,1002,Mascara,200,400,200,1,00184,India
685686,2023-02-24,1005,Nail Polish,50,100,50,1,00184,India
685686,2023-02-24,1001,Lipstick,150,300,150,1,00184,India
423304,2023-02-24,1008,Makeup Remover,80,160,80,1,00185,India
345338,2023-02-24,1006,Blush,150,300,150,1,00186,India
345338,2023-02-24,1009,Moisturizer,250,500,250,2,00186,India
345338,2023-02-24,1005,Nail Polish,50,100,50,1,00186,India
345338,2023-02-24,1012,Body Lotion,200,400,200,2,00186,India
286916,2023-02-24,1002,Mascara,200,400,200,1,00187,India
286916,2023-02-24,1001,Lipstick,150,300,150,1,00187,India
671533,2023-02-24,1009,Moisturizer,250,500,250,2,00188,India
671533,2023-02-24,1008,Makeup Remover,80,160,80,1,00188,India
671533,2023-02-24,1007,Eyeshadow,200,400,200,1,00188,India
551822,2023-02-24,1008,Makeup Remover,80,160,80,1,00189,India
551822,2023-02-24,1009,Moisturizer,250,500,250,2,00189,India
551822,2023-02-24,1007,Eyeshadow,200,400,200,1,00189,India
475133,2023-02-24,1008,Makeup Remover,80,160,80,1,00190,India
475133,2023-02-24,1004,Eyeliner,100,200,100,1,00190,India
475133,2023-02-24,1006,Blush,150,300,150,1,00190,India
794216,2023-02-24,1006,Blush,150,300,150,1,00191,India
371504,2023-02-24,1003,Foundation,300,600,300,1,00192,India
371504,2023-02-24,1012,Body Lotion,200,400,200,2,00192,India
645487,2023-02-24,1006,Blush,150,300,150,1,00193,India
327478,2023-02-24,1005,Nail Polish,50,100,50,1,00194,India
174465,2023-02-24,1008,Makeup Remover,80,160,80,1,00195,India
174465,2023-02-24,1007,Eyeshadow,200,400,200,1,00195,India
174465,2023-02-24,1002,Mascara,200,400,200,1,00195,India
942029,2023-02-24,1002,Mascara,200,400,200,1,00196,India
942029,2023-02-24,1004,Eyeliner,100,200,100,1,00196,India
942029,2023-02-24,1006,Blush,150,300,150,1,00196,India
991904,2023-02-24,1012,Body Lotion,200,400,200,2,00197,India
991904,2023-02-24,1002,Mascara,200,400,200,1,00197,India
167529,2023-02-24,1005,Nail Polish,50,100,50,1,00198,India
636853,2023-02-24,1005,Nail Polish,50,100,50,1,00199,India
636853,2023-02-24,1009,Moisturizer,250,500,250,2,00199,India
636853,2023-02-24,1012,Body Lotion,200,400,200,2,00199,India
636853,2023-02-24,1002,Mascara,200,400,200,1,00199,India
443263,2023-02-24,1003,Foundation,300,600,300,1,00200,India
443263,2023-02-24,1002,Mascara,200,400,200,1,00200,India
443263,2023-02-24,1005,Nail Polish,50,100,50,1,00200,India
443263,2023-02-24,1008,Makeup Remover,80,160,80,1,00200,India
443263,2023-02-24,1009,Moisturizer,250,500,250,2,00200,India
991868,2023-02-24,1004,Eyeliner,100,200,100,1,00201,India
991868,2023-02-24,1001,Lipstick,150,300,150,1,00201,India
991868,2023-02-24,1012,Body Lotion,200,400,200,2,00201,India
863258,2023-02-24,1004,Eyeliner,100,200,100,1,00202,India
863258,2023-02-24,1007,Eyeshadow,200,400,200,1,00202,India
863258,2023-02-24,1006,Blush,150,300,150,1,00202,India
863258,2023-02-24,1009,Moisturizer,250,500,250,2,00202,India
214737,2023-02-24,1007,Eyeshadow,200,400,200,1,00203,India
214737,2023-02-24,1012,Body Lotion,200,400,200,2,00203,India
214737,2023-02-24,1006,Blush,150,300,150,1,00203,India
556575,2023-02-24,1002,Mascara,200,400,200,1,00204,India
556575,2023-02-24,1012,Body Lotion,200,400,200,2,00204,India
914190,2023-02-24,1003,Foundation,300,600,300,1,00205,India
714391,2023-02-24,1004,Eyeliner,100,200,100,1,00206,India
714391,2023-02-24,1003,Foundation,300,600,300,1,00206,India
933244,2023-02-24,1004,Eyeliner,100,200,100,1,00207,India
505858,2023-02-25,1012,Body Lotion,200,400,200,2,00208,India
695685,2023-02-25,1005,Nail Polish,50,100,50,1,00209,India
600826,2023-02-25,1001,Lipstick,150,300,150,1,00210,India
600826,2023-02-25,1004,Eyeliner,100,200,100,1,00210,India
880615,2023-02-25,1004,Eyeliner,100,200,100,1,00211,India
864074,2023-02-25,1006,Blush,150,300,150,1,00212,India
864074,2023-02-25,1005,Nail Polish,50,100,50,1,00212,India
864074,2023-02-25,1012,Body Lotion,200,400,200,2,00212,India
864074,2023-02-25,1003,Foundation,300,600,300,1,00212,India
970464,2023-02-25,1009,Moisturizer,250,500,250,2,00213,India
970464,2023-02-25,1002,Mascara,200,400,200,1,00213,India
970464,2023-02-25,1007,Eyeshadow,200,400,200,1,00213,India
970464,2023-02-25,1012,Body Lotion,200,400,200,2,00213,India
883628,2023-02-25,1003,Foundation,300,600,300,1,00214,India
883628,2023-02-25,1007,Eyeshadow,200,400,200,1,00214,India
951001,2023-02-25,1007,Eyeshadow,200,400,200,1,00215,India
951001,2023-02-25,1006,Blush,150,300,150,1,00215,India
951001,2023-02-25,1004,Eyeliner,100,200,100,1,00215,India
466282,2023-02-25,1004,Eyeliner,100,200,100,1,00216,India
466282,2023-02-25,1003,Foundation,300,600,300,1,00216,India
466282,2023-02-25,1008,Makeup Remover,80,160,80,1,00216,India
466282,2023-02-25,1005,Nail Polish,50,100,50,1,00216,India
654615,2023-02-25,1012,Body Lotion,200,400,200,2,00217,India
654615,2023-02-25,1005,Nail Polish,50,100,50,1,00217,India
400996,2023-02-25,1003,Foundation,300,600,300,1,00218,India
400996,2023-02-25,1009,Moisturizer,250,500,250,2,00218,India
400996,2023-02-25,1005,Nail Polish,50,100,50,1,00218,India
262492,2023-02-25,1006,Blush,150,300,150,1,00219,India
262492,2023-02-25,1005,Nail Polish,50,100,50,1,00219,India
262492,2023-02-25,1004,Eyeliner,100,200,100,1,00219,India
650378,2023-02-25,1005,Nail Polish,50,100,50,1,00220,India
650378,2023-02-25,1012,Body Lotion,200,400,200,2,00220,India
650378,2023-02-25,1009,Moisturizer,250,500,250,2,00220,India
208128,2023-02-25,1012,Body Lotion,200,400,200,2,00221,India
208128,2023-02-25,1006,Blush,150,300,150,1,00221,India
208128,2023-02-25,1005,Nail Polish,50,100,50,1,00221,India
208128,2023-02-25,1004,Eyeliner,100,200,100,1,00221,India
367926,2023-02-25,1002,Mascara,200,400,200,1,00222,India
367926,2023-02-25,1007,Eyeshadow,200,400,200,1,00222,India
367926,2023-02-25,1008,Makeup Remover,80,160,80,1,00222,India
367926,2023-02-25,1012,Body Lotion,200,400,200,2,00222,India
808522,2023-02-25,1007,Eyeshadow,200,400,200,1,00223,India
143724,2023-02-25,1002,Mascara,200,400,200,1,00224,India
465810,2023-02-25,1006,Blush,150,300,150,1,00225,India
465810,2023-02-25,1012,Body Lotion,200,400,200,2,00225,India
465810,2023-02-25,1002,Mascara,200,400,200,1,00225,India
707167,2023-02-25,1002,Mascara,200,400,200,1,00226,India
763752,2023-02-25,1005,Nail Polish,50,100,50,1,00227,India
763752,2023-02-25,1006,Blush,150,300,150,1,00227,India
763752,2023-02-25,1003,Foundation,300,600,300,1,00227,India
763752,2023-02-25,1009,Moisturizer,250,500,250,2,00227,India
428241,2023-02-25,1005,Nail Polish,50,100,50,1,00228,India
428241,2023-02-25,1002,Mascara,200,400,200,1,00228,India
428241,2023-02-25,1003,Foundation,300,600,300,1,00228,India
428241,2023-02-25,1006,Blush,150,300,150,1,00228,India
966508,2023-02-25,1008,Makeup Remover,80,160,80,1,00229,India
966508,2023-02-25,1004,Eyeliner,100,200,100,1,00229,India
966508,2023-02-25,1009,Moisturizer,250,500,250,2,00229,India
390956,2023-02-25,1008,Makeup Remover,80,160,80,1,00230,India
390956,2023-02-25,1009,Moisturizer,250,500,250,2,00230,India
390956,2023-02-25,1005,Nail Polish,50,100,50,1,00230,India
390956,2023-02-25,1004,Eyeliner,100,200,100,1,00230,India
390956,2023-02-25,1012,Body Lotion,200,400,200,2,00230,India
186603,2023-02-25,1002,Mascara,200,400,200,1,00231,India
322756,2023-02-25,1005,Nail Polish,50,100,50,1,00232,India
322756,2023-02-25,1002,Mascara,200,400,200,1,00232,India
322756,2023-02-25,1012,Body Lotion,200,400,200,2,00232,India
232816,2023-02-25,1009,Moisturizer,250,500,250,2,00233,India
232816,2023-02-25,1006,Blush,150,300,150,1,00233,India
232816,2023-02-25,1007,Eyeshadow,200,400,200,1,00233,India
232816,2023-02-25,1012,Body Lotion,200,400,200,2,00233,India
509974,2023-02-25,1002,Mascara,200,400,200,1,00234,India
509974,2023-02-25,1004,Eyeliner,100,200,100,1,00234,India
509974,2023-02-25,1007,Eyeshadow,200,400,200,1,00234,India
325902,2023-02-25,1006,Blush,150,300,150,1,00235,India
325902,2023-02-25,1001,Lipstick,150,300,150,1,00235,India
325902,2023-02-25,1008,Makeup Remover,80,160,80,1,00235,India
704783,2023-02-25,1007,Eyeshadow,200,400,200,1,00236,India
704783,2023-02-25,1004,Eyeliner,100,200,100,1,00236,India
704783,2023-02-25,1003,Foundation,300,600,300,1,00236,India
704783,2023-02-25,1012,Body Lotion,200,400,200,2,00236,India
548780,2023-02-25,1001,Lipstick,150,300,150,1,00237,India
548780,2023-02-25,1008,Makeup Remover,80,160,80,1,00237,India
208281,2023-02-25,1008,Makeup Remover,80,160,80,1,00238,India
208281,2023-02-25,1007,Eyeshadow,200,400,200,1,00238,India
208281,2023-02-25,1001,Lipstick,150,300,150,1,00238,India
208281,2023-02-25,1003,Foundation,300,600,300,1,00238,India
208281,2023-02-25,1006,Blush,150,300,150,1,00238,India
808805,2023-02-25,1004,Eyeliner,100,200,100,1,00239,India
974362,2023-02-25,1007,Eyeshadow,200,400,200,1,00240,India
974362,2023-02-25,1002,Mascara,200,400,200,1,00240,India
131098,2023-02-25,1004,Eyeliner,100,200,100,1,00241,India
131098,2023-02-25,1007,Eyeshadow,200,400,200,1,00241,India
207625,2023-02-25,1004,Eyeliner,100,200,100,1,00242,India
207625,2023-02-25,1006,Blush,150,300,150,1,00242,India
207625,2023-02-25,1005,Nail Polish,50,100,50,1,00242,India
207625,2023-02-25,1007,Eyeshadow,200,400,200,1,00242,India
207625,2023-02-25,1002,Mascara,200,400,200,1,00242,India
889078,2023-02-25,1002,Mascara,200,400,200,1,00243,India
889078,2023-02-25,1009,Moisturizer,250,500,250,2,00243,India
889078,2023-02-25,1005,Nail Polish,50,100,50,1,00243,India
889078,2023-02-25,1003,Foundation,300,600,300,1,00243,India
717502,2023-02-25,1008,Makeup Remover,80,160,80,1,00244,India
717502,2023-02-25,1007,Eyeshadow,200,400,200,1,00244,India
699564,2023-02-25,1008,Makeup Remover,80,160,80,1,00245,India
699564,2023-02-25,1012,Body Lotion,200,400,200,2,00245,India
411248,2023-02-25,1001,Lipstick,150,300,150,1,00246,India
411248,2023-02-25,1002,Mascara,200,400,200,1,00246,India
411248,2023-02-25,1008,Makeup Remover,80,160,80,1,00246,India
324191,2023-02-25,1005,Nail Polish,50,100,50,1,00247,India
324191,2023-02-25,1012,Body Lotion,200,400,200,2,00247,India
324191,2023-02-25,1007,Eyeshadow,200,400,200,1,00247,India
324191,2023-02-25,1001,Lipstick,150,300,150,1,00247,India
324191,2023-02-25,1004,Eyeliner,100,200,100,1,00247,India
748757,2023-02-25,1003,Foundation,300,600,300,1,00248,India
748757,2023-02-25,1005,Nail Polish,50,100,50,1,00248,India
211534,2023-02-25,1009,Moisturizer,250,500,250,2,00249,India
943646,2023-02-25,1012,Body Lotion,200,400,200,2,00250,India
949196,2023-02-25,1001,Lipstick,150,300,150,1,00251,India
949196,2023-02-25,1004,Eyeliner,100,200,100,1,00251,India
949196,2023-02-25,1009,Moisturizer,250,500,250,2,00251,India
949196,2023-02-25,1007,Eyeshadow,200,400,200,1,00251,India
832182,2023-02-25,1008,Makeup Remover,80,160,80,1,00252,India
832182,2023-02-25,1007,Eyeshadow,200,400,200,1,00252,India
832182,2023-02-25,1005,Nail Polish,50,100,50,1,00252,India
832182,2023-02-25,1004,Eyeliner,100,200,100,1,00252,India
918530,2023-02-25,1009,Moisturizer,250,500,250,2,00253,India
918530,2023-02-25,1006,Blush,150,300,150,1,00253,India
918530,2023-02-25,1001,Lipstick,150,300,150,1,00253,India
986712,2023-02-26,1003,Foundation,300,600,300,1,00254,India
986712,2023-02-26,1005,Nail Polish,50,100,50,1,00254,India
909959,2023-02-26,1003,Foundation,300,600,300,1,00255,India
909959,2023-02-26,1009,Moisturizer,250,500,250,2,00255,India
909959,2023-02-26,1005,Nail Polish,50,100,50,1,00255,India
909959,2023-02-26,1006,Blush,150,300,150,1,00255,India
522399,2023-02-26,1001,Lipstick,150,300,150,1,00256,India
936556,2023-02-26,1006,Blush,150,300,150,1,00257,India
919137,2023-02-26,1005,Nail Polish,50,100,50,1,00258,India
546989,2023-02-26,1003,Foundation,300,600,300,1,00259,India
546989,2023-02-26,1009,Moisturizer,250,500,250,2,00259,India
584287,2023-02-26,1001,Lipstick,150,300,150,1,00260,India
896567,2023-02-26,1006,Blush,150,300,150,1,00261,India
896567,2023-02-26,1007,Eyeshadow,200,400,200,1,00261,India
142631,2023-02-26,1002,Mascara,200,400,200,1,00262,India
142631,2023-02-26,1003,Foundation,300,600,300,1,00262,India
142631,2023-02-26,1004,Eyeliner,100,200,100,1,00262,India
142631,2023-02-26,1001,Lipstick,150,300,150,1,00262,India
206866,2023-02-26,1005,Nail Polish,50,100,50,1,00263,India
206866,2023-02-26,1008,Makeup Remover,80,160,80,1,00263,India
727730,2023-02-26,1009,Moisturizer,250,500,250,2,00264,India
727730,2023-02-26,1005,Nail Polish,50,100,50,1,00264,India
714946,2023-02-26,1001,Lipstick,150,300,150,1,00265,India
714946,2023-02-26,1005,Nail Polish,50,100,50,1,00265,India
714946,2023-02-26,1012,Body Lotion,200,400,200,2,00265,India
576434,2023-02-26,1009,Moisturizer,250,500,250,2,00266,India
129115,2023-02-26,1001,Lipstick,150,300,150,1,00267,India
428934,2023-02-26,1004,Eyeliner,100,200,100,1,00268,India
428934,2023-02-26,1005,Nail Polish,50,100,50,1,00268,India
428934,2023-02-26,1012,Body Lotion,200,400,200,2,00268,India
428934,2023-02-26,1007,Eyeshadow,200,400,200,1,00268,India
631808,2023-02-26,1002,Mascara,200,400,200,1,00269,India
631808,2023-02-26,1007,Eyeshadow,200,400,200,1,00269,India
631808,2023-02-26,1009,Moisturizer,250,500,250,2,00269,India
631808,2023-02-26,1005,Nail Polish,50,100,50,1,00269,India
631808,2023-02-26,1003,Foundation,300,600,300,1,00269,India
468417,2023-02-26,1012,Body Lotion,200,400,200,2,00270,India
468417,2023-02-26,1001,Lipstick,150,300,150,1,00270,India
152195,2023-02-26,1005,Nail Polish,50,100,50,1,00271,India
152195,2023-02-26,1008,Makeup Remover,80,160,80,1,00271,India
152195,2023-02-26,1002,Mascara,200,400,200,1,00271,India
101304,2023-02-26,1007,Eyeshadow,200,400,200,1,00272,India
311127,2023-02-26,1006,Blush,150,300,150,1,00273,India
311127,2023-02-26,1008,Makeup Remover,80,160,80,1,00273,India
250886,2023-02-26,1005,Nail Polish,50,100,50,1,00274,India
250886,2023-02-26,1004,Eyeliner,100,200,100,1,00274,India
250886,2023-02-26,1001,Lipstick,150,300,150,1,00274,India
936695,2023-02-26,1006,Blush,150,300,150,1,00275,India
936695,2023-02-26,1009,Moisturizer,250,500,250,2,00275,India
936695,2023-02-26,1008,Makeup Remover,80,160,80,1,00275,India
936695,2023-02-26,1001,Lipstick,150,300,150,1,00275,India
537742,2023-02-26,1004,Eyeliner,100,200,100,1,00276,India
274181,2023-02-26,1004,Eyeliner,100,200,100,1,00277,India
274181,2023-02-26,1008,Makeup Remover,80,160,80,1,00277,India
274181,2023-02-26,1002,Mascara,200,400,200,1,00277,India
274181,2023-02-26,1003,Foundation,300,600,300,1,00277,India
235674,2023-02-26,1008,Makeup Remover,80,160,80,1,00278,India
235674,2023-02-26,1006,Blush,150,300,150,1,00278,India
235674,2023-02-26,1012,Body Lotion,200,400,200,2,00278,India
235674,2023-02-26,1001,Lipstick,150,300,150,1,00278,India
235674,2023-02-26,1002,Mascara,200,400,200,1,00278,India
630532,2023-02-26,1009,Moisturizer,250,500,250,2,00279,India
473572,2023-02-26,1004,Eyeliner,100,200,100,1,00280,India
559706,2023-02-26,1007,Eyeshadow,200,400,200,1,00281,India
559706,2023-02-26,1003,Foundation,300,600,300,1,00281,India
559706,2023-02-26,1006,Blush,150,300,150,1,00281,India
559706,2023-02-26,1002,Mascara,200,400,200,1,00281,India
401077,2023-02-26,1006,Blush,150,300,150,1,00282,India
401077,2023-02-26,1008,Makeup Remover,80,160,80,1,00282,India
401077,2023-02-26,1012,Body Lotion,200,400,200,2,00282,India
401077,2023-02-26,1003,Foundation,300,600,300,1,00282,India
648798,2023-02-26,1005,Nail Polish,50,100,50,1,00283,India
648798,2023-02-26,1007,Eyeshadow,200,400,200,1,00283,India
620512,2023-02-26,1004,Eyeliner,100,200,100,1,00284,India
620512,2023-02-26,1007,Eyeshadow,200,400,200,1,00284,India
982227,2023-02-26,1005,Nail Polish,50,100,50,1,00285,India
982227,2023-02-26,1001,Lipstick,150,300,150,1,00285,India
982227,2023-02-26,1004,Eyeliner,100,200,100,1,00285,India
982227,2023-02-26,1012,Body Lotion,200,400,200,2,00285,India
126123,2023-02-26,1004,Eyeliner,100,200,100,1,00286,India
229030,2023-02-26,1006,Blush,150,300,150,1,00287,India
229030,2023-02-26,1003,Foundation,300,600,300,1,00287,India
531712,2023-02-26,1012,Body Lotion,200,400,200,2,00288,India
206071,2023-02-26,1009,Moisturizer,250,500,250,2,00289,India
206071,2023-02-26,1008,Makeup Remover,80,160,80,1,00289,India
206071,2023-02-26,1003,Foundation,300,600,300,1,00289,India
206071,2023-02-26,1006,Blush,150,300,150,1,00289,India
623515,2023-02-26,1008,Makeup Remover,80,160,80,1,00290,India
623515,2023-02-26,1009,Moisturizer,250,500,250,2,00290,India
623515,2023-02-26,1007,Eyeshadow,200,400,200,1,00290,India
623515,2023-02-26,1003,Foundation,300,600,300,1,00290,India
720181,2023-02-26,1005,Nail Polish,50,100,50,1,00291,India
720181,2023-02-26,1002,Mascara,200,400,200,1,00291,India
720181,2023-02-26,1007,Eyeshadow,200,400,200,1,00291,India
506005,2023-02-26,1002,Mascara,200,400,200,1,00292,India
506005,2023-02-26,1009,Moisturizer,250,500,250,2,00292,India
506005,2023-02-26,1001,Lipstick,150,300,150,1,00292,India
550117,2023-02-26,1008,Makeup Remover,80,160,80,1,00293,India
550117,2023-02-26,1009,Moisturizer,250,500,250,2,00293,India
550117,2023-02-26,1005,Nail Polish,50,100,50,1,00293,India
550117,2023-02-26,1006,Blush,150,300,150,1,00293,India
619980,2023-02-27,1005,Nail Polish,50,100,50,1,00294,India
619980,2023-02-27,1008,Makeup Remover,80,160,80,1,00294,India
619980,2023-02-27,1006,Blush,150,300,150,1,00294,India
619980,2023-02-27,1002,Mascara,200,400,200,1,00294,India
361800,2023-02-27,1007,Eyeshadow,200,400,200,1,00295,India
722618,2023-02-27,1006,Blush,150,300,150,1,00296,India
722618,2023-02-27,1007,Eyeshadow,200,400,200,1,00296,India
722618,2023-02-27,1004,Eyeliner,100,200,100,1,00296,India
722618,2023-02-27,1009,Moisturizer,250,500,250,2,00296,India
684026,2023-02-27,1009,Moisturizer,250,500,250,2,00297,India
684026,2023-02-27,1008,Makeup Remover,80,160,80,1,00297,India
684026,2023-02-27,1005,Nail Polish,50,100,50,1,00297,India
588311,2023-02-27,1009,Moisturizer,250,500,250,2,00298,India
588311,2023-02-27,1006,Blush,150,300,150,1,00298,India
908005,2023-02-27,1006,Blush,150,300,150,1,00299,India
908005,2023-02-27,1012,Body Lotion,200,400,200,2,00299,India
908005,2023-02-27,1004,Eyeliner,100,200,100,1,00299,India
908005,2023-02-27,1007,Eyeshadow,200,400,200,1,00299,India
307099,2023-02-27,1003,Foundation,300,600,300,1,00300,India
307099,2023-02-27,1002,Mascara,200,400,200,1,00300,India
307099,2023-02-27,1008,Makeup Remover,80,160,80,1,00300,India
307099,2023-02-27,1004,Eyeliner,100,200,100,1,00300,India
585992,2023-02-27,1004,Eyeliner,100,200,100,1,00301,India
585992,2023-02-27,1009,Moisturizer,250,500,250,2,00301,India
637513,2023-02-27,1001,Lipstick,150,300,150,1,00302,India
637513,2023-02-27,1003,Foundation,300,600,300,1,00302,India
505852,2023-02-27,1012,Body Lotion,200,400,200,2,00303,India
505852,2023-02-27,1008,Makeup Remover,80,160,80,1,00303,India
505852,2023-02-27,1003,Foundation,300,600,300,1,00303,India
505852,2023-02-27,1002,Mascara,200,400,200,1,00303,India
567615,2023-02-27,1006,Blush,150,300,150,1,00304,India
567615,2023-02-27,1004,Eyeliner,100,200,100,1,00304,India
348427,2023-02-27,1001,Lipstick,150,300,150,1,00305,India
348427,2023-02-27,1004,Eyeliner,100,200,100,1,00305,India
348427,2023-02-27,1002,Mascara,200,400,200,1,00305,India
348427,2023-02-27,1009,Moisturizer,250,500,250,2,00305,India
348427,2023-02-27,1006,Blush,150,300,150,1,00305,India
909429,2023-02-27,1001,Lipstick,150,300,150,1,00306,India
909429,2023-02-27,1006,Blush,150,300,150,1,00306,India
633652,2023-02-27,1002,Mascara,200,400,200,1,00307,India
623136,2023-02-27,1007,Eyeshadow,200,400,200,1,00308,India
623136,2023-02-27,1001,Lipstick,150,300,150,1,00308,India
623136,2023-02-27,1008,Makeup Remover,80,160,80,1,00308,India
913576,2023-02-27,1004,Eyeliner,100,200,100,1,00309,India
855659,2023-02-27,1009,Moisturizer,250,500,250,2,00310,India
855659,2023-02-27,1008,Makeup Remover,80,160,80,1,00310,India
351488,2023-02-27,1012,Body Lotion,200,400,200,2,00311,India
637156,2023-02-27,1002,Mascara,200,400,200,1,00312,India
833929,2023-02-27,1009,Moisturizer,250,500,250,2,00313,India
833929,2023-02-27,1007,Eyeshadow,200,400,200,1,00313,India
833929,2023-02-27,1004,Eyeliner,100,200,100,1,00313,India
833929,2023-02-27,1012,Body Lotion,200,400,200,2,00313,India
466339,2023-02-27,1004,Eyeliner,100,200,100,1,00314,India
466339,2023-02-27,1002,Mascara,200,400,200,1,00314,India
466339,2023-02-27,1012,Body Lotion,200,400,200,2,00314,India
466339,2023-02-27,1001,Lipstick,150,300,150,1,00314,India
908427,2023-02-27,1005,Nail Polish,50,100,50,1,00315,India
908427,2023-02-27,1007,Eyeshadow,200,400,200,1,00315,India
908427,2023-02-27,1009,Moisturizer,250,500,250,2,00315,India
908427,2023-02-27,1002,Mascara,200,400,200,1,00315,India
993472,2023-02-27,1012,Body Lotion,200,400,200,2,00316,India
993472,2023-02-27,1003,Foundation,300,600,300,1,00316,India
993472,2023-02-27,1006,Blush,150,300,150,1,00316,India
874104,2023-02-27,1008,Makeup Remover,80,160,80,1,00317,India
963830,2023-02-27,1002,Mascara,200,400,200,1,00318,India
963830,2023-02-27,1006,Blush,150,300,150,1,00318,India
963830,2023-02-27,1007,Eyeshadow,200,400,200,1,00318,India
963830,2023-02-27,1003,Foundation,300,600,300,1,00318,India
219236,2023-02-27,1003,Foundation,300,600,300,1,00319,India
790905,2023-02-27,1001,Lipstick,150,300,150,1,00320,India
867661,2023-02-27,1007,Eyeshadow,200,400,200,1,00321,India
397978,2023-02-27,1001,Lipstick,150,300,150,1,00322,India
397978,2023-02-27,1002,Mascara,200,400,200,1,00322,India
397978,2023-02-27,1008,Makeup Remover,80,160,80,1,00322,India
901488,2023-02-27,1007,Eyeshadow,200,400,200,1,00323,India
901488,2023-02-27,1001,Lipstick,150,300,150,1,00323,India
901488,2023-02-27,1008,Makeup Remover,80,160,80,1,00323,India
593881,2023-02-27,1003,Foundation,300,600,300,1,00324,India
593881,2023-02-27,1006,Blush,150,300,150,1,00324,India
593881,2023-02-27,1005,Nail Polish,50,100,50,1,00324,India
240397,2023-02-27,1002,Mascara,200,400,200,1,00325,India
240397,2023-02-27,1003,Foundation,300,600,300,1,00325,India
240397,2023-02-27,1005,Nail Polish,50,100,50,1,00325,India
536846,2023-02-27,1008,Makeup Remover,80,160,80,1,00326,India
536846,2023-02-27,1004,Eyeliner,100,200,100,1,00326,India
536846,2023-02-27,1007,Eyeshadow,200,400,200,1,00326,India
573265,2023-02-27,1002,Mascara,200,400,200,1,00327,India
573265,2023-02-27,1001,Lipstick,150,300,150,1,00327,India
573265,2023-02-27,1003,Foundation,300,600,300,1,00327,India
125304,2023-02-27,1007,Eyeshadow,200,400,200,1,00328,India
125304,2023-02-27,1009,Moisturizer,250,500,250,2,00328,India
125304,2023-02-27,1005,Nail Polish,50,100,50,1,00328,India
726213,2023-02-27,1012,Body Lotion,200,400,200,2,00329,India
726213,2023-02-27,1008,Makeup Remover,80,160,80,1,00329,India
311195,2023-02-27,1004,Eyeliner,100,200,100,1,00330,India
311195,2023-02-27,1009,Moisturizer,250,500,250,2,00330,India
311195,2023-02-27,1006,Blush,150,300,150,1,00330,India
827958,2023-02-28,1005,Nail Polish,50,100,50,1,00331,India
687698,2023-02-28,1009,Moisturizer,250,500,250,2,00332,India
687698,2023-02-28,1012,Body Lotion,200,400,200,2,00332,India
399218,2023-02-28,1005,Nail Polish,50,100,50,1,00333,India
399218,2023-02-28,1004,Eyeliner,100,200,100,1,00333,India
651573,2023-02-28,1004,Eyeliner,100,200,100,1,00334,India
713118,2023-02-28,1001,Lipstick,150,300,150,1,00335,India
713118,2023-02-28,1004,Eyeliner,100,200,100,1,00335,India
740650,2023-02-28,1001,Lipstick,150,300,150,1,00336,India
740650,2023-02-28,1002,Mascara,200,400,200,1,00336,India
740650,2023-02-28,1006,Blush,150,300,150,1,00336,India
328786,2023-02-28,1009,Moisturizer,250,500,250,2,00337,India
993304,2023-02-28,1006,Blush,150,300,150,1,00338,India
993304,2023-02-28,1008,Makeup Remover,80,160,80,1,00338,India
993304,2023-02-28,1012,Body Lotion,200,400,200,2,00338,India
616960,2023-02-28,1009,Moisturizer,250,500,250,2,00339,India
616960,2023-02-28,1005,Nail Polish,50,100,50,1,00339,India
124439,2023-02-28,1001,Lipstick,150,300,150,1,00340,India
968831,2023-02-28,1001,Lipstick,150,300,150,1,00341,India
968831,2023-02-28,1002,Mascara,200,400,200,1,00341,India
735244,2023-02-28,1003,Foundation,300,600,300,1,00342,India
735244,2023-02-28,1004,Eyeliner,100,200,100,1,00342,India
735244,2023-02-28,1001,Lipstick,150,300,150,1,00342,India
735244,2023-02-28,1005,Nail Polish,50,100,50,1,00342,India
237662,2023-02-28,1002,Mascara,200,400,200,1,00343,India
748296,2023-02-28,1004,Eyeliner,100,200,100,1,00344,India
748296,2023-02-28,1008,Makeup Remover,80,160,80,1,00344,India
748296,2023-02-28,1003,Foundation,300,600,300,1,00344,India
748296,2023-02-28,1012,Body Lotion,200,400,200,2,00344,India
563368,2023-02-28,1007,Eyeshadow,200,400,200,1,00345,India
213981,2023-02-28,1007,Eyeshadow,200,400,200,1,00346,India
581361,2023-02-28,1007,Eyeshadow,200,400,200,1,00347,India
581361,2023-02-28,1003,Foundation,300,600,300,1,00347,India
581361,2023-02-28,1009,Moisturizer,250,500,250,2,00347,India
581361,2023-02-28,1006,Blush,150,300,150,1,00347,India
733438,2023-02-28,1004,Eyeliner,100,200,100,1,00348,India
733438,2023-02-28,1012,Body Lotion,200,400,200,2,00348,India
628182,2023-02-28,1012,Body Lotion,200,400,200,2,00349,India
628182,2023-02-28,1007,Eyeshadow,200,400,200,1,00349,India
938602,2023-02-28,1012,Body Lotion,200,400,200,2,00350,India
938602,2023-02-28,1004,Eyeliner,100,200,100,1,00350,India
938602,2023-02-28,1003,Foundation,300,600,300,1,00350,India
938602,2023-02-28,1005,Nail Polish,50,100,50,1,00350,India
938602,2023-02-28,1002,Mascara,200,400,200,1,00350,India
958521,2023-02-28,1009,Moisturizer,250,500,250,2,00351,India
628803,2023-02-28,1004,Eyeliner,100,200,100,1,00352,India
628803,2023-02-28,1001,Lipstick,150,300,150,1,00352,India
959591,2023-02-28,1005,Nail Polish,50,100,50,1,00353,India
715631,2023-02-28,1012,Body Lotion,200,400,200,2,00354,India
715631,2023-02-28,1008,Makeup Remover,80,160,80,1,00354,India
715631,2023-02-28,1005,Nail Polish,50,100,50,1,00354,India
715631,2023-02-28,1001,Lipstick,150,300,150,1,00354,India
289488,2023-02-28,1003,Foundation,300,600,300,1,00355,India
289488,2023-02-28,1002,Mascara,200,400,200,1,00355,India
330588,2023-02-28,1009,Moisturizer,250,500,250,2,00356,India
330588,2023-02-28,1001,Lipstick,150,300,150,1,00356,India
330588,2023-02-28,1005,Nail Polish,50,100,50,1,00356,India
330588,2023-02-28,1008,Makeup Remover,80,160,80,1,00356,India
667430,2023-02-28,1008,Makeup Remover,80,160,80,1,00357,India
667430,2023-02-28,1004,Eyeliner,100,200,100,1,00357,India
667430,2023-02-28,1001,Lipstick,150,300,150,1,00357,India
667430,2023-02-28,1012,Body Lotion,200,400,200,2,00357,India
581942,2023-02-28,1012,Body Lotion,200,400,200,2,00358,India
581942,2023-02-28,1004,Eyeliner,100,200,100,1,00358,India
381297,2023-02-28,1002,Mascara,200,400,200,1,00359,India
381297,2023-02-28,1008,Makeup Remover,80,160,80,1,00359,India
937568,2023-02-28,1012,Body Lotion,200,400,200,2,00360,India
937568,2023-02-28,1001,Lipstick,150,300,150,1,00360,India
895896,2023-02-28,1003,Foundation,300,600,300,1,00361,India
895896,2023-02-28,1007,Eyeshadow,200,400,200,1,00361,India
895896,2023-02-28,1004,Eyeliner,100,200,100,1,00361,India
640941,2023-02-28,1002,Mascara,200,400,200,1,00362,India
640941,2023-02-28,1006,Blush,150,300,150,1,00362,India
640941,2023-02-28,1003,Foundation,300,600,300,1,00362,India
640941,2023-02-28,1009,Moisturizer,250,500,250,2,00362,India
591601,2023-02-28,1002,Mascara,200,400,200,1,00363,India
591601,2023-02-28,1007,Eyeshadow,200,400,200,1,00363,India
591601,2023-02-28,1001,Lipstick,150,300,150,1,00363,India
591601,2023-02-28,1004,Eyeliner,100,200,100,1,00363,India
333656,2023-02-28,1012,Body Lotion,200,400,200,2,00364,India
333656,2023-02-28,1004,Eyeliner,100,200,100,1,00364,India
333656,2023-02-28,1005,Nail Polish,50,100,50,1,00364,India
246269,2023-02-28,1007,Eyeshadow,200,400,200,1,00365,India
246269,2023-02-28,1012,Body Lotion,200,400,200,2,00365,India
239359,2023-02-28,1012,Body Lotion,200,400,200,2,00366,India
239359,2023-02-28,1009,Moisturizer,250,500,250,2,00366,India
239359,2023-02-28,1008,Makeup Remover,80,160,80,1,00366,India
303736,2023-02-28,1007,Eyeshadow,200,400,200,1,00367,India
303736,2023-02-28,1003,Foundation,300,600,300,1,00367,India
268004,2023-02-28,1002,Mascara,200,400,200,1,00368,India
268004,2023-02-28,1009,Moisturizer,250,500,250,2,00368,India
268004,2023-02-28,1007,Eyeshadow,200,400,200,1,00368,India
268004,2023-02-28,1008,Makeup Remover,80,160,80,1,00368,India
711230,2023-02-28,1005,Nail Polish,50,100,50,1,00369,India
711230,2023-02-28,1007,Eyeshadow,200,400,200,1,00369,India
711230,2023-02-28,1003,Foundation,300,600,300,1,00369,India
711230,2023-02-28,1004,Eyeliner,100,200,100,1,00369,India
390504,2023-02-28,1005,Nail Polish,50,100,50,1,00370,India
390504,2023-02-28,1012,Body Lotion,200,400,200,2,00370,India
390504,2023-02-28,1009,Moisturizer,250,500,250,2,00370,India
571996,2023-02-28,1009,Moisturizer,250,500,250,2,00371,India
571996,2023-02-28,1004,Eyeliner,100,200,100,1,00371,India
571996,2023-02-28,1006,Blush,150,300,150,1,00371,India
571996,2023-02-28,1001,Lipstick,150,300,150,1,00371,India
571996,2023-02-28,1003,Foundation,300,600,300,1,00371,India
645697,2023-02-28,1004,Eyeliner,100,200,100,1,00372,India
645697,2023-02-28,1001,Lipstick,150,300,150,1,00372,India
645697,2023-02-28,1002,Mascara,200,400,200,1,00372,India
691191,2023-02-28,1001,Lipstick,150,300,150,1,00373,India
691191,2023-02-28,1006,Blush,150,300,150,1,00373,India
691191,2023-02-28,1007,Eyeshadow,200,400,200,1,00373,India
690345,2023-02-28,1003,Foundation,300,600,300,1,00374,India
258856,2023-02-28,1009,Moisturizer,250,500,250,2,00375,India
333080,2023-02-28,1012,Body Lotion,200,400,200,2,00376,India
333080,2023-02-28,1008,Makeup Remover,80,160,80,1,00376,India
464399,2023-02-28,1012,Body Lotion,200,400,200,2,00377,India
464399,2023-02-28,1004,Eyeliner,100,200,100,1,00377,India
464399,2023-02-28,1002,Mascara,200,400,200,1,00377,India
464399,2023-02-28,1005,Nail Polish,50,100,50,1,00377,India
241462,2023-02-28,1005,Nail Polish,50,100,50,1,00378,India
241462,2023-02-28,1001,Lipstick,150,300,150,1,00378,India
299703,2023-03-01,1006,Blush,150,300,150,1,00379,India
211221,2023-03-01,1001,Lipstick,150,300,150,1,00380,India
211221,2023-03-01,1003,Foundation,300,600,300,1,00380,India
612756,2023-03-01,1001,Lipstick,150,300,150,1,00381,India
612756,2023-03-01,1005,Nail Polish,50,100,50,1,00381,India
612756,2023-03-01,1009,Moisturizer,250,500,250,1,00381,India
612756,2023-03-01,1007,Eyeshadow,200,400,200,1,00381,India
878029,2023-03-01,1009,Moisturizer,250,500,250,1,00382,India
878029,2023-03-01,1003,Foundation,300,600,300,1,00382,India
878029,2023-03-01,1006,Blush,150,300,150,1,00382,India
878029,2023-03-01,1008,Makeup Remover,80,160,80,1,00382,India
878029,2023-03-01,1002,Mascara,200,400,200,1,00382,India
433126,2023-03-01,1004,Eyeliner,100,200,100,1,00383,India
433126,2023-03-01,1005,Nail Polish,50,100,50,1,00383,India
433126,2023-03-01,1009,Moisturizer,250,500,250,1,00383,India
547002,2023-03-01,1008,Makeup Remover,80,160,80,1,00384,India
547002,2023-03-01,1009,Moisturizer,250,500,250,1,00384,India
547002,2023-03-01,1007,Eyeshadow,200,400,200,1,00384,India
554920,2023-03-01,1005,Nail Polish,50,100,50,1,00385,India
554920,2023-03-01,1001,Lipstick,150,300,150,1,00385,India
532995,2023-03-01,1003,Foundation,300,600,300,1,00386,India
532995,2023-03-01,1012,Body Lotion,200,400,200,1,00386,India
532995,2023-03-01,1007,Eyeshadow,200,400,200,1,00386,India
532995,2023-03-01,1004,Eyeliner,100,200,100,1,00386,India
484227,2023-03-01,1005,Nail Polish,50,100,50,1,00387,India
484227,2023-03-01,1007,Eyeshadow,200,400,200,1,00387,India
131611,2023-03-01,1002,Mascara,200,400,200,1,00388,India
515828,2023-03-01,1009,Moisturizer,250,500,250,1,00389,India
515828,2023-03-01,1007,Eyeshadow,200,400,200,1,00389,India
515828,2023-03-01,1012,Body Lotion,200,400,200,1,00389,India
515828,2023-03-01,1002,Mascara,200,400,200,1,00389,India
620114,2023-03-01,1009,Moisturizer,250,500,250,1,00390,India
620114,2023-03-01,1006,Blush,150,300,150,1,00390,India
620114,2023-03-01,1002,Mascara,200,400,200,1,00390,India
646779,2023-03-01,1005,Nail Polish,50,100,50,1,00391,India
646779,2023-03-01,1006,Blush,150,300,150,1,00391,India
646779,2023-03-01,1001,Lipstick,150,300,150,1,00391,India
491835,2023-03-01,1006,Blush,150,300,150,1,00392,India
491835,2023-03-01,1004,Eyeliner,100,200,100,1,00392,India
274358,2023-03-01,1001,Lipstick,150,300,150,1,00393,India
274358,2023-03-01,1006,Blush,150,300,150,1,00393,India
205022,2023-03-01,1006,Blush,150,300,150,1,00394,India
205022,2023-03-01,1012,Body Lotion,200,400,200,1,00394,India
205022,2023-03-01,1001,Lipstick,150,300,150,1,00394,India
575578,2023-03-01,1009,Moisturizer,250,500,250,1,00395,India
575578,2023-03-01,1002,Mascara,200,400,200,1,00395,India
575578,2023-03-01,1004,Eyeliner,100,200,100,1,00395,India
504202,2023-03-01,1006,Blush,150,300,150,1,00396,India
504202,2023-03-01,1001,Lipstick,150,300,150,1,00396,India
183216,2023-03-01,1009,Moisturizer,250,500,250,1,00397,India
183216,2023-03-01,1001,Lipstick,150,300,150,1,00397,India
183216,2023-03-01,1002,Mascara,200,400,200,1,00397,India
682844,2023-03-01,1006,Blush,150,300,150,1,00398,India
682844,2023-03-01,1004,Eyeliner,100,200,100,1,00398,India
305306,2023-03-01,1008,Makeup Remover,80,160,80,1,00399,India
305306,2023-03-01,1006,Blush,150,300,150,1,00399,India
305306,2023-03-01,1007,Eyeshadow,200,400,200,1,00399,India
705322,2023-03-01,1003,Foundation,300,600,300,1,00400,India
705322,2023-03-01,1007,Eyeshadow,200,400,200,1,00400,India
274622,2023-03-01,1009,Moisturizer,250,500,250,1,00401,India
274622,2023-03-01,1005,Nail Polish,50,100,50,1,00401,India
274622,2023-03-01,1006,Blush,150,300,150,1,00401,India
313587,2023-03-01,1006,Blush,150,300,150,1,00402,India
313587,2023-03-01,1012,Body Lotion,200,400,200,1,00402,India
313587,2023-03-01,1001,Lipstick,150,300,150,1,00402,India
253770,2023-03-01,1003,Foundation,300,600,300,1,00403,India
253770,2023-03-01,1004,Eyeliner,100,200,100,1,00403,India
381906,2023-03-01,1002,Mascara,200,400,200,1,00404,India
381906,2023-03-01,1007,Eyeshadow,200,400,200,1,00404,India
381906,2023-03-01,1003,Foundation,300,600,300,1,00404,India
381906,2023-03-01,1009,Moisturizer,250,500,250,1,00404,India
701283,2023-03-01,1009,Moisturizer,250,500,250,1,00405,India
701283,2023-03-01,1012,Body Lotion,200,400,200,1,00405,India
701283,2023-03-01,1008,Makeup Remover,80,160,80,1,00405,India
701283,2023-03-01,1001,Lipstick,150,300,150,1,00405,India
154886,2023-03-01,1009,Moisturizer,250,500,250,1,00406,India
154886,2023-03-01,1007,Eyeshadow,200,400,200,1,00406,India
154886,2023-03-01,1008,Makeup Remover,80,160,80,1,00406,India
147045,2023-03-01,1003,Foundation,300,600,300,1,00407,India
147045,2023-03-01,1002,Mascara,200,400,200,1,00407,India
956616,2023-03-01,1003,Foundation,300,600,300,1,00408,India
956616,2023-03-01,1004,Eyeliner,100,200,100,1,00408,India
956616,2023-03-01,1006,Blush,150,300,150,1,00408,India
235107,2023-03-01,1001,Lipstick,150,300,150,1,00409,India
235107,2023-03-01,1007,Eyeshadow,200,400,200,1,00409,India
659987,2023-03-01,1003,Foundation,300,600,300,1,00410,India
781337,2023-03-01,1009,Moisturizer,250,500,250,1,00411,India
781337,2023-03-01,1004,Eyeliner,100,200,100,1,00411,India
781337,2023-03-01,1002,Mascara,200,400,200,1,00411,India
454951,2023-03-01,1006,Blush,150,300,150,1,00412,India
454951,2023-03-01,1004,Eyeliner,100,200,100,1,00412,India
969552,2023-03-01,1012,Body Lotion,200,400,200,1,00413,India
690299,2023-03-01,1005,Nail Polish,50,100,50,1,00414,India
690299,2023-03-01,1006,Blush,150,300,150,1,00414,India
690299,2023-03-01,1004,Eyeliner,100,200,100,1,00414,India
690299,2023-03-01,1007,Eyeshadow,200,400,200,1,00414,India
690299,2023-03-01,1002,Mascara,200,400,200,1,00414,India
656583,2023-03-01,1012,Body Lotion,200,400,200,1,00415,India
656583,2023-03-01,1004,Eyeliner,100,200,100,1,00415,India
656583,2023-03-01,1003,Foundation,300,600,300,1,00415,India
656583,2023-03-01,1009,Moisturizer,250,500,250,1,00415,India
621276,2023-03-01,1006,Blush,150,300,150,1,00416,India
621276,2023-03-01,1008,Makeup Remover,80,160,80,1,00416,India
156360,2023-03-01,1007,Eyeshadow,200,400,200,1,00417,India
156360,2023-03-01,1005,Nail Polish,50,100,50,1,00417,India
736689,2023-03-01,1007,Eyeshadow,200,400,200,1,00418,India
736689,2023-03-01,1002,Mascara,200,400,200,1,00418,India
890174,2023-03-01,1007,Eyeshadow,200,400,200,1,00419,India
890174,2023-03-01,1005,Nail Polish,50,100,50,1,00419,India
600420,2023-03-01,1005,Nail Polish,50,100,50,1,00420,India
600420,2023-03-01,1007,Eyeshadow,200,400,200,1,00420,India
600420,2023-03-01,1006,Blush,150,300,150,1,00420,India
600420,2023-03-01,1009,Moisturizer,250,500,250,1,00420,India
233331,2023-03-01,1001,Lipstick,150,300,150,1,00421,India
233331,2023-03-01,1007,Eyeshadow,200,400,200,1,00421,India
233331,2023-03-01,1006,Blush,150,300,150,1,00421,India
506669,2023-03-01,1004,Eyeliner,100,200,100,1,00422,India
506669,2023-03-01,1005,Nail Polish,50,100,50,1,00422,India
506669,2023-03-01,1007,Eyeshadow,200,400,200,1,00422,India
361220,2023-03-01,1001,Lipstick,150,300,150,1,00423,India
700444,2023-03-01,1003,Foundation,300,600,300,1,00424,India
700444,2023-03-01,1002,Mascara,200,400,200,1,00424,India
700444,2023-03-01,1008,Makeup Remover,80,160,80,1,00424,India
854992,2023-03-01,1003,Foundation,300,600,300,1,00425,India
807135,2023-03-01,1001,Lipstick,150,300,150,1,00426,India
807135,2023-03-01,1002,Mascara,200,400,200,1,00426,India
807135,2023-03-01,1008,Makeup Remover,80,160,80,1,00426,India
771097,2023-03-01,1007,Eyeshadow,200,400,200,1,00427,India
771097,2023-03-01,1001,Lipstick,150,300,150,1,00427,India
771097,2023-03-01,1009,Moisturizer,250,500,250,1,00427,India
880371,2023-03-01,1005,Nail Polish,50,100,50,1,00428,India
166693,2023-03-02,1012,Body Lotion,200,400,200,1,00429,India
166693,2023-03-02,1004,Eyeliner,100,200,100,1,00429,India
994345,2023-03-02,1004,Eyeliner,100,200,100,1,00430,India
994345,2023-03-02,1009,Moisturizer,250,500,250,1,00430,India
994345,2023-03-02,1007,Eyeshadow,200,400,200,1,00430,India
464060,2023-03-02,1012,Body Lotion,200,400,200,1,00431,India
464060,2023-03-02,1001,Lipstick,150,300,150,1,00431,India
464060,2023-03-02,1009,Moisturizer,250,500,250,1,00431,India
464060,2023-03-02,1007,Eyeshadow,200,400,200,1,00431,India
464060,2023-03-02,1005,Nail Polish,50,100,50,1,00431,India
144304,2023-03-02,1005,Nail Polish,50,100,50,1,00432,India
144304,2023-03-02,1004,Eyeliner,100,200,100,1,00432,India
144304,2023-03-02,1001,Lipstick,150,300,150,1,00432,India
216128,2023-03-02,1006,Blush,150,300,150,1,00433,India
216128,2023-03-02,1005,Nail Polish,50,100,50,1,00433,India
216128,2023-03-02,1003,Foundation,300,600,300,1,00433,India
863967,2023-03-02,1006,Blush,150,300,150,1,00434,India
863967,2023-03-02,1005,Nail Polish,50,100,50,1,00434,India
441521,2023-03-02,1006,Blush,150,300,150,1,00435,India
441521,2023-03-02,1007,Eyeshadow,200,400,200,1,00435,India
441521,2023-03-02,1009,Moisturizer,250,500,250,1,00435,India
441521,2023-03-02,1004,Eyeliner,100,200,100,1,00435,India
411311,2023-03-02,1002,Mascara,200,400,200,1,00436,India
411311,2023-03-02,1009,Moisturizer,250,500,250,1,00436,India
411311,2023-03-02,1005,Nail Polish,50,100,50,1,00436,India
411311,2023-03-02,1004,Eyeliner,100,200,100,1,00436,India
411311,2023-03-02,1007,Eyeshadow,200,400,200,1,00436,India
736360,2023-03-02,1006,Blush,150,300,150,1,00437,India
736360,2023-03-02,1004,Eyeliner,100,200,100,1,00437,India
736360,2023-03-02,1008,Makeup Remover,80,160,80,1,00437,India
736360,2023-03-02,1003,Foundation,300,600,300,1,00437,India
332867,2023-03-02,1004,Eyeliner,100,200,100,1,00438,India
388876,2023-03-02,1007,Eyeshadow,200,400,200,1,00439,India
331906,2023-03-02,1001,Lipstick,150,300,150,1,00440,India
331906,2023-03-02,1002,Mascara,200,400,200,1,00440,India
331906,2023-03-02,1012,Body Lotion,200,400,200,1,00440,India
146045,2023-03-02,1004,Eyeliner,100,200,100,1,00441,India
794484,2023-03-02,1001,Lipstick,150,300,150,1,00442,India
794484,2023-03-02,1002,Mascara,200,400,200,1,00442,India
794484,2023-03-02,1003,Foundation,300,600,300,1,00442,India
794484,2023-03-02,1007,Eyeshadow,200,400,200,1,00442,India
794484,2023-03-02,1006,Blush,150,300,150,1,00442,India
736367,2023-03-02,1004,Eyeliner,100,200,100,1,00443,India
736367,2023-03-02,1009,Moisturizer,250,500,250,1,00443,India
736367,2023-03-02,1008,Makeup Remover,80,160,80,1,00443,India
828959,2023-03-02,1003,Foundation,300,600,300,1,00444,India
727296,2023-03-02,1002,Mascara,200,400,200,1,00445,India
727296,2023-03-02,1001,Lipstick,150,300,150,1,00445,India
727296,2023-03-02,1004,Eyeliner,100,200,100,1,00445,India
727296,2023-03-02,1008,Makeup Remover,80,160,80,1,00445,India
165743,2023-03-02,1006,Blush,150,300,150,1,00446,India
955798,2023-03-02,1003,Foundation,300,600,300,1,00447,India
955798,2023-03-02,1004,Eyeliner,100,200,100,1,00447,India
864099,2023-03-02,1009,Moisturizer,250,500,250,1,00448,India
532525,2023-03-02,1002,Mascara,200,400,200,1,00449,India
442959,2023-03-02,1004,Eyeliner,100,200,100,1,00450,India
442959,2023-03-02,1012,Body Lotion,200,400,200,1,00450,India
442959,2023-03-02,1003,Foundation,300,600,300,1,00450,India
442959,2023-03-02,1006,Blush,150,300,150,1,00450,India
386998,2023-03-02,1004,Eyeliner,100,200,100,1,00451,India
221905,2023-03-02,1008,Makeup Remover,80,160,80,1,00452,India
221905,2023-03-02,1007,Eyeshadow,200,400,200,1,00452,India
223513,2023-03-02,1002,Mascara,200,400,200,1,00453,India
223513,2023-03-02,1005,Nail Polish,50,100,50,1,00453,India
223513,2023-03-02,1006,Blush,150,300,150,1,00453,India
784913,2023-03-02,1009,Moisturizer,250,500,250,1,00454,India
784913,2023-03-02,1001,Lipstick,150,300,150,1,00454,India
784913,2023-03-02,1005,Nail Polish,50,100,50,1,00454,India
784913,2023-03-02,1012,Body Lotion,200,400,200,1,00454,India
672363,2023-03-02,1008,Makeup Remover,80,160,80,1,00455,India
207453,2023-03-02,1008,Makeup Remover,80,160,80,1,00456,India
207453,2023-03-02,1006,Blush,150,300,150,1,00456,India
992818,2023-03-02,1007,Eyeshadow,200,400,200,1,00457,India
992818,2023-03-02,1001,Lipstick,150,300,150,1,00457,India
992818,2023-03-02,1006,Blush,150,300,150,1,00457,India
992818,2023-03-02,1005,Nail Polish,50,100,50,1,00457,India
992818,2023-03-02,1008,Makeup Remover,80,160,80,1,00457,India
452643,2023-03-02,1006,Blush,150,300,150,1,00458,India
452643,2023-03-02,1005,Nail Polish,50,100,50,1,00458,India
452643,2023-03-02,1007,Eyeshadow,200,400,200,1,00458,India
452643,2023-03-02,1004,Eyeliner,100,200,100,1,00458,India
393311,2023-03-02,1007,Eyeshadow,200,400,200,1,00459,India
393311,2023-03-02,1001,Lipstick,150,300,150,1,00459,India
393311,2023-03-02,1005,Nail Polish,50,100,50,1,00459,India
393311,2023-03-02,1006,Blush,150,300,150,1,00459,India
727234,2023-03-02,1009,Moisturizer,250,500,250,1,00460,India
727234,2023-03-02,1006,Blush,150,300,150,1,00460,India
727234,2023-03-02,1002,Mascara,200,400,200,1,00460,India
727234,2023-03-02,1003,Foundation,300,600,300,1,00460,India
721647,2023-03-02,1006,Blush,150,300,150,1,00461,India
957814,2023-03-02,1003,Foundation,300,600,300,1,00462,India
957814,2023-03-02,1005,Nail Polish,50,100,50,1,00462,India
795132,2023-03-02,1008,Makeup Remover,80,160,80,1,00463,India
795132,2023-03-02,1001,Lipstick,150,300,150,1,00463,India
255316,2023-03-02,1009,Moisturizer,250,500,250,1,00464,India
766418,2023-03-02,1009,Moisturizer,250,500,250,1,00465,India
192121,2023-03-02,1008,Makeup Remover,80,160,80,1,00466,India
192121,2023-03-02,1007,Eyeshadow,200,400,200,1,00466,India
192121,2023-03-02,1009,Moisturizer,250,500,250,1,00466,India
345959,2023-03-02,1003,Foundation,300,600,300,1,00467,India
345959,2023-03-02,1001,Lipstick,150,300,150,1,00467,India
912611,2023-03-02,1008,Makeup Remover,80,160,80,1,00468,India
912611,2023-03-02,1006,Blush,150,300,150,1,00468,India
594418,2023-03-02,1012,Body Lotion,200,400,200,1,00469,India
818154,2023-03-02,1006,Blush,150,300,150,1,00470,India
818154,2023-03-02,1005,Nail Polish,50,100,50,1,00470,India
818154,2023-03-02,1002,Mascara,200,400,200,1,00470,India
386938,2023-03-02,1012,Body Lotion,200,400,200,1,00471,India
386938,2023-03-02,1004,Eyeliner,100,200,100,1,00471,India
944491,2023-03-02,1005,Nail Polish,50,100,50,1,00472,India
944491,2023-03-02,1007,Eyeshadow,200,400,200,1,00472,India
944491,2023-03-02,1001,Lipstick,150,300,150,1,00472,India
366332,2023-03-02,1006,Blush,150,300,150,1,00473,India
366332,2023-03-02,1007,Eyeshadow,200,400,200,1,00473,India
366332,2023-03-02,1012,Body Lotion,200,400,200,1,00473,India
366332,2023-03-02,1002,Mascara,200,400,200,1,00473,India
378867,2023-03-02,1012,Body Lotion,200,400,200,1,00474,India
378867,2023-03-02,1009,Moisturizer,250,500,250,1,00474,India
782316,2023-03-02,1001,Lipstick,150,300,150,1,00475,India
782316,2023-03-02,1008,Makeup Remover,80,160,80,1,00475,India
782316,2023-03-02,1012,Body Lotion,200,400,200,1,00475,India
782316,2023-03-02,1007,Eyeshadow,200,400,200,1,00475,India
554063,2023-03-03,1001,Lipstick,150,300,150,1,00476,India
554063,2023-03-03,1006,Blush,150,300,150,1,00476,India
554063,2023-03-03,1003,Foundation,300,600,300,1,00476,India
838595,2023-03-03,1002,Mascara,200,400,200,1,00477,India
838595,2023-03-03,1007,Eyeshadow,200,400,200,1,00477,India
838595,2023-03-03,1001,Lipstick,150,300,150,1,00477,India
838595,2023-03-03,1012,Body Lotion,200,400,200,1,00477,India
492723,2023-03-03,1001,Lipstick,150,300,150,1,00478,India
492723,2023-03-03,1005,Nail Polish,50,100,50,1,00478,India
351043,2023-03-03,1003,Foundation,300,600,300,1,00479,India
351043,2023-03-03,1012,Body Lotion,200,400,200,1,00479,India
851312,2023-03-03,1003,Foundation,300,600,300,1,00480,India
851312,2023-03-03,1012,Body Lotion,200,400,200,1,00480,India
611146,2023-03-03,1004,Eyeliner,100,200,100,1,00481,India
611146,2023-03-03,1012,Body Lotion,200,400,200,1,00481,India
611146,2023-03-03,1001,Lipstick,150,300,150,1,00481,India
637378,2023-03-03,1004,Eyeliner,100,200,100,1,00482,India
637378,2023-03-03,1009,Moisturizer,250,500,250,1,00482,India
149665,2023-03-03,1012,Body Lotion,200,400,200,1,00483,India
149665,2023-03-03,1001,Lipstick,150,300,150,1,00483,India
847226,2023-03-03,1009,Moisturizer,250,500,250,1,00484,India
847226,2023-03-03,1012,Body Lotion,200,400,200,1,00484,India
847226,2023-03-03,1005,Nail Polish,50,100,50,1,00484,India
847226,2023-03-03,1004,Eyeliner,100,200,100,1,00484,India
669172,2023-03-03,1001,Lipstick,150,300,150,1,00485,India
892420,2023-03-03,1002,Mascara,200,400,200,1,00486,India
892420,2023-03-03,1003,Foundation,300,600,300,1,00486,India
892420,2023-03-03,1006,Blush,150,300,150,1,00486,India
892420,2023-03-03,1005,Nail Polish,50,100,50,1,00486,India
578724,2023-03-03,1005,Nail Polish,50,100,50,1,00487,India
578724,2023-03-03,1001,Lipstick,150,300,150,1,00487,India
578724,2023-03-03,1004,Eyeliner,100,200,100,1,00487,India
578724,2023-03-03,1006,Blush,150,300,150,1,00487,India
117846,2023-03-03,1001,Lipstick,150,300,150,1,00488,India
124062,2023-03-03,1005,Nail Polish,50,100,50,1,00489,India
238949,2023-03-03,1007,Eyeshadow,200,400,200,1,00490,India
238949,2023-03-03,1003,Foundation,300,600,300,1,00490,India
429745,2023-03-03,1003,Foundation,300,600,300,1,00491,India
429745,2023-03-03,1005,Nail Polish,50,100,50,1,00491,India
429745,2023-03-03,1001,Lipstick,150,300,150,1,00491,India
429745,2023-03-03,1004,Eyeliner,100,200,100,1,00491,India
287422,2023-03-03,1003,Foundation,300,600,300,1,00492,India
287422,2023-03-03,1001,Lipstick,150,300,150,1,00492,India
287422,2023-03-03,1008,Makeup Remover,80,160,80,1,00492,India
287422,2023-03-03,1009,Moisturizer,250,500,250,1,00492,India
500115,2023-03-03,1009,Moisturizer,250,500,250,1,00493,India
500115,2023-03-03,1012,Body Lotion,200,400,200,1,00493,India
500115,2023-03-03,1002,Mascara,200,400,200,1,00493,India
500115,2023-03-03,1008,Makeup Remover,80,160,80,1,00493,India
976199,2023-03-03,1005,Nail Polish,50,100,50,1,00494,India
976199,2023-03-03,1004,Eyeliner,100,200,100,1,00494,India
284874,2023-03-03,1009,Moisturizer,250,500,250,1,00495,India
269476,2023-03-03,1002,Mascara,200,400,200,1,00496,India
269476,2023-03-03,1006,Blush,150,300,150,1,00496,India
269476,2023-03-03,1001,Lipstick,150,300,150,1,00496,India
409488,2023-03-03,1012,Body Lotion,200,400,200,1,00497,India
409488,2023-03-03,1007,Eyeshadow,200,400,200,1,00497,India
409488,2023-03-03,1003,Foundation,300,600,300,1,00497,India
940031,2023-03-03,1003,Foundation,300,600,300,1,00498,India
297285,2023-03-03,1002,Mascara,200,400,200,1,00499,India
297285,2023-03-03,1008,Makeup Remover,80,160,80,1,00499,India
723925,2023-03-03,1002,Mascara,200,400,200,1,00500,India
764849,2023-03-03,1001,Lipstick,150,300,150,1,00352,India
764849,2023-03-03,1004,Eyeliner,100,200,100,1,00352,India
764849,2023-03-03,1002,Mascara,200,400,200,1,00352,India
999125,2023-03-03,1005,Nail Polish,50,100,50,1,00311,India
999125,2023-03-03,1001,Lipstick,150,300,150,1,00311,India
999125,2023-03-03,1004,Eyeliner,100,200,100,1,00311,India
317995,2023-03-03,1006,Blush,150,300,150,1,00468,India
317995,2023-03-03,1005,Nail Polish,50,100,50,1,00468,India
317995,2023-03-03,1008,Makeup Remover,80,160,80,1,00468,India
105204,2023-03-03,1007,Eyeshadow,200,400,200,1,00252,India
153944,2023-03-03,1008,Makeup Remover,80,160,80,1,00470,India
364391,2023-03-03,1005,Nail Polish,50,100,50,1,00088,India
364391,2023-03-03,1007,Eyeshadow,200,400,200,1,00088,India
364391,2023-03-03,1006,Blush,150,300,150,1,00088,India
861548,2023-03-03,1006,Blush,150,300,150,1,00030,India
861548,2023-03-03,1003,Foundation,300,600,300,1,00030,India
861548,2023-03-03,1008,Makeup Remover,80,160,80,1,00030,India
436303,2023-03-03,1007,Eyeshadow,200,400,200,1,00169,India
850333,2023-03-03,1012,Body Lotion,200,400,200,1,00030,India
850333,2023-03-03,1006,Blush,150,300,150,1,00030,India
273891,2023-03-03,1005,Nail Polish,50,100,50,1,00199,India
273891,2023-03-03,1007,Eyeshadow,200,400,200,1,00199,India
668845,2023-03-03,1007,Eyeshadow,200,400,200,1,00058,India
668845,2023-03-03,1006,Blush,150,300,150,1,00058,India
162539,2023-03-03,1001,Lipstick,150,300,150,1,00355,India
162539,2023-03-03,1009,Moisturizer,250,500,250,1,00355,India
162539,2023-03-03,1005,Nail Polish,50,100,50,1,00355,India
445734,2023-03-03,1008,Makeup Remover,80,160,80,1,00120,India
591808,2023-03-03,1009,Moisturizer,250,500,250,1,00471,India
591808,2023-03-03,1004,Eyeliner,100,200,100,1,00471,India
591808,2023-03-03,1005,Nail Polish,50,100,50,1,00471,India
724100,2023-03-03,1012,Body Lotion,200,400,200,1,00468,India
724100,2023-03-03,1005,Nail Polish,50,100,50,1,00468,India
724100,2023-03-03,1007,Eyeshadow,200,400,200,1,00468,India
325573,2023-03-03,1006,Blush,150,300,150,1,00021,India
873646,2023-03-03,1007,Eyeshadow,200,400,200,1,00415,India
873646,2023-03-03,1003,Foundation,300,600,300,1,00415,India
344506,2023-03-04,1001,Lipstick,150,300,150,1,00124,India
344506,2023-03-04,1003,Foundation,300,600,300,1,00124,India
344506,2023-03-04,1006,Blush,150,300,150,1,00124,India
344506,2023-03-04,1009,Moisturizer,250,500,250,1,00124,India
496286,2023-03-04,1009,Moisturizer,250,500,250,1,00296,India
496286,2023-03-04,1005,Nail Polish,50,100,50,1,00296,India
387087,2023-03-04,1007,Eyeshadow,200,400,200,1,00172,India
178632,2023-03-04,1003,Foundation,300,600,300,1,00429,India
178632,2023-03-04,1005,Nail Polish,50,100,50,1,00429,India
126334,2023-03-04,1001,Lipstick,150,300,150,1,00403,India
126334,2023-03-04,1005,Nail Polish,50,100,50,1,00403,India
815148,2023-03-04,1005,Nail Polish,50,100,50,1,00369,India
815148,2023-03-04,1002,Mascara,200,400,200,1,00369,India
926929,2023-03-04,1008,Makeup Remover,80,160,80,1,00485,India
926929,2023-03-04,1001,Lipstick,150,300,150,1,00485,India
524582,2023-03-04,1003,Foundation,300,600,300,1,00446,India
524582,2023-03-04,1001,Lipstick,150,300,150,1,00446,India
524582,2023-03-04,1009,Moisturizer,250,500,250,1,00446,India
733467,2023-03-04,1001,Lipstick,150,300,150,1,00297,India
733467,2023-03-04,1003,Foundation,300,600,300,1,00297,India
733467,2023-03-04,1008,Makeup Remover,80,160,80,1,00297,India
576247,2023-03-04,1003,Foundation,300,600,300,1,00181,India
617927,2023-03-04,1003,Foundation,300,600,300,1,00231,India
617927,2023-03-04,1005,Nail Polish,50,100,50,1,00231,India
617927,2023-03-04,1002,Mascara,200,400,200,1,00231,India
135951,2023-03-04,1006,Blush,150,300,150,1,00027,India
652316,2023-03-04,1001,Lipstick,150,300,150,1,00089,India
652316,2023-03-04,1002,Mascara,200,400,200,1,00089,India
533463,2023-03-04,1004,Eyeliner,100,200,100,1,00181,India
533463,2023-03-04,1001,Lipstick,150,300,150,1,00181,India
158436,2023-03-04,1002,Mascara,200,400,200,1,00086,India
158436,2023-03-04,1004,Eyeliner,100,200,100,1,00086,India
158436,2023-03-04,1007,Eyeshadow,200,400,200,1,00086,India
158436,2023-03-04,1005,Nail Polish,50,100,50,1,00086,India
721179,2023-03-04,1002,Mascara,200,400,200,1,00386,India
721179,2023-03-04,1004,Eyeliner,100,200,100,1,00386,India
151415,2023-03-04,1001,Lipstick,150,300,150,1,00475,India
151415,2023-03-04,1008,Makeup Remover,80,160,80,1,00475,India
606207,2023-03-04,1001,Lipstick,150,300,150,1,00319,India
116789,2023-03-04,1002,Mascara,200,400,200,1,00326,India
116789,2023-03-04,1008,Makeup Remover,80,160,80,1,00326,India
116789,2023-03-04,1012,Body Lotion,200,400,200,1,00326,India
116789,2023-03-04,1001,Lipstick,150,300,150,1,00326,India
154191,2023-03-04,1012,Body Lotion,200,400,200,1,00194,India
154191,2023-03-04,1006,Blush,150,300,150,1,00194,India
154191,2023-03-04,1009,Moisturizer,250,500,250,1,00194,India
965844,2023-03-04,1002,Mascara,200,400,200,1,00332,India
965844,2023-03-04,1005,Nail Polish,50,100,50,1,00332,India
965844,2023-03-04,1004,Eyeliner,100,200,100,1,00332,India
718581,2023-03-04,1001,Lipstick,150,300,150,1,00015,India
371094,2023-03-04,1006,Blush,150,300,150,1,00326,India
821989,2023-03-04,1007,Eyeshadow,200,400,200,1,00485,India
749252,2023-03-04,1003,Foundation,300,600,300,1,00431,India
749252,2023-03-04,1008,Makeup Remover,80,160,80,1,00431,India
749252,2023-03-04,1002,Mascara,200,400,200,1,00431,India
274271,2023-03-04,1008,Makeup Remover,80,160,80,1,00009,India
274271,2023-03-04,1003,Foundation,300,600,300,1,00009,India
274271,2023-03-04,1005,Nail Polish,50,100,50,1,00009,India
274271,2023-03-04,1001,Lipstick,150,300,150,1,00009,India
850219,2023-03-04,1003,Foundation,300,600,300,1,00344,India
850219,2023-03-04,1005,Nail Polish,50,100,50,1,00344,India
850219,2023-03-04,1001,Lipstick,150,300,150,1,00344,India
593004,2023-03-04,1001,Lipstick,150,300,150,1,00222,India
593004,2023-03-04,1007,Eyeshadow,200,400,200,1,00222,India
593004,2023-03-04,1006,Blush,150,300,150,1,00222,India
593004,2023-03-04,1004,Eyeliner,100,200,100,1,00222,India
476588,2023-03-04,1002,Mascara,200,400,200,1,00130,India
709094,2023-03-04,1005,Nail Polish,50,100,50,1,00378,India
709094,2023-03-04,1006,Blush,150,300,150,1,00378,India
391665,2023-03-04,1005,Nail Polish,50,100,50,1,00002,India
391665,2023-03-04,1004,Eyeliner,100,200,100,1,00002,India
391665,2023-03-04,1007,Eyeshadow,200,400,200,1,00002,India
391665,2023-03-04,1002,Mascara,200,400,200,1,00002,India
245286,2023-03-04,1005,Nail Polish,50,100,50,1,00481,India
245286,2023-03-04,1003,Foundation,300,600,300,1,00481,India
802318,2023-03-04,1001,Lipstick,150,300,150,1,00401,India
802318,2023-03-04,1006,Blush,150,300,150,1,00401,India
802318,2023-03-04,1007,Eyeshadow,200,400,200,1,00401,India
802318,2023-03-04,1002,Mascara,200,400,200,1,00401,India
496321,2023-03-04,1004,Eyeliner,100,200,100,1,00133,India
318804,2023-03-04,1005,Nail Polish,50,100,50,1,00433,India
318804,2023-03-04,1008,Makeup Remover,80,160,80,1,00433,India
318804,2023-03-04,1007,Eyeshadow,200,400,200,1,00433,India
916515,2023-03-04,1012,Body Lotion,200,400,200,1,00434,India
916515,2023-03-04,1004,Eyeliner,100,200,100,1,00434,India
916515,2023-03-04,1008,Makeup Remover,80,160,80,1,00434,India
645091,2023-03-04,1008,Makeup Remover,80,160,80,1,00063,India
645091,2023-03-04,1004,Eyeliner,100,200,100,1,00063,India
645091,2023-03-04,1002,Mascara,200,400,200,1,00063,India
527361,2023-03-04,1008,Makeup Remover,80,160,80,1,00250,India
784559,2023-03-04,1006,Blush,150,300,150,1,00227,India
784559,2023-03-04,1009,Moisturizer,250,500,250,1,00227,India
593647,2023-03-04,1012,Body Lotion,200,400,200,1,00478,India
593647,2023-03-04,1003,Foundation,300,600,300,1,00478,India
593647,2023-03-04,1008,Makeup Remover,80,160,80,1,00478,India
784422,2023-03-04,1005,Nail Polish,50,100,50,1,00114,India
784422,2023-03-04,1003,Foundation,300,600,300,1,00114,India
784422,2023-03-04,1002,Mascara,200,400,200,1,00114,India
784422,2023-03-04,1012,Body Lotion,200,400,200,1,00114,India
784422,2023-03-04,1009,Moisturizer,250,500,250,1,00114,India
845001,2023-03-04,1012,Body Lotion,200,400,200,1,00420,India
162507,2023-03-04,1002,Mascara,200,400,200,1,00011,India
162507,2023-03-04,1012,Body Lotion,200,400,200,1,00011,India
162507,2023-03-04,1006,Blush,150,300,150,1,00011,India
162507,2023-03-04,1007,Eyeshadow,200,400,200,1,00011,India
279370,2023-03-04,1003,Foundation,300,600,300,1,00019,India
279370,2023-03-04,1002,Mascara,200,400,200,1,00019,India
279370,2023-03-04,1001,Lipstick,150,300,150,1,00019,India
279370,2023-03-04,1004,Eyeliner,100,200,100,1,00019,India
279370,2023-03-04,1007,Eyeshadow,200,400,200,1,00019,India
664499,2023-03-04,1003,Foundation,300,600,300,1,00069,India
664499,2023-03-04,1009,Moisturizer,250,500,250,1,00069,India
664499,2023-03-04,1006,Blush,150,300,150,1,00069,India
664499,2023-03-04,1008,Makeup Remover,80,160,80,1,00069,India
824151,2023-03-04,1003,Foundation,300,600,300,1,00166,India
824151,2023-03-04,1006,Blush,150,300,150,1,00166,India
824151,2023-03-04,1012,Body Lotion,200,400,200,1,00166,India
837762,2023-03-05,1007,Eyeshadow,200,400,200,1,00222,India
361227,2023-03-05,1008,Makeup Remover,80,160,80,1,00147,India
673874,2023-03-05,1005,Nail Polish,50,100,50,1,00190,India
417464,2023-03-05,1006,Blush,150,300,150,1,00494,India
417464,2023-03-05,1004,Eyeliner,100,200,100,1,00494,India
417464,2023-03-05,1005,Nail Polish,50,100,50,1,00494,India
417464,2023-03-05,1012,Body Lotion,200,400,200,1,00494,India
960633,2023-03-05,1003,Foundation,300,600,300,1,00080,India
245731,2023-03-05,1002,Mascara,200,400,200,1,00331,India
645109,2023-03-05,1012,Body Lotion,200,400,200,1,00032,India
645109,2023-03-05,1007,Eyeshadow,200,400,200,1,00032,India
645109,2023-03-05,1006,Blush,150,300,150,1,00032,India
333224,2023-03-05,1005,Nail Polish,50,100,50,1,00107,India
333224,2023-03-05,1001,Lipstick,150,300,150,1,00107,India
333224,2023-03-05,1003,Foundation,300,600,300,1,00107,India
333224,2023-03-05,1007,Eyeshadow,200,400,200,1,00107,India
118459,2023-03-05,1012,Body Lotion,200,400,200,1,00257,India
118459,2023-03-05,1004,Eyeliner,100,200,100,1,00257,India
118459,2023-03-05,1002,Mascara,200,400,200,1,00257,India
504334,2023-03-05,1007,Eyeshadow,200,400,200,1,00313,India
868792,2023-03-05,1009,Moisturizer,250,500,250,1,00334,India
868792,2023-03-05,1001,Lipstick,150,300,150,1,00334,India
868792,2023-03-05,1005,Nail Polish,50,100,50,1,00334,India
926813,2023-03-05,1001,Lipstick,150,300,150,1,00176,India
926813,2023-03-05,1012,Body Lotion,200,400,200,1,00176,India
540241,2023-03-05,1004,Eyeliner,100,200,100,1,00199,India
395413,2023-03-05,1006,Blush,150,300,150,1,00274,India
395413,2023-03-05,1002,Mascara,200,400,200,1,00274,India
857119,2023-03-05,1002,Mascara,200,400,200,1,00495,India
857119,2023-03-05,1012,Body Lotion,200,400,200,1,00495,India
857119,2023-03-05,1008,Makeup Remover,80,160,80,1,00495,India
822496,2023-03-05,1005,Nail Polish,50,100,50,1,00077,India
822496,2023-03-05,1009,Moisturizer,250,500,250,1,00077,India
822496,2023-03-05,1004,Eyeliner,100,200,100,1,00077,India
471545,2023-03-05,1005,Nail Polish,50,100,50,1,00463,India
471545,2023-03-05,1012,Body Lotion,200,400,200,1,00463,India
215065,2023-03-05,1009,Moisturizer,250,500,250,1,00151,India
215065,2023-03-05,1012,Body Lotion,200,400,200,1,00151,India
622573,2023-03-05,1009,Moisturizer,250,500,250,1,00018,India
622573,2023-03-05,1007,Eyeshadow,200,400,200,1,00018,India
622573,2023-03-05,1001,Lipstick,150,300,150,1,00018,India
829216,2023-03-05,1002,Mascara,200,400,200,1,00153,India
829216,2023-03-05,1001,Lipstick,150,300,150,1,00153,India
376268,2023-03-05,1008,Makeup Remover,80,160,80,1,00294,India
376268,2023-03-05,1012,Body Lotion,200,400,200,1,00294,India
376268,2023-03-05,1009,Moisturizer,250,500,250,1,00294,India
691328,2023-03-05,1001,Lipstick,150,300,150,1,00324,India
691328,2023-03-05,1006,Blush,150,300,150,1,00324,India
691328,2023-03-05,1002,Mascara,200,400,200,1,00324,India
691328,2023-03-05,1003,Foundation,300,600,300,1,00324,India
691328,2023-03-05,1009,Moisturizer,250,500,250,1,00324,India
660510,2023-03-05,1004,Eyeliner,100,200,100,1,00263,India
660510,2023-03-05,1009,Moisturizer,250,500,250,1,00263,India
660510,2023-03-05,1007,Eyeshadow,200,400,200,1,00263,India
660510,2023-03-05,1002,Mascara,200,400,200,1,00263,India
787290,2023-03-05,1007,Eyeshadow,200,400,200,1,00281,India
787290,2023-03-05,1006,Blush,150,300,150,1,00281,India
787290,2023-03-05,1001,Lipstick,150,300,150,1,00281,India
787290,2023-03-05,1004,Eyeliner,100,200,100,1,00281,India
294340,2023-03-05,1003,Foundation,300,600,300,1,00415,India
294340,2023-03-05,1008,Makeup Remover,80,160,80,1,00415,India
294340,2023-03-05,1005,Nail Polish,50,100,50,1,00415,India
348667,2023-03-05,1003,Foundation,300,600,300,1,00200,India
348667,2023-03-05,1002,Mascara,200,400,200,1,00200,India
597456,2023-03-05,1006,Blush,150,300,150,1,00491,India
781165,2023-03-05,1008,Makeup Remover,80,160,80,1,00324,India
781165,2023-03-05,1009,Moisturizer,250,500,250,1,00324,India
427778,2023-03-05,1004,Eyeliner,100,200,100,1,00402,India
427778,2023-03-05,1009,Moisturizer,250,500,250,1,00402,India
427778,2023-03-05,1006,Blush,150,300,150,1,00402,India
427778,2023-03-05,1012,Body Lotion,200,400,200,1,00402,India
880874,2023-03-05,1003,Foundation,300,600,300,1,00433,India
880874,2023-03-05,1001,Lipstick,150,300,150,1,00433,India
880874,2023-03-05,1012,Body Lotion,200,400,200,1,00433,India
880874,2023-03-05,1006,Blush,150,300,150,1,00433,India
325978,2023-03-05,1002,Mascara,200,400,200,1,00342,India
325978,2023-03-05,1001,Lipstick,150,300,150,1,00342,India
325978,2023-03-05,1006,Blush,150,300,150,1,00342,India
325978,2023-03-05,1012,Body Lotion,200,400,200,1,00342,India
605191,2023-03-05,1004,Eyeliner,100,200,100,1,00199,India
605191,2023-03-05,1001,Lipstick,150,300,150,1,00199,India
605191,2023-03-05,1008,Makeup Remover,80,160,80,1,00199,India
605191,2023-03-05,1003,Foundation,300,600,300,1,00199,India
791787,2023-03-05,1007,Eyeshadow,200,400,200,1,00150,India
411035,2023-03-05,1003,Foundation,300,600,300,1,00117,India
411035,2023-03-05,1004,Eyeliner,100,200,100,1,00117,India
345848,2023-03-05,1008,Makeup Remover,80,160,80,1,00078,India
345848,2023-03-05,1002,Mascara,200,400,200,1,00078,India
234256,2023-03-05,1004,Eyeliner,100,200,100,1,00304,India
234256,2023-03-05,1002,Mascara,200,400,200,1,00304,India
626847,2023-03-05,1001,Lipstick,150,300,150,1,00408,India
626847,2023-03-05,1009,Moisturizer,250,500,250,1,00408,India
626847,2023-03-05,1003,Foundation,300,600,300,1,00408,India
626847,2023-03-05,1006,Blush,150,300,150,1,00408,India
146779,2023-03-05,1003,Foundation,300,600,300,1,00480,India
146779,2023-03-05,1002,Mascara,200,400,200,1,00480,India
146779,2023-03-05,1006,Blush,150,300,150,1,00480,India
146779,2023-03-05,1012,Body Lotion,200,400,200,1,00480,India
857358,2023-03-05,1004,Eyeliner,100,200,100,1,00041,India
857358,2023-03-05,1012,Body Lotion,200,400,200,1,00041,India
857358,2023-03-05,1009,Moisturizer,250,500,250,1,00041,India
857358,2023-03-05,1005,Nail Polish,50,100,50,1,00041,India
899692,2023-03-05,1006,Blush,150,300,150,1,00492,India
933575,2023-03-05,1002,Mascara,200,400,200,1,00237,India
933575,2023-03-05,1007,Eyeshadow,200,400,200,1,00237,India
933575,2023-03-05,1008,Makeup Remover,80,160,80,1,00237,India
818110,2023-03-05,1002,Mascara,200,400,200,1,00095,India
818110,2023-03-05,1006,Blush,150,300,150,1,00095,India
818110,2023-03-05,1012,Body Lotion,200,400,200,1,00095,India
818110,2023-03-05,1001,Lipstick,150,300,150,1,00095,India
975545,2023-03-05,1012,Body Lotion,200,400,200,1,00473,India
975545,2023-03-05,1004,Eyeliner,100,200,100,1,00473,India
975545,2023-03-05,1009,Moisturizer,250,500,250,1,00473,India
975545,2023-03-05,1005,Nail Polish,50,100,50,1,00473,India
934340,2023-03-05,1012,Body Lotion,200,400,200,1,00070,India
465497,2023-03-05,1012,Body Lotion,200,400,200,1,00044,India
779328,2023-03-06,1008,Makeup Remover,80,160,80,1,00476,India
779328,2023-03-06,1006,Blush,150,300,150,1,00476,India
779328,2023-03-06,1012,Body Lotion,200,400,200,1,00476,India
779328,2023-03-06,1009,Moisturizer,250,500,250,1,00476,India
335507,2023-03-06,1004,Eyeliner,100,200,100,1,00257,India
335507,2023-03-06,1007,Eyeshadow,200,400,200,1,00257,India
919675,2023-03-06,1004,Eyeliner,100,200,100,1,00482,India
621482,2023-03-06,1006,Blush,150,300,150,1,00037,India
621482,2023-03-06,1008,Makeup Remover,80,160,80,1,00037,India
621482,2023-03-06,1005,Nail Polish,50,100,50,1,00037,India
711976,2023-03-06,1001,Lipstick,150,300,150,1,00032,India
711976,2023-03-06,1006,Blush,150,300,150,1,00032,India
711976,2023-03-06,1002,Mascara,200,400,200,1,00032,India
565950,2023-03-06,1002,Mascara,200,400,200,1,00055,India
565950,2023-03-06,1001,Lipstick,150,300,150,1,00055,India
565950,2023-03-06,1006,Blush,150,300,150,1,00055,India
565950,2023-03-06,1007,Eyeshadow,200,400,200,1,00055,India
631586,2023-03-06,1009,Moisturizer,250,500,250,1,00400,India
631586,2023-03-06,1001,Lipstick,150,300,150,1,00400,India
631586,2023-03-06,1008,Makeup Remover,80,160,80,1,00400,India
631586,2023-03-06,1006,Blush,150,300,150,1,00400,India
433001,2023-03-06,1003,Foundation,300,600,300,1,00155,India
433001,2023-03-06,1009,Moisturizer,250,500,250,1,00155,India
163648,2023-03-06,1003,Foundation,300,600,300,1,00312,India
163648,2023-03-06,1002,Mascara,200,400,200,1,00312,India
163648,2023-03-06,1007,Eyeshadow,200,400,200,1,00312,India
830962,2023-03-06,1005,Nail Polish,50,100,50,1,00448,India
941649,2023-03-06,1003,Foundation,300,600,300,1,00092,India
941649,2023-03-06,1005,Nail Polish,50,100,50,1,00092,India
196415,2023-03-06,1006,Blush,150,300,150,1,00205,India
196415,2023-03-06,1007,Eyeshadow,200,400,200,1,00205,India
393801,2023-03-06,1005,Nail Polish,50,100,50,1,00271,India
365768,2023-03-06,1009,Moisturizer,250,500,250,1,00322,India
365768,2023-03-06,1007,Eyeshadow,200,400,200,1,00322,India
442701,2023-03-06,1007,Eyeshadow,200,400,200,1,00169,India
442701,2023-03-06,1005,Nail Polish,50,100,50,1,00169,India
629742,2023-03-06,1002,Mascara,200,400,200,1,00475,India
629742,2023-03-06,1003,Foundation,300,600,300,1,00475,India
629742,2023-03-06,1004,Eyeliner,100,200,100,1,00475,India
629742,2023-03-06,1007,Eyeshadow,200,400,200,1,00475,India
287584,2023-03-06,1007,Eyeshadow,200,400,200,1,00242,India
835291,2023-03-06,1008,Makeup Remover,80,160,80,1,00023,India
204959,2023-03-06,1007,Eyeshadow,200,400,200,1,00138,India
204959,2023-03-06,1009,Moisturizer,250,500,250,1,00138,India
449558,2023-03-06,1008,Makeup Remover,80,160,80,1,00223,India
449558,2023-03-06,1012,Body Lotion,200,400,200,1,00223,India
449558,2023-03-06,1002,Mascara,200,400,200,1,00223,India
449558,2023-03-06,1006,Blush,150,300,150,1,00223,India
219914,2023-03-06,1006,Blush,150,300,150,1,00215,India
219914,2023-03-06,1001,Lipstick,150,300,150,1,00215,India
219914,2023-03-06,1007,Eyeshadow,200,400,200,1,00215,India
219914,2023-03-06,1009,Moisturizer,250,500,250,1,00215,India
219914,2023-03-06,1008,Makeup Remover,80,160,80,1,00215,India
951898,2023-03-06,1001,Lipstick,150,300,150,1,00050,India
951898,2023-03-06,1004,Eyeliner,100,200,100,1,00050,India
215034,2023-03-06,1009,Moisturizer,250,500,250,1,00403,India
567371,2023-03-06,1005,Nail Polish,50,100,50,1,00356,India
567371,2023-03-06,1012,Body Lotion,200,400,200,1,00356,India
567371,2023-03-06,1006,Blush,150,300,150,1,00356,India
667327,2023-03-06,1001,Lipstick,150,300,150,1,00049,India
667327,2023-03-06,1012,Body Lotion,200,400,200,1,00049,India
783686,2023-03-06,1012,Body Lotion,200,400,200,1,00026,India
783686,2023-03-06,1006,Blush,150,300,150,1,00026,India
957733,2023-03-06,1009,Moisturizer,250,500,250,1,00146,India
957733,2023-03-06,1001,Lipstick,150,300,150,1,00146,India
710033,2023-03-06,1004,Eyeliner,100,200,100,1,00075,India
964895,2023-03-06,1009,Moisturizer,250,500,250,1,00450,India
964895,2023-03-06,1003,Foundation,300,600,300,1,00450,India
209386,2023-03-06,1008,Makeup Remover,80,160,80,1,00105,India
209386,2023-03-06,1006,Blush,150,300,150,1,00105,India
329043,2023-03-06,1012,Body Lotion,200,400,200,1,00018,India
329043,2023-03-06,1009,Moisturizer,250,500,250,1,00018,India
329043,2023-03-06,1004,Eyeliner,100,200,100,1,00018,India
329043,2023-03-06,1002,Mascara,200,400,200,1,00018,India
329043,2023-03-06,1007,Eyeshadow,200,400,200,1,00018,India
749080,2023-03-06,1009,Moisturizer,250,500,250,1,00293,India
813820,2023-03-06,1012,Body Lotion,200,400,200,1,00290,India
813820,2023-03-06,1007,Eyeshadow,200,400,200,1,00290,India
813820,2023-03-06,1006,Blush,150,300,150,1,00290,India
813820,2023-03-06,1001,Lipstick,150,300,150,1,00290,India
908348,2023-03-06,1005,Nail Polish,50,100,50,1,00032,India
908348,2023-03-06,1004,Eyeliner,100,200,100,1,00032,India
908348,2023-03-06,1003,Foundation,300,600,300,1,00032,India
488362,2023-03-06,1004,Eyeliner,100,200,100,1,00090,India
488362,2023-03-06,1009,Moisturizer,250,500,250,1,00090,India
107647,2023-03-06,1006,Blush,150,300,150,1,00498,India
413929,2023-03-06,1005,Nail Polish,50,100,50,1,00183,India
413929,2023-03-06,1007,Eyeshadow,200,400,200,1,00183,India
205629,2023-03-06,1009,Moisturizer,250,500,250,1,00160,India
205629,2023-03-06,1006,Blush,150,300,150,1,00160,India
306701,2023-03-06,1005,Nail Polish,50,100,50,1,00477,India
306701,2023-03-06,1007,Eyeshadow,200,400,200,1,00477,India
306701,2023-03-06,1002,Mascara,200,400,200,1,00477,India
808299,2023-03-06,1012,Body Lotion,200,400,200,1,00283,India
131071,2023-03-06,1007,Eyeshadow,200,400,200,1,00246,India
131071,2023-03-06,1002,Mascara,200,400,200,1,00246,India
341243,2023-03-06,1012,Body Lotion,200,400,200,1,00287,India
341243,2023-03-06,1008,Makeup Remover,80,160,80,1,00287,India
890737,2023-03-06,1009,Moisturizer,250,500,250,1,00406,India
153619,2023-03-06,1012,Body Lotion,200,400,200,1,00253,India
153619,2023-03-06,1008,Makeup Remover,80,160,80,1,00253,India
620410,2023-03-06,1009,Moisturizer,250,500,250,1,00380,India
620410,2023-03-06,1001,Lipstick,150,300,150,1,00380,India
150705,2023-03-06,1005,Nail Polish,50,100,50,1,00283,India
150705,2023-03-06,1004,Eyeliner,100,200,100,1,00283,India
150705,2023-03-06,1006,Blush,150,300,150,1,00283,India
446825,2023-03-06,1004,Eyeliner,100,200,100,1,00294,India
446825,2023-03-06,1006,Blush,150,300,150,1,00294,India
993748,2023-03-06,1005,Nail Polish,50,100,50,1,00431,India
993748,2023-03-06,1004,Eyeliner,100,200,100,1,00431,India
993748,2023-03-06,1012,Body Lotion,200,400,200,1,00431,India
993748,2023-03-06,1002,Mascara,200,400,200,1,00431,India
820226,2023-03-07,1005,Nail Polish,50,100,50,1,00359,India
820226,2023-03-07,1006,Blush,150,300,150,1,00359,India
820226,2023-03-07,1003,Foundation,300,600,300,1,00359,India
820226,2023-03-07,1008,Makeup Remover,80,160,80,1,00359,India
716031,2023-03-07,1003,Foundation,300,600,300,1,00305,India
716031,2023-03-07,1002,Mascara,200,400,200,1,00305,India
716031,2023-03-07,1009,Moisturizer,250,500,250,1,00305,India
716031,2023-03-07,1008,Makeup Remover,80,160,80,1,00305,India
716031,2023-03-07,1005,Nail Polish,50,100,50,1,00305,India
522629,2023-03-07,1002,Mascara,200,400,200,1,00194,India
522629,2023-03-07,1009,Moisturizer,250,500,250,1,00194,India
522629,2023-03-07,1012,Body Lotion,200,400,200,1,00194,India
422839,2023-03-07,1009,Moisturizer,250,500,250,1,00136,India
422839,2023-03-07,1004,Eyeliner,100,200,100,1,00136,India
422839,2023-03-07,1005,Nail Polish,50,100,50,1,00136,India
825401,2023-03-07,1008,Makeup Remover,80,160,80,1,00163,India
825401,2023-03-07,1004,Eyeliner,100,200,100,1,00163,India
825401,2023-03-07,1009,Moisturizer,250,500,250,1,00163,India
487175,2023-03-07,1004,Eyeliner,100,200,100,1,00293,India
487175,2023-03-07,1002,Mascara,200,400,200,1,00293,India
487175,2023-03-07,1006,Blush,150,300,150,1,00293,India
750421,2023-03-07,1007,Eyeshadow,200,400,200,1,00221,India
750421,2023-03-07,1003,Foundation,300,600,300,1,00221,India
750421,2023-03-07,1001,Lipstick,150,300,150,1,00221,India
958626,2023-03-07,1008,Makeup Remover,80,160,80,1,00325,India
958626,2023-03-07,1006,Blush,150,300,150,1,00325,India
942874,2023-03-07,1002,Mascara,200,400,200,1,00328,India
942874,2023-03-07,1004,Eyeliner,100,200,100,1,00328,India
942874,2023-03-07,1007,Eyeshadow,200,400,200,1,00328,India
942874,2023-03-07,1006,Blush,150,300,150,1,00328,India
232326,2023-03-07,1012,Body Lotion,200,400,200,1,00186,India
539064,2023-03-07,1004,Eyeliner,100,200,100,1,00297,India
539064,2023-03-07,1005,Nail Polish,50,100,50,1,00297,India
539064,2023-03-07,1002,Mascara,200,400,200,1,00297,India
539064,2023-03-07,1001,Lipstick,150,300,150,1,00297,India
649989,2023-03-07,1004,Eyeliner,100,200,100,1,00440,India
649989,2023-03-07,1008,Makeup Remover,80,160,80,1,00440,India
649989,2023-03-07,1001,Lipstick,150,300,150,1,00440,India
649989,2023-03-07,1007,Eyeshadow,200,400,200,1,00440,India
741087,2023-03-07,1005,Nail Polish,50,100,50,1,00123,India
741087,2023-03-07,1008,Makeup Remover,80,160,80,1,00123,India
741087,2023-03-07,1006,Blush,150,300,150,1,00123,India
741087,2023-03-07,1007,Eyeshadow,200,400,200,1,00123,India
951624,2023-03-07,1006,Blush,150,300,150,1,00025,India
951624,2023-03-07,1007,Eyeshadow,200,400,200,1,00025,India
951624,2023-03-07,1002,Mascara,200,400,200,1,00025,India
951624,2023-03-07,1012,Body Lotion,200,400,200,1,00025,India
951624,2023-03-07,1005,Nail Polish,50,100,50,1,00025,India
326031,2023-03-07,1003,Foundation,300,600,300,1,00154,India
326031,2023-03-07,1002,Mascara,200,400,200,1,00154,India
326031,2023-03-07,1009,Moisturizer,250,500,250,1,00154,India
904798,2023-03-07,1005,Nail Polish,50,100,50,1,00158,India
904798,2023-03-07,1001,Lipstick,150,300,150,1,00158,India
904798,2023-03-07,1002,Mascara,200,400,200,1,00158,India
904798,2023-03-07,1007,Eyeshadow,200,400,200,1,00158,India
904798,2023-03-07,1006,Blush,150,300,150,1,00158,India
756971,2023-03-07,1012,Body Lotion,200,400,200,1,00452,India
756971,2023-03-07,1005,Nail Polish,50,100,50,1,00452,India
154208,2023-03-07,1004,Eyeliner,100,200,100,1,00471,India
154208,2023-03-07,1003,Foundation,300,600,300,1,00471,India
154208,2023-03-07,1002,Mascara,200,400,200,1,00471,India
154208,2023-03-07,1001,Lipstick,150,300,150,1,00471,India
611409,2023-03-07,1009,Moisturizer,250,500,250,1,00186,India
611409,2023-03-07,1004,Eyeliner,100,200,100,1,00186,India
611409,2023-03-07,1006,Blush,150,300,150,1,00186,India
611409,2023-03-07,1008,Makeup Remover,80,160,80,1,00186,India
747025,2023-03-07,1009,Moisturizer,250,500,250,1,00037,India
483393,2023-03-07,1001,Lipstick,150,300,150,1,00479,India
483393,2023-03-07,1012,Body Lotion,200,400,200,1,00479,India
248920,2023-03-07,1007,Eyeshadow,200,400,200,1,00494,India
248920,2023-03-07,1003,Foundation,300,600,300,1,00494,India
248920,2023-03-07,1008,Makeup Remover,80,160,80,1,00494,India
673937,2023-03-07,1001,Lipstick,150,300,150,1,00322,India
454491,2023-03-07,1001,Lipstick,150,300,150,1,00481,India
454491,2023-03-07,1008,Makeup Remover,80,160,80,1,00481,India
454491,2023-03-07,1009,Moisturizer,250,500,250,1,00481,India
307848,2023-03-07,1005,Nail Polish,50,100,50,1,00282,India
639873,2023-03-07,1003,Foundation,300,600,300,1,00478,India
639873,2023-03-07,1002,Mascara,200,400,200,1,00478,India
549297,2023-03-07,1006,Blush,150,300,150,1,00140,India
549297,2023-03-07,1004,Eyeliner,100,200,100,1,00140,India
549297,2023-03-07,1005,Nail Polish,50,100,50,1,00140,India
709495,2023-03-07,1009,Moisturizer,250,500,250,1,00415,India
709495,2023-03-07,1007,Eyeshadow,200,400,200,1,00415,India
709495,2023-03-07,1003,Foundation,300,600,300,1,00415,India
709495,2023-03-07,1006,Blush,150,300,150,1,00415,India
555933,2023-03-07,1009,Moisturizer,250,500,250,1,00260,India
555933,2023-03-07,1003,Foundation,300,600,300,1,00260,India
555933,2023-03-07,1005,Nail Polish,50,100,50,1,00260,India
555933,2023-03-07,1006,Blush,150,300,150,1,00260,India
770062,2023-03-07,1012,Body Lotion,200,400,200,1,00492,India
770062,2023-03-07,1002,Mascara,200,400,200,1,00492,India
770062,2023-03-07,1003,Foundation,300,600,300,1,00492,India
263543,2023-03-07,1006,Blush,150,300,150,1,00382,India
263543,2023-03-07,1001,Lipstick,150,300,150,1,00382,India
263543,2023-03-07,1004,Eyeliner,100,200,100,1,00382,India
941921,2023-03-07,1006,Blush,150,300,150,1,00149,India
941921,2023-03-07,1003,Foundation,300,600,300,1,00149,India
948968,2023-03-07,1009,Moisturizer,250,500,250,1,00061,India
948968,2023-03-07,1002,Mascara,200,400,200,1,00061,India
948968,2023-03-07,1008,Makeup Remover,80,160,80,1,00061,India
597019,2023-03-08,1003,Foundation,300,600,300,1,00149,India
894416,2023-03-08,1012,Body Lotion,200,400,200,1,00363,India
562185,2023-03-08,1002,Mascara,200,400,200,1,00296,India
562185,2023-03-08,1003,Foundation,300,600,300,1,00296,India
579706,2023-03-08,1001,Lipstick,150,300,150,1,00268,India
579706,2023-03-08,1007,Eyeshadow,200,400,200,1,00268,India
579706,2023-03-08,1002,Mascara,200,400,200,1,00268,India
579706,2023-03-08,1012,Body Lotion,200,400,200,1,00268,India
458547,2023-03-08,1007,Eyeshadow,200,400,200,1,00005,India
458547,2023-03-08,1008,Makeup Remover,80,160,80,1,00005,India
458547,2023-03-08,1012,Body Lotion,200,400,200,1,00005,India
247024,2023-03-08,1001,Lipstick,150,300,150,1,00130,India
440944,2023-03-08,1001,Lipstick,150,300,150,1,00297,India
294108,2023-03-08,1001,Lipstick,150,300,150,1,00137,India
471882,2023-03-08,1005,Nail Polish,50,100,50,1,00376,India
471882,2023-03-08,1007,Eyeshadow,200,400,200,1,00376,India
471882,2023-03-08,1003,Foundation,300,600,300,1,00376,India
471882,2023-03-08,1001,Lipstick,150,300,150,1,00376,India
362686,2023-03-08,1012,Body Lotion,200,400,200,1,00012,India
362686,2023-03-08,1007,Eyeshadow,200,400,200,1,00012,India
673235,2023-03-08,1006,Blush,150,300,150,1,00332,India
673235,2023-03-08,1005,Nail Polish,50,100,50,1,00332,India
673235,2023-03-08,1003,Foundation,300,600,300,1,00332,India
673235,2023-03-08,1002,Mascara,200,400,200,1,00332,India
673235,2023-03-08,1012,Body Lotion,200,400,200,1,00332,India
401923,2023-03-08,1004,Eyeliner,100,200,100,1,00309,India
401923,2023-03-08,1007,Eyeshadow,200,400,200,1,00309,India
351643,2023-03-08,1007,Eyeshadow,200,400,200,1,00123,India
351643,2023-03-08,1004,Eyeliner,100,200,100,1,00123,India
358698,2023-03-08,1005,Nail Polish,50,100,50,1,00058,India
358698,2023-03-08,1003,Foundation,300,600,300,1,00058,India
761240,2023-03-08,1001,Lipstick,150,300,150,1,00205,India
283057,2023-03-08,1012,Body Lotion,200,400,200,1,00220,India
283057,2023-03-08,1001,Lipstick,150,300,150,1,00220,India
283057,2023-03-08,1008,Makeup Remover,80,160,80,1,00220,India
431052,2023-03-08,1003,Foundation,300,600,300,1,00178,India
431052,2023-03-08,1004,Eyeliner,100,200,100,1,00178,India
431052,2023-03-08,1006,Blush,150,300,150,1,00178,India
431052,2023-03-08,1012,Body Lotion,200,400,200,1,00178,India
759309,2023-03-08,1003,Foundation,300,600,300,1,00359,India
759309,2023-03-08,1007,Eyeshadow,200,400,200,1,00359,India
759309,2023-03-08,1002,Mascara,200,400,200,1,00359,India
759309,2023-03-08,1005,Nail Polish,50,100,50,1,00359,India
535599,2023-03-08,1009,Moisturizer,250,500,250,1,00413,India
535599,2023-03-08,1008,Makeup Remover,80,160,80,1,00413,India
535599,2023-03-08,1004,Eyeliner,100,200,100,1,00413,India
535599,2023-03-08,1002,Mascara,200,400,200,1,00413,India
563195,2023-03-08,1007,Eyeshadow,200,400,200,1,00218,India
563195,2023-03-08,1006,Blush,150,300,150,1,00218,India
153809,2023-03-08,1012,Body Lotion,200,400,200,1,00393,India
153809,2023-03-08,1006,Blush,150,300,150,1,00393,India
153809,2023-03-08,1005,Nail Polish,50,100,50,1,00393,India
913575,2023-03-08,1009,Moisturizer,250,500,250,1,00174,India
913575,2023-03-08,1002,Mascara,200,400,200,1,00174,India
913575,2023-03-08,1006,Blush,150,300,150,1,00174,India
913575,2023-03-08,1005,Nail Polish,50,100,50,1,00174,India
739248,2023-03-08,1003,Foundation,300,600,300,1,00079,India
594830,2023-03-08,1005,Nail Polish,50,100,50,1,00213,India
594830,2023-03-08,1006,Blush,150,300,150,1,00213,India
594830,2023-03-08,1004,Eyeliner,100,200,100,1,00213,India
578531,2023-03-08,1008,Makeup Remover,80,160,80,1,00161,India
484169,2023-03-08,1005,Nail Polish,50,100,50,1,00155,India
484169,2023-03-08,1008,Makeup Remover,80,160,80,1,00155,India
623935,2023-03-08,1007,Eyeshadow,200,400,200,1,00011,India
623935,2023-03-08,1009,Moisturizer,250,500,250,1,00011,India
419269,2023-03-08,1006,Blush,150,300,150,1,00044,India
585390,2023-03-08,1003,Foundation,300,600,300,1,00472,India
373417,2023-03-08,1002,Mascara,200,400,200,1,00360,India
373417,2023-03-08,1008,Makeup Remover,80,160,80,1,00360,India
373417,2023-03-08,1004,Eyeliner,100,200,100,1,00360,India
171862,2023-03-08,1003,Foundation,300,600,300,1,00154,India
171862,2023-03-08,1002,Mascara,200,400,200,1,00154,India
171862,2023-03-08,1007,Eyeshadow,200,400,200,1,00154,India
171862,2023-03-08,1009,Moisturizer,250,500,250,1,00154,India
404224,2023-03-08,1001,Lipstick,150,300,150,1,00127,India
404224,2023-03-08,1008,Makeup Remover,80,160,80,1,00127,India
712186,2023-03-09,1005,Nail Polish,50,100,50,1,00495,India
712186,2023-03-09,1001,Lipstick,150,300,150,1,00495,India
712186,2023-03-09,1003,Foundation,300,600,300,1,00495,India
712186,2023-03-09,1002,Mascara,200,400,200,1,00495,India
712186,2023-03-09,1008,Makeup Remover,80,160,80,1,00495,India
873250,2023-03-09,1008,Makeup Remover,80,160,80,1,00120,India
873250,2023-03-09,1009,Moisturizer,250,500,250,1,00120,India
143331,2023-03-09,1006,Blush,150,300,150,1,00306,India
143331,2023-03-09,1002,Mascara,200,400,200,1,00306,India
393463,2023-03-09,1004,Eyeliner,100,200,100,1,00201,India
393463,2023-03-09,1005,Nail Polish,50,100,50,1,00201,India
393463,2023-03-09,1003,Foundation,300,600,300,1,00201,India
362349,2023-03-09,1002,Mascara,200,400,200,1,00064,India
362349,2023-03-09,1008,Makeup Remover,80,160,80,1,00064,India
799627,2023-03-09,1012,Body Lotion,200,400,200,1,00245,India
799627,2023-03-09,1009,Moisturizer,250,500,250,1,00245,India
799627,2023-03-09,1006,Blush,150,300,150,1,00245,India
799627,2023-03-09,1003,Foundation,300,600,300,1,00245,India
452919,2023-03-09,1007,Eyeshadow,200,400,200,1,00069,India
950381,2023-03-09,1006,Blush,150,300,150,1,00255,India
950381,2023-03-09,1007,Eyeshadow,200,400,200,1,00255,India
950381,2023-03-09,1001,Lipstick,150,300,150,1,00255,India
950381,2023-03-09,1003,Foundation,300,600,300,1,00255,India
950381,2023-03-09,1005,Nail Polish,50,100,50,1,00255,India
933560,2023-03-09,1001,Lipstick,150,300,150,1,00064,India
933560,2023-03-09,1004,Eyeliner,100,200,100,1,00064,India
345065,2023-03-09,1009,Moisturizer,250,500,250,1,00353,India
345065,2023-03-09,1001,Lipstick,150,300,150,1,00353,India
207540,2023-03-09,1001,Lipstick,150,300,150,1,00093,India
207540,2023-03-09,1009,Moisturizer,250,500,250,1,00093,India
134216,2023-03-09,1009,Moisturizer,250,500,250,1,00425,India
134216,2023-03-09,1003,Foundation,300,600,300,1,00425,India
125626,2023-03-09,1005,Nail Polish,50,100,50,1,00298,India
125626,2023-03-09,1009,Moisturizer,250,500,250,1,00298,India
125626,2023-03-09,1012,Body Lotion,200,400,200,1,00298,India
667266,2023-03-09,1008,Makeup Remover,80,160,80,1,00340,India
300997,2023-03-09,1009,Moisturizer,250,500,250,1,00279,India
902755,2023-03-09,1012,Body Lotion,200,400,200,1,00319,India
515029,2023-03-09,1012,Body Lotion,200,400,200,1,00494,India
388753,2023-03-09,1005,Nail Polish,50,100,50,1,00027,India
388753,2023-03-09,1006,Blush,150,300,150,1,00027,India
388753,2023-03-09,1009,Moisturizer,250,500,250,1,00027,India
388753,2023-03-09,1012,Body Lotion,200,400,200,1,00027,India
737741,2023-03-09,1005,Nail Polish,50,100,50,1,00287,India
737741,2023-03-09,1006,Blush,150,300,150,1,00287,India
737741,2023-03-09,1008,Makeup Remover,80,160,80,1,00287,India
737741,2023-03-09,1004,Eyeliner,100,200,100,1,00287,India
828548,2023-03-09,1003,Foundation,300,600,300,1,00156,India
828548,2023-03-09,1009,Moisturizer,250,500,250,1,00156,India
694183,2023-03-09,1006,Blush,150,300,150,1,00319,India
694183,2023-03-09,1008,Makeup Remover,80,160,80,1,00319,India
694183,2023-03-09,1005,Nail Polish,50,100,50,1,00319,India
694183,2023-03-09,1001,Lipstick,150,300,150,1,00319,India
372800,2023-03-09,1006,Blush,150,300,150,1,00222,India
372800,2023-03-09,1009,Moisturizer,250,500,250,1,00222,India
372800,2023-03-09,1008,Makeup Remover,80,160,80,1,00222,India
372800,2023-03-09,1005,Nail Polish,50,100,50,1,00222,India
858753,2023-03-09,1012,Body Lotion,200,400,200,1,00422,India
858753,2023-03-09,1006,Blush,150,300,150,1,00422,India
691447,2023-03-09,1004,Eyeliner,100,200,100,1,00226,India
691447,2023-03-09,1006,Blush,150,300,150,1,00226,India
691447,2023-03-09,1003,Foundation,300,600,300,1,00226,India
420204,2023-03-09,1005,Nail Polish,50,100,50,1,00347,India
917533,2023-03-09,1008,Makeup Remover,80,160,80,1,00429,India
917533,2023-03-09,1006,Blush,150,300,150,1,00429,India
917533,2023-03-09,1005,Nail Polish,50,100,50,1,00429,India
917533,2023-03-09,1012,Body Lotion,200,400,200,1,00429,India
238341,2023-03-09,1012,Body Lotion,200,400,200,1,00462,India
215495,2023-03-09,1007,Eyeshadow,200,400,200,1,00306,India
215495,2023-03-09,1003,Foundation,300,600,300,1,00306,India
565395,2023-03-09,1003,Foundation,300,600,300,1,00283,India
565395,2023-03-09,1006,Blush,150,300,150,1,00283,India
392511,2023-03-09,1004,Eyeliner,100,200,100,1,00009,India
915694,2023-03-09,1012,Body Lotion,200,400,200,1,00023,India
915694,2023-03-09,1002,Mascara,200,400,200,1,00023,India
915694,2023-03-09,1006,Blush,150,300,150,1,00023,India
915694,2023-03-09,1003,Foundation,300,600,300,1,00023,India
431934,2023-03-09,1002,Mascara,200,400,200,1,00127,India
433111,2023-03-09,1001,Lipstick,150,300,150,1,00319,India
433111,2023-03-09,1002,Mascara,200,400,200,1,00319,India
433111,2023-03-09,1012,Body Lotion,200,400,200,1,00319,India
826628,2023-03-09,1002,Mascara,200,400,200,1,00103,India
201770,2023-03-09,1008,Makeup Remover,80,160,80,1,00371,India
797415,2023-03-09,1009,Moisturizer,250,500,250,1,00440,India
797415,2023-03-09,1006,Blush,150,300,150,1,00440,India
104122,2023-03-09,1005,Nail Polish,50,100,50,1,00130,India
216264,2023-03-09,1005,Nail Polish,50,100,50,1,00330,India
216264,2023-03-09,1009,Moisturizer,250,500,250,1,00330,India
216264,2023-03-09,1007,Eyeshadow,200,400,200,1,00330,India
216264,2023-03-09,1001,Lipstick,150,300,150,1,00330,India
216264,2023-03-09,1003,Foundation,300,600,300,1,00330,India
274737,2023-03-09,1009,Moisturizer,250,500,250,1,00447,India
533990,2023-03-09,1007,Eyeshadow,200,400,200,1,00195,India
533990,2023-03-09,1001,Lipstick,150,300,150,1,00195,India
579804,2023-03-09,1007,Eyeshadow,200,400,200,1,00260,India
579804,2023-03-09,1003,Foundation,300,600,300,1,00260,India
667734,2023-03-09,1002,Mascara,200,400,200,1,00128,India
667734,2023-03-09,1001,Lipstick,150,300,150,1,00128,India
667734,2023-03-09,1003,Foundation,300,600,300,1,00128,India
667734,2023-03-09,1004,Eyeliner,100,200,100,1,00128,India
667734,2023-03-09,1009,Moisturizer,250,500,250,1,00128,India
109946,2023-03-09,1008,Makeup Remover,80,160,80,1,00136,India
109946,2023-03-09,1009,Moisturizer,250,500,250,1,00136,India
109946,2023-03-09,1002,Mascara,200,400,200,1,00136,India
109946,2023-03-09,1004,Eyeliner,100,200,100,1,00136,India
109946,2023-03-09,1001,Lipstick,150,300,150,1,00136,India
261852,2023-03-09,1004,Eyeliner,100,200,100,1,00471,India
261852,2023-03-09,1002,Mascara,200,400,200,1,00471,India
261852,2023-03-09,1009,Moisturizer,250,500,250,1,00471,India
231155,2023-03-09,1008,Makeup Remover,80,160,80,1,00215,India
231155,2023-03-09,1001,Lipstick,150,300,150,1,00215,India
231155,2023-03-09,1009,Moisturizer,250,500,250,1,00215,India
533600,2023-03-09,1009,Moisturizer,250,500,250,1,00256,India
654212,2023-03-09,1007,Eyeshadow,200,400,200,1,00131,India
654212,2023-03-09,1006,Blush,150,300,150,1,00131,India
462839,2023-03-09,1007,Eyeshadow,200,400,200,1,00145,India
462839,2023-03-09,1009,Moisturizer,250,500,250,1,00145,India
595480,2023-03-10,1007,Eyeshadow,200,400,200,1,00106,India
595480,2023-03-10,1004,Eyeliner,100,200,100,1,00106,India
595480,2023-03-10,1005,Nail Polish,50,100,50,1,00106,India
595480,2023-03-10,1002,Mascara,200,400,200,1,00106,India
336712,2023-03-10,1008,Makeup Remover,80,160,80,1,00396,India
336712,2023-03-10,1003,Foundation,300,600,300,1,00396,India
336712,2023-03-10,1012,Body Lotion,200,400,200,1,00396,India
162873,2023-03-10,1005,Nail Polish,50,100,50,1,00024,India
162873,2023-03-10,1003,Foundation,300,600,300,1,00024,India
162873,2023-03-10,1009,Moisturizer,250,500,250,1,00024,India
306975,2023-03-10,1009,Moisturizer,250,500,250,1,00010,India
235144,2023-03-10,1006,Blush,150,300,150,1,00485,India
444501,2023-03-10,1007,Eyeshadow,200,400,200,1,00386,India
444501,2023-03-10,1002,Mascara,200,400,200,1,00386,India
153974,2023-03-10,1002,Mascara,200,400,200,1,00254,India
153974,2023-03-10,1005,Nail Polish,50,100,50,1,00254,India
153974,2023-03-10,1001,Lipstick,150,300,150,1,00254,India
153974,2023-03-10,1007,Eyeshadow,200,400,200,1,00254,India
153974,2023-03-10,1003,Foundation,300,600,300,1,00254,India
399760,2023-03-10,1009,Moisturizer,250,500,250,1,00398,India
399760,2023-03-10,1007,Eyeshadow,200,400,200,1,00398,India
399760,2023-03-10,1008,Makeup Remover,80,160,80,1,00398,India
399760,2023-03-10,1012,Body Lotion,200,400,200,1,00398,India
432917,2023-03-10,1001,Lipstick,150,300,150,1,00495,India
681204,2023-03-10,1002,Mascara,200,400,200,1,00131,India
681204,2023-03-10,1009,Moisturizer,250,500,250,1,00131,India
681204,2023-03-10,1012,Body Lotion,200,400,200,1,00131,India
681204,2023-03-10,1007,Eyeshadow,200,400,200,1,00131,India
225234,2023-03-10,1001,Lipstick,150,300,150,1,00106,India
225234,2023-03-10,1005,Nail Polish,50,100,50,1,00106,India
692608,2023-03-10,1001,Lipstick,150,300,150,1,00152,India
692608,2023-03-10,1007,Eyeshadow,200,400,200,1,00152,India
692608,2023-03-10,1009,Moisturizer,250,500,250,1,00152,India
692608,2023-03-10,1008,Makeup Remover,80,160,80,1,00152,India
692608,2023-03-10,1006,Blush,150,300,150,1,00152,India
457882,2023-03-10,1006,Blush,150,300,150,1,00483,India
457882,2023-03-10,1004,Eyeliner,100,200,100,1,00483,India
457882,2023-03-10,1009,Moisturizer,250,500,250,1,00483,India
287866,2023-03-10,1002,Mascara,200,400,200,1,00346,India
287866,2023-03-10,1001,Lipstick,150,300,150,1,00346,India
287866,2023-03-10,1005,Nail Polish,50,100,50,1,00346,India
886679,2023-03-10,1003,Foundation,300,600,300,1,00272,India
886679,2023-03-10,1004,Eyeliner,100,200,100,1,00272,India
886679,2023-03-10,1002,Mascara,200,400,200,1,00272,India
299142,2023-03-10,1005,Nail Polish,50,100,50,1,00433,India
299142,2023-03-10,1002,Mascara,200,400,200,1,00433,India
299142,2023-03-10,1003,Foundation,300,600,300,1,00433,India
299142,2023-03-10,1012,Body Lotion,200,400,200,1,00433,India
299142,2023-03-10,1004,Eyeliner,100,200,100,1,00433,India
640741,2023-03-10,1002,Mascara,200,400,200,1,00191,India
640741,2023-03-10,1001,Lipstick,150,300,150,1,00191,India
640741,2023-03-10,1004,Eyeliner,100,200,100,1,00191,India
871218,2023-03-10,1008,Makeup Remover,80,160,80,1,00435,India
871218,2023-03-10,1004,Eyeliner,100,200,100,1,00435,India
712837,2023-03-10,1008,Makeup Remover,80,160,80,1,00111,India
712837,2023-03-10,1006,Blush,150,300,150,1,00111,India
712837,2023-03-10,1005,Nail Polish,50,100,50,1,00111,India
623796,2023-03-10,1008,Makeup Remover,80,160,80,1,00186,India
623796,2023-03-10,1003,Foundation,300,600,300,1,00186,India
623796,2023-03-10,1006,Blush,150,300,150,1,00186,India
623796,2023-03-10,1001,Lipstick,150,300,150,1,00186,India
338198,2023-03-10,1009,Moisturizer,250,500,250,1,00233,India
355824,2023-03-10,1009,Moisturizer,250,500,250,1,00473,India
355824,2023-03-10,1005,Nail Polish,50,100,50,1,00473,India
355824,2023-03-10,1004,Eyeliner,100,200,100,1,00473,India
355824,2023-03-10,1002,Mascara,200,400,200,1,00473,India
355824,2023-03-10,1008,Makeup Remover,80,160,80,1,00473,India
926551,2023-03-10,1009,Moisturizer,250,500,250,1,00102,India
745536,2023-03-10,1006,Blush,150,300,150,1,00395,India
778337,2023-03-10,1006,Blush,150,300,150,1,00419,India
778337,2023-03-10,1012,Body Lotion,200,400,200,1,00419,India
778337,2023-03-10,1003,Foundation,300,600,300,1,00419,India
778337,2023-03-10,1004,Eyeliner,100,200,100,1,00419,India
801811,2023-03-10,1003,Foundation,300,600,300,1,00124,India
277161,2023-03-10,1005,Nail Polish,50,100,50,1,00251,India
277161,2023-03-10,1002,Mascara,200,400,200,1,00251,India
277161,2023-03-10,1001,Lipstick,150,300,150,1,00251,India
277161,2023-03-10,1006,Blush,150,300,150,1,00251,India
548516,2023-03-10,1003,Foundation,300,600,300,1,00237,India
548516,2023-03-10,1001,Lipstick,150,300,150,1,00237,India
340009,2023-03-10,1009,Moisturizer,250,500,250,1,00042,India
346345,2023-03-10,1007,Eyeshadow,200,400,200,1,00228,India
643137,2023-03-10,1008,Makeup Remover,80,160,80,1,00319,India
643137,2023-03-10,1006,Blush,150,300,150,1,00319,India
643137,2023-03-10,1004,Eyeliner,100,200,100,1,00319,India
643137,2023-03-10,1003,Foundation,300,600,300,1,00319,India
654658,2023-03-10,1003,Foundation,300,600,300,1,00073,India
654658,2023-03-10,1005,Nail Polish,50,100,50,1,00073,India
106845,2023-03-10,1006,Blush,150,300,150,1,00295,India
106845,2023-03-10,1001,Lipstick,150,300,150,1,00295,India
277335,2023-03-10,1006,Blush,150,300,150,1,00088,India
277335,2023-03-10,1012,Body Lotion,200,400,200,1,00088,India
277335,2023-03-10,1004,Eyeliner,100,200,100,1,00088,India
175899,2023-03-10,1008,Makeup Remover,80,160,80,1,00353,India
175899,2023-03-10,1006,Blush,150,300,150,1,00353,India
175899,2023-03-10,1012,Body Lotion,200,400,200,1,00353,India
175899,2023-03-10,1003,Foundation,300,600,300,1,00353,India
347437,2023-03-10,1008,Makeup Remover,80,160,80,1,00072,India
325472,2023-03-10,1006,Blush,150,300,150,1,00165,India
325472,2023-03-10,1004,Eyeliner,100,200,100,1,00165,India
325472,2023-03-10,1007,Eyeshadow,200,400,200,1,00165,India
738424,2023-03-10,1001,Lipstick,150,300,150,1,00443,India
288699,2023-03-10,1007,Eyeshadow,200,400,200,1,00479,India
288699,2023-03-10,1004,Eyeliner,100,200,100,1,00479,India
288699,2023-03-10,1001,Lipstick,150,300,150,1,00479,India
929942,2023-03-11,1012,Body Lotion,200,400,200,1,00203,India
999760,2023-03-11,1008,Makeup Remover,80,160,80,1,00316,India
999760,2023-03-11,1001,Lipstick,150,300,150,1,00316,India
999760,2023-03-11,1007,Eyeshadow,200,400,200,1,00316,India
999760,2023-03-11,1002,Mascara,200,400,200,1,00316,India
182476,2023-03-11,1008,Makeup Remover,80,160,80,1,00477,India
988919,2023-03-11,1008,Makeup Remover,80,160,80,1,00055,India
988919,2023-03-11,1001,Lipstick,150,300,150,1,00055,India
988919,2023-03-11,1003,Foundation,300,600,300,1,00055,India
869001,2023-03-11,1005,Nail Polish,50,100,50,1,00342,India
869001,2023-03-11,1008,Makeup Remover,80,160,80,1,00342,India
869001,2023-03-11,1006,Blush,150,300,150,1,00342,India
919499,2023-03-11,1005,Nail Polish,50,100,50,1,00114,India
919499,2023-03-11,1006,Blush,150,300,150,1,00114,India
919499,2023-03-11,1004,Eyeliner,100,200,100,1,00114,India
919499,2023-03-11,1001,Lipstick,150,300,150,1,00114,India
919499,2023-03-11,1002,Mascara,200,400,200,1,00114,India
363923,2023-03-11,1009,Moisturizer,250,500,250,1,00151,India
363923,2023-03-11,1007,Eyeshadow,200,400,200,1,00151,India
363923,2023-03-11,1005,Nail Polish,50,100,50,1,00151,India
553793,2023-03-11,1009,Moisturizer,250,500,250,1,00271,India
553793,2023-03-11,1006,Blush,150,300,150,1,00271,India
806936,2023-03-11,1012,Body Lotion,200,400,200,1,00496,India
475325,2023-03-11,1009,Moisturizer,250,500,250,1,00427,India
652205,2023-03-11,1012,Body Lotion,200,400,200,1,00061,India
652205,2023-03-11,1001,Lipstick,150,300,150,1,00061,India
652205,2023-03-11,1009,Moisturizer,250,500,250,1,00061,India
449998,2023-03-11,1006,Blush,150,300,150,1,00474,India
449998,2023-03-11,1004,Eyeliner,100,200,100,1,00474,India
449998,2023-03-11,1009,Moisturizer,250,500,250,1,00474,India
449998,2023-03-11,1002,Mascara,200,400,200,1,00474,India
291311,2023-03-11,1001,Lipstick,150,300,150,1,00353,India
291311,2023-03-11,1007,Eyeshadow,200,400,200,1,00353,India
291311,2023-03-11,1006,Blush,150,300,150,1,00353,India
291311,2023-03-11,1005,Nail Polish,50,100,50,1,00353,India
135896,2023-03-11,1007,Eyeshadow,200,400,200,1,00158,India
135896,2023-03-11,1005,Nail Polish,50,100,50,1,00158,India
917975,2023-03-11,1004,Eyeliner,100,200,100,1,00094,India
917975,2023-03-11,1007,Eyeshadow,200,400,200,1,00094,India
917975,2023-03-11,1001,Lipstick,150,300,150,1,00094,India
713638,2023-03-11,1004,Eyeliner,100,200,100,1,00170,India
713638,2023-03-11,1012,Body Lotion,200,400,200,1,00170,India
713638,2023-03-11,1007,Eyeshadow,200,400,200,1,00170,India
630606,2023-03-11,1004,Eyeliner,100,200,100,1,00234,India
630606,2023-03-11,1009,Moisturizer,250,500,250,1,00234,India
630606,2023-03-11,1002,Mascara,200,400,200,1,00234,India
440911,2023-03-11,1001,Lipstick,150,300,150,1,00099,India
240275,2023-03-11,1012,Body Lotion,200,400,200,1,00446,India
240275,2023-03-11,1001,Lipstick,150,300,150,1,00446,India
191755,2023-03-11,1007,Eyeshadow,200,400,200,1,00417,India
191755,2023-03-11,1012,Body Lotion,200,400,200,1,00417,India
191755,2023-03-11,1005,Nail Polish,50,100,50,1,00417,India
314870,2023-03-11,1001,Lipstick,150,300,150,1,00500,India
314870,2023-03-11,1006,Blush,150,300,150,1,00500,India
314870,2023-03-11,1009,Moisturizer,250,500,250,1,00500,India
211638,2023-03-11,1012,Body Lotion,200,400,200,1,00360,India
451299,2023-03-11,1009,Moisturizer,250,500,250,1,00396,India
451299,2023-03-11,1008,Makeup Remover,80,160,80,1,00396,India
451299,2023-03-11,1005,Nail Polish,50,100,50,1,00396,India
211151,2023-03-11,1004,Eyeliner,100,200,100,1,00003,India
211151,2023-03-11,1001,Lipstick,150,300,150,1,00003,India
211151,2023-03-11,1003,Foundation,300,600,300,1,00003,India
211151,2023-03-11,1005,Nail Polish,50,100,50,1,00003,India
211151,2023-03-11,1009,Moisturizer,250,500,250,1,00003,India
448101,2023-03-11,1008,Makeup Remover,80,160,80,1,00381,India
448101,2023-03-11,1012,Body Lotion,200,400,200,1,00381,India
294502,2023-03-11,1008,Makeup Remover,80,160,80,1,00359,India
294502,2023-03-11,1002,Mascara,200,400,200,1,00359,India
294502,2023-03-11,1001,Lipstick,150,300,150,1,00359,India
294502,2023-03-11,1006,Blush,150,300,150,1,00359,India
497795,2023-03-11,1004,Eyeliner,100,200,100,1,00115,India
646844,2023-03-11,1002,Mascara,200,400,200,1,00393,India
646844,2023-03-11,1006,Blush,150,300,150,1,00393,India
646844,2023-03-11,1009,Moisturizer,250,500,250,1,00393,India
572175,2023-03-11,1012,Body Lotion,200,400,200,1,00394,India
572175,2023-03-11,1006,Blush,150,300,150,1,00394,India
572175,2023-03-11,1002,Mascara,200,400,200,1,00394,India
980902,2023-03-11,1007,Eyeshadow,200,400,200,1,00116,India
980902,2023-03-11,1003,Foundation,300,600,300,1,00116,India
980902,2023-03-11,1008,Makeup Remover,80,160,80,1,00116,India
665771,2023-03-11,1008,Makeup Remover,80,160,80,1,00138,India
665771,2023-03-11,1001,Lipstick,150,300,150,1,00138,India
665771,2023-03-11,1012,Body Lotion,200,400,200,1,00138,India
501783,2023-03-11,1005,Nail Polish,50,100,50,1,00417,India
501783,2023-03-11,1004,Eyeliner,100,200,100,1,00417,India
414956,2023-03-11,1006,Blush,150,300,150,1,00169,India
735290,2023-03-11,1012,Body Lotion,200,400,200,1,00329,India
578722,2023-03-11,1009,Moisturizer,250,500,250,1,00471,India
578722,2023-03-11,1002,Mascara,200,400,200,1,00471,India
578722,2023-03-11,1001,Lipstick,150,300,150,1,00471,India
578722,2023-03-11,1004,Eyeliner,100,200,100,1,00471,India
941457,2023-03-11,1012,Body Lotion,200,400,200,1,00135,India
197840,2023-03-11,1002,Mascara,200,400,200,1,00339,India
197840,2023-03-11,1005,Nail Polish,50,100,50,1,00339,India
197840,2023-03-11,1001,Lipstick,150,300,150,1,00339,India
197840,2023-03-11,1003,Foundation,300,600,300,1,00339,India
202925,2023-03-11,1006,Blush,150,300,150,1,00391,India
202925,2023-03-11,1008,Makeup Remover,80,160,80,1,00391,India
202925,2023-03-11,1001,Lipstick,150,300,150,1,00391,India
202925,2023-03-11,1005,Nail Polish,50,100,50,1,00391,India
202925,2023-03-11,1007,Eyeshadow,200,400,200,1,00391,India
818683,2023-03-11,1009,Moisturizer,250,500,250,1,00146,India
818683,2023-03-11,1008,Makeup Remover,80,160,80,1,00146,India
818683,2023-03-11,1006,Blush,150,300,150,1,00146,India
964236,2023-03-11,1008,Makeup Remover,80,160,80,1,00437,India
964236,2023-03-11,1009,Moisturizer,250,500,250,1,00437,India
645247,2023-03-11,1003,Foundation,300,600,300,1,00274,India
645247,2023-03-11,1001,Lipstick,150,300,150,1,00274,India
645247,2023-03-11,1004,Eyeliner,100,200,100,1,00274,India
696985,2023-03-11,1012,Body Lotion,200,400,200,1,00432,India
696985,2023-03-11,1004,Eyeliner,100,200,100,1,00432,India
696985,2023-03-11,1005,Nail Polish,50,100,50,1,00432,India
708510,2023-03-11,1004,Eyeliner,100,200,100,1,00204,India
708510,2023-03-11,1003,Foundation,300,600,300,1,00204,India
708510,2023-03-11,1007,Eyeshadow,200,400,200,1,00204,India
968965,2023-03-11,1004,Eyeliner,100,200,100,1,00424,India
968965,2023-03-11,1012,Body Lotion,200,400,200,1,00424,India
968965,2023-03-11,1009,Moisturizer,250,500,250,1,00424,India
968965,2023-03-11,1002,Mascara,200,400,200,1,00424,India
867736,2023-03-12,1009,Moisturizer,250,500,250,1,00219,India
870431,2023-03-12,1012,Body Lotion,200,400,200,1,00272,India
870431,2023-03-12,1008,Makeup Remover,80,160,80,1,00272,India
575903,2023-03-12,1002,Mascara,200,400,200,1,00141,India
575903,2023-03-12,1009,Moisturizer,250,500,250,1,00141,India
820344,2023-03-12,1002,Mascara,200,400,200,1,00278,India
820344,2023-03-12,1001,Lipstick,150,300,150,1,00278,India
339327,2023-03-12,1001,Lipstick,150,300,150,1,00434,India
339327,2023-03-12,1012,Body Lotion,200,400,200,1,00434,India
473478,2023-03-12,1008,Makeup Remover,80,160,80,1,00448,India
473478,2023-03-12,1005,Nail Polish,50,100,50,1,00448,India
384615,2023-03-12,1003,Foundation,300,600,300,1,00049,India
897396,2023-03-12,1003,Foundation,300,600,300,1,00376,India
897396,2023-03-12,1002,Mascara,200,400,200,1,00376,India
897396,2023-03-12,1007,Eyeshadow,200,400,200,1,00376,India
897396,2023-03-12,1004,Eyeliner,100,200,100,1,00376,India
792946,2023-03-12,1009,Moisturizer,250,500,250,1,00205,India
866243,2023-03-12,1008,Makeup Remover,80,160,80,1,00312,India
989591,2023-03-12,1008,Makeup Remover,80,160,80,1,00008,India
759983,2023-03-12,1002,Mascara,200,400,200,1,00444,India
759983,2023-03-12,1001,Lipstick,150,300,150,1,00444,India
759983,2023-03-12,1006,Blush,150,300,150,1,00444,India
759983,2023-03-12,1012,Body Lotion,200,400,200,1,00444,India
348947,2023-03-12,1009,Moisturizer,250,500,250,1,00252,India
348947,2023-03-12,1005,Nail Polish,50,100,50,1,00252,India
348947,2023-03-12,1006,Blush,150,300,150,1,00252,India
348947,2023-03-12,1001,Lipstick,150,300,150,1,00252,India
427323,2023-03-12,1004,Eyeliner,100,200,100,1,00104,India
157785,2023-03-12,1004,Eyeliner,100,200,100,1,00345,India
157785,2023-03-12,1007,Eyeshadow,200,400,200,1,00345,India
568424,2023-03-12,1006,Blush,150,300,150,1,00120,India
568424,2023-03-12,1008,Makeup Remover,80,160,80,1,00120,India
565168,2023-03-12,1003,Foundation,300,600,300,1,00198,India
565168,2023-03-12,1001,Lipstick,150,300,150,1,00198,India
565168,2023-03-12,1009,Moisturizer,250,500,250,1,00198,India
565168,2023-03-12,1004,Eyeliner,100,200,100,1,00198,India
565168,2023-03-12,1005,Nail Polish,50,100,50,1,00198,India
987673,2023-03-12,1002,Mascara,200,400,200,1,00107,India
987673,2023-03-12,1007,Eyeshadow,200,400,200,1,00107,India
987673,2023-03-12,1009,Moisturizer,250,500,250,1,00107,India
667450,2023-03-12,1001,Lipstick,150,300,150,1,00456,India
667450,2023-03-12,1002,Mascara,200,400,200,1,00456,India
667450,2023-03-12,1009,Moisturizer,250,500,250,1,00456,India
667450,2023-03-12,1003,Foundation,300,600,300,1,00456,India
911375,2023-03-12,1007,Eyeshadow,200,400,200,1,00412,India
911375,2023-03-12,1001,Lipstick,150,300,150,1,00412,India
911375,2023-03-12,1004,Eyeliner,100,200,100,1,00412,India
911375,2023-03-12,1009,Moisturizer,250,500,250,1,00412,India
856404,2023-03-12,1009,Moisturizer,250,500,250,1,00471,India
856404,2023-03-12,1006,Blush,150,300,150,1,00471,India
856404,2023-03-12,1008,Makeup Remover,80,160,80,1,00471,India
856404,2023-03-12,1001,Lipstick,150,300,150,1,00471,India
172345,2023-03-12,1003,Foundation,300,600,300,1,00412,India
172345,2023-03-12,1004,Eyeliner,100,200,100,1,00412,India
172345,2023-03-12,1005,Nail Polish,50,100,50,1,00412,India
172345,2023-03-12,1012,Body Lotion,200,400,200,1,00412,India
986790,2023-03-12,1012,Body Lotion,200,400,200,1,00304,India
780994,2023-03-12,1003,Foundation,300,600,300,1,00035,India
780994,2023-03-12,1012,Body Lotion,200,400,200,1,00035,India
780994,2023-03-12,1007,Eyeshadow,200,400,200,1,00035,India
780994,2023-03-12,1001,Lipstick,150,300,150,1,00035,India
563246,2023-03-12,1008,Makeup Remover,80,160,80,1,00178,India
425523,2023-03-12,1002,Mascara,200,400,200,1,00440,India
425523,2023-03-12,1012,Body Lotion,200,400,200,1,00440,India
425523,2023-03-12,1008,Makeup Remover,80,160,80,1,00440,India
425523,2023-03-12,1005,Nail Polish,50,100,50,1,00440,India
941433,2023-03-12,1004,Eyeliner,100,200,100,1,00475,India
941433,2023-03-12,1001,Lipstick,150,300,150,1,00475,India
132842,2023-03-12,1009,Moisturizer,250,500,250,1,00109,India
132842,2023-03-12,1002,Mascara,200,400,200,1,00109,India
132842,2023-03-12,1005,Nail Polish,50,100,50,1,00109,India
132842,2023-03-12,1004,Eyeliner,100,200,100,1,00109,India
589380,2023-03-12,1009,Moisturizer,250,500,250,1,00410,India
589380,2023-03-12,1001,Lipstick,150,300,150,1,00410,India
589380,2023-03-12,1006,Blush,150,300,150,1,00410,India
589380,2023-03-12,1007,Eyeshadow,200,400,200,1,00410,India
574484,2023-03-12,1001,Lipstick,150,300,150,1,00325,India
613071,2023-03-12,1007,Eyeshadow,200,400,200,1,00493,India
613071,2023-03-12,1012,Body Lotion,200,400,200,1,00493,India
213529,2023-03-12,1001,Lipstick,150,300,150,1,00230,India
213529,2023-03-12,1007,Eyeshadow,200,400,200,1,00230,India
213529,2023-03-12,1012,Body Lotion,200,400,200,1,00230,India
143743,2023-03-12,1012,Body Lotion,200,400,200,1,00345,India
143743,2023-03-12,1002,Mascara,200,400,200,1,00345,India
143743,2023-03-12,1005,Nail Polish,50,100,50,1,00345,India
793817,2023-03-12,1003,Foundation,300,600,300,1,00283,India
793817,2023-03-12,1009,Moisturizer,250,500,250,1,00283,India
793817,2023-03-12,1001,Lipstick,150,300,150,1,00283,India
793817,2023-03-12,1012,Body Lotion,200,400,200,1,00283,India
508141,2023-03-12,1002,Mascara,200,400,200,1,00404,India
508141,2023-03-12,1008,Makeup Remover,80,160,80,1,00404,India
508141,2023-03-12,1004,Eyeliner,100,200,100,1,00404,India
508141,2023-03-12,1007,Eyeshadow,200,400,200,1,00404,India
957734,2023-03-12,1003,Foundation,300,600,300,1,00193,India
957734,2023-03-12,1006,Blush,150,300,150,1,00193,India
585630,2023-03-12,1004,Eyeliner,100,200,100,1,00312,India
585630,2023-03-12,1007,Eyeshadow,200,400,200,1,00312,India
585630,2023-03-12,1005,Nail Polish,50,100,50,1,00312,India
244800,2023-03-12,1004,Eyeliner,100,200,100,1,00133,India
852692,2023-03-12,1001,Lipstick,150,300,150,1,00258,India
852692,2023-03-12,1006,Blush,150,300,150,1,00258,India
852692,2023-03-12,1007,Eyeshadow,200,400,200,1,00258,India
364917,2023-03-12,1003,Foundation,300,600,300,1,00233,India
364917,2023-03-12,1012,Body Lotion,200,400,200,1,00233,India
364917,2023-03-12,1009,Moisturizer,250,500,250,1,00233,India
364917,2023-03-12,1006,Blush,150,300,150,1,00233,India
519724,2023-03-12,1002,Mascara,200,400,200,1,00088,India
519724,2023-03-12,1001,Lipstick,150,300,150,1,00088,India
519724,2023-03-12,1003,Foundation,300,600,300,1,00088,India
504129,2023-03-12,1008,Makeup Remover,80,160,80,1,00416,India
504129,2023-03-12,1012,Body Lotion,200,400,200,1,00416,India
504129,2023-03-12,1009,Moisturizer,250,500,250,1,00416,India
612160,2023-03-12,1002,Mascara,200,400,200,1,00058,India
612160,2023-03-12,1009,Moisturizer,250,500,250,1,00058,India
612160,2023-03-12,1006,Blush,150,300,150,1,00058,India
946953,2023-03-12,1009,Moisturizer,250,500,250,1,00157,India
946953,2023-03-12,1005,Nail Polish,50,100,50,1,00157,India
946953,2023-03-12,1002,Mascara,200,400,200,1,00157,India
662829,2023-03-12,1003,Foundation,300,600,300,1,00240,India
662829,2023-03-12,1001,Lipstick,150,300,150,1,00240,India
362200,2023-03-12,1002,Mascara,200,400,200,1,00016,India
362200,2023-03-12,1006,Blush,150,300,150,1,00016,India
362200,2023-03-12,1004,Eyeliner,100,200,100,1,00016,India
362200,2023-03-12,1009,Moisturizer,250,500,250,1,00016,India
156498,2023-03-12,1006,Blush,150,300,150,1,00076,India
156498,2023-03-12,1002,Mascara,200,400,200,1,00076,India
156498,2023-03-12,1005,Nail Polish,50,100,50,1,00076,India
156498,2023-03-12,1012,Body Lotion,200,400,200,1,00076,India
841429,2023-03-12,1003,Foundation,300,600,300,1,00289,India
980891,2023-03-12,1008,Makeup Remover,80,160,80,1,00327,India
980891,2023-03-12,1006,Blush,150,300,150,1,00327,India
379520,2023-03-12,1003,Foundation,300,600,300,1,00394,India
896281,2023-03-13,1001,Lipstick,150,300,150,1,00217,India
896281,2023-03-13,1009,Moisturizer,250,500,250,1,00217,India
896281,2023-03-13,1006,Blush,150,300,150,1,00217,India
544815,2023-03-13,1009,Moisturizer,250,500,250,1,00241,India
544815,2023-03-13,1003,Foundation,300,600,300,1,00241,India
833712,2023-03-13,1003,Foundation,300,600,300,1,00274,India
833712,2023-03-13,1002,Mascara,200,400,200,1,00274,India
833712,2023-03-13,1004,Eyeliner,100,200,100,1,00274,India
833712,2023-03-13,1001,Lipstick,150,300,150,1,00274,India
825065,2023-03-13,1008,Makeup Remover,80,160,80,1,00328,India
825065,2023-03-13,1002,Mascara,200,400,200,1,00328,India
825065,2023-03-13,1009,Moisturizer,250,500,250,1,00328,India
441832,2023-03-13,1008,Makeup Remover,80,160,80,1,00007,India
695109,2023-03-13,1002,Mascara,200,400,200,1,00236,India
695109,2023-03-13,1007,Eyeshadow,200,400,200,1,00236,India
695109,2023-03-13,1004,Eyeliner,100,200,100,1,00236,India
695109,2023-03-13,1012,Body Lotion,200,400,200,1,00236,India
695109,2023-03-13,1008,Makeup Remover,80,160,80,1,00236,India
581959,2023-03-13,1008,Makeup Remover,80,160,80,1,00197,India
581959,2023-03-13,1007,Eyeshadow,200,400,200,1,00197,India
581959,2023-03-13,1006,Blush,150,300,150,1,00197,India
581959,2023-03-13,1004,Eyeliner,100,200,100,1,00197,India
826043,2023-03-13,1007,Eyeshadow,200,400,200,1,00284,India
826043,2023-03-13,1012,Body Lotion,200,400,200,1,00284,India
584883,2023-03-13,1002,Mascara,200,400,200,1,00193,India
584883,2023-03-13,1012,Body Lotion,200,400,200,1,00193,India
584883,2023-03-13,1009,Moisturizer,250,500,250,1,00193,India
667846,2023-03-13,1006,Blush,150,300,150,1,00299,India
667846,2023-03-13,1002,Mascara,200,400,200,1,00299,India
667846,2023-03-13,1012,Body Lotion,200,400,200,1,00299,India
667846,2023-03-13,1007,Eyeshadow,200,400,200,1,00299,India
388273,2023-03-13,1006,Blush,150,300,150,1,00100,India
388273,2023-03-13,1001,Lipstick,150,300,150,1,00100,India
388273,2023-03-13,1012,Body Lotion,200,400,200,1,00100,India
882686,2023-03-13,1006,Blush,150,300,150,1,00259,India
882686,2023-03-13,1002,Mascara,200,400,200,1,00259,India
882686,2023-03-13,1007,Eyeshadow,200,400,200,1,00259,India
760108,2023-03-13,1007,Eyeshadow,200,400,200,1,00385,India
760108,2023-03-13,1008,Makeup Remover,80,160,80,1,00385,India
494846,2023-03-13,1003,Foundation,300,600,300,1,00454,India
494846,2023-03-13,1002,Mascara,200,400,200,1,00454,India
494846,2023-03-13,1001,Lipstick,150,300,150,1,00454,India
494846,2023-03-13,1005,Nail Polish,50,100,50,1,00454,India
643122,2023-03-13,1005,Nail Polish,50,100,50,1,00497,India
643122,2023-03-13,1004,Eyeliner,100,200,100,1,00497,India
643122,2023-03-13,1012,Body Lotion,200,400,200,1,00497,India
639904,2023-03-13,1008,Makeup Remover,80,160,80,1,00399,India
639904,2023-03-13,1002,Mascara,200,400,200,1,00399,India
639904,2023-03-13,1001,Lipstick,150,300,150,1,00399,India
639904,2023-03-13,1009,Moisturizer,250,500,250,1,00399,India
986809,2023-03-13,1002,Mascara,200,400,200,1,00172,India
373112,2023-03-13,1005,Nail Polish,50,100,50,1,00238,India
373112,2023-03-13,1006,Blush,150,300,150,1,00238,India
373112,2023-03-13,1004,Eyeliner,100,200,100,1,00238,India
373112,2023-03-13,1003,Foundation,300,600,300,1,00238,India
372287,2023-03-13,1001,Lipstick,150,300,150,1,00387,India
690117,2023-03-13,1004,Eyeliner,100,200,100,1,00234,India
690117,2023-03-13,1003,Foundation,300,600,300,1,00234,India
690117,2023-03-13,1009,Moisturizer,250,500,250,1,00234,India
690117,2023-03-13,1002,Mascara,200,400,200,1,00234,India
288397,2023-03-13,1006,Blush,150,300,150,1,00496,India
288397,2023-03-13,1009,Moisturizer,250,500,250,1,00496,India
288397,2023-03-13,1002,Mascara,200,400,200,1,00496,India
288397,2023-03-13,1008,Makeup Remover,80,160,80,1,00496,India
828884,2023-03-13,1001,Lipstick,150,300,150,1,00091,India
828884,2023-03-13,1004,Eyeliner,100,200,100,1,00091,India
230735,2023-03-13,1012,Body Lotion,200,400,200,1,00286,India
230735,2023-03-13,1001,Lipstick,150,300,150,1,00286,India
197465,2023-03-13,1003,Foundation,300,600,300,1,00287,India
197465,2023-03-13,1009,Moisturizer,250,500,250,1,00287,India
597897,2023-03-13,1007,Eyeshadow,200,400,200,1,00231,India
626690,2023-03-13,1002,Mascara,200,400,200,1,00219,India
626690,2023-03-13,1003,Foundation,300,600,300,1,00219,India
589094,2023-03-13,1002,Mascara,200,400,200,1,00383,India
589094,2023-03-13,1003,Foundation,300,600,300,1,00383,India
589094,2023-03-13,1006,Blush,150,300,150,1,00383,India
589094,2023-03-13,1009,Moisturizer,250,500,250,1,00383,India
349782,2023-03-13,1009,Moisturizer,250,500,250,1,00341,India
349782,2023-03-13,1004,Eyeliner,100,200,100,1,00341,India
349782,2023-03-13,1007,Eyeshadow,200,400,200,1,00341,India
175822,2023-03-13,1009,Moisturizer,250,500,250,1,00448,India
550236,2023-03-13,1007,Eyeshadow,200,400,200,1,00186,India
571455,2023-03-13,1006,Blush,150,300,150,1,00459,India
571455,2023-03-13,1012,Body Lotion,200,400,200,1,00459,India
571455,2023-03-13,1001,Lipstick,150,300,150,1,00459,India
571455,2023-03-13,1002,Mascara,200,400,200,1,00459,India
907557,2023-03-13,1003,Foundation,300,600,300,1,00437,India
907557,2023-03-13,1008,Makeup Remover,80,160,80,1,00437,India
907557,2023-03-13,1004,Eyeliner,100,200,100,1,00437,India
991565,2023-03-13,1003,Foundation,300,600,300,1,00356,India
991565,2023-03-13,1001,Lipstick,150,300,150,1,00356,India
991565,2023-03-13,1012,Body Lotion,200,400,200,1,00356,India
991565,2023-03-13,1005,Nail Polish,50,100,50,1,00356,India
937246,2023-03-13,1005,Nail Polish,50,100,50,1,00430,India
555166,2023-03-13,1012,Body Lotion,200,400,200,1,00142,India
555166,2023-03-13,1009,Moisturizer,250,500,250,1,00142,India
727342,2023-03-13,1007,Eyeshadow,200,400,200,1,00006,India
727342,2023-03-13,1003,Foundation,300,600,300,1,00006,India
727342,2023-03-13,1004,Eyeliner,100,200,100,1,00006,India
151449,2023-03-14,1001,Lipstick,150,300,150,1,00461,India
151449,2023-03-14,1008,Makeup Remover,80,160,80,1,00461,India
572391,2023-03-14,1012,Body Lotion,200,400,200,1,00419,India
572391,2023-03-14,1003,Foundation,300,600,300,1,00419,India
572391,2023-03-14,1001,Lipstick,150,300,150,1,00419,India
572391,2023-03-14,1009,Moisturizer,250,500,250,1,00419,India
462246,2023-03-14,1012,Body Lotion,200,400,200,1,00320,India
462246,2023-03-14,1008,Makeup Remover,80,160,80,1,00320,India
462246,2023-03-14,1005,Nail Polish,50,100,50,1,00320,India
462246,2023-03-14,1009,Moisturizer,250,500,250,1,00320,India
369355,2023-03-14,1009,Moisturizer,250,500,250,1,00238,India
369355,2023-03-14,1001,Lipstick,150,300,150,1,00238,India
547473,2023-03-14,1012,Body Lotion,200,400,200,1,00147,India
319082,2023-03-14,1005,Nail Polish,50,100,50,1,00357,India
319082,2023-03-14,1002,Mascara,200,400,200,1,00357,India
319082,2023-03-14,1012,Body Lotion,200,400,200,1,00357,India
319082,2023-03-14,1003,Foundation,300,600,300,1,00357,India
808729,2023-03-14,1009,Moisturizer,250,500,250,1,00120,India
808729,2023-03-14,1007,Eyeshadow,200,400,200,1,00120,India
808729,2023-03-14,1012,Body Lotion,200,400,200,1,00120,India
808729,2023-03-14,1003,Foundation,300,600,300,1,00120,India
746372,2023-03-14,1012,Body Lotion,200,400,200,1,00189,India
727512,2023-03-14,1004,Eyeliner,100,200,100,1,00248,India
289432,2023-03-14,1005,Nail Polish,50,100,50,1,00343,India
737652,2023-03-14,1002,Mascara,200,400,200,1,00426,India
737652,2023-03-14,1006,Blush,150,300,150,1,00426,India
295798,2023-03-14,1012,Body Lotion,200,400,200,1,00061,India
295798,2023-03-14,1006,Blush,150,300,150,1,00061,India
295798,2023-03-14,1009,Moisturizer,250,500,250,1,00061,India
295798,2023-03-14,1001,Lipstick,150,300,150,1,00061,India
514498,2023-03-14,1012,Body Lotion,200,400,200,1,00051,India
174020,2023-03-14,1008,Makeup Remover,80,160,80,1,00064,India
174020,2023-03-14,1006,Blush,150,300,150,1,00064,India
174020,2023-03-14,1007,Eyeshadow,200,400,200,1,00064,India
727145,2023-03-14,1006,Blush,150,300,150,1,00017,India
727145,2023-03-14,1008,Makeup Remover,80,160,80,1,00017,India
929621,2023-03-14,1012,Body Lotion,200,400,200,1,00427,India
929621,2023-03-14,1009,Moisturizer,250,500,250,1,00427,India
929621,2023-03-14,1006,Blush,150,300,150,1,00427,India
373776,2023-03-14,1001,Lipstick,150,300,150,1,00316,India
373776,2023-03-14,1003,Foundation,300,600,300,1,00316,India
373776,2023-03-14,1008,Makeup Remover,80,160,80,1,00316,India
573486,2023-03-14,1012,Body Lotion,200,400,200,1,00073,India
573486,2023-03-14,1008,Makeup Remover,80,160,80,1,00073,India
573486,2023-03-14,1001,Lipstick,150,300,150,1,00073,India
695379,2023-03-14,1008,Makeup Remover,80,160,80,1,00139,India
695379,2023-03-14,1002,Mascara,200,400,200,1,00139,India
695379,2023-03-14,1003,Foundation,300,600,300,1,00139,India
695379,2023-03-14,1006,Blush,150,300,150,1,00139,India
483656,2023-03-14,1005,Nail Polish,50,100,50,1,00462,India
483656,2023-03-14,1008,Makeup Remover,80,160,80,1,00462,India
483656,2023-03-14,1006,Blush,150,300,150,1,00462,India
817302,2023-03-14,1007,Eyeshadow,200,400,200,1,00271,India
474191,2023-03-14,1007,Eyeshadow,200,400,200,1,00129,India
518442,2023-03-14,1005,Nail Polish,50,100,50,1,00205,India
518442,2023-03-14,1007,Eyeshadow,200,400,200,1,00205,India
518442,2023-03-14,1009,Moisturizer,250,500,250,1,00205,India
518442,2023-03-14,1006,Blush,150,300,150,1,00205,India
562830,2023-03-14,1003,Foundation,300,600,300,1,00268,India
562830,2023-03-14,1004,Eyeliner,100,200,100,1,00268,India
562830,2023-03-14,1008,Makeup Remover,80,160,80,1,00268,India
562830,2023-03-14,1006,Blush,150,300,150,1,00268,India
489241,2023-03-14,1004,Eyeliner,100,200,100,1,00385,India
489241,2023-03-14,1007,Eyeshadow,200,400,200,1,00385,India
845484,2023-03-14,1004,Eyeliner,100,200,100,1,00463,India
845484,2023-03-14,1003,Foundation,300,600,300,1,00463,India
691853,2023-03-14,1002,Mascara,200,400,200,1,00215,India
346211,2023-03-14,1002,Mascara,200,400,200,1,00345,India
346211,2023-03-14,1001,Lipstick,150,300,150,1,00345,India
346211,2023-03-14,1007,Eyeshadow,200,400,200,1,00345,India
783366,2023-03-14,1005,Nail Polish,50,100,50,1,00343,India
783366,2023-03-14,1003,Foundation,300,600,300,1,00343,India
783366,2023-03-14,1009,Moisturizer,250,500,250,1,00343,India
932408,2023-03-14,1003,Foundation,300,600,300,1,00473,India
932408,2023-03-14,1007,Eyeshadow,200,400,200,1,00473,India
237764,2023-03-14,1001,Lipstick,150,300,150,1,00081,India
237764,2023-03-14,1003,Foundation,300,600,300,1,00081,India
648727,2023-03-14,1008,Makeup Remover,80,160,80,1,00061,India
568796,2023-03-14,1004,Eyeliner,100,200,100,1,00044,India
568796,2023-03-14,1012,Body Lotion,200,400,200,1,00044,India
568796,2023-03-14,1003,Foundation,300,600,300,1,00044,India
997277,2023-03-14,1007,Eyeshadow,200,400,200,1,00265,India
997277,2023-03-14,1005,Nail Polish,50,100,50,1,00265,India
997277,2023-03-14,1006,Blush,150,300,150,1,00265,India
997277,2023-03-14,1012,Body Lotion,200,400,200,1,00265,India
295916,2023-03-14,1003,Foundation,300,600,300,1,00482,India
295916,2023-03-14,1009,Moisturizer,250,500,250,1,00482,India
284669,2023-03-14,1006,Blush,150,300,150,1,00467,India
284669,2023-03-14,1007,Eyeshadow,200,400,200,1,00467,India
284669,2023-03-14,1005,Nail Polish,50,100,50,1,00467,India
284669,2023-03-14,1008,Makeup Remover,80,160,80,1,00467,India
757995,2023-03-14,1005,Nail Polish,50,100,50,1,00089,India
757995,2023-03-14,1001,Lipstick,150,300,150,1,00089,India
369003,2023-03-14,1009,Moisturizer,250,500,250,1,00292,India
381186,2023-03-15,1012,Body Lotion,200,400,200,1,00229,India
381186,2023-03-15,1004,Eyeliner,100,200,100,1,00229,India
381186,2023-03-15,1005,Nail Polish,50,100,50,1,00229,India
178898,2023-03-15,1009,Moisturizer,250,500,250,1,00264,India
195818,2023-03-15,1009,Moisturizer,250,500,250,1,00225,India
195818,2023-03-15,1008,Makeup Remover,80,160,80,1,00225,India
195818,2023-03-15,1006,Blush,150,300,150,1,00225,India
535190,2023-03-15,1005,Nail Polish,50,100,50,1,00036,India
535190,2023-03-15,1003,Foundation,300,600,300,1,00036,India
535190,2023-03-15,1002,Mascara,200,400,200,1,00036,India
535190,2023-03-15,1006,Blush,150,300,150,1,00036,India
439640,2023-03-15,1001,Lipstick,150,300,150,1,00352,India
786339,2023-03-15,1007,Eyeshadow,200,400,200,1,00428,India
786339,2023-03-15,1002,Mascara,200,400,200,1,00428,India
523580,2023-03-15,1003,Foundation,300,600,300,1,00433,India
523580,2023-03-15,1001,Lipstick,150,300,150,1,00433,India
523580,2023-03-15,1008,Makeup Remover,80,160,80,1,00433,India
174781,2023-03-15,1008,Makeup Remover,80,160,80,1,00365,India
174781,2023-03-15,1012,Body Lotion,200,400,200,1,00365,India
174781,2023-03-15,1005,Nail Polish,50,100,50,1,00365,India
174781,2023-03-15,1004,Eyeliner,100,200,100,1,00365,India
119539,2023-03-15,1002,Mascara,200,400,200,1,00076,India
119539,2023-03-15,1004,Eyeliner,100,200,100,1,00076,India
119539,2023-03-15,1005,Nail Polish,50,100,50,1,00076,India
806241,2023-03-15,1009,Moisturizer,250,500,250,1,00083,India
806241,2023-03-15,1008,Makeup Remover,80,160,80,1,00083,India
806241,2023-03-15,1003,Foundation,300,600,300,1,00083,India
151464,2023-03-15,1009,Moisturizer,250,500,250,1,00410,India
151464,2023-03-15,1007,Eyeshadow,200,400,200,1,00410,India
151464,2023-03-15,1002,Mascara,200,400,200,1,00410,India
635873,2023-03-15,1002,Mascara,200,400,200,1,00472,India
635873,2023-03-15,1012,Body Lotion,200,400,200,1,00472,India
820324,2023-03-15,1008,Makeup Remover,80,160,80,1,00219,India
389023,2023-03-15,1002,Mascara,200,400,200,1,00315,India
389023,2023-03-15,1012,Body Lotion,200,400,200,1,00315,India
614929,2023-03-15,1005,Nail Polish,50,100,50,1,00258,India
614929,2023-03-15,1007,Eyeshadow,200,400,200,1,00258,India
964028,2023-03-15,1009,Moisturizer,250,500,250,1,00273,India
488041,2023-03-15,1008,Makeup Remover,80,160,80,1,00192,India
488041,2023-03-15,1006,Blush,150,300,150,1,00192,India
488041,2023-03-15,1007,Eyeshadow,200,400,200,1,00192,India
488041,2023-03-15,1012,Body Lotion,200,400,200,1,00192,India
555321,2023-03-15,1002,Mascara,200,400,200,1,00401,India
566578,2023-03-15,1009,Moisturizer,250,500,250,1,00102,India
235407,2023-03-15,1003,Foundation,300,600,300,1,00454,India
235407,2023-03-15,1006,Blush,150,300,150,1,00454,India
911520,2023-03-15,1009,Moisturizer,250,500,250,1,00041,India
911520,2023-03-15,1012,Body Lotion,200,400,200,1,00041,India
149184,2023-03-15,1012,Body Lotion,200,400,200,1,00427,India
149184,2023-03-15,1004,Eyeliner,100,200,100,1,00427,India
359216,2023-03-15,1003,Foundation,300,600,300,1,00314,India
359216,2023-03-15,1012,Body Lotion,200,400,200,1,00314,India
359216,2023-03-15,1007,Eyeshadow,200,400,200,1,00314,India
359216,2023-03-15,1006,Blush,150,300,150,1,00314,India
949208,2023-03-15,1006,Blush,150,300,150,1,00349,India
655058,2023-03-15,1008,Makeup Remover,80,160,80,1,00053,India
655058,2023-03-15,1004,Eyeliner,100,200,100,1,00053,India
655058,2023-03-15,1007,Eyeshadow,200,400,200,1,00053,India
459728,2023-03-15,1004,Eyeliner,100,200,100,1,00422,India
459728,2023-03-15,1007,Eyeshadow,200,400,200,1,00422,India
459728,2023-03-15,1003,Foundation,300,600,300,1,00422,India
459728,2023-03-15,1006,Blush,150,300,150,1,00422,India
783583,2023-03-15,1006,Blush,150,300,150,1,00347,India
783583,2023-03-15,1002,Mascara,200,400,200,1,00347,India
783583,2023-03-15,1012,Body Lotion,200,400,200,1,00347,India
188058,2023-03-15,1001,Lipstick,150,300,150,1,00398,India
188058,2023-03-15,1012,Body Lotion,200,400,200,1,00398,India
188058,2023-03-15,1004,Eyeliner,100,200,100,1,00398,India
188058,2023-03-15,1008,Makeup Remover,80,160,80,1,00398,India
188058,2023-03-15,1002,Mascara,200,400,200,1,00398,India
341548,2023-03-15,1008,Makeup Remover,80,160,80,1,00322,India
341548,2023-03-15,1012,Body Lotion,200,400,200,1,00322,India
303776,2023-03-15,1002,Mascara,200,400,200,1,00072,India
303776,2023-03-15,1004,Eyeliner,100,200,100,1,00072,India
303776,2023-03-15,1012,Body Lotion,200,400,200,1,00072,India
303776,2023-03-15,1003,Foundation,300,600,300,1,00072,India
303776,2023-03-15,1007,Eyeshadow,200,400,200,1,00072,India
711391,2023-03-15,1007,Eyeshadow,200,400,200,1,00369,India
711391,2023-03-15,1004,Eyeliner,100,200,100,1,00369,India
711391,2023-03-15,1012,Body Lotion,200,400,200,1,00369,India
472650,2023-03-15,1004,Eyeliner,100,200,100,1,00303,India
472650,2023-03-15,1003,Foundation,300,600,300,1,00303,India
472650,2023-03-15,1006,Blush,150,300,150,1,00303,India
474586,2023-03-15,1002,Mascara,200,400,200,1,00023,India
474586,2023-03-15,1003,Foundation,300,600,300,1,00023,India
474586,2023-03-15,1006,Blush,150,300,150,1,00023,India
474586,2023-03-15,1005,Nail Polish,50,100,50,1,00023,India
852864,2023-03-16,1007,Eyeshadow,200,400,200,1,00339,India
852864,2023-03-16,1012,Body Lotion,200,400,200,1,00339,India
852864,2023-03-16,1008,Makeup Remover,80,160,80,1,00339,India
852864,2023-03-16,1005,Nail Polish,50,100,50,1,00339,India
884960,2023-03-16,1006,Blush,150,300,150,1,00082,India
884960,2023-03-16,1009,Moisturizer,250,500,250,1,00082,India
884960,2023-03-16,1012,Body Lotion,200,400,200,1,00082,India
884960,2023-03-16,1002,Mascara,200,400,200,1,00082,India
359719,2023-03-16,1006,Blush,150,300,150,1,00224,India
359719,2023-03-16,1003,Foundation,300,600,300,1,00224,India
359719,2023-03-16,1001,Lipstick,150,300,150,1,00224,India
359719,2023-03-16,1002,Mascara,200,400,200,1,00224,India
359719,2023-03-16,1007,Eyeshadow,200,400,200,1,00224,India
120290,2023-03-16,1001,Lipstick,150,300,150,1,00117,India
372734,2023-03-16,1008,Makeup Remover,80,160,80,1,00195,India
372734,2023-03-16,1002,Mascara,200,400,200,1,00195,India
394320,2023-03-16,1009,Moisturizer,250,500,250,1,00203,India
394320,2023-03-16,1001,Lipstick,150,300,150,1,00203,India
439661,2023-03-16,1004,Eyeliner,100,200,100,1,00438,India
371487,2023-03-16,1003,Foundation,300,600,300,1,00143,India
371487,2023-03-16,1004,Eyeliner,100,200,100,1,00143,India
397435,2023-03-16,1002,Mascara,200,400,200,1,00445,India
397435,2023-03-16,1001,Lipstick,150,300,150,1,00445,India
822616,2023-03-16,1007,Eyeshadow,200,400,200,1,00011,India
874227,2023-03-16,1002,Mascara,200,400,200,1,00253,India
592121,2023-03-16,1004,Eyeliner,100,200,100,1,00178,India
592121,2023-03-16,1003,Foundation,300,600,300,1,00178,India
592121,2023-03-16,1005,Nail Polish,50,100,50,1,00178,India
741296,2023-03-16,1004,Eyeliner,100,200,100,1,00266,India
741296,2023-03-16,1009,Moisturizer,250,500,250,1,00266,India
741296,2023-03-16,1003,Foundation,300,600,300,1,00266,India
913554,2023-03-16,1009,Moisturizer,250,500,250,1,00045,India
693991,2023-03-16,1008,Makeup Remover,80,160,80,1,00067,India
525880,2023-03-16,1003,Foundation,300,600,300,1,00427,India
525880,2023-03-16,1005,Nail Polish,50,100,50,1,00427,India
525880,2023-03-16,1008,Makeup Remover,80,160,80,1,00427,India
989420,2023-03-16,1004,Eyeliner,100,200,100,1,00286,India
989420,2023-03-16,1012,Body Lotion,200,400,200,1,00286,India
193864,2023-03-16,1006,Blush,150,300,150,1,00185,India
193864,2023-03-16,1009,Moisturizer,250,500,250,1,00185,India
788997,2023-03-16,1003,Foundation,300,600,300,1,00257,India
991036,2023-03-16,1006,Blush,150,300,150,1,00290,India
991036,2023-03-16,1007,Eyeshadow,200,400,200,1,00290,India
912330,2023-03-16,1005,Nail Polish,50,100,50,1,00170,India
912330,2023-03-16,1003,Foundation,300,600,300,1,00170,India
912330,2023-03-16,1006,Blush,150,300,150,1,00170,India
367999,2023-03-16,1007,Eyeshadow,200,400,200,1,00487,India
525282,2023-03-16,1002,Mascara,200,400,200,1,00356,India
525282,2023-03-16,1008,Makeup Remover,80,160,80,1,00356,India
252174,2023-03-16,1004,Eyeliner,100,200,100,1,00418,India
631868,2023-03-16,1001,Lipstick,150,300,150,1,00322,India
631868,2023-03-16,1009,Moisturizer,250,500,250,1,00322,India
631868,2023-03-16,1006,Blush,150,300,150,1,00322,India
631868,2023-03-16,1005,Nail Polish,50,100,50,1,00322,India
561996,2023-03-16,1007,Eyeshadow,200,400,200,1,00458,India
561996,2023-03-16,1005,Nail Polish,50,100,50,1,00458,India
561996,2023-03-16,1003,Foundation,300,600,300,1,00458,India
561996,2023-03-16,1006,Blush,150,300,150,1,00458,India
721365,2023-03-16,1007,Eyeshadow,200,400,200,1,00073,India
721365,2023-03-16,1012,Body Lotion,200,400,200,1,00073,India
214700,2023-03-16,1002,Mascara,200,400,200,1,00054,India
214700,2023-03-16,1005,Nail Polish,50,100,50,1,00054,India
214700,2023-03-16,1008,Makeup Remover,80,160,80,1,00054,India
214700,2023-03-16,1012,Body Lotion,200,400,200,1,00054,India
449967,2023-03-16,1003,Foundation,300,600,300,1,00021,India
449967,2023-03-16,1001,Lipstick,150,300,150,1,00021,India
449967,2023-03-16,1007,Eyeshadow,200,400,200,1,00021,India
318524,2023-03-16,1002,Mascara,200,400,200,1,00483,India
318524,2023-03-16,1007,Eyeshadow,200,400,200,1,00483,India
318524,2023-03-16,1008,Makeup Remover,80,160,80,1,00483,India
318524,2023-03-16,1004,Eyeliner,100,200,100,1,00483,India
318524,2023-03-16,1009,Moisturizer,250,500,250,1,00483,India
887104,2023-03-16,1003,Foundation,300,600,300,1,00351,India
887104,2023-03-16,1007,Eyeshadow,200,400,200,1,00351,India
585060,2023-03-16,1012,Body Lotion,200,400,200,1,00394,India
585060,2023-03-16,1005,Nail Polish,50,100,50,1,00394,India
585060,2023-03-16,1009,Moisturizer,250,500,250,1,00394,India
585060,2023-03-16,1001,Lipstick,150,300,150,1,00394,India
260386,2023-03-16,1004,Eyeliner,100,200,100,1,00014,India
260386,2023-03-16,1001,Lipstick,150,300,150,1,00014,India
260386,2023-03-16,1012,Body Lotion,200,400,200,1,00014,India
260386,2023-03-16,1006,Blush,150,300,150,1,00014,India
968596,2023-03-16,1005,Nail Polish,50,100,50,1,00099,India
968596,2023-03-16,1004,Eyeliner,100,200,100,1,00099,India
968596,2023-03-16,1008,Makeup Remover,80,160,80,1,00099,India
304501,2023-03-16,1012,Body Lotion,200,400,200,1,00211,India
304501,2023-03-16,1009,Moisturizer,250,500,250,1,00211,India
256151,2023-03-16,1003,Foundation,300,600,300,1,00299,India
270588,2023-03-16,1009,Moisturizer,250,500,250,1,00383,India
868062,2023-03-16,1005,Nail Polish,50,100,50,1,00205,India
742823,2023-03-16,1009,Moisturizer,250,500,250,1,00250,India
427397,2023-03-16,1006,Blush,150,300,150,1,00026,India
427397,2023-03-16,1003,Foundation,300,600,300,1,00026,India
427397,2023-03-16,1004,Eyeliner,100,200,100,1,00026,India
427397,2023-03-16,1002,Mascara,200,400,200,1,00026,India
264476,2023-03-16,1009,Moisturizer,250,500,250,1,00483,India
384074,2023-03-16,1008,Makeup Remover,80,160,80,1,00162,India
781779,2023-03-17,1007,Eyeshadow,200,400,200,1,00412,India
781779,2023-03-17,1003,Foundation,300,600,300,1,00412,India
781779,2023-03-17,1008,Makeup Remover,80,160,80,1,00412,India
510506,2023-03-17,1004,Eyeliner,100,200,100,1,00061,India
510506,2023-03-17,1007,Eyeshadow,200,400,200,1,00061,India
510506,2023-03-17,1009,Moisturizer,250,500,250,1,00061,India
536832,2023-03-17,1012,Body Lotion,200,400,200,1,00007,India
536832,2023-03-17,1008,Makeup Remover,80,160,80,1,00007,India
536832,2023-03-17,1007,Eyeshadow,200,400,200,1,00007,India
536832,2023-03-17,1009,Moisturizer,250,500,250,1,00007,India
405267,2023-03-17,1003,Foundation,300,600,300,1,00202,India
405267,2023-03-17,1004,Eyeliner,100,200,100,1,00202,India
405267,2023-03-17,1001,Lipstick,150,300,150,1,00202,India
405267,2023-03-17,1006,Blush,150,300,150,1,00202,India
659302,2023-03-17,1009,Moisturizer,250,500,250,1,00395,India
659302,2023-03-17,1001,Lipstick,150,300,150,1,00395,India
659302,2023-03-17,1006,Blush,150,300,150,1,00395,India
944342,2023-03-17,1003,Foundation,300,600,300,1,00426,India
944342,2023-03-17,1009,Moisturizer,250,500,250,1,00426,India
944342,2023-03-17,1004,Eyeliner,100,200,100,1,00426,India
825926,2023-03-17,1001,Lipstick,150,300,150,1,00036,India
701235,2023-03-17,1009,Moisturizer,250,500,250,1,00146,India
701235,2023-03-17,1007,Eyeshadow,200,400,200,1,00146,India
276299,2023-03-17,1009,Moisturizer,250,500,250,1,00143,India
276299,2023-03-17,1012,Body Lotion,200,400,200,1,00143,India
195794,2023-03-17,1004,Eyeliner,100,200,100,1,00315,India
195794,2023-03-17,1003,Foundation,300,600,300,1,00315,India
195794,2023-03-17,1009,Moisturizer,250,500,250,1,00315,India
195794,2023-03-17,1006,Blush,150,300,150,1,00315,India
195794,2023-03-17,1007,Eyeshadow,200,400,200,1,00315,India
120002,2023-03-17,1004,Eyeliner,100,200,100,1,00346,India
120002,2023-03-17,1006,Blush,150,300,150,1,00346,India
378486,2023-03-17,1001,Lipstick,150,300,150,1,00402,India
378486,2023-03-17,1003,Foundation,300,600,300,1,00402,India
378486,2023-03-17,1012,Body Lotion,200,400,200,1,00402,India
201760,2023-03-17,1012,Body Lotion,200,400,200,1,00478,India
325688,2023-03-17,1008,Makeup Remover,80,160,80,1,00387,India
325688,2023-03-17,1009,Moisturizer,250,500,250,1,00387,India
325688,2023-03-17,1004,Eyeliner,100,200,100,1,00387,India
325688,2023-03-17,1007,Eyeshadow,200,400,200,1,00387,India
325688,2023-03-17,1003,Foundation,300,600,300,1,00387,India
515165,2023-03-17,1004,Eyeliner,100,200,100,1,00403,India
515165,2023-03-17,1003,Foundation,300,600,300,1,00403,India
858446,2023-03-17,1002,Mascara,200,400,200,1,00045,India
286107,2023-03-17,1008,Makeup Remover,80,160,80,1,00152,India
692149,2023-03-17,1009,Moisturizer,250,500,250,1,00166,India
692149,2023-03-17,1008,Makeup Remover,80,160,80,1,00166,India
653162,2023-03-17,1012,Body Lotion,200,400,200,1,00150,India
653162,2023-03-17,1006,Blush,150,300,150,1,00150,India
531123,2023-03-17,1002,Mascara,200,400,200,1,00178,India
531123,2023-03-17,1007,Eyeshadow,200,400,200,1,00178,India
767091,2023-03-17,1002,Mascara,200,400,200,1,00150,India
767091,2023-03-17,1004,Eyeliner,100,200,100,1,00150,India
767091,2023-03-17,1001,Lipstick,150,300,150,1,00150,India
689897,2023-03-17,1006,Blush,150,300,150,1,00031,India
312057,2023-03-17,1005,Nail Polish,50,100,50,1,00056,India
312057,2023-03-17,1009,Moisturizer,250,500,250,1,00056,India
312057,2023-03-17,1004,Eyeliner,100,200,100,1,00056,India
448063,2023-03-17,1004,Eyeliner,100,200,100,1,00260,India
657512,2023-03-17,1012,Body Lotion,200,400,200,1,00434,India
657512,2023-03-17,1006,Blush,150,300,150,1,00434,India
998723,2023-03-17,1002,Mascara,200,400,200,1,00293,India
320062,2023-03-17,1009,Moisturizer,250,500,250,1,00232,India
320062,2023-03-17,1004,Eyeliner,100,200,100,1,00232,India
320062,2023-03-17,1003,Foundation,300,600,300,1,00232,India
944043,2023-03-17,1009,Moisturizer,250,500,250,1,00202,India
944043,2023-03-17,1006,Blush,150,300,150,1,00202,India
944043,2023-03-17,1002,Mascara,200,400,200,1,00202,India
937219,2023-03-17,1007,Eyeshadow,200,400,200,1,00023,India
937219,2023-03-17,1004,Eyeliner,100,200,100,1,00023,India
189390,2023-03-17,1003,Foundation,300,600,300,1,00298,India
189390,2023-03-17,1012,Body Lotion,200,400,200,1,00298,India
189390,2023-03-17,1005,Nail Polish,50,100,50,1,00298,India
909886,2023-03-17,1009,Moisturizer,250,500,250,1,00451,India
909886,2023-03-17,1004,Eyeliner,100,200,100,1,00451,India
203517,2023-03-17,1008,Makeup Remover,80,160,80,1,00209,India
203517,2023-03-17,1006,Blush,150,300,150,1,00209,India
474214,2023-03-17,1006,Blush,150,300,150,1,00260,India
474214,2023-03-17,1004,Eyeliner,100,200,100,1,00260,India
415574,2023-03-18,1002,Mascara,200,400,200,1,00043,India
415574,2023-03-18,1012,Body Lotion,200,400,200,1,00043,India
415574,2023-03-18,1004,Eyeliner,100,200,100,1,00043,India
415574,2023-03-18,1001,Lipstick,150,300,150,1,00043,India
927292,2023-03-18,1007,Eyeshadow,200,400,200,1,00435,India
927292,2023-03-18,1005,Nail Polish,50,100,50,1,00435,India
927292,2023-03-18,1012,Body Lotion,200,400,200,1,00435,India
927292,2023-03-18,1002,Mascara,200,400,200,1,00435,India
724532,2023-03-18,1005,Nail Polish,50,100,50,1,00348,India
724532,2023-03-18,1006,Blush,150,300,150,1,00348,India
169379,2023-03-18,1001,Lipstick,150,300,150,1,00458,India
169379,2023-03-18,1008,Makeup Remover,80,160,80,1,00458,India
589522,2023-03-18,1006,Blush,150,300,150,1,00255,India
589522,2023-03-18,1004,Eyeliner,100,200,100,1,00255,India
614842,2023-03-18,1003,Foundation,300,600,300,1,00045,India
307448,2023-03-18,1007,Eyeshadow,200,400,200,1,00409,India
360692,2023-03-18,1008,Makeup Remover,80,160,80,1,00055,India
360692,2023-03-18,1005,Nail Polish,50,100,50,1,00055,India
360692,2023-03-18,1004,Eyeliner,100,200,100,1,00055,India
793718,2023-03-18,1003,Foundation,300,600,300,1,00449,India
793718,2023-03-18,1007,Eyeshadow,200,400,200,1,00449,India
299436,2023-03-18,1005,Nail Polish,50,100,50,1,00437,India
299436,2023-03-18,1008,Makeup Remover,80,160,80,1,00437,India
299436,2023-03-18,1007,Eyeshadow,200,400,200,1,00437,India
793551,2023-03-18,1004,Eyeliner,100,200,100,1,00428,India
793551,2023-03-18,1003,Foundation,300,600,300,1,00428,India
793551,2023-03-18,1006,Blush,150,300,150,1,00428,India
295993,2023-03-18,1012,Body Lotion,200,400,200,1,00407,India
295993,2023-03-18,1002,Mascara,200,400,200,1,00407,India
295993,2023-03-18,1003,Foundation,300,600,300,1,00407,India
360988,2023-03-18,1002,Mascara,200,400,200,1,00064,India
360988,2023-03-18,1003,Foundation,300,600,300,1,00064,India
360988,2023-03-18,1006,Blush,150,300,150,1,00064,India
360988,2023-03-18,1009,Moisturizer,250,500,250,1,00064,India
829181,2023-03-18,1003,Foundation,300,600,300,1,00170,India
411272,2023-03-18,1002,Mascara,200,400,200,1,00067,India
411272,2023-03-18,1006,Blush,150,300,150,1,00067,India
598217,2023-03-18,1006,Blush,150,300,150,1,00092,India
598217,2023-03-18,1005,Nail Polish,50,100,50,1,00092,India
583977,2023-03-18,1005,Nail Polish,50,100,50,1,00255,India
777054,2023-03-18,1012,Body Lotion,200,400,200,1,00150,India
777054,2023-03-18,1006,Blush,150,300,150,1,00150,India
777054,2023-03-18,1009,Moisturizer,250,500,250,1,00150,India
777054,2023-03-18,1005,Nail Polish,50,100,50,1,00150,India
147114,2023-03-18,1012,Body Lotion,200,400,200,1,00105,India
147114,2023-03-18,1002,Mascara,200,400,200,1,00105,India
697398,2023-03-18,1003,Foundation,300,600,300,1,00127,India
483743,2023-03-18,1008,Makeup Remover,80,160,80,1,00278,India
483743,2023-03-18,1006,Blush,150,300,150,1,00278,India
372175,2023-03-18,1002,Mascara,200,400,200,1,00311,India
372175,2023-03-18,1007,Eyeshadow,200,400,200,1,00311,India
533923,2023-03-18,1003,Foundation,300,600,300,1,00230,India
759364,2023-03-18,1002,Mascara,200,400,200,1,00035,India
759364,2023-03-18,1005,Nail Polish,50,100,50,1,00035,India
759364,2023-03-18,1009,Moisturizer,250,500,250,1,00035,India
965676,2023-03-18,1003,Foundation,300,600,300,1,00491,India
965676,2023-03-18,1002,Mascara,200,400,200,1,00491,India
729131,2023-03-18,1002,Mascara,200,400,200,1,00300,India
729131,2023-03-18,1003,Foundation,300,600,300,1,00300,India
729131,2023-03-18,1009,Moisturizer,250,500,250,1,00300,India
729131,2023-03-18,1005,Nail Polish,50,100,50,1,00300,India
729131,2023-03-18,1001,Lipstick,150,300,150,1,00300,India
403039,2023-03-18,1002,Mascara,200,400,200,1,00428,India
403039,2023-03-18,1001,Lipstick,150,300,150,1,00428,India
554729,2023-03-18,1008,Makeup Remover,80,160,80,1,00371,India
554729,2023-03-18,1002,Mascara,200,400,200,1,00371,India
554729,2023-03-18,1009,Moisturizer,250,500,250,1,00371,India
554729,2023-03-18,1012,Body Lotion,200,400,200,1,00371,India
127954,2023-03-18,1006,Blush,150,300,150,1,00490,India
127954,2023-03-18,1008,Makeup Remover,80,160,80,1,00490,India
127954,2023-03-18,1003,Foundation,300,600,300,1,00490,India
127954,2023-03-18,1004,Eyeliner,100,200,100,1,00490,India
289254,2023-03-18,1012,Body Lotion,200,400,200,1,00262,India
793401,2023-03-18,1004,Eyeliner,100,200,100,1,00084,India
614067,2023-03-18,1005,Nail Polish,50,100,50,1,00127,India
614067,2023-03-18,1008,Makeup Remover,80,160,80,1,00127,India
614067,2023-03-18,1012,Body Lotion,200,400,200,1,00127,India
438669,2023-03-18,1007,Eyeshadow,200,400,200,1,00437,India
438669,2023-03-18,1009,Moisturizer,250,500,250,1,00437,India
438669,2023-03-18,1012,Body Lotion,200,400,200,1,00437,India
374529,2023-03-18,1008,Makeup Remover,80,160,80,1,00323,India
347978,2023-03-18,1003,Foundation,300,600,300,1,00237,India
709795,2023-03-18,1004,Eyeliner,100,200,100,1,00471,India
709795,2023-03-18,1006,Blush,150,300,150,1,00471,India
709795,2023-03-18,1005,Nail Polish,50,100,50,1,00471,India
709795,2023-03-18,1003,Foundation,300,600,300,1,00471,India
756006,2023-03-18,1003,Foundation,300,600,300,1,00393,India
756006,2023-03-18,1001,Lipstick,150,300,150,1,00393,India
756006,2023-03-18,1002,Mascara,200,400,200,1,00393,India
756006,2023-03-18,1007,Eyeshadow,200,400,200,1,00393,India
829266,2023-03-18,1008,Makeup Remover,80,160,80,1,00047,India
829266,2023-03-18,1012,Body Lotion,200,400,200,1,00047,India
829266,2023-03-18,1004,Eyeliner,100,200,100,1,00047,India
929038,2023-03-18,1008,Makeup Remover,80,160,80,1,00350,India
929038,2023-03-18,1004,Eyeliner,100,200,100,1,00350,India
929038,2023-03-18,1006,Blush,150,300,150,1,00350,India
929038,2023-03-18,1009,Moisturizer,250,500,250,1,00350,India
305763,2023-03-18,1012,Body Lotion,200,400,200,1,00067,India
372607,2023-03-18,1002,Mascara,200,400,200,1,00312,India
372607,2023-03-18,1005,Nail Polish,50,100,50,1,00312,India
372607,2023-03-18,1012,Body Lotion,200,400,200,1,00312,India
372607,2023-03-18,1009,Moisturizer,250,500,250,1,00312,India
915065,2023-03-18,1009,Moisturizer,250,500,250,1,00145,India
915065,2023-03-18,1006,Blush,150,300,150,1,00145,India
915065,2023-03-18,1012,Body Lotion,200,400,200,1,00145,India
234823,2023-03-18,1006,Blush,150,300,150,1,00418,India
487540,2023-03-18,1006,Blush,150,300,150,1,00229,India
487540,2023-03-18,1002,Mascara,200,400,200,1,00229,India
177188,2023-03-18,1007,Eyeshadow,200,400,200,1,00495,India
177188,2023-03-18,1003,Foundation,300,600,300,1,00495,India
177188,2023-03-18,1009,Moisturizer,250,500,250,1,00495,India
177188,2023-03-18,1006,Blush,150,300,150,1,00495,India
177188,2023-03-18,1001,Lipstick,150,300,150,1,00495,India
728277,2023-03-18,1005,Nail Polish,50,100,50,1,00292,India
728277,2023-03-18,1008,Makeup Remover,80,160,80,1,00292,India
728277,2023-03-18,1012,Body Lotion,200,400,200,1,00292,India
728277,2023-03-18,1003,Foundation,300,600,300,1,00292,India
272079,2023-03-18,1001,Lipstick,150,300,150,1,00492,India
272079,2023-03-18,1003,Foundation,300,600,300,1,00492,India
272079,2023-03-18,1009,Moisturizer,250,500,250,1,00492,India
272079,2023-03-18,1008,Makeup Remover,80,160,80,1,00492,India
272079,2023-03-18,1006,Blush,150,300,150,1,00492,India
332514,2023-03-18,1007,Eyeshadow,200,400,200,1,00081,India
188516,2023-03-18,1006,Blush,150,300,150,1,00132,India
221494,2023-03-19,1009,Moisturizer,250,500,250,1,00178,India
221494,2023-03-19,1004,Eyeliner,100,200,100,1,00178,India
221494,2023-03-19,1002,Mascara,200,400,200,1,00178,India
221494,2023-03-19,1012,Body Lotion,200,400,200,1,00178,India
221494,2023-03-19,1006,Blush,150,300,150,1,00178,India
597026,2023-03-19,1006,Blush,150,300,150,1,00402,India
597026,2023-03-19,1005,Nail Polish,50,100,50,1,00402,India
761246,2023-03-19,1001,Lipstick,150,300,150,1,00070,India
335546,2023-03-19,1006,Blush,150,300,150,1,00075,India
335546,2023-03-19,1005,Nail Polish,50,100,50,1,00075,India
335546,2023-03-19,1002,Mascara,200,400,200,1,00075,India
335546,2023-03-19,1009,Moisturizer,250,500,250,1,00075,India
335546,2023-03-19,1008,Makeup Remover,80,160,80,1,00075,India
699891,2023-03-19,1004,Eyeliner,100,200,100,1,00288,India
689139,2023-03-19,1012,Body Lotion,200,400,200,1,00016,India
689139,2023-03-19,1004,Eyeliner,100,200,100,1,00016,India
689139,2023-03-19,1006,Blush,150,300,150,1,00016,India
689139,2023-03-19,1005,Nail Polish,50,100,50,1,00016,India
274912,2023-03-19,1002,Mascara,200,400,200,1,00106,India
274912,2023-03-19,1003,Foundation,300,600,300,1,00106,India
274912,2023-03-19,1009,Moisturizer,250,500,250,1,00106,India
274912,2023-03-19,1001,Lipstick,150,300,150,1,00106,India
228644,2023-03-19,1009,Moisturizer,250,500,250,1,00095,India
689894,2023-03-19,1009,Moisturizer,250,500,250,1,00341,India
689894,2023-03-19,1003,Foundation,300,600,300,1,00341,India
689894,2023-03-19,1002,Mascara,200,400,200,1,00341,India
689894,2023-03-19,1006,Blush,150,300,150,1,00341,India
331988,2023-03-19,1009,Moisturizer,250,500,250,1,00153,India
331988,2023-03-19,1012,Body Lotion,200,400,200,1,00153,India
331988,2023-03-19,1006,Blush,150,300,150,1,00153,India
290651,2023-03-19,1002,Mascara,200,400,200,1,00135,India
290651,2023-03-19,1004,Eyeliner,100,200,100,1,00135,India
290651,2023-03-19,1009,Moisturizer,250,500,250,1,00135,India
290651,2023-03-19,1012,Body Lotion,200,400,200,1,00135,India
895553,2023-03-19,1004,Eyeliner,100,200,100,1,00242,India
895553,2023-03-19,1007,Eyeshadow,200,400,200,1,00242,India
895553,2023-03-19,1003,Foundation,300,600,300,1,00242,India
116516,2023-03-19,1006,Blush,150,300,150,1,00121,India
642260,2023-03-19,1005,Nail Polish,50,100,50,1,00267,India
642260,2023-03-19,1004,Eyeliner,100,200,100,1,00267,India
454317,2023-03-19,1012,Body Lotion,200,400,200,1,00491,India
454317,2023-03-19,1005,Nail Polish,50,100,50,1,00491,India
415055,2023-03-19,1003,Foundation,300,600,300,1,00219,India
415055,2023-03-19,1006,Blush,150,300,150,1,00219,India
263163,2023-03-19,1005,Nail Polish,50,100,50,1,00036,India
957487,2023-03-19,1007,Eyeshadow,200,400,200,1,00164,India
957487,2023-03-19,1008,Makeup Remover,80,160,80,1,00164,India
957487,2023-03-19,1005,Nail Polish,50,100,50,1,00164,India
612859,2023-03-19,1012,Body Lotion,200,400,200,1,00278,India
612859,2023-03-19,1009,Moisturizer,250,500,250,1,00278,India
612859,2023-03-19,1006,Blush,150,300,150,1,00278,India
612859,2023-03-19,1003,Foundation,300,600,300,1,00278,India
999200,2023-03-19,1004,Eyeliner,100,200,100,1,00155,India
999200,2023-03-19,1002,Mascara,200,400,200,1,00155,India
999200,2023-03-19,1009,Moisturizer,250,500,250,1,00155,India
999200,2023-03-19,1007,Eyeshadow,200,400,200,1,00155,India
609731,2023-03-19,1002,Mascara,200,400,200,1,00062,India
609731,2023-03-19,1005,Nail Polish,50,100,50,1,00062,India
609731,2023-03-19,1008,Makeup Remover,80,160,80,1,00062,India
646572,2023-03-19,1003,Foundation,300,600,300,1,00281,India
278645,2023-03-19,1003,Foundation,300,600,300,1,00288,India
278645,2023-03-19,1005,Nail Polish,50,100,50,1,00288,India
613027,2023-03-19,1006,Blush,150,300,150,1,00292,India
613027,2023-03-19,1004,Eyeliner,100,200,100,1,00292,India
613027,2023-03-19,1009,Moisturizer,250,500,250,1,00292,India
731761,2023-03-19,1007,Eyeshadow,200,400,200,1,00317,India
731761,2023-03-19,1008,Makeup Remover,80,160,80,1,00317,India
731761,2023-03-19,1006,Blush,150,300,150,1,00317,India
731761,2023-03-19,1005,Nail Polish,50,100,50,1,00317,India
731761,2023-03-19,1003,Foundation,300,600,300,1,00317,India
848335,2023-03-19,1006,Blush,150,300,150,1,00215,India
848335,2023-03-19,1012,Body Lotion,200,400,200,1,00215,India
848335,2023-03-19,1002,Mascara,200,400,200,1,00215,India
116821,2023-03-19,1003,Foundation,300,600,300,1,00296,India
116821,2023-03-19,1001,Lipstick,150,300,150,1,00296,India
417637,2023-03-19,1007,Eyeshadow,200,400,200,1,00183,India
417637,2023-03-19,1003,Foundation,300,600,300,1,00183,India
601077,2023-03-19,1004,Eyeliner,100,200,100,1,00452,India
601077,2023-03-19,1009,Moisturizer,250,500,250,1,00452,India
991035,2023-03-19,1006,Blush,150,300,150,1,00164,India
991035,2023-03-19,1008,Makeup Remover,80,160,80,1,00164,India
991035,2023-03-19,1002,Mascara,200,400,200,1,00164,India
991035,2023-03-19,1003,Foundation,300,600,300,1,00164,India
530375,2023-03-20,1008,Makeup Remover,80,160,80,1,00296,India
530375,2023-03-20,1001,Lipstick,150,300,150,1,00296,India
530375,2023-03-20,1004,Eyeliner,100,200,100,1,00296,India
794302,2023-03-20,1007,Eyeshadow,200,400,200,1,00037,India
794302,2023-03-20,1001,Lipstick,150,300,150,1,00037,India
794302,2023-03-20,1006,Blush,150,300,150,1,00037,India
794302,2023-03-20,1008,Makeup Remover,80,160,80,1,00037,India
140604,2023-03-20,1012,Body Lotion,200,400,200,1,00080,India
140604,2023-03-20,1008,Makeup Remover,80,160,80,1,00080,India
403824,2023-03-20,1009,Moisturizer,250,500,250,1,00342,India
403824,2023-03-20,1002,Mascara,200,400,200,1,00342,India
403824,2023-03-20,1003,Foundation,300,600,300,1,00342,India
716796,2023-03-20,1002,Mascara,200,400,200,1,00430,India
418952,2023-03-20,1005,Nail Polish,50,100,50,1,00451,India
418952,2023-03-20,1006,Blush,150,300,150,1,00451,India
418952,2023-03-20,1004,Eyeliner,100,200,100,1,00451,India
205888,2023-03-20,1003,Foundation,300,600,300,1,00371,India
205888,2023-03-20,1001,Lipstick,150,300,150,1,00371,India
205888,2023-03-20,1012,Body Lotion,200,400,200,1,00371,India
321918,2023-03-20,1005,Nail Polish,50,100,50,1,00179,India
321918,2023-03-20,1001,Lipstick,150,300,150,1,00179,India
321918,2023-03-20,1009,Moisturizer,250,500,250,1,00179,India
321918,2023-03-20,1007,Eyeshadow,200,400,200,1,00179,India
321918,2023-03-20,1003,Foundation,300,600,300,1,00179,India
956935,2023-03-20,1001,Lipstick,150,300,150,1,00257,India
956935,2023-03-20,1007,Eyeshadow,200,400,200,1,00257,India
340960,2023-03-20,1007,Eyeshadow,200,400,200,1,00389,India
340960,2023-03-20,1012,Body Lotion,200,400,200,1,00389,India
340960,2023-03-20,1009,Moisturizer,250,500,250,1,00389,India
340960,2023-03-20,1001,Lipstick,150,300,150,1,00389,India
262484,2023-03-20,1007,Eyeshadow,200,400,200,1,00219,India
262484,2023-03-20,1001,Lipstick,150,300,150,1,00219,India
262484,2023-03-20,1009,Moisturizer,250,500,250,1,00219,India
262484,2023-03-20,1012,Body Lotion,200,400,200,1,00219,India
645228,2023-03-20,1008,Makeup Remover,80,160,80,1,00034,India
645228,2023-03-20,1012,Body Lotion,200,400,200,1,00034,India
645228,2023-03-20,1007,Eyeshadow,200,400,200,1,00034,India
645228,2023-03-20,1004,Eyeliner,100,200,100,1,00034,India
597208,2023-03-20,1008,Makeup Remover,80,160,80,1,00480,India
597208,2023-03-20,1003,Foundation,300,600,300,1,00480,India
728125,2023-03-20,1007,Eyeshadow,200,400,200,1,00446,India
728125,2023-03-20,1005,Nail Polish,50,100,50,1,00446,India
728125,2023-03-20,1003,Foundation,300,600,300,1,00446,India
728125,2023-03-20,1002,Mascara,200,400,200,1,00446,India
668214,2023-03-20,1008,Makeup Remover,80,160,80,1,00307,India
668214,2023-03-20,1002,Mascara,200,400,200,1,00307,India
668214,2023-03-20,1003,Foundation,300,600,300,1,00307,India
611843,2023-03-20,1004,Eyeliner,100,200,100,1,00399,India
611843,2023-03-20,1008,Makeup Remover,80,160,80,1,00399,India
382407,2023-03-20,1006,Blush,150,300,150,1,00260,India
634786,2023-03-20,1005,Nail Polish,50,100,50,1,00264,India
634786,2023-03-20,1001,Lipstick,150,300,150,1,00264,India
849657,2023-03-20,1003,Foundation,300,600,300,1,00010,India
849657,2023-03-20,1005,Nail Polish,50,100,50,1,00010,India
249597,2023-03-20,1009,Moisturizer,250,500,250,1,00407,India
240719,2023-03-20,1012,Body Lotion,200,400,200,1,00455,India
240719,2023-03-20,1002,Mascara,200,400,200,1,00455,India
240719,2023-03-20,1005,Nail Polish,50,100,50,1,00455,India
240719,2023-03-20,1009,Moisturizer,250,500,250,1,00455,India
923478,2023-03-20,1007,Eyeshadow,200,400,200,1,00362,India
923478,2023-03-20,1005,Nail Polish,50,100,50,1,00362,India
923478,2023-03-20,1008,Makeup Remover,80,160,80,1,00362,India
923478,2023-03-20,1009,Moisturizer,250,500,250,1,00362,India
121146,2023-03-20,1005,Nail Polish,50,100,50,1,00107,India
121146,2023-03-20,1003,Foundation,300,600,300,1,00107,India
314587,2023-03-20,1012,Body Lotion,200,400,200,1,00270,India
314587,2023-03-20,1001,Lipstick,150,300,150,1,00270,India
382270,2023-03-20,1004,Eyeliner,100,200,100,1,00027,India
382270,2023-03-20,1009,Moisturizer,250,500,250,1,00027,India
324765,2023-03-20,1005,Nail Polish,50,100,50,1,00153,India
324765,2023-03-20,1008,Makeup Remover,80,160,80,1,00153,India
354345,2023-03-20,1009,Moisturizer,250,500,250,1,00165,India
354345,2023-03-20,1006,Blush,150,300,150,1,00165,India
354345,2023-03-20,1001,Lipstick,150,300,150,1,00165,India
354345,2023-03-20,1005,Nail Polish,50,100,50,1,00165,India
350852,2023-03-20,1006,Blush,150,300,150,1,00043,India
350852,2023-03-20,1004,Eyeliner,100,200,100,1,00043,India
536931,2023-03-20,1005,Nail Polish,50,100,50,1,00210,India
899565,2023-03-20,1002,Mascara,200,400,200,1,00023,India
899565,2023-03-20,1005,Nail Polish,50,100,50,1,00023,India
899565,2023-03-20,1003,Foundation,300,600,300,1,00023,India
899565,2023-03-20,1008,Makeup Remover,80,160,80,1,00023,India
216710,2023-03-20,1008,Makeup Remover,80,160,80,1,00493,India
893825,2023-03-20,1004,Eyeliner,100,200,100,1,00185,India
611307,2023-03-20,1007,Eyeshadow,200,400,200,1,00386,India
494347,2023-03-20,1012,Body Lotion,200,400,200,1,00098,India
494347,2023-03-20,1006,Blush,150,300,150,1,00098,India
494347,2023-03-20,1007,Eyeshadow,200,400,200,1,00098,India
494347,2023-03-20,1003,Foundation,300,600,300,1,00098,India
753336,2023-03-20,1005,Nail Polish,50,100,50,1,00481,India
753336,2023-03-20,1004,Eyeliner,100,200,100,1,00481,India
753336,2023-03-20,1008,Makeup Remover,80,160,80,1,00481,India
753336,2023-03-20,1002,Mascara,200,400,200,1,00481,India
220744,2023-03-20,1005,Nail Polish,50,100,50,1,00260,India
220744,2023-03-20,1007,Eyeshadow,200,400,200,1,00260,India
559683,2023-03-20,1008,Makeup Remover,80,160,80,1,00077,India
559683,2023-03-20,1009,Moisturizer,250,500,250,1,00077,India
559683,2023-03-20,1006,Blush,150,300,150,1,00077,India
485004,2023-03-20,1006,Blush,150,300,150,1,00146,India
485004,2023-03-20,1002,Mascara,200,400,200,1,00146,India
485004,2023-03-20,1012,Body Lotion,200,400,200,1,00146,India
485004,2023-03-20,1005,Nail Polish,50,100,50,1,00146,India
485004,2023-03-20,1009,Moisturizer,250,500,250,1,00146,India
682601,2023-03-20,1002,Mascara,200,400,200,1,00102,India
682601,2023-03-20,1006,Blush,150,300,150,1,00102,India
682601,2023-03-20,1001,Lipstick,150,300,150,1,00102,India
949087,2023-03-20,1003,Foundation,300,600,300,1,00044,India
949087,2023-03-20,1009,Moisturizer,250,500,250,1,00044,India
949087,2023-03-20,1004,Eyeliner,100,200,100,1,00044,India
949087,2023-03-20,1002,Mascara,200,400,200,1,00044,India
895810,2023-03-20,1005,Nail Polish,50,100,50,1,00396,India
895810,2023-03-20,1003,Foundation,300,600,300,1,00396,India
895810,2023-03-20,1006,Blush,150,300,150,1,00396,India
895810,2023-03-20,1004,Eyeliner,100,200,100,1,00396,India
232340,2023-03-20,1006,Blush,150,300,150,1,00076,India
232340,2023-03-20,1002,Mascara,200,400,200,1,00076,India
232340,2023-03-20,1004,Eyeliner,100,200,100,1,00076,India
232340,2023-03-20,1007,Eyeshadow,200,400,200,1,00076,India
397369,2023-03-20,1002,Mascara,200,400,200,1,00182,India
397369,2023-03-20,1006,Blush,150,300,150,1,00182,India
397369,2023-03-20,1004,Eyeliner,100,200,100,1,00182,India
869958,2023-03-20,1006,Blush,150,300,150,1,00023,India
759939,2023-03-20,1009,Moisturizer,250,500,250,1,00156,India
759939,2023-03-20,1008,Makeup Remover,80,160,80,1,00156,India
759939,2023-03-20,1003,Foundation,300,600,300,1,00156,India
759939,2023-03-20,1004,Eyeliner,100,200,100,1,00156,India
981546,2023-03-20,1005,Nail Polish,50,100,50,1,00034,India
327246,2023-03-21,1004,Eyeliner,100,200,100,1,00181,India
327246,2023-03-21,1009,Moisturizer,250,500,250,1,00181,India
120252,2023-03-21,1007,Eyeshadow,200,400,200,1,00379,India
120252,2023-03-21,1004,Eyeliner,100,200,100,1,00379,India
662174,2023-03-21,1009,Moisturizer,250,500,250,1,00184,India
662174,2023-03-21,1004,Eyeliner,100,200,100,1,00184,India
425262,2023-03-21,1003,Foundation,300,600,300,1,00435,India
425262,2023-03-21,1005,Nail Polish,50,100,50,1,00435,India
690300,2023-03-21,1001,Lipstick,150,300,150,1,00322,India
690300,2023-03-21,1006,Blush,150,300,150,1,00322,India
690300,2023-03-21,1009,Moisturizer,250,500,250,1,00322,India
624019,2023-03-21,1006,Blush,150,300,150,1,00374,India
624019,2023-03-21,1007,Eyeshadow,200,400,200,1,00374,India
534224,2023-03-21,1005,Nail Polish,50,100,50,1,00011,India
340752,2023-03-21,1003,Foundation,300,600,300,1,00004,India
340752,2023-03-21,1009,Moisturizer,250,500,250,1,00004,India
909733,2023-03-21,1002,Mascara,200,400,200,1,00149,India
909733,2023-03-21,1008,Makeup Remover,80,160,80,1,00149,India
909733,2023-03-21,1001,Lipstick,150,300,150,1,00149,India
909733,2023-03-21,1012,Body Lotion,200,400,200,1,00149,India
950277,2023-03-21,1002,Mascara,200,400,200,1,00488,India
950277,2023-03-21,1009,Moisturizer,250,500,250,1,00488,India
950277,2023-03-21,1004,Eyeliner,100,200,100,1,00488,India
950277,2023-03-21,1007,Eyeshadow,200,400,200,1,00488,India
236076,2023-03-21,1009,Moisturizer,250,500,250,1,00019,India
851030,2023-03-21,1009,Moisturizer,250,500,250,1,00286,India
851030,2023-03-21,1012,Body Lotion,200,400,200,1,00286,India
424295,2023-03-21,1005,Nail Polish,50,100,50,1,00126,India
424295,2023-03-21,1009,Moisturizer,250,500,250,1,00126,India
297838,2023-03-21,1008,Makeup Remover,80,160,80,1,00278,India
297838,2023-03-21,1002,Mascara,200,400,200,1,00278,India
297838,2023-03-21,1012,Body Lotion,200,400,200,1,00278,India
330569,2023-03-21,1008,Makeup Remover,80,160,80,1,00125,India
330569,2023-03-21,1005,Nail Polish,50,100,50,1,00125,India
512322,2023-03-21,1002,Mascara,200,400,200,1,00476,India
512322,2023-03-21,1003,Foundation,300,600,300,1,00476,India
512322,2023-03-21,1001,Lipstick,150,300,150,1,00476,India
160007,2023-03-21,1001,Lipstick,150,300,150,1,00420,India
160007,2023-03-21,1009,Moisturizer,250,500,250,1,00420,India
160007,2023-03-21,1004,Eyeliner,100,200,100,1,00420,India
160007,2023-03-21,1007,Eyeshadow,200,400,200,1,00420,India
850526,2023-03-21,1002,Mascara,200,400,200,1,00398,India
850526,2023-03-21,1006,Blush,150,300,150,1,00398,India
850526,2023-03-21,1005,Nail Polish,50,100,50,1,00398,India
850526,2023-03-21,1009,Moisturizer,250,500,250,1,00398,India
415133,2023-03-21,1012,Body Lotion,200,400,200,1,00200,India
415133,2023-03-21,1002,Mascara,200,400,200,1,00200,India
415133,2023-03-21,1009,Moisturizer,250,500,250,1,00200,India
438227,2023-03-21,1007,Eyeshadow,200,400,200,1,00491,India
102941,2023-03-21,1001,Lipstick,150,300,150,1,00309,India
102941,2023-03-21,1002,Mascara,200,400,200,1,00309,India
102941,2023-03-21,1012,Body Lotion,200,400,200,1,00309,India
501930,2023-03-21,1005,Nail Polish,50,100,50,1,00023,India
159643,2023-03-21,1008,Makeup Remover,80,160,80,1,00439,India
159643,2023-03-21,1004,Eyeliner,100,200,100,1,00439,India
159643,2023-03-21,1009,Moisturizer,250,500,250,1,00439,India
159643,2023-03-21,1007,Eyeshadow,200,400,200,1,00439,India
255347,2023-03-21,1003,Foundation,300,600,300,1,00317,India
629116,2023-03-21,1009,Moisturizer,250,500,250,1,00081,India
629116,2023-03-21,1006,Blush,150,300,150,1,00081,India
629116,2023-03-21,1008,Makeup Remover,80,160,80,1,00081,India
351154,2023-03-21,1008,Makeup Remover,80,160,80,1,00500,India
351154,2023-03-21,1006,Blush,150,300,150,1,00500,India
738848,2023-03-21,1012,Body Lotion,200,400,200,1,00401,India
738848,2023-03-21,1003,Foundation,300,600,300,1,00401,India
741319,2023-03-21,1009,Moisturizer,250,500,250,1,00236,India
561583,2023-03-21,1008,Makeup Remover,80,160,80,1,00128,India
561583,2023-03-21,1005,Nail Polish,50,100,50,1,00128,India
561583,2023-03-21,1003,Foundation,300,600,300,1,00128,India
561583,2023-03-21,1006,Blush,150,300,150,1,00128,India
704332,2023-03-21,1005,Nail Polish,50,100,50,1,00185,India
704332,2023-03-21,1002,Mascara,200,400,200,1,00185,India
704332,2023-03-21,1012,Body Lotion,200,400,200,1,00185,India
704332,2023-03-21,1009,Moisturizer,250,500,250,1,00185,India
497795,2023-03-21,1001,Lipstick,150,300,150,1,00115,India
497795,2023-03-21,1006,Blush,150,300,150,1,00115,India
497795,2023-03-21,1003,Foundation,300,600,300,1,00115,India
939380,2023-03-21,1007,Eyeshadow,200,400,200,1,00179,India
939380,2023-03-21,1008,Makeup Remover,80,160,80,1,00179,India
939380,2023-03-21,1002,Mascara,200,400,200,1,00179,India
481604,2023-03-21,1003,Foundation,300,600,300,1,00477,India
481604,2023-03-21,1009,Moisturizer,250,500,250,1,00477,India
858903,2023-03-21,1008,Makeup Remover,80,160,80,1,00390,India
858903,2023-03-21,1001,Lipstick,150,300,150,1,00390,India
858903,2023-03-21,1006,Blush,150,300,150,1,00390,India
539115,2023-03-21,1006,Blush,150,300,150,1,00257,India
539115,2023-03-21,1009,Moisturizer,250,500,250,1,00257,India
169491,2023-03-21,1007,Eyeshadow,200,400,200,1,00170,India
169491,2023-03-21,1005,Nail Polish,50,100,50,1,00170,India
169491,2023-03-21,1004,Eyeliner,100,200,100,1,00170,India
169491,2023-03-21,1003,Foundation,300,600,300,1,00170,India
553436,2023-03-21,1005,Nail Polish,50,100,50,1,00345,India
553436,2023-03-21,1004,Eyeliner,100,200,100,1,00345,India
553436,2023-03-21,1009,Moisturizer,250,500,250,1,00345,India
553436,2023-03-21,1002,Mascara,200,400,200,1,00345,India
562485,2023-03-22,1001,Lipstick,150,300,150,1,00432,India
563274,2023-03-22,1003,Foundation,300,600,300,1,00028,India
282809,2023-03-22,1006,Blush,150,300,150,1,00453,India
282809,2023-03-22,1008,Makeup Remover,80,160,80,1,00453,India
282809,2023-03-22,1009,Moisturizer,250,500,250,1,00453,India
888086,2023-03-22,1005,Nail Polish,50,100,50,1,00141,India
702226,2023-03-22,1007,Eyeshadow,200,400,200,1,00144,India
702226,2023-03-22,1006,Blush,150,300,150,1,00144,India
702226,2023-03-22,1001,Lipstick,150,300,150,1,00144,India
702226,2023-03-22,1012,Body Lotion,200,400,200,1,00144,India
544820,2023-03-22,1008,Makeup Remover,80,160,80,1,00192,India
544820,2023-03-22,1001,Lipstick,150,300,150,1,00192,India
544820,2023-03-22,1004,Eyeliner,100,200,100,1,00192,India
717343,2023-03-22,1006,Blush,150,300,150,1,00490,India
717343,2023-03-22,1002,Mascara,200,400,200,1,00490,India
717343,2023-03-22,1005,Nail Polish,50,100,50,1,00490,India
717343,2023-03-22,1008,Makeup Remover,80,160,80,1,00490,India
717343,2023-03-22,1009,Moisturizer,250,500,250,1,00490,India
373059,2023-03-22,1001,Lipstick,150,300,150,1,00176,India
373059,2023-03-22,1004,Eyeliner,100,200,100,1,00176,India
373059,2023-03-22,1012,Body Lotion,200,400,200,1,00176,India
807242,2023-03-22,1008,Makeup Remover,80,160,80,1,00321,India
807242,2023-03-22,1001,Lipstick,150,300,150,1,00321,India
807242,2023-03-22,1009,Moisturizer,250,500,250,1,00321,India
807242,2023-03-22,1004,Eyeliner,100,200,100,1,00321,India
347897,2023-03-22,1006,Blush,150,300,150,1,00016,India
347897,2023-03-22,1005,Nail Polish,50,100,50,1,00016,India
347897,2023-03-22,1003,Foundation,300,600,300,1,00016,India
347897,2023-03-22,1007,Eyeshadow,200,400,200,1,00016,India
845682,2023-03-22,1007,Eyeshadow,200,400,200,1,00468,India
845682,2023-03-22,1009,Moisturizer,250,500,250,1,00468,India
845682,2023-03-22,1001,Lipstick,150,300,150,1,00468,India
845682,2023-03-22,1008,Makeup Remover,80,160,80,1,00468,India
845682,2023-03-22,1006,Blush,150,300,150,1,00468,India
406151,2023-03-22,1007,Eyeshadow,200,400,200,1,00409,India
406151,2023-03-22,1006,Blush,150,300,150,1,00409,India
314450,2023-03-22,1012,Body Lotion,200,400,200,1,00240,India
314450,2023-03-22,1004,Eyeliner,100,200,100,1,00240,India
673560,2023-03-22,1009,Moisturizer,250,500,250,1,00119,India
673560,2023-03-22,1008,Makeup Remover,80,160,80,1,00119,India
673560,2023-03-22,1003,Foundation,300,600,300,1,00119,India
808236,2023-03-22,1009,Moisturizer,250,500,250,1,00061,India
188135,2023-03-22,1008,Makeup Remover,80,160,80,1,00344,India
188135,2023-03-22,1006,Blush,150,300,150,1,00344,India
996350,2023-03-22,1009,Moisturizer,250,500,250,1,00270,India
920254,2023-03-22,1005,Nail Polish,50,100,50,1,00163,India
920254,2023-03-22,1004,Eyeliner,100,200,100,1,00163,India
920254,2023-03-22,1001,Lipstick,150,300,150,1,00163,India
920254,2023-03-22,1008,Makeup Remover,80,160,80,1,00163,India
666819,2023-03-22,1012,Body Lotion,200,400,200,1,00181,India
666819,2023-03-22,1009,Moisturizer,250,500,250,1,00181,India
666819,2023-03-22,1001,Lipstick,150,300,150,1,00181,India
792833,2023-03-22,1008,Makeup Remover,80,160,80,1,00161,India
792833,2023-03-22,1002,Mascara,200,400,200,1,00161,India
240572,2023-03-22,1004,Eyeliner,100,200,100,1,00304,India
240572,2023-03-22,1008,Makeup Remover,80,160,80,1,00304,India
240572,2023-03-22,1009,Moisturizer,250,500,250,1,00304,India
240572,2023-03-22,1012,Body Lotion,200,400,200,1,00304,India
668467,2023-03-22,1003,Foundation,300,600,300,1,00243,India
668467,2023-03-22,1002,Mascara,200,400,200,1,00243,India
668467,2023-03-22,1008,Makeup Remover,80,160,80,1,00243,India
197824,2023-03-22,1002,Mascara,200,400,200,1,00242,India
197824,2023-03-22,1005,Nail Polish,50,100,50,1,00242,India
197824,2023-03-22,1004,Eyeliner,100,200,100,1,00242,India
197824,2023-03-22,1006,Blush,150,300,150,1,00242,India
605680,2023-03-22,1005,Nail Polish,50,100,50,1,00171,India
605680,2023-03-22,1008,Makeup Remover,80,160,80,1,00171,India
820027,2023-03-22,1002,Mascara,200,400,200,1,00468,India
820027,2023-03-22,1006,Blush,150,300,150,1,00468,India
569983,2023-03-22,1001,Lipstick,150,300,150,1,00456,India
569983,2023-03-22,1005,Nail Polish,50,100,50,1,00456,India
569983,2023-03-22,1003,Foundation,300,600,300,1,00456,India
776069,2023-03-22,1007,Eyeshadow,200,400,200,1,00365,India
776069,2023-03-22,1002,Mascara,200,400,200,1,00365,India
776069,2023-03-22,1004,Eyeliner,100,200,100,1,00365,India
133843,2023-03-22,1007,Eyeshadow,200,400,200,1,00044,India
133843,2023-03-22,1005,Nail Polish,50,100,50,1,00044,India
925183,2023-03-22,1007,Eyeshadow,200,400,200,1,00259,India
788042,2023-03-22,1003,Foundation,300,600,300,1,00067,India
788042,2023-03-22,1005,Nail Polish,50,100,50,1,00067,India
788042,2023-03-22,1008,Makeup Remover,80,160,80,1,00067,India
358906,2023-03-22,1001,Lipstick,150,300,150,1,00015,India
358906,2023-03-22,1012,Body Lotion,200,400,200,1,00015,India
537713,2023-03-22,1003,Foundation,300,600,300,1,00108,India
537713,2023-03-22,1008,Makeup Remover,80,160,80,1,00108,India
460423,2023-03-22,1007,Eyeshadow,200,400,200,1,00274,India
460423,2023-03-22,1009,Moisturizer,250,500,250,1,00274,India
460423,2023-03-22,1004,Eyeliner,100,200,100,1,00274,India
460423,2023-03-22,1006,Blush,150,300,150,1,00274,India
247807,2023-03-22,1001,Lipstick,150,300,150,1,00191,India
247807,2023-03-22,1009,Moisturizer,250,500,250,1,00191,India
247807,2023-03-22,1003,Foundation,300,600,300,1,00191,India
903758,2023-03-22,1003,Foundation,300,600,300,1,00465,India
903758,2023-03-22,1005,Nail Polish,50,100,50,1,00465,India
530197,2023-03-23,1001,Lipstick,150,300,150,1,00475,India
530197,2023-03-23,1009,Moisturizer,250,500,250,1,00475,India
926631,2023-03-23,1001,Lipstick,150,300,150,1,00442,India
926631,2023-03-23,1002,Mascara,200,400,200,1,00442,India
967616,2023-03-23,1004,Eyeliner,100,200,100,1,00289,India
967616,2023-03-23,1009,Moisturizer,250,500,250,1,00289,India
967616,2023-03-23,1012,Body Lotion,200,400,200,1,00289,India
967616,2023-03-23,1002,Mascara,200,400,200,1,00289,India
370769,2023-03-23,1009,Moisturizer,250,500,250,1,00095,India
370769,2023-03-23,1008,Makeup Remover,80,160,80,1,00095,India
370769,2023-03-23,1001,Lipstick,150,300,150,1,00095,India
198168,2023-03-23,1007,Eyeshadow,200,400,200,1,00274,India
150850,2023-03-23,1001,Lipstick,150,300,150,1,00143,India
882436,2023-03-23,1008,Makeup Remover,80,160,80,1,00450,India
882436,2023-03-23,1007,Eyeshadow,200,400,200,1,00450,India
882436,2023-03-23,1009,Moisturizer,250,500,250,1,00450,India
882436,2023-03-23,1002,Mascara,200,400,200,1,00450,India
716106,2023-03-23,1008,Makeup Remover,80,160,80,1,00193,India
716106,2023-03-23,1001,Lipstick,150,300,150,1,00193,India
716106,2023-03-23,1007,Eyeshadow,200,400,200,1,00193,India
716106,2023-03-23,1005,Nail Polish,50,100,50,1,00193,India
716106,2023-03-23,1012,Body Lotion,200,400,200,1,00193,India
649735,2023-03-23,1001,Lipstick,150,300,150,1,00208,India
172693,2023-03-23,1008,Makeup Remover,80,160,80,1,00296,India
172693,2023-03-23,1006,Blush,150,300,150,1,00296,India
172693,2023-03-23,1005,Nail Polish,50,100,50,1,00296,India
381345,2023-03-23,1012,Body Lotion,200,400,200,1,00479,India
381345,2023-03-23,1001,Lipstick,150,300,150,1,00479,India
927035,2023-03-23,1005,Nail Polish,50,100,50,1,00163,India
927035,2023-03-23,1004,Eyeliner,100,200,100,1,00163,India
927035,2023-03-23,1006,Blush,150,300,150,1,00163,India
927035,2023-03-23,1012,Body Lotion,200,400,200,1,00163,India
927035,2023-03-23,1002,Mascara,200,400,200,1,00163,India
419029,2023-03-23,1012,Body Lotion,200,400,200,1,00393,India
419029,2023-03-23,1006,Blush,150,300,150,1,00393,India
705914,2023-03-23,1001,Lipstick,150,300,150,1,00374,India
705914,2023-03-23,1009,Moisturizer,250,500,250,1,00374,India
478874,2023-03-23,1005,Nail Polish,50,100,50,1,00262,India
478874,2023-03-23,1006,Blush,150,300,150,1,00262,India
478874,2023-03-23,1004,Eyeliner,100,200,100,1,00262,India
647507,2023-03-23,1012,Body Lotion,200,400,200,1,00226,India
647507,2023-03-23,1009,Moisturizer,250,500,250,1,00226,India
647507,2023-03-23,1008,Makeup Remover,80,160,80,1,00226,India
647507,2023-03-23,1004,Eyeliner,100,200,100,1,00226,India
860526,2023-03-23,1004,Eyeliner,100,200,100,1,00131,India
860526,2023-03-23,1005,Nail Polish,50,100,50,1,00131,India
860526,2023-03-23,1008,Makeup Remover,80,160,80,1,00131,India
860526,2023-03-23,1002,Mascara,200,400,200,1,00131,India
860526,2023-03-23,1003,Foundation,300,600,300,1,00131,India
782075,2023-03-23,1005,Nail Polish,50,100,50,1,00467,India
782075,2023-03-23,1003,Foundation,300,600,300,1,00467,India
291567,2023-03-23,1009,Moisturizer,250,500,250,1,00328,India
291567,2023-03-23,1005,Nail Polish,50,100,50,1,00328,India
291567,2023-03-23,1004,Eyeliner,100,200,100,1,00328,India
211839,2023-03-23,1012,Body Lotion,200,400,200,1,00347,India
211839,2023-03-23,1004,Eyeliner,100,200,100,1,00347,India
211839,2023-03-23,1009,Moisturizer,250,500,250,1,00347,India
996867,2023-03-23,1006,Blush,150,300,150,1,00395,India
996867,2023-03-23,1008,Makeup Remover,80,160,80,1,00395,India
996867,2023-03-23,1004,Eyeliner,100,200,100,1,00395,India
996867,2023-03-23,1007,Eyeshadow,200,400,200,1,00395,India
996867,2023-03-23,1009,Moisturizer,250,500,250,1,00395,India
987769,2023-03-23,1008,Makeup Remover,80,160,80,1,00081,India
454169,2023-03-23,1002,Mascara,200,400,200,1,00424,India
913964,2023-03-23,1001,Lipstick,150,300,150,1,00338,India
631958,2023-03-23,1008,Makeup Remover,80,160,80,1,00139,India
631958,2023-03-23,1012,Body Lotion,200,400,200,1,00139,India
631958,2023-03-23,1005,Nail Polish,50,100,50,1,00139,India
631958,2023-03-23,1009,Moisturizer,250,500,250,1,00139,India
699107,2023-03-23,1012,Body Lotion,200,400,200,1,00370,India
699107,2023-03-23,1009,Moisturizer,250,500,250,1,00370,India
158041,2023-03-23,1006,Blush,150,300,150,1,00448,India
921430,2023-03-23,1007,Eyeshadow,200,400,200,1,00139,India
921430,2023-03-23,1008,Makeup Remover,80,160,80,1,00139,India
921430,2023-03-23,1001,Lipstick,150,300,150,1,00139,India
921430,2023-03-23,1004,Eyeliner,100,200,100,1,00139,India
921430,2023-03-23,1012,Body Lotion,200,400,200,1,00139,India
185061,2023-03-23,1001,Lipstick,150,300,150,1,00493,India
185061,2023-03-23,1005,Nail Polish,50,100,50,1,00493,India
185061,2023-03-23,1007,Eyeshadow,200,400,200,1,00493,India
947784,2023-03-23,1002,Mascara,200,400,200,1,00189,India
947784,2023-03-23,1009,Moisturizer,250,500,250,1,00189,India
947784,2023-03-23,1008,Makeup Remover,80,160,80,1,00189,India
947784,2023-03-23,1004,Eyeliner,100,200,100,1,00189,India
344803,2023-03-24,1002,Mascara,200,400,200,1,00023,India
344803,2023-03-24,1006,Blush,150,300,150,1,00023,India
958681,2023-03-24,1007,Eyeshadow,200,400,200,1,00462,India
958681,2023-03-24,1006,Blush,150,300,150,1,00462,India
970889,2023-03-24,1003,Foundation,300,600,300,1,00455,India
970889,2023-03-24,1002,Mascara,200,400,200,1,00455,India
493885,2023-03-24,1012,Body Lotion,200,400,200,1,00316,India
493885,2023-03-24,1003,Foundation,300,600,300,1,00316,India
491442,2023-03-24,1005,Nail Polish,50,100,50,1,00381,India
491442,2023-03-24,1009,Moisturizer,250,500,250,1,00381,India
390179,2023-03-24,1007,Eyeshadow,200,400,200,1,00167,India
372790,2023-03-24,1009,Moisturizer,250,500,250,1,00148,India
536988,2023-03-24,1006,Blush,150,300,150,1,00177,India
536988,2023-03-24,1009,Moisturizer,250,500,250,1,00177,India
536988,2023-03-24,1007,Eyeshadow,200,400,200,1,00177,India
536988,2023-03-24,1008,Makeup Remover,80,160,80,1,00177,India
609658,2023-03-24,1009,Moisturizer,250,500,250,1,00217,India
609658,2023-03-24,1008,Makeup Remover,80,160,80,1,00217,India
609658,2023-03-24,1006,Blush,150,300,150,1,00217,India
142395,2023-03-24,1009,Moisturizer,250,500,250,1,00198,India
142395,2023-03-24,1003,Foundation,300,600,300,1,00198,India
142395,2023-03-24,1004,Eyeliner,100,200,100,1,00198,India
177909,2023-03-24,1001,Lipstick,150,300,150,1,00267,India
177909,2023-03-24,1004,Eyeliner,100,200,100,1,00267,India
850632,2023-03-24,1012,Body Lotion,200,400,200,1,00135,India
850632,2023-03-24,1008,Makeup Remover,80,160,80,1,00135,India
722924,2023-03-24,1003,Foundation,300,600,300,1,00215,India
722924,2023-03-24,1007,Eyeshadow,200,400,200,1,00215,India
722924,2023-03-24,1012,Body Lotion,200,400,200,1,00215,India
359908,2023-03-24,1005,Nail Polish,50,100,50,1,00286,India
359908,2023-03-24,1007,Eyeshadow,200,400,200,1,00286,India
359908,2023-03-24,1001,Lipstick,150,300,150,1,00286,India
572444,2023-03-24,1003,Foundation,300,600,300,1,00158,India
572444,2023-03-24,1007,Eyeshadow,200,400,200,1,00158,India
146163,2023-03-24,1003,Foundation,300,600,300,1,00257,India
146163,2023-03-24,1005,Nail Polish,50,100,50,1,00257,India
231809,2023-03-24,1005,Nail Polish,50,100,50,1,00465,India
231809,2023-03-24,1008,Makeup Remover,80,160,80,1,00465,India
231809,2023-03-24,1002,Mascara,200,400,200,1,00465,India
541707,2023-03-24,1005,Nail Polish,50,100,50,1,00079,India
541707,2023-03-24,1009,Moisturizer,250,500,250,1,00079,India
541707,2023-03-24,1002,Mascara,200,400,200,1,00079,India
596490,2023-03-24,1005,Nail Polish,50,100,50,1,00123,India
596490,2023-03-24,1001,Lipstick,150,300,150,1,00123,India
596490,2023-03-24,1004,Eyeliner,100,200,100,1,00123,India
596490,2023-03-24,1006,Blush,150,300,150,1,00123,India
112881,2023-03-24,1009,Moisturizer,250,500,250,1,00319,India
112881,2023-03-24,1007,Eyeshadow,200,400,200,1,00319,India
695740,2023-03-24,1001,Lipstick,150,300,150,1,00300,India
567703,2023-03-24,1007,Eyeshadow,200,400,200,1,00205,India
779117,2023-03-24,1006,Blush,150,300,150,1,00008,India
779117,2023-03-24,1003,Foundation,300,600,300,1,00008,India
779117,2023-03-24,1005,Nail Polish,50,100,50,1,00008,India
467295,2023-03-24,1005,Nail Polish,50,100,50,1,00456,India
467295,2023-03-24,1009,Moisturizer,250,500,250,1,00456,India
467295,2023-03-24,1001,Lipstick,150,300,150,1,00456,India
467295,2023-03-24,1003,Foundation,300,600,300,1,00456,India
795200,2023-03-24,1004,Eyeliner,100,200,100,1,00037,India
795200,2023-03-24,1005,Nail Polish,50,100,50,1,00037,India
795200,2023-03-24,1002,Mascara,200,400,200,1,00037,India
795200,2023-03-24,1001,Lipstick,150,300,150,1,00037,India
615540,2023-03-24,1006,Blush,150,300,150,1,00455,India
615540,2023-03-24,1002,Mascara,200,400,200,1,00455,India
414807,2023-03-24,1012,Body Lotion,200,400,200,1,00170,India
414807,2023-03-24,1003,Foundation,300,600,300,1,00170,India
414807,2023-03-24,1001,Lipstick,150,300,150,1,00170,India
660663,2023-03-24,1003,Foundation,300,600,300,1,00233,India
660663,2023-03-24,1007,Eyeshadow,200,400,200,1,00233,India
660663,2023-03-24,1012,Body Lotion,200,400,200,1,00233,India
676173,2023-03-24,1004,Eyeliner,100,200,100,1,00028,India
676173,2023-03-24,1009,Moisturizer,250,500,250,1,00028,India
740683,2023-03-24,1007,Eyeshadow,200,400,200,1,00492,India
740683,2023-03-24,1006,Blush,150,300,150,1,00492,India
999441,2023-03-24,1006,Blush,150,300,150,1,00279,India
999441,2023-03-24,1007,Eyeshadow,200,400,200,1,00279,India
999441,2023-03-24,1003,Foundation,300,600,300,1,00279,India
999441,2023-03-24,1002,Mascara,200,400,200,1,00279,India
574871,2023-03-24,1009,Moisturizer,250,500,250,1,00392,India
390530,2023-03-24,1007,Eyeshadow,200,400,200,1,00261,India
390530,2023-03-24,1004,Eyeliner,100,200,100,1,00261,India
494748,2023-03-24,1006,Blush,150,300,150,1,00272,India
494748,2023-03-24,1002,Mascara,200,400,200,1,00272,India
494748,2023-03-24,1008,Makeup Remover,80,160,80,1,00272,India
893394,2023-03-24,1005,Nail Polish,50,100,50,1,00057,India
893394,2023-03-24,1007,Eyeshadow,200,400,200,1,00057,India
893394,2023-03-24,1006,Blush,150,300,150,1,00057,India
893394,2023-03-24,1009,Moisturizer,250,500,250,1,00057,India
433481,2023-03-24,1002,Mascara,200,400,200,1,00167,India
433481,2023-03-24,1003,Foundation,300,600,300,1,00167,India
214906,2023-03-24,1007,Eyeshadow,200,400,200,1,00368,India
214906,2023-03-24,1008,Makeup Remover,80,160,80,1,00368,India
624789,2023-03-24,1002,Mascara,200,400,200,1,00142,India
624789,2023-03-24,1003,Foundation,300,600,300,1,00142,India
603391,2023-03-24,1002,Mascara,200,400,200,1,00476,India
603391,2023-03-24,1008,Makeup Remover,80,160,80,1,00476,India
603391,2023-03-24,1005,Nail Polish,50,100,50,1,00476,India
643733,2023-03-24,1009,Moisturizer,250,500,250,1,00413,India
643733,2023-03-24,1003,Foundation,300,600,300,1,00413,India
643733,2023-03-24,1001,Lipstick,150,300,150,1,00413,India
643733,2023-03-24,1005,Nail Polish,50,100,50,1,00413,India
278329,2023-03-24,1008,Makeup Remover,80,160,80,1,00198,India
278329,2023-03-24,1002,Mascara,200,400,200,1,00198,India
244845,2023-03-24,1007,Eyeshadow,200,400,200,1,00433,India
190402,2023-03-25,1004,Eyeliner,100,200,100,1,00060,India
190402,2023-03-25,1008,Makeup Remover,80,160,80,1,00060,India
252700,2023-03-25,1003,Foundation,300,600,300,1,00474,India
580281,2023-03-25,1002,Mascara,200,400,200,1,00323,India
580281,2023-03-25,1003,Foundation,300,600,300,1,00323,India
944694,2023-03-25,1002,Mascara,200,400,200,1,00416,India
944694,2023-03-25,1009,Moisturizer,250,500,250,1,00416,India
558644,2023-03-25,1001,Lipstick,150,300,150,1,00499,India
189361,2023-03-25,1009,Moisturizer,250,500,250,1,00439,India
189361,2023-03-25,1012,Body Lotion,200,400,200,1,00439,India
189361,2023-03-25,1007,Eyeshadow,200,400,200,1,00439,India
189361,2023-03-25,1006,Blush,150,300,150,1,00439,India
585173,2023-03-25,1002,Mascara,200,400,200,1,00009,India
585173,2023-03-25,1012,Body Lotion,200,400,200,1,00009,India
184918,2023-03-25,1008,Makeup Remover,80,160,80,1,00111,India
184918,2023-03-25,1005,Nail Polish,50,100,50,1,00111,India
799315,2023-03-25,1002,Mascara,200,400,200,1,00051,India
799315,2023-03-25,1001,Lipstick,150,300,150,1,00051,India
799315,2023-03-25,1007,Eyeshadow,200,400,200,1,00051,India
540681,2023-03-25,1005,Nail Polish,50,100,50,1,00142,India
233800,2023-03-25,1003,Foundation,300,600,300,1,00215,India
233800,2023-03-25,1004,Eyeliner,100,200,100,1,00215,India
233800,2023-03-25,1007,Eyeshadow,200,400,200,1,00215,India
136355,2023-03-25,1002,Mascara,200,400,200,1,00025,India
850339,2023-03-25,1005,Nail Polish,50,100,50,1,00256,India
688252,2023-03-25,1002,Mascara,200,400,200,1,00131,India
688252,2023-03-25,1008,Makeup Remover,80,160,80,1,00131,India
688252,2023-03-25,1009,Moisturizer,250,500,250,1,00131,India
442555,2023-03-25,1001,Lipstick,150,300,150,1,00049,India
442555,2023-03-25,1002,Mascara,200,400,200,1,00049,India
891504,2023-03-25,1005,Nail Polish,50,100,50,1,00269,India
532655,2023-03-25,1005,Nail Polish,50,100,50,1,00468,India
532655,2023-03-25,1003,Foundation,300,600,300,1,00468,India
532655,2023-03-25,1004,Eyeliner,100,200,100,1,00468,India
532655,2023-03-25,1012,Body Lotion,200,400,200,1,00468,India
532655,2023-03-25,1007,Eyeshadow,200,400,200,1,00468,India
374749,2023-03-25,1005,Nail Polish,50,100,50,1,00299,India
456213,2023-03-25,1007,Eyeshadow,200,400,200,1,00310,India
146874,2023-03-25,1003,Foundation,300,600,300,1,00472,India
817233,2023-03-25,1003,Foundation,300,600,300,1,00345,India
817233,2023-03-25,1007,Eyeshadow,200,400,200,1,00345,India
198072,2023-03-25,1002,Mascara,200,400,200,1,00444,India
198072,2023-03-25,1008,Makeup Remover,80,160,80,1,00444,India
338649,2023-03-25,1008,Makeup Remover,80,160,80,1,00122,India
564056,2023-03-25,1003,Foundation,300,600,300,1,00478,India
564056,2023-03-25,1001,Lipstick,150,300,150,1,00478,India
279578,2023-03-25,1002,Mascara,200,400,200,1,00038,India
279578,2023-03-25,1006,Blush,150,300,150,1,00038,India
279578,2023-03-25,1012,Body Lotion,200,400,200,1,00038,India
421766,2023-03-25,1005,Nail Polish,50,100,50,1,00408,India
421766,2023-03-25,1012,Body Lotion,200,400,200,1,00408,India
723379,2023-03-25,1007,Eyeshadow,200,400,200,1,00499,India
723379,2023-03-25,1009,Moisturizer,250,500,250,1,00499,India
723379,2023-03-25,1012,Body Lotion,200,400,200,1,00499,India
723379,2023-03-25,1006,Blush,150,300,150,1,00499,India
535982,2023-03-25,1006,Blush,150,300,150,1,00227,India
535982,2023-03-25,1007,Eyeshadow,200,400,200,1,00227,India
535982,2023-03-25,1002,Mascara,200,400,200,1,00227,India
578674,2023-03-25,1007,Eyeshadow,200,400,200,1,00191,India
578674,2023-03-25,1005,Nail Polish,50,100,50,1,00191,India
578674,2023-03-25,1004,Eyeliner,100,200,100,1,00191,India
901951,2023-03-25,1006,Blush,150,300,150,1,00331,India
901951,2023-03-25,1008,Makeup Remover,80,160,80,1,00331,India
901951,2023-03-25,1004,Eyeliner,100,200,100,1,00331,India
702037,2023-03-25,1005,Nail Polish,50,100,50,1,00329,India
702037,2023-03-25,1001,Lipstick,150,300,150,1,00329,India
702037,2023-03-25,1002,Mascara,200,400,200,1,00329,India
702037,2023-03-25,1009,Moisturizer,250,500,250,1,00329,India
872880,2023-03-25,1001,Lipstick,150,300,150,1,00027,India
895436,2023-03-25,1003,Foundation,300,600,300,1,00267,India
895436,2023-03-25,1004,Eyeliner,100,200,100,1,00267,India
895436,2023-03-25,1002,Mascara,200,400,200,1,00267,India
895436,2023-03-25,1005,Nail Polish,50,100,50,1,00267,India
553906,2023-03-25,1008,Makeup Remover,80,160,80,1,00059,India
517176,2023-03-25,1009,Moisturizer,250,500,250,1,00322,India
517176,2023-03-25,1004,Eyeliner,100,200,100,1,00322,India
517176,2023-03-25,1006,Blush,150,300,150,1,00322,India
288131,2023-03-25,1007,Eyeshadow,200,400,200,1,00401,India
288131,2023-03-25,1009,Moisturizer,250,500,250,1,00401,India
288131,2023-03-25,1005,Nail Polish,50,100,50,1,00401,India
244750,2023-03-25,1012,Body Lotion,200,400,200,1,00022,India
244750,2023-03-25,1008,Makeup Remover,80,160,80,1,00022,India
244750,2023-03-25,1002,Mascara,200,400,200,1,00022,India
890790,2023-03-25,1012,Body Lotion,200,400,200,1,00144,India
890790,2023-03-25,1008,Makeup Remover,80,160,80,1,00144,India
391766,2023-03-25,1002,Mascara,200,400,200,1,00003,India
391766,2023-03-25,1001,Lipstick,150,300,150,1,00003,India
353680,2023-03-25,1003,Foundation,300,600,300,1,00221,India
353680,2023-03-25,1008,Makeup Remover,80,160,80,1,00221,India
353680,2023-03-25,1005,Nail Polish,50,100,50,1,00221,India
353680,2023-03-25,1012,Body Lotion,200,400,200,1,00221,India
527041,2023-03-25,1006,Blush,150,300,150,1,00421,India
527041,2023-03-25,1007,Eyeshadow,200,400,200,1,00421,India
527041,2023-03-25,1004,Eyeliner,100,200,100,1,00421,India
527041,2023-03-25,1012,Body Lotion,200,400,200,1,00421,India
385484,2023-03-26,1007,Eyeshadow,200,400,200,1,00302,India
385484,2023-03-26,1012,Body Lotion,200,400,200,1,00302,India
385484,2023-03-26,1006,Blush,150,300,150,1,00302,India
113511,2023-03-26,1005,Nail Polish,50,100,50,1,00368,India
113511,2023-03-26,1002,Mascara,200,400,200,1,00368,India
113511,2023-03-26,1004,Eyeliner,100,200,100,1,00368,India
113511,2023-03-26,1003,Foundation,300,600,300,1,00368,India
355691,2023-03-26,1008,Makeup Remover,80,160,80,1,00347,India
355691,2023-03-26,1007,Eyeshadow,200,400,200,1,00347,India
355691,2023-03-26,1004,Eyeliner,100,200,100,1,00347,India
266506,2023-03-26,1001,Lipstick,150,300,150,1,00142,India
266506,2023-03-26,1012,Body Lotion,200,400,200,1,00142,India
266506,2023-03-26,1003,Foundation,300,600,300,1,00142,India
266506,2023-03-26,1009,Moisturizer,250,500,250,1,00142,India
266506,2023-03-26,1002,Mascara,200,400,200,1,00142,India
709590,2023-03-26,1009,Moisturizer,250,500,250,1,00143,India
709590,2023-03-26,1012,Body Lotion,200,400,200,1,00143,India
709590,2023-03-26,1006,Blush,150,300,150,1,00143,India
709590,2023-03-26,1002,Mascara,200,400,200,1,00143,India
709590,2023-03-26,1007,Eyeshadow,200,400,200,1,00143,India
153912,2023-03-26,1005,Nail Polish,50,100,50,1,00402,India
153912,2023-03-26,1004,Eyeliner,100,200,100,1,00402,India
153912,2023-03-26,1003,Foundation,300,600,300,1,00402,India
153912,2023-03-26,1002,Mascara,200,400,200,1,00402,India
153912,2023-03-26,1007,Eyeshadow,200,400,200,1,00402,India
650157,2023-03-26,1006,Blush,150,300,150,1,00388,India
650157,2023-03-26,1009,Moisturizer,250,500,250,1,00388,India
650157,2023-03-26,1007,Eyeshadow,200,400,200,1,00388,India
827389,2023-03-26,1005,Nail Polish,50,100,50,1,00267,India
827389,2023-03-26,1006,Blush,150,300,150,1,00267,India
310594,2023-03-26,1008,Makeup Remover,80,160,80,1,00230,India
310594,2023-03-26,1005,Nail Polish,50,100,50,1,00230,India
310594,2023-03-26,1009,Moisturizer,250,500,250,1,00230,India
310594,2023-03-26,1006,Blush,150,300,150,1,00230,India
190001,2023-03-26,1003,Foundation,300,600,300,1,00239,India
190001,2023-03-26,1001,Lipstick,150,300,150,1,00239,India
190001,2023-03-26,1012,Body Lotion,200,400,200,1,00239,India
914530,2023-03-26,1006,Blush,150,300,150,1,00446,India
914530,2023-03-26,1012,Body Lotion,200,400,200,1,00446,India
636563,2023-03-26,1012,Body Lotion,200,400,200,1,00284,India
636563,2023-03-26,1006,Blush,150,300,150,1,00284,India
636563,2023-03-26,1007,Eyeshadow,200,400,200,1,00284,India
166875,2023-03-26,1012,Body Lotion,200,400,200,1,00132,India
166875,2023-03-26,1001,Lipstick,150,300,150,1,00132,India
166875,2023-03-26,1009,Moisturizer,250,500,250,1,00132,India
721232,2023-03-26,1009,Moisturizer,250,500,250,1,00005,India
721232,2023-03-26,1008,Makeup Remover,80,160,80,1,00005,India
721232,2023-03-26,1002,Mascara,200,400,200,1,00005,India
721232,2023-03-26,1007,Eyeshadow,200,400,200,1,00005,India
508834,2023-03-26,1002,Mascara,200,400,200,1,00182,India
508834,2023-03-26,1001,Lipstick,150,300,150,1,00182,India
615377,2023-03-26,1003,Foundation,300,600,300,1,00014,India
615377,2023-03-26,1007,Eyeshadow,200,400,200,1,00014,India
615377,2023-03-26,1012,Body Lotion,200,400,200,1,00014,India
615377,2023-03-26,1001,Lipstick,150,300,150,1,00014,India
226554,2023-03-26,1006,Blush,150,300,150,1,00106,India
226554,2023-03-26,1003,Foundation,300,600,300,1,00106,India
226554,2023-03-26,1005,Nail Polish,50,100,50,1,00106,India
694067,2023-03-26,1012,Body Lotion,200,400,200,1,00244,India
694067,2023-03-26,1009,Moisturizer,250,500,250,1,00244,India
694067,2023-03-26,1003,Foundation,300,600,300,1,00244,India
694067,2023-03-26,1007,Eyeshadow,200,400,200,1,00244,India
694067,2023-03-26,1001,Lipstick,150,300,150,1,00244,India
973926,2023-03-26,1008,Makeup Remover,80,160,80,1,00089,India
973926,2023-03-26,1004,Eyeliner,100,200,100,1,00089,India
973926,2023-03-26,1006,Blush,150,300,150,1,00089,India
884556,2023-03-26,1012,Body Lotion,200,400,200,1,00337,India
982286,2023-03-26,1004,Eyeliner,100,200,100,1,00086,India
982286,2023-03-26,1012,Body Lotion,200,400,200,1,00086,India
982286,2023-03-26,1001,Lipstick,150,300,150,1,00086,India
982286,2023-03-26,1003,Foundation,300,600,300,1,00086,India
589608,2023-03-26,1009,Moisturizer,250,500,250,1,00258,India
589608,2023-03-26,1005,Nail Polish,50,100,50,1,00258,India
589608,2023-03-26,1008,Makeup Remover,80,160,80,1,00258,India
589608,2023-03-26,1003,Foundation,300,600,300,1,00258,India
226853,2023-03-26,1012,Body Lotion,200,400,200,1,00438,India
226853,2023-03-26,1008,Makeup Remover,80,160,80,1,00438,India
226853,2023-03-26,1001,Lipstick,150,300,150,1,00438,India
696853,2023-03-26,1012,Body Lotion,200,400,200,1,00298,India
696853,2023-03-26,1009,Moisturizer,250,500,250,1,00298,India
912113,2023-03-26,1012,Body Lotion,200,400,200,1,00034,India
912113,2023-03-26,1004,Eyeliner,100,200,100,1,00034,India
573046,2023-03-26,1001,Lipstick,150,300,150,1,00329,India
479080,2023-03-26,1004,Eyeliner,100,200,100,1,00035,India
479080,2023-03-26,1001,Lipstick,150,300,150,1,00035,India
479080,2023-03-26,1008,Makeup Remover,80,160,80,1,00035,India
479080,2023-03-26,1003,Foundation,300,600,300,1,00035,India
479080,2023-03-26,1007,Eyeshadow,200,400,200,1,00035,India
744466,2023-03-26,1004,Eyeliner,100,200,100,1,00427,India
744466,2023-03-26,1009,Moisturizer,250,500,250,1,00427,India
218331,2023-03-26,1007,Eyeshadow,200,400,200,1,00130,India
431246,2023-03-26,1001,Lipstick,150,300,150,1,00391,India
431246,2023-03-26,1009,Moisturizer,250,500,250,1,00391,India
431246,2023-03-26,1007,Eyeshadow,200,400,200,1,00391,India
850602,2023-03-26,1001,Lipstick,150,300,150,1,00255,India
521075,2023-03-26,1008,Makeup Remover,80,160,80,1,00061,India
521075,2023-03-26,1003,Foundation,300,600,300,1,00061,India
521075,2023-03-26,1004,Eyeliner,100,200,100,1,00061,India
411647,2023-03-26,1007,Eyeshadow,200,400,200,1,00362,India
411647,2023-03-26,1002,Mascara,200,400,200,1,00362,India
411647,2023-03-26,1006,Blush,150,300,150,1,00362,India
822964,2023-03-26,1012,Body Lotion,200,400,200,1,00269,India
360067,2023-03-26,1002,Mascara,200,400,200,1,00300,India
360067,2023-03-26,1012,Body Lotion,200,400,200,1,00300,India
233992,2023-03-26,1008,Makeup Remover,80,160,80,1,00042,India
233992,2023-03-26,1002,Mascara,200,400,200,1,00042,India
233992,2023-03-26,1006,Blush,150,300,150,1,00042,India
233992,2023-03-26,1012,Body Lotion,200,400,200,1,00042,India
969883,2023-03-26,1001,Lipstick,150,300,150,1,00349,India
969883,2023-03-26,1009,Moisturizer,250,500,250,1,00349,India
969883,2023-03-26,1008,Makeup Remover,80,160,80,1,00349,India
969883,2023-03-26,1004,Eyeliner,100,200,100,1,00349,India
636109,2023-03-26,1012,Body Lotion,200,400,200,1,00294,India
636109,2023-03-26,1002,Mascara,200,400,200,1,00294,India
636109,2023-03-26,1005,Nail Polish,50,100,50,1,00294,India
792898,2023-03-26,1009,Moisturizer,250,500,250,1,00054,India
792898,2023-03-26,1005,Nail Polish,50,100,50,1,00054,India
792898,2023-03-26,1007,Eyeshadow,200,400,200,1,00054,India
792898,2023-03-26,1002,Mascara,200,400,200,1,00054,India
441385,2023-03-26,1007,Eyeshadow,200,400,200,1,00070,India
441385,2023-03-26,1004,Eyeliner,100,200,100,1,00070,India
972602,2023-03-26,1004,Eyeliner,100,200,100,1,00317,India
972602,2023-03-26,1001,Lipstick,150,300,150,1,00317,India
972602,2023-03-26,1008,Makeup Remover,80,160,80,1,00317,India
972602,2023-03-26,1002,Mascara,200,400,200,1,00317,India
319576,2023-03-27,1008,Makeup Remover,80,160,80,1,00303,India
371430,2023-03-27,1005,Nail Polish,50,100,50,1,00095,India
371430,2023-03-27,1001,Lipstick,150,300,150,1,00095,India
162828,2023-03-27,1008,Makeup Remover,80,160,80,1,00026,India
162828,2023-03-27,1004,Eyeliner,100,200,100,1,00026,India
162828,2023-03-27,1009,Moisturizer,250,500,250,1,00026,India
162828,2023-03-27,1001,Lipstick,150,300,150,1,00026,India
450802,2023-03-27,1006,Blush,150,300,150,1,00288,India
710394,2023-03-27,1003,Foundation,300,600,300,1,00126,India
468694,2023-03-27,1004,Eyeliner,100,200,100,1,00407,India
468694,2023-03-27,1006,Blush,150,300,150,1,00407,India
610129,2023-03-27,1003,Foundation,300,600,300,1,00200,India
610129,2023-03-27,1008,Makeup Remover,80,160,80,1,00200,India
584040,2023-03-27,1002,Mascara,200,400,200,1,00190,India
584040,2023-03-27,1007,Eyeshadow,200,400,200,1,00190,India
584040,2023-03-27,1004,Eyeliner,100,200,100,1,00190,India
316728,2023-03-27,1005,Nail Polish,50,100,50,1,00062,India
316728,2023-03-27,1009,Moisturizer,250,500,250,1,00062,India
316728,2023-03-27,1001,Lipstick,150,300,150,1,00062,India
165195,2023-03-27,1009,Moisturizer,250,500,250,1,00015,India
570195,2023-03-27,1005,Nail Polish,50,100,50,1,00486,India
298932,2023-03-27,1001,Lipstick,150,300,150,1,00087,India
696786,2023-03-27,1008,Makeup Remover,80,160,80,1,00339,India
471849,2023-03-27,1004,Eyeliner,100,200,100,1,00402,India
471849,2023-03-27,1007,Eyeshadow,200,400,200,1,00402,India
254627,2023-03-27,1008,Makeup Remover,80,160,80,1,00339,India
254627,2023-03-27,1001,Lipstick,150,300,150,1,00339,India
254627,2023-03-27,1009,Moisturizer,250,500,250,1,00339,India
254627,2023-03-27,1005,Nail Polish,50,100,50,1,00339,India
106896,2023-03-27,1001,Lipstick,150,300,150,1,00240,India
106896,2023-03-27,1012,Body Lotion,200,400,200,1,00240,India
106896,2023-03-27,1003,Foundation,300,600,300,1,00240,India
106235,2023-03-27,1004,Eyeliner,100,200,100,1,00186,India
106235,2023-03-27,1002,Mascara,200,400,200,1,00186,India
686226,2023-03-27,1006,Blush,150,300,150,1,00434,India
686226,2023-03-27,1003,Foundation,300,600,300,1,00434,India
686226,2023-03-27,1001,Lipstick,150,300,150,1,00434,India
686226,2023-03-27,1009,Moisturizer,250,500,250,1,00434,India
393110,2023-03-27,1004,Eyeliner,100,200,100,1,00438,India
393110,2023-03-27,1006,Blush,150,300,150,1,00438,India
372182,2023-03-27,1008,Makeup Remover,80,160,80,1,00500,India
372182,2023-03-27,1001,Lipstick,150,300,150,1,00500,India
372182,2023-03-27,1009,Moisturizer,250,500,250,1,00500,India
357599,2023-03-27,1008,Makeup Remover,80,160,80,1,00020,India
377764,2023-03-27,1007,Eyeshadow,200,400,200,1,00428,India
377764,2023-03-27,1004,Eyeliner,100,200,100,1,00428,India
298119,2023-03-27,1009,Moisturizer,250,500,250,1,00092,India
298119,2023-03-27,1005,Nail Polish,50,100,50,1,00092,India
298119,2023-03-27,1006,Blush,150,300,150,1,00092,India
298119,2023-03-27,1001,Lipstick,150,300,150,1,00092,India
866131,2023-03-27,1012,Body Lotion,200,400,200,1,00377,India
866131,2023-03-27,1006,Blush,150,300,150,1,00377,India
131350,2023-03-27,1007,Eyeshadow,200,400,200,1,00448,India
131350,2023-03-27,1003,Foundation,300,600,300,1,00448,India
131350,2023-03-27,1005,Nail Polish,50,100,50,1,00448,India
131350,2023-03-27,1002,Mascara,200,400,200,1,00448,India
802981,2023-03-27,1012,Body Lotion,200,400,200,1,00117,India
802981,2023-03-27,1001,Lipstick,150,300,150,1,00117,India
392981,2023-03-27,1001,Lipstick,150,300,150,1,00373,India
392981,2023-03-27,1005,Nail Polish,50,100,50,1,00373,India
392981,2023-03-27,1006,Blush,150,300,150,1,00373,India
590835,2023-03-27,1001,Lipstick,150,300,150,1,00109,India
590835,2023-03-27,1012,Body Lotion,200,400,200,1,00109,India
590835,2023-03-27,1008,Makeup Remover,80,160,80,1,00109,India
590835,2023-03-27,1009,Moisturizer,250,500,250,1,00109,India
590835,2023-03-27,1007,Eyeshadow,200,400,200,1,00109,India
538481,2023-03-27,1009,Moisturizer,250,500,250,1,00286,India
131121,2023-03-27,1009,Moisturizer,250,500,250,1,00058,India
324851,2023-03-27,1006,Blush,150,300,150,1,00389,India
324851,2023-03-27,1009,Moisturizer,250,500,250,1,00389,India
324851,2023-03-27,1002,Mascara,200,400,200,1,00389,India
324851,2023-03-27,1007,Eyeshadow,200,400,200,1,00389,India
258035,2023-03-27,1003,Foundation,300,600,300,1,00269,India
258035,2023-03-27,1002,Mascara,200,400,200,1,00269,India
258035,2023-03-27,1006,Blush,150,300,150,1,00269,India
258035,2023-03-27,1008,Makeup Remover,80,160,80,1,00269,India
687648,2023-03-27,1007,Eyeshadow,200,400,200,1,00169,India
687648,2023-03-27,1012,Body Lotion,200,400,200,1,00169,India
371122,2023-03-27,1009,Moisturizer,250,500,250,1,00337,India
604652,2023-03-27,1006,Blush,150,300,150,1,00265,India
604652,2023-03-27,1004,Eyeliner,100,200,100,1,00265,India
604652,2023-03-27,1001,Lipstick,150,300,150,1,00265,India
604652,2023-03-27,1012,Body Lotion,200,400,200,1,00265,India
773493,2023-03-27,1006,Blush,150,300,150,1,00107,India
709938,2023-03-27,1008,Makeup Remover,80,160,80,1,00115,India
709938,2023-03-27,1001,Lipstick,150,300,150,1,00115,India
709938,2023-03-27,1005,Nail Polish,50,100,50,1,00115,India
647141,2023-03-27,1001,Lipstick,150,300,150,1,00409,India
647141,2023-03-27,1003,Foundation,300,600,300,1,00409,India
124699,2023-03-27,1008,Makeup Remover,80,160,80,1,00439,India
185881,2023-03-27,1009,Moisturizer,250,500,250,1,00055,India
518487,2023-03-27,1005,Nail Polish,50,100,50,1,00391,India
518487,2023-03-27,1003,Foundation,300,600,300,1,00391,India
518487,2023-03-27,1012,Body Lotion,200,400,200,1,00391,India
518487,2023-03-27,1002,Mascara,200,400,200,1,00391,India
415188,2023-03-27,1012,Body Lotion,200,400,200,1,00284,India
415188,2023-03-27,1007,Eyeshadow,200,400,200,1,00284,India
159613,2023-03-28,1004,Eyeliner,100,200,100,1,00066,India
159613,2023-03-28,1006,Blush,150,300,150,1,00066,India
159613,2023-03-28,1012,Body Lotion,200,400,200,1,00066,India
159613,2023-03-28,1009,Moisturizer,250,500,250,1,00066,India
624452,2023-03-28,1012,Body Lotion,200,400,200,1,00304,India
458940,2023-03-28,1002,Mascara,200,400,200,1,00217,India
458940,2023-03-28,1001,Lipstick,150,300,150,1,00217,India
458940,2023-03-28,1004,Eyeliner,100,200,100,1,00217,India
458940,2023-03-28,1006,Blush,150,300,150,1,00217,India
972425,2023-03-28,1007,Eyeshadow,200,400,200,1,00169,India
192724,2023-03-28,1001,Lipstick,150,300,150,1,00017,India
192724,2023-03-28,1006,Blush,150,300,150,1,00017,India
192724,2023-03-28,1002,Mascara,200,400,200,1,00017,India
192724,2023-03-28,1008,Makeup Remover,80,160,80,1,00017,India
600705,2023-03-28,1002,Mascara,200,400,200,1,00041,India
600705,2023-03-28,1004,Eyeliner,100,200,100,1,00041,India
600705,2023-03-28,1001,Lipstick,150,300,150,1,00041,India
600705,2023-03-28,1009,Moisturizer,250,500,250,1,00041,India
606574,2023-03-28,1003,Foundation,300,600,300,1,00337,India
606574,2023-03-28,1007,Eyeshadow,200,400,200,1,00337,India
606574,2023-03-28,1001,Lipstick,150,300,150,1,00337,India
276322,2023-03-28,1003,Foundation,300,600,300,1,00336,India
276322,2023-03-28,1007,Eyeshadow,200,400,200,1,00336,India
276322,2023-03-28,1004,Eyeliner,100,200,100,1,00336,India
925402,2023-03-28,1012,Body Lotion,200,400,200,1,00391,India
925402,2023-03-28,1003,Foundation,300,600,300,1,00391,India
925402,2023-03-28,1007,Eyeshadow,200,400,200,1,00391,India
925402,2023-03-28,1009,Moisturizer,250,500,250,1,00391,India
925402,2023-03-28,1002,Mascara,200,400,200,1,00391,India
422083,2023-03-28,1001,Lipstick,150,300,150,1,00039,India
422083,2023-03-28,1002,Mascara,200,400,200,1,00039,India
422083,2023-03-28,1004,Eyeliner,100,200,100,1,00039,India
422083,2023-03-28,1012,Body Lotion,200,400,200,1,00039,India
422083,2023-03-28,1006,Blush,150,300,150,1,00039,India
901852,2023-03-28,1004,Eyeliner,100,200,100,1,00300,India
901852,2023-03-28,1001,Lipstick,150,300,150,1,00300,India
901852,2023-03-28,1009,Moisturizer,250,500,250,1,00300,India
229615,2023-03-28,1002,Mascara,200,400,200,1,00344,India
229615,2023-03-28,1009,Moisturizer,250,500,250,1,00344,India
229615,2023-03-28,1004,Eyeliner,100,200,100,1,00344,India
504790,2023-03-28,1004,Eyeliner,100,200,100,1,00183,India
504790,2023-03-28,1008,Makeup Remover,80,160,80,1,00183,India
836651,2023-03-28,1005,Nail Polish,50,100,50,1,00266,India
836651,2023-03-28,1003,Foundation,300,600,300,1,00266,India
273581,2023-03-28,1005,Nail Polish,50,100,50,1,00244,India
379676,2023-03-28,1007,Eyeshadow,200,400,200,1,00250,India
379676,2023-03-28,1001,Lipstick,150,300,150,1,00250,India
379676,2023-03-28,1005,Nail Polish,50,100,50,1,00250,India
486883,2023-03-28,1001,Lipstick,150,300,150,1,00109,India
486883,2023-03-28,1002,Mascara,200,400,200,1,00109,India
486883,2023-03-28,1008,Makeup Remover,80,160,80,1,00109,India
486883,2023-03-28,1009,Moisturizer,250,500,250,1,00109,India
453973,2023-03-28,1005,Nail Polish,50,100,50,1,00018,India
453973,2023-03-28,1001,Lipstick,150,300,150,1,00018,India
726828,2023-03-28,1007,Eyeshadow,200,400,200,1,00086,India
298971,2023-03-28,1008,Makeup Remover,80,160,80,1,00146,India
298971,2023-03-28,1004,Eyeliner,100,200,100,1,00146,India
298971,2023-03-28,1003,Foundation,300,600,300,1,00146,India
240045,2023-03-28,1006,Blush,150,300,150,1,00043,India
240045,2023-03-28,1002,Mascara,200,400,200,1,00043,India
744030,2023-03-28,1005,Nail Polish,50,100,50,1,00229,India
744030,2023-03-28,1001,Lipstick,150,300,150,1,00229,India
744030,2023-03-28,1003,Foundation,300,600,300,1,00229,India
267902,2023-03-28,1003,Foundation,300,600,300,1,00295,India
267902,2023-03-28,1006,Blush,150,300,150,1,00295,India
455659,2023-03-28,1005,Nail Polish,50,100,50,1,00138,India
985121,2023-03-28,1012,Body Lotion,200,400,200,1,00091,India
985121,2023-03-28,1005,Nail Polish,50,100,50,1,00091,India
985121,2023-03-28,1001,Lipstick,150,300,150,1,00091,India
496497,2023-03-28,1007,Eyeshadow,200,400,200,1,00409,India
496497,2023-03-28,1002,Mascara,200,400,200,1,00409,India
746815,2023-03-28,1003,Foundation,300,600,300,1,00325,India
746815,2023-03-28,1008,Makeup Remover,80,160,80,1,00325,India
746815,2023-03-28,1004,Eyeliner,100,200,100,1,00325,India
746815,2023-03-28,1007,Eyeshadow,200,400,200,1,00325,India
548996,2023-03-28,1012,Body Lotion,200,400,200,1,00352,India
909685,2023-03-28,1006,Blush,150,300,150,1,00082,India
909685,2023-03-28,1003,Foundation,300,600,300,1,00082,India
909685,2023-03-28,1004,Eyeliner,100,200,100,1,00082,India
909685,2023-03-28,1005,Nail Polish,50,100,50,1,00082,India
513886,2023-03-28,1012,Body Lotion,200,400,200,1,00217,India
513886,2023-03-28,1004,Eyeliner,100,200,100,1,00217,India
513886,2023-03-28,1002,Mascara,200,400,200,1,00217,India
106566,2023-03-28,1012,Body Lotion,200,400,200,1,00440,India
106566,2023-03-28,1001,Lipstick,150,300,150,1,00440,India
106566,2023-03-28,1009,Moisturizer,250,500,250,1,00440,India
106566,2023-03-28,1007,Eyeshadow,200,400,200,1,00440,India
907473,2023-03-28,1005,Nail Polish,50,100,50,1,00475,India
907473,2023-03-28,1002,Mascara,200,400,200,1,00475,India
907473,2023-03-28,1004,Eyeliner,100,200,100,1,00475,India
279444,2023-03-28,1007,Eyeshadow,200,400,200,1,00365,India
279444,2023-03-28,1008,Makeup Remover,80,160,80,1,00365,India
278555,2023-03-28,1006,Blush,150,300,150,1,00276,India
278555,2023-03-28,1012,Body Lotion,200,400,200,1,00276,India
278555,2023-03-28,1004,Eyeliner,100,200,100,1,00276,India
782898,2023-03-28,1003,Foundation,300,600,300,1,00391,India
782898,2023-03-28,1002,Mascara,200,400,200,1,00391,India
782898,2023-03-28,1001,Lipstick,150,300,150,1,00391,India
599633,2023-03-28,1003,Foundation,300,600,300,1,00003,India
599633,2023-03-28,1001,Lipstick,150,300,150,1,00003,India
599633,2023-03-28,1005,Nail Polish,50,100,50,1,00003,India
734517,2023-03-28,1008,Makeup Remover,80,160,80,1,00489,India
734517,2023-03-28,1003,Foundation,300,600,300,1,00489,India
734517,2023-03-28,1009,Moisturizer,250,500,250,1,00489,India
590115,2023-03-28,1001,Lipstick,150,300,150,1,00018,India
590115,2023-03-28,1004,Eyeliner,100,200,100,1,00018,India
590115,2023-03-28,1008,Makeup Remover,80,160,80,1,00018,India
699783,2023-03-28,1002,Mascara,200,400,200,1,00493,India
699783,2023-03-28,1003,Foundation,300,600,300,1,00493,India
699783,2023-03-28,1008,Makeup Remover,80,160,80,1,00493,India
259379,2023-03-28,1005,Nail Polish,50,100,50,1,00054,India
259379,2023-03-28,1006,Blush,150,300,150,1,00054,India
259379,2023-03-28,1001,Lipstick,150,300,150,1,00054,India
259379,2023-03-28,1004,Eyeliner,100,200,100,1,00054,India
417550,2023-03-29,1006,Blush,150,300,150,1,00323,India
417550,2023-03-29,1012,Body Lotion,200,400,200,1,00323,India
417550,2023-03-29,1005,Nail Polish,50,100,50,1,00323,India
188427,2023-03-29,1006,Blush,150,300,150,1,00025,India
188427,2023-03-29,1007,Eyeshadow,200,400,200,1,00025,India
188427,2023-03-29,1009,Moisturizer,250,500,250,1,00025,India
188427,2023-03-29,1001,Lipstick,150,300,150,1,00025,India
188427,2023-03-29,1003,Foundation,300,600,300,1,00025,India
168265,2023-03-29,1001,Lipstick,150,300,150,1,00112,India
313869,2023-03-29,1001,Lipstick,150,300,150,1,00464,India
313869,2023-03-29,1006,Blush,150,300,150,1,00464,India
313869,2023-03-29,1008,Makeup Remover,80,160,80,1,00464,India
597710,2023-03-29,1007,Eyeshadow,200,400,200,1,00380,India
970318,2023-03-29,1007,Eyeshadow,200,400,200,1,00384,India
970318,2023-03-29,1008,Makeup Remover,80,160,80,1,00384,India
281734,2023-03-29,1006,Blush,150,300,150,1,00433,India
281734,2023-03-29,1007,Eyeshadow,200,400,200,1,00433,India
281734,2023-03-29,1012,Body Lotion,200,400,200,1,00433,India
281734,2023-03-29,1002,Mascara,200,400,200,1,00433,India
543772,2023-03-29,1002,Mascara,200,400,200,1,00183,India
543772,2023-03-29,1007,Eyeshadow,200,400,200,1,00183,India
543772,2023-03-29,1009,Moisturizer,250,500,250,1,00183,India
525747,2023-03-29,1003,Foundation,300,600,300,1,00475,India
525747,2023-03-29,1009,Moisturizer,250,500,250,1,00475,India
525747,2023-03-29,1005,Nail Polish,50,100,50,1,00475,India
840643,2023-03-29,1005,Nail Polish,50,100,50,1,00111,India
840643,2023-03-29,1008,Makeup Remover,80,160,80,1,00111,India
840643,2023-03-29,1006,Blush,150,300,150,1,00111,India
840643,2023-03-29,1004,Eyeliner,100,200,100,1,00111,India
472091,2023-03-29,1005,Nail Polish,50,100,50,1,00115,India
472091,2023-03-29,1004,Eyeliner,100,200,100,1,00115,India
862890,2023-03-29,1009,Moisturizer,250,500,250,1,00050,India
714769,2023-03-29,1003,Foundation,300,600,300,1,00483,India
381088,2023-03-29,1002,Mascara,200,400,200,1,00168,India
381088,2023-03-29,1009,Moisturizer,250,500,250,1,00168,India
381088,2023-03-29,1006,Blush,150,300,150,1,00168,India
417164,2023-03-29,1005,Nail Polish,50,100,50,1,00337,India
417164,2023-03-29,1009,Moisturizer,250,500,250,1,00337,India
550352,2023-03-29,1012,Body Lotion,200,400,200,1,00417,India
550352,2023-03-29,1007,Eyeshadow,200,400,200,1,00417,India
896927,2023-03-29,1007,Eyeshadow,200,400,200,1,00066,India
896927,2023-03-29,1008,Makeup Remover,80,160,80,1,00066,India
896927,2023-03-29,1002,Mascara,200,400,200,1,00066,India
896927,2023-03-29,1006,Blush,150,300,150,1,00066,India
896927,2023-03-29,1003,Foundation,300,600,300,1,00066,India
256220,2023-03-29,1003,Foundation,300,600,300,1,00354,India
256220,2023-03-29,1001,Lipstick,150,300,150,1,00354,India
822281,2023-03-29,1007,Eyeshadow,200,400,200,1,00293,India
822281,2023-03-29,1001,Lipstick,150,300,150,1,00293,India
822281,2023-03-29,1005,Nail Polish,50,100,50,1,00293,India
863739,2023-03-29,1009,Moisturizer,250,500,250,1,00412,India
863739,2023-03-29,1012,Body Lotion,200,400,200,1,00412,India
863739,2023-03-29,1007,Eyeshadow,200,400,200,1,00412,India
305009,2023-03-29,1001,Lipstick,150,300,150,1,00475,India
305009,2023-03-29,1005,Nail Polish,50,100,50,1,00475,India
305009,2023-03-29,1006,Blush,150,300,150,1,00475,India
605093,2023-03-29,1003,Foundation,300,600,300,1,00346,India
111822,2023-03-29,1003,Foundation,300,600,300,1,00249,India
111822,2023-03-29,1012,Body Lotion,200,400,200,1,00249,India
111822,2023-03-29,1006,Blush,150,300,150,1,00249,India
111822,2023-03-29,1009,Moisturizer,250,500,250,1,00249,India
111822,2023-03-29,1008,Makeup Remover,80,160,80,1,00249,India
808098,2023-03-29,1012,Body Lotion,200,400,200,1,00318,India
808098,2023-03-29,1003,Foundation,300,600,300,1,00318,India
808098,2023-03-29,1008,Makeup Remover,80,160,80,1,00318,India
132057,2023-03-29,1007,Eyeshadow,200,400,200,1,00454,India
132057,2023-03-29,1003,Foundation,300,600,300,1,00454,India
562481,2023-03-29,1002,Mascara,200,400,200,1,00421,India
562481,2023-03-29,1006,Blush,150,300,150,1,00421,India
562481,2023-03-29,1003,Foundation,300,600,300,1,00421,India
562481,2023-03-29,1008,Makeup Remover,80,160,80,1,00421,India
484180,2023-03-29,1002,Mascara,200,400,200,1,00023,India
658685,2023-03-29,1006,Blush,150,300,150,1,00177,India
575653,2023-03-29,1004,Eyeliner,100,200,100,1,00285,India
575653,2023-03-29,1003,Foundation,300,600,300,1,00285,India
575653,2023-03-29,1012,Body Lotion,200,400,200,1,00285,India
575653,2023-03-29,1006,Blush,150,300,150,1,00285,India
385232,2023-03-29,1004,Eyeliner,100,200,100,1,00275,India
385232,2023-03-29,1001,Lipstick,150,300,150,1,00275,India
341359,2023-03-29,1002,Mascara,200,400,200,1,00093,India
341359,2023-03-29,1004,Eyeliner,100,200,100,1,00093,India
149422,2023-03-30,1005,Nail Polish,50,100,50,1,00322,India
149422,2023-03-30,1004,Eyeliner,100,200,100,1,00322,India
310286,2023-03-30,1001,Lipstick,150,300,150,1,00490,India
860452,2023-03-30,1005,Nail Polish,50,100,50,1,00460,India
860452,2023-03-30,1001,Lipstick,150,300,150,1,00460,India
525007,2023-03-30,1007,Eyeshadow,200,400,200,1,00202,India
525007,2023-03-30,1005,Nail Polish,50,100,50,1,00202,India
525007,2023-03-30,1002,Mascara,200,400,200,1,00202,India
525007,2023-03-30,1008,Makeup Remover,80,160,80,1,00202,India
525007,2023-03-30,1004,Eyeliner,100,200,100,1,00202,India
919078,2023-03-30,1005,Nail Polish,50,100,50,1,00004,India
919078,2023-03-30,1012,Body Lotion,200,400,200,1,00004,India
919078,2023-03-30,1003,Foundation,300,600,300,1,00004,India
415562,2023-03-30,1004,Eyeliner,100,200,100,1,00275,India
415562,2023-03-30,1006,Blush,150,300,150,1,00275,India
415562,2023-03-30,1003,Foundation,300,600,300,1,00275,India
415562,2023-03-30,1007,Eyeshadow,200,400,200,1,00275,India
225885,2023-03-30,1012,Body Lotion,200,400,200,1,00277,India
519973,2023-03-30,1004,Eyeliner,100,200,100,1,00264,India
519973,2023-03-30,1009,Moisturizer,250,500,250,1,00264,India
278679,2023-03-30,1009,Moisturizer,250,500,250,1,00337,India
278679,2023-03-30,1006,Blush,150,300,150,1,00337,India
278679,2023-03-30,1003,Foundation,300,600,300,1,00337,India
277808,2023-03-30,1009,Moisturizer,250,500,250,1,00185,India
277808,2023-03-30,1007,Eyeshadow,200,400,200,1,00185,India
793728,2023-03-30,1004,Eyeliner,100,200,100,1,00106,India
793728,2023-03-30,1005,Nail Polish,50,100,50,1,00106,India
793728,2023-03-30,1001,Lipstick,150,300,150,1,00106,India
118882,2023-03-30,1004,Eyeliner,100,200,100,1,00445,India
118882,2023-03-30,1008,Makeup Remover,80,160,80,1,00445,India
118882,2023-03-30,1006,Blush,150,300,150,1,00445,India
118882,2023-03-30,1009,Moisturizer,250,500,250,1,00445,India
301561,2023-03-30,1002,Mascara,200,400,200,1,00281,India
301561,2023-03-30,1012,Body Lotion,200,400,200,1,00281,India
301561,2023-03-30,1006,Blush,150,300,150,1,00281,India
318065,2023-03-30,1003,Foundation,300,600,300,1,00405,India
318065,2023-03-30,1006,Blush,150,300,150,1,00405,India
318065,2023-03-30,1009,Moisturizer,250,500,250,1,00405,India
112410,2023-03-30,1002,Mascara,200,400,200,1,00104,India
272663,2023-03-30,1007,Eyeshadow,200,400,200,1,00076,India
272663,2023-03-30,1004,Eyeliner,100,200,100,1,00076,India
491672,2023-03-30,1004,Eyeliner,100,200,100,1,00238,India
491672,2023-03-30,1008,Makeup Remover,80,160,80,1,00238,India
491672,2023-03-30,1005,Nail Polish,50,100,50,1,00238,India
491672,2023-03-30,1007,Eyeshadow,200,400,200,1,00238,India
218669,2023-03-30,1004,Eyeliner,100,200,100,1,00169,India
218669,2023-03-30,1002,Mascara,200,400,200,1,00169,India
901926,2023-03-30,1006,Blush,150,300,150,1,00441,India
901926,2023-03-30,1012,Body Lotion,200,400,200,1,00441,India
216131,2023-03-30,1012,Body Lotion,200,400,200,1,00493,India
216131,2023-03-30,1006,Blush,150,300,150,1,00493,India
222770,2023-03-30,1006,Blush,150,300,150,1,00248,India
222770,2023-03-30,1001,Lipstick,150,300,150,1,00248,India
222770,2023-03-30,1008,Makeup Remover,80,160,80,1,00248,India
157035,2023-03-30,1008,Makeup Remover,80,160,80,1,00321,India
157035,2023-03-30,1006,Blush,150,300,150,1,00321,India
441464,2023-03-30,1004,Eyeliner,100,200,100,1,00406,India
441464,2023-03-30,1012,Body Lotion,200,400,200,1,00406,India
549358,2023-03-30,1008,Makeup Remover,80,160,80,1,00086,India
549358,2023-03-30,1005,Nail Polish,50,100,50,1,00086,India
549358,2023-03-30,1009,Moisturizer,250,500,250,1,00086,India
549358,2023-03-30,1006,Blush,150,300,150,1,00086,India
549358,2023-03-30,1004,Eyeliner,100,200,100,1,00086,India
234651,2023-03-30,1012,Body Lotion,200,400,200,1,00062,India
234651,2023-03-30,1001,Lipstick,150,300,150,1,00062,India
450566,2023-03-30,1003,Foundation,300,600,300,1,00471,India
450566,2023-03-30,1012,Body Lotion,200,400,200,1,00471,India
450566,2023-03-30,1002,Mascara,200,400,200,1,00471,India
334717,2023-03-30,1005,Nail Polish,50,100,50,1,00481,India
334717,2023-03-30,1008,Makeup Remover,80,160,80,1,00481,India
334717,2023-03-30,1003,Foundation,300,600,300,1,00481,India
573540,2023-03-30,1008,Makeup Remover,80,160,80,1,00021,India
573540,2023-03-30,1009,Moisturizer,250,500,250,1,00021,India
573540,2023-03-30,1012,Body Lotion,200,400,200,1,00021,India
484972,2023-03-30,1009,Moisturizer,250,500,250,1,00451,India
484972,2023-03-30,1006,Blush,150,300,150,1,00451,India
484972,2023-03-30,1005,Nail Polish,50,100,50,1,00451,India
368907,2023-03-30,1003,Foundation,300,600,300,1,00243,India
368907,2023-03-30,1008,Makeup Remover,80,160,80,1,00243,India
368907,2023-03-30,1001,Lipstick,150,300,150,1,00243,India
368907,2023-03-30,1007,Eyeshadow,200,400,200,1,00243,India
943475,2023-03-30,1005,Nail Polish,50,100,50,1,00305,India
943475,2023-03-30,1007,Eyeshadow,200,400,200,1,00305,India
943475,2023-03-30,1008,Makeup Remover,80,160,80,1,00305,India
943475,2023-03-30,1002,Mascara,200,400,200,1,00305,India
607343,2023-03-30,1004,Eyeliner,100,200,100,1,00135,India
623375,2023-03-30,1008,Makeup Remover,80,160,80,1,00255,India
623375,2023-03-30,1003,Foundation,300,600,300,1,00255,India
750577,2023-03-30,1009,Moisturizer,250,500,250,1,00143,India
790137,2023-03-30,1008,Makeup Remover,80,160,80,1,00314,India
413172,2023-03-30,1006,Blush,150,300,150,1,00437,India
413172,2023-03-30,1012,Body Lotion,200,400,200,1,00437,India
411749,2023-03-30,1005,Nail Polish,50,100,50,1,00160,India
411749,2023-03-30,1002,Mascara,200,400,200,1,00160,India
768999,2023-03-30,1012,Body Lotion,200,400,200,1,00398,India
768999,2023-03-30,1003,Foundation,300,600,300,1,00398,India
768999,2023-03-30,1007,Eyeshadow,200,400,200,1,00398,India
148173,2023-03-31,1005,Nail Polish,50,100,50,1,00185,India
148173,2023-03-31,1006,Blush,150,300,150,1,00185,India
148173,2023-03-31,1001,Lipstick,150,300,150,1,00185,India
148173,2023-03-31,1003,Foundation,300,600,300,1,00185,India
204228,2023-03-31,1001,Lipstick,150,300,150,1,00073,India
656817,2023-03-31,1008,Makeup Remover,80,160,80,1,00065,India
656817,2023-03-31,1009,Moisturizer,250,500,250,1,00065,India
657152,2023-03-31,1002,Mascara,200,400,200,1,00155,India
657152,2023-03-31,1006,Blush,150,300,150,1,00155,India
657152,2023-03-31,1003,Foundation,300,600,300,1,00155,India
684518,2023-03-31,1006,Blush,150,300,150,1,00285,India
684518,2023-03-31,1003,Foundation,300,600,300,1,00285,India
684518,2023-03-31,1005,Nail Polish,50,100,50,1,00285,India
684518,2023-03-31,1001,Lipstick,150,300,150,1,00285,India
684518,2023-03-31,1004,Eyeliner,100,200,100,1,00285,India
754780,2023-03-31,1002,Mascara,200,400,200,1,00281,India
754780,2023-03-31,1004,Eyeliner,100,200,100,1,00281,India
754780,2023-03-31,1008,Makeup Remover,80,160,80,1,00281,India
913268,2023-03-31,1012,Body Lotion,200,400,200,1,00428,India
913268,2023-03-31,1005,Nail Polish,50,100,50,1,00428,India
913268,2023-03-31,1004,Eyeliner,100,200,100,1,00428,India
913268,2023-03-31,1001,Lipstick,150,300,150,1,00428,India
298970,2023-03-31,1008,Makeup Remover,80,160,80,1,00062,India
298970,2023-03-31,1007,Eyeshadow,200,400,200,1,00062,India
298970,2023-03-31,1006,Blush,150,300,150,1,00062,India
298970,2023-03-31,1009,Moisturizer,250,500,250,1,00062,India
208292,2023-03-31,1008,Makeup Remover,80,160,80,1,00182,India
822550,2023-03-31,1004,Eyeliner,100,200,100,1,00269,India
936844,2023-03-31,1008,Makeup Remover,80,160,80,1,00441,India
936844,2023-03-31,1004,Eyeliner,100,200,100,1,00441,India
806569,2023-03-31,1009,Moisturizer,250,500,250,1,00115,India
806569,2023-03-31,1004,Eyeliner,100,200,100,1,00115,India
806569,2023-03-31,1003,Foundation,300,600,300,1,00115,India
806569,2023-03-31,1008,Makeup Remover,80,160,80,1,00115,India
439587,2023-03-31,1009,Moisturizer,250,500,250,1,00415,India
439587,2023-03-31,1002,Mascara,200,400,200,1,00415,India
439587,2023-03-31,1003,Foundation,300,600,300,1,00415,India
907950,2023-03-31,1007,Eyeshadow,200,400,200,1,00449,India
524144,2023-03-31,1009,Moisturizer,250,500,250,1,00169,India
524144,2023-03-31,1003,Foundation,300,600,300,1,00169,India
524144,2023-03-31,1007,Eyeshadow,200,400,200,1,00169,India
524144,2023-03-31,1001,Lipstick,150,300,150,1,00169,India
810299,2023-03-31,1012,Body Lotion,200,400,200,1,00008,India
810299,2023-03-31,1007,Eyeshadow,200,400,200,1,00008,India
810299,2023-03-31,1008,Makeup Remover,80,160,80,1,00008,India
166826,2023-03-31,1012,Body Lotion,200,400,200,1,00385,India
278516,2023-03-31,1008,Makeup Remover,80,160,80,1,00112,India
730033,2023-03-31,1008,Makeup Remover,80,160,80,1,00058,India
420780,2023-03-31,1002,Mascara,200,400,200,1,00247,India
420780,2023-03-31,1003,Foundation,300,600,300,1,00247,India
420780,2023-03-31,1012,Body Lotion,200,400,200,1,00247,India
420780,2023-03-31,1001,Lipstick,150,300,150,1,00247,India
640917,2023-03-31,1012,Body Lotion,200,400,200,1,00460,India
205306,2023-03-31,1001,Lipstick,150,300,150,1,00385,India
371200,2023-03-31,1009,Moisturizer,250,500,250,1,00317,India
371200,2023-03-31,1006,Blush,150,300,150,1,00317,India
739845,2023-03-31,1006,Blush,150,300,150,1,00461,India
739845,2023-03-31,1005,Nail Polish,50,100,50,1,00461,India
739845,2023-03-31,1001,Lipstick,150,300,150,1,00461,India
822463,2023-03-31,1004,Eyeliner,100,200,100,1,00376,India
536388,2023-03-31,1006,Blush,150,300,150,1,00334,India
536388,2023-03-31,1005,Nail Polish,50,100,50,1,00334,India
536388,2023-03-31,1007,Eyeshadow,200,400,200,1,00334,India
536388,2023-03-31,1003,Foundation,300,600,300,1,00334,India
508182,2023-03-31,1001,Lipstick,150,300,150,1,00023,India
508182,2023-03-31,1009,Moisturizer,250,500,250,1,00023,India
267303,2023-03-31,1008,Makeup Remover,80,160,80,1,00216,India
267303,2023-03-31,1012,Body Lotion,200,400,200,1,00216,India
267303,2023-03-31,1009,Moisturizer,250,500,250,1,00216,India
267303,2023-03-31,1004,Eyeliner,100,200,100,1,00216,India
172419,2023-03-31,1001,Lipstick,150,300,150,1,00387,India
172419,2023-03-31,1005,Nail Polish,50,100,50,1,00387,India
697525,2023-03-31,1007,Eyeshadow,200,400,200,1,00192,India
697525,2023-03-31,1004,Eyeliner,100,200,100,1,00192,India
795514,2023-03-31,1003,Foundation,300,600,300,1,00035,India
795514,2023-03-31,1009,Moisturizer,250,500,250,1,00035,India
795514,2023-03-31,1006,Blush,150,300,150,1,00035,India
285899,2023-03-31,1012,Body Lotion,200,400,200,1,00349,India
833827,2023-03-31,1009,Moisturizer,250,500,250,1,00366,India
833827,2023-03-31,1001,Lipstick,150,300,150,1,00366,India
833827,2023-03-31,1007,Eyeshadow,200,400,200,1,00366,India
683842,2023-03-31,1008,Makeup Remover,80,160,80,1,00213,India
683842,2023-03-31,1007,Eyeshadow,200,400,200,1,00213,India
683842,2023-03-31,1001,Lipstick,150,300,150,1,00213,India
683842,2023-03-31,1009,Moisturizer,250,500,250,1,00213,India
683842,2023-03-31,1006,Blush,150,300,150,1,00213,India
145485,2023-03-31,1002,Mascara,200,400,200,1,00255,India
145485,2023-03-31,1009,Moisturizer,250,500,250,1,00255,India
119175,2023-03-31,1009,Moisturizer,250,500,250,1,00013,India
119175,2023-03-31,1012,Body Lotion,200,400,200,1,00013,India
215453,2023-03-31,1003,Foundation,300,600,300,1,00122,India
215453,2023-03-31,1009,Moisturizer,250,500,250,1,00122,India
251874,2023-03-31,1003,Foundation,300,600,300,1,00485,India
251874,2023-03-31,1004,Eyeliner,100,200,100,1,00485,India
251874,2023-03-31,1002,Mascara,200,400,200,1,00485,India
251874,2023-03-31,1007,Eyeshadow,200,400,200,1,00485,India
539160,2023-03-31,1003,Foundation,300,600,300,1,00472,India
539160,2023-03-31,1001,Lipstick,150,300,150,1,00472,India
539160,2023-03-31,1009,Moisturizer,250,500,250,1,00472,India
539160,2023-03-31,1006,Blush,150,300,150,1,00472,India
135814,2023-03-31,1005,Nail Polish,50,100,50,1,00079,India
135814,2023-03-31,1008,Makeup Remover,80,160,80,1,00079,India
853744,2023-03-31,1004,Eyeliner,100,200,100,1,00032,India
275668,2023-03-31,1009,Moisturizer,250,500,250,1,00415,India
275668,2023-03-31,1008,Makeup Remover,80,160,80,1,00415,India
621418,2023-03-31,1005,Nail Polish,50,100,50,1,00354,India
621418,2023-03-31,1001,Lipstick,150,300,150,1,00354,India
852743,2023-03-31,1004,Eyeliner,100,200,100,1,00442,India
852743,2023-03-31,1003,Foundation,300,600,300,1,00442,India
670651,2023-03-31,1012,Body Lotion,200,400,200,1,00245,India
589031,2023-04-01,1008,Makeup Remover,80,160,80,2,00098,India
589031,2023-04-01,1006,Blush,150,300,150,2,00098,India
589031,2023-04-01,1001,Lipstick,150,300,150,2,00098,India
897084,2023-04-01,1003,Foundation,300,600,300,2,00156,India
897084,2023-04-01,1008,Makeup Remover,80,160,80,2,00156,India
897084,2023-04-01,1009,Moisturizer,250,500,250,1,00156,India
897084,2023-04-01,1005,Nail Polish,50,100,50,2,00156,India
897084,2023-04-01,1001,Lipstick,150,300,150,2,00156,India
658422,2023-04-01,1004,Eyeliner,100,200,100,2,00223,India
658422,2023-04-01,1005,Nail Polish,50,100,50,2,00223,India
519031,2023-04-01,1003,Foundation,300,600,300,2,00298,India
550725,2023-04-01,1004,Eyeliner,100,200,100,2,00391,India
550725,2023-04-01,1008,Makeup Remover,80,160,80,2,00391,India
377754,2023-04-01,1001,Lipstick,150,300,150,2,00454,India
377754,2023-04-01,1003,Foundation,300,600,300,2,00454,India
377754,2023-04-01,1002,Mascara,200,400,200,2,00454,India
377754,2023-04-01,1007,Eyeshadow,200,400,200,2,00454,India
692694,2023-04-01,1003,Foundation,300,600,300,2,00413,India
692694,2023-04-01,1008,Makeup Remover,80,160,80,2,00413,India
692694,2023-04-01,1007,Eyeshadow,200,400,200,2,00413,India
538768,2023-04-01,1005,Nail Polish,50,100,50,2,00344,India
538768,2023-04-01,1009,Moisturizer,250,500,250,1,00344,India
538768,2023-04-01,1002,Mascara,200,400,200,2,00344,India
414483,2023-04-01,1002,Mascara,200,400,200,2,00216,India
433293,2023-04-01,1012,Body Lotion,200,400,200,1,00477,India
433293,2023-04-01,1001,Lipstick,150,300,150,2,00477,India
433293,2023-04-01,1004,Eyeliner,100,200,100,2,00477,India
433293,2023-04-01,1006,Blush,150,300,150,2,00477,India
429724,2023-04-01,1012,Body Lotion,200,400,200,1,00237,India
429724,2023-04-01,1006,Blush,150,300,150,2,00237,India
130464,2023-04-01,1012,Body Lotion,200,400,200,1,00254,India
130464,2023-04-01,1006,Blush,150,300,150,2,00254,India
130464,2023-04-01,1005,Nail Polish,50,100,50,2,00254,India
130464,2023-04-01,1007,Eyeshadow,200,400,200,2,00254,India
130464,2023-04-01,1004,Eyeliner,100,200,100,2,00254,India
781483,2023-04-01,1001,Lipstick,150,300,150,2,00082,India
781483,2023-04-01,1005,Nail Polish,50,100,50,2,00082,India
781483,2023-04-01,1003,Foundation,300,600,300,2,00082,India
781483,2023-04-01,1007,Eyeshadow,200,400,200,2,00082,India
199009,2023-04-01,1008,Makeup Remover,80,160,80,2,00018,India
199009,2023-04-01,1009,Moisturizer,250,500,250,1,00018,India
199009,2023-04-01,1012,Body Lotion,200,400,200,1,00018,India
671552,2023-04-01,1012,Body Lotion,200,400,200,1,00340,India
189311,2023-04-01,1002,Mascara,200,400,200,2,00141,India
687551,2023-04-01,1003,Foundation,300,600,300,2,00047,India
610340,2023-04-01,1007,Eyeshadow,200,400,200,2,00126,India
610340,2023-04-01,1001,Lipstick,150,300,150,2,00126,India
284583,2023-04-01,1009,Moisturizer,250,500,250,1,00268,India
284583,2023-04-01,1005,Nail Polish,50,100,50,2,00268,India
284583,2023-04-01,1001,Lipstick,150,300,150,2,00268,India
141570,2023-04-01,1001,Lipstick,150,300,150,2,00080,India
141570,2023-04-01,1004,Eyeliner,100,200,100,2,00080,India
141570,2023-04-01,1006,Blush,150,300,150,2,00080,India
141570,2023-04-01,1007,Eyeshadow,200,400,200,2,00080,India
646375,2023-04-01,1007,Eyeshadow,200,400,200,2,00083,India
646375,2023-04-01,1008,Makeup Remover,80,160,80,2,00083,India
646375,2023-04-01,1006,Blush,150,300,150,2,00083,India
194430,2023-04-01,1002,Mascara,200,400,200,2,00405,India
194430,2023-04-01,1012,Body Lotion,200,400,200,1,00405,India
344021,2023-04-01,1006,Blush,150,300,150,2,00052,India
964725,2023-04-01,1007,Eyeshadow,200,400,200,2,00496,India
964725,2023-04-01,1012,Body Lotion,200,400,200,1,00496,India
964725,2023-04-01,1003,Foundation,300,600,300,2,00496,India
218633,2023-04-01,1005,Nail Polish,50,100,50,2,00483,India
287076,2023-04-01,1004,Eyeliner,100,200,100,2,00112,India
287076,2023-04-01,1007,Eyeshadow,200,400,200,2,00112,India
287076,2023-04-01,1012,Body Lotion,200,400,200,1,00112,India
287076,2023-04-01,1003,Foundation,300,600,300,2,00112,India
570607,2023-04-01,1008,Makeup Remover,80,160,80,2,00306,India
570607,2023-04-01,1002,Mascara,200,400,200,2,00306,India
570607,2023-04-01,1003,Foundation,300,600,300,2,00306,India
570607,2023-04-01,1005,Nail Polish,50,100,50,2,00306,India
589849,2023-04-01,1002,Mascara,200,400,200,2,00314,India
589849,2023-04-01,1001,Lipstick,150,300,150,2,00314,India
833042,2023-04-01,1004,Eyeliner,100,200,100,2,00196,India
300722,2023-04-01,1004,Eyeliner,100,200,100,2,00362,India
300722,2023-04-01,1005,Nail Polish,50,100,50,2,00362,India
879610,2023-04-01,1003,Foundation,300,600,300,2,00137,India
627801,2023-04-01,1008,Makeup Remover,80,160,80,2,00044,India
627801,2023-04-01,1009,Moisturizer,250,500,250,1,00044,India
907117,2023-04-01,1008,Makeup Remover,80,160,80,2,00135,India
850028,2023-04-01,1008,Makeup Remover,80,160,80,2,00234,India
850028,2023-04-01,1004,Eyeliner,100,200,100,2,00234,India
850028,2023-04-01,1012,Body Lotion,200,400,200,1,00234,India
850028,2023-04-01,1006,Blush,150,300,150,2,00234,India
888295,2023-04-01,1002,Mascara,200,400,200,2,00317,India
888295,2023-04-01,1009,Moisturizer,250,500,250,1,00317,India
911198,2023-04-01,1009,Moisturizer,250,500,250,1,00154,India
229945,2023-04-01,1001,Lipstick,150,300,150,2,00334,India
229945,2023-04-01,1004,Eyeliner,100,200,100,2,00334,India
229945,2023-04-01,1012,Body Lotion,200,400,200,1,00334,India
506501,2023-04-01,1002,Mascara,200,400,200,2,00044,India
506501,2023-04-01,1008,Makeup Remover,80,160,80,2,00044,India
499987,2023-04-01,1006,Blush,150,300,150,2,00152,India
610978,2023-04-01,1004,Eyeliner,100,200,100,2,00215,India
610978,2023-04-01,1003,Foundation,300,600,300,2,00215,India
757505,2023-04-01,1001,Lipstick,150,300,150,2,00158,India
757505,2023-04-01,1009,Moisturizer,250,500,250,1,00158,India
757505,2023-04-01,1007,Eyeshadow,200,400,200,2,00158,India
100304,2023-04-01,1009,Moisturizer,250,500,250,1,00099,India
100304,2023-04-01,1003,Foundation,300,600,300,2,00099,India
153258,2023-04-01,1005,Nail Polish,50,100,50,2,00208,India
153258,2023-04-01,1001,Lipstick,150,300,150,2,00208,India
153258,2023-04-01,1008,Makeup Remover,80,160,80,2,00208,India
497415,2023-04-01,1008,Makeup Remover,80,160,80,2,00202,India
123180,2023-04-01,1005,Nail Polish,50,100,50,2,00131,India
123180,2023-04-01,1002,Mascara,200,400,200,2,00131,India
123180,2023-04-01,1001,Lipstick,150,300,150,2,00131,India
123180,2023-04-01,1006,Blush,150,300,150,2,00131,India
563410,2023-04-01,1008,Makeup Remover,80,160,80,2,00049,India
563410,2023-04-01,1006,Blush,150,300,150,2,00049,India
268758,2023-04-01,1009,Moisturizer,250,500,250,1,00240,India
268758,2023-04-01,1003,Foundation,300,600,300,2,00240,India
268758,2023-04-01,1007,Eyeshadow,200,400,200,2,00240,India
382511,2023-04-01,1008,Makeup Remover,80,160,80,2,00009,India
382511,2023-04-01,1006,Blush,150,300,150,2,00009,India
382511,2023-04-01,1009,Moisturizer,250,500,250,1,00009,India
382511,2023-04-01,1004,Eyeliner,100,200,100,2,00009,India
337354,2023-04-02,1006,Blush,150,300,150,2,00193,India
337354,2023-04-02,1012,Body Lotion,200,400,200,1,00193,India
356362,2023-04-02,1002,Mascara,200,400,200,2,00435,India
356362,2023-04-02,1012,Body Lotion,200,400,200,1,00435,India
356362,2023-04-02,1009,Moisturizer,250,500,250,1,00435,India
749115,2023-04-02,1004,Eyeliner,100,200,100,2,00282,India
749115,2023-04-02,1012,Body Lotion,200,400,200,1,00282,India
749115,2023-04-02,1008,Makeup Remover,80,160,80,2,00282,India
749115,2023-04-02,1002,Mascara,200,400,200,2,00282,India
547977,2023-04-02,1004,Eyeliner,100,200,100,2,00369,India
362580,2023-04-02,1007,Eyeshadow,200,400,200,2,00255,India
998378,2023-04-02,1001,Lipstick,150,300,150,2,00146,India
998378,2023-04-02,1007,Eyeshadow,200,400,200,2,00146,India
998378,2023-04-02,1009,Moisturizer,250,500,250,1,00146,India
998378,2023-04-02,1002,Mascara,200,400,200,2,00146,India
527130,2023-04-02,1004,Eyeliner,100,200,100,2,00259,India
527130,2023-04-02,1012,Body Lotion,200,400,200,1,00259,India
197249,2023-04-02,1008,Makeup Remover,80,160,80,2,00230,India
197249,2023-04-02,1004,Eyeliner,100,200,100,2,00230,India
197249,2023-04-02,1002,Mascara,200,400,200,2,00230,India
197249,2023-04-02,1012,Body Lotion,200,400,200,1,00230,India
197249,2023-04-02,1001,Lipstick,150,300,150,2,00230,India
549211,2023-04-02,1001,Lipstick,150,300,150,2,00268,India
549211,2023-04-02,1007,Eyeshadow,200,400,200,2,00268,India
549211,2023-04-02,1005,Nail Polish,50,100,50,2,00268,India
549211,2023-04-02,1003,Foundation,300,600,300,2,00268,India
933775,2023-04-02,1006,Blush,150,300,150,2,00087,India
932639,2023-04-02,1012,Body Lotion,200,400,200,1,00475,India
932639,2023-04-02,1002,Mascara,200,400,200,2,00475,India
932639,2023-04-02,1003,Foundation,300,600,300,2,00475,India
338930,2023-04-02,1007,Eyeshadow,200,400,200,2,00228,India
462962,2023-04-02,1003,Foundation,300,600,300,2,00359,India
534325,2023-04-02,1003,Foundation,300,600,300,2,00437,India
534325,2023-04-02,1009,Moisturizer,250,500,250,1,00437,India
534325,2023-04-02,1007,Eyeshadow,200,400,200,2,00437,India
534325,2023-04-02,1004,Eyeliner,100,200,100,2,00437,India
746430,2023-04-02,1003,Foundation,300,600,300,2,00337,India
746430,2023-04-02,1009,Moisturizer,250,500,250,1,00337,India
358961,2023-04-02,1012,Body Lotion,200,400,200,1,00107,India
358961,2023-04-02,1007,Eyeshadow,200,400,200,2,00107,India
358961,2023-04-02,1005,Nail Polish,50,100,50,2,00107,India
358961,2023-04-02,1002,Mascara,200,400,200,2,00107,India
704840,2023-04-02,1007,Eyeshadow,200,400,200,2,00187,India
704840,2023-04-02,1006,Blush,150,300,150,2,00187,India
704840,2023-04-02,1012,Body Lotion,200,400,200,1,00187,India
704840,2023-04-02,1008,Makeup Remover,80,160,80,2,00187,India
231200,2023-04-02,1009,Moisturizer,250,500,250,1,00026,India
231200,2023-04-02,1001,Lipstick,150,300,150,2,00026,India
688073,2023-04-02,1003,Foundation,300,600,300,2,00091,India
688073,2023-04-02,1002,Mascara,200,400,200,2,00091,India
982788,2023-04-02,1009,Moisturizer,250,500,250,1,00098,India
219433,2023-04-02,1003,Foundation,300,600,300,2,00458,India
795617,2023-04-02,1004,Eyeliner,100,200,100,2,00019,India
483926,2023-04-02,1005,Nail Polish,50,100,50,2,00130,India
483926,2023-04-02,1001,Lipstick,150,300,150,2,00130,India
359936,2023-04-02,1002,Mascara,200,400,200,2,00206,India
359936,2023-04-02,1001,Lipstick,150,300,150,2,00206,India
359936,2023-04-02,1003,Foundation,300,600,300,2,00206,India
285781,2023-04-02,1006,Blush,150,300,150,2,00108,India
285781,2023-04-02,1008,Makeup Remover,80,160,80,2,00108,India
285781,2023-04-02,1009,Moisturizer,250,500,250,1,00108,India
485707,2023-04-02,1008,Makeup Remover,80,160,80,2,00093,India
485707,2023-04-02,1004,Eyeliner,100,200,100,2,00093,India
485707,2023-04-02,1012,Body Lotion,200,400,200,1,00093,India
485707,2023-04-02,1003,Foundation,300,600,300,2,00093,India
352125,2023-04-02,1005,Nail Polish,50,100,50,2,00423,India
352125,2023-04-02,1004,Eyeliner,100,200,100,2,00423,India
597683,2023-04-02,1012,Body Lotion,200,400,200,1,00491,India
597683,2023-04-02,1001,Lipstick,150,300,150,2,00491,India
597683,2023-04-02,1004,Eyeliner,100,200,100,2,00491,India
597683,2023-04-02,1007,Eyeshadow,200,400,200,2,00491,India
740873,2023-04-02,1012,Body Lotion,200,400,200,1,00002,India
849981,2023-04-02,1012,Body Lotion,200,400,200,1,00395,India
849981,2023-04-02,1002,Mascara,200,400,200,2,00395,India
849981,2023-04-02,1005,Nail Polish,50,100,50,2,00395,India
222058,2023-04-02,1004,Eyeliner,100,200,100,2,00437,India
222058,2023-04-02,1008,Makeup Remover,80,160,80,2,00437,India
222058,2023-04-02,1002,Mascara,200,400,200,2,00437,India
222058,2023-04-02,1012,Body Lotion,200,400,200,1,00437,India
402184,2023-04-02,1012,Body Lotion,200,400,200,1,00073,India
402184,2023-04-02,1007,Eyeshadow,200,400,200,2,00073,India
402184,2023-04-02,1001,Lipstick,150,300,150,2,00073,India
836861,2023-04-02,1007,Eyeshadow,200,400,200,2,00391,India
836861,2023-04-02,1012,Body Lotion,200,400,200,1,00391,India
683673,2023-04-03,1009,Moisturizer,250,500,250,1,00330,India
683673,2023-04-03,1004,Eyeliner,100,200,100,2,00330,India
683673,2023-04-03,1005,Nail Polish,50,100,50,2,00330,India
941566,2023-04-03,1002,Mascara,200,400,200,2,00026,India
704423,2023-04-03,1006,Blush,150,300,150,2,00172,India
704423,2023-04-03,1009,Moisturizer,250,500,250,1,00172,India
704423,2023-04-03,1008,Makeup Remover,80,160,80,2,00172,India
976260,2023-04-03,1008,Makeup Remover,80,160,80,2,00117,India
976260,2023-04-03,1002,Mascara,200,400,200,2,00117,India
454105,2023-04-03,1006,Blush,150,300,150,2,00491,India
454105,2023-04-03,1008,Makeup Remover,80,160,80,2,00491,India
454105,2023-04-03,1001,Lipstick,150,300,150,2,00491,India
582906,2023-04-03,1009,Moisturizer,250,500,250,1,00214,India
582906,2023-04-03,1003,Foundation,300,600,300,2,00214,India
138725,2023-04-03,1009,Moisturizer,250,500,250,1,00271,India
138725,2023-04-03,1003,Foundation,300,600,300,2,00271,India
138725,2023-04-03,1002,Mascara,200,400,200,2,00271,India
138725,2023-04-03,1012,Body Lotion,200,400,200,1,00271,India
718952,2023-04-03,1003,Foundation,300,600,300,2,00080,India
718952,2023-04-03,1005,Nail Polish,50,100,50,2,00080,India
718952,2023-04-03,1004,Eyeliner,100,200,100,2,00080,India
718952,2023-04-03,1006,Blush,150,300,150,2,00080,India
694241,2023-04-03,1007,Eyeshadow,200,400,200,2,00314,India
840879,2023-04-03,1002,Mascara,200,400,200,2,00127,India
840879,2023-04-03,1004,Eyeliner,100,200,100,2,00127,India
757484,2023-04-03,1002,Mascara,200,400,200,2,00459,India
757484,2023-04-03,1012,Body Lotion,200,400,200,1,00459,India
757484,2023-04-03,1006,Blush,150,300,150,2,00459,India
199909,2023-04-03,1012,Body Lotion,200,400,200,1,00333,India
199909,2023-04-03,1009,Moisturizer,250,500,250,1,00333,India
866034,2023-04-03,1005,Nail Polish,50,100,50,2,00491,India
866034,2023-04-03,1002,Mascara,200,400,200,2,00491,India
866034,2023-04-03,1008,Makeup Remover,80,160,80,2,00491,India
265056,2023-04-03,1006,Blush,150,300,150,2,00168,India
399668,2023-04-03,1009,Moisturizer,250,500,250,1,00121,India
399668,2023-04-03,1003,Foundation,300,600,300,2,00121,India
399668,2023-04-03,1005,Nail Polish,50,100,50,2,00121,India
399668,2023-04-03,1004,Eyeliner,100,200,100,2,00121,India
399668,2023-04-03,1006,Blush,150,300,150,2,00121,India
966819,2023-04-03,1006,Blush,150,300,150,2,00070,India
966819,2023-04-03,1008,Makeup Remover,80,160,80,2,00070,India
966819,2023-04-03,1004,Eyeliner,100,200,100,2,00070,India
966819,2023-04-03,1005,Nail Polish,50,100,50,2,00070,India
268971,2023-04-03,1007,Eyeshadow,200,400,200,2,00491,India
268971,2023-04-03,1005,Nail Polish,50,100,50,2,00491,India
268971,2023-04-03,1006,Blush,150,300,150,2,00491,India
268971,2023-04-03,1003,Foundation,300,600,300,2,00491,India
402175,2023-04-03,1004,Eyeliner,100,200,100,2,00395,India
402175,2023-04-03,1012,Body Lotion,200,400,200,1,00395,India
402175,2023-04-03,1006,Blush,150,300,150,2,00395,India
402175,2023-04-03,1007,Eyeshadow,200,400,200,2,00395,India
724901,2023-04-03,1005,Nail Polish,50,100,50,2,00153,India
724901,2023-04-03,1006,Blush,150,300,150,2,00153,India
724901,2023-04-03,1002,Mascara,200,400,200,2,00153,India
393574,2023-04-03,1005,Nail Polish,50,100,50,2,00361,India
757108,2023-04-03,1012,Body Lotion,200,400,200,1,00034,India
757108,2023-04-03,1003,Foundation,300,600,300,2,00034,India
757108,2023-04-03,1002,Mascara,200,400,200,2,00034,India
381858,2023-04-03,1009,Moisturizer,250,500,250,1,00298,India
381858,2023-04-03,1012,Body Lotion,200,400,200,1,00298,India
419522,2023-04-03,1008,Makeup Remover,80,160,80,2,00363,India
363062,2023-04-03,1001,Lipstick,150,300,150,2,00024,India
363062,2023-04-03,1002,Mascara,200,400,200,2,00024,India
363062,2023-04-03,1004,Eyeliner,100,200,100,2,00024,India
899148,2023-04-03,1009,Moisturizer,250,500,250,1,00104,India
899148,2023-04-03,1002,Mascara,200,400,200,2,00104,India
899148,2023-04-03,1004,Eyeliner,100,200,100,2,00104,India
899148,2023-04-03,1006,Blush,150,300,150,2,00104,India
297263,2023-04-03,1004,Eyeliner,100,200,100,2,00438,India
297263,2023-04-03,1008,Makeup Remover,80,160,80,2,00438,India
297263,2023-04-03,1007,Eyeshadow,200,400,200,2,00438,India
644043,2023-04-03,1008,Makeup Remover,80,160,80,2,00235,India
644043,2023-04-03,1004,Eyeliner,100,200,100,2,00235,India
644043,2023-04-03,1012,Body Lotion,200,400,200,1,00235,India
558743,2023-04-03,1009,Moisturizer,250,500,250,1,00456,India
558743,2023-04-03,1007,Eyeshadow,200,400,200,2,00456,India
558743,2023-04-03,1004,Eyeliner,100,200,100,2,00456,India
558743,2023-04-03,1006,Blush,150,300,150,2,00456,India
558743,2023-04-03,1003,Foundation,300,600,300,2,00456,India
944570,2023-04-03,1012,Body Lotion,200,400,200,1,00218,India
944570,2023-04-03,1002,Mascara,200,400,200,2,00218,India
944570,2023-04-03,1001,Lipstick,150,300,150,2,00218,India
944570,2023-04-03,1006,Blush,150,300,150,2,00218,India
416443,2023-04-03,1008,Makeup Remover,80,160,80,2,00421,India
416443,2023-04-03,1005,Nail Polish,50,100,50,2,00421,India
416443,2023-04-03,1009,Moisturizer,250,500,250,1,00421,India
342169,2023-04-03,1006,Blush,150,300,150,2,00304,India
342169,2023-04-03,1005,Nail Polish,50,100,50,2,00304,India
820718,2023-04-03,1003,Foundation,300,600,300,2,00023,India
820718,2023-04-03,1002,Mascara,200,400,200,2,00023,India
162775,2023-04-03,1002,Mascara,200,400,200,2,00447,India
162775,2023-04-03,1004,Eyeliner,100,200,100,2,00447,India
741624,2023-04-03,1005,Nail Polish,50,100,50,2,00471,India
741624,2023-04-03,1006,Blush,150,300,150,2,00471,India
317257,2023-04-03,1003,Foundation,300,600,300,2,00323,India
317257,2023-04-03,1007,Eyeshadow,200,400,200,2,00323,India
317257,2023-04-03,1002,Mascara,200,400,200,2,00323,India
317257,2023-04-03,1001,Lipstick,150,300,150,2,00323,India
246870,2023-04-03,1009,Moisturizer,250,500,250,1,00065,India
246870,2023-04-03,1007,Eyeshadow,200,400,200,2,00065,India
246870,2023-04-03,1006,Blush,150,300,150,2,00065,India
923497,2023-04-03,1006,Blush,150,300,150,2,00047,India
926312,2023-04-03,1007,Eyeshadow,200,400,200,2,00480,India
926312,2023-04-03,1006,Blush,150,300,150,2,00480,India
926312,2023-04-03,1008,Makeup Remover,80,160,80,2,00480,India
926312,2023-04-03,1001,Lipstick,150,300,150,2,00480,India
329415,2023-04-03,1005,Nail Polish,50,100,50,2,00146,India
329415,2023-04-03,1012,Body Lotion,200,400,200,1,00146,India
329415,2023-04-03,1007,Eyeshadow,200,400,200,2,00146,India
882156,2023-04-03,1006,Blush,150,300,150,2,00192,India
464653,2023-04-03,1007,Eyeshadow,200,400,200,2,00089,India
464653,2023-04-03,1004,Eyeliner,100,200,100,2,00089,India
464653,2023-04-03,1005,Nail Polish,50,100,50,2,00089,India
464653,2023-04-03,1006,Blush,150,300,150,2,00089,India
368803,2023-04-03,1009,Moisturizer,250,500,250,1,00188,India
390885,2023-04-03,1012,Body Lotion,200,400,200,1,00244,India
390885,2023-04-03,1003,Foundation,300,600,300,2,00244,India
390885,2023-04-03,1002,Mascara,200,400,200,2,00244,India
290354,2023-04-03,1001,Lipstick,150,300,150,2,00332,India
290354,2023-04-03,1003,Foundation,300,600,300,2,00332,India
290354,2023-04-03,1006,Blush,150,300,150,2,00332,India
290354,2023-04-03,1008,Makeup Remover,80,160,80,2,00332,India
124194,2023-04-03,1008,Makeup Remover,80,160,80,2,00301,India
124194,2023-04-03,1007,Eyeshadow,200,400,200,2,00301,India
124194,2023-04-03,1006,Blush,150,300,150,2,00301,India
728569,2023-04-03,1004,Eyeliner,100,200,100,2,00336,India
728569,2023-04-03,1001,Lipstick,150,300,150,2,00336,India
275572,2023-04-03,1006,Blush,150,300,150,2,00095,India
275572,2023-04-03,1002,Mascara,200,400,200,2,00095,India
940962,2023-04-03,1008,Makeup Remover,80,160,80,2,00386,India
940962,2023-04-03,1005,Nail Polish,50,100,50,2,00386,India
940962,2023-04-03,1006,Blush,150,300,150,2,00386,India
971803,2023-04-04,1009,Moisturizer,250,500,250,1,00131,India
278750,2023-04-04,1005,Nail Polish,50,100,50,2,00386,India
278750,2023-04-04,1002,Mascara,200,400,200,2,00386,India
526444,2023-04-04,1008,Makeup Remover,80,160,80,2,00242,India
526444,2023-04-04,1006,Blush,150,300,150,2,00242,India
854291,2023-04-04,1003,Foundation,300,600,300,2,00239,India
854291,2023-04-04,1009,Moisturizer,250,500,250,1,00239,India
444340,2023-04-04,1012,Body Lotion,200,400,200,1,00254,India
444340,2023-04-04,1004,Eyeliner,100,200,100,2,00254,India
444340,2023-04-04,1005,Nail Polish,50,100,50,2,00254,India
444340,2023-04-04,1002,Mascara,200,400,200,2,00254,India
620321,2023-04-04,1003,Foundation,300,600,300,2,00494,India
620321,2023-04-04,1002,Mascara,200,400,200,2,00494,India
387679,2023-04-04,1006,Blush,150,300,150,2,00091,India
570760,2023-04-04,1007,Eyeshadow,200,400,200,2,00203,India
570760,2023-04-04,1008,Makeup Remover,80,160,80,2,00203,India
570760,2023-04-04,1003,Foundation,300,600,300,2,00203,India
336722,2023-04-04,1007,Eyeshadow,200,400,200,2,00033,India
336722,2023-04-04,1001,Lipstick,150,300,150,2,00033,India
336722,2023-04-04,1002,Mascara,200,400,200,2,00033,India
336722,2023-04-04,1004,Eyeliner,100,200,100,2,00033,India
493622,2023-04-04,1001,Lipstick,150,300,150,2,00357,India
512853,2023-04-04,1012,Body Lotion,200,400,200,1,00476,India
512853,2023-04-04,1001,Lipstick,150,300,150,2,00476,India
512853,2023-04-04,1006,Blush,150,300,150,2,00476,India
383130,2023-04-04,1002,Mascara,200,400,200,2,00057,India
383130,2023-04-04,1009,Moisturizer,250,500,250,1,00057,India
383130,2023-04-04,1006,Blush,150,300,150,2,00057,India
546620,2023-04-04,1006,Blush,150,300,150,2,00264,India
546620,2023-04-04,1009,Moisturizer,250,500,250,1,00264,India
130434,2023-04-04,1007,Eyeshadow,200,400,200,2,00427,India
109463,2023-04-04,1005,Nail Polish,50,100,50,2,00016,India
808561,2023-04-04,1003,Foundation,300,600,300,2,00166,India
808561,2023-04-04,1005,Nail Polish,50,100,50,2,00166,India
832595,2023-04-04,1007,Eyeshadow,200,400,200,2,00063,India
102993,2023-04-04,1001,Lipstick,150,300,150,2,00290,India
102993,2023-04-04,1005,Nail Polish,50,100,50,2,00290,India
102993,2023-04-04,1007,Eyeshadow,200,400,200,2,00290,India
102993,2023-04-04,1012,Body Lotion,200,400,200,1,00290,India
153783,2023-04-04,1001,Lipstick,150,300,150,2,00473,India
153783,2023-04-04,1005,Nail Polish,50,100,50,2,00473,India
153783,2023-04-04,1007,Eyeshadow,200,400,200,2,00473,India
153783,2023-04-04,1003,Foundation,300,600,300,2,00473,India
546005,2023-04-04,1004,Eyeliner,100,200,100,2,00295,India
659656,2023-04-04,1012,Body Lotion,200,400,200,1,00296,India
659656,2023-04-04,1005,Nail Polish,50,100,50,2,00296,India
659656,2023-04-04,1002,Mascara,200,400,200,2,00296,India
628282,2023-04-04,1003,Foundation,300,600,300,2,00200,India
628282,2023-04-04,1005,Nail Polish,50,100,50,2,00200,India
628282,2023-04-04,1004,Eyeliner,100,200,100,2,00200,India
775127,2023-04-04,1009,Moisturizer,250,500,250,1,00410,India
775127,2023-04-04,1001,Lipstick,150,300,150,2,00410,India
775127,2023-04-04,1003,Foundation,300,600,300,2,00410,India
832247,2023-04-04,1006,Blush,150,300,150,2,00061,India
380481,2023-04-04,1004,Eyeliner,100,200,100,2,00163,India
380481,2023-04-04,1005,Nail Polish,50,100,50,2,00163,India
380481,2023-04-04,1012,Body Lotion,200,400,200,1,00163,India
380481,2023-04-04,1003,Foundation,300,600,300,2,00163,India
380481,2023-04-04,1007,Eyeshadow,200,400,200,2,00163,India
734271,2023-04-04,1008,Makeup Remover,80,160,80,2,00394,India
734271,2023-04-04,1005,Nail Polish,50,100,50,2,00394,India
673205,2023-04-04,1005,Nail Polish,50,100,50,2,00063,India
673205,2023-04-04,1006,Blush,150,300,150,2,00063,India
673205,2023-04-04,1008,Makeup Remover,80,160,80,2,00063,India
673205,2023-04-04,1003,Foundation,300,600,300,2,00063,India
693934,2023-04-04,1002,Mascara,200,400,200,2,00275,India
693934,2023-04-04,1006,Blush,150,300,150,2,00275,India
693934,2023-04-04,1008,Makeup Remover,80,160,80,2,00275,India
693934,2023-04-04,1005,Nail Polish,50,100,50,2,00275,India
693934,2023-04-04,1003,Foundation,300,600,300,2,00275,India
160166,2023-04-04,1012,Body Lotion,200,400,200,1,00160,India
160166,2023-04-04,1005,Nail Polish,50,100,50,2,00160,India
160166,2023-04-04,1002,Mascara,200,400,200,2,00160,India
480073,2023-04-04,1007,Eyeshadow,200,400,200,2,00380,India
480073,2023-04-04,1008,Makeup Remover,80,160,80,2,00380,India
480073,2023-04-04,1005,Nail Polish,50,100,50,2,00380,India
480073,2023-04-04,1012,Body Lotion,200,400,200,1,00380,India
923254,2023-04-04,1001,Lipstick,150,300,150,2,00104,India
923254,2023-04-04,1006,Blush,150,300,150,2,00104,India
923254,2023-04-04,1012,Body Lotion,200,400,200,1,00104,India
923254,2023-04-04,1008,Makeup Remover,80,160,80,2,00104,India
281910,2023-04-05,1009,Moisturizer,250,500,250,1,00323,India
476470,2023-04-05,1009,Moisturizer,250,500,250,1,00453,India
515696,2023-04-05,1005,Nail Polish,50,100,50,2,00211,India
206465,2023-04-05,1009,Moisturizer,250,500,250,1,00453,India
276434,2023-04-05,1002,Mascara,200,400,200,2,00276,India
276434,2023-04-05,1006,Blush,150,300,150,2,00276,India
806246,2023-04-05,1002,Mascara,200,400,200,2,00290,India
806246,2023-04-05,1003,Foundation,300,600,300,2,00290,India
806246,2023-04-05,1006,Blush,150,300,150,2,00290,India
806246,2023-04-05,1009,Moisturizer,250,500,250,1,00290,India
806246,2023-04-05,1008,Makeup Remover,80,160,80,2,00290,India
148170,2023-04-05,1005,Nail Polish,50,100,50,2,00270,India
148170,2023-04-05,1008,Makeup Remover,80,160,80,2,00270,India
593270,2023-04-05,1006,Blush,150,300,150,2,00457,India
593270,2023-04-05,1001,Lipstick,150,300,150,2,00457,India
593270,2023-04-05,1007,Eyeshadow,200,400,200,2,00457,India
246647,2023-04-05,1012,Body Lotion,200,400,200,1,00030,India
246647,2023-04-05,1009,Moisturizer,250,500,250,1,00030,India
246647,2023-04-05,1008,Makeup Remover,80,160,80,2,00030,India
246647,2023-04-05,1002,Mascara,200,400,200,2,00030,India
913759,2023-04-05,1012,Body Lotion,200,400,200,1,00303,India
913759,2023-04-05,1007,Eyeshadow,200,400,200,2,00303,India
913759,2023-04-05,1003,Foundation,300,600,300,2,00303,India
644480,2023-04-05,1002,Mascara,200,400,200,2,00134,India
644480,2023-04-05,1006,Blush,150,300,150,2,00134,India
644480,2023-04-05,1004,Eyeliner,100,200,100,2,00134,India
746431,2023-04-05,1001,Lipstick,150,300,150,2,00174,India
935486,2023-04-05,1003,Foundation,300,600,300,2,00144,India
935486,2023-04-05,1002,Mascara,200,400,200,2,00144,India
935486,2023-04-05,1009,Moisturizer,250,500,250,1,00144,India
308132,2023-04-05,1007,Eyeshadow,200,400,200,2,00208,India
308132,2023-04-05,1003,Foundation,300,600,300,2,00208,India
308132,2023-04-05,1004,Eyeliner,100,200,100,2,00208,India
308132,2023-04-05,1002,Mascara,200,400,200,2,00208,India
780881,2023-04-05,1004,Eyeliner,100,200,100,2,00482,India
780881,2023-04-05,1002,Mascara,200,400,200,2,00482,India
813774,2023-04-05,1005,Nail Polish,50,100,50,2,00196,India
813774,2023-04-05,1009,Moisturizer,250,500,250,1,00196,India
813774,2023-04-05,1002,Mascara,200,400,200,2,00196,India
813774,2023-04-05,1006,Blush,150,300,150,2,00196,India
176942,2023-04-05,1005,Nail Polish,50,100,50,2,00213,India
251775,2023-04-05,1006,Blush,150,300,150,2,00168,India
251775,2023-04-05,1009,Moisturizer,250,500,250,1,00168,India
251775,2023-04-05,1005,Nail Polish,50,100,50,2,00168,India
875634,2023-04-05,1002,Mascara,200,400,200,2,00029,India
875634,2023-04-05,1008,Makeup Remover,80,160,80,2,00029,India
875634,2023-04-05,1007,Eyeshadow,200,400,200,2,00029,India
710015,2023-04-05,1003,Foundation,300,600,300,2,00258,India
710015,2023-04-05,1002,Mascara,200,400,200,2,00258,India
619901,2023-04-05,1006,Blush,150,300,150,2,00220,India
663389,2023-04-05,1012,Body Lotion,200,400,200,1,00167,India
663389,2023-04-05,1008,Makeup Remover,80,160,80,2,00167,India
663389,2023-04-05,1005,Nail Polish,50,100,50,2,00167,India
663389,2023-04-05,1006,Blush,150,300,150,2,00167,India
407109,2023-04-05,1012,Body Lotion,200,400,200,1,00045,India
407109,2023-04-05,1008,Makeup Remover,80,160,80,2,00045,India
407109,2023-04-05,1006,Blush,150,300,150,2,00045,India
407109,2023-04-05,1003,Foundation,300,600,300,2,00045,India
373441,2023-04-05,1005,Nail Polish,50,100,50,2,00160,India
373441,2023-04-05,1007,Eyeshadow,200,400,200,2,00160,India
121790,2023-04-05,1012,Body Lotion,200,400,200,1,00232,India
121790,2023-04-05,1006,Blush,150,300,150,2,00232,India
121790,2023-04-05,1002,Mascara,200,400,200,2,00232,India
121790,2023-04-05,1001,Lipstick,150,300,150,2,00232,India
121790,2023-04-05,1008,Makeup Remover,80,160,80,2,00232,India
167680,2023-04-05,1009,Moisturizer,250,500,250,1,00068,India
167680,2023-04-05,1001,Lipstick,150,300,150,2,00068,India
167680,2023-04-05,1005,Nail Polish,50,100,50,2,00068,India
167680,2023-04-05,1003,Foundation,300,600,300,2,00068,India
160875,2023-04-05,1009,Moisturizer,250,500,250,1,00160,India
160875,2023-04-05,1012,Body Lotion,200,400,200,1,00160,India
160875,2023-04-05,1004,Eyeliner,100,200,100,2,00160,India
126714,2023-04-05,1012,Body Lotion,200,400,200,1,00274,India
126714,2023-04-05,1008,Makeup Remover,80,160,80,2,00274,India
126714,2023-04-05,1007,Eyeshadow,200,400,200,2,00274,India
126714,2023-04-05,1003,Foundation,300,600,300,2,00274,India
126714,2023-04-05,1009,Moisturizer,250,500,250,1,00274,India
797367,2023-04-05,1003,Foundation,300,600,300,2,00382,India
797367,2023-04-05,1007,Eyeshadow,200,400,200,2,00382,India
177243,2023-04-05,1005,Nail Polish,50,100,50,2,00156,India
177243,2023-04-05,1001,Lipstick,150,300,150,2,00156,India
177243,2023-04-05,1009,Moisturizer,250,500,250,1,00156,India
177243,2023-04-05,1006,Blush,150,300,150,2,00156,India
957706,2023-04-05,1009,Moisturizer,250,500,250,1,00180,India
866920,2023-04-05,1008,Makeup Remover,80,160,80,2,00133,India
866920,2023-04-05,1003,Foundation,300,600,300,2,00133,India
866920,2023-04-05,1006,Blush,150,300,150,2,00133,India
261607,2023-04-05,1004,Eyeliner,100,200,100,2,00403,India
261607,2023-04-05,1003,Foundation,300,600,300,2,00403,India
261607,2023-04-05,1009,Moisturizer,250,500,250,1,00403,India
349960,2023-04-05,1007,Eyeshadow,200,400,200,2,00233,India
349960,2023-04-05,1006,Blush,150,300,150,2,00233,India
508402,2023-04-05,1005,Nail Polish,50,100,50,2,00139,India
508402,2023-04-05,1009,Moisturizer,250,500,250,1,00139,India
795444,2023-04-05,1002,Mascara,200,400,200,2,00401,India
764856,2023-04-05,1008,Makeup Remover,80,160,80,2,00244,India
764856,2023-04-05,1009,Moisturizer,250,500,250,1,00244,India
764856,2023-04-05,1006,Blush,150,300,150,2,00244,India
764856,2023-04-05,1001,Lipstick,150,300,150,2,00244,India
571802,2023-04-05,1012,Body Lotion,200,400,200,1,00500,India
571802,2023-04-05,1009,Moisturizer,250,500,250,1,00500,India
130478,2023-04-05,1008,Makeup Remover,80,160,80,2,00480,India
130478,2023-04-05,1002,Mascara,200,400,200,2,00480,India
713895,2023-04-05,1005,Nail Polish,50,100,50,2,00325,India
713895,2023-04-05,1012,Body Lotion,200,400,200,1,00325,India
713895,2023-04-05,1001,Lipstick,150,300,150,2,00325,India
951095,2023-04-05,1009,Moisturizer,250,500,250,1,00378,India
951095,2023-04-05,1004,Eyeliner,100,200,100,2,00378,India
951095,2023-04-05,1002,Mascara,200,400,200,2,00378,India
951095,2023-04-05,1005,Nail Polish,50,100,50,2,00378,India
161153,2023-04-06,1012,Body Lotion,200,400,200,1,00059,India
161153,2023-04-06,1007,Eyeshadow,200,400,200,2,00059,India
161153,2023-04-06,1006,Blush,150,300,150,2,00059,India
500380,2023-04-06,1002,Mascara,200,400,200,2,00130,India
500380,2023-04-06,1001,Lipstick,150,300,150,2,00130,India
500380,2023-04-06,1005,Nail Polish,50,100,50,2,00130,India
660503,2023-04-06,1008,Makeup Remover,80,160,80,2,00038,India
867737,2023-04-06,1001,Lipstick,150,300,150,2,00316,India
573338,2023-04-06,1002,Mascara,200,400,200,2,00219,India
573338,2023-04-06,1007,Eyeshadow,200,400,200,2,00219,India
573338,2023-04-06,1005,Nail Polish,50,100,50,2,00219,India
165798,2023-04-06,1009,Moisturizer,250,500,250,1,00178,India
165798,2023-04-06,1007,Eyeshadow,200,400,200,2,00178,India
439684,2023-04-06,1006,Blush,150,300,150,2,00476,India
439684,2023-04-06,1007,Eyeshadow,200,400,200,2,00476,India
439684,2023-04-06,1008,Makeup Remover,80,160,80,2,00476,India
439684,2023-04-06,1005,Nail Polish,50,100,50,2,00476,India
209424,2023-04-06,1002,Mascara,200,400,200,2,00102,India
853540,2023-04-06,1012,Body Lotion,200,400,200,1,00140,India
670458,2023-04-06,1009,Moisturizer,250,500,250,1,00007,India
670458,2023-04-06,1012,Body Lotion,200,400,200,1,00007,India
207483,2023-04-06,1006,Blush,150,300,150,2,00222,India
207483,2023-04-06,1005,Nail Polish,50,100,50,2,00222,India
207483,2023-04-06,1008,Makeup Remover,80,160,80,2,00222,India
817972,2023-04-06,1003,Foundation,300,600,300,2,00107,India
817972,2023-04-06,1001,Lipstick,150,300,150,2,00107,India
302825,2023-04-06,1006,Blush,150,300,150,2,00068,India
302825,2023-04-06,1007,Eyeshadow,200,400,200,2,00068,India
483874,2023-04-06,1001,Lipstick,150,300,150,2,00240,India
483874,2023-04-06,1008,Makeup Remover,80,160,80,2,00240,India
495415,2023-04-06,1008,Makeup Remover,80,160,80,2,00391,India
419198,2023-04-06,1007,Eyeshadow,200,400,200,2,00346,India
419198,2023-04-06,1002,Mascara,200,400,200,2,00346,India
419198,2023-04-06,1001,Lipstick,150,300,150,2,00346,India
459783,2023-04-06,1007,Eyeshadow,200,400,200,2,00395,India
459783,2023-04-06,1005,Nail Polish,50,100,50,2,00395,India
459783,2023-04-06,1003,Foundation,300,600,300,2,00395,India
459783,2023-04-06,1001,Lipstick,150,300,150,2,00395,India
375034,2023-04-06,1004,Eyeliner,100,200,100,2,00232,India
375034,2023-04-06,1006,Blush,150,300,150,2,00232,India
375034,2023-04-06,1007,Eyeshadow,200,400,200,2,00232,India
375034,2023-04-06,1009,Moisturizer,250,500,250,1,00232,India
819839,2023-04-06,1002,Mascara,200,400,200,2,00033,India
819839,2023-04-06,1004,Eyeliner,100,200,100,2,00033,India
703238,2023-04-06,1004,Eyeliner,100,200,100,2,00371,India
703238,2023-04-06,1007,Eyeshadow,200,400,200,2,00371,India
703238,2023-04-06,1009,Moisturizer,250,500,250,1,00371,India
579663,2023-04-06,1008,Makeup Remover,80,160,80,2,00489,India
579663,2023-04-06,1009,Moisturizer,250,500,250,1,00489,India
579663,2023-04-06,1006,Blush,150,300,150,2,00489,India
467138,2023-04-06,1004,Eyeliner,100,200,100,2,00225,India
467138,2023-04-06,1012,Body Lotion,200,400,200,1,00225,India
467138,2023-04-06,1005,Nail Polish,50,100,50,2,00225,India
800413,2023-04-06,1005,Nail Polish,50,100,50,2,00327,India
800413,2023-04-06,1004,Eyeliner,100,200,100,2,00327,India
800413,2023-04-06,1003,Foundation,300,600,300,2,00327,India
944911,2023-04-06,1004,Eyeliner,100,200,100,2,00497,India
944911,2023-04-06,1009,Moisturizer,250,500,250,1,00497,India
944911,2023-04-06,1006,Blush,150,300,150,2,00497,India
155314,2023-04-06,1001,Lipstick,150,300,150,2,00187,India
155314,2023-04-06,1007,Eyeshadow,200,400,200,2,00187,India
155314,2023-04-06,1002,Mascara,200,400,200,2,00187,India
832486,2023-04-06,1003,Foundation,300,600,300,2,00475,India
832486,2023-04-06,1007,Eyeshadow,200,400,200,2,00475,India
431019,2023-04-06,1004,Eyeliner,100,200,100,2,00360,India
548055,2023-04-06,1008,Makeup Remover,80,160,80,2,00336,India
548055,2023-04-06,1005,Nail Polish,50,100,50,2,00336,India
445077,2023-04-06,1005,Nail Polish,50,100,50,2,00288,India
445077,2023-04-06,1012,Body Lotion,200,400,200,1,00288,India
445077,2023-04-06,1002,Mascara,200,400,200,2,00288,India
445077,2023-04-06,1008,Makeup Remover,80,160,80,2,00288,India
445077,2023-04-06,1009,Moisturizer,250,500,250,1,00288,India
766078,2023-04-06,1009,Moisturizer,250,500,250,1,00149,India
766078,2023-04-06,1007,Eyeshadow,200,400,200,2,00149,India
766078,2023-04-06,1003,Foundation,300,600,300,2,00149,India
319475,2023-04-06,1001,Lipstick,150,300,150,2,00488,India
948052,2023-04-06,1001,Lipstick,150,300,150,2,00187,India
948052,2023-04-06,1008,Makeup Remover,80,160,80,2,00187,India
948052,2023-04-06,1012,Body Lotion,200,400,200,1,00187,India
905175,2023-04-06,1004,Eyeliner,100,200,100,2,00053,India
905175,2023-04-06,1007,Eyeshadow,200,400,200,2,00053,India
905175,2023-04-06,1003,Foundation,300,600,300,2,00053,India
905175,2023-04-06,1001,Lipstick,150,300,150,2,00053,India
206153,2023-04-06,1004,Eyeliner,100,200,100,2,00041,India
206153,2023-04-06,1007,Eyeshadow,200,400,200,2,00041,India
206153,2023-04-06,1006,Blush,150,300,150,2,00041,India
206153,2023-04-06,1003,Foundation,300,600,300,2,00041,India
944916,2023-04-07,1009,Moisturizer,250,500,250,1,00029,India
944916,2023-04-07,1006,Blush,150,300,150,2,00029,India
944916,2023-04-07,1005,Nail Polish,50,100,50,2,00029,India
221453,2023-04-07,1007,Eyeshadow,200,400,200,2,00451,India
221453,2023-04-07,1001,Lipstick,150,300,150,2,00451,India
221453,2023-04-07,1002,Mascara,200,400,200,2,00451,India
429338,2023-04-07,1005,Nail Polish,50,100,50,2,00003,India
429338,2023-04-07,1009,Moisturizer,250,500,250,1,00003,India
429338,2023-04-07,1007,Eyeshadow,200,400,200,2,00003,India
429338,2023-04-07,1012,Body Lotion,200,400,200,1,00003,India
626692,2023-04-07,1009,Moisturizer,250,500,250,1,00195,India
626692,2023-04-07,1012,Body Lotion,200,400,200,1,00195,India
243058,2023-04-07,1001,Lipstick,150,300,150,2,00355,India
243058,2023-04-07,1002,Mascara,200,400,200,2,00355,India
243058,2023-04-07,1008,Makeup Remover,80,160,80,2,00355,India
243058,2023-04-07,1007,Eyeshadow,200,400,200,2,00355,India
843689,2023-04-07,1007,Eyeshadow,200,400,200,2,00350,India
921573,2023-04-07,1003,Foundation,300,600,300,2,00381,India
921573,2023-04-07,1002,Mascara,200,400,200,2,00381,India
921573,2023-04-07,1001,Lipstick,150,300,150,2,00381,India
921573,2023-04-07,1008,Makeup Remover,80,160,80,2,00381,India
283774,2023-04-07,1005,Nail Polish,50,100,50,2,00384,India
283774,2023-04-07,1003,Foundation,300,600,300,2,00384,India
470667,2023-04-07,1004,Eyeliner,100,200,100,2,00351,India
573028,2023-04-07,1008,Makeup Remover,80,160,80,2,00313,India
573028,2023-04-07,1003,Foundation,300,600,300,2,00313,India
573028,2023-04-07,1002,Mascara,200,400,200,2,00313,India
256873,2023-04-07,1001,Lipstick,150,300,150,2,00236,India
256873,2023-04-07,1008,Makeup Remover,80,160,80,2,00236,India
256873,2023-04-07,1006,Blush,150,300,150,2,00236,India
856352,2023-04-07,1002,Mascara,200,400,200,2,00093,India
856352,2023-04-07,1007,Eyeshadow,200,400,200,2,00093,India
990107,2023-04-07,1012,Body Lotion,200,400,200,1,00103,India
990107,2023-04-07,1007,Eyeshadow,200,400,200,2,00103,India
990107,2023-04-07,1002,Mascara,200,400,200,2,00103,India
533541,2023-04-07,1004,Eyeliner,100,200,100,2,00237,India
533541,2023-04-07,1001,Lipstick,150,300,150,2,00237,India
533541,2023-04-07,1007,Eyeshadow,200,400,200,2,00237,India
675562,2023-04-07,1007,Eyeshadow,200,400,200,2,00486,India
675562,2023-04-07,1009,Moisturizer,250,500,250,1,00486,India
675562,2023-04-07,1012,Body Lotion,200,400,200,1,00486,India
675562,2023-04-07,1003,Foundation,300,600,300,2,00486,India
675562,2023-04-07,1004,Eyeliner,100,200,100,2,00486,India
315119,2023-04-07,1012,Body Lotion,200,400,200,1,00432,India
315119,2023-04-07,1002,Mascara,200,400,200,2,00432,India
141617,2023-04-07,1001,Lipstick,150,300,150,2,00371,India
141617,2023-04-07,1004,Eyeliner,100,200,100,2,00371,India
141617,2023-04-07,1007,Eyeshadow,200,400,200,2,00371,India
141617,2023-04-07,1005,Nail Polish,50,100,50,2,00371,India
745901,2023-04-07,1003,Foundation,300,600,300,2,00266,India
269706,2023-04-07,1009,Moisturizer,250,500,250,1,00263,India
160310,2023-04-07,1004,Eyeliner,100,200,100,2,00224,India
319360,2023-04-07,1002,Mascara,200,400,200,2,00189,India
958999,2023-04-07,1005,Nail Polish,50,100,50,2,00188,India
958999,2023-04-07,1002,Mascara,200,400,200,2,00188,India
958999,2023-04-07,1006,Blush,150,300,150,2,00188,India
327603,2023-04-07,1008,Makeup Remover,80,160,80,2,00106,India
327603,2023-04-07,1005,Nail Polish,50,100,50,2,00106,India
327603,2023-04-07,1012,Body Lotion,200,400,200,1,00106,India
229118,2023-04-07,1001,Lipstick,150,300,150,2,00468,India
229118,2023-04-07,1009,Moisturizer,250,500,250,1,00468,India
229118,2023-04-07,1002,Mascara,200,400,200,2,00468,India
229118,2023-04-07,1003,Foundation,300,600,300,2,00468,India
722172,2023-04-07,1009,Moisturizer,250,500,250,1,00332,India
722172,2023-04-07,1007,Eyeshadow,200,400,200,2,00332,India
722172,2023-04-07,1005,Nail Polish,50,100,50,2,00332,India
722172,2023-04-07,1001,Lipstick,150,300,150,2,00332,India
140573,2023-04-07,1005,Nail Polish,50,100,50,2,00317,India
140573,2023-04-07,1007,Eyeshadow,200,400,200,2,00317,India
140573,2023-04-07,1003,Foundation,300,600,300,2,00317,India
140573,2023-04-07,1002,Mascara,200,400,200,2,00317,India
756572,2023-04-07,1012,Body Lotion,200,400,200,1,00071,India
756572,2023-04-07,1007,Eyeshadow,200,400,200,2,00071,India
756572,2023-04-07,1009,Moisturizer,250,500,250,1,00071,India
697315,2023-04-07,1006,Blush,150,300,150,2,00319,India
697315,2023-04-07,1007,Eyeshadow,200,400,200,2,00319,India
370539,2023-04-07,1009,Moisturizer,250,500,250,1,00183,India
370539,2023-04-07,1008,Makeup Remover,80,160,80,2,00183,India
370539,2023-04-07,1002,Mascara,200,400,200,2,00183,India
370539,2023-04-07,1003,Foundation,300,600,300,2,00183,India
486192,2023-04-07,1004,Eyeliner,100,200,100,2,00455,India
486192,2023-04-07,1005,Nail Polish,50,100,50,2,00455,India
486192,2023-04-07,1001,Lipstick,150,300,150,2,00455,India
486192,2023-04-07,1003,Foundation,300,600,300,2,00455,India
390487,2023-04-07,1006,Blush,150,300,150,2,00380,India
910786,2023-04-07,1003,Foundation,300,600,300,2,00070,India
910786,2023-04-07,1005,Nail Polish,50,100,50,2,00070,India
206013,2023-04-07,1002,Mascara,200,400,200,2,00365,India
158878,2023-04-07,1007,Eyeshadow,200,400,200,2,00364,India
158878,2023-04-07,1006,Blush,150,300,150,2,00364,India
158878,2023-04-07,1002,Mascara,200,400,200,2,00364,India
496333,2023-04-07,1004,Eyeliner,100,200,100,2,00425,India
496333,2023-04-07,1006,Blush,150,300,150,2,00425,India
496333,2023-04-07,1003,Foundation,300,600,300,2,00425,India
496333,2023-04-07,1007,Eyeshadow,200,400,200,2,00425,India
496333,2023-04-07,1009,Moisturizer,250,500,250,1,00425,India
490798,2023-04-07,1008,Makeup Remover,80,160,80,2,00311,India
490798,2023-04-07,1006,Blush,150,300,150,2,00311,India
490798,2023-04-07,1005,Nail Polish,50,100,50,2,00311,India
164691,2023-04-07,1012,Body Lotion,200,400,200,1,00352,India
164691,2023-04-07,1003,Foundation,300,600,300,2,00352,India
433834,2023-04-07,1008,Makeup Remover,80,160,80,2,00208,India
433834,2023-04-07,1007,Eyeshadow,200,400,200,2,00208,India
433834,2023-04-07,1004,Eyeliner,100,200,100,2,00208,India
433834,2023-04-07,1006,Blush,150,300,150,2,00208,India
433834,2023-04-07,1009,Moisturizer,250,500,250,1,00208,India
924991,2023-04-07,1005,Nail Polish,50,100,50,2,00476,India
590880,2023-04-07,1008,Makeup Remover,80,160,80,2,00451,India
590880,2023-04-07,1004,Eyeliner,100,200,100,2,00451,India
590880,2023-04-07,1001,Lipstick,150,300,150,2,00451,India
590880,2023-04-07,1005,Nail Polish,50,100,50,2,00451,India
543779,2023-04-07,1009,Moisturizer,250,500,250,1,00147,India
543779,2023-04-07,1002,Mascara,200,400,200,2,00147,India
543779,2023-04-07,1007,Eyeshadow,200,400,200,2,00147,India
543779,2023-04-07,1004,Eyeliner,100,200,100,2,00147,India
566916,2023-04-07,1001,Lipstick,150,300,150,2,00146,India
218464,2023-04-07,1005,Nail Polish,50,100,50,2,00476,India
218464,2023-04-07,1008,Makeup Remover,80,160,80,2,00476,India
223300,2023-04-07,1007,Eyeshadow,200,400,200,2,00140,India
223300,2023-04-07,1004,Eyeliner,100,200,100,2,00140,India
223300,2023-04-07,1012,Body Lotion,200,400,200,1,00140,India
440455,2023-04-07,1004,Eyeliner,100,200,100,2,00148,India
440455,2023-04-07,1006,Blush,150,300,150,2,00148,India
440455,2023-04-07,1007,Eyeshadow,200,400,200,2,00148,India
440455,2023-04-07,1009,Moisturizer,250,500,250,1,00148,India
224169,2023-04-07,1008,Makeup Remover,80,160,80,2,00465,India
224169,2023-04-07,1003,Foundation,300,600,300,2,00465,India
224169,2023-04-07,1005,Nail Polish,50,100,50,2,00465,India
224169,2023-04-07,1001,Lipstick,150,300,150,2,00465,India
138238,2023-04-07,1006,Blush,150,300,150,2,00346,India
138238,2023-04-07,1007,Eyeshadow,200,400,200,2,00346,India
288316,2023-04-08,1006,Blush,150,300,150,2,00203,India
721313,2023-04-08,1006,Blush,150,300,150,2,00214,India
721313,2023-04-08,1003,Foundation,300,600,300,2,00214,India
721313,2023-04-08,1001,Lipstick,150,300,150,2,00214,India
503437,2023-04-08,1008,Makeup Remover,80,160,80,2,00338,India
503437,2023-04-08,1004,Eyeliner,100,200,100,2,00338,India
751371,2023-04-08,1001,Lipstick,150,300,150,2,00066,India
751371,2023-04-08,1002,Mascara,200,400,200,2,00066,India
211955,2023-04-08,1012,Body Lotion,200,400,200,1,00472,India
211955,2023-04-08,1008,Makeup Remover,80,160,80,2,00472,India
726831,2023-04-08,1004,Eyeliner,100,200,100,2,00219,India
726831,2023-04-08,1005,Nail Polish,50,100,50,2,00219,India
726831,2023-04-08,1003,Foundation,300,600,300,2,00219,India
311087,2023-04-08,1008,Makeup Remover,80,160,80,2,00247,India
311087,2023-04-08,1007,Eyeshadow,200,400,200,2,00247,India
361930,2023-04-08,1007,Eyeshadow,200,400,200,2,00271,India
361930,2023-04-08,1006,Blush,150,300,150,2,00271,India
620804,2023-04-08,1008,Makeup Remover,80,160,80,2,00295,India
620804,2023-04-08,1005,Nail Polish,50,100,50,2,00295,India
666894,2023-04-08,1008,Makeup Remover,80,160,80,2,00493,India
666894,2023-04-08,1001,Lipstick,150,300,150,2,00493,India
666894,2023-04-08,1006,Blush,150,300,150,2,00493,India
188736,2023-04-08,1005,Nail Polish,50,100,50,2,00119,India
188736,2023-04-08,1008,Makeup Remover,80,160,80,2,00119,India
188736,2023-04-08,1012,Body Lotion,200,400,200,1,00119,India
188736,2023-04-08,1009,Moisturizer,250,500,250,1,00119,India
249661,2023-04-08,1004,Eyeliner,100,200,100,2,00478,India
249661,2023-04-08,1003,Foundation,300,600,300,2,00478,India
380028,2023-04-08,1012,Body Lotion,200,400,200,1,00407,India
380028,2023-04-08,1002,Mascara,200,400,200,2,00407,India
234475,2023-04-08,1001,Lipstick,150,300,150,2,00238,India
234475,2023-04-08,1009,Moisturizer,250,500,250,1,00238,India
582930,2023-04-08,1003,Foundation,300,600,300,2,00231,India
164699,2023-04-08,1007,Eyeshadow,200,400,200,2,00268,India
164699,2023-04-08,1005,Nail Polish,50,100,50,2,00268,India
164699,2023-04-08,1012,Body Lotion,200,400,200,1,00268,India
462549,2023-04-08,1009,Moisturizer,250,500,250,1,00088,India
462549,2023-04-08,1007,Eyeshadow,200,400,200,2,00088,India
462549,2023-04-08,1008,Makeup Remover,80,160,80,2,00088,India
462549,2023-04-08,1003,Foundation,300,600,300,2,00088,India
670137,2023-04-08,1012,Body Lotion,200,400,200,1,00229,India
670137,2023-04-08,1006,Blush,150,300,150,2,00229,India
670137,2023-04-08,1005,Nail Polish,50,100,50,2,00229,India
670137,2023-04-08,1003,Foundation,300,600,300,2,00229,India
670137,2023-04-08,1007,Eyeshadow,200,400,200,2,00229,India
857024,2023-04-08,1002,Mascara,200,400,200,2,00402,India
857024,2023-04-08,1001,Lipstick,150,300,150,2,00402,India
857024,2023-04-08,1004,Eyeliner,100,200,100,2,00402,India
857024,2023-04-08,1003,Foundation,300,600,300,2,00402,India
954749,2023-04-08,1003,Foundation,300,600,300,2,00182,India
954749,2023-04-08,1004,Eyeliner,100,200,100,2,00182,India
954749,2023-04-08,1007,Eyeshadow,200,400,200,2,00182,India
954749,2023-04-08,1001,Lipstick,150,300,150,2,00182,India
954749,2023-04-08,1006,Blush,150,300,150,2,00182,India
622116,2023-04-08,1007,Eyeshadow,200,400,200,2,00410,India
622116,2023-04-08,1009,Moisturizer,250,500,250,1,00410,India
622116,2023-04-08,1004,Eyeliner,100,200,100,2,00410,India
731221,2023-04-08,1007,Eyeshadow,200,400,200,2,00460,India
731221,2023-04-08,1009,Moisturizer,250,500,250,1,00460,India
731221,2023-04-08,1012,Body Lotion,200,400,200,1,00460,India
539696,2023-04-08,1012,Body Lotion,200,400,200,1,00305,India
539696,2023-04-08,1001,Lipstick,150,300,150,2,00305,India
539696,2023-04-08,1007,Eyeshadow,200,400,200,2,00305,India
827363,2023-04-08,1005,Nail Polish,50,100,50,2,00077,India
827363,2023-04-08,1012,Body Lotion,200,400,200,1,00077,India
827363,2023-04-08,1009,Moisturizer,250,500,250,1,00077,India
140768,2023-04-08,1001,Lipstick,150,300,150,2,00206,India
140768,2023-04-08,1002,Mascara,200,400,200,2,00206,India
435240,2023-04-08,1002,Mascara,200,400,200,2,00118,India
435240,2023-04-08,1001,Lipstick,150,300,150,2,00118,India
435240,2023-04-08,1007,Eyeshadow,200,400,200,2,00118,India
235164,2023-04-08,1012,Body Lotion,200,400,200,1,00019,India
235164,2023-04-08,1003,Foundation,300,600,300,2,00019,India
412280,2023-04-08,1005,Nail Polish,50,100,50,2,00478,India
412280,2023-04-08,1006,Blush,150,300,150,2,00478,India
412280,2023-04-08,1002,Mascara,200,400,200,2,00478,India
412280,2023-04-08,1004,Eyeliner,100,200,100,2,00478,India
790944,2023-04-08,1009,Moisturizer,250,500,250,1,00332,India
790944,2023-04-08,1002,Mascara,200,400,200,2,00332,India
790944,2023-04-08,1004,Eyeliner,100,200,100,2,00332,India
307350,2023-04-08,1003,Foundation,300,600,300,2,00291,India
307350,2023-04-08,1001,Lipstick,150,300,150,2,00291,India
307350,2023-04-08,1002,Mascara,200,400,200,2,00291,India
307350,2023-04-08,1008,Makeup Remover,80,160,80,2,00291,India
673090,2023-04-08,1012,Body Lotion,200,400,200,1,00320,India
673090,2023-04-08,1003,Foundation,300,600,300,2,00320,India
343383,2023-04-08,1012,Body Lotion,200,400,200,1,00399,India
343383,2023-04-08,1005,Nail Polish,50,100,50,2,00399,India
343383,2023-04-08,1004,Eyeliner,100,200,100,2,00399,India
400904,2023-04-08,1009,Moisturizer,250,500,250,1,00299,India
292698,2023-04-08,1006,Blush,150,300,150,2,00099,India
774909,2023-04-08,1004,Eyeliner,100,200,100,2,00483,India
774909,2023-04-08,1005,Nail Polish,50,100,50,2,00483,India
774909,2023-04-08,1003,Foundation,300,600,300,2,00483,India
244038,2023-04-08,1002,Mascara,200,400,200,2,00455,India
244038,2023-04-08,1003,Foundation,300,600,300,2,00455,India
244038,2023-04-08,1001,Lipstick,150,300,150,2,00455,India
244038,2023-04-08,1012,Body Lotion,200,400,200,1,00455,India
219810,2023-04-08,1008,Makeup Remover,80,160,80,2,00015,India
193222,2023-04-08,1001,Lipstick,150,300,150,2,00433,India
193222,2023-04-08,1007,Eyeshadow,200,400,200,2,00433,India
478728,2023-04-08,1009,Moisturizer,250,500,250,1,00309,India
572952,2023-04-08,1003,Foundation,300,600,300,2,00064,India
959983,2023-04-08,1003,Foundation,300,600,300,2,00430,India
959983,2023-04-08,1004,Eyeliner,100,200,100,2,00430,India
922642,2023-04-09,1005,Nail Polish,50,100,50,2,00374,India
454041,2023-04-09,1006,Blush,150,300,150,2,00372,India
454041,2023-04-09,1001,Lipstick,150,300,150,2,00372,India
797488,2023-04-09,1004,Eyeliner,100,200,100,2,00111,India
797488,2023-04-09,1012,Body Lotion,200,400,200,1,00111,India
797488,2023-04-09,1003,Foundation,300,600,300,2,00111,India
989152,2023-04-09,1002,Mascara,200,400,200,2,00272,India
614737,2023-04-09,1003,Foundation,300,600,300,2,00263,India
614737,2023-04-09,1008,Makeup Remover,80,160,80,2,00263,India
614737,2023-04-09,1007,Eyeshadow,200,400,200,2,00263,India
614737,2023-04-09,1009,Moisturizer,250,500,250,1,00263,India
981368,2023-04-09,1004,Eyeliner,100,200,100,2,00185,India
981368,2023-04-09,1012,Body Lotion,200,400,200,1,00185,India
981368,2023-04-09,1007,Eyeshadow,200,400,200,2,00185,India
981368,2023-04-09,1005,Nail Polish,50,100,50,2,00185,India
358237,2023-04-09,1006,Blush,150,300,150,2,00418,India
358237,2023-04-09,1009,Moisturizer,250,500,250,1,00418,India
358237,2023-04-09,1002,Mascara,200,400,200,2,00418,India
639653,2023-04-09,1012,Body Lotion,200,400,200,1,00373,India
305245,2023-04-09,1009,Moisturizer,250,500,250,1,00090,India
305245,2023-04-09,1006,Blush,150,300,150,2,00090,India
190367,2023-04-09,1004,Eyeliner,100,200,100,2,00500,India
190367,2023-04-09,1009,Moisturizer,250,500,250,1,00500,India
190367,2023-04-09,1012,Body Lotion,200,400,200,1,00500,India
190367,2023-04-09,1006,Blush,150,300,150,2,00500,India
190367,2023-04-09,1007,Eyeshadow,200,400,200,2,00500,India
468049,2023-04-09,1007,Eyeshadow,200,400,200,2,00304,India
468049,2023-04-09,1005,Nail Polish,50,100,50,2,00304,India
969610,2023-04-09,1009,Moisturizer,250,500,250,1,00207,India
969610,2023-04-09,1004,Eyeliner,100,200,100,2,00207,India
969610,2023-04-09,1007,Eyeshadow,200,400,200,2,00207,India
969610,2023-04-09,1005,Nail Polish,50,100,50,2,00207,India
162470,2023-04-09,1002,Mascara,200,400,200,2,00318,India
162470,2023-04-09,1001,Lipstick,150,300,150,2,00318,India
162470,2023-04-09,1008,Makeup Remover,80,160,80,2,00318,India
558039,2023-04-09,1003,Foundation,300,600,300,2,00046,India
558039,2023-04-09,1005,Nail Polish,50,100,50,2,00046,India
558039,2023-04-09,1007,Eyeshadow,200,400,200,2,00046,India
558039,2023-04-09,1004,Eyeliner,100,200,100,2,00046,India
558039,2023-04-09,1012,Body Lotion,200,400,200,1,00046,India
594988,2023-04-09,1009,Moisturizer,250,500,250,1,00246,India
594988,2023-04-09,1005,Nail Polish,50,100,50,2,00246,India
594988,2023-04-09,1006,Blush,150,300,150,2,00246,India
594988,2023-04-09,1007,Eyeshadow,200,400,200,2,00246,India
985243,2023-04-09,1002,Mascara,200,400,200,2,00290,India
985243,2023-04-09,1008,Makeup Remover,80,160,80,2,00290,India
985243,2023-04-09,1005,Nail Polish,50,100,50,2,00290,India
985243,2023-04-09,1007,Eyeshadow,200,400,200,2,00290,India
724136,2023-04-09,1007,Eyeshadow,200,400,200,2,00435,India
724136,2023-04-09,1001,Lipstick,150,300,150,2,00435,India
724136,2023-04-09,1009,Moisturizer,250,500,250,1,00435,India
724136,2023-04-09,1002,Mascara,200,400,200,2,00435,India
706482,2023-04-09,1006,Blush,150,300,150,2,00433,India
706482,2023-04-09,1012,Body Lotion,200,400,200,1,00433,India
706482,2023-04-09,1009,Moisturizer,250,500,250,1,00433,India
706482,2023-04-09,1007,Eyeshadow,200,400,200,2,00433,India
712037,2023-04-09,1012,Body Lotion,200,400,200,1,00172,India
712037,2023-04-09,1008,Makeup Remover,80,160,80,2,00172,India
712037,2023-04-09,1006,Blush,150,300,150,2,00172,India
917337,2023-04-09,1001,Lipstick,150,300,150,2,00343,India
917337,2023-04-09,1008,Makeup Remover,80,160,80,2,00343,India
989144,2023-04-09,1007,Eyeshadow,200,400,200,2,00399,India
989144,2023-04-09,1006,Blush,150,300,150,2,00399,India
989144,2023-04-09,1002,Mascara,200,400,200,2,00399,India
651674,2023-04-09,1002,Mascara,200,400,200,2,00364,India
651674,2023-04-09,1009,Moisturizer,250,500,250,1,00364,India
651674,2023-04-09,1003,Foundation,300,600,300,2,00364,India
481600,2023-04-09,1007,Eyeshadow,200,400,200,2,00264,India
481600,2023-04-09,1009,Moisturizer,250,500,250,1,00264,India
481600,2023-04-09,1005,Nail Polish,50,100,50,2,00264,India
146971,2023-04-09,1004,Eyeliner,100,200,100,2,00138,India
485388,2023-04-09,1012,Body Lotion,200,400,200,1,00086,India
485388,2023-04-09,1005,Nail Polish,50,100,50,2,00086,India
979806,2023-04-09,1008,Makeup Remover,80,160,80,2,00003,India
979806,2023-04-09,1001,Lipstick,150,300,150,2,00003,India
979806,2023-04-09,1007,Eyeshadow,200,400,200,2,00003,India
979806,2023-04-09,1006,Blush,150,300,150,2,00003,India
899236,2023-04-09,1008,Makeup Remover,80,160,80,2,00097,India
699207,2023-04-09,1006,Blush,150,300,150,2,00337,India
699207,2023-04-09,1002,Mascara,200,400,200,2,00337,India
926974,2023-04-09,1009,Moisturizer,250,500,250,1,00299,India
926974,2023-04-09,1001,Lipstick,150,300,150,2,00299,India
926974,2023-04-09,1006,Blush,150,300,150,2,00299,India
227374,2023-04-09,1008,Makeup Remover,80,160,80,2,00425,India
227374,2023-04-09,1004,Eyeliner,100,200,100,2,00425,India
835417,2023-04-10,1004,Eyeliner,100,200,100,2,00021,India
835417,2023-04-10,1003,Foundation,300,600,300,2,00021,India
624600,2023-04-10,1006,Blush,150,300,150,2,00398,India
293611,2023-04-10,1007,Eyeshadow,200,400,200,2,00477,India
851839,2023-04-10,1001,Lipstick,150,300,150,2,00078,India
851839,2023-04-10,1004,Eyeliner,100,200,100,2,00078,India
851839,2023-04-10,1006,Blush,150,300,150,2,00078,India
851839,2023-04-10,1009,Moisturizer,250,500,250,1,00078,India
126938,2023-04-10,1002,Mascara,200,400,200,2,00056,India
306329,2023-04-10,1004,Eyeliner,100,200,100,2,00345,India
306329,2023-04-10,1008,Makeup Remover,80,160,80,2,00345,India
306329,2023-04-10,1007,Eyeshadow,200,400,200,2,00345,India
681594,2023-04-10,1003,Foundation,300,600,300,2,00307,India
681594,2023-04-10,1001,Lipstick,150,300,150,2,00307,India
681594,2023-04-10,1004,Eyeliner,100,200,100,2,00307,India
681594,2023-04-10,1008,Makeup Remover,80,160,80,2,00307,India
711656,2023-04-10,1005,Nail Polish,50,100,50,2,00444,India
711656,2023-04-10,1002,Mascara,200,400,200,2,00444,India
838619,2023-04-10,1005,Nail Polish,50,100,50,2,00390,India
838619,2023-04-10,1004,Eyeliner,100,200,100,2,00390,India
854987,2023-04-10,1005,Nail Polish,50,100,50,2,00426,India
854987,2023-04-10,1001,Lipstick,150,300,150,2,00426,India
854987,2023-04-10,1004,Eyeliner,100,200,100,2,00426,India
854987,2023-04-10,1009,Moisturizer,250,500,250,1,00426,India
461842,2023-04-10,1009,Moisturizer,250,500,250,1,00443,India
384454,2023-04-10,1007,Eyeshadow,200,400,200,2,00073,India
783794,2023-04-10,1005,Nail Polish,50,100,50,2,00122,India
783794,2023-04-10,1006,Blush,150,300,150,2,00122,India
783794,2023-04-10,1003,Foundation,300,600,300,2,00122,India
783794,2023-04-10,1008,Makeup Remover,80,160,80,2,00122,India
180030,2023-04-10,1002,Mascara,200,400,200,2,00250,India
180030,2023-04-10,1001,Lipstick,150,300,150,2,00250,India
605633,2023-04-10,1005,Nail Polish,50,100,50,2,00332,India
605633,2023-04-10,1003,Foundation,300,600,300,2,00332,India
605633,2023-04-10,1004,Eyeliner,100,200,100,2,00332,India
576708,2023-04-10,1012,Body Lotion,200,400,200,1,00247,India
576708,2023-04-10,1001,Lipstick,150,300,150,2,00247,India
576708,2023-04-10,1007,Eyeshadow,200,400,200,2,00247,India
465120,2023-04-10,1005,Nail Polish,50,100,50,2,00225,India
465120,2023-04-10,1002,Mascara,200,400,200,2,00225,India
465120,2023-04-10,1004,Eyeliner,100,200,100,2,00225,India
465120,2023-04-10,1009,Moisturizer,250,500,250,1,00225,India
561135,2023-04-10,1006,Blush,150,300,150,2,00123,India
561135,2023-04-10,1002,Mascara,200,400,200,2,00123,India
561135,2023-04-10,1009,Moisturizer,250,500,250,1,00123,India
561135,2023-04-10,1008,Makeup Remover,80,160,80,2,00123,India
626954,2023-04-10,1007,Eyeshadow,200,400,200,2,00169,India
156001,2023-04-10,1001,Lipstick,150,300,150,2,00375,India
156001,2023-04-10,1005,Nail Polish,50,100,50,2,00375,India
156001,2023-04-10,1002,Mascara,200,400,200,2,00375,India
233817,2023-04-10,1008,Makeup Remover,80,160,80,2,00454,India
233817,2023-04-10,1005,Nail Polish,50,100,50,2,00454,India
233817,2023-04-10,1012,Body Lotion,200,400,200,1,00454,India
233817,2023-04-10,1009,Moisturizer,250,500,250,1,00454,India
883274,2023-04-10,1003,Foundation,300,600,300,2,00475,India
883274,2023-04-10,1007,Eyeshadow,200,400,200,2,00475,India
883274,2023-04-10,1005,Nail Polish,50,100,50,2,00475,India
723703,2023-04-10,1007,Eyeshadow,200,400,200,2,00154,India
723703,2023-04-10,1009,Moisturizer,250,500,250,1,00154,India
723703,2023-04-10,1001,Lipstick,150,300,150,2,00154,India
453909,2023-04-10,1012,Body Lotion,200,400,200,1,00192,India
453909,2023-04-10,1005,Nail Polish,50,100,50,2,00192,India
453909,2023-04-10,1001,Lipstick,150,300,150,2,00192,India
414520,2023-04-10,1002,Mascara,200,400,200,2,00037,India
414520,2023-04-10,1001,Lipstick,150,300,150,2,00037,India
298885,2023-04-10,1012,Body Lotion,200,400,200,1,00245,India
298885,2023-04-10,1006,Blush,150,300,150,2,00245,India
298885,2023-04-10,1005,Nail Polish,50,100,50,2,00245,India
736315,2023-04-10,1009,Moisturizer,250,500,250,1,00195,India
736315,2023-04-10,1012,Body Lotion,200,400,200,1,00195,India
762290,2023-04-10,1006,Blush,150,300,150,2,00163,India
762290,2023-04-10,1001,Lipstick,150,300,150,2,00163,India
762290,2023-04-10,1012,Body Lotion,200,400,200,1,00163,India
762290,2023-04-10,1003,Foundation,300,600,300,2,00163,India
328748,2023-04-10,1001,Lipstick,150,300,150,2,00338,India
573092,2023-04-10,1005,Nail Polish,50,100,50,2,00461,India
573092,2023-04-10,1004,Eyeliner,100,200,100,2,00461,India
573092,2023-04-10,1009,Moisturizer,250,500,250,1,00461,India
440646,2023-04-10,1004,Eyeliner,100,200,100,2,00054,India
871138,2023-04-10,1004,Eyeliner,100,200,100,2,00172,India
871138,2023-04-10,1006,Blush,150,300,150,2,00172,India
871138,2023-04-10,1001,Lipstick,150,300,150,2,00172,India
871138,2023-04-10,1012,Body Lotion,200,400,200,1,00172,India
457042,2023-04-10,1008,Makeup Remover,80,160,80,2,00325,India
651866,2023-04-10,1001,Lipstick,150,300,150,2,00100,India
651866,2023-04-10,1006,Blush,150,300,150,2,00100,India
651866,2023-04-10,1007,Eyeshadow,200,400,200,2,00100,India
651866,2023-04-10,1003,Foundation,300,600,300,2,00100,India
337176,2023-04-10,1009,Moisturizer,250,500,250,1,00165,India
337176,2023-04-10,1003,Foundation,300,600,300,2,00165,India
337176,2023-04-10,1002,Mascara,200,400,200,2,00165,India
671440,2023-04-10,1005,Nail Polish,50,100,50,2,00336,India
671440,2023-04-10,1007,Eyeshadow,200,400,200,2,00336,India
671440,2023-04-10,1006,Blush,150,300,150,2,00336,India
671440,2023-04-10,1001,Lipstick,150,300,150,2,00336,India
317484,2023-04-11,1006,Blush,150,300,150,2,00322,India
317484,2023-04-11,1003,Foundation,300,600,300,2,00322,India
624602,2023-04-11,1006,Blush,150,300,150,2,00030,India
624602,2023-04-11,1009,Moisturizer,250,500,250,1,00030,India
170681,2023-04-11,1001,Lipstick,150,300,150,2,00393,India
170681,2023-04-11,1004,Eyeliner,100,200,100,2,00393,India
170681,2023-04-11,1005,Nail Polish,50,100,50,2,00393,India
170681,2023-04-11,1006,Blush,150,300,150,2,00393,India
607222,2023-04-11,1003,Foundation,300,600,300,2,00310,India
607222,2023-04-11,1001,Lipstick,150,300,150,2,00310,India
607222,2023-04-11,1007,Eyeshadow,200,400,200,2,00310,India
607222,2023-04-11,1009,Moisturizer,250,500,250,1,00310,India
735664,2023-04-11,1006,Blush,150,300,150,2,00408,India
735664,2023-04-11,1009,Moisturizer,250,500,250,1,00408,India
531040,2023-04-11,1006,Blush,150,300,150,2,00382,India
861905,2023-04-11,1005,Nail Polish,50,100,50,2,00479,India
861905,2023-04-11,1003,Foundation,300,600,300,2,00479,India
861905,2023-04-11,1006,Blush,150,300,150,2,00479,India
408395,2023-04-11,1012,Body Lotion,200,400,200,1,00076,India
983029,2023-04-11,1002,Mascara,200,400,200,2,00195,India
983029,2023-04-11,1007,Eyeshadow,200,400,200,2,00195,India
983029,2023-04-11,1001,Lipstick,150,300,150,2,00195,India
983029,2023-04-11,1005,Nail Polish,50,100,50,2,00195,India
733080,2023-04-11,1003,Foundation,300,600,300,2,00485,India
733080,2023-04-11,1012,Body Lotion,200,400,200,1,00485,India
733080,2023-04-11,1006,Blush,150,300,150,2,00485,India
944886,2023-04-11,1005,Nail Polish,50,100,50,2,00090,India
944886,2023-04-11,1002,Mascara,200,400,200,2,00090,India
944886,2023-04-11,1012,Body Lotion,200,400,200,1,00090,India
944886,2023-04-11,1006,Blush,150,300,150,2,00090,India
304030,2023-04-11,1009,Moisturizer,250,500,250,1,00144,India
304030,2023-04-11,1003,Foundation,300,600,300,2,00144,India
799881,2023-04-11,1004,Eyeliner,100,200,100,2,00130,India
799881,2023-04-11,1006,Blush,150,300,150,2,00130,India
473821,2023-04-11,1001,Lipstick,150,300,150,2,00491,India
473821,2023-04-11,1007,Eyeshadow,200,400,200,2,00491,India
473821,2023-04-11,1009,Moisturizer,250,500,250,1,00491,India
473821,2023-04-11,1012,Body Lotion,200,400,200,1,00491,India
473821,2023-04-11,1006,Blush,150,300,150,2,00491,India
490300,2023-04-11,1002,Mascara,200,400,200,2,00248,India
490300,2023-04-11,1008,Makeup Remover,80,160,80,2,00248,India
490300,2023-04-11,1005,Nail Polish,50,100,50,2,00248,India
490300,2023-04-11,1009,Moisturizer,250,500,250,1,00248,India
490300,2023-04-11,1003,Foundation,300,600,300,2,00248,India
869110,2023-04-11,1012,Body Lotion,200,400,200,1,00488,India
869110,2023-04-11,1006,Blush,150,300,150,2,00488,India
869110,2023-04-11,1003,Foundation,300,600,300,2,00488,India
869110,2023-04-11,1009,Moisturizer,250,500,250,1,00488,India
869110,2023-04-11,1002,Mascara,200,400,200,2,00488,India
277917,2023-04-11,1004,Eyeliner,100,200,100,2,00446,India
277917,2023-04-11,1012,Body Lotion,200,400,200,1,00446,India
506793,2023-04-11,1012,Body Lotion,200,400,200,1,00323,India
506793,2023-04-11,1009,Moisturizer,250,500,250,1,00323,India
506793,2023-04-11,1006,Blush,150,300,150,2,00323,India
972608,2023-04-11,1012,Body Lotion,200,400,200,1,00052,India
972608,2023-04-11,1001,Lipstick,150,300,150,2,00052,India
604709,2023-04-11,1002,Mascara,200,400,200,2,00291,India
604709,2023-04-11,1007,Eyeshadow,200,400,200,2,00291,India
182241,2023-04-11,1008,Makeup Remover,80,160,80,2,00298,India
182241,2023-04-11,1004,Eyeliner,100,200,100,2,00298,India
182241,2023-04-11,1012,Body Lotion,200,400,200,1,00298,India
182241,2023-04-11,1005,Nail Polish,50,100,50,2,00298,India
399125,2023-04-11,1002,Mascara,200,400,200,2,00488,India
399125,2023-04-11,1005,Nail Polish,50,100,50,2,00488,India
399125,2023-04-11,1008,Makeup Remover,80,160,80,2,00488,India
454468,2023-04-11,1007,Eyeshadow,200,400,200,2,00001,India
454468,2023-04-11,1009,Moisturizer,250,500,250,1,00001,India
672060,2023-04-11,1006,Blush,150,300,150,2,00059,India
564616,2023-04-11,1002,Mascara,200,400,200,2,00130,India
564616,2023-04-11,1012,Body Lotion,200,400,200,1,00130,India
696148,2023-04-11,1007,Eyeshadow,200,400,200,2,00150,India
696148,2023-04-11,1008,Makeup Remover,80,160,80,2,00150,India
696148,2023-04-11,1001,Lipstick,150,300,150,2,00150,India
139583,2023-04-11,1012,Body Lotion,200,400,200,1,00452,India
139583,2023-04-11,1003,Foundation,300,600,300,2,00452,India
456704,2023-04-11,1007,Eyeshadow,200,400,200,2,00382,India
456704,2023-04-11,1008,Makeup Remover,80,160,80,2,00382,India
273859,2023-04-11,1012,Body Lotion,200,400,200,1,00030,India
273859,2023-04-11,1007,Eyeshadow,200,400,200,2,00030,India
273859,2023-04-11,1006,Blush,150,300,150,2,00030,India
617585,2023-04-11,1004,Eyeliner,100,200,100,2,00450,India
229975,2023-04-11,1003,Foundation,300,600,300,2,00031,India
229975,2023-04-11,1006,Blush,150,300,150,2,00031,India
363023,2023-04-11,1002,Mascara,200,400,200,2,00339,India
363023,2023-04-11,1008,Makeup Remover,80,160,80,2,00339,India
363023,2023-04-11,1009,Moisturizer,250,500,250,1,00339,India
363023,2023-04-11,1004,Eyeliner,100,200,100,2,00339,India
587359,2023-04-11,1003,Foundation,300,600,300,2,00373,India
179710,2023-04-11,1004,Eyeliner,100,200,100,2,00384,India
179710,2023-04-11,1008,Makeup Remover,80,160,80,2,00384,India
981879,2023-04-11,1002,Mascara,200,400,200,2,00495,India
981879,2023-04-11,1009,Moisturizer,250,500,250,1,00495,India
981879,2023-04-11,1003,Foundation,300,600,300,2,00495,India
981879,2023-04-11,1007,Eyeshadow,200,400,200,2,00495,India
608618,2023-04-11,1001,Lipstick,150,300,150,2,00392,India
608618,2023-04-11,1002,Mascara,200,400,200,2,00392,India
452557,2023-04-11,1012,Body Lotion,200,400,200,1,00472,India
452557,2023-04-11,1007,Eyeshadow,200,400,200,2,00472,India
454072,2023-04-11,1005,Nail Polish,50,100,50,2,00387,India
454072,2023-04-11,1001,Lipstick,150,300,150,2,00387,India
454072,2023-04-11,1002,Mascara,200,400,200,2,00387,India
565589,2023-04-11,1009,Moisturizer,250,500,250,1,00462,India
565589,2023-04-11,1004,Eyeliner,100,200,100,2,00462,India
565589,2023-04-11,1008,Makeup Remover,80,160,80,2,00462,India
471988,2023-04-12,1001,Lipstick,150,300,150,2,00259,India
516836,2023-04-12,1012,Body Lotion,200,400,200,1,00174,India
516836,2023-04-12,1007,Eyeshadow,200,400,200,2,00174,India
199160,2023-04-12,1005,Nail Polish,50,100,50,2,00455,India
199160,2023-04-12,1006,Blush,150,300,150,2,00455,India
627526,2023-04-12,1009,Moisturizer,250,500,250,1,00037,India
627526,2023-04-12,1005,Nail Polish,50,100,50,2,00037,India
636048,2023-04-12,1004,Eyeliner,100,200,100,2,00163,India
636048,2023-04-12,1008,Makeup Remover,80,160,80,2,00163,India
636048,2023-04-12,1005,Nail Polish,50,100,50,2,00163,India
636048,2023-04-12,1012,Body Lotion,200,400,200,1,00163,India
922762,2023-04-12,1002,Mascara,200,400,200,2,00426,India
922762,2023-04-12,1003,Foundation,300,600,300,2,00426,India
922762,2023-04-12,1009,Moisturizer,250,500,250,1,00426,India
419927,2023-04-12,1004,Eyeliner,100,200,100,2,00226,India
419927,2023-04-12,1012,Body Lotion,200,400,200,1,00226,India
419927,2023-04-12,1002,Mascara,200,400,200,2,00226,India
419927,2023-04-12,1006,Blush,150,300,150,2,00226,India
630548,2023-04-12,1002,Mascara,200,400,200,2,00127,India
805092,2023-04-12,1001,Lipstick,150,300,150,2,00057,India
805092,2023-04-12,1009,Moisturizer,250,500,250,1,00057,India
805092,2023-04-12,1005,Nail Polish,50,100,50,2,00057,India
805092,2023-04-12,1004,Eyeliner,100,200,100,2,00057,India
908629,2023-04-12,1005,Nail Polish,50,100,50,2,00159,India
908629,2023-04-12,1001,Lipstick,150,300,150,2,00159,India
908629,2023-04-12,1003,Foundation,300,600,300,2,00159,India
908629,2023-04-12,1002,Mascara,200,400,200,2,00159,India
841170,2023-04-12,1003,Foundation,300,600,300,2,00452,India
841170,2023-04-12,1008,Makeup Remover,80,160,80,2,00452,India
115029,2023-04-12,1001,Lipstick,150,300,150,2,00231,India
115029,2023-04-12,1009,Moisturizer,250,500,250,1,00231,India
498701,2023-04-12,1006,Blush,150,300,150,2,00499,India
514343,2023-04-12,1005,Nail Polish,50,100,50,2,00069,India
514343,2023-04-12,1002,Mascara,200,400,200,2,00069,India
514343,2023-04-12,1007,Eyeshadow,200,400,200,2,00069,India
827421,2023-04-12,1003,Foundation,300,600,300,2,00187,India
827421,2023-04-12,1009,Moisturizer,250,500,250,1,00187,India
827421,2023-04-12,1007,Eyeshadow,200,400,200,2,00187,India
827421,2023-04-12,1002,Mascara,200,400,200,2,00187,India
527543,2023-04-12,1003,Foundation,300,600,300,2,00496,India
521867,2023-04-12,1002,Mascara,200,400,200,2,00456,India
521867,2023-04-12,1012,Body Lotion,200,400,200,1,00456,India
521867,2023-04-12,1005,Nail Polish,50,100,50,2,00456,India
694325,2023-04-12,1004,Eyeliner,100,200,100,2,00463,India
694325,2023-04-12,1006,Blush,150,300,150,2,00463,India
694325,2023-04-12,1003,Foundation,300,600,300,2,00463,India
922280,2023-04-12,1012,Body Lotion,200,400,200,1,00472,India
269108,2023-04-12,1004,Eyeliner,100,200,100,2,00136,India
269108,2023-04-12,1009,Moisturizer,250,500,250,1,00136,India
269108,2023-04-12,1012,Body Lotion,200,400,200,1,00136,India
269108,2023-04-12,1007,Eyeshadow,200,400,200,2,00136,India
307613,2023-04-12,1004,Eyeliner,100,200,100,2,00230,India
307613,2023-04-12,1002,Mascara,200,400,200,2,00230,India
307613,2023-04-12,1008,Makeup Remover,80,160,80,2,00230,India
307613,2023-04-12,1012,Body Lotion,200,400,200,1,00230,India
307613,2023-04-12,1009,Moisturizer,250,500,250,1,00230,India
961736,2023-04-12,1003,Foundation,300,600,300,2,00474,India
961736,2023-04-12,1007,Eyeshadow,200,400,200,2,00474,India
961736,2023-04-12,1004,Eyeliner,100,200,100,2,00474,India
218277,2023-04-12,1002,Mascara,200,400,200,2,00036,India
218277,2023-04-12,1012,Body Lotion,200,400,200,1,00036,India
666496,2023-04-12,1012,Body Lotion,200,400,200,1,00359,India
666496,2023-04-12,1004,Eyeliner,100,200,100,2,00359,India
666496,2023-04-12,1002,Mascara,200,400,200,2,00359,India
583281,2023-04-12,1009,Moisturizer,250,500,250,1,00477,India
583281,2023-04-12,1005,Nail Polish,50,100,50,2,00477,India
771953,2023-04-12,1006,Blush,150,300,150,2,00041,India
771953,2023-04-12,1001,Lipstick,150,300,150,2,00041,India
887637,2023-04-12,1007,Eyeshadow,200,400,200,2,00384,India
887637,2023-04-12,1012,Body Lotion,200,400,200,1,00384,India
887637,2023-04-12,1006,Blush,150,300,150,2,00384,India
887637,2023-04-12,1003,Foundation,300,600,300,2,00384,India
329367,2023-04-12,1007,Eyeshadow,200,400,200,2,00091,India
329367,2023-04-12,1002,Mascara,200,400,200,2,00091,India
329367,2023-04-12,1012,Body Lotion,200,400,200,1,00091,India
329367,2023-04-12,1001,Lipstick,150,300,150,2,00091,India
329367,2023-04-12,1008,Makeup Remover,80,160,80,2,00091,India
211176,2023-04-12,1006,Blush,150,300,150,2,00310,India
211176,2023-04-12,1004,Eyeliner,100,200,100,2,00310,India
211176,2023-04-12,1007,Eyeshadow,200,400,200,2,00310,India
211176,2023-04-12,1003,Foundation,300,600,300,2,00310,India
438918,2023-04-12,1006,Blush,150,300,150,2,00372,India
438918,2023-04-12,1003,Foundation,300,600,300,2,00372,India
438918,2023-04-12,1004,Eyeliner,100,200,100,2,00372,India
323492,2023-04-12,1002,Mascara,200,400,200,2,00270,India
323492,2023-04-12,1001,Lipstick,150,300,150,2,00270,India
323492,2023-04-12,1004,Eyeliner,100,200,100,2,00270,India
323492,2023-04-12,1012,Body Lotion,200,400,200,1,00270,India
323492,2023-04-12,1008,Makeup Remover,80,160,80,2,00270,India
515451,2023-04-12,1001,Lipstick,150,300,150,2,00493,India
515451,2023-04-12,1002,Mascara,200,400,200,2,00493,India
515451,2023-04-12,1005,Nail Polish,50,100,50,2,00493,India
515451,2023-04-12,1008,Makeup Remover,80,160,80,2,00493,India
802517,2023-04-12,1003,Foundation,300,600,300,2,00099,India
802517,2023-04-12,1005,Nail Polish,50,100,50,2,00099,India
802517,2023-04-12,1007,Eyeshadow,200,400,200,2,00099,India
241052,2023-04-12,1012,Body Lotion,200,400,200,1,00243,India
241052,2023-04-12,1008,Makeup Remover,80,160,80,2,00243,India
241052,2023-04-12,1005,Nail Polish,50,100,50,2,00243,India
494425,2023-04-12,1008,Makeup Remover,80,160,80,2,00423,India
753720,2023-04-12,1007,Eyeshadow,200,400,200,2,00441,India
753720,2023-04-12,1003,Foundation,300,600,300,2,00441,India
924402,2023-04-12,1008,Makeup Remover,80,160,80,2,00464,India
924402,2023-04-12,1002,Mascara,200,400,200,2,00464,India
924402,2023-04-12,1001,Lipstick,150,300,150,2,00464,India
171576,2023-04-12,1002,Mascara,200,400,200,2,00415,India
194693,2023-04-12,1012,Body Lotion,200,400,200,1,00194,India
194693,2023-04-12,1002,Mascara,200,400,200,2,00194,India
194693,2023-04-12,1008,Makeup Remover,80,160,80,2,00194,India
194693,2023-04-12,1004,Eyeliner,100,200,100,2,00194,India
194693,2023-04-12,1006,Blush,150,300,150,2,00194,India
742501,2023-04-12,1004,Eyeliner,100,200,100,2,00251,India
742501,2023-04-12,1005,Nail Polish,50,100,50,2,00251,India
937787,2023-04-13,1004,Eyeliner,100,200,100,2,00129,India
937787,2023-04-13,1001,Lipstick,150,300,150,2,00129,India
937787,2023-04-13,1012,Body Lotion,200,400,200,1,00129,India
679715,2023-04-13,1008,Makeup Remover,80,160,80,2,00325,India
679715,2023-04-13,1003,Foundation,300,600,300,2,00325,India
482408,2023-04-13,1001,Lipstick,150,300,150,2,00498,India
216179,2023-04-13,1009,Moisturizer,250,500,250,1,00458,India
216179,2023-04-13,1001,Lipstick,150,300,150,2,00458,India
216179,2023-04-13,1012,Body Lotion,200,400,200,1,00458,India
259903,2023-04-13,1004,Eyeliner,100,200,100,2,00293,India
259903,2023-04-13,1007,Eyeshadow,200,400,200,2,00293,India
259903,2023-04-13,1002,Mascara,200,400,200,2,00293,India
259903,2023-04-13,1003,Foundation,300,600,300,2,00293,India
978946,2023-04-13,1007,Eyeshadow,200,400,200,2,00319,India
171998,2023-04-13,1002,Mascara,200,400,200,2,00312,India
171998,2023-04-13,1009,Moisturizer,250,500,250,1,00312,India
171998,2023-04-13,1006,Blush,150,300,150,2,00312,India
171998,2023-04-13,1004,Eyeliner,100,200,100,2,00312,India
814236,2023-04-13,1001,Lipstick,150,300,150,2,00392,India
814236,2023-04-13,1003,Foundation,300,600,300,2,00392,India
814236,2023-04-13,1006,Blush,150,300,150,2,00392,India
237577,2023-04-13,1007,Eyeshadow,200,400,200,2,00205,India
793367,2023-04-13,1002,Mascara,200,400,200,2,00378,India
793367,2023-04-13,1001,Lipstick,150,300,150,2,00378,India
520992,2023-04-13,1009,Moisturizer,250,500,250,1,00108,India
520992,2023-04-13,1006,Blush,150,300,150,2,00108,India
576184,2023-04-13,1005,Nail Polish,50,100,50,2,00045,India
576184,2023-04-13,1012,Body Lotion,200,400,200,1,00045,India
576184,2023-04-13,1001,Lipstick,150,300,150,2,00045,India
576184,2023-04-13,1009,Moisturizer,250,500,250,1,00045,India
627139,2023-04-13,1008,Makeup Remover,80,160,80,2,00243,India
627139,2023-04-13,1005,Nail Polish,50,100,50,2,00243,India
627139,2023-04-13,1009,Moisturizer,250,500,250,1,00243,India
627139,2023-04-13,1006,Blush,150,300,150,2,00243,India
268894,2023-04-13,1002,Mascara,200,400,200,2,00418,India
268894,2023-04-13,1007,Eyeshadow,200,400,200,2,00418,India
268894,2023-04-13,1012,Body Lotion,200,400,200,1,00418,India
268894,2023-04-13,1003,Foundation,300,600,300,2,00418,India
861508,2023-04-13,1006,Blush,150,300,150,2,00317,India
509444,2023-04-13,1012,Body Lotion,200,400,200,1,00339,India
656961,2023-04-13,1004,Eyeliner,100,200,100,2,00076,India
656961,2023-04-13,1001,Lipstick,150,300,150,2,00076,India
656961,2023-04-13,1006,Blush,150,300,150,2,00076,India
656961,2023-04-13,1012,Body Lotion,200,400,200,1,00076,India
656961,2023-04-13,1002,Mascara,200,400,200,2,00076,India
780109,2023-04-13,1001,Lipstick,150,300,150,2,00433,India
780109,2023-04-13,1012,Body Lotion,200,400,200,1,00433,India
780109,2023-04-13,1005,Nail Polish,50,100,50,2,00433,India
107271,2023-04-13,1002,Mascara,200,400,200,2,00440,India
107271,2023-04-13,1006,Blush,150,300,150,2,00440,India
107271,2023-04-13,1012,Body Lotion,200,400,200,1,00440,India
606032,2023-04-13,1003,Foundation,300,600,300,2,00016,India
606032,2023-04-13,1005,Nail Polish,50,100,50,2,00016,India
594679,2023-04-13,1006,Blush,150,300,150,2,00453,India
594679,2023-04-13,1007,Eyeshadow,200,400,200,2,00453,India
594679,2023-04-13,1012,Body Lotion,200,400,200,1,00453,India
837615,2023-04-13,1002,Mascara,200,400,200,2,00142,India
837615,2023-04-13,1006,Blush,150,300,150,2,00142,India
837615,2023-04-13,1005,Nail Polish,50,100,50,2,00142,India
837615,2023-04-13,1004,Eyeliner,100,200,100,2,00142,India
837615,2023-04-13,1007,Eyeshadow,200,400,200,2,00142,India
834279,2023-04-13,1001,Lipstick,150,300,150,2,00347,India
834279,2023-04-13,1002,Mascara,200,400,200,2,00347,India
857955,2023-04-13,1008,Makeup Remover,80,160,80,2,00260,India
857955,2023-04-13,1005,Nail Polish,50,100,50,2,00260,India
857955,2023-04-13,1007,Eyeshadow,200,400,200,2,00260,India
934081,2023-04-13,1002,Mascara,200,400,200,2,00221,India
934081,2023-04-13,1004,Eyeliner,100,200,100,2,00221,India
934081,2023-04-13,1001,Lipstick,150,300,150,2,00221,India
519061,2023-04-13,1007,Eyeshadow,200,400,200,2,00426,India
519061,2023-04-13,1006,Blush,150,300,150,2,00426,India
519061,2023-04-13,1005,Nail Polish,50,100,50,2,00426,India
512244,2023-04-13,1003,Foundation,300,600,300,2,00264,India
512244,2023-04-13,1004,Eyeliner,100,200,100,2,00264,India
344706,2023-04-13,1002,Mascara,200,400,200,2,00263,India
344706,2023-04-13,1003,Foundation,300,600,300,2,00263,India
344706,2023-04-13,1009,Moisturizer,250,500,250,1,00263,India
344706,2023-04-13,1001,Lipstick,150,300,150,2,00263,India
217402,2023-04-13,1006,Blush,150,300,150,2,00197,India
217402,2023-04-13,1003,Foundation,300,600,300,2,00197,India
217402,2023-04-13,1012,Body Lotion,200,400,200,1,00197,India
106959,2023-04-13,1002,Mascara,200,400,200,2,00094,India
106959,2023-04-13,1007,Eyeshadow,200,400,200,2,00094,India
342967,2023-04-13,1003,Foundation,300,600,300,2,00285,India
342967,2023-04-13,1012,Body Lotion,200,400,200,1,00285,India
805247,2023-04-13,1003,Foundation,300,600,300,2,00456,India
805247,2023-04-13,1009,Moisturizer,250,500,250,1,00456,India
805247,2023-04-13,1001,Lipstick,150,300,150,2,00456,India
805247,2023-04-13,1005,Nail Polish,50,100,50,2,00456,India
505161,2023-04-13,1001,Lipstick,150,300,150,2,00447,India
505161,2023-04-13,1009,Moisturizer,250,500,250,1,00447,India
505161,2023-04-13,1006,Blush,150,300,150,2,00447,India
505161,2023-04-13,1004,Eyeliner,100,200,100,2,00447,India
225774,2023-04-13,1012,Body Lotion,200,400,200,1,00034,India
225774,2023-04-13,1003,Foundation,300,600,300,2,00034,India
502945,2023-04-13,1008,Makeup Remover,80,160,80,2,00330,India
502945,2023-04-13,1004,Eyeliner,100,200,100,2,00330,India
502945,2023-04-13,1007,Eyeshadow,200,400,200,2,00330,India
730243,2023-04-13,1005,Nail Polish,50,100,50,2,00471,India
730243,2023-04-13,1007,Eyeshadow,200,400,200,2,00471,India
730243,2023-04-13,1003,Foundation,300,600,300,2,00471,India
730243,2023-04-13,1012,Body Lotion,200,400,200,1,00471,India
497401,2023-04-13,1006,Blush,150,300,150,2,00250,India
497401,2023-04-13,1007,Eyeshadow,200,400,200,2,00250,India
497401,2023-04-13,1004,Eyeliner,100,200,100,2,00250,India
354488,2023-04-13,1009,Moisturizer,250,500,250,1,00301,India
218525,2023-04-13,1005,Nail Polish,50,100,50,2,00208,India
218525,2023-04-13,1009,Moisturizer,250,500,250,1,00208,India
620462,2023-04-13,1001,Lipstick,150,300,150,2,00333,India
620462,2023-04-13,1008,Makeup Remover,80,160,80,2,00333,India
620462,2023-04-13,1012,Body Lotion,200,400,200,1,00333,India
342766,2023-04-13,1001,Lipstick,150,300,150,2,00365,India
342766,2023-04-13,1006,Blush,150,300,150,2,00365,India
342766,2023-04-13,1008,Makeup Remover,80,160,80,2,00365,India
349797,2023-04-13,1012,Body Lotion,200,400,200,1,00140,India
425002,2023-04-13,1008,Makeup Remover,80,160,80,2,00102,India
425002,2023-04-13,1009,Moisturizer,250,500,250,1,00102,India
425002,2023-04-13,1004,Eyeliner,100,200,100,2,00102,India
658026,2023-04-13,1003,Foundation,300,600,300,2,00480,India
658026,2023-04-13,1002,Mascara,200,400,200,2,00480,India
658026,2023-04-13,1007,Eyeshadow,200,400,200,2,00480,India
658026,2023-04-13,1005,Nail Polish,50,100,50,2,00480,India
658026,2023-04-13,1008,Makeup Remover,80,160,80,2,00480,India
890984,2023-04-13,1006,Blush,150,300,150,2,00380,India
890984,2023-04-13,1001,Lipstick,150,300,150,2,00380,India
890984,2023-04-13,1012,Body Lotion,200,400,200,1,00380,India
890984,2023-04-13,1004,Eyeliner,100,200,100,2,00380,India
593511,2023-04-13,1009,Moisturizer,250,500,250,1,00454,India
137397,2023-04-13,1004,Eyeliner,100,200,100,2,00341,India
137397,2023-04-13,1007,Eyeshadow,200,400,200,2,00341,India
137397,2023-04-13,1003,Foundation,300,600,300,2,00341,India
873668,2023-04-13,1001,Lipstick,150,300,150,2,00257,India
873668,2023-04-13,1002,Mascara,200,400,200,2,00257,India
157859,2023-04-14,1001,Lipstick,150,300,150,2,00166,India
461827,2023-04-14,1006,Blush,150,300,150,2,00003,India
461827,2023-04-14,1012,Body Lotion,200,400,200,1,00003,India
461827,2023-04-14,1004,Eyeliner,100,200,100,2,00003,India
461827,2023-04-14,1009,Moisturizer,250,500,250,1,00003,India
461827,2023-04-14,1007,Eyeshadow,200,400,200,2,00003,India
731637,2023-04-14,1005,Nail Polish,50,100,50,2,00177,India
731637,2023-04-14,1009,Moisturizer,250,500,250,1,00177,India
175737,2023-04-14,1007,Eyeshadow,200,400,200,2,00196,India
175737,2023-04-14,1005,Nail Polish,50,100,50,2,00196,India
809286,2023-04-14,1008,Makeup Remover,80,160,80,2,00262,India
809286,2023-04-14,1007,Eyeshadow,200,400,200,2,00262,India
809286,2023-04-14,1002,Mascara,200,400,200,2,00262,India
809286,2023-04-14,1001,Lipstick,150,300,150,2,00262,India
841250,2023-04-14,1007,Eyeshadow,200,400,200,2,00364,India
841250,2023-04-14,1008,Makeup Remover,80,160,80,2,00364,India
953462,2023-04-14,1004,Eyeliner,100,200,100,2,00345,India
953462,2023-04-14,1012,Body Lotion,200,400,200,1,00345,India
953462,2023-04-14,1008,Makeup Remover,80,160,80,2,00345,India
953462,2023-04-14,1001,Lipstick,150,300,150,2,00345,India
916985,2023-04-14,1008,Makeup Remover,80,160,80,2,00498,India
901720,2023-04-14,1009,Moisturizer,250,500,250,1,00365,India
901720,2023-04-14,1007,Eyeshadow,200,400,200,2,00365,India
901720,2023-04-14,1002,Mascara,200,400,200,2,00365,India
920594,2023-04-14,1006,Blush,150,300,150,2,00478,India
920594,2023-04-14,1001,Lipstick,150,300,150,2,00478,India
920594,2023-04-14,1012,Body Lotion,200,400,200,1,00478,India
920594,2023-04-14,1005,Nail Polish,50,100,50,2,00478,India
483520,2023-04-14,1003,Foundation,300,600,300,2,00190,India
483520,2023-04-14,1012,Body Lotion,200,400,200,1,00190,India
331691,2023-04-14,1005,Nail Polish,50,100,50,2,00287,India
331691,2023-04-14,1006,Blush,150,300,150,2,00287,India
331691,2023-04-14,1001,Lipstick,150,300,150,2,00287,India
331691,2023-04-14,1002,Mascara,200,400,200,2,00287,India
784387,2023-04-14,1004,Eyeliner,100,200,100,2,00179,India
784387,2023-04-14,1009,Moisturizer,250,500,250,1,00179,India
784387,2023-04-14,1008,Makeup Remover,80,160,80,2,00179,India
784387,2023-04-14,1003,Foundation,300,600,300,2,00179,India
479759,2023-04-14,1007,Eyeshadow,200,400,200,2,00149,India
479759,2023-04-14,1003,Foundation,300,600,300,2,00149,India
540101,2023-04-14,1004,Eyeliner,100,200,100,2,00003,India
540101,2023-04-14,1002,Mascara,200,400,200,2,00003,India
540101,2023-04-14,1009,Moisturizer,250,500,250,1,00003,India
469648,2023-04-14,1001,Lipstick,150,300,150,2,00151,India
469648,2023-04-14,1007,Eyeshadow,200,400,200,2,00151,India
469648,2023-04-14,1012,Body Lotion,200,400,200,1,00151,India
469648,2023-04-14,1006,Blush,150,300,150,2,00151,India
469648,2023-04-14,1008,Makeup Remover,80,160,80,2,00151,India
908681,2023-04-14,1004,Eyeliner,100,200,100,2,00022,India
908681,2023-04-14,1012,Body Lotion,200,400,200,1,00022,India
908681,2023-04-14,1002,Mascara,200,400,200,2,00022,India
465714,2023-04-14,1012,Body Lotion,200,400,200,1,00130,India
465714,2023-04-14,1007,Eyeshadow,200,400,200,2,00130,India
465714,2023-04-14,1003,Foundation,300,600,300,2,00130,India
273487,2023-04-14,1001,Lipstick,150,300,150,2,00207,India
273487,2023-04-14,1012,Body Lotion,200,400,200,1,00207,India
335201,2023-04-14,1002,Mascara,200,400,200,2,00055,India
335201,2023-04-14,1012,Body Lotion,200,400,200,1,00055,India
460176,2023-04-14,1001,Lipstick,150,300,150,2,00391,India
175881,2023-04-14,1006,Blush,150,300,150,2,00236,India
175881,2023-04-14,1007,Eyeshadow,200,400,200,2,00236,India
361842,2023-04-14,1012,Body Lotion,200,400,200,1,00118,India
361842,2023-04-14,1006,Blush,150,300,150,2,00118,India
361842,2023-04-14,1003,Foundation,300,600,300,2,00118,India
705219,2023-04-14,1006,Blush,150,300,150,2,00022,India
181494,2023-04-14,1003,Foundation,300,600,300,2,00411,India
181494,2023-04-14,1005,Nail Polish,50,100,50,2,00411,India
181494,2023-04-14,1004,Eyeliner,100,200,100,2,00411,India
324443,2023-04-14,1003,Foundation,300,600,300,2,00441,India
324443,2023-04-14,1012,Body Lotion,200,400,200,1,00441,India
324443,2023-04-14,1002,Mascara,200,400,200,2,00441,India
324443,2023-04-14,1009,Moisturizer,250,500,250,1,00441,India
491100,2023-04-14,1008,Makeup Remover,80,160,80,2,00003,India
673831,2023-04-14,1004,Eyeliner,100,200,100,2,00160,India
500031,2023-04-14,1006,Blush,150,300,150,2,00183,India
500031,2023-04-14,1001,Lipstick,150,300,150,2,00183,India
500031,2023-04-14,1002,Mascara,200,400,200,2,00183,India
500031,2023-04-14,1005,Nail Polish,50,100,50,2,00183,India
551715,2023-04-14,1007,Eyeshadow,200,400,200,2,00300,India
769293,2023-04-14,1004,Eyeliner,100,200,100,2,00464,India
475661,2023-04-15,1012,Body Lotion,200,400,200,1,00395,India
591522,2023-04-15,1001,Lipstick,150,300,150,2,00052,India
591522,2023-04-15,1005,Nail Polish,50,100,50,2,00052,India
591522,2023-04-15,1003,Foundation,300,600,300,2,00052,India
560174,2023-04-15,1005,Nail Polish,50,100,50,2,00176,India
560174,2023-04-15,1002,Mascara,200,400,200,2,00176,India
722785,2023-04-15,1005,Nail Polish,50,100,50,2,00024,India
698583,2023-04-15,1012,Body Lotion,200,400,200,1,00101,India
698583,2023-04-15,1001,Lipstick,150,300,150,2,00101,India
698583,2023-04-15,1002,Mascara,200,400,200,2,00101,India
698583,2023-04-15,1009,Moisturizer,250,500,250,1,00101,India
618100,2023-04-15,1008,Makeup Remover,80,160,80,2,00188,India
618100,2023-04-15,1004,Eyeliner,100,200,100,2,00188,India
932557,2023-04-15,1012,Body Lotion,200,400,200,1,00485,India
932557,2023-04-15,1008,Makeup Remover,80,160,80,2,00485,India
212117,2023-04-15,1005,Nail Polish,50,100,50,2,00004,India
212117,2023-04-15,1006,Blush,150,300,150,2,00004,India
397546,2023-04-15,1004,Eyeliner,100,200,100,2,00068,India
397546,2023-04-15,1005,Nail Polish,50,100,50,2,00068,India
397546,2023-04-15,1003,Foundation,300,600,300,2,00068,India
329147,2023-04-15,1004,Eyeliner,100,200,100,2,00086,India
329147,2023-04-15,1009,Moisturizer,250,500,250,1,00086,India
329147,2023-04-15,1008,Makeup Remover,80,160,80,2,00086,India
943695,2023-04-15,1004,Eyeliner,100,200,100,2,00178,India
394947,2023-04-15,1005,Nail Polish,50,100,50,2,00244,India
394947,2023-04-15,1008,Makeup Remover,80,160,80,2,00244,India
791881,2023-04-15,1002,Mascara,200,400,200,2,00057,India
791881,2023-04-15,1005,Nail Polish,50,100,50,2,00057,India
791881,2023-04-15,1008,Makeup Remover,80,160,80,2,00057,India
791881,2023-04-15,1006,Blush,150,300,150,2,00057,India
816518,2023-04-15,1007,Eyeshadow,200,400,200,2,00212,India
816518,2023-04-15,1009,Moisturizer,250,500,250,1,00212,India
816518,2023-04-15,1012,Body Lotion,200,400,200,1,00212,India
713960,2023-04-15,1005,Nail Polish,50,100,50,2,00220,India
713960,2023-04-15,1006,Blush,150,300,150,2,00220,India
713960,2023-04-15,1007,Eyeshadow,200,400,200,2,00220,India
316885,2023-04-15,1007,Eyeshadow,200,400,200,2,00170,India
316885,2023-04-15,1003,Foundation,300,600,300,2,00170,India
316885,2023-04-15,1008,Makeup Remover,80,160,80,2,00170,India
974742,2023-04-15,1002,Mascara,200,400,200,2,00176,India
974742,2023-04-15,1001,Lipstick,150,300,150,2,00176,India
974742,2023-04-15,1012,Body Lotion,200,400,200,1,00176,India
843314,2023-04-15,1003,Foundation,300,600,300,2,00481,India
843314,2023-04-15,1009,Moisturizer,250,500,250,1,00481,India
843314,2023-04-15,1004,Eyeliner,100,200,100,2,00481,India
517395,2023-04-15,1005,Nail Polish,50,100,50,2,00447,India
517395,2023-04-15,1008,Makeup Remover,80,160,80,2,00447,India
517395,2023-04-15,1002,Mascara,200,400,200,2,00447,India
741565,2023-04-15,1007,Eyeshadow,200,400,200,2,00410,India
741565,2023-04-15,1004,Eyeliner,100,200,100,2,00410,India
741565,2023-04-15,1003,Foundation,300,600,300,2,00410,India
741565,2023-04-15,1002,Mascara,200,400,200,2,00410,India
741565,2023-04-15,1012,Body Lotion,200,400,200,1,00410,India
259742,2023-04-15,1006,Blush,150,300,150,2,00118,India
259742,2023-04-15,1002,Mascara,200,400,200,2,00118,India
259742,2023-04-15,1008,Makeup Remover,80,160,80,2,00118,India
259742,2023-04-15,1012,Body Lotion,200,400,200,1,00118,India
598746,2023-04-15,1001,Lipstick,150,300,150,2,00474,India
598746,2023-04-15,1002,Mascara,200,400,200,2,00474,India
598746,2023-04-15,1004,Eyeliner,100,200,100,2,00474,India
598746,2023-04-15,1008,Makeup Remover,80,160,80,2,00474,India
413927,2023-04-15,1003,Foundation,300,600,300,2,00124,India
670033,2023-04-15,1004,Eyeliner,100,200,100,2,00279,India
670033,2023-04-15,1008,Makeup Remover,80,160,80,2,00279,India
670033,2023-04-15,1003,Foundation,300,600,300,2,00279,India
597765,2023-04-15,1007,Eyeshadow,200,400,200,2,00440,India
939181,2023-04-15,1003,Foundation,300,600,300,2,00382,India
939181,2023-04-15,1007,Eyeshadow,200,400,200,2,00382,India
939181,2023-04-15,1008,Makeup Remover,80,160,80,2,00382,India
939181,2023-04-15,1004,Eyeliner,100,200,100,2,00382,India
449071,2023-04-15,1008,Makeup Remover,80,160,80,2,00153,India
449071,2023-04-15,1012,Body Lotion,200,400,200,1,00153,India
449071,2023-04-15,1001,Lipstick,150,300,150,2,00153,India
695306,2023-04-15,1012,Body Lotion,200,400,200,1,00008,India
980964,2023-04-15,1007,Eyeshadow,200,400,200,2,00157,India
980964,2023-04-15,1008,Makeup Remover,80,160,80,2,00157,India
980964,2023-04-15,1006,Blush,150,300,150,2,00157,India
980964,2023-04-15,1012,Body Lotion,200,400,200,1,00157,India
671785,2023-04-15,1005,Nail Polish,50,100,50,2,00427,India
270542,2023-04-15,1007,Eyeshadow,200,400,200,2,00074,India
270542,2023-04-15,1002,Mascara,200,400,200,2,00074,India
270542,2023-04-15,1009,Moisturizer,250,500,250,1,00074,India
270542,2023-04-15,1004,Eyeliner,100,200,100,2,00074,India
144758,2023-04-15,1008,Makeup Remover,80,160,80,2,00426,India
491550,2023-04-15,1007,Eyeshadow,200,400,200,2,00451,India
491550,2023-04-15,1008,Makeup Remover,80,160,80,2,00451,India
995044,2023-04-15,1002,Mascara,200,400,200,2,00087,India
995044,2023-04-15,1006,Blush,150,300,150,2,00087,India
995044,2023-04-15,1001,Lipstick,150,300,150,2,00087,India
133617,2023-04-15,1008,Makeup Remover,80,160,80,2,00308,India
133617,2023-04-15,1005,Nail Polish,50,100,50,2,00308,India
133617,2023-04-15,1007,Eyeshadow,200,400,200,2,00308,India
268744,2023-04-15,1008,Makeup Remover,80,160,80,2,00144,India
268744,2023-04-15,1001,Lipstick,150,300,150,2,00144,India
504297,2023-04-15,1004,Eyeliner,100,200,100,2,00418,India
504297,2023-04-15,1007,Eyeshadow,200,400,200,2,00418,India
504297,2023-04-15,1001,Lipstick,150,300,150,2,00418,India
504297,2023-04-15,1003,Foundation,300,600,300,2,00418,India
357840,2023-04-15,1003,Foundation,300,600,300,2,00182,India
357840,2023-04-15,1001,Lipstick,150,300,150,2,00182,India
357840,2023-04-15,1012,Body Lotion,200,400,200,1,00182,India
357840,2023-04-15,1006,Blush,150,300,150,2,00182,India
529188,2023-04-15,1005,Nail Polish,50,100,50,2,00014,India
529188,2023-04-15,1008,Makeup Remover,80,160,80,2,00014,India
230226,2023-04-15,1004,Eyeliner,100,200,100,2,00098,India
613808,2023-04-15,1003,Foundation,300,600,300,2,00417,India
126194,2023-04-16,1006,Blush,150,300,150,2,00122,India
126194,2023-04-16,1005,Nail Polish,50,100,50,2,00122,India
126194,2023-04-16,1012,Body Lotion,200,400,200,1,00122,India
346113,2023-04-16,1008,Makeup Remover,80,160,80,2,00327,India
346113,2023-04-16,1009,Moisturizer,250,500,250,1,00327,India
346113,2023-04-16,1005,Nail Polish,50,100,50,2,00327,India
271770,2023-04-16,1005,Nail Polish,50,100,50,2,00017,India
271770,2023-04-16,1006,Blush,150,300,150,2,00017,India
271770,2023-04-16,1009,Moisturizer,250,500,250,1,00017,India
525466,2023-04-16,1012,Body Lotion,200,400,200,1,00361,India
525466,2023-04-16,1009,Moisturizer,250,500,250,1,00361,India
525466,2023-04-16,1008,Makeup Remover,80,160,80,2,00361,India
525466,2023-04-16,1003,Foundation,300,600,300,2,00361,India
787991,2023-04-16,1004,Eyeliner,100,200,100,2,00385,India
787991,2023-04-16,1007,Eyeshadow,200,400,200,2,00385,India
787991,2023-04-16,1006,Blush,150,300,150,2,00385,India
496411,2023-04-16,1006,Blush,150,300,150,2,00043,India
463471,2023-04-16,1003,Foundation,300,600,300,2,00221,India
463471,2023-04-16,1009,Moisturizer,250,500,250,1,00221,India
235639,2023-04-16,1001,Lipstick,150,300,150,2,00017,India
235639,2023-04-16,1012,Body Lotion,200,400,200,1,00017,India
235639,2023-04-16,1008,Makeup Remover,80,160,80,2,00017,India
235639,2023-04-16,1009,Moisturizer,250,500,250,1,00017,India
492117,2023-04-16,1007,Eyeshadow,200,400,200,2,00273,India
492117,2023-04-16,1005,Nail Polish,50,100,50,2,00273,India
114283,2023-04-16,1003,Foundation,300,600,300,2,00231,India
114283,2023-04-16,1005,Nail Polish,50,100,50,2,00231,India
454219,2023-04-16,1008,Makeup Remover,80,160,80,2,00103,India
454219,2023-04-16,1012,Body Lotion,200,400,200,1,00103,India
454219,2023-04-16,1007,Eyeshadow,200,400,200,2,00103,India
749974,2023-04-16,1009,Moisturizer,250,500,250,1,00425,India
350978,2023-04-16,1008,Makeup Remover,80,160,80,2,00453,India
350978,2023-04-16,1007,Eyeshadow,200,400,200,2,00453,India
885944,2023-04-16,1007,Eyeshadow,200,400,200,2,00036,India
885944,2023-04-16,1004,Eyeliner,100,200,100,2,00036,India
749251,2023-04-16,1002,Mascara,200,400,200,2,00017,India
749251,2023-04-16,1008,Makeup Remover,80,160,80,2,00017,India
749251,2023-04-16,1004,Eyeliner,100,200,100,2,00017,India
749251,2023-04-16,1009,Moisturizer,250,500,250,1,00017,India
210678,2023-04-16,1008,Makeup Remover,80,160,80,2,00117,India
210678,2023-04-16,1002,Mascara,200,400,200,2,00117,India
273091,2023-04-16,1009,Moisturizer,250,500,250,1,00153,India
273091,2023-04-16,1008,Makeup Remover,80,160,80,2,00153,India
612291,2023-04-16,1006,Blush,150,300,150,2,00093,India
612291,2023-04-16,1004,Eyeliner,100,200,100,2,00093,India
101282,2023-04-16,1007,Eyeshadow,200,400,200,2,00260,India
101282,2023-04-16,1002,Mascara,200,400,200,2,00260,India
101282,2023-04-16,1005,Nail Polish,50,100,50,2,00260,India
172701,2023-04-16,1006,Blush,150,300,150,2,00378,India
172701,2023-04-16,1002,Mascara,200,400,200,2,00378,India
172701,2023-04-16,1012,Body Lotion,200,400,200,1,00378,India
172701,2023-04-16,1005,Nail Polish,50,100,50,2,00378,India
102493,2023-04-16,1007,Eyeshadow,200,400,200,2,00228,India
405747,2023-04-16,1012,Body Lotion,200,400,200,1,00057,India
405747,2023-04-16,1007,Eyeshadow,200,400,200,2,00057,India
930602,2023-04-16,1001,Lipstick,150,300,150,2,00399,India
930602,2023-04-16,1003,Foundation,300,600,300,2,00399,India
930602,2023-04-16,1004,Eyeliner,100,200,100,2,00399,India
625054,2023-04-16,1002,Mascara,200,400,200,2,00279,India
625054,2023-04-16,1012,Body Lotion,200,400,200,1,00279,India
625054,2023-04-16,1007,Eyeshadow,200,400,200,2,00279,India
625054,2023-04-16,1001,Lipstick,150,300,150,2,00279,India
538716,2023-04-16,1004,Eyeliner,100,200,100,2,00394,India
574512,2023-04-16,1003,Foundation,300,600,300,2,00281,India
574512,2023-04-16,1007,Eyeshadow,200,400,200,2,00281,India
574512,2023-04-16,1008,Makeup Remover,80,160,80,2,00281,India
858823,2023-04-16,1007,Eyeshadow,200,400,200,2,00448,India
858823,2023-04-16,1008,Makeup Remover,80,160,80,2,00448,India
858823,2023-04-16,1004,Eyeliner,100,200,100,2,00448,India
858823,2023-04-16,1001,Lipstick,150,300,150,2,00448,India
858823,2023-04-16,1005,Nail Polish,50,100,50,2,00448,India
436635,2023-04-16,1005,Nail Polish,50,100,50,2,00250,India
436635,2023-04-16,1003,Foundation,300,600,300,2,00250,India
436635,2023-04-16,1008,Makeup Remover,80,160,80,2,00250,India
751818,2023-04-16,1012,Body Lotion,200,400,200,1,00345,India
751818,2023-04-16,1004,Eyeliner,100,200,100,2,00345,India
751818,2023-04-16,1002,Mascara,200,400,200,2,00345,India
605275,2023-04-16,1002,Mascara,200,400,200,2,00305,India
605275,2023-04-16,1012,Body Lotion,200,400,200,1,00305,India
247710,2023-04-16,1006,Blush,150,300,150,2,00214,India
247710,2023-04-16,1001,Lipstick,150,300,150,2,00214,India
247710,2023-04-16,1012,Body Lotion,200,400,200,1,00214,India
381977,2023-04-16,1009,Moisturizer,250,500,250,1,00346,India
381977,2023-04-16,1002,Mascara,200,400,200,2,00346,India
813839,2023-04-16,1009,Moisturizer,250,500,250,1,00394,India
268655,2023-04-16,1005,Nail Polish,50,100,50,2,00231,India
268655,2023-04-16,1001,Lipstick,150,300,150,2,00231,India
268655,2023-04-16,1012,Body Lotion,200,400,200,1,00231,India
268655,2023-04-16,1007,Eyeshadow,200,400,200,2,00231,India
905303,2023-04-17,1008,Makeup Remover,80,160,80,2,00350,India
976610,2023-04-17,1003,Foundation,300,600,300,2,00325,India
976610,2023-04-17,1001,Lipstick,150,300,150,2,00325,India
941492,2023-04-17,1005,Nail Polish,50,100,50,2,00252,India
941492,2023-04-17,1004,Eyeliner,100,200,100,2,00252,India
941492,2023-04-17,1006,Blush,150,300,150,2,00252,India
821053,2023-04-17,1006,Blush,150,300,150,2,00013,India
657589,2023-04-17,1002,Mascara,200,400,200,2,00059,India
136545,2023-04-17,1005,Nail Polish,50,100,50,2,00445,India
136545,2023-04-17,1012,Body Lotion,200,400,200,1,00445,India
136545,2023-04-17,1008,Makeup Remover,80,160,80,2,00445,India
136545,2023-04-17,1003,Foundation,300,600,300,2,00445,India
903459,2023-04-17,1004,Eyeliner,100,200,100,2,00099,India
903459,2023-04-17,1012,Body Lotion,200,400,200,1,00099,India
903459,2023-04-17,1007,Eyeshadow,200,400,200,2,00099,India
639001,2023-04-17,1003,Foundation,300,600,300,2,00497,India
639001,2023-04-17,1009,Moisturizer,250,500,250,1,00497,India
639001,2023-04-17,1001,Lipstick,150,300,150,2,00497,India
416040,2023-04-17,1012,Body Lotion,200,400,200,1,00359,India
416040,2023-04-17,1006,Blush,150,300,150,2,00359,India
416040,2023-04-17,1004,Eyeliner,100,200,100,2,00359,India
416040,2023-04-17,1003,Foundation,300,600,300,2,00359,India
753574,2023-04-17,1001,Lipstick,150,300,150,2,00153,India
788874,2023-04-17,1005,Nail Polish,50,100,50,2,00002,India
779410,2023-04-17,1009,Moisturizer,250,500,250,1,00252,India
214041,2023-04-17,1009,Moisturizer,250,500,250,1,00375,India
356707,2023-04-17,1012,Body Lotion,200,400,200,1,00316,India
356707,2023-04-17,1001,Lipstick,150,300,150,2,00316,India
526775,2023-04-17,1009,Moisturizer,250,500,250,1,00500,India
241015,2023-04-17,1005,Nail Polish,50,100,50,2,00057,India
241015,2023-04-17,1003,Foundation,300,600,300,2,00057,India
550591,2023-04-17,1009,Moisturizer,250,500,250,1,00017,India
550591,2023-04-17,1004,Eyeliner,100,200,100,2,00017,India
550591,2023-04-17,1006,Blush,150,300,150,2,00017,India
754422,2023-04-17,1005,Nail Polish,50,100,50,2,00311,India
383289,2023-04-17,1009,Moisturizer,250,500,250,1,00309,India
313033,2023-04-17,1012,Body Lotion,200,400,200,1,00343,India
313033,2023-04-17,1006,Blush,150,300,150,2,00343,India
313033,2023-04-17,1003,Foundation,300,600,300,2,00343,India
313033,2023-04-17,1007,Eyeshadow,200,400,200,2,00343,India
391727,2023-04-17,1004,Eyeliner,100,200,100,2,00263,India
391727,2023-04-17,1009,Moisturizer,250,500,250,1,00263,India
534323,2023-04-17,1009,Moisturizer,250,500,250,1,00027,India
534323,2023-04-17,1005,Nail Polish,50,100,50,2,00027,India
534323,2023-04-17,1001,Lipstick,150,300,150,2,00027,India
534323,2023-04-17,1006,Blush,150,300,150,2,00027,India
907026,2023-04-17,1001,Lipstick,150,300,150,2,00044,India
907026,2023-04-17,1002,Mascara,200,400,200,2,00044,India
907026,2023-04-17,1012,Body Lotion,200,400,200,1,00044,India
382879,2023-04-17,1005,Nail Polish,50,100,50,2,00098,India
382879,2023-04-17,1006,Blush,150,300,150,2,00098,India
382879,2023-04-17,1004,Eyeliner,100,200,100,2,00098,India
309901,2023-04-17,1009,Moisturizer,250,500,250,1,00136,India
309901,2023-04-17,1004,Eyeliner,100,200,100,2,00136,India
836889,2023-04-17,1004,Eyeliner,100,200,100,2,00045,India
836889,2023-04-17,1005,Nail Polish,50,100,50,2,00045,India
836889,2023-04-17,1008,Makeup Remover,80,160,80,2,00045,India
148520,2023-04-17,1004,Eyeliner,100,200,100,2,00153,India
148520,2023-04-17,1009,Moisturizer,250,500,250,1,00153,India
148520,2023-04-17,1001,Lipstick,150,300,150,2,00153,India
148520,2023-04-17,1007,Eyeshadow,200,400,200,2,00153,India
840513,2023-04-17,1002,Mascara,200,400,200,2,00300,India
840513,2023-04-17,1006,Blush,150,300,150,2,00300,India
691364,2023-04-17,1004,Eyeliner,100,200,100,2,00079,India
691364,2023-04-17,1006,Blush,150,300,150,2,00079,India
691364,2023-04-17,1005,Nail Polish,50,100,50,2,00079,India
440083,2023-04-17,1004,Eyeliner,100,200,100,2,00454,India
440083,2023-04-17,1012,Body Lotion,200,400,200,1,00454,India
440083,2023-04-17,1003,Foundation,300,600,300,2,00454,India
440083,2023-04-17,1005,Nail Polish,50,100,50,2,00454,India
185122,2023-04-17,1002,Mascara,200,400,200,2,00229,India
185122,2023-04-17,1003,Foundation,300,600,300,2,00229,India
185122,2023-04-17,1006,Blush,150,300,150,2,00229,India
247782,2023-04-17,1007,Eyeshadow,200,400,200,2,00472,India
247782,2023-04-17,1001,Lipstick,150,300,150,2,00472,India
247782,2023-04-17,1006,Blush,150,300,150,2,00472,India
247782,2023-04-17,1005,Nail Polish,50,100,50,2,00472,India
247782,2023-04-17,1008,Makeup Remover,80,160,80,2,00472,India
694898,2023-04-17,1009,Moisturizer,250,500,250,1,00275,India
694898,2023-04-17,1006,Blush,150,300,150,2,00275,India
694898,2023-04-17,1004,Eyeliner,100,200,100,2,00275,India
694898,2023-04-17,1008,Makeup Remover,80,160,80,2,00275,India
694898,2023-04-17,1005,Nail Polish,50,100,50,2,00275,India
448144,2023-04-17,1012,Body Lotion,200,400,200,1,00161,India
448144,2023-04-17,1009,Moisturizer,250,500,250,1,00161,India
773154,2023-04-17,1008,Makeup Remover,80,160,80,2,00104,India
796695,2023-04-17,1001,Lipstick,150,300,150,2,00249,India
796695,2023-04-17,1003,Foundation,300,600,300,2,00249,India
803598,2023-04-17,1002,Mascara,200,400,200,2,00171,India
803598,2023-04-17,1001,Lipstick,150,300,150,2,00171,India
803598,2023-04-17,1008,Makeup Remover,80,160,80,2,00171,India
749095,2023-04-17,1009,Moisturizer,250,500,250,1,00366,India
749095,2023-04-17,1001,Lipstick,150,300,150,2,00366,India
749095,2023-04-17,1003,Foundation,300,600,300,2,00366,India
567852,2023-04-17,1001,Lipstick,150,300,150,2,00104,India
567852,2023-04-17,1009,Moisturizer,250,500,250,1,00104,India
471929,2023-04-17,1002,Mascara,200,400,200,2,00459,India
471929,2023-04-17,1004,Eyeliner,100,200,100,2,00459,India
848864,2023-04-17,1001,Lipstick,150,300,150,2,00233,India
848864,2023-04-17,1004,Eyeliner,100,200,100,2,00233,India
151664,2023-04-17,1009,Moisturizer,250,500,250,1,00258,India
151664,2023-04-17,1003,Foundation,300,600,300,2,00258,India
814040,2023-04-17,1007,Eyeshadow,200,400,200,2,00155,India
814040,2023-04-17,1003,Foundation,300,600,300,2,00155,India
814040,2023-04-17,1006,Blush,150,300,150,2,00155,India
814040,2023-04-17,1012,Body Lotion,200,400,200,1,00155,India
923150,2023-04-17,1002,Mascara,200,400,200,2,00255,India
213053,2023-04-17,1007,Eyeshadow,200,400,200,2,00307,India
213053,2023-04-17,1005,Nail Polish,50,100,50,2,00307,India
404518,2023-04-17,1001,Lipstick,150,300,150,2,00409,India
404518,2023-04-17,1004,Eyeliner,100,200,100,2,00409,India
404518,2023-04-17,1009,Moisturizer,250,500,250,1,00409,India
491650,2023-04-18,1005,Nail Polish,50,100,50,2,00264,India
491650,2023-04-18,1009,Moisturizer,250,500,250,1,00264,India
491650,2023-04-18,1007,Eyeshadow,200,400,200,2,00264,India
491650,2023-04-18,1001,Lipstick,150,300,150,2,00264,India
263298,2023-04-18,1007,Eyeshadow,200,400,200,2,00123,India
263298,2023-04-18,1001,Lipstick,150,300,150,2,00123,India
263298,2023-04-18,1006,Blush,150,300,150,2,00123,India
263298,2023-04-18,1009,Moisturizer,250,500,250,1,00123,India
972157,2023-04-18,1002,Mascara,200,400,200,2,00307,India
972157,2023-04-18,1005,Nail Polish,50,100,50,2,00307,India
914692,2023-04-18,1004,Eyeliner,100,200,100,2,00233,India
914692,2023-04-18,1009,Moisturizer,250,500,250,1,00233,India
914692,2023-04-18,1008,Makeup Remover,80,160,80,2,00233,India
145572,2023-04-18,1012,Body Lotion,200,400,200,1,00248,India
145572,2023-04-18,1006,Blush,150,300,150,2,00248,India
368422,2023-04-18,1002,Mascara,200,400,200,2,00246,India
368422,2023-04-18,1009,Moisturizer,250,500,250,1,00246,India
368422,2023-04-18,1006,Blush,150,300,150,2,00246,India
368422,2023-04-18,1004,Eyeliner,100,200,100,2,00246,India
393276,2023-04-18,1008,Makeup Remover,80,160,80,2,00194,India
393276,2023-04-18,1002,Mascara,200,400,200,2,00194,India
487636,2023-04-18,1003,Foundation,300,600,300,2,00247,India
487636,2023-04-18,1006,Blush,150,300,150,2,00247,India
487636,2023-04-18,1001,Lipstick,150,300,150,2,00247,India
194866,2023-04-18,1005,Nail Polish,50,100,50,2,00451,India
194866,2023-04-18,1003,Foundation,300,600,300,2,00451,India
194866,2023-04-18,1001,Lipstick,150,300,150,2,00451,India
929264,2023-04-18,1001,Lipstick,150,300,150,2,00275,India
929264,2023-04-18,1007,Eyeshadow,200,400,200,2,00275,India
929264,2023-04-18,1008,Makeup Remover,80,160,80,2,00275,India
929264,2023-04-18,1009,Moisturizer,250,500,250,1,00275,India
929264,2023-04-18,1002,Mascara,200,400,200,2,00275,India
137964,2023-04-18,1009,Moisturizer,250,500,250,1,00304,India
137964,2023-04-18,1007,Eyeshadow,200,400,200,2,00304,India
500050,2023-04-18,1004,Eyeliner,100,200,100,2,00080,India
500050,2023-04-18,1005,Nail Polish,50,100,50,2,00080,India
500050,2023-04-18,1003,Foundation,300,600,300,2,00080,India
731713,2023-04-18,1005,Nail Polish,50,100,50,2,00378,India
731713,2023-04-18,1004,Eyeliner,100,200,100,2,00378,India
311914,2023-04-18,1003,Foundation,300,600,300,2,00352,India
334530,2023-04-18,1004,Eyeliner,100,200,100,2,00112,India
334530,2023-04-18,1001,Lipstick,150,300,150,2,00112,India
145260,2023-04-18,1008,Makeup Remover,80,160,80,2,00083,India
145260,2023-04-18,1003,Foundation,300,600,300,2,00083,India
405904,2023-04-18,1002,Mascara,200,400,200,2,00389,India
405904,2023-04-18,1012,Body Lotion,200,400,200,1,00389,India
405904,2023-04-18,1006,Blush,150,300,150,2,00389,India
605592,2023-04-18,1007,Eyeshadow,200,400,200,2,00278,India
605592,2023-04-18,1009,Moisturizer,250,500,250,1,00278,India
605592,2023-04-18,1008,Makeup Remover,80,160,80,2,00278,India
605592,2023-04-18,1001,Lipstick,150,300,150,2,00278,India
851638,2023-04-18,1004,Eyeliner,100,200,100,2,00454,India
851638,2023-04-18,1007,Eyeshadow,200,400,200,2,00454,India
288250,2023-04-18,1005,Nail Polish,50,100,50,2,00445,India
288250,2023-04-18,1001,Lipstick,150,300,150,2,00445,India
288250,2023-04-18,1009,Moisturizer,250,500,250,1,00445,India
127943,2023-04-18,1012,Body Lotion,200,400,200,1,00265,India
127943,2023-04-18,1001,Lipstick,150,300,150,2,00265,India
127943,2023-04-18,1008,Makeup Remover,80,160,80,2,00265,India
127943,2023-04-18,1004,Eyeliner,100,200,100,2,00265,India
919950,2023-04-18,1003,Foundation,300,600,300,2,00002,India
919950,2023-04-18,1004,Eyeliner,100,200,100,2,00002,India
978559,2023-04-18,1004,Eyeliner,100,200,100,2,00239,India
978559,2023-04-18,1005,Nail Polish,50,100,50,2,00239,India
602272,2023-04-18,1012,Body Lotion,200,400,200,1,00224,India
602272,2023-04-18,1004,Eyeliner,100,200,100,2,00224,India
156797,2023-04-18,1003,Foundation,300,600,300,2,00038,India
156797,2023-04-18,1008,Makeup Remover,80,160,80,2,00038,India
156797,2023-04-18,1006,Blush,150,300,150,2,00038,India
156797,2023-04-18,1012,Body Lotion,200,400,200,1,00038,India
156797,2023-04-18,1002,Mascara,200,400,200,2,00038,India
290892,2023-04-18,1012,Body Lotion,200,400,200,1,00369,India
610714,2023-04-18,1001,Lipstick,150,300,150,2,00222,India
610714,2023-04-18,1004,Eyeliner,100,200,100,2,00222,India
610714,2023-04-18,1006,Blush,150,300,150,2,00222,India
998170,2023-04-18,1002,Mascara,200,400,200,2,00074,India
998170,2023-04-18,1007,Eyeshadow,200,400,200,2,00074,India
410136,2023-04-18,1001,Lipstick,150,300,150,2,00307,India
410136,2023-04-18,1005,Nail Polish,50,100,50,2,00307,India
785197,2023-04-18,1002,Mascara,200,400,200,2,00479,India
785197,2023-04-18,1001,Lipstick,150,300,150,2,00479,India
785197,2023-04-18,1004,Eyeliner,100,200,100,2,00479,India
764407,2023-04-18,1003,Foundation,300,600,300,2,00319,India
128598,2023-04-18,1002,Mascara,200,400,200,2,00020,India
128598,2023-04-18,1005,Nail Polish,50,100,50,2,00020,India
128598,2023-04-18,1003,Foundation,300,600,300,2,00020,India
483035,2023-04-18,1008,Makeup Remover,80,160,80,2,00114,India
483035,2023-04-18,1004,Eyeliner,100,200,100,2,00114,India
963808,2023-04-19,1004,Eyeliner,100,200,100,2,00385,India
963808,2023-04-19,1008,Makeup Remover,80,160,80,2,00385,India
963808,2023-04-19,1003,Foundation,300,600,300,2,00385,India
512652,2023-04-19,1004,Eyeliner,100,200,100,2,00081,India
512652,2023-04-19,1012,Body Lotion,200,400,200,1,00081,India
512652,2023-04-19,1008,Makeup Remover,80,160,80,2,00081,India
512652,2023-04-19,1009,Moisturizer,250,500,250,1,00081,India
512652,2023-04-19,1005,Nail Polish,50,100,50,2,00081,India
158099,2023-04-19,1006,Blush,150,300,150,2,00381,India
158099,2023-04-19,1012,Body Lotion,200,400,200,1,00381,India
158099,2023-04-19,1008,Makeup Remover,80,160,80,2,00381,India
158099,2023-04-19,1009,Moisturizer,250,500,250,1,00381,India
253581,2023-04-19,1003,Foundation,300,600,300,2,00230,India
253581,2023-04-19,1001,Lipstick,150,300,150,2,00230,India
698819,2023-04-19,1012,Body Lotion,200,400,200,1,00011,India
698819,2023-04-19,1009,Moisturizer,250,500,250,1,00011,India
245686,2023-04-19,1001,Lipstick,150,300,150,2,00208,India
245686,2023-04-19,1006,Blush,150,300,150,2,00208,India
245686,2023-04-19,1004,Eyeliner,100,200,100,2,00208,India
238752,2023-04-19,1001,Lipstick,150,300,150,2,00433,India
238752,2023-04-19,1012,Body Lotion,200,400,200,1,00433,India
238752,2023-04-19,1007,Eyeshadow,200,400,200,2,00433,India
427482,2023-04-19,1001,Lipstick,150,300,150,2,00461,India
633918,2023-04-19,1007,Eyeshadow,200,400,200,2,00302,India
249722,2023-04-19,1009,Moisturizer,250,500,250,1,00127,India
249722,2023-04-19,1005,Nail Polish,50,100,50,2,00127,India
249722,2023-04-19,1012,Body Lotion,200,400,200,1,00127,India
249722,2023-04-19,1006,Blush,150,300,150,2,00127,India
304348,2023-04-19,1004,Eyeliner,100,200,100,2,00344,India
404524,2023-04-19,1005,Nail Polish,50,100,50,2,00466,India
825531,2023-04-19,1001,Lipstick,150,300,150,2,00451,India
825531,2023-04-19,1002,Mascara,200,400,200,2,00451,India
825531,2023-04-19,1005,Nail Polish,50,100,50,2,00451,India
825531,2023-04-19,1006,Blush,150,300,150,2,00451,India
627687,2023-04-19,1004,Eyeliner,100,200,100,2,00323,India
627687,2023-04-19,1012,Body Lotion,200,400,200,1,00323,India
627687,2023-04-19,1008,Makeup Remover,80,160,80,2,00323,India
982298,2023-04-19,1006,Blush,150,300,150,2,00481,India
982298,2023-04-19,1003,Foundation,300,600,300,2,00481,India
982298,2023-04-19,1008,Makeup Remover,80,160,80,2,00481,India
982298,2023-04-19,1004,Eyeliner,100,200,100,2,00481,India
770832,2023-04-19,1006,Blush,150,300,150,2,00117,India
770832,2023-04-19,1005,Nail Polish,50,100,50,2,00117,India
770832,2023-04-19,1004,Eyeliner,100,200,100,2,00117,India
300854,2023-04-19,1006,Blush,150,300,150,2,00284,India
297811,2023-04-19,1009,Moisturizer,250,500,250,1,00113,India
297811,2023-04-19,1005,Nail Polish,50,100,50,2,00113,India
297811,2023-04-19,1008,Makeup Remover,80,160,80,2,00113,India
236169,2023-04-19,1008,Makeup Remover,80,160,80,2,00392,India
236169,2023-04-19,1006,Blush,150,300,150,2,00392,India
236169,2023-04-19,1002,Mascara,200,400,200,2,00392,India
236169,2023-04-19,1003,Foundation,300,600,300,2,00392,India
236169,2023-04-19,1009,Moisturizer,250,500,250,1,00392,India
262976,2023-04-19,1007,Eyeshadow,200,400,200,2,00217,India
296271,2023-04-19,1009,Moisturizer,250,500,250,1,00349,India
296271,2023-04-19,1003,Foundation,300,600,300,2,00349,India
133464,2023-04-19,1005,Nail Polish,50,100,50,2,00131,India
133464,2023-04-19,1012,Body Lotion,200,400,200,1,00131,India
133464,2023-04-19,1001,Lipstick,150,300,150,2,00131,India
989336,2023-04-19,1009,Moisturizer,250,500,250,1,00300,India
989336,2023-04-19,1002,Mascara,200,400,200,2,00300,India
989336,2023-04-19,1001,Lipstick,150,300,150,2,00300,India
989336,2023-04-19,1007,Eyeshadow,200,400,200,2,00300,India
607699,2023-04-19,1008,Makeup Remover,80,160,80,2,00049,India
607699,2023-04-19,1004,Eyeliner,100,200,100,2,00049,India
607699,2023-04-19,1009,Moisturizer,250,500,250,1,00049,India
607699,2023-04-19,1006,Blush,150,300,150,2,00049,India
742962,2023-04-19,1005,Nail Polish,50,100,50,2,00120,India
742962,2023-04-19,1006,Blush,150,300,150,2,00120,India
742962,2023-04-19,1007,Eyeshadow,200,400,200,2,00120,India
742962,2023-04-19,1001,Lipstick,150,300,150,2,00120,India
606944,2023-04-19,1007,Eyeshadow,200,400,200,2,00464,India
621464,2023-04-19,1007,Eyeshadow,200,400,200,2,00198,India
621464,2023-04-19,1003,Foundation,300,600,300,2,00198,India
621464,2023-04-19,1012,Body Lotion,200,400,200,1,00198,India
458704,2023-04-19,1003,Foundation,300,600,300,2,00333,India
545203,2023-04-19,1005,Nail Polish,50,100,50,2,00082,India
545203,2023-04-19,1002,Mascara,200,400,200,2,00082,India
545203,2023-04-19,1012,Body Lotion,200,400,200,1,00082,India
723028,2023-04-19,1001,Lipstick,150,300,150,2,00399,India
723028,2023-04-19,1004,Eyeliner,100,200,100,2,00399,India
601575,2023-04-19,1005,Nail Polish,50,100,50,2,00056,India
601575,2023-04-19,1003,Foundation,300,600,300,2,00056,India
601575,2023-04-19,1004,Eyeliner,100,200,100,2,00056,India
601575,2023-04-19,1007,Eyeshadow,200,400,200,2,00056,India
911562,2023-04-19,1008,Makeup Remover,80,160,80,2,00324,India
911562,2023-04-19,1006,Blush,150,300,150,2,00324,India
911562,2023-04-19,1002,Mascara,200,400,200,2,00324,India
911562,2023-04-19,1012,Body Lotion,200,400,200,1,00324,India
911562,2023-04-19,1009,Moisturizer,250,500,250,1,00324,India
622500,2023-04-19,1007,Eyeshadow,200,400,200,2,00377,India
622500,2023-04-19,1008,Makeup Remover,80,160,80,2,00377,India
750944,2023-04-19,1003,Foundation,300,600,300,2,00038,India
750944,2023-04-19,1001,Lipstick,150,300,150,2,00038,India
750944,2023-04-19,1009,Moisturizer,250,500,250,1,00038,India
635756,2023-04-19,1004,Eyeliner,100,200,100,2,00360,India
635756,2023-04-19,1002,Mascara,200,400,200,2,00360,India
437412,2023-04-19,1009,Moisturizer,250,500,250,1,00174,India
437412,2023-04-19,1001,Lipstick,150,300,150,2,00174,India
288413,2023-04-19,1007,Eyeshadow,200,400,200,2,00072,India
288413,2023-04-19,1012,Body Lotion,200,400,200,1,00072,India
288413,2023-04-19,1008,Makeup Remover,80,160,80,2,00072,India
998680,2023-04-20,1009,Moisturizer,250,500,250,1,00121,India
998680,2023-04-20,1001,Lipstick,150,300,150,2,00121,India
998680,2023-04-20,1006,Blush,150,300,150,2,00121,India
998680,2023-04-20,1003,Foundation,300,600,300,2,00121,India
458614,2023-04-20,1006,Blush,150,300,150,2,00163,India
467510,2023-04-20,1009,Moisturizer,250,500,250,1,00064,India
467510,2023-04-20,1008,Makeup Remover,80,160,80,2,00064,India
467510,2023-04-20,1003,Foundation,300,600,300,2,00064,India
467510,2023-04-20,1006,Blush,150,300,150,2,00064,India
548405,2023-04-20,1006,Blush,150,300,150,2,00076,India
548405,2023-04-20,1003,Foundation,300,600,300,2,00076,India
548405,2023-04-20,1001,Lipstick,150,300,150,2,00076,India
594445,2023-04-20,1002,Mascara,200,400,200,2,00049,India
854596,2023-04-20,1006,Blush,150,300,150,2,00237,India
854596,2023-04-20,1003,Foundation,300,600,300,2,00237,India
710745,2023-04-20,1004,Eyeliner,100,200,100,2,00140,India
710745,2023-04-20,1009,Moisturizer,250,500,250,1,00140,India
710745,2023-04-20,1001,Lipstick,150,300,150,2,00140,India
417246,2023-04-20,1012,Body Lotion,200,400,200,1,00261,India
417246,2023-04-20,1009,Moisturizer,250,500,250,1,00261,India
417246,2023-04-20,1008,Makeup Remover,80,160,80,2,00261,India
417246,2023-04-20,1004,Eyeliner,100,200,100,2,00261,India
773865,2023-04-20,1009,Moisturizer,250,500,250,1,00022,India
303078,2023-04-20,1007,Eyeshadow,200,400,200,2,00205,India
530521,2023-04-20,1009,Moisturizer,250,500,250,1,00447,India
879368,2023-04-20,1004,Eyeliner,100,200,100,2,00192,India
879368,2023-04-20,1012,Body Lotion,200,400,200,1,00192,India
879368,2023-04-20,1006,Blush,150,300,150,2,00192,India
576706,2023-04-20,1012,Body Lotion,200,400,200,1,00097,India
576706,2023-04-20,1005,Nail Polish,50,100,50,2,00097,India
576706,2023-04-20,1002,Mascara,200,400,200,2,00097,India
576706,2023-04-20,1007,Eyeshadow,200,400,200,2,00097,India
980942,2023-04-20,1004,Eyeliner,100,200,100,2,00116,India
980942,2023-04-20,1008,Makeup Remover,80,160,80,2,00116,India
980942,2023-04-20,1002,Mascara,200,400,200,2,00116,India
674119,2023-04-20,1003,Foundation,300,600,300,2,00264,India
885879,2023-04-20,1004,Eyeliner,100,200,100,2,00304,India
885879,2023-04-20,1002,Mascara,200,400,200,2,00304,India
885879,2023-04-20,1007,Eyeshadow,200,400,200,2,00304,India
116265,2023-04-20,1005,Nail Polish,50,100,50,2,00049,India
166589,2023-04-20,1007,Eyeshadow,200,400,200,2,00044,India
166589,2023-04-20,1006,Blush,150,300,150,2,00044,India
170728,2023-04-20,1004,Eyeliner,100,200,100,2,00315,India
170728,2023-04-20,1008,Makeup Remover,80,160,80,2,00315,India
170728,2023-04-20,1003,Foundation,300,600,300,2,00315,India
644732,2023-04-20,1003,Foundation,300,600,300,2,00108,India
601049,2023-04-20,1006,Blush,150,300,150,2,00005,India
601049,2023-04-20,1012,Body Lotion,200,400,200,1,00005,India
601049,2023-04-20,1003,Foundation,300,600,300,2,00005,India
448326,2023-04-20,1002,Mascara,200,400,200,2,00459,India
448326,2023-04-20,1001,Lipstick,150,300,150,2,00459,India
448326,2023-04-20,1009,Moisturizer,250,500,250,1,00459,India
448326,2023-04-20,1012,Body Lotion,200,400,200,1,00459,India
946226,2023-04-20,1003,Foundation,300,600,300,2,00130,India
946226,2023-04-20,1012,Body Lotion,200,400,200,1,00130,India
463759,2023-04-20,1003,Foundation,300,600,300,2,00004,India
463759,2023-04-20,1004,Eyeliner,100,200,100,2,00004,India
463759,2023-04-20,1001,Lipstick,150,300,150,2,00004,India
463759,2023-04-20,1007,Eyeshadow,200,400,200,2,00004,India
463759,2023-04-20,1009,Moisturizer,250,500,250,1,00004,India
839302,2023-04-20,1003,Foundation,300,600,300,2,00107,India
839302,2023-04-20,1006,Blush,150,300,150,2,00107,India
839302,2023-04-20,1007,Eyeshadow,200,400,200,2,00107,India
839302,2023-04-20,1005,Nail Polish,50,100,50,2,00107,India
145632,2023-04-20,1001,Lipstick,150,300,150,2,00170,India
145632,2023-04-20,1006,Blush,150,300,150,2,00170,India
145632,2023-04-20,1007,Eyeshadow,200,400,200,2,00170,India
131623,2023-04-20,1005,Nail Polish,50,100,50,2,00347,India
131623,2023-04-20,1007,Eyeshadow,200,400,200,2,00347,India
131623,2023-04-20,1012,Body Lotion,200,400,200,1,00347,India
449665,2023-04-20,1005,Nail Polish,50,100,50,2,00476,India
449665,2023-04-20,1007,Eyeshadow,200,400,200,2,00476,India
449665,2023-04-20,1009,Moisturizer,250,500,250,1,00476,India
449665,2023-04-20,1012,Body Lotion,200,400,200,1,00476,India
745273,2023-04-20,1005,Nail Polish,50,100,50,2,00333,India
745273,2023-04-20,1009,Moisturizer,250,500,250,1,00333,India
745273,2023-04-20,1004,Eyeliner,100,200,100,2,00333,India
745273,2023-04-20,1012,Body Lotion,200,400,200,1,00333,India
817563,2023-04-20,1001,Lipstick,150,300,150,2,00102,India
817563,2023-04-20,1007,Eyeshadow,200,400,200,2,00102,India
817563,2023-04-20,1006,Blush,150,300,150,2,00102,India
817563,2023-04-20,1012,Body Lotion,200,400,200,1,00102,India
843499,2023-04-20,1008,Makeup Remover,80,160,80,2,00491,India
843499,2023-04-20,1007,Eyeshadow,200,400,200,2,00491,India
851256,2023-04-20,1002,Mascara,200,400,200,2,00097,India
851256,2023-04-20,1008,Makeup Remover,80,160,80,2,00097,India
851256,2023-04-20,1003,Foundation,300,600,300,2,00097,India
522975,2023-04-21,1005,Nail Polish,50,100,50,2,00320,India
522975,2023-04-21,1001,Lipstick,150,300,150,2,00320,India
522975,2023-04-21,1012,Body Lotion,200,400,200,1,00320,India
522975,2023-04-21,1004,Eyeliner,100,200,100,2,00320,India
522975,2023-04-21,1006,Blush,150,300,150,2,00320,India
442813,2023-04-21,1009,Moisturizer,250,500,250,1,00407,India
442813,2023-04-21,1002,Mascara,200,400,200,2,00407,India
490502,2023-04-21,1009,Moisturizer,250,500,250,1,00418,India
490502,2023-04-21,1006,Blush,150,300,150,2,00418,India
663758,2023-04-21,1001,Lipstick,150,300,150,2,00112,India
663758,2023-04-21,1007,Eyeshadow,200,400,200,2,00112,India
663758,2023-04-21,1012,Body Lotion,200,400,200,1,00112,India
561611,2023-04-21,1012,Body Lotion,200,400,200,1,00027,India
450369,2023-04-21,1009,Moisturizer,250,500,250,1,00049,India
450369,2023-04-21,1002,Mascara,200,400,200,2,00049,India
450369,2023-04-21,1007,Eyeshadow,200,400,200,2,00049,India
450369,2023-04-21,1001,Lipstick,150,300,150,2,00049,India
450369,2023-04-21,1003,Foundation,300,600,300,2,00049,India
975814,2023-04-21,1004,Eyeliner,100,200,100,2,00043,India
975814,2023-04-21,1001,Lipstick,150,300,150,2,00043,India
746464,2023-04-21,1007,Eyeshadow,200,400,200,2,00063,India
746464,2023-04-21,1003,Foundation,300,600,300,2,00063,India
746464,2023-04-21,1001,Lipstick,150,300,150,2,00063,India
305059,2023-04-21,1009,Moisturizer,250,500,250,1,00001,India
305059,2023-04-21,1007,Eyeshadow,200,400,200,2,00001,India
305059,2023-04-21,1008,Makeup Remover,80,160,80,2,00001,India
128922,2023-04-21,1012,Body Lotion,200,400,200,1,00064,India
128922,2023-04-21,1007,Eyeshadow,200,400,200,2,00064,India
451874,2023-04-21,1004,Eyeliner,100,200,100,2,00431,India
451874,2023-04-21,1005,Nail Polish,50,100,50,2,00431,India
451874,2023-04-21,1003,Foundation,300,600,300,2,00431,India
451874,2023-04-21,1002,Mascara,200,400,200,2,00431,India
189952,2023-04-21,1003,Foundation,300,600,300,2,00461,India
189952,2023-04-21,1004,Eyeliner,100,200,100,2,00461,India
189952,2023-04-21,1009,Moisturizer,250,500,250,1,00461,India
189952,2023-04-21,1012,Body Lotion,200,400,200,1,00461,India
189952,2023-04-21,1001,Lipstick,150,300,150,2,00461,India
241811,2023-04-21,1002,Mascara,200,400,200,2,00130,India
241811,2023-04-21,1012,Body Lotion,200,400,200,1,00130,India
241811,2023-04-21,1009,Moisturizer,250,500,250,1,00130,India
241811,2023-04-21,1008,Makeup Remover,80,160,80,2,00130,India
241811,2023-04-21,1005,Nail Polish,50,100,50,2,00130,India
869759,2023-04-21,1012,Body Lotion,200,400,200,1,00436,India
869759,2023-04-21,1009,Moisturizer,250,500,250,1,00436,India
869759,2023-04-21,1006,Blush,150,300,150,2,00436,India
796697,2023-04-21,1012,Body Lotion,200,400,200,1,00184,India
796697,2023-04-21,1008,Makeup Remover,80,160,80,2,00184,India
796697,2023-04-21,1002,Mascara,200,400,200,2,00184,India
896569,2023-04-21,1003,Foundation,300,600,300,2,00165,India
896569,2023-04-21,1009,Moisturizer,250,500,250,1,00165,India
896569,2023-04-21,1005,Nail Polish,50,100,50,2,00165,India
492054,2023-04-21,1002,Mascara,200,400,200,2,00377,India
492054,2023-04-21,1004,Eyeliner,100,200,100,2,00377,India
795880,2023-04-21,1006,Blush,150,300,150,2,00168,India
795880,2023-04-21,1001,Lipstick,150,300,150,2,00168,India
795880,2023-04-21,1012,Body Lotion,200,400,200,1,00168,India
366993,2023-04-21,1006,Blush,150,300,150,2,00022,India
145940,2023-04-21,1005,Nail Polish,50,100,50,2,00192,India
145940,2023-04-21,1008,Makeup Remover,80,160,80,2,00192,India
641633,2023-04-21,1003,Foundation,300,600,300,2,00432,India
641633,2023-04-21,1002,Mascara,200,400,200,2,00432,India
470558,2023-04-21,1002,Mascara,200,400,200,2,00433,India
215717,2023-04-21,1006,Blush,150,300,150,2,00112,India
643496,2023-04-21,1009,Moisturizer,250,500,250,1,00044,India
643496,2023-04-21,1003,Foundation,300,600,300,2,00044,India
643496,2023-04-21,1005,Nail Polish,50,100,50,2,00044,India
643496,2023-04-21,1002,Mascara,200,400,200,2,00044,India
452435,2023-04-21,1012,Body Lotion,200,400,200,1,00188,India
452435,2023-04-21,1004,Eyeliner,100,200,100,2,00188,India
452435,2023-04-21,1005,Nail Polish,50,100,50,2,00188,India
452435,2023-04-21,1006,Blush,150,300,150,2,00188,India
465694,2023-04-21,1012,Body Lotion,200,400,200,1,00028,India
465694,2023-04-21,1008,Makeup Remover,80,160,80,2,00028,India
338928,2023-04-21,1002,Mascara,200,400,200,2,00320,India
338928,2023-04-21,1009,Moisturizer,250,500,250,1,00320,India
178763,2023-04-21,1008,Makeup Remover,80,160,80,2,00191,India
178763,2023-04-21,1005,Nail Polish,50,100,50,2,00191,India
855283,2023-04-21,1006,Blush,150,300,150,2,00448,India
855283,2023-04-21,1008,Makeup Remover,80,160,80,2,00448,India
855283,2023-04-21,1012,Body Lotion,200,400,200,1,00448,India
333136,2023-04-21,1008,Makeup Remover,80,160,80,2,00160,India
333136,2023-04-21,1004,Eyeliner,100,200,100,2,00160,India
983871,2023-04-21,1007,Eyeshadow,200,400,200,2,00160,India
130812,2023-04-21,1006,Blush,150,300,150,2,00039,India
898587,2023-04-21,1012,Body Lotion,200,400,200,1,00488,India
301828,2023-04-21,1007,Eyeshadow,200,400,200,2,00297,India
301828,2023-04-21,1009,Moisturizer,250,500,250,1,00297,India
301828,2023-04-21,1008,Makeup Remover,80,160,80,2,00297,India
161856,2023-04-21,1009,Moisturizer,250,500,250,1,00355,India
161856,2023-04-21,1001,Lipstick,150,300,150,2,00355,India
264780,2023-04-21,1005,Nail Polish,50,100,50,2,00025,India
264780,2023-04-21,1008,Makeup Remover,80,160,80,2,00025,India
264780,2023-04-21,1009,Moisturizer,250,500,250,1,00025,India
264780,2023-04-21,1007,Eyeshadow,200,400,200,2,00025,India
373592,2023-04-21,1005,Nail Polish,50,100,50,2,00438,India
373592,2023-04-21,1009,Moisturizer,250,500,250,1,00438,India
373592,2023-04-21,1001,Lipstick,150,300,150,2,00438,India
623822,2023-04-21,1012,Body Lotion,200,400,200,1,00209,India
623822,2023-04-21,1002,Mascara,200,400,200,2,00209,India
992940,2023-04-21,1005,Nail Polish,50,100,50,2,00285,India
992940,2023-04-21,1008,Makeup Remover,80,160,80,2,00285,India
992940,2023-04-21,1001,Lipstick,150,300,150,2,00285,India
992940,2023-04-21,1003,Foundation,300,600,300,2,00285,India
359117,2023-04-21,1007,Eyeshadow,200,400,200,2,00032,India
645593,2023-04-21,1009,Moisturizer,250,500,250,1,00286,India
645593,2023-04-21,1003,Foundation,300,600,300,2,00286,India
645593,2023-04-21,1006,Blush,150,300,150,2,00286,India
645593,2023-04-21,1012,Body Lotion,200,400,200,1,00286,India
451382,2023-04-21,1008,Makeup Remover,80,160,80,2,00309,India
403927,2023-04-21,1006,Blush,150,300,150,2,00333,India
403927,2023-04-21,1001,Lipstick,150,300,150,2,00333,India
403927,2023-04-21,1009,Moisturizer,250,500,250,1,00333,India
403927,2023-04-21,1005,Nail Polish,50,100,50,2,00333,India
911901,2023-04-21,1008,Makeup Remover,80,160,80,2,00464,India
911901,2023-04-21,1002,Mascara,200,400,200,2,00464,India
911901,2023-04-21,1003,Foundation,300,600,300,2,00464,India
911901,2023-04-21,1006,Blush,150,300,150,2,00464,India
746572,2023-04-21,1003,Foundation,300,600,300,2,00277,India
207958,2023-04-21,1008,Makeup Remover,80,160,80,2,00042,India
207958,2023-04-21,1012,Body Lotion,200,400,200,1,00042,India
594200,2023-04-21,1007,Eyeshadow,200,400,200,2,00489,India
594200,2023-04-21,1005,Nail Polish,50,100,50,2,00489,India
594200,2023-04-21,1001,Lipstick,150,300,150,2,00489,India
268178,2023-04-21,1005,Nail Polish,50,100,50,2,00425,India
268178,2023-04-21,1002,Mascara,200,400,200,2,00425,India
268178,2023-04-21,1004,Eyeliner,100,200,100,2,00425,India
268178,2023-04-21,1001,Lipstick,150,300,150,2,00425,India
788540,2023-04-21,1002,Mascara,200,400,200,2,00364,India
788540,2023-04-21,1007,Eyeshadow,200,400,200,2,00364,India
122711,2023-04-22,1006,Blush,150,300,150,2,00335,India
257658,2023-04-22,1002,Mascara,200,400,200,2,00177,India
257658,2023-04-22,1003,Foundation,300,600,300,2,00177,India
544306,2023-04-22,1006,Blush,150,300,150,2,00282,India
544306,2023-04-22,1002,Mascara,200,400,200,2,00282,India
544306,2023-04-22,1005,Nail Polish,50,100,50,2,00282,India
544306,2023-04-22,1004,Eyeliner,100,200,100,2,00282,India
366328,2023-04-22,1008,Makeup Remover,80,160,80,2,00373,India
222070,2023-04-22,1007,Eyeshadow,200,400,200,2,00433,India
481639,2023-04-22,1007,Eyeshadow,200,400,200,2,00289,India
373838,2023-04-22,1002,Mascara,200,400,200,2,00472,India
373838,2023-04-22,1007,Eyeshadow,200,400,200,2,00472,India
373838,2023-04-22,1005,Nail Polish,50,100,50,2,00472,India
373838,2023-04-22,1001,Lipstick,150,300,150,2,00472,India
488822,2023-04-22,1008,Makeup Remover,80,160,80,2,00130,India
488822,2023-04-22,1004,Eyeliner,100,200,100,2,00130,India
488822,2023-04-22,1012,Body Lotion,200,400,200,1,00130,India
488822,2023-04-22,1005,Nail Polish,50,100,50,2,00130,India
488822,2023-04-22,1003,Foundation,300,600,300,2,00130,India
979696,2023-04-22,1005,Nail Polish,50,100,50,2,00499,India
979696,2023-04-22,1002,Mascara,200,400,200,2,00499,India
596542,2023-04-22,1002,Mascara,200,400,200,2,00392,India
596542,2023-04-22,1009,Moisturizer,250,500,250,1,00392,India
596542,2023-04-22,1004,Eyeliner,100,200,100,2,00392,India
596542,2023-04-22,1005,Nail Polish,50,100,50,2,00392,India
596542,2023-04-22,1003,Foundation,300,600,300,2,00392,India
224687,2023-04-22,1002,Mascara,200,400,200,2,00069,India
833852,2023-04-22,1012,Body Lotion,200,400,200,1,00044,India
903815,2023-04-22,1008,Makeup Remover,80,160,80,2,00266,India
903815,2023-04-22,1003,Foundation,300,600,300,2,00266,India
903815,2023-04-22,1009,Moisturizer,250,500,250,1,00266,India
929129,2023-04-22,1012,Body Lotion,200,400,200,1,00312,India
929129,2023-04-22,1006,Blush,150,300,150,2,00312,India
929129,2023-04-22,1004,Eyeliner,100,200,100,2,00312,India
504940,2023-04-22,1002,Mascara,200,400,200,2,00452,India
504940,2023-04-22,1006,Blush,150,300,150,2,00452,India
504940,2023-04-22,1003,Foundation,300,600,300,2,00452,India
460812,2023-04-22,1007,Eyeshadow,200,400,200,2,00229,India
460812,2023-04-22,1004,Eyeliner,100,200,100,2,00229,India
460812,2023-04-22,1003,Foundation,300,600,300,2,00229,India
460916,2023-04-22,1001,Lipstick,150,300,150,2,00325,India
460916,2023-04-22,1008,Makeup Remover,80,160,80,2,00325,India
460916,2023-04-22,1009,Moisturizer,250,500,250,1,00325,India
460916,2023-04-22,1007,Eyeshadow,200,400,200,2,00325,India
460916,2023-04-22,1012,Body Lotion,200,400,200,1,00325,India
831242,2023-04-22,1007,Eyeshadow,200,400,200,2,00012,India
629361,2023-04-22,1006,Blush,150,300,150,2,00309,India
629361,2023-04-22,1007,Eyeshadow,200,400,200,2,00309,India
844519,2023-04-22,1009,Moisturizer,250,500,250,1,00183,India
844519,2023-04-22,1006,Blush,150,300,150,2,00183,India
844519,2023-04-22,1007,Eyeshadow,200,400,200,2,00183,India
325456,2023-04-22,1007,Eyeshadow,200,400,200,2,00478,India
914583,2023-04-22,1009,Moisturizer,250,500,250,1,00435,India
914583,2023-04-22,1003,Foundation,300,600,300,2,00435,India
914583,2023-04-22,1005,Nail Polish,50,100,50,2,00435,India
438443,2023-04-22,1007,Eyeshadow,200,400,200,2,00001,India
438443,2023-04-22,1001,Lipstick,150,300,150,2,00001,India
137038,2023-04-22,1002,Mascara,200,400,200,2,00038,India
137038,2023-04-22,1009,Moisturizer,250,500,250,1,00038,India
137038,2023-04-22,1004,Eyeliner,100,200,100,2,00038,India
878887,2023-04-22,1012,Body Lotion,200,400,200,1,00363,India
878887,2023-04-22,1006,Blush,150,300,150,2,00363,India
878887,2023-04-22,1007,Eyeshadow,200,400,200,2,00363,India
878887,2023-04-22,1009,Moisturizer,250,500,250,1,00363,India
631851,2023-04-22,1003,Foundation,300,600,300,2,00064,India
403770,2023-04-22,1009,Moisturizer,250,500,250,1,00285,India
750102,2023-04-22,1002,Mascara,200,400,200,2,00462,India
750102,2023-04-22,1001,Lipstick,150,300,150,2,00462,India
750102,2023-04-22,1004,Eyeliner,100,200,100,2,00462,India
979372,2023-04-22,1007,Eyeshadow,200,400,200,2,00026,India
381517,2023-04-22,1004,Eyeliner,100,200,100,2,00038,India
381517,2023-04-22,1005,Nail Polish,50,100,50,2,00038,India
381517,2023-04-22,1006,Blush,150,300,150,2,00038,India
381517,2023-04-22,1008,Makeup Remover,80,160,80,2,00038,India
575495,2023-04-22,1003,Foundation,300,600,300,2,00062,India
575495,2023-04-22,1009,Moisturizer,250,500,250,1,00062,India
583431,2023-04-22,1003,Foundation,300,600,300,2,00214,India
583431,2023-04-22,1008,Makeup Remover,80,160,80,2,00214,India
583431,2023-04-22,1004,Eyeliner,100,200,100,2,00214,India
583431,2023-04-22,1009,Moisturizer,250,500,250,1,00214,India
187880,2023-04-22,1004,Eyeliner,100,200,100,2,00306,India
187880,2023-04-22,1002,Mascara,200,400,200,2,00306,India
876547,2023-04-22,1009,Moisturizer,250,500,250,1,00497,India
824607,2023-04-22,1001,Lipstick,150,300,150,2,00305,India
824607,2023-04-22,1008,Makeup Remover,80,160,80,2,00305,India
824607,2023-04-22,1007,Eyeshadow,200,400,200,2,00305,India
824607,2023-04-22,1003,Foundation,300,600,300,2,00305,India
808875,2023-04-22,1008,Makeup Remover,80,160,80,2,00039,India
808875,2023-04-22,1012,Body Lotion,200,400,200,1,00039,India
808875,2023-04-22,1006,Blush,150,300,150,2,00039,India
174833,2023-04-22,1012,Body Lotion,200,400,200,1,00180,India
174833,2023-04-22,1002,Mascara,200,400,200,2,00180,India
174833,2023-04-22,1009,Moisturizer,250,500,250,1,00180,India
888557,2023-04-22,1002,Mascara,200,400,200,2,00155,India
888557,2023-04-22,1009,Moisturizer,250,500,250,1,00155,India
933933,2023-04-22,1002,Mascara,200,400,200,2,00381,India
391592,2023-04-22,1009,Moisturizer,250,500,250,1,00167,India
391592,2023-04-22,1003,Foundation,300,600,300,2,00167,India
391592,2023-04-22,1002,Mascara,200,400,200,2,00167,India
474729,2023-04-22,1005,Nail Polish,50,100,50,2,00009,India
474729,2023-04-22,1008,Makeup Remover,80,160,80,2,00009,India
947520,2023-04-22,1009,Moisturizer,250,500,250,1,00091,India
947520,2023-04-22,1002,Mascara,200,400,200,2,00091,India
947520,2023-04-22,1007,Eyeshadow,200,400,200,2,00091,India
871239,2023-04-22,1003,Foundation,300,600,300,2,00008,India
871239,2023-04-22,1012,Body Lotion,200,400,200,1,00008,India
998212,2023-04-22,1012,Body Lotion,200,400,200,1,00067,India
998212,2023-04-22,1004,Eyeliner,100,200,100,2,00067,India
337860,2023-04-22,1012,Body Lotion,200,400,200,1,00377,India
246874,2023-04-22,1007,Eyeshadow,200,400,200,2,00278,India
246874,2023-04-22,1006,Blush,150,300,150,2,00278,India
246874,2023-04-22,1002,Mascara,200,400,200,2,00278,India
621850,2023-04-22,1003,Foundation,300,600,300,2,00049,India
621850,2023-04-22,1007,Eyeshadow,200,400,200,2,00049,India
621850,2023-04-22,1012,Body Lotion,200,400,200,1,00049,India
474663,2023-04-23,1006,Blush,150,300,150,2,00376,India
474663,2023-04-23,1005,Nail Polish,50,100,50,2,00376,India
474663,2023-04-23,1008,Makeup Remover,80,160,80,2,00376,India
474663,2023-04-23,1001,Lipstick,150,300,150,2,00376,India
709736,2023-04-23,1012,Body Lotion,200,400,200,1,00431,India
412127,2023-04-23,1009,Moisturizer,250,500,250,1,00320,India
412127,2023-04-23,1012,Body Lotion,200,400,200,1,00320,India
412127,2023-04-23,1008,Makeup Remover,80,160,80,2,00320,India
412127,2023-04-23,1005,Nail Polish,50,100,50,2,00320,India
900772,2023-04-23,1003,Foundation,300,600,300,2,00147,India
900772,2023-04-23,1001,Lipstick,150,300,150,2,00147,India
900772,2023-04-23,1004,Eyeliner,100,200,100,2,00147,India
970452,2023-04-23,1009,Moisturizer,250,500,250,1,00349,India
970452,2023-04-23,1005,Nail Polish,50,100,50,2,00349,India
970452,2023-04-23,1002,Mascara,200,400,200,2,00349,India
970452,2023-04-23,1001,Lipstick,150,300,150,2,00349,India
203549,2023-04-23,1009,Moisturizer,250,500,250,1,00196,India
203549,2023-04-23,1002,Mascara,200,400,200,2,00196,India
203549,2023-04-23,1001,Lipstick,150,300,150,2,00196,India
114208,2023-04-23,1006,Blush,150,300,150,2,00362,India
114208,2023-04-23,1005,Nail Polish,50,100,50,2,00362,India
741074,2023-04-23,1002,Mascara,200,400,200,2,00050,India
741074,2023-04-23,1012,Body Lotion,200,400,200,1,00050,India
317665,2023-04-23,1004,Eyeliner,100,200,100,2,00076,India
317665,2023-04-23,1006,Blush,150,300,150,2,00076,India
317665,2023-04-23,1005,Nail Polish,50,100,50,2,00076,India
317665,2023-04-23,1009,Moisturizer,250,500,250,1,00076,India
607457,2023-04-23,1001,Lipstick,150,300,150,2,00182,India
561509,2023-04-23,1009,Moisturizer,250,500,250,1,00332,India
561509,2023-04-23,1004,Eyeliner,100,200,100,2,00332,India
561509,2023-04-23,1001,Lipstick,150,300,150,2,00332,India
561509,2023-04-23,1005,Nail Polish,50,100,50,2,00332,India
652259,2023-04-23,1006,Blush,150,300,150,2,00092,India
731549,2023-04-23,1001,Lipstick,150,300,150,2,00260,India
731549,2023-04-23,1004,Eyeliner,100,200,100,2,00260,India
731549,2023-04-23,1007,Eyeshadow,200,400,200,2,00260,India
731549,2023-04-23,1009,Moisturizer,250,500,250,1,00260,India
731549,2023-04-23,1008,Makeup Remover,80,160,80,2,00260,India
357707,2023-04-23,1001,Lipstick,150,300,150,2,00052,India
357707,2023-04-23,1003,Foundation,300,600,300,2,00052,India
357707,2023-04-23,1005,Nail Polish,50,100,50,2,00052,India
357707,2023-04-23,1009,Moisturizer,250,500,250,1,00052,India
723872,2023-04-23,1008,Makeup Remover,80,160,80,2,00281,India
823431,2023-04-23,1012,Body Lotion,200,400,200,1,00309,India
126521,2023-04-23,1008,Makeup Remover,80,160,80,2,00077,India
126521,2023-04-23,1002,Mascara,200,400,200,2,00077,India
126521,2023-04-23,1012,Body Lotion,200,400,200,1,00077,India
995688,2023-04-23,1009,Moisturizer,250,500,250,1,00132,India
995688,2023-04-23,1001,Lipstick,150,300,150,2,00132,India
971796,2023-04-23,1004,Eyeliner,100,200,100,2,00050,India
971796,2023-04-23,1009,Moisturizer,250,500,250,1,00050,India
307139,2023-04-23,1008,Makeup Remover,80,160,80,2,00132,India
307139,2023-04-23,1012,Body Lotion,200,400,200,1,00132,India
106582,2023-04-23,1001,Lipstick,150,300,150,2,00367,India
106582,2023-04-23,1005,Nail Polish,50,100,50,2,00367,India
106582,2023-04-23,1008,Makeup Remover,80,160,80,2,00367,India
203886,2023-04-23,1001,Lipstick,150,300,150,2,00457,India
203886,2023-04-23,1008,Makeup Remover,80,160,80,2,00457,India
203886,2023-04-23,1005,Nail Polish,50,100,50,2,00457,India
296569,2023-04-23,1008,Makeup Remover,80,160,80,2,00389,India
296569,2023-04-23,1002,Mascara,200,400,200,2,00389,India
296569,2023-04-23,1003,Foundation,300,600,300,2,00389,India
296569,2023-04-23,1005,Nail Polish,50,100,50,2,00389,India
161074,2023-04-23,1006,Blush,150,300,150,2,00032,India
762556,2023-04-23,1005,Nail Polish,50,100,50,2,00454,India
762556,2023-04-23,1004,Eyeliner,100,200,100,2,00454,India
762556,2023-04-23,1009,Moisturizer,250,500,250,1,00454,India
494158,2023-04-23,1002,Mascara,200,400,200,2,00474,India
494158,2023-04-23,1007,Eyeshadow,200,400,200,2,00474,India
305159,2023-04-23,1006,Blush,150,300,150,2,00217,India
305159,2023-04-23,1001,Lipstick,150,300,150,2,00217,India
305159,2023-04-23,1005,Nail Polish,50,100,50,2,00217,India
716211,2023-04-23,1009,Moisturizer,250,500,250,1,00389,India
716211,2023-04-23,1005,Nail Polish,50,100,50,2,00389,India
780429,2023-04-23,1004,Eyeliner,100,200,100,2,00146,India
782350,2023-04-23,1004,Eyeliner,100,200,100,2,00403,India
911398,2023-04-23,1009,Moisturizer,250,500,250,1,00176,India
165996,2023-04-23,1007,Eyeshadow,200,400,200,2,00082,India
179298,2023-04-23,1006,Blush,150,300,150,2,00154,India
179298,2023-04-23,1002,Mascara,200,400,200,2,00154,India
179298,2023-04-23,1008,Makeup Remover,80,160,80,2,00154,India
179298,2023-04-23,1009,Moisturizer,250,500,250,1,00154,India
296240,2023-04-23,1008,Makeup Remover,80,160,80,2,00270,India
296240,2023-04-23,1007,Eyeshadow,200,400,200,2,00270,India
659516,2023-04-23,1007,Eyeshadow,200,400,200,2,00126,India
659516,2023-04-23,1002,Mascara,200,400,200,2,00126,India
659516,2023-04-23,1005,Nail Polish,50,100,50,2,00126,India
707047,2023-04-23,1002,Mascara,200,400,200,2,00218,India
707047,2023-04-23,1008,Makeup Remover,80,160,80,2,00218,India
476473,2023-04-23,1002,Mascara,200,400,200,2,00391,India
476473,2023-04-23,1012,Body Lotion,200,400,200,1,00391,India
476473,2023-04-23,1003,Foundation,300,600,300,2,00391,India
801900,2023-04-23,1003,Foundation,300,600,300,2,00306,India
695472,2023-04-23,1001,Lipstick,150,300,150,2,00159,India
695472,2023-04-23,1007,Eyeshadow,200,400,200,2,00159,India
695472,2023-04-23,1012,Body Lotion,200,400,200,1,00159,India
276815,2023-04-23,1008,Makeup Remover,80,160,80,2,00054,India
276815,2023-04-23,1005,Nail Polish,50,100,50,2,00054,India
786207,2023-04-23,1007,Eyeshadow,200,400,200,2,00462,India
786207,2023-04-23,1003,Foundation,300,600,300,2,00462,India
786207,2023-04-23,1009,Moisturizer,250,500,250,1,00462,India
786207,2023-04-23,1006,Blush,150,300,150,2,00462,India
527450,2023-04-23,1001,Lipstick,150,300,150,2,00169,India
527450,2023-04-23,1006,Blush,150,300,150,2,00169,India
187262,2023-04-23,1012,Body Lotion,200,400,200,1,00212,India
187262,2023-04-23,1003,Foundation,300,600,300,2,00212,India
205791,2023-04-23,1002,Mascara,200,400,200,2,00478,India
205791,2023-04-23,1006,Blush,150,300,150,2,00478,India
205791,2023-04-23,1005,Nail Polish,50,100,50,2,00478,India
205791,2023-04-23,1012,Body Lotion,200,400,200,1,00478,India
205791,2023-04-23,1003,Foundation,300,600,300,2,00478,India
758585,2023-04-23,1005,Nail Polish,50,100,50,2,00166,India
758585,2023-04-23,1002,Mascara,200,400,200,2,00166,India
758585,2023-04-23,1007,Eyeshadow,200,400,200,2,00166,India
680624,2023-04-24,1008,Makeup Remover,80,160,80,2,00127,India
240110,2023-04-24,1002,Mascara,200,400,200,2,00257,India
244797,2023-04-24,1001,Lipstick,150,300,150,2,00125,India
244797,2023-04-24,1006,Blush,150,300,150,2,00125,India
709163,2023-04-24,1006,Blush,150,300,150,2,00202,India
796041,2023-04-24,1009,Moisturizer,250,500,250,1,00216,India
796041,2023-04-24,1006,Blush,150,300,150,2,00216,India
816884,2023-04-24,1009,Moisturizer,250,500,250,1,00216,India
816884,2023-04-24,1006,Blush,150,300,150,2,00216,India
816884,2023-04-24,1004,Eyeliner,100,200,100,2,00216,India
252578,2023-04-24,1001,Lipstick,150,300,150,2,00388,India
252578,2023-04-24,1005,Nail Polish,50,100,50,2,00388,India
252578,2023-04-24,1012,Body Lotion,200,400,200,1,00388,India
252578,2023-04-24,1008,Makeup Remover,80,160,80,2,00388,India
936607,2023-04-24,1007,Eyeshadow,200,400,200,2,00102,India
936607,2023-04-24,1005,Nail Polish,50,100,50,2,00102,India
936607,2023-04-24,1008,Makeup Remover,80,160,80,2,00102,India
936607,2023-04-24,1003,Foundation,300,600,300,2,00102,India
288013,2023-04-24,1004,Eyeliner,100,200,100,2,00450,India
288013,2023-04-24,1002,Mascara,200,400,200,2,00450,India
288013,2023-04-24,1006,Blush,150,300,150,2,00450,India
139717,2023-04-24,1012,Body Lotion,200,400,200,1,00455,India
139717,2023-04-24,1001,Lipstick,150,300,150,2,00455,India
139717,2023-04-24,1003,Foundation,300,600,300,2,00455,India
139717,2023-04-24,1005,Nail Polish,50,100,50,2,00455,India
123321,2023-04-24,1009,Moisturizer,250,500,250,1,00263,India
123321,2023-04-24,1001,Lipstick,150,300,150,2,00263,India
123321,2023-04-24,1004,Eyeliner,100,200,100,2,00263,India
943861,2023-04-24,1012,Body Lotion,200,400,200,1,00025,India
943861,2023-04-24,1001,Lipstick,150,300,150,2,00025,India
943861,2023-04-24,1004,Eyeliner,100,200,100,2,00025,India
668060,2023-04-24,1005,Nail Polish,50,100,50,2,00316,India
668060,2023-04-24,1007,Eyeshadow,200,400,200,2,00316,India
668060,2023-04-24,1001,Lipstick,150,300,150,2,00316,India
967579,2023-04-24,1012,Body Lotion,200,400,200,1,00112,India
773692,2023-04-24,1001,Lipstick,150,300,150,2,00466,India
773692,2023-04-24,1012,Body Lotion,200,400,200,1,00466,India
106543,2023-04-24,1012,Body Lotion,200,400,200,1,00029,India
106543,2023-04-24,1007,Eyeshadow,200,400,200,2,00029,India
356492,2023-04-24,1008,Makeup Remover,80,160,80,2,00240,India
356492,2023-04-24,1009,Moisturizer,250,500,250,1,00240,India
356492,2023-04-24,1003,Foundation,300,600,300,2,00240,India
472951,2023-04-24,1007,Eyeshadow,200,400,200,2,00422,India
472951,2023-04-24,1002,Mascara,200,400,200,2,00422,India
767371,2023-04-24,1009,Moisturizer,250,500,250,1,00033,India
767371,2023-04-24,1012,Body Lotion,200,400,200,1,00033,India
767371,2023-04-24,1008,Makeup Remover,80,160,80,2,00033,India
767371,2023-04-24,1006,Blush,150,300,150,2,00033,India
813357,2023-04-24,1005,Nail Polish,50,100,50,2,00171,India
813357,2023-04-24,1009,Moisturizer,250,500,250,1,00171,India
813357,2023-04-24,1008,Makeup Remover,80,160,80,2,00171,India
615807,2023-04-24,1006,Blush,150,300,150,2,00155,India
786093,2023-04-24,1003,Foundation,300,600,300,2,00187,India
786093,2023-04-24,1012,Body Lotion,200,400,200,1,00187,India
109242,2023-04-24,1005,Nail Polish,50,100,50,2,00470,India
109242,2023-04-24,1006,Blush,150,300,150,2,00470,India
109242,2023-04-24,1008,Makeup Remover,80,160,80,2,00470,India
109242,2023-04-24,1002,Mascara,200,400,200,2,00470,India
187682,2023-04-24,1004,Eyeliner,100,200,100,2,00017,India
187682,2023-04-24,1009,Moisturizer,250,500,250,1,00017,India
187682,2023-04-24,1002,Mascara,200,400,200,2,00017,India
875941,2023-04-24,1009,Moisturizer,250,500,250,1,00173,India
285188,2023-04-24,1001,Lipstick,150,300,150,2,00243,India
285188,2023-04-24,1006,Blush,150,300,150,2,00243,India
285188,2023-04-24,1004,Eyeliner,100,200,100,2,00243,India
285188,2023-04-24,1003,Foundation,300,600,300,2,00243,India
112681,2023-04-24,1007,Eyeshadow,200,400,200,2,00180,India
112681,2023-04-24,1004,Eyeliner,100,200,100,2,00180,India
285407,2023-04-24,1004,Eyeliner,100,200,100,2,00257,India
597617,2023-04-24,1004,Eyeliner,100,200,100,2,00190,India
597617,2023-04-24,1003,Foundation,300,600,300,2,00190,India
597617,2023-04-24,1005,Nail Polish,50,100,50,2,00190,India
597617,2023-04-24,1012,Body Lotion,200,400,200,1,00190,India
685368,2023-04-24,1001,Lipstick,150,300,150,2,00402,India
252504,2023-04-24,1009,Moisturizer,250,500,250,1,00328,India
762113,2023-04-24,1004,Eyeliner,100,200,100,2,00472,India
762113,2023-04-24,1003,Foundation,300,600,300,2,00472,India
112362,2023-04-24,1008,Makeup Remover,80,160,80,2,00210,India
112362,2023-04-24,1006,Blush,150,300,150,2,00210,India
755402,2023-04-24,1009,Moisturizer,250,500,250,1,00457,India
755402,2023-04-24,1004,Eyeliner,100,200,100,2,00457,India
129207,2023-04-24,1012,Body Lotion,200,400,200,1,00476,India
129207,2023-04-24,1003,Foundation,300,600,300,2,00476,India
129207,2023-04-24,1006,Blush,150,300,150,2,00476,India
129207,2023-04-24,1004,Eyeliner,100,200,100,2,00476,India
897394,2023-04-24,1006,Blush,150,300,150,2,00219,India
701750,2023-04-25,1006,Blush,150,300,150,2,00415,India
701750,2023-04-25,1001,Lipstick,150,300,150,2,00415,India
701750,2023-04-25,1012,Body Lotion,200,400,200,1,00415,India
986413,2023-04-25,1008,Makeup Remover,80,160,80,2,00451,India
986413,2023-04-25,1004,Eyeliner,100,200,100,2,00451,India
986413,2023-04-25,1009,Moisturizer,250,500,250,1,00451,India
986413,2023-04-25,1002,Mascara,200,400,200,2,00451,India
986413,2023-04-25,1003,Foundation,300,600,300,2,00451,India
109770,2023-04-25,1009,Moisturizer,250,500,250,1,00262,India
109770,2023-04-25,1012,Body Lotion,200,400,200,1,00262,India
109770,2023-04-25,1001,Lipstick,150,300,150,2,00262,India
109770,2023-04-25,1005,Nail Polish,50,100,50,2,00262,India
130848,2023-04-25,1005,Nail Polish,50,100,50,2,00219,India
130848,2023-04-25,1012,Body Lotion,200,400,200,1,00219,India
130848,2023-04-25,1001,Lipstick,150,300,150,2,00219,India
130848,2023-04-25,1003,Foundation,300,600,300,2,00219,India
130848,2023-04-25,1004,Eyeliner,100,200,100,2,00219,India
639161,2023-04-25,1008,Makeup Remover,80,160,80,2,00286,India
639161,2023-04-25,1009,Moisturizer,250,500,250,1,00286,India
639161,2023-04-25,1004,Eyeliner,100,200,100,2,00286,India
513796,2023-04-25,1012,Body Lotion,200,400,200,1,00047,India
513796,2023-04-25,1006,Blush,150,300,150,2,00047,India
284632,2023-04-25,1008,Makeup Remover,80,160,80,2,00249,India
462524,2023-04-25,1002,Mascara,200,400,200,2,00277,India
462524,2023-04-25,1008,Makeup Remover,80,160,80,2,00277,India
462524,2023-04-25,1012,Body Lotion,200,400,200,1,00277,India
606859,2023-04-25,1005,Nail Polish,50,100,50,2,00251,India
606859,2023-04-25,1002,Mascara,200,400,200,2,00251,India
606859,2023-04-25,1008,Makeup Remover,80,160,80,2,00251,India
572483,2023-04-25,1006,Blush,150,300,150,2,00328,India
205297,2023-04-25,1005,Nail Polish,50,100,50,2,00123,India
205297,2023-04-25,1009,Moisturizer,250,500,250,1,00123,India
419962,2023-04-25,1002,Mascara,200,400,200,2,00032,India
419962,2023-04-25,1006,Blush,150,300,150,2,00032,India
419962,2023-04-25,1004,Eyeliner,100,200,100,2,00032,India
368111,2023-04-25,1003,Foundation,300,600,300,2,00276,India
368111,2023-04-25,1007,Eyeshadow,200,400,200,2,00276,India
371611,2023-04-25,1008,Makeup Remover,80,160,80,2,00039,India
371611,2023-04-25,1004,Eyeliner,100,200,100,2,00039,India
999076,2023-04-25,1009,Moisturizer,250,500,250,1,00254,India
378191,2023-04-25,1003,Foundation,300,600,300,2,00312,India
627417,2023-04-25,1001,Lipstick,150,300,150,2,00485,India
956893,2023-04-25,1005,Nail Polish,50,100,50,2,00164,India
956893,2023-04-25,1001,Lipstick,150,300,150,2,00164,India
956893,2023-04-25,1009,Moisturizer,250,500,250,1,00164,India
799753,2023-04-25,1006,Blush,150,300,150,2,00062,India
799753,2023-04-25,1002,Mascara,200,400,200,2,00062,India
799753,2023-04-25,1009,Moisturizer,250,500,250,1,00062,India
236303,2023-04-25,1003,Foundation,300,600,300,2,00070,India
236303,2023-04-25,1009,Moisturizer,250,500,250,1,00070,India
236303,2023-04-25,1004,Eyeliner,100,200,100,2,00070,India
236303,2023-04-25,1002,Mascara,200,400,200,2,00070,India
661150,2023-04-25,1009,Moisturizer,250,500,250,1,00413,India
661150,2023-04-25,1012,Body Lotion,200,400,200,1,00413,India
661150,2023-04-25,1001,Lipstick,150,300,150,2,00413,India
661150,2023-04-25,1003,Foundation,300,600,300,2,00413,India
377903,2023-04-25,1006,Blush,150,300,150,2,00374,India
377903,2023-04-25,1008,Makeup Remover,80,160,80,2,00374,India
377903,2023-04-25,1001,Lipstick,150,300,150,2,00374,India
377903,2023-04-25,1005,Nail Polish,50,100,50,2,00374,India
126875,2023-04-25,1006,Blush,150,300,150,2,00405,India
126875,2023-04-25,1004,Eyeliner,100,200,100,2,00405,India
126875,2023-04-25,1003,Foundation,300,600,300,2,00405,India
869791,2023-04-25,1008,Makeup Remover,80,160,80,2,00246,India
869791,2023-04-25,1002,Mascara,200,400,200,2,00246,India
717052,2023-04-25,1006,Blush,150,300,150,2,00241,India
717052,2023-04-25,1007,Eyeshadow,200,400,200,2,00241,India
717052,2023-04-25,1001,Lipstick,150,300,150,2,00241,India
115841,2023-04-25,1003,Foundation,300,600,300,2,00300,India
115841,2023-04-25,1002,Mascara,200,400,200,2,00300,India
115841,2023-04-25,1006,Blush,150,300,150,2,00300,India
205524,2023-04-25,1001,Lipstick,150,300,150,2,00461,India
590485,2023-04-25,1006,Blush,150,300,150,2,00057,India
590485,2023-04-25,1007,Eyeshadow,200,400,200,2,00057,India
590485,2023-04-25,1009,Moisturizer,250,500,250,1,00057,India
128811,2023-04-25,1005,Nail Polish,50,100,50,2,00485,India
128811,2023-04-25,1009,Moisturizer,250,500,250,1,00485,India
128811,2023-04-25,1002,Mascara,200,400,200,2,00485,India
128811,2023-04-25,1008,Makeup Remover,80,160,80,2,00485,India
959308,2023-04-25,1008,Makeup Remover,80,160,80,2,00345,India
959308,2023-04-25,1002,Mascara,200,400,200,2,00345,India
959308,2023-04-25,1012,Body Lotion,200,400,200,1,00345,India
959308,2023-04-25,1005,Nail Polish,50,100,50,2,00345,India
959308,2023-04-25,1003,Foundation,300,600,300,2,00345,India
101918,2023-04-25,1008,Makeup Remover,80,160,80,2,00228,India
101918,2023-04-25,1002,Mascara,200,400,200,2,00228,India
101918,2023-04-25,1007,Eyeshadow,200,400,200,2,00228,India
707479,2023-04-26,1007,Eyeshadow,200,400,200,2,00074,India
707479,2023-04-26,1002,Mascara,200,400,200,2,00074,India
506515,2023-04-26,1005,Nail Polish,50,100,50,2,00385,India
689895,2023-04-26,1007,Eyeshadow,200,400,200,2,00405,India
689895,2023-04-26,1005,Nail Polish,50,100,50,2,00405,India
353228,2023-04-26,1005,Nail Polish,50,100,50,2,00011,India
531377,2023-04-26,1004,Eyeliner,100,200,100,2,00322,India
531377,2023-04-26,1008,Makeup Remover,80,160,80,2,00322,India
531377,2023-04-26,1009,Moisturizer,250,500,250,1,00322,India
260957,2023-04-26,1007,Eyeshadow,200,400,200,2,00156,India
260957,2023-04-26,1001,Lipstick,150,300,150,2,00156,India
260957,2023-04-26,1012,Body Lotion,200,400,200,1,00156,India
203435,2023-04-26,1006,Blush,150,300,150,2,00228,India
203435,2023-04-26,1005,Nail Polish,50,100,50,2,00228,India
305131,2023-04-26,1012,Body Lotion,200,400,200,1,00051,India
511804,2023-04-26,1005,Nail Polish,50,100,50,2,00334,India
511804,2023-04-26,1006,Blush,150,300,150,2,00334,India
511804,2023-04-26,1009,Moisturizer,250,500,250,1,00334,India
511804,2023-04-26,1012,Body Lotion,200,400,200,1,00334,India
839484,2023-04-26,1007,Eyeshadow,200,400,200,2,00088,India
839484,2023-04-26,1008,Makeup Remover,80,160,80,2,00088,India
840466,2023-04-26,1003,Foundation,300,600,300,2,00165,India
840466,2023-04-26,1005,Nail Polish,50,100,50,2,00165,India
273472,2023-04-26,1001,Lipstick,150,300,150,2,00492,India
273472,2023-04-26,1012,Body Lotion,200,400,200,1,00492,India
273472,2023-04-26,1008,Makeup Remover,80,160,80,2,00492,India
917183,2023-04-26,1005,Nail Polish,50,100,50,2,00384,India
758796,2023-04-26,1001,Lipstick,150,300,150,2,00294,India
676977,2023-04-26,1012,Body Lotion,200,400,200,1,00467,India
676977,2023-04-26,1009,Moisturizer,250,500,250,1,00467,India
676977,2023-04-26,1002,Mascara,200,400,200,2,00467,India
676977,2023-04-26,1004,Eyeliner,100,200,100,2,00467,India
676977,2023-04-26,1008,Makeup Remover,80,160,80,2,00467,India
767253,2023-04-26,1004,Eyeliner,100,200,100,2,00415,India
773259,2023-04-26,1009,Moisturizer,250,500,250,1,00232,India
773259,2023-04-26,1005,Nail Polish,50,100,50,2,00232,India
500655,2023-04-26,1008,Makeup Remover,80,160,80,2,00176,India
164779,2023-04-26,1004,Eyeliner,100,200,100,2,00101,India
164779,2023-04-26,1012,Body Lotion,200,400,200,1,00101,India
164779,2023-04-26,1006,Blush,150,300,150,2,00101,India
164779,2023-04-26,1002,Mascara,200,400,200,2,00101,India
719513,2023-04-26,1007,Eyeshadow,200,400,200,2,00197,India
719513,2023-04-26,1002,Mascara,200,400,200,2,00197,India
498472,2023-04-26,1009,Moisturizer,250,500,250,1,00280,India
498472,2023-04-26,1003,Foundation,300,600,300,2,00280,India
892998,2023-04-26,1008,Makeup Remover,80,160,80,2,00405,India
892998,2023-04-26,1009,Moisturizer,250,500,250,1,00405,India
892998,2023-04-26,1004,Eyeliner,100,200,100,2,00405,India
597174,2023-04-26,1004,Eyeliner,100,200,100,2,00219,India
597174,2023-04-26,1012,Body Lotion,200,400,200,1,00219,India
597174,2023-04-26,1006,Blush,150,300,150,2,00219,India
832934,2023-04-26,1001,Lipstick,150,300,150,2,00285,India
832934,2023-04-26,1004,Eyeliner,100,200,100,2,00285,India
832934,2023-04-26,1007,Eyeshadow,200,400,200,2,00285,India
617582,2023-04-26,1012,Body Lotion,200,400,200,1,00292,India
617582,2023-04-26,1008,Makeup Remover,80,160,80,2,00292,India
617582,2023-04-26,1005,Nail Polish,50,100,50,2,00292,India
617582,2023-04-26,1006,Blush,150,300,150,2,00292,India
815912,2023-04-26,1008,Makeup Remover,80,160,80,2,00428,India
815912,2023-04-26,1006,Blush,150,300,150,2,00428,India
472796,2023-04-26,1005,Nail Polish,50,100,50,2,00383,India
472796,2023-04-26,1009,Moisturizer,250,500,250,1,00383,India
472796,2023-04-26,1003,Foundation,300,600,300,2,00383,India
472796,2023-04-26,1007,Eyeshadow,200,400,200,2,00383,India
549924,2023-04-26,1008,Makeup Remover,80,160,80,2,00481,India
549924,2023-04-26,1004,Eyeliner,100,200,100,2,00481,India
549924,2023-04-26,1002,Mascara,200,400,200,2,00481,India
284776,2023-04-26,1008,Makeup Remover,80,160,80,2,00259,India
284776,2023-04-26,1001,Lipstick,150,300,150,2,00259,India
284776,2023-04-26,1012,Body Lotion,200,400,200,1,00259,India
284776,2023-04-26,1003,Foundation,300,600,300,2,00259,India
746207,2023-04-26,1005,Nail Polish,50,100,50,2,00044,India
746207,2023-04-26,1003,Foundation,300,600,300,2,00044,India
218911,2023-04-26,1003,Foundation,300,600,300,2,00407,India
218911,2023-04-26,1009,Moisturizer,250,500,250,1,00407,India
218911,2023-04-26,1012,Body Lotion,200,400,200,1,00407,India
733260,2023-04-26,1003,Foundation,300,600,300,2,00095,India
733260,2023-04-26,1006,Blush,150,300,150,2,00095,India
733260,2023-04-26,1009,Moisturizer,250,500,250,1,00095,India
262317,2023-04-26,1003,Foundation,300,600,300,2,00080,India
262317,2023-04-26,1006,Blush,150,300,150,2,00080,India
867617,2023-04-26,1003,Foundation,300,600,300,2,00092,India
338061,2023-04-26,1007,Eyeshadow,200,400,200,2,00471,India
338061,2023-04-26,1009,Moisturizer,250,500,250,1,00471,India
338061,2023-04-26,1004,Eyeliner,100,200,100,2,00471,India
338061,2023-04-26,1001,Lipstick,150,300,150,2,00471,India
776291,2023-04-26,1006,Blush,150,300,150,2,00382,India
776291,2023-04-26,1003,Foundation,300,600,300,2,00382,India
776291,2023-04-26,1001,Lipstick,150,300,150,2,00382,India
776291,2023-04-26,1009,Moisturizer,250,500,250,1,00382,India
629768,2023-04-26,1006,Blush,150,300,150,2,00282,India
629768,2023-04-26,1009,Moisturizer,250,500,250,1,00282,India
629768,2023-04-26,1007,Eyeshadow,200,400,200,2,00282,India
629768,2023-04-26,1004,Eyeliner,100,200,100,2,00282,India
313969,2023-04-27,1002,Mascara,200,400,200,2,00157,India
313969,2023-04-27,1005,Nail Polish,50,100,50,2,00157,India
313969,2023-04-27,1009,Moisturizer,250,500,250,1,00157,India
617035,2023-04-27,1005,Nail Polish,50,100,50,2,00380,India
142700,2023-04-27,1009,Moisturizer,250,500,250,1,00385,India
142700,2023-04-27,1005,Nail Polish,50,100,50,2,00385,India
142700,2023-04-27,1007,Eyeshadow,200,400,200,2,00385,India
142700,2023-04-27,1004,Eyeliner,100,200,100,2,00385,India
923391,2023-04-27,1007,Eyeshadow,200,400,200,2,00109,India
908832,2023-04-27,1002,Mascara,200,400,200,2,00137,India
908832,2023-04-27,1003,Foundation,300,600,300,2,00137,India
908832,2023-04-27,1008,Makeup Remover,80,160,80,2,00137,India
908832,2023-04-27,1004,Eyeliner,100,200,100,2,00137,India
315705,2023-04-27,1012,Body Lotion,200,400,200,1,00135,India
315705,2023-04-27,1006,Blush,150,300,150,2,00135,India
315705,2023-04-27,1001,Lipstick,150,300,150,2,00135,India
315705,2023-04-27,1009,Moisturizer,250,500,250,1,00135,India
315705,2023-04-27,1007,Eyeshadow,200,400,200,2,00135,India
402258,2023-04-27,1009,Moisturizer,250,500,250,1,00219,India
402258,2023-04-27,1007,Eyeshadow,200,400,200,2,00219,India
402258,2023-04-27,1008,Makeup Remover,80,160,80,2,00219,India
604242,2023-04-27,1006,Blush,150,300,150,2,00274,India
604242,2023-04-27,1012,Body Lotion,200,400,200,1,00274,India
604242,2023-04-27,1002,Mascara,200,400,200,2,00274,India
292125,2023-04-27,1005,Nail Polish,50,100,50,2,00347,India
292125,2023-04-27,1001,Lipstick,150,300,150,2,00347,India
292125,2023-04-27,1008,Makeup Remover,80,160,80,2,00347,India
713671,2023-04-27,1006,Blush,150,300,150,2,00327,India
190050,2023-04-27,1007,Eyeshadow,200,400,200,2,00194,India
190050,2023-04-27,1005,Nail Polish,50,100,50,2,00194,India
396762,2023-04-27,1003,Foundation,300,600,300,2,00098,India
396762,2023-04-27,1007,Eyeshadow,200,400,200,2,00098,India
396762,2023-04-27,1004,Eyeliner,100,200,100,2,00098,India
534094,2023-04-27,1003,Foundation,300,600,300,2,00294,India
534094,2023-04-27,1005,Nail Polish,50,100,50,2,00294,India
534094,2023-04-27,1012,Body Lotion,200,400,200,1,00294,India
709331,2023-04-27,1001,Lipstick,150,300,150,2,00424,India
709331,2023-04-27,1009,Moisturizer,250,500,250,1,00424,India
841742,2023-04-27,1001,Lipstick,150,300,150,2,00269,India
402152,2023-04-27,1001,Lipstick,150,300,150,2,00231,India
402152,2023-04-27,1009,Moisturizer,250,500,250,1,00231,India
625309,2023-04-27,1005,Nail Polish,50,100,50,2,00138,India
625309,2023-04-27,1004,Eyeliner,100,200,100,2,00138,India
625309,2023-04-27,1006,Blush,150,300,150,2,00138,India
709496,2023-04-27,1003,Foundation,300,600,300,2,00369,India
709496,2023-04-27,1004,Eyeliner,100,200,100,2,00369,India
709496,2023-04-27,1012,Body Lotion,200,400,200,1,00369,India
709496,2023-04-27,1006,Blush,150,300,150,2,00369,India
660777,2023-04-27,1001,Lipstick,150,300,150,2,00326,India
660777,2023-04-27,1003,Foundation,300,600,300,2,00326,India
660777,2023-04-27,1007,Eyeshadow,200,400,200,2,00326,India
926894,2023-04-27,1002,Mascara,200,400,200,2,00214,India
926894,2023-04-27,1003,Foundation,300,600,300,2,00214,India
926894,2023-04-27,1004,Eyeliner,100,200,100,2,00214,India
846863,2023-04-27,1008,Makeup Remover,80,160,80,2,00160,India
846863,2023-04-27,1001,Lipstick,150,300,150,2,00160,India
538291,2023-04-27,1005,Nail Polish,50,100,50,2,00283,India
538291,2023-04-27,1004,Eyeliner,100,200,100,2,00283,India
732643,2023-04-27,1007,Eyeshadow,200,400,200,2,00007,India
732643,2023-04-27,1009,Moisturizer,250,500,250,1,00007,India
732643,2023-04-27,1005,Nail Polish,50,100,50,2,00007,India
166952,2023-04-27,1006,Blush,150,300,150,2,00054,India
166952,2023-04-27,1003,Foundation,300,600,300,2,00054,India
783349,2023-04-27,1008,Makeup Remover,80,160,80,2,00319,India
783349,2023-04-27,1005,Nail Polish,50,100,50,2,00319,India
783349,2023-04-27,1003,Foundation,300,600,300,2,00319,India
783349,2023-04-27,1001,Lipstick,150,300,150,2,00319,India
783349,2023-04-27,1012,Body Lotion,200,400,200,1,00319,India
183744,2023-04-27,1001,Lipstick,150,300,150,2,00086,India
183744,2023-04-27,1012,Body Lotion,200,400,200,1,00086,India
183744,2023-04-27,1006,Blush,150,300,150,2,00086,India
183744,2023-04-27,1009,Moisturizer,250,500,250,1,00086,India
183744,2023-04-27,1008,Makeup Remover,80,160,80,2,00086,India
959340,2023-04-27,1012,Body Lotion,200,400,200,1,00491,India
959340,2023-04-27,1007,Eyeshadow,200,400,200,2,00491,India
706260,2023-04-27,1008,Makeup Remover,80,160,80,2,00438,India
706260,2023-04-27,1006,Blush,150,300,150,2,00438,India
756880,2023-04-27,1005,Nail Polish,50,100,50,2,00175,India
756880,2023-04-27,1003,Foundation,300,600,300,2,00175,India
763829,2023-04-27,1002,Mascara,200,400,200,2,00057,India
763829,2023-04-27,1007,Eyeshadow,200,400,200,2,00057,India
763829,2023-04-27,1012,Body Lotion,200,400,200,1,00057,India
581681,2023-04-27,1006,Blush,150,300,150,2,00290,India
581681,2023-04-27,1008,Makeup Remover,80,160,80,2,00290,India
862254,2023-04-27,1005,Nail Polish,50,100,50,2,00450,India
450235,2023-04-27,1002,Mascara,200,400,200,2,00215,India
602805,2023-04-27,1003,Foundation,300,600,300,2,00029,India
686853,2023-04-27,1005,Nail Polish,50,100,50,2,00203,India
686853,2023-04-27,1002,Mascara,200,400,200,2,00203,India
965590,2023-04-27,1009,Moisturizer,250,500,250,1,00013,India
965590,2023-04-27,1012,Body Lotion,200,400,200,1,00013,India
965590,2023-04-27,1008,Makeup Remover,80,160,80,2,00013,India
342162,2023-04-27,1001,Lipstick,150,300,150,2,00114,India
342162,2023-04-27,1009,Moisturizer,250,500,250,1,00114,India
698219,2023-04-27,1004,Eyeliner,100,200,100,2,00161,India
698219,2023-04-27,1007,Eyeshadow,200,400,200,2,00161,India
698219,2023-04-27,1009,Moisturizer,250,500,250,1,00161,India
698219,2023-04-27,1006,Blush,150,300,150,2,00161,India
556948,2023-04-27,1008,Makeup Remover,80,160,80,2,00139,India
556948,2023-04-27,1009,Moisturizer,250,500,250,1,00139,India
943479,2023-04-28,1005,Nail Polish,50,100,50,2,00203,India
371496,2023-04-28,1007,Eyeshadow,200,400,200,2,00077,India
148195,2023-04-28,1005,Nail Polish,50,100,50,2,00222,India
148195,2023-04-28,1001,Lipstick,150,300,150,2,00222,India
925689,2023-04-28,1008,Makeup Remover,80,160,80,2,00131,India
925689,2023-04-28,1006,Blush,150,300,150,2,00131,India
925689,2023-04-28,1004,Eyeliner,100,200,100,2,00131,India
925689,2023-04-28,1001,Lipstick,150,300,150,2,00131,India
593282,2023-04-28,1007,Eyeshadow,200,400,200,2,00103,India
593282,2023-04-28,1012,Body Lotion,200,400,200,1,00103,India
754939,2023-04-28,1001,Lipstick,150,300,150,2,00479,India
754939,2023-04-28,1002,Mascara,200,400,200,2,00479,India
754939,2023-04-28,1007,Eyeshadow,200,400,200,2,00479,India
549214,2023-04-28,1009,Moisturizer,250,500,250,1,00089,India
549214,2023-04-28,1006,Blush,150,300,150,2,00089,India
549214,2023-04-28,1005,Nail Polish,50,100,50,2,00089,India
698491,2023-04-28,1008,Makeup Remover,80,160,80,2,00461,India
698491,2023-04-28,1004,Eyeliner,100,200,100,2,00461,India
698491,2023-04-28,1003,Foundation,300,600,300,2,00461,India
698491,2023-04-28,1007,Eyeshadow,200,400,200,2,00461,India
237757,2023-04-28,1002,Mascara,200,400,200,2,00102,India
237757,2023-04-28,1009,Moisturizer,250,500,250,1,00102,India
223242,2023-04-28,1001,Lipstick,150,300,150,2,00130,India
223242,2023-04-28,1006,Blush,150,300,150,2,00130,India
223242,2023-04-28,1003,Foundation,300,600,300,2,00130,India
680092,2023-04-28,1004,Eyeliner,100,200,100,2,00137,India
680092,2023-04-28,1002,Mascara,200,400,200,2,00137,India
285186,2023-04-28,1006,Blush,150,300,150,2,00170,India
285186,2023-04-28,1003,Foundation,300,600,300,2,00170,India
285186,2023-04-28,1004,Eyeliner,100,200,100,2,00170,India
285186,2023-04-28,1005,Nail Polish,50,100,50,2,00170,India
170032,2023-04-28,1007,Eyeshadow,200,400,200,2,00492,India
204599,2023-04-28,1008,Makeup Remover,80,160,80,2,00400,India
204599,2023-04-28,1007,Eyeshadow,200,400,200,2,00400,India
204599,2023-04-28,1006,Blush,150,300,150,2,00400,India
326076,2023-04-28,1004,Eyeliner,100,200,100,2,00049,India
326076,2023-04-28,1002,Mascara,200,400,200,2,00049,India
793972,2023-04-28,1009,Moisturizer,250,500,250,1,00430,India
793972,2023-04-28,1008,Makeup Remover,80,160,80,2,00430,India
793972,2023-04-28,1005,Nail Polish,50,100,50,2,00430,India
793972,2023-04-28,1007,Eyeshadow,200,400,200,2,00430,India
793972,2023-04-28,1001,Lipstick,150,300,150,2,00430,India
976137,2023-04-28,1008,Makeup Remover,80,160,80,2,00209,India
976137,2023-04-28,1009,Moisturizer,250,500,250,1,00209,India
976137,2023-04-28,1001,Lipstick,150,300,150,2,00209,India
792794,2023-04-28,1009,Moisturizer,250,500,250,1,00296,India
792794,2023-04-28,1002,Mascara,200,400,200,2,00296,India
637116,2023-04-28,1009,Moisturizer,250,500,250,1,00229,India
637116,2023-04-28,1006,Blush,150,300,150,2,00229,India
637116,2023-04-28,1012,Body Lotion,200,400,200,1,00229,India
781564,2023-04-28,1008,Makeup Remover,80,160,80,2,00316,India
781564,2023-04-28,1007,Eyeshadow,200,400,200,2,00316,India
781564,2023-04-28,1005,Nail Polish,50,100,50,2,00316,India
781564,2023-04-28,1012,Body Lotion,200,400,200,1,00316,India
199655,2023-04-28,1012,Body Lotion,200,400,200,1,00276,India
736390,2023-04-28,1009,Moisturizer,250,500,250,1,00103,India
736390,2023-04-28,1012,Body Lotion,200,400,200,1,00103,India
720671,2023-04-28,1001,Lipstick,150,300,150,2,00255,India
720671,2023-04-28,1005,Nail Polish,50,100,50,2,00255,India
720671,2023-04-28,1009,Moisturizer,250,500,250,1,00255,India
955436,2023-04-28,1012,Body Lotion,200,400,200,1,00005,India
955436,2023-04-28,1006,Blush,150,300,150,2,00005,India
955436,2023-04-28,1002,Mascara,200,400,200,2,00005,India
126628,2023-04-28,1007,Eyeshadow,200,400,200,2,00111,India
126628,2023-04-28,1006,Blush,150,300,150,2,00111,India
847778,2023-04-28,1006,Blush,150,300,150,2,00344,India
597551,2023-04-28,1006,Blush,150,300,150,2,00272,India
597551,2023-04-28,1002,Mascara,200,400,200,2,00272,India
597551,2023-04-28,1003,Foundation,300,600,300,2,00272,India
597551,2023-04-28,1005,Nail Polish,50,100,50,2,00272,India
503282,2023-04-28,1002,Mascara,200,400,200,2,00021,India
134241,2023-04-28,1008,Makeup Remover,80,160,80,2,00168,India
134241,2023-04-28,1001,Lipstick,150,300,150,2,00168,India
444219,2023-04-28,1002,Mascara,200,400,200,2,00001,India
444219,2023-04-28,1004,Eyeliner,100,200,100,2,00001,India
836735,2023-04-28,1003,Foundation,300,600,300,2,00129,India
836735,2023-04-28,1004,Eyeliner,100,200,100,2,00129,India
836735,2023-04-28,1012,Body Lotion,200,400,200,1,00129,India
836735,2023-04-28,1007,Eyeshadow,200,400,200,2,00129,India
836735,2023-04-28,1009,Moisturizer,250,500,250,1,00129,India
652766,2023-04-29,1012,Body Lotion,200,400,200,1,00333,India
652766,2023-04-29,1009,Moisturizer,250,500,250,1,00333,India
652766,2023-04-29,1002,Mascara,200,400,200,2,00333,India
493830,2023-04-29,1004,Eyeliner,100,200,100,2,00383,India
493830,2023-04-29,1002,Mascara,200,400,200,2,00383,India
493830,2023-04-29,1001,Lipstick,150,300,150,2,00383,India
451949,2023-04-29,1009,Moisturizer,250,500,250,1,00080,India
451949,2023-04-29,1007,Eyeshadow,200,400,200,2,00080,India
451949,2023-04-29,1006,Blush,150,300,150,2,00080,India
890167,2023-04-29,1002,Mascara,200,400,200,2,00435,India
890167,2023-04-29,1008,Makeup Remover,80,160,80,2,00435,India
922156,2023-04-29,1005,Nail Polish,50,100,50,2,00302,India
922156,2023-04-29,1004,Eyeliner,100,200,100,2,00302,India
922156,2023-04-29,1009,Moisturizer,250,500,250,1,00302,India
772545,2023-04-29,1005,Nail Polish,50,100,50,2,00057,India
772545,2023-04-29,1004,Eyeliner,100,200,100,2,00057,India
772545,2023-04-29,1001,Lipstick,150,300,150,2,00057,India
459528,2023-04-29,1008,Makeup Remover,80,160,80,2,00299,India
459528,2023-04-29,1006,Blush,150,300,150,2,00299,India
519359,2023-04-29,1006,Blush,150,300,150,2,00145,India
519359,2023-04-29,1004,Eyeliner,100,200,100,2,00145,India
519359,2023-04-29,1008,Makeup Remover,80,160,80,2,00145,India
681631,2023-04-29,1003,Foundation,300,600,300,2,00131,India
797166,2023-04-29,1005,Nail Polish,50,100,50,2,00149,India
401472,2023-04-29,1008,Makeup Remover,80,160,80,2,00172,India
401472,2023-04-29,1001,Lipstick,150,300,150,2,00172,India
401472,2023-04-29,1002,Mascara,200,400,200,2,00172,India
694923,2023-04-29,1004,Eyeliner,100,200,100,2,00339,India
529780,2023-04-29,1004,Eyeliner,100,200,100,2,00170,India
427925,2023-04-29,1002,Mascara,200,400,200,2,00351,India
427925,2023-04-29,1003,Foundation,300,600,300,2,00351,India
427925,2023-04-29,1007,Eyeshadow,200,400,200,2,00351,India
427925,2023-04-29,1009,Moisturizer,250,500,250,1,00351,India
427925,2023-04-29,1006,Blush,150,300,150,2,00351,India
137607,2023-04-29,1005,Nail Polish,50,100,50,2,00097,India
462329,2023-04-29,1007,Eyeshadow,200,400,200,2,00216,India
462329,2023-04-29,1008,Makeup Remover,80,160,80,2,00216,India
804779,2023-04-29,1008,Makeup Remover,80,160,80,2,00028,India
804779,2023-04-29,1007,Eyeshadow,200,400,200,2,00028,India
804779,2023-04-29,1001,Lipstick,150,300,150,2,00028,India
993000,2023-04-29,1012,Body Lotion,200,400,200,1,00310,India
906330,2023-04-29,1001,Lipstick,150,300,150,2,00340,India
582620,2023-04-29,1007,Eyeshadow,200,400,200,2,00111,India
582620,2023-04-29,1009,Moisturizer,250,500,250,1,00111,India
582620,2023-04-29,1008,Makeup Remover,80,160,80,2,00111,India
582620,2023-04-29,1001,Lipstick,150,300,150,2,00111,India
425882,2023-04-29,1005,Nail Polish,50,100,50,2,00237,India
290763,2023-04-29,1001,Lipstick,150,300,150,2,00323,India
290763,2023-04-29,1003,Foundation,300,600,300,2,00323,India
290763,2023-04-29,1012,Body Lotion,200,400,200,1,00323,India
290763,2023-04-29,1004,Eyeliner,100,200,100,2,00323,India
290763,2023-04-29,1006,Blush,150,300,150,2,00323,India
763277,2023-04-29,1005,Nail Polish,50,100,50,2,00228,India
763277,2023-04-29,1001,Lipstick,150,300,150,2,00228,India
236764,2023-04-29,1007,Eyeshadow,200,400,200,2,00391,India
323602,2023-04-29,1007,Eyeshadow,200,400,200,2,00404,India
323602,2023-04-29,1006,Blush,150,300,150,2,00404,India
323602,2023-04-29,1009,Moisturizer,250,500,250,1,00404,India
323602,2023-04-29,1012,Body Lotion,200,400,200,1,00404,India
323602,2023-04-29,1002,Mascara,200,400,200,2,00404,India
765570,2023-04-29,1003,Foundation,300,600,300,2,00228,India
122910,2023-04-29,1008,Makeup Remover,80,160,80,2,00078,India
122910,2023-04-29,1001,Lipstick,150,300,150,2,00078,India
122910,2023-04-29,1004,Eyeliner,100,200,100,2,00078,India
122910,2023-04-29,1002,Mascara,200,400,200,2,00078,India
122910,2023-04-29,1012,Body Lotion,200,400,200,1,00078,India
298168,2023-04-29,1001,Lipstick,150,300,150,2,00283,India
298168,2023-04-29,1009,Moisturizer,250,500,250,1,00283,India
298168,2023-04-29,1008,Makeup Remover,80,160,80,2,00283,India
298168,2023-04-29,1003,Foundation,300,600,300,2,00283,India
660830,2023-04-29,1006,Blush,150,300,150,2,00024,India
660830,2023-04-29,1007,Eyeshadow,200,400,200,2,00024,India
660830,2023-04-29,1008,Makeup Remover,80,160,80,2,00024,India
660830,2023-04-29,1009,Moisturizer,250,500,250,1,00024,India
250850,2023-04-29,1003,Foundation,300,600,300,2,00189,India
250850,2023-04-29,1009,Moisturizer,250,500,250,1,00189,India
250850,2023-04-29,1001,Lipstick,150,300,150,2,00189,India
284474,2023-04-29,1005,Nail Polish,50,100,50,2,00440,India
939332,2023-04-29,1008,Makeup Remover,80,160,80,2,00068,India
939332,2023-04-29,1004,Eyeliner,100,200,100,2,00068,India
939332,2023-04-29,1006,Blush,150,300,150,2,00068,India
939332,2023-04-29,1002,Mascara,200,400,200,2,00068,India
505985,2023-04-29,1004,Eyeliner,100,200,100,2,00445,India
505985,2023-04-29,1006,Blush,150,300,150,2,00445,India
505985,2023-04-29,1001,Lipstick,150,300,150,2,00445,India
505985,2023-04-29,1002,Mascara,200,400,200,2,00445,India
591342,2023-04-29,1002,Mascara,200,400,200,2,00372,India
591342,2023-04-29,1003,Foundation,300,600,300,2,00372,India
378483,2023-04-29,1006,Blush,150,300,150,2,00117,India
378483,2023-04-29,1002,Mascara,200,400,200,2,00117,India
378483,2023-04-29,1001,Lipstick,150,300,150,2,00117,India
109697,2023-04-29,1007,Eyeshadow,200,400,200,2,00222,India
109697,2023-04-29,1008,Makeup Remover,80,160,80,2,00222,India
109697,2023-04-29,1012,Body Lotion,200,400,200,1,00222,India
109697,2023-04-29,1005,Nail Polish,50,100,50,2,00222,India
627535,2023-04-29,1007,Eyeshadow,200,400,200,2,00045,India
627535,2023-04-29,1009,Moisturizer,250,500,250,1,00045,India
627535,2023-04-29,1012,Body Lotion,200,400,200,1,00045,India
773159,2023-04-30,1004,Eyeliner,100,200,100,2,00468,India
773159,2023-04-30,1001,Lipstick,150,300,150,2,00468,India
773159,2023-04-30,1005,Nail Polish,50,100,50,2,00468,India
958421,2023-04-30,1007,Eyeshadow,200,400,200,2,00486,India
958421,2023-04-30,1003,Foundation,300,600,300,2,00486,India
861315,2023-04-30,1007,Eyeshadow,200,400,200,2,00011,India
761549,2023-04-30,1006,Blush,150,300,150,2,00099,India
761549,2023-04-30,1007,Eyeshadow,200,400,200,2,00099,India
761549,2023-04-30,1004,Eyeliner,100,200,100,2,00099,India
761549,2023-04-30,1002,Mascara,200,400,200,2,00099,India
761549,2023-04-30,1005,Nail Polish,50,100,50,2,00099,India
995080,2023-04-30,1009,Moisturizer,250,500,250,1,00401,India
995080,2023-04-30,1005,Nail Polish,50,100,50,2,00401,India
995080,2023-04-30,1004,Eyeliner,100,200,100,2,00401,India
334378,2023-04-30,1012,Body Lotion,200,400,200,1,00054,India
334378,2023-04-30,1009,Moisturizer,250,500,250,1,00054,India
334378,2023-04-30,1003,Foundation,300,600,300,2,00054,India
284462,2023-04-30,1008,Makeup Remover,80,160,80,2,00241,India
284462,2023-04-30,1003,Foundation,300,600,300,2,00241,India
856173,2023-04-30,1003,Foundation,300,600,300,2,00024,India
740421,2023-04-30,1005,Nail Polish,50,100,50,2,00336,India
740421,2023-04-30,1002,Mascara,200,400,200,2,00336,India
250731,2023-04-30,1005,Nail Polish,50,100,50,2,00309,India
250731,2023-04-30,1007,Eyeshadow,200,400,200,2,00309,India
250731,2023-04-30,1002,Mascara,200,400,200,2,00309,India
250731,2023-04-30,1008,Makeup Remover,80,160,80,2,00309,India
403744,2023-04-30,1003,Foundation,300,600,300,2,00107,India
403744,2023-04-30,1004,Eyeliner,100,200,100,2,00107,India
403744,2023-04-30,1001,Lipstick,150,300,150,2,00107,India
403744,2023-04-30,1002,Mascara,200,400,200,2,00107,India
397873,2023-04-30,1002,Mascara,200,400,200,2,00211,India
397873,2023-04-30,1006,Blush,150,300,150,2,00211,India
397873,2023-04-30,1009,Moisturizer,250,500,250,1,00211,India
409692,2023-04-30,1012,Body Lotion,200,400,200,1,00193,India
409692,2023-04-30,1001,Lipstick,150,300,150,2,00193,India
105288,2023-04-30,1002,Mascara,200,400,200,2,00099,India
105288,2023-04-30,1008,Makeup Remover,80,160,80,2,00099,India
105288,2023-04-30,1005,Nail Polish,50,100,50,2,00099,India
105288,2023-04-30,1012,Body Lotion,200,400,200,1,00099,India
651748,2023-04-30,1012,Body Lotion,200,400,200,1,00401,India
651748,2023-04-30,1004,Eyeliner,100,200,100,2,00401,India
651748,2023-04-30,1003,Foundation,300,600,300,2,00401,India
651748,2023-04-30,1005,Nail Polish,50,100,50,2,00401,India
665657,2023-04-30,1007,Eyeshadow,200,400,200,2,00129,India
665657,2023-04-30,1003,Foundation,300,600,300,2,00129,India
665657,2023-04-30,1001,Lipstick,150,300,150,2,00129,India
988042,2023-04-30,1004,Eyeliner,100,200,100,2,00331,India
988042,2023-04-30,1008,Makeup Remover,80,160,80,2,00331,India
120663,2023-04-30,1007,Eyeshadow,200,400,200,2,00354,India
120663,2023-04-30,1009,Moisturizer,250,500,250,1,00354,India
120663,2023-04-30,1001,Lipstick,150,300,150,2,00354,India
120663,2023-04-30,1004,Eyeliner,100,200,100,2,00354,India
661405,2023-04-30,1012,Body Lotion,200,400,200,1,00053,India
661405,2023-04-30,1006,Blush,150,300,150,2,00053,India
661405,2023-04-30,1002,Mascara,200,400,200,2,00053,India
700860,2023-04-30,1008,Makeup Remover,80,160,80,2,00197,India
700860,2023-04-30,1004,Eyeliner,100,200,100,2,00197,India
700860,2023-04-30,1005,Nail Polish,50,100,50,2,00197,India
700860,2023-04-30,1003,Foundation,300,600,300,2,00197,India
700860,2023-04-30,1007,Eyeshadow,200,400,200,2,00197,India
919653,2023-04-30,1006,Blush,150,300,150,2,00349,India
919653,2023-04-30,1004,Eyeliner,100,200,100,2,00349,India
887472,2023-04-30,1002,Mascara,200,400,200,2,00211,India
887472,2023-04-30,1004,Eyeliner,100,200,100,2,00211,India
887472,2023-04-30,1008,Makeup Remover,80,160,80,2,00211,India
887472,2023-04-30,1005,Nail Polish,50,100,50,2,00211,India
525522,2023-04-30,1008,Makeup Remover,80,160,80,2,00218,India
525522,2023-04-30,1006,Blush,150,300,150,2,00218,India
525522,2023-04-30,1002,Mascara,200,400,200,2,00218,India
872576,2023-04-30,1009,Moisturizer,250,500,250,1,00101,India
872576,2023-04-30,1004,Eyeliner,100,200,100,2,00101,India
276755,2023-04-30,1003,Foundation,300,600,300,2,00333,India
276755,2023-04-30,1001,Lipstick,150,300,150,2,00333,India
276755,2023-04-30,1009,Moisturizer,250,500,250,1,00333,India
276755,2023-04-30,1007,Eyeshadow,200,400,200,2,00333,India
562350,2023-04-30,1005,Nail Polish,50,100,50,2,00048,India
562350,2023-04-30,1004,Eyeliner,100,200,100,2,00048,India
562350,2023-04-30,1007,Eyeshadow,200,400,200,2,00048,India
560726,2023-04-30,1002,Mascara,200,400,200,2,00487,India
923159,2023-04-30,1012,Body Lotion,200,400,200,1,00082,India
923159,2023-04-30,1008,Makeup Remover,80,160,80,2,00082,India
923159,2023-04-30,1002,Mascara,200,400,200,2,00082,India
699392,2023-04-30,1012,Body Lotion,200,400,200,1,00467,India
699392,2023-04-30,1003,Foundation,300,600,300,2,00467,India
764616,2023-04-30,1005,Nail Polish,50,100,50,2,00328,India
764616,2023-04-30,1006,Blush,150,300,150,2,00328,India
764616,2023-04-30,1002,Mascara,200,400,200,2,00328,India
140424,2023-04-30,1003,Foundation,300,600,300,2,00021,India
140424,2023-04-30,1002,Mascara,200,400,200,2,00021,India
140424,2023-04-30,1008,Makeup Remover,80,160,80,2,00021,India
728855,2023-04-30,1012,Body Lotion,200,400,200,1,00483,India
728855,2023-04-30,1007,Eyeshadow,200,400,200,2,00483,India
728855,2023-04-30,1008,Makeup Remover,80,160,80,2,00483,India
564419,2023-04-30,1008,Makeup Remover,80,160,80,2,00294,India
564419,2023-04-30,1003,Foundation,300,600,300,2,00294,India
564419,2023-04-30,1009,Moisturizer,250,500,250,1,00294,India
564419,2023-04-30,1001,Lipstick,150,300,150,2,00294,India
569479,2023-04-30,1007,Eyeshadow,200,400,200,2,00491,India
122512,2023-04-30,1009,Moisturizer,250,500,250,1,00424,India
122512,2023-04-30,1002,Mascara,200,400,200,2,00424,India
330188,2023-04-30,1007,Eyeshadow,200,400,200,2,00007,India
330188,2023-04-30,1004,Eyeliner,100,200,100,2,00007,India
330188,2023-04-30,1008,Makeup Remover,80,160,80,2,00007,India
330188,2023-04-30,1001,Lipstick,150,300,150,2,00007,India
255899,2023-04-30,1007,Eyeshadow,200,400,200,2,00306,India
255899,2023-04-30,1004,Eyeliner,100,200,100,2,00306,India
255899,2023-04-30,1012,Body Lotion,200,400,200,1,00306,India
848913,2023-04-30,1003,Foundation,300,600,300,2,00490,India
764961,2023-04-30,1001,Lipstick,150,300,150,2,00249,India
764961,2023-04-30,1006,Blush,150,300,150,2,00249,India
995204,2023-04-30,1007,Eyeshadow,200,400,200,2,00446,India
879993,2023-04-30,1001,Lipstick,150,300,150,2,00405,India
249002,2023-04-30,1007,Eyeshadow,200,400,200,2,00359,India
249002,2023-04-30,1002,Mascara,200,400,200,2,00359,India
249002,2023-04-30,1006,Blush,150,300,150,2,00359,India
249002,2023-04-30,1004,Eyeliner,100,200,100,2,00359,India
249002,2023-04-30,1009,Moisturizer,250,500,250,1,00359,India
589830,2023-04-30,1008,Makeup Remover,80,160,80,2,00029,India
589830,2023-04-30,1004,Eyeliner,100,200,100,2,00029,India
589830,2023-04-30,1006,Blush,150,300,150,2,00029,India
589830,2023-04-30,1001,Lipstick,150,300,150,2,00029,India
679845,2023-04-30,1006,Blush,150,300,150,2,00252,India
109172,2023-04-30,1008,Makeup Remover,80,160,80,2,00218,India
798118,2023-04-30,1005,Nail Polish,50,100,50,2,00189,India
798118,2023-04-30,1004,Eyeliner,100,200,100,2,00189,India
562468,2023-04-30,1006,Blush,150,300,150,2,00039,India
562468,2023-04-30,1007,Eyeshadow,200,400,200,2,00039,India
562468,2023-04-30,1012,Body Lotion,200,400,200,1,00039,India
442367,2023-04-30,1003,Foundation,300,600,300,2,00143,India
442367,2023-04-30,1007,Eyeshadow,200,400,200,2,00143,India
442367,2023-04-30,1008,Makeup Remover,80,160,80,2,00143,India
442367,2023-04-30,1001,Lipstick,150,300,150,2,00143,India
164443,2023-05-01,1008,Makeup Remover,80,160,80,2,00152,India
266692,2023-05-01,1003,Foundation,300,600,300,2,00075,India
266692,2023-05-01,1002,Mascara,200,400,200,2,00075,India
266692,2023-05-01,1008,Makeup Remover,80,160,80,2,00075,India
837305,2023-05-01,1007,Eyeshadow,200,400,200,2,00393,India
837305,2023-05-01,1008,Makeup Remover,80,160,80,2,00393,India
837305,2023-05-01,1004,Eyeliner,100,200,100,2,00393,India
837305,2023-05-01,1002,Mascara,200,400,200,2,00393,India
721931,2023-05-01,1007,Eyeshadow,200,400,200,2,00434,India
721931,2023-05-01,1012,Body Lotion,200,400,200,1,00434,India
721931,2023-05-01,1003,Foundation,300,600,300,2,00434,India
613710,2023-05-01,1001,Lipstick,150,300,150,2,00285,India
613710,2023-05-01,1002,Mascara,200,400,200,2,00285,India
613710,2023-05-01,1003,Foundation,300,600,300,2,00285,India
133260,2023-05-01,1008,Makeup Remover,80,160,80,2,00263,India
133260,2023-05-01,1002,Mascara,200,400,200,2,00263,India
133260,2023-05-01,1005,Nail Polish,50,100,50,2,00263,India
133260,2023-05-01,1006,Blush,150,300,150,2,00263,India
917575,2023-05-01,1007,Eyeshadow,200,400,200,2,00158,India
917575,2023-05-01,1002,Mascara,200,400,200,2,00158,India
917575,2023-05-01,1009,Moisturizer,250,500,250,1,00158,India
551726,2023-05-01,1006,Blush,150,300,150,2,00406,India
581191,2023-05-01,1003,Foundation,300,600,300,2,00212,India
581191,2023-05-01,1012,Body Lotion,200,400,200,1,00212,India
581191,2023-05-01,1002,Mascara,200,400,200,2,00212,India
230095,2023-05-01,1008,Makeup Remover,80,160,80,2,00305,India
230095,2023-05-01,1009,Moisturizer,250,500,250,1,00305,India
230095,2023-05-01,1001,Lipstick,150,300,150,2,00305,India
342855,2023-05-01,1003,Foundation,300,600,300,2,00200,India
342855,2023-05-01,1006,Blush,150,300,150,2,00200,India
342855,2023-05-01,1004,Eyeliner,100,200,100,2,00200,India
342855,2023-05-01,1009,Moisturizer,250,500,250,1,00200,India
182948,2023-05-01,1003,Foundation,300,600,300,2,00490,India
861027,2023-05-01,1004,Eyeliner,100,200,100,2,00430,India
861027,2023-05-01,1001,Lipstick,150,300,150,2,00430,India
861027,2023-05-01,1007,Eyeshadow,200,400,200,2,00430,India
346842,2023-05-01,1009,Moisturizer,250,500,250,1,00361,India
748352,2023-05-01,1006,Blush,150,300,150,2,00226,India
748352,2023-05-01,1002,Mascara,200,400,200,2,00226,India
748352,2023-05-01,1009,Moisturizer,250,500,250,1,00226,India
748352,2023-05-01,1001,Lipstick,150,300,150,2,00226,India
493996,2023-05-01,1008,Makeup Remover,80,160,80,2,00143,India
493996,2023-05-01,1007,Eyeshadow,200,400,200,2,00143,India
493996,2023-05-01,1009,Moisturizer,250,500,250,1,00143,India
493996,2023-05-01,1004,Eyeliner,100,200,100,2,00143,India
904964,2023-05-01,1003,Foundation,300,600,300,2,00420,India
283041,2023-05-01,1001,Lipstick,150,300,150,2,00240,India
283041,2023-05-01,1007,Eyeshadow,200,400,200,2,00240,India
283041,2023-05-01,1009,Moisturizer,250,500,250,1,00240,India
283041,2023-05-01,1003,Foundation,300,600,300,2,00240,India
149886,2023-05-01,1002,Mascara,200,400,200,2,00125,India
149886,2023-05-01,1004,Eyeliner,100,200,100,2,00125,India
149886,2023-05-01,1009,Moisturizer,250,500,250,1,00125,India
149886,2023-05-01,1005,Nail Polish,50,100,50,2,00125,India
945377,2023-05-01,1009,Moisturizer,250,500,250,1,00479,India
945377,2023-05-01,1004,Eyeliner,100,200,100,2,00479,India
945377,2023-05-01,1005,Nail Polish,50,100,50,2,00479,India
644182,2023-05-01,1004,Eyeliner,100,200,100,2,00199,India
644182,2023-05-01,1005,Nail Polish,50,100,50,2,00199,India
644182,2023-05-01,1003,Foundation,300,600,300,2,00199,India
644182,2023-05-01,1002,Mascara,200,400,200,2,00199,India
171809,2023-05-01,1006,Blush,150,300,150,2,00476,India
171809,2023-05-01,1008,Makeup Remover,80,160,80,2,00476,India
764861,2023-05-01,1002,Mascara,200,400,200,2,00488,India
764861,2023-05-01,1003,Foundation,300,600,300,2,00488,India
632829,2023-05-01,1003,Foundation,300,600,300,2,00162,India
632829,2023-05-01,1005,Nail Polish,50,100,50,2,00162,India
632829,2023-05-01,1002,Mascara,200,400,200,2,00162,India
632829,2023-05-01,1009,Moisturizer,250,500,250,1,00162,India
117377,2023-05-01,1005,Nail Polish,50,100,50,2,00154,India
117377,2023-05-01,1004,Eyeliner,100,200,100,2,00154,India
117377,2023-05-01,1009,Moisturizer,250,500,250,1,00154,India
117377,2023-05-01,1008,Makeup Remover,80,160,80,2,00154,India
959731,2023-05-01,1007,Eyeshadow,200,400,200,2,00437,India
959731,2023-05-01,1003,Foundation,300,600,300,2,00437,India
959731,2023-05-01,1009,Moisturizer,250,500,250,1,00437,India
959731,2023-05-01,1008,Makeup Remover,80,160,80,2,00437,India
959731,2023-05-01,1002,Mascara,200,400,200,2,00437,India
571641,2023-05-01,1005,Nail Polish,50,100,50,2,00270,India
571641,2023-05-01,1009,Moisturizer,250,500,250,1,00270,India
571641,2023-05-01,1006,Blush,150,300,150,2,00270,India
571641,2023-05-01,1012,Body Lotion,200,400,200,1,00270,India
984392,2023-05-01,1008,Makeup Remover,80,160,80,2,00130,India
984392,2023-05-01,1009,Moisturizer,250,500,250,1,00130,India
984392,2023-05-01,1006,Blush,150,300,150,2,00130,India
984392,2023-05-01,1002,Mascara,200,400,200,2,00130,India
897974,2023-05-01,1002,Mascara,200,400,200,2,00243,India
810395,2023-05-01,1008,Makeup Remover,80,160,80,2,00157,India
810395,2023-05-01,1005,Nail Polish,50,100,50,2,00157,India
383591,2023-05-01,1001,Lipstick,150,300,150,2,00238,India
383591,2023-05-01,1009,Moisturizer,250,500,250,1,00238,India
383591,2023-05-01,1012,Body Lotion,200,400,200,1,00238,India
383591,2023-05-01,1002,Mascara,200,400,200,2,00238,India
432965,2023-05-01,1003,Foundation,300,600,300,2,00062,India
432965,2023-05-01,1001,Lipstick,150,300,150,2,00062,India
196498,2023-05-01,1001,Lipstick,150,300,150,2,00063,India
196498,2023-05-01,1004,Eyeliner,100,200,100,2,00063,India
196498,2023-05-01,1005,Nail Polish,50,100,50,2,00063,India
196498,2023-05-01,1003,Foundation,300,600,300,2,00063,India
196498,2023-05-01,1012,Body Lotion,200,400,200,1,00063,India
119809,2023-05-01,1006,Blush,150,300,150,2,00140,India
119809,2023-05-01,1001,Lipstick,150,300,150,2,00140,India
514431,2023-05-01,1002,Mascara,200,400,200,2,00460,India
514431,2023-05-01,1004,Eyeliner,100,200,100,2,00460,India
928953,2023-05-01,1006,Blush,150,300,150,2,00093,India
928953,2023-05-01,1007,Eyeshadow,200,400,200,2,00093,India
928953,2023-05-01,1009,Moisturizer,250,500,250,1,00093,India
928953,2023-05-01,1008,Makeup Remover,80,160,80,2,00093,India
774990,2023-05-01,1002,Mascara,200,400,200,2,00423,India
774990,2023-05-01,1003,Foundation,300,600,300,2,00423,India
774990,2023-05-01,1006,Blush,150,300,150,2,00423,India
944478,2023-05-01,1006,Blush,150,300,150,2,00152,India
944478,2023-05-01,1005,Nail Polish,50,100,50,2,00152,India
310734,2023-05-01,1002,Mascara,200,400,200,2,00341,India
310734,2023-05-01,1008,Makeup Remover,80,160,80,2,00341,India
565858,2023-05-02,1012,Body Lotion,200,400,200,1,00206,India
565858,2023-05-02,1009,Moisturizer,250,500,250,1,00206,India
565858,2023-05-02,1002,Mascara,200,400,200,2,00206,India
797922,2023-05-02,1009,Moisturizer,250,500,250,1,00336,India
797922,2023-05-02,1012,Body Lotion,200,400,200,1,00336,India
797922,2023-05-02,1001,Lipstick,150,300,150,2,00336,India
797922,2023-05-02,1004,Eyeliner,100,200,100,2,00336,India
442528,2023-05-02,1008,Makeup Remover,80,160,80,2,00007,India
442528,2023-05-02,1005,Nail Polish,50,100,50,2,00007,India
713849,2023-05-02,1009,Moisturizer,250,500,250,1,00266,India
713849,2023-05-02,1008,Makeup Remover,80,160,80,2,00266,India
713849,2023-05-02,1005,Nail Polish,50,100,50,2,00266,India
971773,2023-05-02,1007,Eyeshadow,200,400,200,2,00486,India
591986,2023-05-02,1006,Blush,150,300,150,2,00107,India
591986,2023-05-02,1004,Eyeliner,100,200,100,2,00107,India
591986,2023-05-02,1003,Foundation,300,600,300,2,00107,India
266002,2023-05-02,1005,Nail Polish,50,100,50,2,00070,India
266002,2023-05-02,1006,Blush,150,300,150,2,00070,India
266002,2023-05-02,1012,Body Lotion,200,400,200,1,00070,India
584710,2023-05-02,1007,Eyeshadow,200,400,200,2,00270,India
584710,2023-05-02,1006,Blush,150,300,150,2,00270,India
584710,2023-05-02,1004,Eyeliner,100,200,100,2,00270,India
584710,2023-05-02,1001,Lipstick,150,300,150,2,00270,India
928576,2023-05-02,1007,Eyeshadow,200,400,200,2,00005,India
928576,2023-05-02,1012,Body Lotion,200,400,200,1,00005,India
185522,2023-05-02,1003,Foundation,300,600,300,2,00152,India
381345,2023-05-02,1003,Foundation,300,600,300,2,00479,India
138563,2023-05-02,1001,Lipstick,150,300,150,2,00211,India
138563,2023-05-02,1008,Makeup Remover,80,160,80,2,00211,India
138563,2023-05-02,1012,Body Lotion,200,400,200,1,00211,India
239303,2023-05-02,1005,Nail Polish,50,100,50,2,00395,India
239303,2023-05-02,1008,Makeup Remover,80,160,80,2,00395,India
295512,2023-05-02,1008,Makeup Remover,80,160,80,2,00314,India
295512,2023-05-02,1005,Nail Polish,50,100,50,2,00314,India
295512,2023-05-02,1006,Blush,150,300,150,2,00314,India
295512,2023-05-02,1002,Mascara,200,400,200,2,00314,India
123398,2023-05-02,1009,Moisturizer,250,500,250,1,00063,India
123398,2023-05-02,1005,Nail Polish,50,100,50,2,00063,India
123398,2023-05-02,1003,Foundation,300,600,300,2,00063,India
117000,2023-05-02,1008,Makeup Remover,80,160,80,2,00347,India
117000,2023-05-02,1006,Blush,150,300,150,2,00347,India
462130,2023-05-02,1007,Eyeshadow,200,400,200,2,00150,India
462130,2023-05-02,1004,Eyeliner,100,200,100,2,00150,India
462130,2023-05-02,1002,Mascara,200,400,200,2,00150,India
304711,2023-05-02,1001,Lipstick,150,300,150,2,00417,India
229900,2023-05-02,1008,Makeup Remover,80,160,80,2,00060,India
229900,2023-05-02,1003,Foundation,300,600,300,2,00060,India
229900,2023-05-02,1001,Lipstick,150,300,150,2,00060,India
229900,2023-05-02,1002,Mascara,200,400,200,2,00060,India
587378,2023-05-02,1009,Moisturizer,250,500,250,1,00192,India
587378,2023-05-02,1002,Mascara,200,400,200,2,00192,India
587378,2023-05-02,1003,Foundation,300,600,300,2,00192,India
587378,2023-05-02,1008,Makeup Remover,80,160,80,2,00192,India
716522,2023-05-02,1003,Foundation,300,600,300,2,00060,India
716522,2023-05-02,1009,Moisturizer,250,500,250,1,00060,India
716522,2023-05-02,1002,Mascara,200,400,200,2,00060,India
716522,2023-05-02,1008,Makeup Remover,80,160,80,2,00060,India
470713,2023-05-02,1006,Blush,150,300,150,2,00416,India
713482,2023-05-02,1004,Eyeliner,100,200,100,2,00033,India
713482,2023-05-02,1001,Lipstick,150,300,150,2,00033,India
713482,2023-05-02,1007,Eyeshadow,200,400,200,2,00033,India
713482,2023-05-02,1006,Blush,150,300,150,2,00033,India
894588,2023-05-02,1004,Eyeliner,100,200,100,2,00374,India
894588,2023-05-02,1007,Eyeshadow,200,400,200,2,00374,India
894588,2023-05-02,1012,Body Lotion,200,400,200,1,00374,India
894588,2023-05-02,1005,Nail Polish,50,100,50,2,00374,India
168683,2023-05-02,1012,Body Lotion,200,400,200,1,00465,India
168683,2023-05-02,1003,Foundation,300,600,300,2,00465,India
168683,2023-05-02,1004,Eyeliner,100,200,100,2,00465,India
168683,2023-05-02,1007,Eyeshadow,200,400,200,2,00465,India
384687,2023-05-02,1003,Foundation,300,600,300,2,00444,India
691806,2023-05-02,1004,Eyeliner,100,200,100,2,00268,India
691806,2023-05-02,1006,Blush,150,300,150,2,00268,India
198132,2023-05-02,1004,Eyeliner,100,200,100,2,00292,India
198132,2023-05-02,1009,Moisturizer,250,500,250,1,00292,India
198132,2023-05-02,1001,Lipstick,150,300,150,2,00292,India
198132,2023-05-02,1007,Eyeshadow,200,400,200,2,00292,India
634876,2023-05-02,1005,Nail Polish,50,100,50,2,00417,India
634876,2023-05-02,1012,Body Lotion,200,400,200,1,00417,India
634876,2023-05-02,1007,Eyeshadow,200,400,200,2,00417,India
768482,2023-05-02,1007,Eyeshadow,200,400,200,2,00209,India
768482,2023-05-02,1008,Makeup Remover,80,160,80,2,00209,India
768482,2023-05-02,1004,Eyeliner,100,200,100,2,00209,India
778836,2023-05-02,1002,Mascara,200,400,200,2,00442,India
778836,2023-05-02,1006,Blush,150,300,150,2,00442,India
778836,2023-05-02,1001,Lipstick,150,300,150,2,00442,India
778836,2023-05-02,1012,Body Lotion,200,400,200,1,00442,India
621695,2023-05-02,1003,Foundation,300,600,300,2,00002,India
218902,2023-05-02,1005,Nail Polish,50,100,50,2,00331,India
218902,2023-05-02,1001,Lipstick,150,300,150,2,00331,India
218902,2023-05-02,1009,Moisturizer,250,500,250,1,00331,India
218902,2023-05-02,1008,Makeup Remover,80,160,80,2,00331,India
361793,2023-05-02,1008,Makeup Remover,80,160,80,2,00299,India
361793,2023-05-02,1002,Mascara,200,400,200,2,00299,India
361793,2023-05-02,1004,Eyeliner,100,200,100,2,00299,India
361793,2023-05-02,1007,Eyeshadow,200,400,200,2,00299,India
670574,2023-05-02,1001,Lipstick,150,300,150,2,00030,India
670574,2023-05-02,1008,Makeup Remover,80,160,80,2,00030,India
670574,2023-05-02,1004,Eyeliner,100,200,100,2,00030,India
670574,2023-05-02,1005,Nail Polish,50,100,50,2,00030,India
569485,2023-05-02,1012,Body Lotion,200,400,200,1,00113,India
569485,2023-05-02,1006,Blush,150,300,150,2,00113,India
569485,2023-05-02,1001,Lipstick,150,300,150,2,00113,India
569485,2023-05-02,1004,Eyeliner,100,200,100,2,00113,India
569485,2023-05-02,1002,Mascara,200,400,200,2,00113,India
971219,2023-05-02,1012,Body Lotion,200,400,200,1,00401,India
791671,2023-05-02,1005,Nail Polish,50,100,50,2,00095,India
497801,2023-05-02,1004,Eyeliner,100,200,100,2,00360,India
497801,2023-05-02,1012,Body Lotion,200,400,200,1,00360,India
497801,2023-05-02,1008,Makeup Remover,80,160,80,2,00360,India
263082,2023-05-02,1002,Mascara,200,400,200,2,00166,India
263082,2023-05-02,1012,Body Lotion,200,400,200,1,00166,India
263082,2023-05-02,1001,Lipstick,150,300,150,2,00166,India
263082,2023-05-02,1004,Eyeliner,100,200,100,2,00166,India
496926,2023-05-02,1002,Mascara,200,400,200,2,00025,India
496926,2023-05-02,1001,Lipstick,150,300,150,2,00025,India
954324,2023-05-02,1005,Nail Polish,50,100,50,2,00442,India
954324,2023-05-02,1012,Body Lotion,200,400,200,1,00442,India
954324,2023-05-02,1002,Mascara,200,400,200,2,00442,India
954324,2023-05-02,1009,Moisturizer,250,500,250,1,00442,India
935445,2023-05-02,1012,Body Lotion,200,400,200,1,00041,India
243634,2023-05-02,1007,Eyeshadow,200,400,200,2,00496,India
243634,2023-05-02,1002,Mascara,200,400,200,2,00496,India
243634,2023-05-02,1006,Blush,150,300,150,2,00496,India
243634,2023-05-02,1005,Nail Polish,50,100,50,2,00496,India
243634,2023-05-02,1009,Moisturizer,250,500,250,1,00496,India
832841,2023-05-02,1009,Moisturizer,250,500,250,1,00393,India
832841,2023-05-02,1012,Body Lotion,200,400,200,1,00393,India
832841,2023-05-02,1008,Makeup Remover,80,160,80,2,00393,India
125236,2023-05-03,1008,Makeup Remover,80,160,80,2,00137,India
125236,2023-05-03,1005,Nail Polish,50,100,50,2,00137,India
125236,2023-05-03,1006,Blush,150,300,150,2,00137,India
125236,2023-05-03,1009,Moisturizer,250,500,250,1,00137,India
125236,2023-05-03,1002,Mascara,200,400,200,2,00137,India
902792,2023-05-03,1001,Lipstick,150,300,150,2,00382,India
123729,2023-05-03,1012,Body Lotion,200,400,200,1,00406,India
132260,2023-05-03,1004,Eyeliner,100,200,100,2,00296,India
132260,2023-05-03,1003,Foundation,300,600,300,2,00296,India
132260,2023-05-03,1008,Makeup Remover,80,160,80,2,00296,India
492161,2023-05-03,1004,Eyeliner,100,200,100,2,00236,India
597468,2023-05-03,1007,Eyeshadow,200,400,200,2,00378,India
597468,2023-05-03,1001,Lipstick,150,300,150,2,00378,India
597468,2023-05-03,1003,Foundation,300,600,300,2,00378,India
597468,2023-05-03,1012,Body Lotion,200,400,200,1,00378,India
156649,2023-05-03,1002,Mascara,200,400,200,2,00170,India
156649,2023-05-03,1005,Nail Polish,50,100,50,2,00170,India
156649,2023-05-03,1012,Body Lotion,200,400,200,1,00170,India
961456,2023-05-03,1002,Mascara,200,400,200,2,00149,India
961456,2023-05-03,1005,Nail Polish,50,100,50,2,00149,India
884307,2023-05-03,1005,Nail Polish,50,100,50,2,00299,India
884307,2023-05-03,1003,Foundation,300,600,300,2,00299,India
884307,2023-05-03,1002,Mascara,200,400,200,2,00299,India
908648,2023-05-03,1003,Foundation,300,600,300,2,00240,India
908648,2023-05-03,1007,Eyeshadow,200,400,200,2,00240,India
102255,2023-05-03,1007,Eyeshadow,200,400,200,2,00079,India
859217,2023-05-03,1002,Mascara,200,400,200,2,00420,India
859217,2023-05-03,1008,Makeup Remover,80,160,80,2,00420,India
859217,2023-05-03,1007,Eyeshadow,200,400,200,2,00420,India
323687,2023-05-03,1005,Nail Polish,50,100,50,2,00362,India
323687,2023-05-03,1002,Mascara,200,400,200,2,00362,India
244758,2023-05-03,1002,Mascara,200,400,200,2,00442,India
316641,2023-05-03,1001,Lipstick,150,300,150,2,00130,India
316641,2023-05-03,1002,Mascara,200,400,200,2,00130,India
316641,2023-05-03,1004,Eyeliner,100,200,100,2,00130,India
316641,2023-05-03,1005,Nail Polish,50,100,50,2,00130,India
913830,2023-05-03,1012,Body Lotion,200,400,200,1,00130,India
913830,2023-05-03,1005,Nail Polish,50,100,50,2,00130,India
534922,2023-05-03,1009,Moisturizer,250,500,250,1,00247,India
534922,2023-05-03,1007,Eyeshadow,200,400,200,2,00247,India
534922,2023-05-03,1001,Lipstick,150,300,150,2,00247,India
920782,2023-05-03,1005,Nail Polish,50,100,50,2,00458,India
920782,2023-05-03,1009,Moisturizer,250,500,250,1,00458,India
920782,2023-05-03,1001,Lipstick,150,300,150,2,00458,India
805217,2023-05-03,1004,Eyeliner,100,200,100,2,00194,India
805217,2023-05-03,1001,Lipstick,150,300,150,2,00194,India
805217,2023-05-03,1002,Mascara,200,400,200,2,00194,India
805217,2023-05-03,1008,Makeup Remover,80,160,80,2,00194,India
805217,2023-05-03,1003,Foundation,300,600,300,2,00194,India
277631,2023-05-03,1012,Body Lotion,200,400,200,1,00188,India
277631,2023-05-03,1001,Lipstick,150,300,150,2,00188,India
446810,2023-05-03,1006,Blush,150,300,150,2,00116,India
446810,2023-05-03,1007,Eyeshadow,200,400,200,2,00116,India
446810,2023-05-03,1004,Eyeliner,100,200,100,2,00116,India
547232,2023-05-03,1005,Nail Polish,50,100,50,2,00347,India
547232,2023-05-03,1002,Mascara,200,400,200,2,00347,India
547232,2023-05-03,1003,Foundation,300,600,300,2,00347,India
258189,2023-05-03,1009,Moisturizer,250,500,250,1,00040,India
258189,2023-05-03,1006,Blush,150,300,150,2,00040,India
258189,2023-05-03,1004,Eyeliner,100,200,100,2,00040,India
453895,2023-05-03,1005,Nail Polish,50,100,50,2,00043,India
453895,2023-05-03,1009,Moisturizer,250,500,250,1,00043,India
453895,2023-05-03,1001,Lipstick,150,300,150,2,00043,India
453895,2023-05-03,1007,Eyeshadow,200,400,200,2,00043,India
152396,2023-05-03,1003,Foundation,300,600,300,2,00497,India
113676,2023-05-03,1003,Foundation,300,600,300,2,00349,India
113676,2023-05-03,1012,Body Lotion,200,400,200,1,00349,India
113676,2023-05-03,1009,Moisturizer,250,500,250,1,00349,India
698368,2023-05-03,1012,Body Lotion,200,400,200,1,00145,India
698368,2023-05-03,1001,Lipstick,150,300,150,2,00145,India
698368,2023-05-03,1003,Foundation,300,600,300,2,00145,India
161995,2023-05-03,1012,Body Lotion,200,400,200,1,00415,India
161995,2023-05-03,1003,Foundation,300,600,300,2,00415,India
752999,2023-05-03,1006,Blush,150,300,150,2,00262,India
752999,2023-05-03,1012,Body Lotion,200,400,200,1,00262,India
752999,2023-05-03,1002,Mascara,200,400,200,2,00262,India
980109,2023-05-03,1001,Lipstick,150,300,150,2,00444,India
980109,2023-05-03,1006,Blush,150,300,150,2,00444,India
793055,2023-05-03,1012,Body Lotion,200,400,200,1,00162,India
793055,2023-05-03,1006,Blush,150,300,150,2,00162,India
793055,2023-05-03,1003,Foundation,300,600,300,2,00162,India
793055,2023-05-03,1007,Eyeshadow,200,400,200,2,00162,India
614102,2023-05-03,1005,Nail Polish,50,100,50,2,00339,India
614102,2023-05-03,1007,Eyeshadow,200,400,200,2,00339,India
614102,2023-05-03,1003,Foundation,300,600,300,2,00339,India
614102,2023-05-03,1002,Mascara,200,400,200,2,00339,India
999574,2023-05-03,1002,Mascara,200,400,200,2,00110,India
112875,2023-05-03,1012,Body Lotion,200,400,200,1,00222,India
112875,2023-05-03,1004,Eyeliner,100,200,100,2,00222,India
112875,2023-05-03,1009,Moisturizer,250,500,250,1,00222,India
872336,2023-05-03,1002,Mascara,200,400,200,2,00474,India
872336,2023-05-03,1012,Body Lotion,200,400,200,1,00474,India
872336,2023-05-03,1005,Nail Polish,50,100,50,2,00474,India
872336,2023-05-03,1001,Lipstick,150,300,150,2,00474,India
817465,2023-05-04,1003,Foundation,300,600,300,2,00013,India
817465,2023-05-04,1002,Mascara,200,400,200,2,00013,India
817465,2023-05-04,1006,Blush,150,300,150,2,00013,India
817465,2023-05-04,1004,Eyeliner,100,200,100,2,00013,India
680715,2023-05-04,1004,Eyeliner,100,200,100,2,00133,India
680715,2023-05-04,1006,Blush,150,300,150,2,00133,India
680715,2023-05-04,1008,Makeup Remover,80,160,80,2,00133,India
680715,2023-05-04,1001,Lipstick,150,300,150,2,00133,India
108380,2023-05-04,1006,Blush,150,300,150,2,00494,India
108380,2023-05-04,1012,Body Lotion,200,400,200,1,00494,India
108380,2023-05-04,1007,Eyeshadow,200,400,200,2,00494,India
108380,2023-05-04,1004,Eyeliner,100,200,100,2,00494,India
108380,2023-05-04,1008,Makeup Remover,80,160,80,2,00494,India
313926,2023-05-04,1006,Blush,150,300,150,2,00056,India
313926,2023-05-04,1003,Foundation,300,600,300,2,00056,India
660466,2023-05-04,1004,Eyeliner,100,200,100,2,00131,India
660466,2023-05-04,1008,Makeup Remover,80,160,80,2,00131,India
660466,2023-05-04,1002,Mascara,200,400,200,2,00131,India
370491,2023-05-04,1009,Moisturizer,250,500,250,1,00282,India
671534,2023-05-04,1003,Foundation,300,600,300,2,00380,India
671534,2023-05-04,1006,Blush,150,300,150,2,00380,India
671534,2023-05-04,1002,Mascara,200,400,200,2,00380,India
671534,2023-05-04,1001,Lipstick,150,300,150,2,00380,India
269383,2023-05-04,1003,Foundation,300,600,300,2,00383,India
831297,2023-05-04,1007,Eyeshadow,200,400,200,2,00404,India
831297,2023-05-04,1003,Foundation,300,600,300,2,00404,India
831297,2023-05-04,1006,Blush,150,300,150,2,00404,India
665764,2023-05-04,1009,Moisturizer,250,500,250,1,00298,India
665764,2023-05-04,1005,Nail Polish,50,100,50,2,00298,India
856450,2023-05-04,1008,Makeup Remover,80,160,80,2,00250,India
856450,2023-05-04,1007,Eyeshadow,200,400,200,2,00250,India
770527,2023-05-04,1003,Foundation,300,600,300,2,00163,India
116765,2023-05-04,1005,Nail Polish,50,100,50,2,00040,India
116765,2023-05-04,1003,Foundation,300,600,300,2,00040,India
116765,2023-05-04,1012,Body Lotion,200,400,200,1,00040,India
323461,2023-05-04,1002,Mascara,200,400,200,2,00432,India
323461,2023-05-04,1007,Eyeshadow,200,400,200,2,00432,India
323461,2023-05-04,1001,Lipstick,150,300,150,2,00432,India
699642,2023-05-04,1007,Eyeshadow,200,400,200,2,00315,India
699642,2023-05-04,1001,Lipstick,150,300,150,2,00315,India
699642,2023-05-04,1008,Makeup Remover,80,160,80,2,00315,India
178915,2023-05-04,1012,Body Lotion,200,400,200,1,00428,India
178915,2023-05-04,1007,Eyeshadow,200,400,200,2,00428,India
178915,2023-05-04,1008,Makeup Remover,80,160,80,2,00428,India
178915,2023-05-04,1005,Nail Polish,50,100,50,2,00428,India
306301,2023-05-04,1002,Mascara,200,400,200,2,00489,India
306301,2023-05-04,1004,Eyeliner,100,200,100,2,00489,India
306301,2023-05-04,1001,Lipstick,150,300,150,2,00489,India
840464,2023-05-04,1001,Lipstick,150,300,150,2,00224,India
840464,2023-05-04,1003,Foundation,300,600,300,2,00224,India
840464,2023-05-04,1004,Eyeliner,100,200,100,2,00224,India
196491,2023-05-04,1012,Body Lotion,200,400,200,1,00178,India
196491,2023-05-04,1004,Eyeliner,100,200,100,2,00178,India
241609,2023-05-04,1007,Eyeshadow,200,400,200,2,00055,India
241609,2023-05-04,1006,Blush,150,300,150,2,00055,India
747475,2023-05-04,1008,Makeup Remover,80,160,80,2,00194,India
747475,2023-05-04,1012,Body Lotion,200,400,200,1,00194,India
747475,2023-05-04,1006,Blush,150,300,150,2,00194,India
178095,2023-05-04,1003,Foundation,300,600,300,2,00110,India
178095,2023-05-04,1002,Mascara,200,400,200,2,00110,India
178095,2023-05-04,1006,Blush,150,300,150,2,00110,India
178095,2023-05-04,1007,Eyeshadow,200,400,200,2,00110,India
885118,2023-05-04,1001,Lipstick,150,300,150,2,00276,India
885118,2023-05-04,1012,Body Lotion,200,400,200,1,00276,India
885118,2023-05-04,1006,Blush,150,300,150,2,00276,India
885118,2023-05-04,1003,Foundation,300,600,300,2,00276,India
885118,2023-05-04,1002,Mascara,200,400,200,2,00276,India
615541,2023-05-04,1003,Foundation,300,600,300,2,00295,India
615541,2023-05-04,1001,Lipstick,150,300,150,2,00295,India
615541,2023-05-04,1007,Eyeshadow,200,400,200,2,00295,India
615541,2023-05-04,1005,Nail Polish,50,100,50,2,00295,India
615541,2023-05-04,1006,Blush,150,300,150,2,00295,India
462644,2023-05-04,1004,Eyeliner,100,200,100,2,00476,India
462644,2023-05-04,1005,Nail Polish,50,100,50,2,00476,India
462644,2023-05-04,1008,Makeup Remover,80,160,80,2,00476,India
462644,2023-05-04,1007,Eyeshadow,200,400,200,2,00476,India
266513,2023-05-04,1005,Nail Polish,50,100,50,2,00431,India
277598,2023-05-04,1008,Makeup Remover,80,160,80,2,00203,India
277598,2023-05-04,1003,Foundation,300,600,300,2,00203,India
560726,2023-05-04,1012,Body Lotion,200,400,200,1,00487,India
560726,2023-05-04,1002,Mascara,200,400,200,2,00487,India
560726,2023-05-04,1004,Eyeliner,100,200,100,2,00487,India
613569,2023-05-04,1001,Lipstick,150,300,150,2,00233,India
792073,2023-05-04,1004,Eyeliner,100,200,100,2,00489,India
792073,2023-05-04,1005,Nail Polish,50,100,50,2,00489,India
792073,2023-05-04,1006,Blush,150,300,150,2,00489,India
450932,2023-05-04,1012,Body Lotion,200,400,200,1,00359,India
962713,2023-05-04,1008,Makeup Remover,80,160,80,2,00350,India
774000,2023-05-04,1001,Lipstick,150,300,150,2,00302,India
774000,2023-05-04,1004,Eyeliner,100,200,100,2,00302,India
774000,2023-05-04,1005,Nail Polish,50,100,50,2,00302,India
668852,2023-05-04,1003,Foundation,300,600,300,2,00067,India
668852,2023-05-04,1009,Moisturizer,250,500,250,1,00067,India
668852,2023-05-04,1012,Body Lotion,200,400,200,1,00067,India
668852,2023-05-04,1004,Eyeliner,100,200,100,2,00067,India
338626,2023-05-04,1001,Lipstick,150,300,150,2,00266,India
338626,2023-05-04,1009,Moisturizer,250,500,250,1,00266,India
643307,2023-05-04,1008,Makeup Remover,80,160,80,2,00231,India
857193,2023-05-04,1007,Eyeshadow,200,400,200,2,00144,India
857193,2023-05-04,1003,Foundation,300,600,300,2,00144,India
857193,2023-05-04,1006,Blush,150,300,150,2,00144,India
857193,2023-05-04,1012,Body Lotion,200,400,200,1,00144,India
857193,2023-05-04,1009,Moisturizer,250,500,250,1,00144,India
730312,2023-05-04,1008,Makeup Remover,80,160,80,2,00327,India
730312,2023-05-04,1012,Body Lotion,200,400,200,1,00327,India
336651,2023-05-04,1012,Body Lotion,200,400,200,1,00372,India
336651,2023-05-04,1005,Nail Polish,50,100,50,2,00372,India
572962,2023-05-04,1006,Blush,150,300,150,2,00083,India
572962,2023-05-04,1012,Body Lotion,200,400,200,1,00083,India
572962,2023-05-04,1008,Makeup Remover,80,160,80,2,00083,India
572962,2023-05-04,1004,Eyeliner,100,200,100,2,00083,India
258456,2023-05-04,1009,Moisturizer,250,500,250,1,00281,India
140454,2023-05-04,1001,Lipstick,150,300,150,2,00221,India
140454,2023-05-04,1007,Eyeshadow,200,400,200,2,00221,India
140454,2023-05-04,1009,Moisturizer,250,500,250,1,00221,India
140454,2023-05-04,1005,Nail Polish,50,100,50,2,00221,India
446760,2023-05-04,1006,Blush,150,300,150,2,00119,India
446760,2023-05-04,1004,Eyeliner,100,200,100,2,00119,India
446760,2023-05-04,1005,Nail Polish,50,100,50,2,00119,India
446760,2023-05-04,1007,Eyeshadow,200,400,200,2,00119,India
446760,2023-05-04,1009,Moisturizer,250,500,250,1,00119,India
339431,2023-05-04,1005,Nail Polish,50,100,50,2,00350,India
339431,2023-05-04,1003,Foundation,300,600,300,2,00350,India
339431,2023-05-04,1004,Eyeliner,100,200,100,2,00350,India
339431,2023-05-04,1012,Body Lotion,200,400,200,1,00350,India
546040,2023-05-04,1012,Body Lotion,200,400,200,1,00168,India
546040,2023-05-04,1005,Nail Polish,50,100,50,2,00168,India
546040,2023-05-04,1002,Mascara,200,400,200,2,00168,India
546040,2023-05-04,1004,Eyeliner,100,200,100,2,00168,India
546040,2023-05-04,1009,Moisturizer,250,500,250,1,00168,India
235739,2023-05-04,1012,Body Lotion,200,400,200,1,00104,India
235739,2023-05-04,1002,Mascara,200,400,200,2,00104,India
235739,2023-05-04,1005,Nail Polish,50,100,50,2,00104,India
235739,2023-05-04,1006,Blush,150,300,150,2,00104,India
906981,2023-05-04,1005,Nail Polish,50,100,50,2,00114,India
906981,2023-05-04,1002,Mascara,200,400,200,2,00114,India
906981,2023-05-04,1009,Moisturizer,250,500,250,1,00114,India
906981,2023-05-04,1012,Body Lotion,200,400,200,1,00114,India
260959,2023-05-04,1012,Body Lotion,200,400,200,1,00203,India
260959,2023-05-04,1005,Nail Polish,50,100,50,2,00203,India
260959,2023-05-04,1009,Moisturizer,250,500,250,1,00203,India
584704,2023-05-05,1002,Mascara,200,400,200,2,00137,India
584704,2023-05-05,1007,Eyeshadow,200,400,200,2,00137,India
584704,2023-05-05,1001,Lipstick,150,300,150,2,00137,India
151439,2023-05-05,1008,Makeup Remover,80,160,80,2,00453,India
151439,2023-05-05,1009,Moisturizer,250,500,250,1,00453,India
151439,2023-05-05,1002,Mascara,200,400,200,2,00453,India
151439,2023-05-05,1005,Nail Polish,50,100,50,2,00453,India
734167,2023-05-05,1006,Blush,150,300,150,2,00202,India
734167,2023-05-05,1009,Moisturizer,250,500,250,1,00202,India
734167,2023-05-05,1005,Nail Polish,50,100,50,2,00202,India
719499,2023-05-05,1008,Makeup Remover,80,160,80,2,00333,India
719499,2023-05-05,1005,Nail Polish,50,100,50,2,00333,India
719499,2023-05-05,1006,Blush,150,300,150,2,00333,India
917611,2023-05-05,1008,Makeup Remover,80,160,80,2,00481,India
917611,2023-05-05,1012,Body Lotion,200,400,200,1,00481,India
657050,2023-05-05,1002,Mascara,200,400,200,2,00024,India
657050,2023-05-05,1008,Makeup Remover,80,160,80,2,00024,India
657050,2023-05-05,1006,Blush,150,300,150,2,00024,India
745019,2023-05-05,1008,Makeup Remover,80,160,80,2,00290,India
326630,2023-05-05,1004,Eyeliner,100,200,100,2,00007,India
326630,2023-05-05,1006,Blush,150,300,150,2,00007,India
326630,2023-05-05,1009,Moisturizer,250,500,250,1,00007,India
271764,2023-05-05,1002,Mascara,200,400,200,2,00210,India
271764,2023-05-05,1009,Moisturizer,250,500,250,1,00210,India
271764,2023-05-05,1012,Body Lotion,200,400,200,1,00210,India
271764,2023-05-05,1004,Eyeliner,100,200,100,2,00210,India
261195,2023-05-05,1012,Body Lotion,200,400,200,1,00339,India
261195,2023-05-05,1008,Makeup Remover,80,160,80,2,00339,India
504363,2023-05-05,1009,Moisturizer,250,500,250,1,00324,India
504363,2023-05-05,1005,Nail Polish,50,100,50,2,00324,India
504363,2023-05-05,1002,Mascara,200,400,200,2,00324,India
504363,2023-05-05,1003,Foundation,300,600,300,2,00324,India
504363,2023-05-05,1012,Body Lotion,200,400,200,1,00324,India
804897,2023-05-05,1008,Makeup Remover,80,160,80,2,00013,India
804897,2023-05-05,1006,Blush,150,300,150,2,00013,India
530086,2023-05-05,1008,Makeup Remover,80,160,80,2,00225,India
530086,2023-05-05,1012,Body Lotion,200,400,200,1,00225,India
530086,2023-05-05,1003,Foundation,300,600,300,2,00225,India
530086,2023-05-05,1007,Eyeshadow,200,400,200,2,00225,India
973538,2023-05-05,1008,Makeup Remover,80,160,80,2,00482,India
973538,2023-05-05,1005,Nail Polish,50,100,50,2,00482,India
973538,2023-05-05,1001,Lipstick,150,300,150,2,00482,India
973538,2023-05-05,1009,Moisturizer,250,500,250,1,00482,India
312596,2023-05-05,1007,Eyeshadow,200,400,200,2,00165,India
312596,2023-05-05,1003,Foundation,300,600,300,2,00165,India
673886,2023-05-05,1003,Foundation,300,600,300,2,00095,India
673886,2023-05-05,1007,Eyeshadow,200,400,200,2,00095,India
465237,2023-05-05,1004,Eyeliner,100,200,100,2,00048,India
465237,2023-05-05,1007,Eyeshadow,200,400,200,2,00048,India
735915,2023-05-05,1006,Blush,150,300,150,2,00082,India
928659,2023-05-05,1009,Moisturizer,250,500,250,1,00274,India
928659,2023-05-05,1004,Eyeliner,100,200,100,2,00274,India
943473,2023-05-05,1007,Eyeshadow,200,400,200,2,00121,India
943473,2023-05-05,1005,Nail Polish,50,100,50,2,00121,India
405038,2023-05-05,1005,Nail Polish,50,100,50,2,00324,India
405038,2023-05-05,1003,Foundation,300,600,300,2,00324,India
405038,2023-05-05,1008,Makeup Remover,80,160,80,2,00324,India
841842,2023-05-05,1006,Blush,150,300,150,2,00391,India
841842,2023-05-05,1012,Body Lotion,200,400,200,1,00391,India
841842,2023-05-05,1002,Mascara,200,400,200,2,00391,India
805137,2023-05-05,1004,Eyeliner,100,200,100,2,00438,India
805137,2023-05-05,1003,Foundation,300,600,300,2,00438,India
805137,2023-05-05,1012,Body Lotion,200,400,200,1,00438,India
673528,2023-05-05,1012,Body Lotion,200,400,200,1,00285,India
673528,2023-05-05,1003,Foundation,300,600,300,2,00285,India
673528,2023-05-05,1007,Eyeshadow,200,400,200,2,00285,India
143600,2023-05-05,1007,Eyeshadow,200,400,200,2,00393,India
143600,2023-05-05,1005,Nail Polish,50,100,50,2,00393,India
143600,2023-05-05,1004,Eyeliner,100,200,100,2,00393,India
991900,2023-05-05,1001,Lipstick,150,300,150,2,00300,India
105225,2023-05-05,1006,Blush,150,300,150,2,00322,India
105225,2023-05-05,1001,Lipstick,150,300,150,2,00322,India
105225,2023-05-05,1004,Eyeliner,100,200,100,2,00322,India
908592,2023-05-05,1003,Foundation,300,600,300,2,00050,India
908592,2023-05-05,1001,Lipstick,150,300,150,2,00050,India
908592,2023-05-05,1012,Body Lotion,200,400,200,1,00050,India
930309,2023-05-05,1005,Nail Polish,50,100,50,2,00097,India
930309,2023-05-05,1007,Eyeshadow,200,400,200,2,00097,India
930309,2023-05-05,1004,Eyeliner,100,200,100,2,00097,India
574400,2023-05-05,1008,Makeup Remover,80,160,80,2,00045,India
274995,2023-05-05,1008,Makeup Remover,80,160,80,2,00214,India
441334,2023-05-05,1007,Eyeshadow,200,400,200,2,00262,India
441334,2023-05-05,1001,Lipstick,150,300,150,2,00262,India
441334,2023-05-05,1008,Makeup Remover,80,160,80,2,00262,India
441334,2023-05-05,1003,Foundation,300,600,300,2,00262,India
696075,2023-05-05,1004,Eyeliner,100,200,100,2,00448,India
696075,2023-05-05,1005,Nail Polish,50,100,50,2,00448,India
696075,2023-05-05,1006,Blush,150,300,150,2,00448,India
433932,2023-05-05,1005,Nail Polish,50,100,50,2,00035,India
671978,2023-05-05,1002,Mascara,200,400,200,2,00474,India
671978,2023-05-05,1012,Body Lotion,200,400,200,1,00474,India
775172,2023-05-05,1001,Lipstick,150,300,150,2,00100,India
775172,2023-05-05,1002,Mascara,200,400,200,2,00100,India
775172,2023-05-05,1007,Eyeshadow,200,400,200,2,00100,India
775172,2023-05-05,1003,Foundation,300,600,300,2,00100,India
403605,2023-05-05,1004,Eyeliner,100,200,100,2,00200,India
403605,2023-05-05,1006,Blush,150,300,150,2,00200,India
403605,2023-05-05,1008,Makeup Remover,80,160,80,2,00200,India
403605,2023-05-05,1001,Lipstick,150,300,150,2,00200,India
567450,2023-05-05,1001,Lipstick,150,300,150,2,00107,India
567450,2023-05-05,1006,Blush,150,300,150,2,00107,India
567450,2023-05-05,1007,Eyeshadow,200,400,200,2,00107,India
567450,2023-05-05,1003,Foundation,300,600,300,2,00107,India
161865,2023-05-05,1008,Makeup Remover,80,160,80,2,00433,India
161865,2023-05-05,1005,Nail Polish,50,100,50,2,00433,India
856724,2023-05-05,1004,Eyeliner,100,200,100,2,00123,India
856724,2023-05-05,1009,Moisturizer,250,500,250,1,00123,India
856724,2023-05-05,1005,Nail Polish,50,100,50,2,00123,India
990353,2023-05-05,1004,Eyeliner,100,200,100,2,00029,India
990353,2023-05-05,1012,Body Lotion,200,400,200,1,00029,India
990353,2023-05-05,1008,Makeup Remover,80,160,80,2,00029,India
990353,2023-05-05,1001,Lipstick,150,300,150,2,00029,India
990353,2023-05-05,1005,Nail Polish,50,100,50,2,00029,India
324453,2023-05-05,1008,Makeup Remover,80,160,80,2,00208,India
918507,2023-05-05,1008,Makeup Remover,80,160,80,2,00213,India
268750,2023-05-05,1012,Body Lotion,200,400,200,1,00422,India
268750,2023-05-05,1003,Foundation,300,600,300,2,00422,India
268750,2023-05-05,1007,Eyeshadow,200,400,200,2,00422,India
794447,2023-05-05,1007,Eyeshadow,200,400,200,2,00255,India
794447,2023-05-05,1006,Blush,150,300,150,2,00255,India
302626,2023-05-05,1003,Foundation,300,600,300,2,00316,India
302626,2023-05-05,1002,Mascara,200,400,200,2,00316,India
302626,2023-05-05,1008,Makeup Remover,80,160,80,2,00316,India
865597,2023-05-06,1001,Lipstick,150,300,150,2,00253,India
865597,2023-05-06,1006,Blush,150,300,150,2,00253,India
865597,2023-05-06,1002,Mascara,200,400,200,2,00253,India
534457,2023-05-06,1009,Moisturizer,250,500,250,1,00449,India
534457,2023-05-06,1007,Eyeshadow,200,400,200,2,00449,India
534457,2023-05-06,1008,Makeup Remover,80,160,80,2,00449,India
185835,2023-05-06,1007,Eyeshadow,200,400,200,2,00441,India
861796,2023-05-06,1004,Eyeliner,100,200,100,2,00235,India
455316,2023-05-06,1008,Makeup Remover,80,160,80,2,00443,India
455316,2023-05-06,1006,Blush,150,300,150,2,00443,India
628782,2023-05-06,1012,Body Lotion,200,400,200,1,00101,India
628782,2023-05-06,1007,Eyeshadow,200,400,200,2,00101,India
628782,2023-05-06,1006,Blush,150,300,150,2,00101,India
849522,2023-05-06,1003,Foundation,300,600,300,2,00029,India
910020,2023-05-06,1002,Mascara,200,400,200,2,00221,India
910020,2023-05-06,1004,Eyeliner,100,200,100,2,00221,India
910020,2023-05-06,1005,Nail Polish,50,100,50,2,00221,India
910020,2023-05-06,1007,Eyeshadow,200,400,200,2,00221,India
326528,2023-05-06,1012,Body Lotion,200,400,200,1,00500,India
326528,2023-05-06,1006,Blush,150,300,150,2,00500,India
326528,2023-05-06,1009,Moisturizer,250,500,250,1,00500,India
701013,2023-05-06,1005,Nail Polish,50,100,50,2,00357,India
956127,2023-05-06,1012,Body Lotion,200,400,200,1,00060,India
956127,2023-05-06,1004,Eyeliner,100,200,100,2,00060,India
985322,2023-05-06,1007,Eyeshadow,200,400,200,2,00148,India
727441,2023-05-06,1005,Nail Polish,50,100,50,2,00064,India
727441,2023-05-06,1008,Makeup Remover,80,160,80,2,00064,India
727441,2023-05-06,1007,Eyeshadow,200,400,200,2,00064,India
280825,2023-05-06,1007,Eyeshadow,200,400,200,2,00215,India
280825,2023-05-06,1001,Lipstick,150,300,150,2,00215,India
280825,2023-05-06,1003,Foundation,300,600,300,2,00215,India
280825,2023-05-06,1004,Eyeliner,100,200,100,2,00215,India
310342,2023-05-06,1002,Mascara,200,400,200,2,00014,India
310342,2023-05-06,1006,Blush,150,300,150,2,00014,India
310342,2023-05-06,1009,Moisturizer,250,500,250,1,00014,India
844721,2023-05-06,1003,Foundation,300,600,300,2,00110,India
844721,2023-05-06,1012,Body Lotion,200,400,200,1,00110,India
844721,2023-05-06,1004,Eyeliner,100,200,100,2,00110,India
631591,2023-05-06,1004,Eyeliner,100,200,100,2,00255,India
631591,2023-05-06,1006,Blush,150,300,150,2,00255,India
582292,2023-05-06,1005,Nail Polish,50,100,50,2,00014,India
582292,2023-05-06,1009,Moisturizer,250,500,250,1,00014,India
252216,2023-05-06,1002,Mascara,200,400,200,2,00067,India
252216,2023-05-06,1012,Body Lotion,200,400,200,1,00067,India
252216,2023-05-06,1003,Foundation,300,600,300,2,00067,India
940114,2023-05-06,1004,Eyeliner,100,200,100,2,00103,India
940114,2023-05-06,1007,Eyeshadow,200,400,200,2,00103,India
876455,2023-05-06,1005,Nail Polish,50,100,50,2,00468,India
321355,2023-05-06,1012,Body Lotion,200,400,200,1,00332,India
321355,2023-05-06,1006,Blush,150,300,150,2,00332,India
635531,2023-05-06,1006,Blush,150,300,150,2,00044,India
910986,2023-05-06,1006,Blush,150,300,150,2,00300,India
301048,2023-05-06,1002,Mascara,200,400,200,2,00421,India
711249,2023-05-06,1005,Nail Polish,50,100,50,2,00185,India
711249,2023-05-06,1003,Foundation,300,600,300,2,00185,India
711249,2023-05-06,1008,Makeup Remover,80,160,80,2,00185,India
194969,2023-05-06,1008,Makeup Remover,80,160,80,2,00092,India
473466,2023-05-06,1005,Nail Polish,50,100,50,2,00021,India
473466,2023-05-06,1009,Moisturizer,250,500,250,1,00021,India
473466,2023-05-06,1004,Eyeliner,100,200,100,2,00021,India
833698,2023-05-06,1008,Makeup Remover,80,160,80,2,00408,India
833698,2023-05-06,1012,Body Lotion,200,400,200,1,00408,India
307277,2023-05-06,1005,Nail Polish,50,100,50,2,00484,India
332571,2023-05-06,1012,Body Lotion,200,400,200,1,00244,India
332571,2023-05-06,1009,Moisturizer,250,500,250,1,00244,India
332571,2023-05-06,1007,Eyeshadow,200,400,200,2,00244,India
374956,2023-05-06,1002,Mascara,200,400,200,2,00156,India
374956,2023-05-06,1004,Eyeliner,100,200,100,2,00156,India
374956,2023-05-06,1007,Eyeshadow,200,400,200,2,00156,India
374956,2023-05-06,1009,Moisturizer,250,500,250,1,00156,India
743839,2023-05-06,1012,Body Lotion,200,400,200,1,00065,India
743839,2023-05-06,1005,Nail Polish,50,100,50,2,00065,India
743839,2023-05-06,1007,Eyeshadow,200,400,200,2,00065,India
743839,2023-05-06,1006,Blush,150,300,150,2,00065,India
743839,2023-05-06,1001,Lipstick,150,300,150,2,00065,India
957461,2023-05-06,1009,Moisturizer,250,500,250,1,00299,India
957461,2023-05-06,1004,Eyeliner,100,200,100,2,00299,India
957461,2023-05-06,1006,Blush,150,300,150,2,00299,India
951858,2023-05-07,1002,Mascara,200,400,200,2,00029,India
951858,2023-05-07,1005,Nail Polish,50,100,50,2,00029,India
339752,2023-05-07,1004,Eyeliner,100,200,100,2,00396,India
339752,2023-05-07,1009,Moisturizer,250,500,250,1,00396,India
339752,2023-05-07,1005,Nail Polish,50,100,50,2,00396,India
339752,2023-05-07,1008,Makeup Remover,80,160,80,2,00396,India
519843,2023-05-07,1009,Moisturizer,250,500,250,1,00313,India
519843,2023-05-07,1007,Eyeshadow,200,400,200,2,00313,India
519843,2023-05-07,1002,Mascara,200,400,200,2,00313,India
669542,2023-05-07,1008,Makeup Remover,80,160,80,2,00129,India
669542,2023-05-07,1006,Blush,150,300,150,2,00129,India
413214,2023-05-07,1006,Blush,150,300,150,2,00221,India
413214,2023-05-07,1004,Eyeliner,100,200,100,2,00221,India
413214,2023-05-07,1009,Moisturizer,250,500,250,1,00221,India
413214,2023-05-07,1003,Foundation,300,600,300,2,00221,India
155545,2023-05-07,1004,Eyeliner,100,200,100,2,00476,India
155545,2023-05-07,1007,Eyeshadow,200,400,200,2,00476,India
155545,2023-05-07,1006,Blush,150,300,150,2,00476,India
155545,2023-05-07,1008,Makeup Remover,80,160,80,2,00476,India
829139,2023-05-07,1002,Mascara,200,400,200,2,00260,India
829139,2023-05-07,1009,Moisturizer,250,500,250,1,00260,India
829139,2023-05-07,1005,Nail Polish,50,100,50,2,00260,India
703842,2023-05-07,1009,Moisturizer,250,500,250,1,00079,India
703842,2023-05-07,1003,Foundation,300,600,300,2,00079,India
703842,2023-05-07,1012,Body Lotion,200,400,200,1,00079,India
703842,2023-05-07,1002,Mascara,200,400,200,2,00079,India
631524,2023-05-07,1006,Blush,150,300,150,2,00189,India
631524,2023-05-07,1004,Eyeliner,100,200,100,2,00189,India
631524,2023-05-07,1002,Mascara,200,400,200,2,00189,India
631524,2023-05-07,1012,Body Lotion,200,400,200,1,00189,India
443567,2023-05-07,1005,Nail Polish,50,100,50,2,00091,India
443567,2023-05-07,1004,Eyeliner,100,200,100,2,00091,India
147322,2023-05-07,1004,Eyeliner,100,200,100,2,00080,India
147322,2023-05-07,1005,Nail Polish,50,100,50,2,00080,India
147322,2023-05-07,1002,Mascara,200,400,200,2,00080,India
147322,2023-05-07,1012,Body Lotion,200,400,200,1,00080,India
584772,2023-05-07,1003,Foundation,300,600,300,2,00402,India
584772,2023-05-07,1012,Body Lotion,200,400,200,1,00402,India
584772,2023-05-07,1001,Lipstick,150,300,150,2,00402,India
347080,2023-05-07,1001,Lipstick,150,300,150,2,00005,India
909415,2023-05-07,1004,Eyeliner,100,200,100,2,00456,India
909415,2023-05-07,1003,Foundation,300,600,300,2,00456,India
909415,2023-05-07,1002,Mascara,200,400,200,2,00456,India
909415,2023-05-07,1001,Lipstick,150,300,150,2,00456,India
106069,2023-05-07,1002,Mascara,200,400,200,2,00043,India
106069,2023-05-07,1001,Lipstick,150,300,150,2,00043,India
106069,2023-05-07,1008,Makeup Remover,80,160,80,2,00043,India
106069,2023-05-07,1007,Eyeshadow,200,400,200,2,00043,India
663094,2023-05-07,1002,Mascara,200,400,200,2,00037,India
838951,2023-05-07,1001,Lipstick,150,300,150,2,00107,India
838951,2023-05-07,1005,Nail Polish,50,100,50,2,00107,India
838951,2023-05-07,1003,Foundation,300,600,300,2,00107,India
838951,2023-05-07,1009,Moisturizer,250,500,250,1,00107,India
852652,2023-05-07,1007,Eyeshadow,200,400,200,2,00274,India
852652,2023-05-07,1009,Moisturizer,250,500,250,1,00274,India
115716,2023-05-07,1007,Eyeshadow,200,400,200,2,00348,India
115716,2023-05-07,1006,Blush,150,300,150,2,00348,India
115716,2023-05-07,1008,Makeup Remover,80,160,80,2,00348,India
620135,2023-05-07,1012,Body Lotion,200,400,200,1,00428,India
620135,2023-05-07,1001,Lipstick,150,300,150,2,00428,India
586370,2023-05-07,1007,Eyeshadow,200,400,200,2,00173,India
586370,2023-05-07,1009,Moisturizer,250,500,250,1,00173,India
586370,2023-05-07,1006,Blush,150,300,150,2,00173,India
586370,2023-05-07,1004,Eyeliner,100,200,100,2,00173,India
883161,2023-05-07,1004,Eyeliner,100,200,100,2,00051,India
883161,2023-05-07,1007,Eyeshadow,200,400,200,2,00051,India
883161,2023-05-07,1008,Makeup Remover,80,160,80,2,00051,India
775051,2023-05-07,1007,Eyeshadow,200,400,200,2,00161,India
775051,2023-05-07,1008,Makeup Remover,80,160,80,2,00161,India
436972,2023-05-07,1001,Lipstick,150,300,150,2,00396,India
436972,2023-05-07,1004,Eyeliner,100,200,100,2,00396,India
123526,2023-05-07,1006,Blush,150,300,150,2,00110,India
123526,2023-05-07,1005,Nail Polish,50,100,50,2,00110,India
123526,2023-05-07,1007,Eyeshadow,200,400,200,2,00110,India
686409,2023-05-07,1001,Lipstick,150,300,150,2,00486,India
686409,2023-05-07,1007,Eyeshadow,200,400,200,2,00486,India
686409,2023-05-07,1012,Body Lotion,200,400,200,1,00486,India
686409,2023-05-07,1002,Mascara,200,400,200,2,00486,India
143933,2023-05-07,1008,Makeup Remover,80,160,80,2,00168,India
143933,2023-05-07,1005,Nail Polish,50,100,50,2,00168,India
143933,2023-05-07,1009,Moisturizer,250,500,250,1,00168,India
143933,2023-05-07,1003,Foundation,300,600,300,2,00168,India
767997,2023-05-07,1003,Foundation,300,600,300,2,00165,India
767997,2023-05-07,1005,Nail Polish,50,100,50,2,00165,India
593207,2023-05-07,1003,Foundation,300,600,300,2,00083,India
593207,2023-05-07,1001,Lipstick,150,300,150,2,00083,India
593207,2023-05-07,1008,Makeup Remover,80,160,80,2,00083,India
969745,2023-05-07,1004,Eyeliner,100,200,100,2,00270,India
969745,2023-05-07,1003,Foundation,300,600,300,2,00270,India
969745,2023-05-07,1009,Moisturizer,250,500,250,1,00270,India
969745,2023-05-07,1012,Body Lotion,200,400,200,1,00270,India
900788,2023-05-07,1008,Makeup Remover,80,160,80,2,00395,India
900788,2023-05-07,1005,Nail Polish,50,100,50,2,00395,India
900788,2023-05-07,1012,Body Lotion,200,400,200,1,00395,India
900788,2023-05-07,1003,Foundation,300,600,300,2,00395,India
587508,2023-05-07,1002,Mascara,200,400,200,2,00319,India
603386,2023-05-07,1002,Mascara,200,400,200,2,00154,India
846733,2023-05-07,1007,Eyeshadow,200,400,200,2,00154,India
425014,2023-05-07,1001,Lipstick,150,300,150,2,00290,India
425014,2023-05-07,1009,Moisturizer,250,500,250,1,00290,India
419858,2023-05-07,1007,Eyeshadow,200,400,200,2,00444,India
950171,2023-05-07,1008,Makeup Remover,80,160,80,2,00212,India
950171,2023-05-07,1003,Foundation,300,600,300,2,00212,India
211465,2023-05-07,1003,Foundation,300,600,300,2,00261,India
925215,2023-05-07,1006,Blush,150,300,150,2,00116,India
925215,2023-05-07,1004,Eyeliner,100,200,100,2,00116,India
925215,2023-05-07,1012,Body Lotion,200,400,200,1,00116,India
925215,2023-05-07,1005,Nail Polish,50,100,50,2,00116,India
477366,2023-05-07,1005,Nail Polish,50,100,50,2,00162,India
477366,2023-05-07,1004,Eyeliner,100,200,100,2,00162,India
477366,2023-05-07,1001,Lipstick,150,300,150,2,00162,India
477366,2023-05-07,1008,Makeup Remover,80,160,80,2,00162,India
477366,2023-05-07,1012,Body Lotion,200,400,200,1,00162,India
124184,2023-05-07,1007,Eyeshadow,200,400,200,2,00446,India
124184,2023-05-07,1004,Eyeliner,100,200,100,2,00446,India
124184,2023-05-07,1009,Moisturizer,250,500,250,1,00446,India
338043,2023-05-08,1007,Eyeshadow,200,400,200,2,00032,India
338043,2023-05-08,1003,Foundation,300,600,300,2,00032,India
338043,2023-05-08,1009,Moisturizer,250,500,250,1,00032,India
338043,2023-05-08,1004,Eyeliner,100,200,100,2,00032,India
350955,2023-05-08,1008,Makeup Remover,80,160,80,2,00150,India
350955,2023-05-08,1002,Mascara,200,400,200,2,00150,India
350955,2023-05-08,1004,Eyeliner,100,200,100,2,00150,India
195735,2023-05-08,1007,Eyeshadow,200,400,200,2,00442,India
506207,2023-05-08,1004,Eyeliner,100,200,100,2,00233,India
506207,2023-05-08,1008,Makeup Remover,80,160,80,2,00233,India
506207,2023-05-08,1012,Body Lotion,200,400,200,1,00233,India
452280,2023-05-08,1004,Eyeliner,100,200,100,2,00379,India
452280,2023-05-08,1005,Nail Polish,50,100,50,2,00379,India
452280,2023-05-08,1003,Foundation,300,600,300,2,00379,India
452280,2023-05-08,1001,Lipstick,150,300,150,2,00379,India
452280,2023-05-08,1009,Moisturizer,250,500,250,1,00379,India
113959,2023-05-08,1003,Foundation,300,600,300,2,00229,India
113959,2023-05-08,1004,Eyeliner,100,200,100,2,00229,India
285081,2023-05-08,1003,Foundation,300,600,300,2,00401,India
285081,2023-05-08,1001,Lipstick,150,300,150,2,00401,India
285081,2023-05-08,1009,Moisturizer,250,500,250,1,00401,India
285081,2023-05-08,1006,Blush,150,300,150,2,00401,India
907873,2023-05-08,1003,Foundation,300,600,300,2,00463,India
907873,2023-05-08,1002,Mascara,200,400,200,2,00463,India
907873,2023-05-08,1001,Lipstick,150,300,150,2,00463,India
382020,2023-05-08,1001,Lipstick,150,300,150,2,00120,India
382020,2023-05-08,1012,Body Lotion,200,400,200,1,00120,India
382020,2023-05-08,1006,Blush,150,300,150,2,00120,India
382020,2023-05-08,1005,Nail Polish,50,100,50,2,00120,India
777834,2023-05-08,1008,Makeup Remover,80,160,80,2,00348,India
777834,2023-05-08,1005,Nail Polish,50,100,50,2,00348,India
777834,2023-05-08,1006,Blush,150,300,150,2,00348,India
340693,2023-05-08,1005,Nail Polish,50,100,50,2,00444,India
340693,2023-05-08,1009,Moisturizer,250,500,250,1,00444,India
340693,2023-05-08,1003,Foundation,300,600,300,2,00444,India
340693,2023-05-08,1004,Eyeliner,100,200,100,2,00444,India
251245,2023-05-08,1008,Makeup Remover,80,160,80,2,00494,India
251245,2023-05-08,1005,Nail Polish,50,100,50,2,00494,India
251245,2023-05-08,1006,Blush,150,300,150,2,00494,India
251245,2023-05-08,1004,Eyeliner,100,200,100,2,00494,India
447639,2023-05-08,1002,Mascara,200,400,200,2,00381,India
447639,2023-05-08,1006,Blush,150,300,150,2,00381,India
556733,2023-05-08,1002,Mascara,200,400,200,2,00320,India
556733,2023-05-08,1005,Nail Polish,50,100,50,2,00320,India
556733,2023-05-08,1003,Foundation,300,600,300,2,00320,India
556733,2023-05-08,1009,Moisturizer,250,500,250,1,00320,India
959579,2023-05-08,1008,Makeup Remover,80,160,80,2,00287,India
959579,2023-05-08,1002,Mascara,200,400,200,2,00287,India
147514,2023-05-08,1007,Eyeshadow,200,400,200,2,00233,India
147514,2023-05-08,1005,Nail Polish,50,100,50,2,00233,India
147514,2023-05-08,1001,Lipstick,150,300,150,2,00233,India
772230,2023-05-08,1004,Eyeliner,100,200,100,2,00412,India
760301,2023-05-08,1003,Foundation,300,600,300,2,00167,India
849802,2023-05-08,1003,Foundation,300,600,300,2,00367,India
849802,2023-05-08,1004,Eyeliner,100,200,100,2,00367,India
849802,2023-05-08,1002,Mascara,200,400,200,2,00367,India
849802,2023-05-08,1008,Makeup Remover,80,160,80,2,00367,India
849802,2023-05-08,1005,Nail Polish,50,100,50,2,00367,India
810635,2023-05-08,1008,Makeup Remover,80,160,80,2,00268,India
810635,2023-05-08,1012,Body Lotion,200,400,200,1,00268,India
307604,2023-05-08,1001,Lipstick,150,300,150,2,00256,India
307604,2023-05-08,1003,Foundation,300,600,300,2,00256,India
307604,2023-05-08,1004,Eyeliner,100,200,100,2,00256,India
785699,2023-05-08,1004,Eyeliner,100,200,100,2,00424,India
785699,2023-05-08,1003,Foundation,300,600,300,2,00424,India
785699,2023-05-08,1008,Makeup Remover,80,160,80,2,00424,India
785699,2023-05-08,1005,Nail Polish,50,100,50,2,00424,India
949074,2023-05-08,1007,Eyeshadow,200,400,200,2,00013,India
949074,2023-05-08,1002,Mascara,200,400,200,2,00013,India
949074,2023-05-08,1003,Foundation,300,600,300,2,00013,India
949074,2023-05-08,1005,Nail Polish,50,100,50,2,00013,India
562572,2023-05-08,1009,Moisturizer,250,500,250,1,00304,India
562572,2023-05-08,1012,Body Lotion,200,400,200,1,00304,India
562572,2023-05-08,1003,Foundation,300,600,300,2,00304,India
168128,2023-05-08,1003,Foundation,300,600,300,2,00283,India
168128,2023-05-08,1008,Makeup Remover,80,160,80,2,00283,India
168128,2023-05-08,1005,Nail Polish,50,100,50,2,00283,India
168128,2023-05-08,1002,Mascara,200,400,200,2,00283,India
889324,2023-05-08,1004,Eyeliner,100,200,100,2,00375,India
557362,2023-05-08,1003,Foundation,300,600,300,2,00318,India
557362,2023-05-08,1008,Makeup Remover,80,160,80,2,00318,India
387031,2023-05-08,1008,Makeup Remover,80,160,80,2,00069,India
387031,2023-05-08,1007,Eyeshadow,200,400,200,2,00069,India
387031,2023-05-08,1001,Lipstick,150,300,150,2,00069,India
716394,2023-05-08,1003,Foundation,300,600,300,2,00303,India
716394,2023-05-08,1006,Blush,150,300,150,2,00303,India
405030,2023-05-08,1005,Nail Polish,50,100,50,2,00072,India
405030,2023-05-08,1006,Blush,150,300,150,2,00072,India
405030,2023-05-08,1001,Lipstick,150,300,150,2,00072,India
239199,2023-05-08,1004,Eyeliner,100,200,100,2,00021,India
239199,2023-05-08,1005,Nail Polish,50,100,50,2,00021,India
239199,2023-05-08,1006,Blush,150,300,150,2,00021,India
544581,2023-05-08,1006,Blush,150,300,150,2,00480,India
544581,2023-05-08,1012,Body Lotion,200,400,200,1,00480,India
544581,2023-05-08,1005,Nail Polish,50,100,50,2,00480,India
284656,2023-05-08,1006,Blush,150,300,150,2,00114,India
284656,2023-05-08,1001,Lipstick,150,300,150,2,00114,India
495646,2023-05-08,1006,Blush,150,300,150,2,00186,India
495646,2023-05-08,1003,Foundation,300,600,300,2,00186,India
536527,2023-05-08,1003,Foundation,300,600,300,2,00135,India
626832,2023-05-08,1004,Eyeliner,100,200,100,2,00009,India
626832,2023-05-08,1002,Mascara,200,400,200,2,00009,India
626832,2023-05-08,1012,Body Lotion,200,400,200,1,00009,India
626832,2023-05-08,1003,Foundation,300,600,300,2,00009,India
658152,2023-05-08,1003,Foundation,300,600,300,2,00265,India
658152,2023-05-08,1002,Mascara,200,400,200,2,00265,India
672721,2023-05-08,1012,Body Lotion,200,400,200,1,00254,India
672721,2023-05-08,1007,Eyeshadow,200,400,200,2,00254,India
672721,2023-05-08,1001,Lipstick,150,300,150,2,00254,India
672721,2023-05-08,1006,Blush,150,300,150,2,00254,India
427618,2023-05-08,1006,Blush,150,300,150,2,00093,India
997117,2023-05-08,1004,Eyeliner,100,200,100,2,00153,India
997117,2023-05-08,1009,Moisturizer,250,500,250,1,00153,India
997117,2023-05-08,1006,Blush,150,300,150,2,00153,India
393138,2023-05-08,1012,Body Lotion,200,400,200,1,00309,India
393138,2023-05-08,1007,Eyeshadow,200,400,200,2,00309,India
393138,2023-05-08,1001,Lipstick,150,300,150,2,00309,India
944710,2023-05-08,1001,Lipstick,150,300,150,2,00376,India
944710,2023-05-08,1005,Nail Polish,50,100,50,2,00376,India
944710,2023-05-08,1008,Makeup Remover,80,160,80,2,00376,India
344400,2023-05-08,1006,Blush,150,300,150,2,00241,India
344400,2023-05-08,1001,Lipstick,150,300,150,2,00241,India
344400,2023-05-08,1002,Mascara,200,400,200,2,00241,India
242143,2023-05-08,1007,Eyeshadow,200,400,200,2,00242,India
242143,2023-05-08,1009,Moisturizer,250,500,250,1,00242,India
242143,2023-05-08,1006,Blush,150,300,150,2,00242,India
937309,2023-05-08,1002,Mascara,200,400,200,2,00395,India
937309,2023-05-08,1003,Foundation,300,600,300,2,00395,India
100548,2023-05-08,1003,Foundation,300,600,300,2,00076,India
321208,2023-05-09,1001,Lipstick,150,300,150,2,00032,India
321208,2023-05-09,1003,Foundation,300,600,300,2,00032,India
321208,2023-05-09,1007,Eyeshadow,200,400,200,2,00032,India
880139,2023-05-09,1008,Makeup Remover,80,160,80,2,00388,India
880139,2023-05-09,1009,Moisturizer,250,500,250,1,00388,India
353130,2023-05-09,1007,Eyeshadow,200,400,200,2,00276,India
353130,2023-05-09,1005,Nail Polish,50,100,50,2,00276,India
651156,2023-05-09,1009,Moisturizer,250,500,250,1,00191,India
651156,2023-05-09,1007,Eyeshadow,200,400,200,2,00191,India
651156,2023-05-09,1006,Blush,150,300,150,2,00191,India
118880,2023-05-09,1004,Eyeliner,100,200,100,2,00022,India
118880,2023-05-09,1012,Body Lotion,200,400,200,1,00022,India
118880,2023-05-09,1002,Mascara,200,400,200,2,00022,India
118880,2023-05-09,1007,Eyeshadow,200,400,200,2,00022,India
131773,2023-05-09,1003,Foundation,300,600,300,2,00456,India
131773,2023-05-09,1002,Mascara,200,400,200,2,00456,India
131773,2023-05-09,1001,Lipstick,150,300,150,2,00456,India
267741,2023-05-09,1007,Eyeshadow,200,400,200,2,00423,India
231010,2023-05-09,1002,Mascara,200,400,200,2,00120,India
231010,2023-05-09,1007,Eyeshadow,200,400,200,2,00120,India
319497,2023-05-09,1001,Lipstick,150,300,150,2,00462,India
319497,2023-05-09,1003,Foundation,300,600,300,2,00462,India
319497,2023-05-09,1005,Nail Polish,50,100,50,2,00462,India
348217,2023-05-09,1012,Body Lotion,200,400,200,1,00362,India
348217,2023-05-09,1002,Mascara,200,400,200,2,00362,India
348217,2023-05-09,1007,Eyeshadow,200,400,200,2,00362,India
179742,2023-05-09,1001,Lipstick,150,300,150,2,00247,India
179742,2023-05-09,1002,Mascara,200,400,200,2,00247,India
179742,2023-05-09,1006,Blush,150,300,150,2,00247,India
659815,2023-05-09,1001,Lipstick,150,300,150,2,00026,India
659815,2023-05-09,1002,Mascara,200,400,200,2,00026,India
659815,2023-05-09,1007,Eyeshadow,200,400,200,2,00026,India
659815,2023-05-09,1009,Moisturizer,250,500,250,1,00026,India
224264,2023-05-09,1007,Eyeshadow,200,400,200,2,00405,India
224264,2023-05-09,1012,Body Lotion,200,400,200,1,00405,India
333615,2023-05-09,1009,Moisturizer,250,500,250,1,00375,India
333615,2023-05-09,1005,Nail Polish,50,100,50,2,00375,India
333615,2023-05-09,1001,Lipstick,150,300,150,2,00375,India
895749,2023-05-09,1002,Mascara,200,400,200,2,00054,India
895749,2023-05-09,1006,Blush,150,300,150,2,00054,India
895749,2023-05-09,1001,Lipstick,150,300,150,2,00054,India
390625,2023-05-09,1002,Mascara,200,400,200,2,00218,India
390625,2023-05-09,1009,Moisturizer,250,500,250,1,00218,India
390625,2023-05-09,1008,Makeup Remover,80,160,80,2,00218,India
228487,2023-05-09,1003,Foundation,300,600,300,2,00371,India
228487,2023-05-09,1005,Nail Polish,50,100,50,2,00371,India
228487,2023-05-09,1006,Blush,150,300,150,2,00371,India
100413,2023-05-09,1001,Lipstick,150,300,150,2,00129,India
100413,2023-05-09,1006,Blush,150,300,150,2,00129,India
501464,2023-05-09,1001,Lipstick,150,300,150,2,00067,India
501464,2023-05-09,1002,Mascara,200,400,200,2,00067,India
794741,2023-05-09,1003,Foundation,300,600,300,2,00497,India
794741,2023-05-09,1012,Body Lotion,200,400,200,1,00497,India
853310,2023-05-09,1012,Body Lotion,200,400,200,1,00086,India
853310,2023-05-09,1008,Makeup Remover,80,160,80,2,00086,India
469131,2023-05-09,1002,Mascara,200,400,200,2,00037,India
469131,2023-05-09,1012,Body Lotion,200,400,200,1,00037,India
469131,2023-05-09,1006,Blush,150,300,150,2,00037,India
469131,2023-05-09,1008,Makeup Remover,80,160,80,2,00037,India
469131,2023-05-09,1001,Lipstick,150,300,150,2,00037,India
498594,2023-05-09,1006,Blush,150,300,150,2,00061,India
621620,2023-05-09,1012,Body Lotion,200,400,200,1,00194,India
621620,2023-05-09,1003,Foundation,300,600,300,2,00194,India
570763,2023-05-09,1003,Foundation,300,600,300,2,00117,India
729041,2023-05-09,1001,Lipstick,150,300,150,2,00357,India
729041,2023-05-09,1007,Eyeshadow,200,400,200,2,00357,India
812818,2023-05-09,1004,Eyeliner,100,200,100,2,00074,India
812818,2023-05-09,1001,Lipstick,150,300,150,2,00074,India
812818,2023-05-09,1003,Foundation,300,600,300,2,00074,India
812818,2023-05-09,1006,Blush,150,300,150,2,00074,India
356187,2023-05-09,1006,Blush,150,300,150,2,00134,India
356187,2023-05-09,1003,Foundation,300,600,300,2,00134,India
586869,2023-05-09,1003,Foundation,300,600,300,2,00421,India
586869,2023-05-09,1006,Blush,150,300,150,2,00421,India
586869,2023-05-09,1012,Body Lotion,200,400,200,1,00421,India
586869,2023-05-09,1002,Mascara,200,400,200,2,00421,India
818407,2023-05-09,1006,Blush,150,300,150,2,00022,India
389117,2023-05-09,1012,Body Lotion,200,400,200,1,00093,India
825029,2023-05-09,1007,Eyeshadow,200,400,200,2,00315,India
825029,2023-05-09,1008,Makeup Remover,80,160,80,2,00315,India
825029,2023-05-09,1003,Foundation,300,600,300,2,00315,India
825029,2023-05-09,1001,Lipstick,150,300,150,2,00315,India
425259,2023-05-09,1004,Eyeliner,100,200,100,2,00148,India
425259,2023-05-09,1003,Foundation,300,600,300,2,00148,India
425259,2023-05-09,1002,Mascara,200,400,200,2,00148,India
418606,2023-05-09,1007,Eyeshadow,200,400,200,2,00358,India
418606,2023-05-09,1012,Body Lotion,200,400,200,1,00358,India
356753,2023-05-10,1001,Lipstick,150,300,150,2,00220,India
356753,2023-05-10,1007,Eyeshadow,200,400,200,2,00220,India
356753,2023-05-10,1012,Body Lotion,200,400,200,1,00220,India
356753,2023-05-10,1009,Moisturizer,250,500,250,1,00220,India
630343,2023-05-10,1005,Nail Polish,50,100,50,2,00285,India
630343,2023-05-10,1009,Moisturizer,250,500,250,1,00285,India
630343,2023-05-10,1012,Body Lotion,200,400,200,1,00285,India
718476,2023-05-10,1001,Lipstick,150,300,150,2,00220,India
718476,2023-05-10,1006,Blush,150,300,150,2,00220,India
718476,2023-05-10,1003,Foundation,300,600,300,2,00220,India
880207,2023-05-10,1007,Eyeshadow,200,400,200,2,00322,India
880207,2023-05-10,1009,Moisturizer,250,500,250,1,00322,India
494118,2023-05-10,1003,Foundation,300,600,300,2,00187,India
494118,2023-05-10,1006,Blush,150,300,150,2,00187,India
494118,2023-05-10,1012,Body Lotion,200,400,200,1,00187,India
909737,2023-05-10,1005,Nail Polish,50,100,50,2,00323,India
909737,2023-05-10,1001,Lipstick,150,300,150,2,00323,India
909737,2023-05-10,1004,Eyeliner,100,200,100,2,00323,India
958750,2023-05-10,1009,Moisturizer,250,500,250,1,00221,India
958750,2023-05-10,1012,Body Lotion,200,400,200,1,00221,India
958750,2023-05-10,1008,Makeup Remover,80,160,80,2,00221,India
958750,2023-05-10,1007,Eyeshadow,200,400,200,2,00221,India
958750,2023-05-10,1006,Blush,150,300,150,2,00221,India
638040,2023-05-10,1005,Nail Polish,50,100,50,2,00190,India
306345,2023-05-10,1002,Mascara,200,400,200,2,00384,India
306345,2023-05-10,1006,Blush,150,300,150,2,00384,India
306345,2023-05-10,1008,Makeup Remover,80,160,80,2,00384,India
306345,2023-05-10,1004,Eyeliner,100,200,100,2,00384,India
879481,2023-05-10,1007,Eyeshadow,200,400,200,2,00219,India
879481,2023-05-10,1006,Blush,150,300,150,2,00219,India
111399,2023-05-10,1004,Eyeliner,100,200,100,2,00424,India
111399,2023-05-10,1012,Body Lotion,200,400,200,1,00424,India
111399,2023-05-10,1007,Eyeshadow,200,400,200,2,00424,India
111399,2023-05-10,1009,Moisturizer,250,500,250,1,00424,India
849194,2023-05-10,1003,Foundation,300,600,300,2,00396,India
849194,2023-05-10,1009,Moisturizer,250,500,250,1,00396,India
849194,2023-05-10,1001,Lipstick,150,300,150,2,00396,India
849194,2023-05-10,1007,Eyeshadow,200,400,200,2,00396,India
849194,2023-05-10,1006,Blush,150,300,150,2,00396,India
878415,2023-05-10,1005,Nail Polish,50,100,50,2,00400,India
598833,2023-05-10,1006,Blush,150,300,150,2,00008,India
598833,2023-05-10,1002,Mascara,200,400,200,2,00008,India
598833,2023-05-10,1012,Body Lotion,200,400,200,1,00008,India
734658,2023-05-10,1012,Body Lotion,200,400,200,1,00171,India
734658,2023-05-10,1002,Mascara,200,400,200,2,00171,India
734658,2023-05-10,1005,Nail Polish,50,100,50,2,00171,India
120527,2023-05-10,1002,Mascara,200,400,200,2,00050,India
120527,2023-05-10,1001,Lipstick,150,300,150,2,00050,India
120527,2023-05-10,1008,Makeup Remover,80,160,80,2,00050,India
920721,2023-05-10,1009,Moisturizer,250,500,250,1,00320,India
324450,2023-05-10,1009,Moisturizer,250,500,250,1,00164,India
324450,2023-05-10,1006,Blush,150,300,150,2,00164,India
723512,2023-05-10,1002,Mascara,200,400,200,2,00191,India
723512,2023-05-10,1012,Body Lotion,200,400,200,1,00191,India
723512,2023-05-10,1004,Eyeliner,100,200,100,2,00191,India
723512,2023-05-10,1005,Nail Polish,50,100,50,2,00191,India
996955,2023-05-10,1003,Foundation,300,600,300,2,00191,India
996955,2023-05-10,1006,Blush,150,300,150,2,00191,India
198709,2023-05-10,1001,Lipstick,150,300,150,2,00233,India
586594,2023-05-10,1001,Lipstick,150,300,150,2,00091,India
586594,2023-05-10,1008,Makeup Remover,80,160,80,2,00091,India
454977,2023-05-10,1005,Nail Polish,50,100,50,2,00336,India
454977,2023-05-10,1002,Mascara,200,400,200,2,00336,India
214965,2023-05-10,1006,Blush,150,300,150,2,00109,India
214965,2023-05-10,1002,Mascara,200,400,200,2,00109,India
214965,2023-05-10,1007,Eyeshadow,200,400,200,2,00109,India
895502,2023-05-10,1005,Nail Polish,50,100,50,2,00103,India
895502,2023-05-10,1001,Lipstick,150,300,150,2,00103,India
204255,2023-05-10,1003,Foundation,300,600,300,2,00037,India
204255,2023-05-10,1001,Lipstick,150,300,150,2,00037,India
775527,2023-05-10,1003,Foundation,300,600,300,2,00369,India
775527,2023-05-10,1004,Eyeliner,100,200,100,2,00369,India
775527,2023-05-10,1002,Mascara,200,400,200,2,00369,India
775527,2023-05-10,1012,Body Lotion,200,400,200,1,00369,India
775527,2023-05-10,1009,Moisturizer,250,500,250,1,00369,India
123114,2023-05-10,1001,Lipstick,150,300,150,2,00251,India
123114,2023-05-10,1003,Foundation,300,600,300,2,00251,India
123114,2023-05-10,1008,Makeup Remover,80,160,80,2,00251,India
123114,2023-05-10,1006,Blush,150,300,150,2,00251,India
479039,2023-05-10,1005,Nail Polish,50,100,50,2,00411,India
929031,2023-05-10,1003,Foundation,300,600,300,2,00428,India
929031,2023-05-10,1001,Lipstick,150,300,150,2,00428,India
287594,2023-05-10,1001,Lipstick,150,300,150,2,00278,India
287594,2023-05-10,1008,Makeup Remover,80,160,80,2,00278,India
287594,2023-05-10,1006,Blush,150,300,150,2,00278,India
287594,2023-05-10,1012,Body Lotion,200,400,200,1,00278,India
191772,2023-05-10,1002,Mascara,200,400,200,2,00277,India
299350,2023-05-10,1003,Foundation,300,600,300,2,00107,India
299350,2023-05-10,1007,Eyeshadow,200,400,200,2,00107,India
334546,2023-05-10,1012,Body Lotion,200,400,200,1,00105,India
334546,2023-05-10,1007,Eyeshadow,200,400,200,2,00105,India
334546,2023-05-10,1002,Mascara,200,400,200,2,00105,India
653348,2023-05-10,1007,Eyeshadow,200,400,200,2,00382,India
653348,2023-05-10,1008,Makeup Remover,80,160,80,2,00382,India
172531,2023-05-10,1012,Body Lotion,200,400,200,1,00141,India
172531,2023-05-10,1001,Lipstick,150,300,150,2,00141,India
595008,2023-05-10,1003,Foundation,300,600,300,2,00088,India
488199,2023-05-10,1001,Lipstick,150,300,150,2,00429,India
488199,2023-05-10,1012,Body Lotion,200,400,200,1,00429,India
488199,2023-05-10,1008,Makeup Remover,80,160,80,2,00429,India
126872,2023-05-10,1002,Mascara,200,400,200,2,00088,India
126872,2023-05-10,1008,Makeup Remover,80,160,80,2,00088,India
126872,2023-05-10,1004,Eyeliner,100,200,100,2,00088,India
404679,2023-05-10,1009,Moisturizer,250,500,250,1,00146,India
711958,2023-05-10,1007,Eyeshadow,200,400,200,2,00278,India
317133,2023-05-10,1007,Eyeshadow,200,400,200,2,00321,India
122824,2023-05-10,1008,Makeup Remover,80,160,80,2,00299,India
609788,2023-05-11,1003,Foundation,300,600,300,2,00209,India
609788,2023-05-11,1007,Eyeshadow,200,400,200,2,00209,India
609788,2023-05-11,1009,Moisturizer,250,500,250,1,00209,India
609788,2023-05-11,1002,Mascara,200,400,200,2,00209,India
473763,2023-05-11,1008,Makeup Remover,80,160,80,2,00064,India
473763,2023-05-11,1003,Foundation,300,600,300,2,00064,India
473763,2023-05-11,1001,Lipstick,150,300,150,2,00064,India
162251,2023-05-11,1003,Foundation,300,600,300,2,00349,India
162251,2023-05-11,1004,Eyeliner,100,200,100,2,00349,India
162251,2023-05-11,1002,Mascara,200,400,200,2,00349,India
860672,2023-05-11,1004,Eyeliner,100,200,100,2,00098,India
860672,2023-05-11,1008,Makeup Remover,80,160,80,2,00098,India
860672,2023-05-11,1012,Body Lotion,200,400,200,1,00098,India
761378,2023-05-11,1007,Eyeshadow,200,400,200,2,00131,India
761378,2023-05-11,1002,Mascara,200,400,200,2,00131,India
761378,2023-05-11,1005,Nail Polish,50,100,50,2,00131,India
761378,2023-05-11,1009,Moisturizer,250,500,250,1,00131,India
729604,2023-05-11,1012,Body Lotion,200,400,200,1,00213,India
502798,2023-05-11,1009,Moisturizer,250,500,250,1,00279,India
502798,2023-05-11,1008,Makeup Remover,80,160,80,2,00279,India
502798,2023-05-11,1012,Body Lotion,200,400,200,1,00279,India
463597,2023-05-11,1003,Foundation,300,600,300,2,00087,India
463597,2023-05-11,1009,Moisturizer,250,500,250,1,00087,India
463597,2023-05-11,1012,Body Lotion,200,400,200,1,00087,India
998063,2023-05-11,1007,Eyeshadow,200,400,200,2,00449,India
998063,2023-05-11,1006,Blush,150,300,150,2,00449,India
998063,2023-05-11,1005,Nail Polish,50,100,50,2,00449,India
998063,2023-05-11,1003,Foundation,300,600,300,2,00449,India
288002,2023-05-11,1008,Makeup Remover,80,160,80,2,00282,India
288002,2023-05-11,1003,Foundation,300,600,300,2,00282,India
288002,2023-05-11,1006,Blush,150,300,150,2,00282,India
288002,2023-05-11,1007,Eyeshadow,200,400,200,2,00282,India
872967,2023-05-11,1007,Eyeshadow,200,400,200,2,00344,India
857936,2023-05-11,1007,Eyeshadow,200,400,200,2,00299,India
857936,2023-05-11,1008,Makeup Remover,80,160,80,2,00299,India
840631,2023-05-11,1002,Mascara,200,400,200,2,00131,India
393609,2023-05-11,1002,Mascara,200,400,200,2,00168,India
393609,2023-05-11,1005,Nail Polish,50,100,50,2,00168,India
764736,2023-05-11,1007,Eyeshadow,200,400,200,2,00314,India
984480,2023-05-11,1006,Blush,150,300,150,2,00469,India
984480,2023-05-11,1012,Body Lotion,200,400,200,1,00469,India
984480,2023-05-11,1005,Nail Polish,50,100,50,2,00469,India
265126,2023-05-11,1005,Nail Polish,50,100,50,2,00407,India
265126,2023-05-11,1002,Mascara,200,400,200,2,00407,India
265126,2023-05-11,1004,Eyeliner,100,200,100,2,00407,India
439402,2023-05-11,1004,Eyeliner,100,200,100,2,00408,India
439402,2023-05-11,1002,Mascara,200,400,200,2,00408,India
439402,2023-05-11,1007,Eyeshadow,200,400,200,2,00408,India
439402,2023-05-11,1008,Makeup Remover,80,160,80,2,00408,India
686941,2023-05-11,1005,Nail Polish,50,100,50,2,00316,India
686941,2023-05-11,1012,Body Lotion,200,400,200,1,00316,India
514452,2023-05-11,1002,Mascara,200,400,200,2,00453,India
514452,2023-05-11,1005,Nail Polish,50,100,50,2,00453,India
514452,2023-05-11,1003,Foundation,300,600,300,2,00453,India
851492,2023-05-11,1006,Blush,150,300,150,2,00288,India
851492,2023-05-11,1009,Moisturizer,250,500,250,1,00288,India
851492,2023-05-11,1005,Nail Polish,50,100,50,2,00288,India
851492,2023-05-11,1008,Makeup Remover,80,160,80,2,00288,India
851492,2023-05-11,1001,Lipstick,150,300,150,2,00288,India
324730,2023-05-11,1008,Makeup Remover,80,160,80,2,00402,India
167061,2023-05-11,1009,Moisturizer,250,500,250,1,00389,India
167061,2023-05-11,1008,Makeup Remover,80,160,80,2,00389,India
167061,2023-05-11,1004,Eyeliner,100,200,100,2,00389,India
325552,2023-05-11,1001,Lipstick,150,300,150,2,00262,India
474126,2023-05-11,1004,Eyeliner,100,200,100,2,00108,India
474126,2023-05-11,1003,Foundation,300,600,300,2,00108,India
668153,2023-05-11,1008,Makeup Remover,80,160,80,2,00006,India
668153,2023-05-11,1004,Eyeliner,100,200,100,2,00006,India
144566,2023-05-11,1004,Eyeliner,100,200,100,2,00158,India
144566,2023-05-11,1008,Makeup Remover,80,160,80,2,00158,India
144566,2023-05-11,1001,Lipstick,150,300,150,2,00158,India
572564,2023-05-11,1004,Eyeliner,100,200,100,2,00148,India
752933,2023-05-11,1006,Blush,150,300,150,2,00375,India
234732,2023-05-11,1008,Makeup Remover,80,160,80,2,00427,India
723419,2023-05-11,1007,Eyeshadow,200,400,200,2,00147,India
723419,2023-05-11,1004,Eyeliner,100,200,100,2,00147,India
765930,2023-05-11,1005,Nail Polish,50,100,50,2,00381,India
765930,2023-05-11,1001,Lipstick,150,300,150,2,00381,India
765930,2023-05-11,1008,Makeup Remover,80,160,80,2,00381,India
765930,2023-05-11,1006,Blush,150,300,150,2,00381,India
802732,2023-05-11,1003,Foundation,300,600,300,2,00177,India
802732,2023-05-11,1006,Blush,150,300,150,2,00177,India
802732,2023-05-11,1002,Mascara,200,400,200,2,00177,India
802732,2023-05-11,1004,Eyeliner,100,200,100,2,00177,India
244311,2023-05-11,1001,Lipstick,150,300,150,2,00401,India
244311,2023-05-11,1005,Nail Polish,50,100,50,2,00401,India
830435,2023-05-11,1004,Eyeliner,100,200,100,2,00486,India
721005,2023-05-11,1003,Foundation,300,600,300,2,00366,India
388605,2023-05-11,1005,Nail Polish,50,100,50,2,00176,India
771544,2023-05-11,1005,Nail Polish,50,100,50,2,00484,India
771544,2023-05-11,1001,Lipstick,150,300,150,2,00484,India
771544,2023-05-11,1007,Eyeshadow,200,400,200,2,00484,India
853149,2023-05-11,1002,Mascara,200,400,200,2,00267,India
564365,2023-05-12,1002,Mascara,200,400,200,2,00164,India
564365,2023-05-12,1007,Eyeshadow,200,400,200,2,00164,India
564365,2023-05-12,1012,Body Lotion,200,400,200,1,00164,India
564365,2023-05-12,1006,Blush,150,300,150,2,00164,India
334045,2023-05-12,1004,Eyeliner,100,200,100,2,00065,India
334045,2023-05-12,1012,Body Lotion,200,400,200,1,00065,India
334045,2023-05-12,1009,Moisturizer,250,500,250,1,00065,India
521643,2023-05-12,1001,Lipstick,150,300,150,2,00466,India
985325,2023-05-12,1003,Foundation,300,600,300,2,00396,India
985325,2023-05-12,1009,Moisturizer,250,500,250,1,00396,India
985325,2023-05-12,1006,Blush,150,300,150,2,00396,India
985325,2023-05-12,1005,Nail Polish,50,100,50,2,00396,India
985325,2023-05-12,1012,Body Lotion,200,400,200,1,00396,India
331033,2023-05-12,1002,Mascara,200,400,200,2,00095,India
331033,2023-05-12,1003,Foundation,300,600,300,2,00095,India
494216,2023-05-12,1009,Moisturizer,250,500,250,1,00328,India
601737,2023-05-12,1006,Blush,150,300,150,2,00398,India
601737,2023-05-12,1007,Eyeshadow,200,400,200,2,00398,India
601737,2023-05-12,1008,Makeup Remover,80,160,80,2,00398,India
725419,2023-05-12,1006,Blush,150,300,150,2,00259,India
498295,2023-05-12,1003,Foundation,300,600,300,2,00200,India
498295,2023-05-12,1002,Mascara,200,400,200,2,00200,India
623891,2023-05-12,1004,Eyeliner,100,200,100,2,00420,India
623891,2023-05-12,1012,Body Lotion,200,400,200,1,00420,India
617495,2023-05-12,1003,Foundation,300,600,300,2,00235,India
749517,2023-05-12,1005,Nail Polish,50,100,50,2,00475,India
749517,2023-05-12,1002,Mascara,200,400,200,2,00475,India
749517,2023-05-12,1003,Foundation,300,600,300,2,00475,India
262710,2023-05-12,1007,Eyeshadow,200,400,200,2,00106,India
262710,2023-05-12,1003,Foundation,300,600,300,2,00106,India
262710,2023-05-12,1008,Makeup Remover,80,160,80,2,00106,India
684460,2023-05-12,1003,Foundation,300,600,300,2,00183,India
713221,2023-05-12,1007,Eyeshadow,200,400,200,2,00349,India
713221,2023-05-12,1006,Blush,150,300,150,2,00349,India
922926,2023-05-12,1002,Mascara,200,400,200,2,00044,India
682530,2023-05-12,1007,Eyeshadow,200,400,200,2,00384,India
712520,2023-05-12,1005,Nail Polish,50,100,50,2,00119,India
712520,2023-05-12,1001,Lipstick,150,300,150,2,00119,India
712520,2023-05-12,1007,Eyeshadow,200,400,200,2,00119,India
712520,2023-05-12,1012,Body Lotion,200,400,200,1,00119,India
266910,2023-05-12,1008,Makeup Remover,80,160,80,2,00397,India
308565,2023-05-12,1012,Body Lotion,200,400,200,1,00250,India
547876,2023-05-12,1009,Moisturizer,250,500,250,1,00361,India
781665,2023-05-12,1002,Mascara,200,400,200,2,00053,India
801290,2023-05-12,1002,Mascara,200,400,200,2,00344,India
801290,2023-05-12,1012,Body Lotion,200,400,200,1,00344,India
989499,2023-05-12,1009,Moisturizer,250,500,250,1,00409,India
989499,2023-05-12,1002,Mascara,200,400,200,2,00409,India
989499,2023-05-12,1001,Lipstick,150,300,150,2,00409,India
465180,2023-05-12,1003,Foundation,300,600,300,2,00449,India
465180,2023-05-12,1005,Nail Polish,50,100,50,2,00449,India
465180,2023-05-12,1008,Makeup Remover,80,160,80,2,00449,India
494571,2023-05-12,1007,Eyeshadow,200,400,200,2,00492,India
125125,2023-05-12,1007,Eyeshadow,200,400,200,2,00103,India
125125,2023-05-12,1006,Blush,150,300,150,2,00103,India
548619,2023-05-12,1007,Eyeshadow,200,400,200,2,00499,India
548619,2023-05-12,1006,Blush,150,300,150,2,00499,India
548619,2023-05-12,1005,Nail Polish,50,100,50,2,00499,India
283830,2023-05-12,1009,Moisturizer,250,500,250,1,00380,India
283830,2023-05-12,1004,Eyeliner,100,200,100,2,00380,India
154556,2023-05-12,1009,Moisturizer,250,500,250,1,00452,India
154556,2023-05-12,1012,Body Lotion,200,400,200,1,00452,India
154556,2023-05-12,1008,Makeup Remover,80,160,80,2,00452,India
154556,2023-05-12,1004,Eyeliner,100,200,100,2,00452,India
154556,2023-05-12,1002,Mascara,200,400,200,2,00452,India
306056,2023-05-12,1004,Eyeliner,100,200,100,2,00307,India
934523,2023-05-12,1008,Makeup Remover,80,160,80,2,00421,India
934523,2023-05-12,1007,Eyeshadow,200,400,200,2,00421,India
934523,2023-05-12,1012,Body Lotion,200,400,200,1,00421,India
793557,2023-05-12,1002,Mascara,200,400,200,2,00122,India
793557,2023-05-12,1006,Blush,150,300,150,2,00122,India
793557,2023-05-12,1004,Eyeliner,100,200,100,2,00122,India
793557,2023-05-12,1009,Moisturizer,250,500,250,1,00122,India
145572,2023-05-13,1002,Mascara,200,400,200,2,00248,India
533332,2023-05-13,1003,Foundation,300,600,300,2,00165,India
533332,2023-05-13,1012,Body Lotion,200,400,200,1,00165,India
533332,2023-05-13,1002,Mascara,200,400,200,2,00165,India
533332,2023-05-13,1005,Nail Polish,50,100,50,2,00165,India
533332,2023-05-13,1006,Blush,150,300,150,2,00165,India
967608,2023-05-13,1007,Eyeshadow,200,400,200,2,00441,India
967608,2023-05-13,1003,Foundation,300,600,300,2,00441,India
967608,2023-05-13,1001,Lipstick,150,300,150,2,00441,India
967608,2023-05-13,1009,Moisturizer,250,500,250,1,00441,India
967608,2023-05-13,1005,Nail Polish,50,100,50,2,00441,India
275630,2023-05-13,1005,Nail Polish,50,100,50,2,00373,India
275630,2023-05-13,1012,Body Lotion,200,400,200,1,00373,India
275630,2023-05-13,1004,Eyeliner,100,200,100,2,00373,India
263393,2023-05-13,1002,Mascara,200,400,200,2,00092,India
263393,2023-05-13,1012,Body Lotion,200,400,200,1,00092,India
263393,2023-05-13,1005,Nail Polish,50,100,50,2,00092,India
314564,2023-05-13,1009,Moisturizer,250,500,250,1,00271,India
314564,2023-05-13,1004,Eyeliner,100,200,100,2,00271,India
314564,2023-05-13,1007,Eyeshadow,200,400,200,2,00271,India
372865,2023-05-13,1001,Lipstick,150,300,150,2,00060,India
372865,2023-05-13,1004,Eyeliner,100,200,100,2,00060,India
372865,2023-05-13,1003,Foundation,300,600,300,2,00060,India
198934,2023-05-13,1002,Mascara,200,400,200,2,00061,India
198934,2023-05-13,1005,Nail Polish,50,100,50,2,00061,India
198934,2023-05-13,1006,Blush,150,300,150,2,00061,India
198934,2023-05-13,1008,Makeup Remover,80,160,80,2,00061,India
987920,2023-05-13,1002,Mascara,200,400,200,2,00455,India
286305,2023-05-13,1006,Blush,150,300,150,2,00189,India
282704,2023-05-13,1001,Lipstick,150,300,150,2,00464,India
282704,2023-05-13,1007,Eyeshadow,200,400,200,2,00464,India
282704,2023-05-13,1005,Nail Polish,50,100,50,2,00464,India
282704,2023-05-13,1002,Mascara,200,400,200,2,00464,India
282704,2023-05-13,1006,Blush,150,300,150,2,00464,India
283067,2023-05-13,1003,Foundation,300,600,300,2,00478,India
283067,2023-05-13,1005,Nail Polish,50,100,50,2,00478,India
644636,2023-05-13,1001,Lipstick,150,300,150,2,00121,India
644636,2023-05-13,1005,Nail Polish,50,100,50,2,00121,India
644636,2023-05-13,1002,Mascara,200,400,200,2,00121,India
920839,2023-05-13,1006,Blush,150,300,150,2,00466,India
219628,2023-05-13,1004,Eyeliner,100,200,100,2,00101,India
219628,2023-05-13,1006,Blush,150,300,150,2,00101,India
219628,2023-05-13,1008,Makeup Remover,80,160,80,2,00101,India
219628,2023-05-13,1003,Foundation,300,600,300,2,00101,India
201355,2023-05-13,1009,Moisturizer,250,500,250,1,00009,India
201355,2023-05-13,1008,Makeup Remover,80,160,80,2,00009,India
605821,2023-05-13,1008,Makeup Remover,80,160,80,2,00439,India
605821,2023-05-13,1002,Mascara,200,400,200,2,00439,India
605821,2023-05-13,1012,Body Lotion,200,400,200,1,00439,India
605821,2023-05-13,1005,Nail Polish,50,100,50,2,00439,India
118787,2023-05-13,1012,Body Lotion,200,400,200,1,00162,India
118787,2023-05-13,1002,Mascara,200,400,200,2,00162,India
141872,2023-05-13,1003,Foundation,300,600,300,2,00146,India
141872,2023-05-13,1004,Eyeliner,100,200,100,2,00146,India
141872,2023-05-13,1008,Makeup Remover,80,160,80,2,00146,India
977977,2023-05-13,1009,Moisturizer,250,500,250,1,00386,India
977977,2023-05-13,1005,Nail Polish,50,100,50,2,00386,India
977977,2023-05-13,1001,Lipstick,150,300,150,2,00386,India
632765,2023-05-13,1006,Blush,150,300,150,2,00186,India
632765,2023-05-13,1005,Nail Polish,50,100,50,2,00186,India
756708,2023-05-13,1009,Moisturizer,250,500,250,1,00227,India
756708,2023-05-13,1001,Lipstick,150,300,150,2,00227,India
756708,2023-05-13,1005,Nail Polish,50,100,50,2,00227,India
402713,2023-05-13,1007,Eyeshadow,200,400,200,2,00121,India
402713,2023-05-13,1009,Moisturizer,250,500,250,1,00121,India
941059,2023-05-13,1012,Body Lotion,200,400,200,1,00130,India
941059,2023-05-13,1003,Foundation,300,600,300,2,00130,India
941059,2023-05-13,1008,Makeup Remover,80,160,80,2,00130,India
941059,2023-05-13,1009,Moisturizer,250,500,250,1,00130,India
923851,2023-05-13,1005,Nail Polish,50,100,50,2,00445,India
953148,2023-05-13,1012,Body Lotion,200,400,200,1,00198,India
953148,2023-05-13,1004,Eyeliner,100,200,100,2,00198,India
953148,2023-05-13,1001,Lipstick,150,300,150,2,00198,India
273378,2023-05-13,1004,Eyeliner,100,200,100,2,00399,India
273378,2023-05-13,1006,Blush,150,300,150,2,00399,India
927833,2023-05-13,1006,Blush,150,300,150,2,00080,India
927833,2023-05-13,1009,Moisturizer,250,500,250,1,00080,India
842600,2023-05-13,1003,Foundation,300,600,300,2,00192,India
842600,2023-05-13,1001,Lipstick,150,300,150,2,00192,India
842600,2023-05-13,1008,Makeup Remover,80,160,80,2,00192,India
189007,2023-05-13,1008,Makeup Remover,80,160,80,2,00187,India
189007,2023-05-13,1007,Eyeshadow,200,400,200,2,00187,India
189007,2023-05-13,1003,Foundation,300,600,300,2,00187,India
189007,2023-05-13,1005,Nail Polish,50,100,50,2,00187,India
189007,2023-05-13,1012,Body Lotion,200,400,200,1,00187,India
561732,2023-05-13,1007,Eyeshadow,200,400,200,2,00233,India
561732,2023-05-13,1005,Nail Polish,50,100,50,2,00233,India
561732,2023-05-13,1002,Mascara,200,400,200,2,00233,India
561732,2023-05-13,1012,Body Lotion,200,400,200,1,00233,India
429776,2023-05-13,1003,Foundation,300,600,300,2,00156,India
928992,2023-05-13,1012,Body Lotion,200,400,200,1,00081,India
928992,2023-05-13,1002,Mascara,200,400,200,2,00081,India
928992,2023-05-13,1007,Eyeshadow,200,400,200,2,00081,India
479098,2023-05-13,1004,Eyeliner,100,200,100,2,00403,India
933706,2023-05-13,1007,Eyeshadow,200,400,200,2,00435,India
933706,2023-05-13,1009,Moisturizer,250,500,250,1,00435,India
933706,2023-05-13,1005,Nail Polish,50,100,50,2,00435,India
820783,2023-05-13,1001,Lipstick,150,300,150,2,00355,India
820783,2023-05-13,1012,Body Lotion,200,400,200,1,00355,India
820783,2023-05-13,1005,Nail Polish,50,100,50,2,00355,India
391028,2023-05-13,1002,Mascara,200,400,200,2,00354,India
391028,2023-05-13,1004,Eyeliner,100,200,100,2,00354,India
391028,2023-05-13,1007,Eyeshadow,200,400,200,2,00354,India
391028,2023-05-13,1005,Nail Polish,50,100,50,2,00354,India
391028,2023-05-13,1012,Body Lotion,200,400,200,1,00354,India
820220,2023-05-13,1002,Mascara,200,400,200,2,00375,India
820220,2023-05-13,1001,Lipstick,150,300,150,2,00375,India
918013,2023-05-13,1007,Eyeshadow,200,400,200,2,00349,India
918013,2023-05-13,1004,Eyeliner,100,200,100,2,00349,India
918013,2023-05-13,1008,Makeup Remover,80,160,80,2,00349,India
138560,2023-05-13,1005,Nail Polish,50,100,50,2,00330,India
138560,2023-05-13,1003,Foundation,300,600,300,2,00330,India
138560,2023-05-13,1008,Makeup Remover,80,160,80,2,00330,India
498254,2023-05-14,1012,Body Lotion,200,400,200,1,00294,India
498254,2023-05-14,1009,Moisturizer,250,500,250,1,00294,India
498254,2023-05-14,1008,Makeup Remover,80,160,80,2,00294,India
498254,2023-05-14,1007,Eyeshadow,200,400,200,2,00294,India
386040,2023-05-14,1004,Eyeliner,100,200,100,2,00230,India
386040,2023-05-14,1009,Moisturizer,250,500,250,1,00230,India
309655,2023-05-14,1009,Moisturizer,250,500,250,1,00026,India
309655,2023-05-14,1005,Nail Polish,50,100,50,2,00026,India
309655,2023-05-14,1007,Eyeshadow,200,400,200,2,00026,India
309655,2023-05-14,1002,Mascara,200,400,200,2,00026,India
309655,2023-05-14,1008,Makeup Remover,80,160,80,2,00026,India
510908,2023-05-14,1003,Foundation,300,600,300,2,00345,India
510908,2023-05-14,1002,Mascara,200,400,200,2,00345,India
179830,2023-05-14,1003,Foundation,300,600,300,2,00047,India
179830,2023-05-14,1004,Eyeliner,100,200,100,2,00047,India
179830,2023-05-14,1002,Mascara,200,400,200,2,00047,India
986128,2023-05-14,1006,Blush,150,300,150,2,00270,India
986128,2023-05-14,1003,Foundation,300,600,300,2,00270,India
986128,2023-05-14,1012,Body Lotion,200,400,200,1,00270,India
986128,2023-05-14,1009,Moisturizer,250,500,250,1,00270,India
565276,2023-05-14,1007,Eyeshadow,200,400,200,2,00186,India
343518,2023-05-14,1008,Makeup Remover,80,160,80,2,00472,India
343518,2023-05-14,1004,Eyeliner,100,200,100,2,00472,India
343518,2023-05-14,1006,Blush,150,300,150,2,00472,India
606186,2023-05-14,1012,Body Lotion,200,400,200,1,00126,India
606186,2023-05-14,1005,Nail Polish,50,100,50,2,00126,India
126704,2023-05-14,1002,Mascara,200,400,200,2,00288,India
126704,2023-05-14,1004,Eyeliner,100,200,100,2,00288,India
126704,2023-05-14,1007,Eyeshadow,200,400,200,2,00288,India
126704,2023-05-14,1003,Foundation,300,600,300,2,00288,India
187157,2023-05-14,1012,Body Lotion,200,400,200,1,00134,India
878174,2023-05-14,1009,Moisturizer,250,500,250,1,00222,India
204366,2023-05-14,1008,Makeup Remover,80,160,80,2,00361,India
204366,2023-05-14,1012,Body Lotion,200,400,200,1,00361,India
204366,2023-05-14,1002,Mascara,200,400,200,2,00361,India
853239,2023-05-14,1009,Moisturizer,250,500,250,1,00023,India
461695,2023-05-14,1002,Mascara,200,400,200,2,00137,India
461695,2023-05-14,1005,Nail Polish,50,100,50,2,00137,India
632264,2023-05-14,1005,Nail Polish,50,100,50,2,00010,India
632264,2023-05-14,1006,Blush,150,300,150,2,00010,India
151209,2023-05-14,1007,Eyeshadow,200,400,200,2,00455,India
151209,2023-05-14,1001,Lipstick,150,300,150,2,00455,India
203624,2023-05-14,1003,Foundation,300,600,300,2,00414,India
203624,2023-05-14,1009,Moisturizer,250,500,250,1,00414,India
203624,2023-05-14,1012,Body Lotion,200,400,200,1,00414,India
535340,2023-05-14,1012,Body Lotion,200,400,200,1,00417,India
388354,2023-05-14,1006,Blush,150,300,150,2,00442,India
388354,2023-05-14,1005,Nail Polish,50,100,50,2,00442,India
388354,2023-05-14,1003,Foundation,300,600,300,2,00442,India
388354,2023-05-14,1001,Lipstick,150,300,150,2,00442,India
169562,2023-05-14,1012,Body Lotion,200,400,200,1,00163,India
169562,2023-05-14,1005,Nail Polish,50,100,50,2,00163,India
169562,2023-05-14,1001,Lipstick,150,300,150,2,00163,India
169562,2023-05-14,1006,Blush,150,300,150,2,00163,India
169562,2023-05-14,1003,Foundation,300,600,300,2,00163,India
504424,2023-05-14,1005,Nail Polish,50,100,50,2,00121,India
265818,2023-05-14,1008,Makeup Remover,80,160,80,2,00001,India
450150,2023-05-14,1004,Eyeliner,100,200,100,2,00002,India
450150,2023-05-14,1007,Eyeshadow,200,400,200,2,00002,India
450150,2023-05-14,1002,Mascara,200,400,200,2,00002,India
450150,2023-05-14,1001,Lipstick,150,300,150,2,00002,India
209130,2023-05-14,1001,Lipstick,150,300,150,2,00376,India
542252,2023-05-14,1005,Nail Polish,50,100,50,2,00029,India
542252,2023-05-14,1008,Makeup Remover,80,160,80,2,00029,India
928076,2023-05-14,1009,Moisturizer,250,500,250,1,00199,India
113870,2023-05-14,1009,Moisturizer,250,500,250,1,00353,India
113870,2023-05-14,1008,Makeup Remover,80,160,80,2,00353,India
113870,2023-05-14,1001,Lipstick,150,300,150,2,00353,India
113870,2023-05-14,1002,Mascara,200,400,200,2,00353,India
641289,2023-05-14,1003,Foundation,300,600,300,2,00383,India
385361,2023-05-14,1002,Mascara,200,400,200,2,00226,India
385361,2023-05-14,1012,Body Lotion,200,400,200,1,00226,India
134412,2023-05-14,1004,Eyeliner,100,200,100,2,00450,India
134412,2023-05-14,1009,Moisturizer,250,500,250,1,00450,India
134412,2023-05-14,1005,Nail Polish,50,100,50,2,00450,India
907143,2023-05-14,1009,Moisturizer,250,500,250,1,00057,India
907143,2023-05-14,1001,Lipstick,150,300,150,2,00057,India
907143,2023-05-14,1005,Nail Polish,50,100,50,2,00057,India
459385,2023-05-14,1007,Eyeshadow,200,400,200,2,00351,India
459385,2023-05-14,1004,Eyeliner,100,200,100,2,00351,India
459385,2023-05-14,1002,Mascara,200,400,200,2,00351,India
459385,2023-05-14,1008,Makeup Remover,80,160,80,2,00351,India
105094,2023-05-14,1007,Eyeshadow,200,400,200,2,00386,India
105094,2023-05-14,1006,Blush,150,300,150,2,00386,India
105094,2023-05-14,1003,Foundation,300,600,300,2,00386,India
566751,2023-05-14,1003,Foundation,300,600,300,2,00245,India
566751,2023-05-14,1007,Eyeshadow,200,400,200,2,00245,India
566751,2023-05-14,1009,Moisturizer,250,500,250,1,00245,India
566751,2023-05-14,1004,Eyeliner,100,200,100,2,00245,India
996415,2023-05-14,1003,Foundation,300,600,300,2,00045,India
844822,2023-05-14,1012,Body Lotion,200,400,200,1,00254,India
844822,2023-05-14,1001,Lipstick,150,300,150,2,00254,India
421609,2023-05-14,1001,Lipstick,150,300,150,2,00377,India
421609,2023-05-14,1009,Moisturizer,250,500,250,1,00377,India
688391,2023-05-14,1012,Body Lotion,200,400,200,1,00239,India
484062,2023-05-14,1006,Blush,150,300,150,2,00118,India
888721,2023-05-14,1001,Lipstick,150,300,150,2,00174,India
932061,2023-05-14,1003,Foundation,300,600,300,2,00140,India
932061,2023-05-14,1001,Lipstick,150,300,150,2,00140,India
932061,2023-05-14,1008,Makeup Remover,80,160,80,2,00140,India
932061,2023-05-14,1004,Eyeliner,100,200,100,2,00140,India
932061,2023-05-14,1002,Mascara,200,400,200,2,00140,India
709134,2023-05-14,1009,Moisturizer,250,500,250,1,00440,India
709134,2023-05-14,1004,Eyeliner,100,200,100,2,00440,India
709134,2023-05-14,1008,Makeup Remover,80,160,80,2,00440,India
404677,2023-05-14,1009,Moisturizer,250,500,250,1,00089,India
404677,2023-05-14,1007,Eyeshadow,200,400,200,2,00089,India
404677,2023-05-14,1002,Mascara,200,400,200,2,00089,India
131784,2023-05-14,1006,Blush,150,300,150,2,00281,India
131784,2023-05-14,1001,Lipstick,150,300,150,2,00281,India
563212,2023-05-14,1001,Lipstick,150,300,150,2,00272,India
563212,2023-05-14,1006,Blush,150,300,150,2,00272,India
563212,2023-05-14,1002,Mascara,200,400,200,2,00272,India
383386,2023-05-14,1005,Nail Polish,50,100,50,2,00002,India
383386,2023-05-14,1003,Foundation,300,600,300,2,00002,India
383386,2023-05-14,1002,Mascara,200,400,200,2,00002,India
383386,2023-05-14,1004,Eyeliner,100,200,100,2,00002,India
453793,2023-05-15,1001,Lipstick,150,300,150,2,00332,India
453793,2023-05-15,1008,Makeup Remover,80,160,80,2,00332,India
453793,2023-05-15,1007,Eyeshadow,200,400,200,2,00332,India
677537,2023-05-15,1007,Eyeshadow,200,400,200,2,00379,India
677537,2023-05-15,1004,Eyeliner,100,200,100,2,00379,India
677537,2023-05-15,1001,Lipstick,150,300,150,2,00379,India
449360,2023-05-15,1002,Mascara,200,400,200,2,00288,India
245579,2023-05-15,1004,Eyeliner,100,200,100,2,00241,India
245579,2023-05-15,1005,Nail Polish,50,100,50,2,00241,India
888479,2023-05-15,1005,Nail Polish,50,100,50,2,00379,India
888479,2023-05-15,1012,Body Lotion,200,400,200,1,00379,India
888479,2023-05-15,1007,Eyeshadow,200,400,200,2,00379,India
888479,2023-05-15,1008,Makeup Remover,80,160,80,2,00379,India
909232,2023-05-15,1008,Makeup Remover,80,160,80,2,00317,India
909232,2023-05-15,1001,Lipstick,150,300,150,2,00317,India
909232,2023-05-15,1002,Mascara,200,400,200,2,00317,India
844886,2023-05-15,1007,Eyeshadow,200,400,200,2,00263,India
844886,2023-05-15,1004,Eyeliner,100,200,100,2,00263,India
693933,2023-05-15,1003,Foundation,300,600,300,2,00140,India
693933,2023-05-15,1006,Blush,150,300,150,2,00140,India
693933,2023-05-15,1004,Eyeliner,100,200,100,2,00140,India
103487,2023-05-15,1002,Mascara,200,400,200,2,00282,India
103487,2023-05-15,1009,Moisturizer,250,500,250,1,00282,India
278332,2023-05-15,1008,Makeup Remover,80,160,80,2,00032,India
278332,2023-05-15,1006,Blush,150,300,150,2,00032,India
278332,2023-05-15,1004,Eyeliner,100,200,100,2,00032,India
278332,2023-05-15,1003,Foundation,300,600,300,2,00032,India
250616,2023-05-15,1001,Lipstick,150,300,150,2,00185,India
250616,2023-05-15,1009,Moisturizer,250,500,250,1,00185,India
743959,2023-05-15,1012,Body Lotion,200,400,200,1,00287,India
743959,2023-05-15,1005,Nail Polish,50,100,50,2,00287,India
268498,2023-05-15,1001,Lipstick,150,300,150,2,00168,India
111097,2023-05-15,1012,Body Lotion,200,400,200,1,00175,India
111097,2023-05-15,1004,Eyeliner,100,200,100,2,00175,India
111097,2023-05-15,1007,Eyeshadow,200,400,200,2,00175,India
634093,2023-05-15,1001,Lipstick,150,300,150,2,00490,India
634093,2023-05-15,1009,Moisturizer,250,500,250,1,00490,India
387829,2023-05-15,1003,Foundation,300,600,300,2,00466,India
387829,2023-05-15,1006,Blush,150,300,150,2,00466,India
387829,2023-05-15,1012,Body Lotion,200,400,200,1,00466,India
245794,2023-05-15,1003,Foundation,300,600,300,2,00047,India
245794,2023-05-15,1009,Moisturizer,250,500,250,1,00047,India
774902,2023-05-15,1002,Mascara,200,400,200,2,00466,India
774902,2023-05-15,1007,Eyeshadow,200,400,200,2,00466,India
964419,2023-05-15,1003,Foundation,300,600,300,2,00471,India
964419,2023-05-15,1012,Body Lotion,200,400,200,1,00471,India
964419,2023-05-15,1006,Blush,150,300,150,2,00471,India
496213,2023-05-15,1009,Moisturizer,250,500,250,1,00500,India
496213,2023-05-15,1012,Body Lotion,200,400,200,1,00500,India
496213,2023-05-15,1004,Eyeliner,100,200,100,2,00500,India
496213,2023-05-15,1006,Blush,150,300,150,2,00500,India
726655,2023-05-15,1004,Eyeliner,100,200,100,2,00155,India
726655,2023-05-15,1009,Moisturizer,250,500,250,1,00155,India
726655,2023-05-15,1006,Blush,150,300,150,2,00155,India
641259,2023-05-15,1007,Eyeshadow,200,400,200,2,00395,India
214793,2023-05-15,1003,Foundation,300,600,300,2,00128,India
214793,2023-05-15,1004,Eyeliner,100,200,100,2,00128,India
214793,2023-05-15,1007,Eyeshadow,200,400,200,2,00128,India
756067,2023-05-15,1003,Foundation,300,600,300,2,00475,India
756067,2023-05-15,1002,Mascara,200,400,200,2,00475,India
756067,2023-05-15,1004,Eyeliner,100,200,100,2,00475,India
115192,2023-05-15,1003,Foundation,300,600,300,2,00344,India
115192,2023-05-15,1002,Mascara,200,400,200,2,00344,India
812276,2023-05-15,1003,Foundation,300,600,300,2,00353,India
812276,2023-05-15,1007,Eyeshadow,200,400,200,2,00353,India
419386,2023-05-15,1003,Foundation,300,600,300,2,00152,India
419386,2023-05-15,1008,Makeup Remover,80,160,80,2,00152,India
419386,2023-05-15,1007,Eyeshadow,200,400,200,2,00152,India
419386,2023-05-15,1002,Mascara,200,400,200,2,00152,India
570797,2023-05-15,1002,Mascara,200,400,200,2,00128,India
570797,2023-05-15,1012,Body Lotion,200,400,200,1,00128,India
570797,2023-05-15,1007,Eyeshadow,200,400,200,2,00128,India
570797,2023-05-15,1001,Lipstick,150,300,150,2,00128,India
192952,2023-05-15,1007,Eyeshadow,200,400,200,2,00472,India
192952,2023-05-15,1009,Moisturizer,250,500,250,1,00472,India
962087,2023-05-15,1001,Lipstick,150,300,150,2,00312,India
698061,2023-05-15,1002,Mascara,200,400,200,2,00031,India
698061,2023-05-15,1003,Foundation,300,600,300,2,00031,India
291785,2023-05-15,1003,Foundation,300,600,300,2,00394,India
291785,2023-05-15,1006,Blush,150,300,150,2,00394,India
992137,2023-05-15,1004,Eyeliner,100,200,100,2,00240,India
703372,2023-05-15,1002,Mascara,200,400,200,2,00490,India
703372,2023-05-15,1004,Eyeliner,100,200,100,2,00490,India
703372,2023-05-15,1001,Lipstick,150,300,150,2,00490,India
209331,2023-05-15,1007,Eyeshadow,200,400,200,2,00322,India
209331,2023-05-15,1008,Makeup Remover,80,160,80,2,00322,India
775788,2023-05-15,1009,Moisturizer,250,500,250,1,00281,India
775788,2023-05-15,1001,Lipstick,150,300,150,2,00281,India
775788,2023-05-15,1005,Nail Polish,50,100,50,2,00281,India
439469,2023-05-15,1003,Foundation,300,600,300,2,00079,India
439469,2023-05-15,1004,Eyeliner,100,200,100,2,00079,India
439469,2023-05-15,1005,Nail Polish,50,100,50,2,00079,India
439469,2023-05-15,1002,Mascara,200,400,200,2,00079,India
439469,2023-05-15,1007,Eyeshadow,200,400,200,2,00079,India
534245,2023-05-15,1007,Eyeshadow,200,400,200,2,00421,India
534245,2023-05-15,1008,Makeup Remover,80,160,80,2,00421,India
534245,2023-05-15,1009,Moisturizer,250,500,250,1,00421,India
534245,2023-05-15,1001,Lipstick,150,300,150,2,00421,India
646062,2023-05-15,1004,Eyeliner,100,200,100,2,00347,India
796619,2023-05-15,1002,Mascara,200,400,200,2,00236,India
117251,2023-05-15,1009,Moisturizer,250,500,250,1,00266,India
117251,2023-05-15,1003,Foundation,300,600,300,2,00266,India
117251,2023-05-15,1001,Lipstick,150,300,150,2,00266,India
451130,2023-05-15,1012,Body Lotion,200,400,200,1,00326,India
451130,2023-05-15,1006,Blush,150,300,150,2,00326,India
451130,2023-05-15,1004,Eyeliner,100,200,100,2,00326,India
367817,2023-05-15,1012,Body Lotion,200,400,200,1,00327,India
367817,2023-05-15,1004,Eyeliner,100,200,100,2,00327,India
367817,2023-05-15,1008,Makeup Remover,80,160,80,2,00327,India
367817,2023-05-15,1001,Lipstick,150,300,150,2,00327,India
794558,2023-05-15,1006,Blush,150,300,150,2,00429,India
794558,2023-05-15,1002,Mascara,200,400,200,2,00429,India
794558,2023-05-15,1004,Eyeliner,100,200,100,2,00429,India
425872,2023-05-16,1007,Eyeshadow,200,400,200,2,00463,India
425872,2023-05-16,1003,Foundation,300,600,300,2,00463,India
425872,2023-05-16,1005,Nail Polish,50,100,50,2,00463,India
845620,2023-05-16,1006,Blush,150,300,150,2,00322,India
845620,2023-05-16,1012,Body Lotion,200,400,200,1,00322,India
566506,2023-05-16,1004,Eyeliner,100,200,100,2,00337,India
566506,2023-05-16,1001,Lipstick,150,300,150,2,00337,India
566506,2023-05-16,1006,Blush,150,300,150,2,00337,India
717004,2023-05-16,1006,Blush,150,300,150,2,00324,India
717004,2023-05-16,1002,Mascara,200,400,200,2,00324,India
717004,2023-05-16,1008,Makeup Remover,80,160,80,2,00324,India
397325,2023-05-16,1007,Eyeshadow,200,400,200,2,00444,India
686856,2023-05-16,1012,Body Lotion,200,400,200,1,00082,India
686856,2023-05-16,1004,Eyeliner,100,200,100,2,00082,India
686856,2023-05-16,1005,Nail Polish,50,100,50,2,00082,India
686856,2023-05-16,1001,Lipstick,150,300,150,2,00082,India
686856,2023-05-16,1007,Eyeshadow,200,400,200,2,00082,India
444288,2023-05-16,1002,Mascara,200,400,200,2,00408,India
444288,2023-05-16,1009,Moisturizer,250,500,250,1,00408,India
444288,2023-05-16,1012,Body Lotion,200,400,200,1,00408,India
472013,2023-05-16,1006,Blush,150,300,150,2,00055,India
472013,2023-05-16,1001,Lipstick,150,300,150,2,00055,India
592447,2023-05-16,1001,Lipstick,150,300,150,2,00292,India
592447,2023-05-16,1009,Moisturizer,250,500,250,1,00292,India
246758,2023-05-16,1005,Nail Polish,50,100,50,2,00073,India
246758,2023-05-16,1006,Blush,150,300,150,2,00073,India
653206,2023-05-16,1001,Lipstick,150,300,150,2,00268,India
653206,2023-05-16,1007,Eyeshadow,200,400,200,2,00268,India
286637,2023-05-16,1006,Blush,150,300,150,2,00250,India
900807,2023-05-16,1012,Body Lotion,200,400,200,1,00147,India
572857,2023-05-16,1006,Blush,150,300,150,2,00330,India
572857,2023-05-16,1001,Lipstick,150,300,150,2,00330,India
264276,2023-05-16,1012,Body Lotion,200,400,200,1,00085,India
264276,2023-05-16,1007,Eyeshadow,200,400,200,2,00085,India
264276,2023-05-16,1009,Moisturizer,250,500,250,1,00085,India
264276,2023-05-16,1001,Lipstick,150,300,150,2,00085,India
120350,2023-05-16,1007,Eyeshadow,200,400,200,2,00213,India
120350,2023-05-16,1006,Blush,150,300,150,2,00213,India
120350,2023-05-16,1005,Nail Polish,50,100,50,2,00213,India
256922,2023-05-16,1012,Body Lotion,200,400,200,1,00186,India
256922,2023-05-16,1003,Foundation,300,600,300,2,00186,India
256922,2023-05-16,1008,Makeup Remover,80,160,80,2,00186,India
732889,2023-05-16,1008,Makeup Remover,80,160,80,2,00180,India
732889,2023-05-16,1001,Lipstick,150,300,150,2,00180,India
660857,2023-05-16,1008,Makeup Remover,80,160,80,2,00463,India
660857,2023-05-16,1001,Lipstick,150,300,150,2,00463,India
660857,2023-05-16,1006,Blush,150,300,150,2,00463,India
522329,2023-05-16,1001,Lipstick,150,300,150,2,00105,India
522329,2023-05-16,1008,Makeup Remover,80,160,80,2,00105,India
522329,2023-05-16,1006,Blush,150,300,150,2,00105,India
807578,2023-05-16,1002,Mascara,200,400,200,2,00499,India
807578,2023-05-16,1009,Moisturizer,250,500,250,1,00499,India
807578,2023-05-16,1012,Body Lotion,200,400,200,1,00499,India
807578,2023-05-16,1008,Makeup Remover,80,160,80,2,00499,India
807578,2023-05-16,1001,Lipstick,150,300,150,2,00499,India
559351,2023-05-16,1006,Blush,150,300,150,2,00210,India
559351,2023-05-16,1012,Body Lotion,200,400,200,1,00210,India
559351,2023-05-16,1004,Eyeliner,100,200,100,2,00210,India
359672,2023-05-16,1001,Lipstick,150,300,150,2,00329,India
950707,2023-05-16,1005,Nail Polish,50,100,50,2,00241,India
950707,2023-05-16,1012,Body Lotion,200,400,200,1,00241,India
950707,2023-05-16,1007,Eyeshadow,200,400,200,2,00241,India
849182,2023-05-16,1009,Moisturizer,250,500,250,1,00352,India
849182,2023-05-16,1004,Eyeliner,100,200,100,2,00352,India
849182,2023-05-16,1005,Nail Polish,50,100,50,2,00352,India
849182,2023-05-16,1008,Makeup Remover,80,160,80,2,00352,India
954466,2023-05-16,1001,Lipstick,150,300,150,2,00490,India
954466,2023-05-16,1002,Mascara,200,400,200,2,00490,India
784314,2023-05-16,1009,Moisturizer,250,500,250,1,00452,India
716595,2023-05-16,1003,Foundation,300,600,300,2,00136,India
716595,2023-05-16,1007,Eyeshadow,200,400,200,2,00136,India
716595,2023-05-16,1004,Eyeliner,100,200,100,2,00136,India
692468,2023-05-16,1004,Eyeliner,100,200,100,2,00192,India
692468,2023-05-16,1001,Lipstick,150,300,150,2,00192,India
692468,2023-05-16,1003,Foundation,300,600,300,2,00192,India
108691,2023-05-16,1005,Nail Polish,50,100,50,2,00209,India
726377,2023-05-16,1007,Eyeshadow,200,400,200,2,00068,India
395442,2023-05-16,1001,Lipstick,150,300,150,2,00448,India
395442,2023-05-16,1008,Makeup Remover,80,160,80,2,00448,India
395442,2023-05-16,1004,Eyeliner,100,200,100,2,00448,India
232188,2023-05-16,1012,Body Lotion,200,400,200,1,00391,India
232188,2023-05-16,1003,Foundation,300,600,300,2,00391,India
232188,2023-05-16,1007,Eyeshadow,200,400,200,2,00391,India
760675,2023-05-16,1009,Moisturizer,250,500,250,1,00171,India
760675,2023-05-16,1008,Makeup Remover,80,160,80,2,00171,India
556922,2023-05-16,1005,Nail Polish,50,100,50,2,00449,India
556922,2023-05-16,1003,Foundation,300,600,300,2,00449,India
556922,2023-05-16,1004,Eyeliner,100,200,100,2,00449,India
556922,2023-05-16,1008,Makeup Remover,80,160,80,2,00449,India
783620,2023-05-16,1009,Moisturizer,250,500,250,1,00389,India
783620,2023-05-16,1008,Makeup Remover,80,160,80,2,00389,India
783620,2023-05-16,1005,Nail Polish,50,100,50,2,00389,India
788608,2023-05-16,1006,Blush,150,300,150,2,00460,India
788608,2023-05-16,1004,Eyeliner,100,200,100,2,00460,India
788608,2023-05-16,1001,Lipstick,150,300,150,2,00460,India
788608,2023-05-16,1005,Nail Polish,50,100,50,2,00460,India
788608,2023-05-16,1008,Makeup Remover,80,160,80,2,00460,India
164146,2023-05-16,1009,Moisturizer,250,500,250,1,00299,India
594130,2023-05-16,1002,Mascara,200,400,200,2,00490,India
218062,2023-05-16,1012,Body Lotion,200,400,200,1,00017,India
615414,2023-05-16,1001,Lipstick,150,300,150,2,00080,India
615414,2023-05-16,1004,Eyeliner,100,200,100,2,00080,India
182555,2023-05-16,1012,Body Lotion,200,400,200,1,00199,India
182555,2023-05-16,1003,Foundation,300,600,300,2,00199,India
555396,2023-05-16,1006,Blush,150,300,150,2,00251,India
555396,2023-05-16,1009,Moisturizer,250,500,250,1,00251,India
917330,2023-05-16,1007,Eyeshadow,200,400,200,2,00148,India
917330,2023-05-16,1005,Nail Polish,50,100,50,2,00148,India
920416,2023-05-16,1008,Makeup Remover,80,160,80,2,00246,India
920416,2023-05-16,1001,Lipstick,150,300,150,2,00246,India
146345,2023-05-17,1001,Lipstick,150,300,150,2,00199,India
146345,2023-05-17,1003,Foundation,300,600,300,2,00199,India
146345,2023-05-17,1006,Blush,150,300,150,2,00199,India
146345,2023-05-17,1004,Eyeliner,100,200,100,2,00199,India
907626,2023-05-17,1012,Body Lotion,200,400,200,1,00204,India
907626,2023-05-17,1005,Nail Polish,50,100,50,2,00204,India
119357,2023-05-17,1008,Makeup Remover,80,160,80,2,00192,India
119357,2023-05-17,1007,Eyeshadow,200,400,200,2,00192,India
879062,2023-05-17,1012,Body Lotion,200,400,200,1,00082,India
879062,2023-05-17,1008,Makeup Remover,80,160,80,2,00082,India
306553,2023-05-17,1006,Blush,150,300,150,2,00160,India
306553,2023-05-17,1001,Lipstick,150,300,150,2,00160,India
380949,2023-05-17,1002,Mascara,200,400,200,2,00402,India
380949,2023-05-17,1003,Foundation,300,600,300,2,00402,India
498964,2023-05-17,1009,Moisturizer,250,500,250,1,00403,India
498964,2023-05-17,1005,Nail Polish,50,100,50,2,00403,India
498964,2023-05-17,1001,Lipstick,150,300,150,2,00403,India
498964,2023-05-17,1003,Foundation,300,600,300,2,00403,India
306658,2023-05-17,1008,Makeup Remover,80,160,80,2,00143,India
306658,2023-05-17,1003,Foundation,300,600,300,2,00143,India
306658,2023-05-17,1002,Mascara,200,400,200,2,00143,India
912321,2023-05-17,1004,Eyeliner,100,200,100,2,00244,India
912321,2023-05-17,1006,Blush,150,300,150,2,00244,India
454562,2023-05-17,1001,Lipstick,150,300,150,2,00243,India
454562,2023-05-17,1008,Makeup Remover,80,160,80,2,00243,India
586471,2023-05-17,1008,Makeup Remover,80,160,80,2,00050,India
586471,2023-05-17,1001,Lipstick,150,300,150,2,00050,India
586471,2023-05-17,1009,Moisturizer,250,500,250,1,00050,India
346292,2023-05-17,1004,Eyeliner,100,200,100,2,00265,India
346292,2023-05-17,1003,Foundation,300,600,300,2,00265,India
346292,2023-05-17,1002,Mascara,200,400,200,2,00265,India
652077,2023-05-17,1004,Eyeliner,100,200,100,2,00426,India
745522,2023-05-17,1007,Eyeshadow,200,400,200,2,00025,India
745522,2023-05-17,1008,Makeup Remover,80,160,80,2,00025,India
745522,2023-05-17,1012,Body Lotion,200,400,200,1,00025,India
745522,2023-05-17,1009,Moisturizer,250,500,250,1,00025,India
745522,2023-05-17,1006,Blush,150,300,150,2,00025,India
190741,2023-05-17,1002,Mascara,200,400,200,2,00267,India
728720,2023-05-17,1004,Eyeliner,100,200,100,2,00091,India
728720,2023-05-17,1009,Moisturizer,250,500,250,1,00091,India
480028,2023-05-17,1003,Foundation,300,600,300,2,00465,India
480028,2023-05-17,1012,Body Lotion,200,400,200,1,00465,India
828430,2023-05-17,1006,Blush,150,300,150,2,00472,India
828430,2023-05-17,1002,Mascara,200,400,200,2,00472,India
828430,2023-05-17,1007,Eyeshadow,200,400,200,2,00472,India
941872,2023-05-17,1005,Nail Polish,50,100,50,2,00322,India
941872,2023-05-17,1003,Foundation,300,600,300,2,00322,India
941872,2023-05-17,1007,Eyeshadow,200,400,200,2,00322,India
149301,2023-05-17,1003,Foundation,300,600,300,2,00066,India
502938,2023-05-17,1004,Eyeliner,100,200,100,2,00203,India
502938,2023-05-17,1002,Mascara,200,400,200,2,00203,India
257503,2023-05-17,1004,Eyeliner,100,200,100,2,00153,India
257503,2023-05-17,1003,Foundation,300,600,300,2,00153,India
257503,2023-05-17,1001,Lipstick,150,300,150,2,00153,India
257503,2023-05-17,1012,Body Lotion,200,400,200,1,00153,India
769088,2023-05-17,1006,Blush,150,300,150,2,00102,India
769088,2023-05-17,1008,Makeup Remover,80,160,80,2,00102,India
769088,2023-05-17,1003,Foundation,300,600,300,2,00102,India
769088,2023-05-17,1002,Mascara,200,400,200,2,00102,India
769088,2023-05-17,1005,Nail Polish,50,100,50,2,00102,India
993307,2023-05-17,1007,Eyeshadow,200,400,200,2,00138,India
993307,2023-05-17,1003,Foundation,300,600,300,2,00138,India
993307,2023-05-17,1002,Mascara,200,400,200,2,00138,India
956712,2023-05-17,1008,Makeup Remover,80,160,80,2,00467,India
792338,2023-05-17,1009,Moisturizer,250,500,250,1,00477,India
792338,2023-05-17,1001,Lipstick,150,300,150,2,00477,India
324000,2023-05-17,1003,Foundation,300,600,300,2,00142,India
324000,2023-05-17,1009,Moisturizer,250,500,250,1,00142,India
789741,2023-05-17,1002,Mascara,200,400,200,2,00262,India
789741,2023-05-17,1009,Moisturizer,250,500,250,1,00262,India
789741,2023-05-17,1005,Nail Polish,50,100,50,2,00262,India
900174,2023-05-17,1008,Makeup Remover,80,160,80,2,00295,India
900174,2023-05-17,1007,Eyeshadow,200,400,200,2,00295,India
900174,2023-05-17,1012,Body Lotion,200,400,200,1,00295,India
218688,2023-05-17,1003,Foundation,300,600,300,2,00423,India
360466,2023-05-17,1005,Nail Polish,50,100,50,2,00290,India
360466,2023-05-17,1003,Foundation,300,600,300,2,00290,India
360466,2023-05-17,1009,Moisturizer,250,500,250,1,00290,India
220975,2023-05-17,1007,Eyeshadow,200,400,200,2,00155,India
220975,2023-05-17,1003,Foundation,300,600,300,2,00155,India
220975,2023-05-17,1001,Lipstick,150,300,150,2,00155,India
710469,2023-05-17,1004,Eyeliner,100,200,100,2,00198,India
710469,2023-05-17,1006,Blush,150,300,150,2,00198,India
710469,2023-05-17,1009,Moisturizer,250,500,250,1,00198,India
713418,2023-05-17,1002,Mascara,200,400,200,2,00371,India
362855,2023-05-17,1009,Moisturizer,250,500,250,1,00446,India
362855,2023-05-17,1006,Blush,150,300,150,2,00446,India
362855,2023-05-17,1002,Mascara,200,400,200,2,00446,India
362855,2023-05-17,1005,Nail Polish,50,100,50,2,00446,India
362855,2023-05-17,1003,Foundation,300,600,300,2,00446,India
641968,2023-05-17,1012,Body Lotion,200,400,200,1,00229,India
641968,2023-05-17,1004,Eyeliner,100,200,100,2,00229,India
641968,2023-05-17,1006,Blush,150,300,150,2,00229,India
641968,2023-05-17,1008,Makeup Remover,80,160,80,2,00229,India
631357,2023-05-17,1006,Blush,150,300,150,2,00305,India
631357,2023-05-17,1002,Mascara,200,400,200,2,00305,India
631357,2023-05-17,1007,Eyeshadow,200,400,200,2,00305,India
627523,2023-05-17,1008,Makeup Remover,80,160,80,2,00494,India
627523,2023-05-17,1007,Eyeshadow,200,400,200,2,00494,India
627523,2023-05-17,1009,Moisturizer,250,500,250,1,00494,India
366425,2023-05-17,1002,Mascara,200,400,200,2,00230,India
705305,2023-05-17,1006,Blush,150,300,150,2,00233,India
323501,2023-05-18,1005,Nail Polish,50,100,50,2,00456,India
552446,2023-05-18,1003,Foundation,300,600,300,2,00244,India
552446,2023-05-18,1012,Body Lotion,200,400,200,1,00244,India
552446,2023-05-18,1001,Lipstick,150,300,150,2,00244,India
552446,2023-05-18,1006,Blush,150,300,150,2,00244,India
119911,2023-05-18,1004,Eyeliner,100,200,100,2,00149,India
119911,2023-05-18,1001,Lipstick,150,300,150,2,00149,India
899308,2023-05-18,1009,Moisturizer,250,500,250,1,00345,India
899308,2023-05-18,1004,Eyeliner,100,200,100,2,00345,India
899308,2023-05-18,1002,Mascara,200,400,200,2,00345,India
304214,2023-05-18,1001,Lipstick,150,300,150,2,00029,India
304214,2023-05-18,1007,Eyeshadow,200,400,200,2,00029,India
612508,2023-05-18,1008,Makeup Remover,80,160,80,2,00404,India
612508,2023-05-18,1009,Moisturizer,250,500,250,1,00404,India
612508,2023-05-18,1007,Eyeshadow,200,400,200,2,00404,India
612508,2023-05-18,1012,Body Lotion,200,400,200,1,00404,India
691272,2023-05-18,1007,Eyeshadow,200,400,200,2,00281,India
691272,2023-05-18,1002,Mascara,200,400,200,2,00281,India
239028,2023-05-18,1005,Nail Polish,50,100,50,2,00162,India
258375,2023-05-18,1009,Moisturizer,250,500,250,1,00382,India
258375,2023-05-18,1004,Eyeliner,100,200,100,2,00382,India
258375,2023-05-18,1007,Eyeshadow,200,400,200,2,00382,India
258375,2023-05-18,1006,Blush,150,300,150,2,00382,India
786771,2023-05-18,1004,Eyeliner,100,200,100,2,00402,India
786771,2023-05-18,1003,Foundation,300,600,300,2,00402,India
656571,2023-05-18,1003,Foundation,300,600,300,2,00378,India
656571,2023-05-18,1007,Eyeshadow,200,400,200,2,00378,India
656571,2023-05-18,1005,Nail Polish,50,100,50,2,00378,India
656571,2023-05-18,1004,Eyeliner,100,200,100,2,00378,India
523705,2023-05-18,1001,Lipstick,150,300,150,2,00238,India
523705,2023-05-18,1006,Blush,150,300,150,2,00238,India
523705,2023-05-18,1004,Eyeliner,100,200,100,2,00238,India
286761,2023-05-18,1007,Eyeshadow,200,400,200,2,00429,India
286761,2023-05-18,1005,Nail Polish,50,100,50,2,00429,India
622195,2023-05-18,1006,Blush,150,300,150,2,00404,India
622195,2023-05-18,1003,Foundation,300,600,300,2,00404,India
622195,2023-05-18,1002,Mascara,200,400,200,2,00404,India
622195,2023-05-18,1012,Body Lotion,200,400,200,1,00404,India
495481,2023-05-18,1008,Makeup Remover,80,160,80,2,00091,India
495481,2023-05-18,1012,Body Lotion,200,400,200,1,00091,India
495481,2023-05-18,1004,Eyeliner,100,200,100,2,00091,India
588838,2023-05-18,1005,Nail Polish,50,100,50,2,00198,India
588838,2023-05-18,1008,Makeup Remover,80,160,80,2,00198,India
639985,2023-05-18,1004,Eyeliner,100,200,100,2,00105,India
639985,2023-05-18,1007,Eyeshadow,200,400,200,2,00105,India
639985,2023-05-18,1001,Lipstick,150,300,150,2,00105,India
887953,2023-05-18,1009,Moisturizer,250,500,250,1,00015,India
887953,2023-05-18,1005,Nail Polish,50,100,50,2,00015,India
887953,2023-05-18,1003,Foundation,300,600,300,2,00015,India
887953,2023-05-18,1004,Eyeliner,100,200,100,2,00015,India
532381,2023-05-18,1003,Foundation,300,600,300,2,00164,India
532381,2023-05-18,1012,Body Lotion,200,400,200,1,00164,India
744968,2023-05-18,1007,Eyeshadow,200,400,200,2,00008,India
262583,2023-05-18,1001,Lipstick,150,300,150,2,00400,India
262583,2023-05-18,1009,Moisturizer,250,500,250,1,00400,India
262583,2023-05-18,1007,Eyeshadow,200,400,200,2,00400,India
262583,2023-05-18,1004,Eyeliner,100,200,100,2,00400,India
851203,2023-05-18,1002,Mascara,200,400,200,2,00275,India
865664,2023-05-18,1001,Lipstick,150,300,150,2,00271,India
865664,2023-05-18,1009,Moisturizer,250,500,250,1,00271,India
359858,2023-05-18,1002,Mascara,200,400,200,2,00464,India
359858,2023-05-18,1006,Blush,150,300,150,2,00464,India
138949,2023-05-18,1008,Makeup Remover,80,160,80,2,00208,India
138949,2023-05-18,1006,Blush,150,300,150,2,00208,India
203391,2023-05-18,1006,Blush,150,300,150,2,00101,India
939587,2023-05-18,1006,Blush,150,300,150,2,00303,India
939587,2023-05-18,1008,Makeup Remover,80,160,80,2,00303,India
115458,2023-05-18,1005,Nail Polish,50,100,50,2,00499,India
115458,2023-05-18,1002,Mascara,200,400,200,2,00499,India
115458,2023-05-18,1007,Eyeshadow,200,400,200,2,00499,India
156947,2023-05-18,1001,Lipstick,150,300,150,2,00416,India
156947,2023-05-18,1003,Foundation,300,600,300,2,00416,India
156947,2023-05-18,1004,Eyeliner,100,200,100,2,00416,India
156947,2023-05-18,1005,Nail Polish,50,100,50,2,00416,India
156947,2023-05-18,1007,Eyeshadow,200,400,200,2,00416,India
107851,2023-05-18,1006,Blush,150,300,150,2,00308,India
107851,2023-05-18,1001,Lipstick,150,300,150,2,00308,India
860409,2023-05-18,1004,Eyeliner,100,200,100,2,00398,India
460822,2023-05-18,1001,Lipstick,150,300,150,2,00389,India
123276,2023-05-18,1009,Moisturizer,250,500,250,1,00357,India
123276,2023-05-18,1004,Eyeliner,100,200,100,2,00357,India
123276,2023-05-18,1007,Eyeshadow,200,400,200,2,00357,India
957413,2023-05-18,1007,Eyeshadow,200,400,200,2,00453,India
957413,2023-05-18,1005,Nail Polish,50,100,50,2,00453,India
992977,2023-05-18,1007,Eyeshadow,200,400,200,2,00227,India
992977,2023-05-18,1002,Mascara,200,400,200,2,00227,India
992977,2023-05-18,1004,Eyeliner,100,200,100,2,00227,India
992977,2023-05-18,1006,Blush,150,300,150,2,00227,India
442661,2023-05-18,1006,Blush,150,300,150,2,00368,India
442661,2023-05-18,1005,Nail Polish,50,100,50,2,00368,India
478085,2023-05-18,1007,Eyeshadow,200,400,200,2,00206,India
478085,2023-05-18,1001,Lipstick,150,300,150,2,00206,India
478085,2023-05-18,1003,Foundation,300,600,300,2,00206,India
478085,2023-05-18,1005,Nail Polish,50,100,50,2,00206,India
582068,2023-05-18,1008,Makeup Remover,80,160,80,2,00250,India
582068,2023-05-18,1006,Blush,150,300,150,2,00250,India
582068,2023-05-18,1005,Nail Polish,50,100,50,2,00250,India
582068,2023-05-18,1004,Eyeliner,100,200,100,2,00250,India
582068,2023-05-18,1007,Eyeshadow,200,400,200,2,00250,India
482703,2023-05-18,1004,Eyeliner,100,200,100,2,00248,India
482703,2023-05-18,1008,Makeup Remover,80,160,80,2,00248,India
482703,2023-05-18,1005,Nail Polish,50,100,50,2,00248,India
482703,2023-05-18,1001,Lipstick,150,300,150,2,00248,India
511023,2023-05-18,1002,Mascara,200,400,200,2,00243,India
860118,2023-05-18,1003,Foundation,300,600,300,2,00250,India
860118,2023-05-18,1008,Makeup Remover,80,160,80,2,00250,India
860118,2023-05-18,1001,Lipstick,150,300,150,2,00250,India
112592,2023-05-18,1002,Mascara,200,400,200,2,00400,India
112592,2023-05-18,1009,Moisturizer,250,500,250,1,00400,India
112592,2023-05-18,1006,Blush,150,300,150,2,00400,India
545626,2023-05-18,1007,Eyeshadow,200,400,200,2,00358,India
996314,2023-05-18,1004,Eyeliner,100,200,100,2,00330,India
996314,2023-05-18,1007,Eyeshadow,200,400,200,2,00330,India
996314,2023-05-18,1002,Mascara,200,400,200,2,00330,India
473297,2023-05-18,1008,Makeup Remover,80,160,80,2,00147,India
473297,2023-05-18,1012,Body Lotion,200,400,200,1,00147,India
473297,2023-05-18,1002,Mascara,200,400,200,2,00147,India
484955,2023-05-18,1003,Foundation,300,600,300,2,00034,India
484955,2023-05-18,1008,Makeup Remover,80,160,80,2,00034,India
484955,2023-05-18,1009,Moisturizer,250,500,250,1,00034,India
484955,2023-05-18,1001,Lipstick,150,300,150,2,00034,India
484955,2023-05-18,1002,Mascara,200,400,200,2,00034,India
351844,2023-05-18,1006,Blush,150,300,150,2,00222,India
230724,2023-05-18,1003,Foundation,300,600,300,2,00140,India
230724,2023-05-18,1004,Eyeliner,100,200,100,2,00140,India
357106,2023-05-18,1009,Moisturizer,250,500,250,1,00423,India
287817,2023-05-18,1009,Moisturizer,250,500,250,1,00088,India
287817,2023-05-18,1006,Blush,150,300,150,2,00088,India
287817,2023-05-18,1007,Eyeshadow,200,400,200,2,00088,India
173892,2023-05-19,1005,Nail Polish,50,100,50,2,00478,India
183480,2023-05-19,1003,Foundation,300,600,300,2,00466,India
183480,2023-05-19,1005,Nail Polish,50,100,50,2,00466,India
183480,2023-05-19,1012,Body Lotion,200,400,200,1,00466,India
183480,2023-05-19,1008,Makeup Remover,80,160,80,2,00466,India
819420,2023-05-19,1003,Foundation,300,600,300,2,00059,India
819420,2023-05-19,1002,Mascara,200,400,200,2,00059,India
819420,2023-05-19,1005,Nail Polish,50,100,50,2,00059,India
408493,2023-05-19,1007,Eyeshadow,200,400,200,2,00107,India
408493,2023-05-19,1006,Blush,150,300,150,2,00107,India
408493,2023-05-19,1012,Body Lotion,200,400,200,1,00107,India
409660,2023-05-19,1004,Eyeliner,100,200,100,2,00117,India
409660,2023-05-19,1001,Lipstick,150,300,150,2,00117,India
409660,2023-05-19,1002,Mascara,200,400,200,2,00117,India
500134,2023-05-19,1002,Mascara,200,400,200,2,00437,India
500134,2023-05-19,1001,Lipstick,150,300,150,2,00437,India
500134,2023-05-19,1012,Body Lotion,200,400,200,1,00437,India
500134,2023-05-19,1007,Eyeshadow,200,400,200,2,00437,India
500134,2023-05-19,1003,Foundation,300,600,300,2,00437,India
280857,2023-05-19,1007,Eyeshadow,200,400,200,2,00116,India
280857,2023-05-19,1009,Moisturizer,250,500,250,1,00116,India
280857,2023-05-19,1012,Body Lotion,200,400,200,1,00116,India
712864,2023-05-19,1004,Eyeliner,100,200,100,2,00183,India
712864,2023-05-19,1009,Moisturizer,250,500,250,1,00183,India
712864,2023-05-19,1003,Foundation,300,600,300,2,00183,India
345990,2023-05-19,1006,Blush,150,300,150,2,00476,India
345990,2023-05-19,1002,Mascara,200,400,200,2,00476,India
345990,2023-05-19,1008,Makeup Remover,80,160,80,2,00476,India
723198,2023-05-19,1012,Body Lotion,200,400,200,1,00055,India
723198,2023-05-19,1001,Lipstick,150,300,150,2,00055,India
690290,2023-05-19,1006,Blush,150,300,150,2,00417,India
690290,2023-05-19,1008,Makeup Remover,80,160,80,2,00417,India
690290,2023-05-19,1001,Lipstick,150,300,150,2,00417,India
879155,2023-05-19,1007,Eyeshadow,200,400,200,2,00069,India
879155,2023-05-19,1006,Blush,150,300,150,2,00069,India
879155,2023-05-19,1005,Nail Polish,50,100,50,2,00069,India
652266,2023-05-19,1008,Makeup Remover,80,160,80,2,00398,India
652266,2023-05-19,1006,Blush,150,300,150,2,00398,India
652266,2023-05-19,1004,Eyeliner,100,200,100,2,00398,India
703016,2023-05-19,1005,Nail Polish,50,100,50,2,00258,India
703016,2023-05-19,1006,Blush,150,300,150,2,00258,India
703016,2023-05-19,1003,Foundation,300,600,300,2,00258,India
582211,2023-05-19,1003,Foundation,300,600,300,2,00013,India
582211,2023-05-19,1012,Body Lotion,200,400,200,1,00013,India
582211,2023-05-19,1004,Eyeliner,100,200,100,2,00013,India
582211,2023-05-19,1006,Blush,150,300,150,2,00013,India
398060,2023-05-19,1003,Foundation,300,600,300,2,00115,India
203466,2023-05-19,1004,Eyeliner,100,200,100,2,00494,India
258037,2023-05-19,1012,Body Lotion,200,400,200,1,00120,India
258037,2023-05-19,1002,Mascara,200,400,200,2,00120,India
127812,2023-05-19,1003,Foundation,300,600,300,2,00042,India
793995,2023-05-19,1009,Moisturizer,250,500,250,1,00120,India
775735,2023-05-19,1008,Makeup Remover,80,160,80,2,00157,India
775735,2023-05-19,1002,Mascara,200,400,200,2,00157,India
821035,2023-05-19,1007,Eyeshadow,200,400,200,2,00246,India
821035,2023-05-19,1009,Moisturizer,250,500,250,1,00246,India
821035,2023-05-19,1001,Lipstick,150,300,150,2,00246,India
271578,2023-05-19,1004,Eyeliner,100,200,100,2,00088,India
271578,2023-05-19,1005,Nail Polish,50,100,50,2,00088,India
760444,2023-05-19,1001,Lipstick,150,300,150,2,00057,India
489563,2023-05-19,1005,Nail Polish,50,100,50,2,00347,India
489563,2023-05-19,1007,Eyeshadow,200,400,200,2,00347,India
489563,2023-05-19,1008,Makeup Remover,80,160,80,2,00347,India
489563,2023-05-19,1003,Foundation,300,600,300,2,00347,India
802019,2023-05-19,1001,Lipstick,150,300,150,2,00280,India
958095,2023-05-19,1012,Body Lotion,200,400,200,1,00333,India
933590,2023-05-19,1001,Lipstick,150,300,150,2,00338,India
933590,2023-05-19,1005,Nail Polish,50,100,50,2,00338,India
933590,2023-05-19,1008,Makeup Remover,80,160,80,2,00338,India
723256,2023-05-19,1008,Makeup Remover,80,160,80,2,00418,India
723256,2023-05-19,1007,Eyeshadow,200,400,200,2,00418,India
723256,2023-05-19,1006,Blush,150,300,150,2,00418,India
723256,2023-05-19,1003,Foundation,300,600,300,2,00418,India
625632,2023-05-19,1008,Makeup Remover,80,160,80,2,00277,India
625632,2023-05-19,1009,Moisturizer,250,500,250,1,00277,India
402819,2023-05-20,1001,Lipstick,150,300,150,2,00379,India
402819,2023-05-20,1007,Eyeshadow,200,400,200,2,00379,India
402819,2023-05-20,1009,Moisturizer,250,500,250,1,00379,India
402819,2023-05-20,1005,Nail Polish,50,100,50,2,00379,India
176441,2023-05-20,1004,Eyeliner,100,200,100,2,00464,India
176441,2023-05-20,1006,Blush,150,300,150,2,00464,India
176441,2023-05-20,1012,Body Lotion,200,400,200,1,00464,India
176441,2023-05-20,1009,Moisturizer,250,500,250,1,00464,India
229227,2023-05-20,1005,Nail Polish,50,100,50,2,00374,India
229227,2023-05-20,1008,Makeup Remover,80,160,80,2,00374,India
263715,2023-05-20,1004,Eyeliner,100,200,100,2,00124,India
242870,2023-05-20,1001,Lipstick,150,300,150,2,00434,India
242870,2023-05-20,1012,Body Lotion,200,400,200,1,00434,India
242870,2023-05-20,1007,Eyeshadow,200,400,200,2,00434,India
803232,2023-05-20,1006,Blush,150,300,150,2,00264,India
803232,2023-05-20,1009,Moisturizer,250,500,250,1,00264,India
803232,2023-05-20,1007,Eyeshadow,200,400,200,2,00264,India
803232,2023-05-20,1005,Nail Polish,50,100,50,2,00264,India
803232,2023-05-20,1003,Foundation,300,600,300,2,00264,India
243690,2023-05-20,1009,Moisturizer,250,500,250,1,00080,India
213220,2023-05-20,1007,Eyeshadow,200,400,200,2,00061,India
213220,2023-05-20,1012,Body Lotion,200,400,200,1,00061,India
213220,2023-05-20,1002,Mascara,200,400,200,2,00061,India
213220,2023-05-20,1008,Makeup Remover,80,160,80,2,00061,India
213220,2023-05-20,1009,Moisturizer,250,500,250,1,00061,India
225034,2023-05-20,1009,Moisturizer,250,500,250,1,00293,India
979859,2023-05-20,1005,Nail Polish,50,100,50,2,00237,India
979859,2023-05-20,1008,Makeup Remover,80,160,80,2,00237,India
131548,2023-05-20,1008,Makeup Remover,80,160,80,2,00138,India
131548,2023-05-20,1003,Foundation,300,600,300,2,00138,India
131548,2023-05-20,1004,Eyeliner,100,200,100,2,00138,India
556372,2023-05-20,1007,Eyeshadow,200,400,200,2,00021,India
556372,2023-05-20,1006,Blush,150,300,150,2,00021,India
600575,2023-05-20,1004,Eyeliner,100,200,100,2,00326,India
600575,2023-05-20,1008,Makeup Remover,80,160,80,2,00326,India
600575,2023-05-20,1003,Foundation,300,600,300,2,00326,India
600575,2023-05-20,1009,Moisturizer,250,500,250,1,00326,India
158296,2023-05-20,1009,Moisturizer,250,500,250,1,00220,India
158296,2023-05-20,1002,Mascara,200,400,200,2,00220,India
617167,2023-05-20,1012,Body Lotion,200,400,200,1,00399,India
617167,2023-05-20,1006,Blush,150,300,150,2,00399,India
715732,2023-05-20,1007,Eyeshadow,200,400,200,2,00308,India
715732,2023-05-20,1001,Lipstick,150,300,150,2,00308,India
715732,2023-05-20,1006,Blush,150,300,150,2,00308,India
257609,2023-05-20,1003,Foundation,300,600,300,2,00103,India
257609,2023-05-20,1008,Makeup Remover,80,160,80,2,00103,India
655748,2023-05-20,1004,Eyeliner,100,200,100,2,00221,India
655748,2023-05-20,1001,Lipstick,150,300,150,2,00221,India
655748,2023-05-20,1002,Mascara,200,400,200,2,00221,India
751409,2023-05-20,1008,Makeup Remover,80,160,80,2,00451,India
751409,2023-05-20,1006,Blush,150,300,150,2,00451,India
751409,2023-05-20,1012,Body Lotion,200,400,200,1,00451,India
266575,2023-05-20,1009,Moisturizer,250,500,250,1,00027,India
266575,2023-05-20,1008,Makeup Remover,80,160,80,2,00027,India
384662,2023-05-20,1001,Lipstick,150,300,150,2,00464,India
384662,2023-05-20,1007,Eyeshadow,200,400,200,2,00464,India
384662,2023-05-20,1003,Foundation,300,600,300,2,00464,India
384662,2023-05-20,1008,Makeup Remover,80,160,80,2,00464,India
384662,2023-05-20,1005,Nail Polish,50,100,50,2,00464,India
991660,2023-05-20,1008,Makeup Remover,80,160,80,2,00358,India
991660,2023-05-20,1009,Moisturizer,250,500,250,1,00358,India
991660,2023-05-20,1012,Body Lotion,200,400,200,1,00358,India
991660,2023-05-20,1007,Eyeshadow,200,400,200,2,00358,India
625809,2023-05-20,1004,Eyeliner,100,200,100,2,00087,India
625809,2023-05-20,1008,Makeup Remover,80,160,80,2,00087,India
625809,2023-05-20,1005,Nail Polish,50,100,50,2,00087,India
469282,2023-05-20,1006,Blush,150,300,150,2,00313,India
549995,2023-05-20,1006,Blush,150,300,150,2,00110,India
549995,2023-05-20,1003,Foundation,300,600,300,2,00110,India
549995,2023-05-20,1008,Makeup Remover,80,160,80,2,00110,India
395699,2023-05-20,1001,Lipstick,150,300,150,2,00260,India
395699,2023-05-20,1003,Foundation,300,600,300,2,00260,India
395699,2023-05-20,1002,Mascara,200,400,200,2,00260,India
395699,2023-05-20,1008,Makeup Remover,80,160,80,2,00260,India
481655,2023-05-20,1004,Eyeliner,100,200,100,2,00113,India
481655,2023-05-20,1003,Foundation,300,600,300,2,00113,India
481655,2023-05-20,1007,Eyeshadow,200,400,200,2,00113,India
481655,2023-05-20,1008,Makeup Remover,80,160,80,2,00113,India
284644,2023-05-20,1008,Makeup Remover,80,160,80,2,00049,India
284644,2023-05-20,1001,Lipstick,150,300,150,2,00049,India
284644,2023-05-20,1012,Body Lotion,200,400,200,1,00049,India
284644,2023-05-20,1002,Mascara,200,400,200,2,00049,India
643495,2023-05-20,1002,Mascara,200,400,200,2,00379,India
643495,2023-05-20,1008,Makeup Remover,80,160,80,2,00379,India
987434,2023-05-20,1005,Nail Polish,50,100,50,2,00025,India
987434,2023-05-20,1004,Eyeliner,100,200,100,2,00025,India
987434,2023-05-20,1007,Eyeshadow,200,400,200,2,00025,India
113249,2023-05-20,1005,Nail Polish,50,100,50,2,00378,India
113249,2023-05-20,1012,Body Lotion,200,400,200,1,00378,India
176999,2023-05-20,1012,Body Lotion,200,400,200,1,00255,India
176999,2023-05-20,1002,Mascara,200,400,200,2,00255,India
176999,2023-05-20,1009,Moisturizer,250,500,250,1,00255,India
353852,2023-05-20,1001,Lipstick,150,300,150,2,00256,India
353852,2023-05-20,1012,Body Lotion,200,400,200,1,00256,India
799908,2023-05-20,1009,Moisturizer,250,500,250,1,00338,India
799908,2023-05-20,1001,Lipstick,150,300,150,2,00338,India
799908,2023-05-20,1007,Eyeshadow,200,400,200,2,00338,India
112476,2023-05-20,1001,Lipstick,150,300,150,2,00016,India
872613,2023-05-20,1001,Lipstick,150,300,150,2,00074,India
872613,2023-05-20,1002,Mascara,200,400,200,2,00074,India
872613,2023-05-20,1006,Blush,150,300,150,2,00074,India
872613,2023-05-20,1012,Body Lotion,200,400,200,1,00074,India
705309,2023-05-20,1012,Body Lotion,200,400,200,1,00131,India
705309,2023-05-20,1005,Nail Polish,50,100,50,2,00131,India
705309,2023-05-20,1006,Blush,150,300,150,2,00131,India
739483,2023-05-20,1004,Eyeliner,100,200,100,2,00269,India
757818,2023-05-20,1004,Eyeliner,100,200,100,2,00325,India
258625,2023-05-20,1003,Foundation,300,600,300,2,00077,India
759787,2023-05-20,1002,Mascara,200,400,200,2,00076,India
759787,2023-05-20,1004,Eyeliner,100,200,100,2,00076,India
759787,2023-05-20,1008,Makeup Remover,80,160,80,2,00076,India
757598,2023-05-20,1001,Lipstick,150,300,150,2,00357,India
757598,2023-05-20,1007,Eyeshadow,200,400,200,2,00357,India
757598,2023-05-20,1006,Blush,150,300,150,2,00357,India
231302,2023-05-20,1002,Mascara,200,400,200,2,00449,India
231302,2023-05-20,1012,Body Lotion,200,400,200,1,00449,India
534604,2023-05-20,1002,Mascara,200,400,200,2,00479,India
534604,2023-05-20,1003,Foundation,300,600,300,2,00479,India
534604,2023-05-20,1006,Blush,150,300,150,2,00479,India
534604,2023-05-20,1005,Nail Polish,50,100,50,2,00479,India
988518,2023-05-20,1001,Lipstick,150,300,150,2,00182,India
988518,2023-05-20,1007,Eyeshadow,200,400,200,2,00182,India
988518,2023-05-20,1006,Blush,150,300,150,2,00182,India
988518,2023-05-20,1003,Foundation,300,600,300,2,00182,India
629470,2023-05-20,1012,Body Lotion,200,400,200,1,00417,India
629470,2023-05-20,1009,Moisturizer,250,500,250,1,00417,India
629470,2023-05-20,1007,Eyeshadow,200,400,200,2,00417,India
629470,2023-05-20,1008,Makeup Remover,80,160,80,2,00417,India
629470,2023-05-20,1004,Eyeliner,100,200,100,2,00417,India
442773,2023-05-20,1009,Moisturizer,250,500,250,1,00409,India
442773,2023-05-20,1012,Body Lotion,200,400,200,1,00409,India
442773,2023-05-20,1005,Nail Polish,50,100,50,2,00409,India
442773,2023-05-20,1008,Makeup Remover,80,160,80,2,00409,India
442773,2023-05-20,1004,Eyeliner,100,200,100,2,00409,India
951022,2023-05-20,1012,Body Lotion,200,400,200,1,00116,India
951022,2023-05-20,1004,Eyeliner,100,200,100,2,00116,India
951022,2023-05-20,1003,Foundation,300,600,300,2,00116,India
720398,2023-05-20,1008,Makeup Remover,80,160,80,2,00014,India
363667,2023-05-21,1006,Blush,150,300,150,2,00131,India
363667,2023-05-21,1009,Moisturizer,250,500,250,1,00131,India
363667,2023-05-21,1004,Eyeliner,100,200,100,2,00131,India
844365,2023-05-21,1004,Eyeliner,100,200,100,2,00426,India
601872,2023-05-21,1007,Eyeshadow,200,400,200,2,00082,India
601872,2023-05-21,1001,Lipstick,150,300,150,2,00082,India
601872,2023-05-21,1009,Moisturizer,250,500,250,1,00082,India
601872,2023-05-21,1003,Foundation,300,600,300,2,00082,India
601872,2023-05-21,1006,Blush,150,300,150,2,00082,India
860915,2023-05-21,1004,Eyeliner,100,200,100,2,00238,India
860915,2023-05-21,1007,Eyeshadow,200,400,200,2,00238,India
949006,2023-05-21,1008,Makeup Remover,80,160,80,2,00068,India
949006,2023-05-21,1002,Mascara,200,400,200,2,00068,India
949006,2023-05-21,1006,Blush,150,300,150,2,00068,India
553293,2023-05-21,1001,Lipstick,150,300,150,2,00234,India
553293,2023-05-21,1005,Nail Polish,50,100,50,2,00234,India
553293,2023-05-21,1003,Foundation,300,600,300,2,00234,India
902396,2023-05-21,1006,Blush,150,300,150,2,00154,India
349729,2023-05-21,1004,Eyeliner,100,200,100,2,00382,India
349729,2023-05-21,1001,Lipstick,150,300,150,2,00382,India
349729,2023-05-21,1007,Eyeshadow,200,400,200,2,00382,India
479206,2023-05-21,1005,Nail Polish,50,100,50,2,00115,India
479206,2023-05-21,1012,Body Lotion,200,400,200,1,00115,India
479206,2023-05-21,1002,Mascara,200,400,200,2,00115,India
479206,2023-05-21,1003,Foundation,300,600,300,2,00115,India
922170,2023-05-21,1005,Nail Polish,50,100,50,2,00276,India
922170,2023-05-21,1002,Mascara,200,400,200,2,00276,India
922170,2023-05-21,1001,Lipstick,150,300,150,2,00276,India
922170,2023-05-21,1007,Eyeshadow,200,400,200,2,00276,India
577047,2023-05-21,1008,Makeup Remover,80,160,80,2,00409,India
599141,2023-05-21,1004,Eyeliner,100,200,100,2,00013,India
998745,2023-05-21,1008,Makeup Remover,80,160,80,2,00169,India
945288,2023-05-21,1005,Nail Polish,50,100,50,2,00285,India
945288,2023-05-21,1001,Lipstick,150,300,150,2,00285,India
945288,2023-05-21,1002,Mascara,200,400,200,2,00285,India
770202,2023-05-21,1009,Moisturizer,250,500,250,1,00160,India
770202,2023-05-21,1003,Foundation,300,600,300,2,00160,India
770202,2023-05-21,1002,Mascara,200,400,200,2,00160,India
585930,2023-05-21,1008,Makeup Remover,80,160,80,2,00107,India
299152,2023-05-21,1006,Blush,150,300,150,2,00395,India
269174,2023-05-21,1007,Eyeshadow,200,400,200,2,00044,India
929542,2023-05-21,1008,Makeup Remover,80,160,80,2,00175,India
929542,2023-05-21,1004,Eyeliner,100,200,100,2,00175,India
929542,2023-05-21,1006,Blush,150,300,150,2,00175,India
916085,2023-05-21,1008,Makeup Remover,80,160,80,2,00200,India
916085,2023-05-21,1001,Lipstick,150,300,150,2,00200,India
916085,2023-05-21,1012,Body Lotion,200,400,200,1,00200,India
916085,2023-05-21,1006,Blush,150,300,150,2,00200,India
916085,2023-05-21,1009,Moisturizer,250,500,250,1,00200,India
505089,2023-05-21,1003,Foundation,300,600,300,2,00004,India
505089,2023-05-21,1012,Body Lotion,200,400,200,1,00004,India
505089,2023-05-21,1007,Eyeshadow,200,400,200,2,00004,India
237685,2023-05-21,1009,Moisturizer,250,500,250,1,00467,India
318295,2023-05-21,1008,Makeup Remover,80,160,80,2,00155,India
318295,2023-05-21,1002,Mascara,200,400,200,2,00155,India
529408,2023-05-21,1012,Body Lotion,200,400,200,1,00397,India
529408,2023-05-21,1003,Foundation,300,600,300,2,00397,India
696625,2023-05-21,1007,Eyeshadow,200,400,200,2,00219,India
696625,2023-05-21,1004,Eyeliner,100,200,100,2,00219,India
777426,2023-05-21,1009,Moisturizer,250,500,250,1,00095,India
519037,2023-05-21,1006,Blush,150,300,150,2,00394,India
519037,2023-05-21,1004,Eyeliner,100,200,100,2,00394,India
587210,2023-05-21,1008,Makeup Remover,80,160,80,2,00122,India
587210,2023-05-21,1009,Moisturizer,250,500,250,1,00122,India
587210,2023-05-21,1002,Mascara,200,400,200,2,00122,India
728482,2023-05-21,1009,Moisturizer,250,500,250,1,00127,India
728482,2023-05-21,1002,Mascara,200,400,200,2,00127,India
728482,2023-05-21,1007,Eyeshadow,200,400,200,2,00127,India
728482,2023-05-21,1008,Makeup Remover,80,160,80,2,00127,India
490164,2023-05-21,1009,Moisturizer,250,500,250,1,00378,India
490164,2023-05-21,1008,Makeup Remover,80,160,80,2,00378,India
490164,2023-05-21,1012,Body Lotion,200,400,200,1,00378,India
129481,2023-05-21,1003,Foundation,300,600,300,2,00328,India
772165,2023-05-21,1004,Eyeliner,100,200,100,2,00199,India
772165,2023-05-21,1012,Body Lotion,200,400,200,1,00199,India
772165,2023-05-21,1008,Makeup Remover,80,160,80,2,00199,India
772165,2023-05-21,1002,Mascara,200,400,200,2,00199,India
229744,2023-05-21,1006,Blush,150,300,150,2,00270,India
229744,2023-05-21,1001,Lipstick,150,300,150,2,00270,India
229744,2023-05-21,1007,Eyeshadow,200,400,200,2,00270,India
635255,2023-05-21,1002,Mascara,200,400,200,2,00270,India
635255,2023-05-21,1001,Lipstick,150,300,150,2,00270,India
635255,2023-05-21,1008,Makeup Remover,80,160,80,2,00270,India
635255,2023-05-21,1012,Body Lotion,200,400,200,1,00270,India
292109,2023-05-21,1001,Lipstick,150,300,150,2,00264,India
292109,2023-05-21,1008,Makeup Remover,80,160,80,2,00264,India
292109,2023-05-21,1005,Nail Polish,50,100,50,2,00264,India
292109,2023-05-21,1007,Eyeshadow,200,400,200,2,00264,India
292109,2023-05-21,1006,Blush,150,300,150,2,00264,India
696620,2023-05-21,1006,Blush,150,300,150,2,00017,India
696620,2023-05-21,1008,Makeup Remover,80,160,80,2,00017,India
696620,2023-05-21,1012,Body Lotion,200,400,200,1,00017,India
696620,2023-05-21,1005,Nail Polish,50,100,50,2,00017,India
696620,2023-05-21,1003,Foundation,300,600,300,2,00017,India
833571,2023-05-22,1009,Moisturizer,250,500,250,1,00329,India
833571,2023-05-22,1008,Makeup Remover,80,160,80,2,00329,India
833571,2023-05-22,1007,Eyeshadow,200,400,200,2,00329,India
833571,2023-05-22,1001,Lipstick,150,300,150,2,00329,India
701331,2023-05-22,1009,Moisturizer,250,500,250,1,00473,India
701331,2023-05-22,1005,Nail Polish,50,100,50,2,00473,India
701331,2023-05-22,1006,Blush,150,300,150,2,00473,India
701331,2023-05-22,1002,Mascara,200,400,200,2,00473,India
701331,2023-05-22,1001,Lipstick,150,300,150,2,00473,India
693196,2023-05-22,1001,Lipstick,150,300,150,2,00191,India
378419,2023-05-22,1004,Eyeliner,100,200,100,2,00297,India
296507,2023-05-22,1003,Foundation,300,600,300,2,00018,India
296507,2023-05-22,1006,Blush,150,300,150,2,00018,India
296507,2023-05-22,1002,Mascara,200,400,200,2,00018,India
325418,2023-05-22,1012,Body Lotion,200,400,200,1,00138,India
325418,2023-05-22,1003,Foundation,300,600,300,2,00138,India
325418,2023-05-22,1004,Eyeliner,100,200,100,2,00138,India
164786,2023-05-22,1009,Moisturizer,250,500,250,1,00054,India
817502,2023-05-22,1012,Body Lotion,200,400,200,1,00065,India
743208,2023-05-22,1006,Blush,150,300,150,2,00452,India
743208,2023-05-22,1003,Foundation,300,600,300,2,00452,India
743208,2023-05-22,1002,Mascara,200,400,200,2,00452,India
457142,2023-05-22,1001,Lipstick,150,300,150,2,00016,India
647060,2023-05-22,1008,Makeup Remover,80,160,80,2,00448,India
647060,2023-05-22,1002,Mascara,200,400,200,2,00448,India
647060,2023-05-22,1007,Eyeshadow,200,400,200,2,00448,India
486593,2023-05-22,1003,Foundation,300,600,300,2,00293,India
486593,2023-05-22,1012,Body Lotion,200,400,200,1,00293,India
486593,2023-05-22,1004,Eyeliner,100,200,100,2,00293,India
486593,2023-05-22,1005,Nail Polish,50,100,50,2,00293,India
157789,2023-05-22,1007,Eyeshadow,200,400,200,2,00306,India
157789,2023-05-22,1012,Body Lotion,200,400,200,1,00306,India
325752,2023-05-22,1005,Nail Polish,50,100,50,2,00374,India
341397,2023-05-22,1006,Blush,150,300,150,2,00401,India
341397,2023-05-22,1001,Lipstick,150,300,150,2,00401,India
341397,2023-05-22,1012,Body Lotion,200,400,200,1,00401,India
341397,2023-05-22,1003,Foundation,300,600,300,2,00401,India
910105,2023-05-22,1012,Body Lotion,200,400,200,1,00082,India
910105,2023-05-22,1006,Blush,150,300,150,2,00082,India
910105,2023-05-22,1005,Nail Polish,50,100,50,2,00082,India
910105,2023-05-22,1008,Makeup Remover,80,160,80,2,00082,India
635462,2023-05-22,1001,Lipstick,150,300,150,2,00132,India
414102,2023-05-22,1009,Moisturizer,250,500,250,1,00129,India
414102,2023-05-22,1004,Eyeliner,100,200,100,2,00129,India
414102,2023-05-22,1002,Mascara,200,400,200,2,00129,India
329691,2023-05-22,1002,Mascara,200,400,200,2,00452,India
329691,2023-05-22,1008,Makeup Remover,80,160,80,2,00452,India
329691,2023-05-22,1004,Eyeliner,100,200,100,2,00452,India
435751,2023-05-22,1008,Makeup Remover,80,160,80,2,00224,India
435751,2023-05-22,1003,Foundation,300,600,300,2,00224,India
669099,2023-05-22,1007,Eyeshadow,200,400,200,2,00019,India
669099,2023-05-22,1005,Nail Polish,50,100,50,2,00019,India
669099,2023-05-22,1003,Foundation,300,600,300,2,00019,India
669099,2023-05-22,1002,Mascara,200,400,200,2,00019,India
858472,2023-05-22,1001,Lipstick,150,300,150,2,00286,India
858472,2023-05-22,1003,Foundation,300,600,300,2,00286,India
134057,2023-05-22,1002,Mascara,200,400,200,2,00259,India
134057,2023-05-22,1001,Lipstick,150,300,150,2,00259,India
134057,2023-05-22,1005,Nail Polish,50,100,50,2,00259,India
134057,2023-05-22,1003,Foundation,300,600,300,2,00259,India
600222,2023-05-22,1002,Mascara,200,400,200,2,00478,India
600222,2023-05-22,1012,Body Lotion,200,400,200,1,00478,India
600222,2023-05-22,1009,Moisturizer,250,500,250,1,00478,India
600222,2023-05-22,1001,Lipstick,150,300,150,2,00478,India
760579,2023-05-22,1003,Foundation,300,600,300,2,00321,India
760579,2023-05-22,1002,Mascara,200,400,200,2,00321,India
760579,2023-05-22,1009,Moisturizer,250,500,250,1,00321,India
255869,2023-05-22,1004,Eyeliner,100,200,100,2,00207,India
255869,2023-05-22,1001,Lipstick,150,300,150,2,00207,India
255869,2023-05-22,1009,Moisturizer,250,500,250,1,00207,India
255869,2023-05-22,1012,Body Lotion,200,400,200,1,00207,India
162924,2023-05-22,1002,Mascara,200,400,200,2,00477,India
162924,2023-05-22,1006,Blush,150,300,150,2,00477,India
162924,2023-05-22,1003,Foundation,300,600,300,2,00477,India
698341,2023-05-22,1009,Moisturizer,250,500,250,1,00016,India
698341,2023-05-22,1001,Lipstick,150,300,150,2,00016,India
698341,2023-05-22,1006,Blush,150,300,150,2,00016,India
995861,2023-05-22,1012,Body Lotion,200,400,200,1,00180,India
995861,2023-05-22,1002,Mascara,200,400,200,2,00180,India
995861,2023-05-22,1008,Makeup Remover,80,160,80,2,00180,India
995861,2023-05-22,1001,Lipstick,150,300,150,2,00180,India
717178,2023-05-22,1005,Nail Polish,50,100,50,2,00045,India
717178,2023-05-22,1001,Lipstick,150,300,150,2,00045,India
717178,2023-05-22,1012,Body Lotion,200,400,200,1,00045,India
584202,2023-05-22,1005,Nail Polish,50,100,50,2,00155,India
584202,2023-05-22,1002,Mascara,200,400,200,2,00155,India
584202,2023-05-22,1004,Eyeliner,100,200,100,2,00155,India
584202,2023-05-22,1009,Moisturizer,250,500,250,1,00155,India
509109,2023-05-22,1008,Makeup Remover,80,160,80,2,00299,India
509109,2023-05-22,1006,Blush,150,300,150,2,00299,India
509109,2023-05-22,1001,Lipstick,150,300,150,2,00299,India
509109,2023-05-22,1009,Moisturizer,250,500,250,1,00299,India
869393,2023-05-22,1012,Body Lotion,200,400,200,1,00167,India
869393,2023-05-22,1002,Mascara,200,400,200,2,00167,India
608650,2023-05-22,1008,Makeup Remover,80,160,80,2,00139,India
608650,2023-05-22,1012,Body Lotion,200,400,200,1,00139,India
608650,2023-05-22,1005,Nail Polish,50,100,50,2,00139,India
241993,2023-05-22,1009,Moisturizer,250,500,250,1,00300,India
241993,2023-05-22,1002,Mascara,200,400,200,2,00300,India
241993,2023-05-22,1001,Lipstick,150,300,150,2,00300,India
988302,2023-05-22,1005,Nail Polish,50,100,50,2,00110,India
988302,2023-05-22,1001,Lipstick,150,300,150,2,00110,India
988302,2023-05-22,1004,Eyeliner,100,200,100,2,00110,India
297898,2023-05-22,1003,Foundation,300,600,300,2,00279,India
480324,2023-05-22,1003,Foundation,300,600,300,2,00024,India
737412,2023-05-22,1012,Body Lotion,200,400,200,1,00319,India
737412,2023-05-22,1008,Makeup Remover,80,160,80,2,00319,India
737412,2023-05-22,1009,Moisturizer,250,500,250,1,00319,India
862015,2023-05-23,1001,Lipstick,150,300,150,2,00026,India
862015,2023-05-23,1006,Blush,150,300,150,2,00026,India
862015,2023-05-23,1004,Eyeliner,100,200,100,2,00026,India
968069,2023-05-23,1005,Nail Polish,50,100,50,2,00023,India
879309,2023-05-23,1012,Body Lotion,200,400,200,1,00273,India
879309,2023-05-23,1008,Makeup Remover,80,160,80,2,00273,India
879309,2023-05-23,1007,Eyeshadow,200,400,200,2,00273,India
879309,2023-05-23,1004,Eyeliner,100,200,100,2,00273,India
139832,2023-05-23,1008,Makeup Remover,80,160,80,2,00073,India
303135,2023-05-23,1008,Makeup Remover,80,160,80,2,00492,India
303135,2023-05-23,1003,Foundation,300,600,300,2,00492,India
303135,2023-05-23,1004,Eyeliner,100,200,100,2,00492,India
303135,2023-05-23,1007,Eyeshadow,200,400,200,2,00492,India
768449,2023-05-23,1003,Foundation,300,600,300,2,00042,India
768449,2023-05-23,1006,Blush,150,300,150,2,00042,India
768449,2023-05-23,1008,Makeup Remover,80,160,80,2,00042,India
768449,2023-05-23,1005,Nail Polish,50,100,50,2,00042,India
486415,2023-05-23,1005,Nail Polish,50,100,50,2,00224,India
975314,2023-05-23,1006,Blush,150,300,150,2,00129,India
975314,2023-05-23,1005,Nail Polish,50,100,50,2,00129,India
975314,2023-05-23,1009,Moisturizer,250,500,250,1,00129,India
975314,2023-05-23,1002,Mascara,200,400,200,2,00129,India
485211,2023-05-23,1001,Lipstick,150,300,150,2,00347,India
885691,2023-05-23,1009,Moisturizer,250,500,250,1,00156,India
885691,2023-05-23,1006,Blush,150,300,150,2,00156,India
885691,2023-05-23,1003,Foundation,300,600,300,2,00156,India
529936,2023-05-23,1003,Foundation,300,600,300,2,00269,India
529936,2023-05-23,1006,Blush,150,300,150,2,00269,India
529936,2023-05-23,1005,Nail Polish,50,100,50,2,00269,India
529936,2023-05-23,1007,Eyeshadow,200,400,200,2,00269,India
517733,2023-05-23,1002,Mascara,200,400,200,2,00315,India
517733,2023-05-23,1008,Makeup Remover,80,160,80,2,00315,India
517733,2023-05-23,1009,Moisturizer,250,500,250,1,00315,India
517733,2023-05-23,1006,Blush,150,300,150,2,00315,India
779308,2023-05-23,1012,Body Lotion,200,400,200,1,00030,India
581375,2023-05-23,1008,Makeup Remover,80,160,80,2,00325,India
581375,2023-05-23,1006,Blush,150,300,150,2,00325,India
581375,2023-05-23,1009,Moisturizer,250,500,250,1,00325,India
581375,2023-05-23,1007,Eyeshadow,200,400,200,2,00325,India
912210,2023-05-23,1001,Lipstick,150,300,150,2,00092,India
912210,2023-05-23,1008,Makeup Remover,80,160,80,2,00092,India
912210,2023-05-23,1004,Eyeliner,100,200,100,2,00092,India
261007,2023-05-23,1006,Blush,150,300,150,2,00172,India
261007,2023-05-23,1002,Mascara,200,400,200,2,00172,India
261007,2023-05-23,1007,Eyeshadow,200,400,200,2,00172,India
261007,2023-05-23,1004,Eyeliner,100,200,100,2,00172,India
806746,2023-05-23,1009,Moisturizer,250,500,250,1,00182,India
806746,2023-05-23,1006,Blush,150,300,150,2,00182,India
806746,2023-05-23,1007,Eyeshadow,200,400,200,2,00182,India
806746,2023-05-23,1008,Makeup Remover,80,160,80,2,00182,India
894835,2023-05-23,1008,Makeup Remover,80,160,80,2,00449,India
894835,2023-05-23,1001,Lipstick,150,300,150,2,00449,India
894835,2023-05-23,1005,Nail Polish,50,100,50,2,00449,India
588005,2023-05-23,1002,Mascara,200,400,200,2,00009,India
588005,2023-05-23,1001,Lipstick,150,300,150,2,00009,India
588005,2023-05-23,1009,Moisturizer,250,500,250,1,00009,India
646055,2023-05-23,1007,Eyeshadow,200,400,200,2,00439,India
646055,2023-05-23,1001,Lipstick,150,300,150,2,00439,India
646055,2023-05-23,1005,Nail Polish,50,100,50,2,00439,India
646055,2023-05-23,1012,Body Lotion,200,400,200,1,00439,India
473312,2023-05-23,1012,Body Lotion,200,400,200,1,00406,India
473312,2023-05-23,1009,Moisturizer,250,500,250,1,00406,India
719476,2023-05-23,1004,Eyeliner,100,200,100,2,00484,India
719476,2023-05-23,1012,Body Lotion,200,400,200,1,00484,India
719476,2023-05-23,1007,Eyeshadow,200,400,200,2,00484,India
719476,2023-05-23,1001,Lipstick,150,300,150,2,00484,India
419231,2023-05-23,1001,Lipstick,150,300,150,2,00043,India
419231,2023-05-23,1009,Moisturizer,250,500,250,1,00043,India
419231,2023-05-23,1004,Eyeliner,100,200,100,2,00043,India
125262,2023-05-23,1008,Makeup Remover,80,160,80,2,00386,India
125262,2023-05-23,1004,Eyeliner,100,200,100,2,00386,India
544885,2023-05-23,1009,Moisturizer,250,500,250,1,00418,India
544885,2023-05-23,1001,Lipstick,150,300,150,2,00418,India
406389,2023-05-23,1008,Makeup Remover,80,160,80,2,00362,India
373333,2023-05-23,1002,Mascara,200,400,200,2,00077,India
373333,2023-05-23,1007,Eyeshadow,200,400,200,2,00077,India
424807,2023-05-23,1003,Foundation,300,600,300,2,00322,India
424807,2023-05-23,1012,Body Lotion,200,400,200,1,00322,India
424807,2023-05-23,1007,Eyeshadow,200,400,200,2,00322,India
424807,2023-05-23,1006,Blush,150,300,150,2,00322,India
988024,2023-05-23,1009,Moisturizer,250,500,250,1,00032,India
988024,2023-05-23,1004,Eyeliner,100,200,100,2,00032,India
704156,2023-05-23,1002,Mascara,200,400,200,2,00270,India
396275,2023-05-23,1004,Eyeliner,100,200,100,2,00059,India
396275,2023-05-23,1009,Moisturizer,250,500,250,1,00059,India
396275,2023-05-23,1006,Blush,150,300,150,2,00059,India
396275,2023-05-23,1008,Makeup Remover,80,160,80,2,00059,India
137340,2023-05-23,1005,Nail Polish,50,100,50,2,00138,India
137340,2023-05-23,1006,Blush,150,300,150,2,00138,India
137340,2023-05-23,1002,Mascara,200,400,200,2,00138,India
872487,2023-05-23,1003,Foundation,300,600,300,2,00348,India
872487,2023-05-23,1006,Blush,150,300,150,2,00348,India
872487,2023-05-23,1008,Makeup Remover,80,160,80,2,00348,India
872487,2023-05-23,1001,Lipstick,150,300,150,2,00348,India
379179,2023-05-23,1004,Eyeliner,100,200,100,2,00015,India
409577,2023-05-23,1005,Nail Polish,50,100,50,2,00072,India
409577,2023-05-23,1001,Lipstick,150,300,150,2,00072,India
497968,2023-05-23,1001,Lipstick,150,300,150,2,00355,India
497968,2023-05-23,1007,Eyeshadow,200,400,200,2,00355,India
497968,2023-05-23,1006,Blush,150,300,150,2,00355,India
497968,2023-05-23,1002,Mascara,200,400,200,2,00355,India
521687,2023-05-23,1005,Nail Polish,50,100,50,2,00180,India
314906,2023-05-23,1001,Lipstick,150,300,150,2,00329,India
314906,2023-05-23,1009,Moisturizer,250,500,250,1,00329,India
314906,2023-05-23,1006,Blush,150,300,150,2,00329,India
719357,2023-05-23,1007,Eyeshadow,200,400,200,2,00233,India
605795,2023-05-23,1009,Moisturizer,250,500,250,1,00375,India
605795,2023-05-23,1002,Mascara,200,400,200,2,00375,India
605795,2023-05-23,1008,Makeup Remover,80,160,80,2,00375,India
605795,2023-05-23,1006,Blush,150,300,150,2,00375,India
853851,2023-05-23,1004,Eyeliner,100,200,100,2,00277,India
853851,2023-05-23,1012,Body Lotion,200,400,200,1,00277,India
814805,2023-05-23,1008,Makeup Remover,80,160,80,2,00145,India
814805,2023-05-23,1004,Eyeliner,100,200,100,2,00145,India
814805,2023-05-23,1009,Moisturizer,250,500,250,1,00145,India
428316,2023-05-23,1003,Foundation,300,600,300,2,00318,India
428316,2023-05-23,1002,Mascara,200,400,200,2,00318,India
584435,2023-05-23,1004,Eyeliner,100,200,100,2,00206,India
584435,2023-05-23,1001,Lipstick,150,300,150,2,00206,India
860222,2023-05-24,1002,Mascara,200,400,200,2,00192,India
860222,2023-05-24,1012,Body Lotion,200,400,200,1,00192,India
860222,2023-05-24,1001,Lipstick,150,300,150,2,00192,India
158232,2023-05-24,1008,Makeup Remover,80,160,80,2,00026,India
158232,2023-05-24,1004,Eyeliner,100,200,100,2,00026,India
158232,2023-05-24,1005,Nail Polish,50,100,50,2,00026,India
602817,2023-05-24,1012,Body Lotion,200,400,200,1,00275,India
602817,2023-05-24,1005,Nail Polish,50,100,50,2,00275,India
602817,2023-05-24,1001,Lipstick,150,300,150,2,00275,India
602817,2023-05-24,1004,Eyeliner,100,200,100,2,00275,India
697443,2023-05-24,1007,Eyeshadow,200,400,200,2,00432,India
317542,2023-05-24,1008,Makeup Remover,80,160,80,2,00077,India
433791,2023-05-24,1002,Mascara,200,400,200,2,00390,India
481708,2023-05-24,1006,Blush,150,300,150,2,00461,India
481708,2023-05-24,1004,Eyeliner,100,200,100,2,00461,India
481708,2023-05-24,1001,Lipstick,150,300,150,2,00461,India
556373,2023-05-24,1009,Moisturizer,250,500,250,1,00488,India
556373,2023-05-24,1003,Foundation,300,600,300,2,00488,India
556373,2023-05-24,1005,Nail Polish,50,100,50,2,00488,India
556373,2023-05-24,1012,Body Lotion,200,400,200,1,00488,India
290876,2023-05-24,1002,Mascara,200,400,200,2,00180,India
647136,2023-05-24,1008,Makeup Remover,80,160,80,2,00337,India
647136,2023-05-24,1001,Lipstick,150,300,150,2,00337,India
647136,2023-05-24,1005,Nail Polish,50,100,50,2,00337,India
647136,2023-05-24,1003,Foundation,300,600,300,2,00337,India
780160,2023-05-24,1003,Foundation,300,600,300,2,00440,India
780160,2023-05-24,1007,Eyeshadow,200,400,200,2,00440,India
780160,2023-05-24,1005,Nail Polish,50,100,50,2,00440,India
780160,2023-05-24,1006,Blush,150,300,150,2,00440,India
489189,2023-05-24,1002,Mascara,200,400,200,2,00127,India
489189,2023-05-24,1003,Foundation,300,600,300,2,00127,India
489189,2023-05-24,1012,Body Lotion,200,400,200,1,00127,India
373483,2023-05-24,1003,Foundation,300,600,300,2,00279,India
373483,2023-05-24,1002,Mascara,200,400,200,2,00279,India
373483,2023-05-24,1001,Lipstick,150,300,150,2,00279,India
727727,2023-05-24,1004,Eyeliner,100,200,100,2,00275,India
730621,2023-05-24,1009,Moisturizer,250,500,250,1,00168,India
730621,2023-05-24,1007,Eyeshadow,200,400,200,2,00168,India
681264,2023-05-24,1003,Foundation,300,600,300,2,00216,India
681264,2023-05-24,1012,Body Lotion,200,400,200,1,00216,India
681264,2023-05-24,1006,Blush,150,300,150,2,00216,India
681264,2023-05-24,1002,Mascara,200,400,200,2,00216,India
681264,2023-05-24,1001,Lipstick,150,300,150,2,00216,India
408045,2023-05-24,1002,Mascara,200,400,200,2,00231,India
783725,2023-05-24,1007,Eyeshadow,200,400,200,2,00223,India
783725,2023-05-24,1003,Foundation,300,600,300,2,00223,India
783725,2023-05-24,1012,Body Lotion,200,400,200,1,00223,India
783725,2023-05-24,1006,Blush,150,300,150,2,00223,India
783725,2023-05-24,1004,Eyeliner,100,200,100,2,00223,India
788596,2023-05-24,1003,Foundation,300,600,300,2,00371,India
788596,2023-05-24,1002,Mascara,200,400,200,2,00371,India
788596,2023-05-24,1001,Lipstick,150,300,150,2,00371,India
119015,2023-05-24,1008,Makeup Remover,80,160,80,2,00441,India
119015,2023-05-24,1009,Moisturizer,250,500,250,1,00441,India
119015,2023-05-24,1003,Foundation,300,600,300,2,00441,India
119015,2023-05-24,1001,Lipstick,150,300,150,2,00441,India
337391,2023-05-24,1006,Blush,150,300,150,2,00194,India
337391,2023-05-24,1001,Lipstick,150,300,150,2,00194,India
337391,2023-05-24,1008,Makeup Remover,80,160,80,2,00194,India
556607,2023-05-24,1012,Body Lotion,200,400,200,1,00238,India
556607,2023-05-24,1003,Foundation,300,600,300,2,00238,India
556607,2023-05-24,1009,Moisturizer,250,500,250,1,00238,India
125190,2023-05-24,1003,Foundation,300,600,300,2,00185,India
125190,2023-05-24,1006,Blush,150,300,150,2,00185,India
896287,2023-05-24,1004,Eyeliner,100,200,100,2,00447,India
896287,2023-05-24,1007,Eyeshadow,200,400,200,2,00447,India
896287,2023-05-24,1002,Mascara,200,400,200,2,00447,India
896287,2023-05-24,1008,Makeup Remover,80,160,80,2,00447,India
411846,2023-05-24,1004,Eyeliner,100,200,100,2,00320,India
411846,2023-05-24,1006,Blush,150,300,150,2,00320,India
554939,2023-05-24,1004,Eyeliner,100,200,100,2,00323,India
798337,2023-05-24,1012,Body Lotion,200,400,200,1,00097,India
565006,2023-05-24,1002,Mascara,200,400,200,2,00036,India
565006,2023-05-24,1012,Body Lotion,200,400,200,1,00036,India
353004,2023-05-24,1002,Mascara,200,400,200,2,00064,India
353004,2023-05-24,1003,Foundation,300,600,300,2,00064,India
353004,2023-05-24,1008,Makeup Remover,80,160,80,2,00064,India
731483,2023-05-24,1002,Mascara,200,400,200,2,00029,India
731483,2023-05-24,1004,Eyeliner,100,200,100,2,00029,India
497557,2023-05-24,1008,Makeup Remover,80,160,80,2,00452,India
497557,2023-05-24,1012,Body Lotion,200,400,200,1,00452,India
497557,2023-05-24,1004,Eyeliner,100,200,100,2,00452,India
497557,2023-05-24,1006,Blush,150,300,150,2,00452,India
919843,2023-05-24,1003,Foundation,300,600,300,2,00054,India
919843,2023-05-24,1008,Makeup Remover,80,160,80,2,00054,India
326071,2023-05-24,1006,Blush,150,300,150,2,00381,India
326071,2023-05-24,1008,Makeup Remover,80,160,80,2,00381,India
647264,2023-05-24,1012,Body Lotion,200,400,200,1,00148,India
647264,2023-05-24,1004,Eyeliner,100,200,100,2,00148,India
647264,2023-05-24,1007,Eyeshadow,200,400,200,2,00148,India
647264,2023-05-24,1001,Lipstick,150,300,150,2,00148,India
647264,2023-05-24,1003,Foundation,300,600,300,2,00148,India
187428,2023-05-24,1006,Blush,150,300,150,2,00284,India
187428,2023-05-24,1009,Moisturizer,250,500,250,1,00284,India
187428,2023-05-24,1004,Eyeliner,100,200,100,2,00284,India
584247,2023-05-24,1009,Moisturizer,250,500,250,1,00280,India
584247,2023-05-24,1002,Mascara,200,400,200,2,00280,India
584247,2023-05-24,1004,Eyeliner,100,200,100,2,00280,India
729467,2023-05-24,1006,Blush,150,300,150,2,00479,India
703613,2023-05-24,1007,Eyeshadow,200,400,200,2,00363,India
703613,2023-05-24,1009,Moisturizer,250,500,250,1,00363,India
516915,2023-05-24,1008,Makeup Remover,80,160,80,2,00020,India
578852,2023-05-24,1005,Nail Polish,50,100,50,2,00402,India
578852,2023-05-24,1012,Body Lotion,200,400,200,1,00402,India
578852,2023-05-24,1006,Blush,150,300,150,2,00402,India
578852,2023-05-24,1001,Lipstick,150,300,150,2,00402,India
134418,2023-05-24,1012,Body Lotion,200,400,200,1,00172,India
743669,2023-05-24,1012,Body Lotion,200,400,200,1,00100,India
743669,2023-05-24,1009,Moisturizer,250,500,250,1,00100,India
743669,2023-05-24,1003,Foundation,300,600,300,2,00100,India
613551,2023-05-24,1003,Foundation,300,600,300,2,00380,India
613551,2023-05-24,1006,Blush,150,300,150,2,00380,India
613551,2023-05-24,1008,Makeup Remover,80,160,80,2,00380,India
427637,2023-05-25,1008,Makeup Remover,80,160,80,2,00332,India
427637,2023-05-25,1005,Nail Polish,50,100,50,2,00332,India
427637,2023-05-25,1009,Moisturizer,250,500,250,1,00332,India
841366,2023-05-25,1012,Body Lotion,200,400,200,1,00441,India
841366,2023-05-25,1009,Moisturizer,250,500,250,1,00441,India
841366,2023-05-25,1008,Makeup Remover,80,160,80,2,00441,India
841366,2023-05-25,1007,Eyeshadow,200,400,200,2,00441,India
688966,2023-05-25,1003,Foundation,300,600,300,2,00069,India
688966,2023-05-25,1001,Lipstick,150,300,150,2,00069,India
688966,2023-05-25,1004,Eyeliner,100,200,100,2,00069,India
688966,2023-05-25,1005,Nail Polish,50,100,50,2,00069,India
668210,2023-05-25,1005,Nail Polish,50,100,50,2,00122,India
736098,2023-05-25,1006,Blush,150,300,150,2,00174,India
363805,2023-05-25,1005,Nail Polish,50,100,50,2,00140,India
363805,2023-05-25,1012,Body Lotion,200,400,200,1,00140,India
303032,2023-05-25,1006,Blush,150,300,150,2,00156,India
303032,2023-05-25,1001,Lipstick,150,300,150,2,00156,India
303032,2023-05-25,1009,Moisturizer,250,500,250,1,00156,India
303032,2023-05-25,1003,Foundation,300,600,300,2,00156,India
379704,2023-05-25,1007,Eyeshadow,200,400,200,2,00389,India
894738,2023-05-25,1002,Mascara,200,400,200,2,00231,India
894738,2023-05-25,1004,Eyeliner,100,200,100,2,00231,India
129020,2023-05-25,1008,Makeup Remover,80,160,80,2,00245,India
129020,2023-05-25,1007,Eyeshadow,200,400,200,2,00245,India
129020,2023-05-25,1012,Body Lotion,200,400,200,1,00245,India
835582,2023-05-25,1007,Eyeshadow,200,400,200,2,00366,India
835582,2023-05-25,1012,Body Lotion,200,400,200,1,00366,India
835582,2023-05-25,1004,Eyeliner,100,200,100,2,00366,India
835582,2023-05-25,1001,Lipstick,150,300,150,2,00366,India
983452,2023-05-25,1005,Nail Polish,50,100,50,2,00187,India
983452,2023-05-25,1006,Blush,150,300,150,2,00187,India
983452,2023-05-25,1003,Foundation,300,600,300,2,00187,India
983452,2023-05-25,1002,Mascara,200,400,200,2,00187,India
848124,2023-05-25,1009,Moisturizer,250,500,250,1,00019,India
848124,2023-05-25,1001,Lipstick,150,300,150,2,00019,India
708733,2023-05-25,1007,Eyeshadow,200,400,200,2,00250,India
508336,2023-05-25,1001,Lipstick,150,300,150,2,00283,India
508336,2023-05-25,1003,Foundation,300,600,300,2,00283,India
508336,2023-05-25,1008,Makeup Remover,80,160,80,2,00283,India
966391,2023-05-25,1009,Moisturizer,250,500,250,1,00249,India
966391,2023-05-25,1012,Body Lotion,200,400,200,1,00249,India
966391,2023-05-25,1001,Lipstick,150,300,150,2,00249,India
966391,2023-05-25,1005,Nail Polish,50,100,50,2,00249,India
247492,2023-05-25,1001,Lipstick,150,300,150,2,00068,India
247492,2023-05-25,1008,Makeup Remover,80,160,80,2,00068,India
893268,2023-05-25,1007,Eyeshadow,200,400,200,2,00382,India
149331,2023-05-25,1007,Eyeshadow,200,400,200,2,00094,India
149331,2023-05-25,1001,Lipstick,150,300,150,2,00094,India
149331,2023-05-25,1006,Blush,150,300,150,2,00094,India
807782,2023-05-25,1003,Foundation,300,600,300,2,00336,India
807782,2023-05-25,1002,Mascara,200,400,200,2,00336,India
807782,2023-05-25,1008,Makeup Remover,80,160,80,2,00336,India
354684,2023-05-25,1002,Mascara,200,400,200,2,00279,India
507707,2023-05-25,1009,Moisturizer,250,500,250,1,00427,India
507707,2023-05-25,1005,Nail Polish,50,100,50,2,00427,India
507707,2023-05-25,1004,Eyeliner,100,200,100,2,00427,India
415794,2023-05-25,1009,Moisturizer,250,500,250,1,00402,India
415794,2023-05-25,1008,Makeup Remover,80,160,80,2,00402,India
415794,2023-05-25,1012,Body Lotion,200,400,200,1,00402,India
287122,2023-05-25,1003,Foundation,300,600,300,2,00271,India
287122,2023-05-25,1002,Mascara,200,400,200,2,00271,India
287122,2023-05-25,1007,Eyeshadow,200,400,200,2,00271,India
405372,2023-05-25,1004,Eyeliner,100,200,100,2,00327,India
405372,2023-05-25,1001,Lipstick,150,300,150,2,00327,India
405372,2023-05-25,1006,Blush,150,300,150,2,00327,India
405372,2023-05-25,1009,Moisturizer,250,500,250,1,00327,India
440152,2023-05-25,1012,Body Lotion,200,400,200,1,00082,India
440152,2023-05-25,1004,Eyeliner,100,200,100,2,00082,India
440152,2023-05-25,1003,Foundation,300,600,300,2,00082,India
270922,2023-05-25,1007,Eyeshadow,200,400,200,2,00188,India
270922,2023-05-25,1012,Body Lotion,200,400,200,1,00188,India
270922,2023-05-25,1004,Eyeliner,100,200,100,2,00188,India
270922,2023-05-25,1003,Foundation,300,600,300,2,00188,India
973486,2023-05-25,1009,Moisturizer,250,500,250,1,00450,India
973486,2023-05-25,1002,Mascara,200,400,200,2,00450,India
973486,2023-05-25,1012,Body Lotion,200,400,200,1,00450,India
973486,2023-05-25,1007,Eyeshadow,200,400,200,2,00450,India
876300,2023-05-25,1007,Eyeshadow,200,400,200,2,00288,India
632727,2023-05-25,1004,Eyeliner,100,200,100,2,00397,India
632727,2023-05-25,1001,Lipstick,150,300,150,2,00397,India
632727,2023-05-25,1006,Blush,150,300,150,2,00397,India
632727,2023-05-25,1012,Body Lotion,200,400,200,1,00397,India
315254,2023-05-25,1001,Lipstick,150,300,150,2,00191,India
315254,2023-05-25,1002,Mascara,200,400,200,2,00191,India
315254,2023-05-25,1012,Body Lotion,200,400,200,1,00191,India
315254,2023-05-25,1009,Moisturizer,250,500,250,1,00191,India
824321,2023-05-25,1001,Lipstick,150,300,150,2,00124,India
824321,2023-05-25,1003,Foundation,300,600,300,2,00124,India
824321,2023-05-25,1005,Nail Polish,50,100,50,2,00124,India
388680,2023-05-25,1006,Blush,150,300,150,2,00016,India
388680,2023-05-25,1003,Foundation,300,600,300,2,00016,India
388680,2023-05-25,1009,Moisturizer,250,500,250,1,00016,India
934567,2023-05-26,1008,Makeup Remover,80,160,80,2,00034,India
934567,2023-05-26,1009,Moisturizer,250,500,250,1,00034,India
934567,2023-05-26,1006,Blush,150,300,150,2,00034,India
444931,2023-05-26,1005,Nail Polish,50,100,50,2,00152,India
444931,2023-05-26,1007,Eyeshadow,200,400,200,2,00152,India
444931,2023-05-26,1008,Makeup Remover,80,160,80,2,00152,India
532699,2023-05-26,1012,Body Lotion,200,400,200,1,00300,India
167148,2023-05-26,1005,Nail Polish,50,100,50,2,00362,India
167148,2023-05-26,1004,Eyeliner,100,200,100,2,00362,India
167148,2023-05-26,1001,Lipstick,150,300,150,2,00362,India
331572,2023-05-26,1008,Makeup Remover,80,160,80,2,00340,India
331572,2023-05-26,1002,Mascara,200,400,200,2,00340,India
331572,2023-05-26,1007,Eyeshadow,200,400,200,2,00340,India
611283,2023-05-26,1003,Foundation,300,600,300,2,00243,India
611283,2023-05-26,1009,Moisturizer,250,500,250,1,00243,India
646978,2023-05-26,1002,Mascara,200,400,200,2,00099,India
646978,2023-05-26,1001,Lipstick,150,300,150,2,00099,India
646978,2023-05-26,1008,Makeup Remover,80,160,80,2,00099,India
646978,2023-05-26,1012,Body Lotion,200,400,200,1,00099,India
219637,2023-05-26,1009,Moisturizer,250,500,250,1,00098,India
219637,2023-05-26,1007,Eyeshadow,200,400,200,2,00098,India
219637,2023-05-26,1002,Mascara,200,400,200,2,00098,India
859986,2023-05-26,1005,Nail Polish,50,100,50,2,00363,India
859986,2023-05-26,1003,Foundation,300,600,300,2,00363,India
859986,2023-05-26,1009,Moisturizer,250,500,250,1,00363,India
859986,2023-05-26,1002,Mascara,200,400,200,2,00363,India
837497,2023-05-26,1007,Eyeshadow,200,400,200,2,00271,India
837497,2023-05-26,1001,Lipstick,150,300,150,2,00271,India
837497,2023-05-26,1009,Moisturizer,250,500,250,1,00271,India
837497,2023-05-26,1008,Makeup Remover,80,160,80,2,00271,India
519842,2023-05-26,1005,Nail Polish,50,100,50,2,00035,India
475218,2023-05-26,1002,Mascara,200,400,200,2,00347,India
475218,2023-05-26,1004,Eyeliner,100,200,100,2,00347,India
451094,2023-05-26,1002,Mascara,200,400,200,2,00353,India
451094,2023-05-26,1012,Body Lotion,200,400,200,1,00353,India
451094,2023-05-26,1007,Eyeshadow,200,400,200,2,00353,India
451094,2023-05-26,1006,Blush,150,300,150,2,00353,India
988718,2023-05-26,1012,Body Lotion,200,400,200,1,00156,India
988718,2023-05-26,1007,Eyeshadow,200,400,200,2,00156,India
423992,2023-05-26,1009,Moisturizer,250,500,250,1,00496,India
423992,2023-05-26,1002,Mascara,200,400,200,2,00496,India
423992,2023-05-26,1003,Foundation,300,600,300,2,00496,India
233524,2023-05-26,1003,Foundation,300,600,300,2,00080,India
233524,2023-05-26,1009,Moisturizer,250,500,250,1,00080,India
233524,2023-05-26,1004,Eyeliner,100,200,100,2,00080,India
287917,2023-05-26,1007,Eyeshadow,200,400,200,2,00388,India
287917,2023-05-26,1001,Lipstick,150,300,150,2,00388,India
287917,2023-05-26,1002,Mascara,200,400,200,2,00388,India
287917,2023-05-26,1006,Blush,150,300,150,2,00388,India
504678,2023-05-26,1005,Nail Polish,50,100,50,2,00420,India
504678,2023-05-26,1012,Body Lotion,200,400,200,1,00420,India
504678,2023-05-26,1002,Mascara,200,400,200,2,00420,India
377970,2023-05-26,1008,Makeup Remover,80,160,80,2,00360,India
377970,2023-05-26,1001,Lipstick,150,300,150,2,00360,India
851840,2023-05-26,1012,Body Lotion,200,400,200,1,00076,India
851840,2023-05-26,1006,Blush,150,300,150,2,00076,India
851840,2023-05-26,1002,Mascara,200,400,200,2,00076,India
634868,2023-05-26,1012,Body Lotion,200,400,200,1,00147,India
634868,2023-05-26,1008,Makeup Remover,80,160,80,2,00147,India
712262,2023-05-26,1001,Lipstick,150,300,150,2,00021,India
988218,2023-05-26,1004,Eyeliner,100,200,100,2,00288,India
988218,2023-05-26,1001,Lipstick,150,300,150,2,00288,India
988218,2023-05-26,1009,Moisturizer,250,500,250,1,00288,India
988218,2023-05-26,1005,Nail Polish,50,100,50,2,00288,India
739219,2023-05-26,1004,Eyeliner,100,200,100,2,00119,India
739219,2023-05-26,1007,Eyeshadow,200,400,200,2,00119,India
739219,2023-05-26,1008,Makeup Remover,80,160,80,2,00119,India
971875,2023-05-26,1005,Nail Polish,50,100,50,2,00439,India
920677,2023-05-26,1001,Lipstick,150,300,150,2,00192,India
235734,2023-05-26,1003,Foundation,300,600,300,2,00333,India
235734,2023-05-26,1004,Eyeliner,100,200,100,2,00333,India
286789,2023-05-26,1006,Blush,150,300,150,2,00346,India
286789,2023-05-26,1005,Nail Polish,50,100,50,2,00346,India
286789,2023-05-26,1007,Eyeshadow,200,400,200,2,00346,India
286789,2023-05-26,1004,Eyeliner,100,200,100,2,00346,India
832004,2023-05-26,1004,Eyeliner,100,200,100,2,00166,India
325298,2023-05-26,1007,Eyeshadow,200,400,200,2,00470,India
611730,2023-05-26,1004,Eyeliner,100,200,100,2,00321,India
611730,2023-05-26,1007,Eyeshadow,200,400,200,2,00321,India
691960,2023-05-26,1003,Foundation,300,600,300,2,00209,India
691960,2023-05-26,1004,Eyeliner,100,200,100,2,00209,India
691960,2023-05-26,1012,Body Lotion,200,400,200,1,00209,India
390919,2023-05-26,1003,Foundation,300,600,300,2,00080,India
390919,2023-05-26,1001,Lipstick,150,300,150,2,00080,India
390919,2023-05-26,1005,Nail Polish,50,100,50,2,00080,India
816235,2023-05-26,1008,Makeup Remover,80,160,80,2,00386,India
511713,2023-05-26,1003,Foundation,300,600,300,2,00039,India
511713,2023-05-26,1008,Makeup Remover,80,160,80,2,00039,India
511713,2023-05-26,1012,Body Lotion,200,400,200,1,00039,India
511713,2023-05-26,1004,Eyeliner,100,200,100,2,00039,India
629342,2023-05-27,1008,Makeup Remover,80,160,80,2,00283,India
629342,2023-05-27,1007,Eyeshadow,200,400,200,2,00283,India
629342,2023-05-27,1012,Body Lotion,200,400,200,1,00283,India
283900,2023-05-27,1001,Lipstick,150,300,150,2,00401,India
283900,2023-05-27,1002,Mascara,200,400,200,2,00401,India
283900,2023-05-27,1012,Body Lotion,200,400,200,1,00401,India
180711,2023-05-27,1012,Body Lotion,200,400,200,1,00482,India
180711,2023-05-27,1003,Foundation,300,600,300,2,00482,India
180711,2023-05-27,1005,Nail Polish,50,100,50,2,00482,India
159704,2023-05-27,1009,Moisturizer,250,500,250,1,00207,India
159704,2023-05-27,1004,Eyeliner,100,200,100,2,00207,India
159704,2023-05-27,1006,Blush,150,300,150,2,00207,India
159704,2023-05-27,1005,Nail Polish,50,100,50,2,00207,India
159704,2023-05-27,1012,Body Lotion,200,400,200,1,00207,India
918124,2023-05-27,1008,Makeup Remover,80,160,80,2,00464,India
918124,2023-05-27,1012,Body Lotion,200,400,200,1,00464,India
918124,2023-05-27,1006,Blush,150,300,150,2,00464,India
320361,2023-05-27,1012,Body Lotion,200,400,200,1,00288,India
320361,2023-05-27,1008,Makeup Remover,80,160,80,2,00288,India
320361,2023-05-27,1009,Moisturizer,250,500,250,1,00288,India
320361,2023-05-27,1006,Blush,150,300,150,2,00288,India
503641,2023-05-27,1002,Mascara,200,400,200,2,00385,India
503641,2023-05-27,1003,Foundation,300,600,300,2,00385,India
503641,2023-05-27,1007,Eyeshadow,200,400,200,2,00385,India
685272,2023-05-27,1009,Moisturizer,250,500,250,1,00391,India
685272,2023-05-27,1005,Nail Polish,50,100,50,2,00391,India
221738,2023-05-27,1003,Foundation,300,600,300,2,00058,India
221738,2023-05-27,1012,Body Lotion,200,400,200,1,00058,India
221738,2023-05-27,1002,Mascara,200,400,200,2,00058,India
221738,2023-05-27,1005,Nail Polish,50,100,50,2,00058,India
221738,2023-05-27,1007,Eyeshadow,200,400,200,2,00058,India
560367,2023-05-27,1008,Makeup Remover,80,160,80,2,00015,India
560367,2023-05-27,1003,Foundation,300,600,300,2,00015,India
807253,2023-05-27,1006,Blush,150,300,150,2,00069,India
807253,2023-05-27,1009,Moisturizer,250,500,250,1,00069,India
807253,2023-05-27,1012,Body Lotion,200,400,200,1,00069,India
127482,2023-05-27,1009,Moisturizer,250,500,250,1,00133,India
127482,2023-05-27,1007,Eyeshadow,200,400,200,2,00133,India
127482,2023-05-27,1001,Lipstick,150,300,150,2,00133,India
127482,2023-05-27,1003,Foundation,300,600,300,2,00133,India
126508,2023-05-27,1012,Body Lotion,200,400,200,1,00313,India
126508,2023-05-27,1003,Foundation,300,600,300,2,00313,India
126508,2023-05-27,1007,Eyeshadow,200,400,200,2,00313,India
126508,2023-05-27,1005,Nail Polish,50,100,50,2,00313,India
514265,2023-05-27,1007,Eyeshadow,200,400,200,2,00123,India
514265,2023-05-27,1005,Nail Polish,50,100,50,2,00123,India
514265,2023-05-27,1006,Blush,150,300,150,2,00123,India
514265,2023-05-27,1009,Moisturizer,250,500,250,1,00123,India
710031,2023-05-27,1006,Blush,150,300,150,2,00325,India
710031,2023-05-27,1004,Eyeliner,100,200,100,2,00325,India
175397,2023-05-27,1012,Body Lotion,200,400,200,1,00014,India
175397,2023-05-27,1008,Makeup Remover,80,160,80,2,00014,India
836049,2023-05-27,1008,Makeup Remover,80,160,80,2,00170,India
784272,2023-05-27,1008,Makeup Remover,80,160,80,2,00147,India
586839,2023-05-27,1002,Mascara,200,400,200,2,00067,India
586839,2023-05-27,1012,Body Lotion,200,400,200,1,00067,India
586839,2023-05-27,1006,Blush,150,300,150,2,00067,India
540022,2023-05-27,1006,Blush,150,300,150,2,00272,India
540022,2023-05-27,1012,Body Lotion,200,400,200,1,00272,India
547994,2023-05-27,1001,Lipstick,150,300,150,2,00277,India
547994,2023-05-27,1012,Body Lotion,200,400,200,1,00277,India
547994,2023-05-27,1003,Foundation,300,600,300,2,00277,India
547994,2023-05-27,1005,Nail Polish,50,100,50,2,00277,India
385948,2023-05-27,1009,Moisturizer,250,500,250,1,00245,India
385948,2023-05-27,1006,Blush,150,300,150,2,00245,India
385948,2023-05-27,1003,Foundation,300,600,300,2,00245,India
385948,2023-05-27,1002,Mascara,200,400,200,2,00245,India
385948,2023-05-27,1007,Eyeshadow,200,400,200,2,00245,India
553296,2023-05-27,1001,Lipstick,150,300,150,2,00338,India
553296,2023-05-27,1012,Body Lotion,200,400,200,1,00338,India
553296,2023-05-27,1003,Foundation,300,600,300,2,00338,India
553296,2023-05-27,1002,Mascara,200,400,200,2,00338,India
553296,2023-05-27,1004,Eyeliner,100,200,100,2,00338,India
441202,2023-05-27,1009,Moisturizer,250,500,250,1,00408,India
441202,2023-05-27,1003,Foundation,300,600,300,2,00408,India
898783,2023-05-27,1004,Eyeliner,100,200,100,2,00383,India
555486,2023-05-27,1001,Lipstick,150,300,150,2,00373,India
555486,2023-05-27,1005,Nail Polish,50,100,50,2,00373,India
522510,2023-05-27,1008,Makeup Remover,80,160,80,2,00485,India
522510,2023-05-27,1003,Foundation,300,600,300,2,00485,India
641519,2023-05-27,1006,Blush,150,300,150,2,00257,India
641519,2023-05-27,1008,Makeup Remover,80,160,80,2,00257,India
641519,2023-05-27,1009,Moisturizer,250,500,250,1,00257,India
247499,2023-05-27,1012,Body Lotion,200,400,200,1,00342,India
247499,2023-05-27,1008,Makeup Remover,80,160,80,2,00342,India
247499,2023-05-27,1007,Eyeshadow,200,400,200,2,00342,India
247499,2023-05-27,1003,Foundation,300,600,300,2,00342,India
644094,2023-05-27,1005,Nail Polish,50,100,50,2,00453,India
644094,2023-05-27,1007,Eyeshadow,200,400,200,2,00453,India
644094,2023-05-27,1004,Eyeliner,100,200,100,2,00453,India
644094,2023-05-27,1009,Moisturizer,250,500,250,1,00453,India
841296,2023-05-27,1005,Nail Polish,50,100,50,2,00292,India
841296,2023-05-27,1009,Moisturizer,250,500,250,1,00292,India
841296,2023-05-27,1002,Mascara,200,400,200,2,00292,India
841296,2023-05-27,1006,Blush,150,300,150,2,00292,India
841296,2023-05-27,1001,Lipstick,150,300,150,2,00292,India
620651,2023-05-27,1009,Moisturizer,250,500,250,1,00111,India
620651,2023-05-27,1006,Blush,150,300,150,2,00111,India
620651,2023-05-27,1004,Eyeliner,100,200,100,2,00111,India
165341,2023-05-27,1009,Moisturizer,250,500,250,1,00472,India
165341,2023-05-27,1005,Nail Polish,50,100,50,2,00472,India
165341,2023-05-27,1006,Blush,150,300,150,2,00472,India
243751,2023-05-27,1007,Eyeshadow,200,400,200,2,00268,India
243751,2023-05-27,1012,Body Lotion,200,400,200,1,00268,India
932001,2023-05-27,1004,Eyeliner,100,200,100,2,00034,India
805653,2023-05-27,1006,Blush,150,300,150,2,00094,India
805653,2023-05-27,1009,Moisturizer,250,500,250,1,00094,India
805653,2023-05-27,1003,Foundation,300,600,300,2,00094,India
798633,2023-05-27,1002,Mascara,200,400,200,2,00223,India
798633,2023-05-27,1005,Nail Polish,50,100,50,2,00223,India
798633,2023-05-27,1004,Eyeliner,100,200,100,2,00223,India
798633,2023-05-27,1006,Blush,150,300,150,2,00223,India
912398,2023-05-27,1002,Mascara,200,400,200,2,00198,India
912398,2023-05-27,1012,Body Lotion,200,400,200,1,00198,India
912398,2023-05-27,1007,Eyeshadow,200,400,200,2,00198,India
912398,2023-05-27,1004,Eyeliner,100,200,100,2,00198,India
912398,2023-05-27,1001,Lipstick,150,300,150,2,00198,India
260869,2023-05-27,1012,Body Lotion,200,400,200,1,00221,India
260869,2023-05-27,1007,Eyeshadow,200,400,200,2,00221,India
260869,2023-05-27,1009,Moisturizer,250,500,250,1,00221,India
840226,2023-05-27,1005,Nail Polish,50,100,50,2,00312,India
840226,2023-05-27,1004,Eyeliner,100,200,100,2,00312,India
840226,2023-05-27,1006,Blush,150,300,150,2,00312,India
902334,2023-05-27,1009,Moisturizer,250,500,250,1,00408,India
697918,2023-05-27,1001,Lipstick,150,300,150,2,00475,India
697918,2023-05-27,1007,Eyeshadow,200,400,200,2,00475,India
697918,2023-05-27,1003,Foundation,300,600,300,2,00475,India
697918,2023-05-27,1002,Mascara,200,400,200,2,00475,India
697918,2023-05-27,1012,Body Lotion,200,400,200,1,00475,India
685378,2023-05-27,1003,Foundation,300,600,300,2,00370,India
763373,2023-05-27,1008,Makeup Remover,80,160,80,2,00364,India
763373,2023-05-27,1005,Nail Polish,50,100,50,2,00364,India
763373,2023-05-27,1007,Eyeshadow,200,400,200,2,00364,India
763373,2023-05-27,1003,Foundation,300,600,300,2,00364,India
921753,2023-05-27,1008,Makeup Remover,80,160,80,2,00129,India
921753,2023-05-27,1006,Blush,150,300,150,2,00129,India
966389,2023-05-28,1002,Mascara,200,400,200,2,00375,India
966389,2023-05-28,1012,Body Lotion,200,400,200,1,00375,India
966389,2023-05-28,1005,Nail Polish,50,100,50,2,00375,India
966389,2023-05-28,1008,Makeup Remover,80,160,80,2,00375,India
733390,2023-05-28,1008,Makeup Remover,80,160,80,2,00051,India
733390,2023-05-28,1009,Moisturizer,250,500,250,1,00051,India
733390,2023-05-28,1006,Blush,150,300,150,2,00051,India
733390,2023-05-28,1007,Eyeshadow,200,400,200,2,00051,India
273368,2023-05-28,1012,Body Lotion,200,400,200,1,00089,India
273368,2023-05-28,1001,Lipstick,150,300,150,2,00089,India
273368,2023-05-28,1006,Blush,150,300,150,2,00089,India
612442,2023-05-28,1005,Nail Polish,50,100,50,2,00423,India
612442,2023-05-28,1004,Eyeliner,100,200,100,2,00423,India
612442,2023-05-28,1008,Makeup Remover,80,160,80,2,00423,India
228371,2023-05-28,1001,Lipstick,150,300,150,2,00129,India
980236,2023-05-28,1005,Nail Polish,50,100,50,2,00140,India
980236,2023-05-28,1012,Body Lotion,200,400,200,1,00140,India
980236,2023-05-28,1001,Lipstick,150,300,150,2,00140,India
361900,2023-05-28,1012,Body Lotion,200,400,200,1,00307,India
126970,2023-05-28,1004,Eyeliner,100,200,100,2,00449,India
126970,2023-05-28,1007,Eyeshadow,200,400,200,2,00449,India
126970,2023-05-28,1008,Makeup Remover,80,160,80,2,00449,India
889114,2023-05-28,1007,Eyeshadow,200,400,200,2,00176,India
889114,2023-05-28,1003,Foundation,300,600,300,2,00176,India
889114,2023-05-28,1004,Eyeliner,100,200,100,2,00176,India
889114,2023-05-28,1002,Mascara,200,400,200,2,00176,India
584250,2023-05-28,1006,Blush,150,300,150,2,00204,India
810079,2023-05-28,1003,Foundation,300,600,300,2,00249,India
810079,2023-05-28,1002,Mascara,200,400,200,2,00249,India
810079,2023-05-28,1008,Makeup Remover,80,160,80,2,00249,India
810079,2023-05-28,1005,Nail Polish,50,100,50,2,00249,India
833031,2023-05-28,1004,Eyeliner,100,200,100,2,00419,India
125022,2023-05-28,1001,Lipstick,150,300,150,2,00337,India
125022,2023-05-28,1006,Blush,150,300,150,2,00337,India
125022,2023-05-28,1005,Nail Polish,50,100,50,2,00337,India
125022,2023-05-28,1003,Foundation,300,600,300,2,00337,India
575472,2023-05-28,1007,Eyeshadow,200,400,200,2,00105,India
524703,2023-05-28,1009,Moisturizer,250,500,250,1,00428,India
524703,2023-05-28,1003,Foundation,300,600,300,2,00428,India
655629,2023-05-28,1003,Foundation,300,600,300,2,00266,India
655629,2023-05-28,1008,Makeup Remover,80,160,80,2,00266,India
195423,2023-05-28,1009,Moisturizer,250,500,250,1,00306,India
195423,2023-05-28,1006,Blush,150,300,150,2,00306,India
195423,2023-05-28,1001,Lipstick,150,300,150,2,00306,India
885470,2023-05-28,1012,Body Lotion,200,400,200,1,00145,India
885470,2023-05-28,1001,Lipstick,150,300,150,2,00145,India
885470,2023-05-28,1009,Moisturizer,250,500,250,1,00145,India
303041,2023-05-28,1012,Body Lotion,200,400,200,1,00343,India
303041,2023-05-28,1006,Blush,150,300,150,2,00343,India
303041,2023-05-28,1002,Mascara,200,400,200,2,00343,India
448944,2023-05-28,1002,Mascara,200,400,200,2,00430,India
448944,2023-05-28,1009,Moisturizer,250,500,250,1,00430,India
448944,2023-05-28,1012,Body Lotion,200,400,200,1,00430,India
828929,2023-05-28,1001,Lipstick,150,300,150,2,00402,India
828929,2023-05-28,1012,Body Lotion,200,400,200,1,00402,India
828929,2023-05-28,1009,Moisturizer,250,500,250,1,00402,India
546564,2023-05-28,1009,Moisturizer,250,500,250,1,00359,India
546564,2023-05-28,1003,Foundation,300,600,300,2,00359,India
546564,2023-05-28,1002,Mascara,200,400,200,2,00359,India
841717,2023-05-28,1008,Makeup Remover,80,160,80,2,00292,India
636548,2023-05-28,1004,Eyeliner,100,200,100,2,00457,India
636548,2023-05-28,1006,Blush,150,300,150,2,00457,India
765782,2023-05-28,1012,Body Lotion,200,400,200,1,00124,India
765782,2023-05-28,1009,Moisturizer,250,500,250,1,00124,India
953195,2023-05-28,1004,Eyeliner,100,200,100,2,00445,India
953195,2023-05-28,1005,Nail Polish,50,100,50,2,00445,India
953195,2023-05-28,1006,Blush,150,300,150,2,00445,India
953195,2023-05-28,1008,Makeup Remover,80,160,80,2,00445,India
463186,2023-05-28,1008,Makeup Remover,80,160,80,2,00085,India
463186,2023-05-28,1001,Lipstick,150,300,150,2,00085,India
463186,2023-05-28,1004,Eyeliner,100,200,100,2,00085,India
213415,2023-05-28,1009,Moisturizer,250,500,250,1,00275,India
213415,2023-05-28,1005,Nail Polish,50,100,50,2,00275,India
213415,2023-05-28,1002,Mascara,200,400,200,2,00275,India
649555,2023-05-28,1003,Foundation,300,600,300,2,00254,India
649555,2023-05-28,1008,Makeup Remover,80,160,80,2,00254,India
649555,2023-05-28,1005,Nail Polish,50,100,50,2,00254,India
649555,2023-05-28,1007,Eyeshadow,200,400,200,2,00254,India
649555,2023-05-28,1009,Moisturizer,250,500,250,1,00254,India
317800,2023-05-28,1005,Nail Polish,50,100,50,2,00208,India
317800,2023-05-28,1007,Eyeshadow,200,400,200,2,00208,India
317800,2023-05-28,1006,Blush,150,300,150,2,00208,India
986088,2023-05-28,1004,Eyeliner,100,200,100,2,00319,India
986088,2023-05-28,1009,Moisturizer,250,500,250,1,00319,India
219948,2023-05-28,1001,Lipstick,150,300,150,2,00360,India
219948,2023-05-28,1009,Moisturizer,250,500,250,1,00360,India
219948,2023-05-28,1002,Mascara,200,400,200,2,00360,India
219948,2023-05-28,1008,Makeup Remover,80,160,80,2,00360,India
986079,2023-05-28,1003,Foundation,300,600,300,2,00221,India
986079,2023-05-28,1009,Moisturizer,250,500,250,1,00221,India
358474,2023-05-28,1005,Nail Polish,50,100,50,2,00071,India
358474,2023-05-28,1007,Eyeshadow,200,400,200,2,00071,India
358474,2023-05-28,1006,Blush,150,300,150,2,00071,India
999820,2023-05-28,1003,Foundation,300,600,300,2,00330,India
999820,2023-05-28,1001,Lipstick,150,300,150,2,00330,India
999820,2023-05-28,1005,Nail Polish,50,100,50,2,00330,India
278910,2023-05-28,1008,Makeup Remover,80,160,80,2,00068,India
278910,2023-05-28,1007,Eyeshadow,200,400,200,2,00068,India
870789,2023-05-28,1009,Moisturizer,250,500,250,1,00360,India
870789,2023-05-28,1007,Eyeshadow,200,400,200,2,00360,India
427061,2023-05-28,1008,Makeup Remover,80,160,80,2,00274,India
427061,2023-05-28,1001,Lipstick,150,300,150,2,00274,India
115225,2023-05-28,1009,Moisturizer,250,500,250,1,00114,India
115225,2023-05-28,1005,Nail Polish,50,100,50,2,00114,India
115225,2023-05-28,1001,Lipstick,150,300,150,2,00114,India
115225,2023-05-28,1004,Eyeliner,100,200,100,2,00114,India
127247,2023-05-28,1007,Eyeshadow,200,400,200,2,00370,India
127247,2023-05-28,1001,Lipstick,150,300,150,2,00370,India
127247,2023-05-28,1002,Mascara,200,400,200,2,00370,India
127247,2023-05-28,1012,Body Lotion,200,400,200,1,00370,India
719109,2023-05-28,1007,Eyeshadow,200,400,200,2,00234,India
301614,2023-05-29,1007,Eyeshadow,200,400,200,2,00344,India
301614,2023-05-29,1006,Blush,150,300,150,2,00344,India
301614,2023-05-29,1001,Lipstick,150,300,150,2,00344,India
588241,2023-05-29,1002,Mascara,200,400,200,2,00261,India
588241,2023-05-29,1006,Blush,150,300,150,2,00261,India
493782,2023-05-29,1008,Makeup Remover,80,160,80,2,00288,India
493782,2023-05-29,1006,Blush,150,300,150,2,00288,India
493782,2023-05-29,1001,Lipstick,150,300,150,2,00288,India
289911,2023-05-29,1001,Lipstick,150,300,150,2,00072,India
289911,2023-05-29,1003,Foundation,300,600,300,2,00072,India
289911,2023-05-29,1002,Mascara,200,400,200,2,00072,India
297278,2023-05-29,1006,Blush,150,300,150,2,00268,India
297278,2023-05-29,1008,Makeup Remover,80,160,80,2,00268,India
297278,2023-05-29,1004,Eyeliner,100,200,100,2,00268,India
670358,2023-05-29,1004,Eyeliner,100,200,100,2,00475,India
670358,2023-05-29,1008,Makeup Remover,80,160,80,2,00475,India
939783,2023-05-29,1008,Makeup Remover,80,160,80,2,00360,India
816405,2023-05-29,1009,Moisturizer,250,500,250,1,00415,India
816405,2023-05-29,1005,Nail Polish,50,100,50,2,00415,India
816405,2023-05-29,1001,Lipstick,150,300,150,2,00415,India
672968,2023-05-29,1012,Body Lotion,200,400,200,1,00295,India
672968,2023-05-29,1009,Moisturizer,250,500,250,1,00295,India
672968,2023-05-29,1007,Eyeshadow,200,400,200,2,00295,India
267797,2023-05-29,1003,Foundation,300,600,300,2,00423,India
267797,2023-05-29,1009,Moisturizer,250,500,250,1,00423,India
267797,2023-05-29,1002,Mascara,200,400,200,2,00423,India
267797,2023-05-29,1004,Eyeliner,100,200,100,2,00423,India
586138,2023-05-29,1006,Blush,150,300,150,2,00328,India
586138,2023-05-29,1001,Lipstick,150,300,150,2,00328,India
586138,2023-05-29,1008,Makeup Remover,80,160,80,2,00328,India
586138,2023-05-29,1007,Eyeshadow,200,400,200,2,00328,India
406966,2023-05-29,1006,Blush,150,300,150,2,00340,India
146557,2023-05-29,1002,Mascara,200,400,200,2,00140,India
146557,2023-05-29,1004,Eyeliner,100,200,100,2,00140,India
368106,2023-05-29,1008,Makeup Remover,80,160,80,2,00299,India
253700,2023-05-29,1001,Lipstick,150,300,150,2,00307,India
253700,2023-05-29,1012,Body Lotion,200,400,200,1,00307,India
253700,2023-05-29,1008,Makeup Remover,80,160,80,2,00307,India
476557,2023-05-29,1003,Foundation,300,600,300,2,00418,India
476557,2023-05-29,1012,Body Lotion,200,400,200,1,00418,India
975739,2023-05-29,1006,Blush,150,300,150,2,00236,India
975739,2023-05-29,1012,Body Lotion,200,400,200,1,00236,India
575319,2023-05-29,1005,Nail Polish,50,100,50,2,00468,India
132968,2023-05-29,1001,Lipstick,150,300,150,2,00140,India
836506,2023-05-29,1001,Lipstick,150,300,150,2,00063,India
595643,2023-05-29,1008,Makeup Remover,80,160,80,2,00243,India
423646,2023-05-29,1004,Eyeliner,100,200,100,2,00412,India
423646,2023-05-29,1001,Lipstick,150,300,150,2,00412,India
438155,2023-05-29,1004,Eyeliner,100,200,100,2,00349,India
438155,2023-05-29,1005,Nail Polish,50,100,50,2,00349,India
477154,2023-05-29,1009,Moisturizer,250,500,250,1,00236,India
610053,2023-05-29,1006,Blush,150,300,150,2,00345,India
106045,2023-05-29,1007,Eyeshadow,200,400,200,2,00151,India
490458,2023-05-29,1006,Blush,150,300,150,2,00155,India
490458,2023-05-29,1005,Nail Polish,50,100,50,2,00155,India
490458,2023-05-29,1009,Moisturizer,250,500,250,1,00155,India
472040,2023-05-29,1002,Mascara,200,400,200,2,00090,India
472040,2023-05-29,1008,Makeup Remover,80,160,80,2,00090,India
420226,2023-05-29,1009,Moisturizer,250,500,250,1,00453,India
219871,2023-05-29,1005,Nail Polish,50,100,50,2,00436,India
219871,2023-05-29,1012,Body Lotion,200,400,200,1,00436,India
769184,2023-05-29,1007,Eyeshadow,200,400,200,2,00197,India
769184,2023-05-29,1009,Moisturizer,250,500,250,1,00197,India
769184,2023-05-29,1002,Mascara,200,400,200,2,00197,India
769184,2023-05-29,1004,Eyeliner,100,200,100,2,00197,India
122791,2023-05-29,1006,Blush,150,300,150,2,00016,India
620713,2023-05-29,1006,Blush,150,300,150,2,00262,India
620713,2023-05-29,1008,Makeup Remover,80,160,80,2,00262,India
262332,2023-05-29,1008,Makeup Remover,80,160,80,2,00461,India
262332,2023-05-29,1002,Mascara,200,400,200,2,00461,India
262332,2023-05-29,1004,Eyeliner,100,200,100,2,00461,India
262332,2023-05-29,1001,Lipstick,150,300,150,2,00461,India
305154,2023-05-29,1002,Mascara,200,400,200,2,00037,India
739985,2023-05-29,1003,Foundation,300,600,300,2,00228,India
739985,2023-05-29,1004,Eyeliner,100,200,100,2,00228,India
727367,2023-05-29,1004,Eyeliner,100,200,100,2,00268,India
727367,2023-05-29,1002,Mascara,200,400,200,2,00268,India
773138,2023-05-29,1009,Moisturizer,250,500,250,1,00143,India
773138,2023-05-29,1012,Body Lotion,200,400,200,1,00143,India
773138,2023-05-29,1008,Makeup Remover,80,160,80,2,00143,India
547915,2023-05-29,1008,Makeup Remover,80,160,80,2,00329,India
611512,2023-05-29,1003,Foundation,300,600,300,2,00002,India
611512,2023-05-29,1001,Lipstick,150,300,150,2,00002,India
202740,2023-05-29,1002,Mascara,200,400,200,2,00496,India
202740,2023-05-29,1012,Body Lotion,200,400,200,1,00496,India
431509,2023-05-29,1009,Moisturizer,250,500,250,1,00098,India
431509,2023-05-29,1006,Blush,150,300,150,2,00098,India
431509,2023-05-29,1001,Lipstick,150,300,150,2,00098,India
431509,2023-05-29,1002,Mascara,200,400,200,2,00098,India
107345,2023-05-29,1002,Mascara,200,400,200,2,00424,India
107345,2023-05-29,1006,Blush,150,300,150,2,00424,India
259699,2023-05-29,1002,Mascara,200,400,200,2,00124,India
259699,2023-05-29,1007,Eyeshadow,200,400,200,2,00124,India
259699,2023-05-29,1009,Moisturizer,250,500,250,1,00124,India
259699,2023-05-29,1006,Blush,150,300,150,2,00124,India
576584,2023-05-29,1004,Eyeliner,100,200,100,2,00159,India
659549,2023-05-29,1008,Makeup Remover,80,160,80,2,00110,India
330769,2023-05-30,1003,Foundation,300,600,300,2,00379,India
330769,2023-05-30,1001,Lipstick,150,300,150,2,00379,India
943898,2023-05-30,1001,Lipstick,150,300,150,2,00176,India
943898,2023-05-30,1002,Mascara,200,400,200,2,00176,India
943898,2023-05-30,1005,Nail Polish,50,100,50,2,00176,India
943898,2023-05-30,1012,Body Lotion,200,400,200,1,00176,India
763529,2023-05-30,1005,Nail Polish,50,100,50,2,00413,India
763529,2023-05-30,1001,Lipstick,150,300,150,2,00413,India
824372,2023-05-30,1008,Makeup Remover,80,160,80,2,00184,India
824372,2023-05-30,1001,Lipstick,150,300,150,2,00184,India
340576,2023-05-30,1002,Mascara,200,400,200,2,00491,India
340576,2023-05-30,1001,Lipstick,150,300,150,2,00491,India
340576,2023-05-30,1007,Eyeshadow,200,400,200,2,00491,India
157076,2023-05-30,1001,Lipstick,150,300,150,2,00271,India
240570,2023-05-30,1009,Moisturizer,250,500,250,1,00282,India
240570,2023-05-30,1003,Foundation,300,600,300,2,00282,India
240570,2023-05-30,1008,Makeup Remover,80,160,80,2,00282,India
240570,2023-05-30,1005,Nail Polish,50,100,50,2,00282,India
611789,2023-05-30,1012,Body Lotion,200,400,200,1,00355,India
611789,2023-05-30,1002,Mascara,200,400,200,2,00355,India
611789,2023-05-30,1007,Eyeshadow,200,400,200,2,00355,India
611789,2023-05-30,1001,Lipstick,150,300,150,2,00355,India
533796,2023-05-30,1007,Eyeshadow,200,400,200,2,00378,India
533796,2023-05-30,1001,Lipstick,150,300,150,2,00378,India
533796,2023-05-30,1005,Nail Polish,50,100,50,2,00378,India
533796,2023-05-30,1006,Blush,150,300,150,2,00378,India
823218,2023-05-30,1012,Body Lotion,200,400,200,1,00425,India
823218,2023-05-30,1005,Nail Polish,50,100,50,2,00425,India
521276,2023-05-30,1008,Makeup Remover,80,160,80,2,00195,India
475035,2023-05-30,1002,Mascara,200,400,200,2,00414,India
288764,2023-05-30,1007,Eyeshadow,200,400,200,2,00450,India
288764,2023-05-30,1005,Nail Polish,50,100,50,2,00450,India
288764,2023-05-30,1004,Eyeliner,100,200,100,2,00450,India
789216,2023-05-30,1003,Foundation,300,600,300,2,00079,India
789216,2023-05-30,1012,Body Lotion,200,400,200,1,00079,India
592480,2023-05-30,1004,Eyeliner,100,200,100,2,00375,India
282129,2023-05-30,1001,Lipstick,150,300,150,2,00078,India
282129,2023-05-30,1005,Nail Polish,50,100,50,2,00078,India
797346,2023-05-30,1002,Mascara,200,400,200,2,00350,India
797346,2023-05-30,1006,Blush,150,300,150,2,00350,India
797346,2023-05-30,1001,Lipstick,150,300,150,2,00350,India
517533,2023-05-30,1009,Moisturizer,250,500,250,1,00184,India
517533,2023-05-30,1001,Lipstick,150,300,150,2,00184,India
517533,2023-05-30,1007,Eyeshadow,200,400,200,2,00184,India
811553,2023-05-30,1007,Eyeshadow,200,400,200,2,00498,India
811553,2023-05-30,1002,Mascara,200,400,200,2,00498,India
382366,2023-05-30,1004,Eyeliner,100,200,100,2,00100,India
382366,2023-05-30,1001,Lipstick,150,300,150,2,00100,India
156687,2023-05-30,1008,Makeup Remover,80,160,80,2,00359,India
559982,2023-05-30,1009,Moisturizer,250,500,250,1,00315,India
559982,2023-05-30,1003,Foundation,300,600,300,2,00315,India
559982,2023-05-30,1006,Blush,150,300,150,2,00315,India
438752,2023-05-30,1004,Eyeliner,100,200,100,2,00081,India
438752,2023-05-30,1001,Lipstick,150,300,150,2,00081,India
438752,2023-05-30,1003,Foundation,300,600,300,2,00081,India
438752,2023-05-30,1009,Moisturizer,250,500,250,1,00081,India
662929,2023-05-30,1012,Body Lotion,200,400,200,1,00365,India
662929,2023-05-30,1008,Makeup Remover,80,160,80,2,00365,India
662929,2023-05-30,1006,Blush,150,300,150,2,00365,India
662929,2023-05-30,1001,Lipstick,150,300,150,2,00365,India
772559,2023-05-30,1001,Lipstick,150,300,150,2,00273,India
772559,2023-05-30,1004,Eyeliner,100,200,100,2,00273,India
852601,2023-05-30,1001,Lipstick,150,300,150,2,00328,India
852601,2023-05-30,1008,Makeup Remover,80,160,80,2,00328,India
852601,2023-05-30,1004,Eyeliner,100,200,100,2,00328,India
994985,2023-05-30,1005,Nail Polish,50,100,50,2,00421,India
994985,2023-05-30,1003,Foundation,300,600,300,2,00421,India
903720,2023-05-30,1008,Makeup Remover,80,160,80,2,00426,India
903720,2023-05-30,1006,Blush,150,300,150,2,00426,India
903720,2023-05-30,1005,Nail Polish,50,100,50,2,00426,India
903720,2023-05-30,1009,Moisturizer,250,500,250,1,00426,India
880744,2023-05-30,1001,Lipstick,150,300,150,2,00135,India
176417,2023-05-30,1007,Eyeshadow,200,400,200,2,00260,India
176417,2023-05-30,1012,Body Lotion,200,400,200,1,00260,India
693321,2023-05-30,1008,Makeup Remover,80,160,80,2,00013,India
700643,2023-05-30,1003,Foundation,300,600,300,2,00068,India
700643,2023-05-30,1001,Lipstick,150,300,150,2,00068,India
166696,2023-05-30,1008,Makeup Remover,80,160,80,2,00073,India
166696,2023-05-30,1003,Foundation,300,600,300,2,00073,India
467761,2023-05-30,1002,Mascara,200,400,200,2,00306,India
677708,2023-05-30,1006,Blush,150,300,150,2,00340,India
677708,2023-05-30,1003,Foundation,300,600,300,2,00340,India
677708,2023-05-30,1002,Mascara,200,400,200,2,00340,India
677708,2023-05-30,1009,Moisturizer,250,500,250,1,00340,India
677708,2023-05-30,1004,Eyeliner,100,200,100,2,00340,India
690910,2023-05-30,1008,Makeup Remover,80,160,80,2,00443,India
690910,2023-05-30,1012,Body Lotion,200,400,200,1,00443,India
690910,2023-05-30,1002,Mascara,200,400,200,2,00443,India
690910,2023-05-30,1001,Lipstick,150,300,150,2,00443,India
737643,2023-05-30,1001,Lipstick,150,300,150,2,00468,India
737643,2023-05-30,1002,Mascara,200,400,200,2,00468,India
737643,2023-05-30,1009,Moisturizer,250,500,250,1,00468,India
737643,2023-05-30,1005,Nail Polish,50,100,50,2,00468,India
345588,2023-05-31,1004,Eyeliner,100,200,100,2,00199,India
345588,2023-05-31,1009,Moisturizer,250,500,250,1,00199,India
345588,2023-05-31,1003,Foundation,300,600,300,2,00199,India
407141,2023-05-31,1007,Eyeshadow,200,400,200,2,00194,India
407141,2023-05-31,1003,Foundation,300,600,300,2,00194,India
407141,2023-05-31,1009,Moisturizer,250,500,250,1,00194,India
407141,2023-05-31,1001,Lipstick,150,300,150,2,00194,India
253595,2023-05-31,1009,Moisturizer,250,500,250,1,00457,India
253595,2023-05-31,1003,Foundation,300,600,300,2,00457,India
253595,2023-05-31,1006,Blush,150,300,150,2,00457,India
253595,2023-05-31,1012,Body Lotion,200,400,200,1,00457,India
291458,2023-05-31,1004,Eyeliner,100,200,100,2,00358,India
291458,2023-05-31,1006,Blush,150,300,150,2,00358,India
291458,2023-05-31,1003,Foundation,300,600,300,2,00358,India
291458,2023-05-31,1012,Body Lotion,200,400,200,1,00358,India
639335,2023-05-31,1006,Blush,150,300,150,2,00442,India
639335,2023-05-31,1005,Nail Polish,50,100,50,2,00442,India
111476,2023-05-31,1003,Foundation,300,600,300,2,00076,India
111476,2023-05-31,1004,Eyeliner,100,200,100,2,00076,India
111476,2023-05-31,1012,Body Lotion,200,400,200,1,00076,India
383228,2023-05-31,1005,Nail Polish,50,100,50,2,00325,India
467731,2023-05-31,1003,Foundation,300,600,300,2,00148,India
467731,2023-05-31,1012,Body Lotion,200,400,200,1,00148,India
467731,2023-05-31,1002,Mascara,200,400,200,2,00148,India
659080,2023-05-31,1005,Nail Polish,50,100,50,2,00346,India
659080,2023-05-31,1007,Eyeshadow,200,400,200,2,00346,India
659080,2023-05-31,1009,Moisturizer,250,500,250,1,00346,India
659080,2023-05-31,1008,Makeup Remover,80,160,80,2,00346,India
719808,2023-05-31,1012,Body Lotion,200,400,200,1,00027,India
719808,2023-05-31,1002,Mascara,200,400,200,2,00027,India
719808,2023-05-31,1007,Eyeshadow,200,400,200,2,00027,India
763838,2023-05-31,1009,Moisturizer,250,500,250,1,00036,India
262929,2023-05-31,1001,Lipstick,150,300,150,2,00316,India
262929,2023-05-31,1006,Blush,150,300,150,2,00316,India
262929,2023-05-31,1007,Eyeshadow,200,400,200,2,00316,India
262929,2023-05-31,1009,Moisturizer,250,500,250,1,00316,India
262929,2023-05-31,1005,Nail Polish,50,100,50,2,00316,India
502777,2023-05-31,1008,Makeup Remover,80,160,80,2,00005,India
502777,2023-05-31,1003,Foundation,300,600,300,2,00005,India
502777,2023-05-31,1001,Lipstick,150,300,150,2,00005,India
502777,2023-05-31,1004,Eyeliner,100,200,100,2,00005,India
363592,2023-05-31,1012,Body Lotion,200,400,200,1,00454,India
363592,2023-05-31,1001,Lipstick,150,300,150,2,00454,India
576866,2023-05-31,1008,Makeup Remover,80,160,80,2,00099,India
576866,2023-05-31,1009,Moisturizer,250,500,250,1,00099,India
576866,2023-05-31,1006,Blush,150,300,150,2,00099,India
210475,2023-05-31,1002,Mascara,200,400,200,2,00002,India
210475,2023-05-31,1005,Nail Polish,50,100,50,2,00002,India
210475,2023-05-31,1008,Makeup Remover,80,160,80,2,00002,India
291244,2023-05-31,1007,Eyeshadow,200,400,200,2,00062,India
291244,2023-05-31,1001,Lipstick,150,300,150,2,00062,India
291244,2023-05-31,1004,Eyeliner,100,200,100,2,00062,India
291244,2023-05-31,1006,Blush,150,300,150,2,00062,India
316943,2023-05-31,1009,Moisturizer,250,500,250,1,00011,India
316943,2023-05-31,1008,Makeup Remover,80,160,80,2,00011,India
316943,2023-05-31,1005,Nail Polish,50,100,50,2,00011,India
380574,2023-05-31,1004,Eyeliner,100,200,100,2,00282,India
401221,2023-05-31,1005,Nail Polish,50,100,50,2,00292,India
611397,2023-05-31,1008,Makeup Remover,80,160,80,2,00040,India
611397,2023-05-31,1009,Moisturizer,250,500,250,1,00040,India
611397,2023-05-31,1007,Eyeshadow,200,400,200,2,00040,India
537381,2023-05-31,1006,Blush,150,300,150,2,00087,India
537381,2023-05-31,1002,Mascara,200,400,200,2,00087,India
278006,2023-05-31,1005,Nail Polish,50,100,50,2,00232,India
136430,2023-05-31,1005,Nail Polish,50,100,50,2,00099,India
136430,2023-05-31,1003,Foundation,300,600,300,2,00099,India
997531,2023-05-31,1004,Eyeliner,100,200,100,2,00253,India
997531,2023-05-31,1005,Nail Polish,50,100,50,2,00253,India
997531,2023-05-31,1006,Blush,150,300,150,2,00253,India
413000,2023-05-31,1001,Lipstick,150,300,150,2,00325,India
142285,2023-05-31,1009,Moisturizer,250,500,250,1,00340,India
142285,2023-05-31,1002,Mascara,200,400,200,2,00340,India
547195,2023-05-31,1006,Blush,150,300,150,2,00087,India
547195,2023-05-31,1008,Makeup Remover,80,160,80,2,00087,India
547195,2023-05-31,1002,Mascara,200,400,200,2,00087,India
547195,2023-05-31,1012,Body Lotion,200,400,200,1,00087,India
330941,2023-05-31,1002,Mascara,200,400,200,2,00335,India
352516,2023-05-31,1001,Lipstick,150,300,150,2,00068,India
352516,2023-05-31,1008,Makeup Remover,80,160,80,2,00068,India
183994,2023-05-31,1012,Body Lotion,200,400,200,1,00162,India
183994,2023-05-31,1005,Nail Polish,50,100,50,2,00162,India
760799,2023-05-31,1006,Blush,150,300,150,2,00208,India
760799,2023-05-31,1005,Nail Polish,50,100,50,2,00208,India
760799,2023-05-31,1001,Lipstick,150,300,150,2,00208,India
760799,2023-05-31,1007,Eyeshadow,200,400,200,2,00208,India
479439,2023-05-31,1006,Blush,150,300,150,2,00351,India
479439,2023-05-31,1012,Body Lotion,200,400,200,1,00351,India
479439,2023-05-31,1007,Eyeshadow,200,400,200,2,00351,India
479439,2023-05-31,1004,Eyeliner,100,200,100,2,00351,India
183001,2023-05-31,1009,Moisturizer,250,500,250,1,00342,India
508701,2023-05-31,1012,Body Lotion,200,400,200,1,00052,India
508701,2023-05-31,1001,Lipstick,150,300,150,2,00052,India
781344,2023-05-31,1003,Foundation,300,600,300,2,00312,India
781344,2023-05-31,1001,Lipstick,150,300,150,2,00312,India
470310,2023-05-31,1006,Blush,150,300,150,2,00219,India
470310,2023-05-31,1003,Foundation,300,600,300,2,00219,India
470310,2023-05-31,1008,Makeup Remover,80,160,80,2,00219,India
470310,2023-05-31,1005,Nail Polish,50,100,50,2,00219,India
247151,2023-06-01,1005,Nail Polish,50,100,50,1,00433,India
247151,2023-06-01,1007,Eyeshadow,200,400,200,1,00433,India
247151,2023-06-01,1001,Lipstick,150,300,150,1,00433,India
247151,2023-06-01,1009,Moisturizer,250,500,250,1,00433,India
902412,2023-06-01,1012,Body Lotion,200,400,200,1,00261,India
902412,2023-06-01,1006,Blush,150,300,150,1,00261,India
902412,2023-06-01,1005,Nail Polish,50,100,50,1,00261,India
796763,2023-06-01,1001,Lipstick,150,300,150,1,00204,India
796763,2023-06-01,1012,Body Lotion,200,400,200,1,00204,India
278031,2023-06-01,1001,Lipstick,150,300,150,1,00334,India
278031,2023-06-01,1004,Eyeliner,100,200,100,1,00334,India
186341,2023-06-01,1004,Eyeliner,100,200,100,1,00499,India
204392,2023-06-01,1008,Makeup Remover,80,160,80,1,00179,India
204392,2023-06-01,1006,Blush,150,300,150,1,00179,India
204392,2023-06-01,1004,Eyeliner,100,200,100,1,00179,India
764975,2023-06-01,1006,Blush,150,300,150,1,00303,India
764975,2023-06-01,1002,Mascara,200,400,200,1,00303,India
764975,2023-06-01,1009,Moisturizer,250,500,250,1,00303,India
764975,2023-06-01,1007,Eyeshadow,200,400,200,1,00303,India
852002,2023-06-01,1012,Body Lotion,200,400,200,1,00483,India
852002,2023-06-01,1007,Eyeshadow,200,400,200,1,00483,India
852002,2023-06-01,1009,Moisturizer,250,500,250,1,00483,India
681867,2023-06-01,1005,Nail Polish,50,100,50,1,00299,India
681867,2023-06-01,1006,Blush,150,300,150,1,00299,India
681867,2023-06-01,1001,Lipstick,150,300,150,1,00299,India
103649,2023-06-01,1007,Eyeshadow,200,400,200,1,00141,India
103649,2023-06-01,1002,Mascara,200,400,200,1,00141,India
103649,2023-06-01,1005,Nail Polish,50,100,50,1,00141,India
321377,2023-06-01,1001,Lipstick,150,300,150,1,00366,India
321377,2023-06-01,1002,Mascara,200,400,200,1,00366,India
321377,2023-06-01,1004,Eyeliner,100,200,100,1,00366,India
265005,2023-06-01,1004,Eyeliner,100,200,100,1,00304,India
104832,2023-06-01,1012,Body Lotion,200,400,200,1,00211,India
104832,2023-06-01,1005,Nail Polish,50,100,50,1,00211,India
104832,2023-06-01,1009,Moisturizer,250,500,250,1,00211,India
835636,2023-06-01,1001,Lipstick,150,300,150,1,00399,India
835636,2023-06-01,1005,Nail Polish,50,100,50,1,00399,India
835636,2023-06-01,1006,Blush,150,300,150,1,00399,India
747189,2023-06-01,1012,Body Lotion,200,400,200,1,00285,India
132545,2023-06-01,1008,Makeup Remover,80,160,80,1,00104,India
132545,2023-06-01,1002,Mascara,200,400,200,1,00104,India
132545,2023-06-01,1007,Eyeshadow,200,400,200,1,00104,India
452214,2023-06-01,1001,Lipstick,150,300,150,1,00167,India
452214,2023-06-01,1005,Nail Polish,50,100,50,1,00167,India
227533,2023-06-01,1009,Moisturizer,250,500,250,1,00250,India
227533,2023-06-01,1001,Lipstick,150,300,150,1,00250,India
200351,2023-06-01,1001,Lipstick,150,300,150,1,00433,India
200351,2023-06-01,1003,Foundation,300,600,300,1,00433,India
200351,2023-06-01,1004,Eyeliner,100,200,100,1,00433,India
626531,2023-06-01,1006,Blush,150,300,150,1,00135,India
626531,2023-06-01,1002,Mascara,200,400,200,1,00135,India
626531,2023-06-01,1012,Body Lotion,200,400,200,1,00135,India
478930,2023-06-01,1012,Body Lotion,200,400,200,1,00071,India
478930,2023-06-01,1008,Makeup Remover,80,160,80,1,00071,India
478930,2023-06-01,1004,Eyeliner,100,200,100,1,00071,India
478930,2023-06-01,1006,Blush,150,300,150,1,00071,India
762225,2023-06-01,1001,Lipstick,150,300,150,1,00185,India
762225,2023-06-01,1004,Eyeliner,100,200,100,1,00185,India
762225,2023-06-01,1003,Foundation,300,600,300,1,00185,India
762225,2023-06-01,1005,Nail Polish,50,100,50,1,00185,India
895153,2023-06-01,1002,Mascara,200,400,200,1,00314,India
895153,2023-06-01,1006,Blush,150,300,150,1,00314,India
895153,2023-06-01,1005,Nail Polish,50,100,50,1,00314,India
895153,2023-06-01,1004,Eyeliner,100,200,100,1,00314,India
880973,2023-06-01,1001,Lipstick,150,300,150,1,00357,India
880973,2023-06-01,1007,Eyeshadow,200,400,200,1,00357,India
880973,2023-06-01,1003,Foundation,300,600,300,1,00357,India
413012,2023-06-01,1006,Blush,150,300,150,1,00381,India
413012,2023-06-01,1003,Foundation,300,600,300,1,00381,India
758618,2023-06-01,1003,Foundation,300,600,300,1,00481,India
758618,2023-06-01,1009,Moisturizer,250,500,250,1,00481,India
306512,2023-06-01,1004,Eyeliner,100,200,100,1,00222,India
229326,2023-06-01,1004,Eyeliner,100,200,100,1,00166,India
229326,2023-06-01,1007,Eyeshadow,200,400,200,1,00166,India
870398,2023-06-01,1008,Makeup Remover,80,160,80,1,00228,India
870398,2023-06-01,1001,Lipstick,150,300,150,1,00228,India
870398,2023-06-01,1009,Moisturizer,250,500,250,1,00228,India
870398,2023-06-01,1005,Nail Polish,50,100,50,1,00228,India
870398,2023-06-01,1006,Blush,150,300,150,1,00228,India
955773,2023-06-01,1004,Eyeliner,100,200,100,1,00310,India
558983,2023-06-01,1009,Moisturizer,250,500,250,1,00337,India
558983,2023-06-01,1001,Lipstick,150,300,150,1,00337,India
558983,2023-06-01,1012,Body Lotion,200,400,200,1,00337,India
558983,2023-06-01,1004,Eyeliner,100,200,100,1,00337,India
503614,2023-06-01,1012,Body Lotion,200,400,200,1,00454,India
503614,2023-06-01,1007,Eyeshadow,200,400,200,1,00454,India
335432,2023-06-01,1003,Foundation,300,600,300,1,00094,India
278291,2023-06-01,1006,Blush,150,300,150,1,00300,India
278291,2023-06-01,1005,Nail Polish,50,100,50,1,00300,India
682222,2023-06-01,1008,Makeup Remover,80,160,80,1,00359,India
567930,2023-06-01,1007,Eyeshadow,200,400,200,1,00470,India
567930,2023-06-01,1008,Makeup Remover,80,160,80,1,00470,India
162971,2023-06-01,1009,Moisturizer,250,500,250,1,00113,India
162971,2023-06-01,1008,Makeup Remover,80,160,80,1,00113,India
162971,2023-06-01,1001,Lipstick,150,300,150,1,00113,India
162971,2023-06-01,1004,Eyeliner,100,200,100,1,00113,India
162971,2023-06-01,1003,Foundation,300,600,300,1,00113,India
908110,2023-06-01,1003,Foundation,300,600,300,1,00113,India
908110,2023-06-01,1007,Eyeshadow,200,400,200,1,00113,India
342617,2023-06-02,1003,Foundation,300,600,300,1,00267,India
342617,2023-06-02,1001,Lipstick,150,300,150,1,00267,India
342617,2023-06-02,1008,Makeup Remover,80,160,80,1,00267,India
290532,2023-06-02,1008,Makeup Remover,80,160,80,1,00030,India
169428,2023-06-02,1006,Blush,150,300,150,1,00309,India
169428,2023-06-02,1003,Foundation,300,600,300,1,00309,India
561747,2023-06-02,1001,Lipstick,150,300,150,1,00107,India
447281,2023-06-02,1001,Lipstick,150,300,150,1,00161,India
447281,2023-06-02,1012,Body Lotion,200,400,200,1,00161,India
701682,2023-06-02,1002,Mascara,200,400,200,1,00360,India
701682,2023-06-02,1008,Makeup Remover,80,160,80,1,00360,India
859261,2023-06-02,1004,Eyeliner,100,200,100,1,00378,India
617271,2023-06-02,1007,Eyeshadow,200,400,200,1,00022,India
939786,2023-06-02,1003,Foundation,300,600,300,1,00230,India
567595,2023-06-02,1004,Eyeliner,100,200,100,1,00393,India
567595,2023-06-02,1007,Eyeshadow,200,400,200,1,00393,India
567595,2023-06-02,1002,Mascara,200,400,200,1,00393,India
567595,2023-06-02,1005,Nail Polish,50,100,50,1,00393,India
567595,2023-06-02,1008,Makeup Remover,80,160,80,1,00393,India
699029,2023-06-02,1008,Makeup Remover,80,160,80,1,00423,India
699029,2023-06-02,1006,Blush,150,300,150,1,00423,India
699029,2023-06-02,1004,Eyeliner,100,200,100,1,00423,India
699029,2023-06-02,1001,Lipstick,150,300,150,1,00423,India
883848,2023-06-02,1004,Eyeliner,100,200,100,1,00095,India
883848,2023-06-02,1009,Moisturizer,250,500,250,1,00095,India
883848,2023-06-02,1001,Lipstick,150,300,150,1,00095,India
883848,2023-06-02,1007,Eyeshadow,200,400,200,1,00095,India
781908,2023-06-02,1005,Nail Polish,50,100,50,1,00466,India
781908,2023-06-02,1012,Body Lotion,200,400,200,1,00466,India
781908,2023-06-02,1004,Eyeliner,100,200,100,1,00466,India
151999,2023-06-02,1007,Eyeshadow,200,400,200,1,00482,India
250986,2023-06-02,1012,Body Lotion,200,400,200,1,00313,India
250986,2023-06-02,1009,Moisturizer,250,500,250,1,00313,India
897084,2023-06-02,1001,Lipstick,150,300,150,1,00156,India
897084,2023-06-02,1004,Eyeliner,100,200,100,1,00156,India
897084,2023-06-02,1012,Body Lotion,200,400,200,1,00156,India
897084,2023-06-02,1008,Makeup Remover,80,160,80,1,00156,India
897084,2023-06-02,1005,Nail Polish,50,100,50,1,00156,India
909353,2023-06-02,1001,Lipstick,150,300,150,1,00332,India
368129,2023-06-02,1004,Eyeliner,100,200,100,1,00438,India
914740,2023-06-02,1004,Eyeliner,100,200,100,1,00115,India
660698,2023-06-02,1002,Mascara,200,400,200,1,00097,India
660698,2023-06-02,1008,Makeup Remover,80,160,80,1,00097,India
660698,2023-06-02,1004,Eyeliner,100,200,100,1,00097,India
988588,2023-06-02,1003,Foundation,300,600,300,1,00272,India
988588,2023-06-02,1007,Eyeshadow,200,400,200,1,00272,India
988588,2023-06-02,1008,Makeup Remover,80,160,80,1,00272,India
988588,2023-06-02,1002,Mascara,200,400,200,1,00272,India
480033,2023-06-02,1006,Blush,150,300,150,1,00255,India
608225,2023-06-02,1004,Eyeliner,100,200,100,1,00017,India
608225,2023-06-02,1008,Makeup Remover,80,160,80,1,00017,India
608225,2023-06-02,1006,Blush,150,300,150,1,00017,India
608225,2023-06-02,1002,Mascara,200,400,200,1,00017,India
801497,2023-06-02,1002,Mascara,200,400,200,1,00093,India
801497,2023-06-02,1012,Body Lotion,200,400,200,1,00093,India
801497,2023-06-02,1007,Eyeshadow,200,400,200,1,00093,India
801497,2023-06-02,1008,Makeup Remover,80,160,80,1,00093,India
234364,2023-06-02,1006,Blush,150,300,150,1,00244,India
234364,2023-06-02,1008,Makeup Remover,80,160,80,1,00244,India
234364,2023-06-02,1007,Eyeshadow,200,400,200,1,00244,India
234364,2023-06-02,1005,Nail Polish,50,100,50,1,00244,India
643511,2023-06-02,1008,Makeup Remover,80,160,80,1,00414,India
643511,2023-06-02,1001,Lipstick,150,300,150,1,00414,India
643511,2023-06-02,1007,Eyeshadow,200,400,200,1,00414,India
643511,2023-06-02,1005,Nail Polish,50,100,50,1,00414,India
694930,2023-06-02,1004,Eyeliner,100,200,100,1,00376,India
694930,2023-06-02,1002,Mascara,200,400,200,1,00376,India
694930,2023-06-02,1007,Eyeshadow,200,400,200,1,00376,India
309326,2023-06-02,1005,Nail Polish,50,100,50,1,00350,India
309326,2023-06-02,1012,Body Lotion,200,400,200,1,00350,India
309326,2023-06-02,1009,Moisturizer,250,500,250,1,00350,India
309326,2023-06-02,1006,Blush,150,300,150,1,00350,India
946591,2023-06-02,1008,Makeup Remover,80,160,80,1,00033,India
946591,2023-06-02,1009,Moisturizer,250,500,250,1,00033,India
946591,2023-06-02,1004,Eyeliner,100,200,100,1,00033,India
946591,2023-06-02,1005,Nail Polish,50,100,50,1,00033,India
946591,2023-06-02,1002,Mascara,200,400,200,1,00033,India
767372,2023-06-02,1007,Eyeshadow,200,400,200,1,00183,India
767372,2023-06-02,1001,Lipstick,150,300,150,1,00183,India
767372,2023-06-02,1004,Eyeliner,100,200,100,1,00183,India
871671,2023-06-02,1009,Moisturizer,250,500,250,1,00117,India
651555,2023-06-02,1006,Blush,150,300,150,1,00227,India
651555,2023-06-02,1001,Lipstick,150,300,150,1,00227,India
902938,2023-06-02,1003,Foundation,300,600,300,1,00091,India
902938,2023-06-02,1008,Makeup Remover,80,160,80,1,00091,India
902938,2023-06-02,1006,Blush,150,300,150,1,00091,India
902938,2023-06-02,1004,Eyeliner,100,200,100,1,00091,India
706943,2023-06-02,1012,Body Lotion,200,400,200,1,00483,India
706943,2023-06-02,1006,Blush,150,300,150,1,00483,India
228741,2023-06-02,1002,Mascara,200,400,200,1,00356,India
228741,2023-06-02,1009,Moisturizer,250,500,250,1,00356,India
228741,2023-06-02,1012,Body Lotion,200,400,200,1,00356,India
228741,2023-06-02,1008,Makeup Remover,80,160,80,1,00356,India
400853,2023-06-02,1008,Makeup Remover,80,160,80,1,00462,India
400853,2023-06-02,1006,Blush,150,300,150,1,00462,India
400853,2023-06-02,1004,Eyeliner,100,200,100,1,00462,India
879412,2023-06-02,1008,Makeup Remover,80,160,80,1,00117,India
628051,2023-06-02,1008,Makeup Remover,80,160,80,1,00364,India
503216,2023-06-02,1005,Nail Polish,50,100,50,1,00141,India
503216,2023-06-02,1008,Makeup Remover,80,160,80,1,00141,India
377379,2023-06-02,1005,Nail Polish,50,100,50,1,00237,India
873220,2023-06-02,1001,Lipstick,150,300,150,1,00124,India
873220,2023-06-02,1003,Foundation,300,600,300,1,00124,India
873220,2023-06-02,1002,Mascara,200,400,200,1,00124,India
873220,2023-06-02,1005,Nail Polish,50,100,50,1,00124,India
334552,2023-06-02,1002,Mascara,200,400,200,1,00258,India
334552,2023-06-02,1005,Nail Polish,50,100,50,1,00258,India
334552,2023-06-02,1001,Lipstick,150,300,150,1,00258,India
334552,2023-06-02,1007,Eyeshadow,200,400,200,1,00258,India
912501,2023-06-02,1005,Nail Polish,50,100,50,1,00277,India
383816,2023-06-02,1009,Moisturizer,250,500,250,1,00416,India
383816,2023-06-02,1002,Mascara,200,400,200,1,00416,India
739129,2023-06-02,1008,Makeup Remover,80,160,80,1,00274,India
739129,2023-06-02,1012,Body Lotion,200,400,200,1,00274,India
739129,2023-06-02,1005,Nail Polish,50,100,50,1,00274,India
743170,2023-06-02,1006,Blush,150,300,150,1,00129,India
743170,2023-06-02,1002,Mascara,200,400,200,1,00129,India
743170,2023-06-02,1004,Eyeliner,100,200,100,1,00129,India
743170,2023-06-02,1012,Body Lotion,200,400,200,1,00129,India
133442,2023-06-02,1007,Eyeshadow,200,400,200,1,00345,India
454807,2023-06-02,1002,Mascara,200,400,200,1,00325,India
454807,2023-06-02,1009,Moisturizer,250,500,250,1,00325,India
454807,2023-06-02,1003,Foundation,300,600,300,1,00325,India
174685,2023-06-02,1007,Eyeshadow,200,400,200,1,00113,India
252577,2023-06-02,1008,Makeup Remover,80,160,80,1,00096,India
252577,2023-06-02,1004,Eyeliner,100,200,100,1,00096,India
252577,2023-06-02,1012,Body Lotion,200,400,200,1,00096,India
252577,2023-06-02,1003,Foundation,300,600,300,1,00096,India
873380,2023-06-03,1008,Makeup Remover,80,160,80,1,00391,India
873380,2023-06-03,1009,Moisturizer,250,500,250,1,00391,India
873380,2023-06-03,1001,Lipstick,150,300,150,1,00391,India
963328,2023-06-03,1006,Blush,150,300,150,1,00417,India
963328,2023-06-03,1001,Lipstick,150,300,150,1,00417,India
963328,2023-06-03,1008,Makeup Remover,80,160,80,1,00417,India
963328,2023-06-03,1002,Mascara,200,400,200,1,00417,India
430115,2023-06-03,1002,Mascara,200,400,200,1,00438,India
430115,2023-06-03,1003,Foundation,300,600,300,1,00438,India
885925,2023-06-03,1002,Mascara,200,400,200,1,00382,India
885925,2023-06-03,1005,Nail Polish,50,100,50,1,00382,India
432131,2023-06-03,1009,Moisturizer,250,500,250,1,00207,India
432131,2023-06-03,1002,Mascara,200,400,200,1,00207,India
432131,2023-06-03,1007,Eyeshadow,200,400,200,1,00207,India
696247,2023-06-03,1009,Moisturizer,250,500,250,1,00157,India
696247,2023-06-03,1006,Blush,150,300,150,1,00157,India
696247,2023-06-03,1004,Eyeliner,100,200,100,1,00157,India
420456,2023-06-03,1001,Lipstick,150,300,150,1,00044,India
420456,2023-06-03,1005,Nail Polish,50,100,50,1,00044,India
420456,2023-06-03,1006,Blush,150,300,150,1,00044,India
420456,2023-06-03,1004,Eyeliner,100,200,100,1,00044,India
457116,2023-06-03,1006,Blush,150,300,150,1,00136,India
457116,2023-06-03,1003,Foundation,300,600,300,1,00136,India
457116,2023-06-03,1001,Lipstick,150,300,150,1,00136,India
457116,2023-06-03,1007,Eyeshadow,200,400,200,1,00136,India
457116,2023-06-03,1008,Makeup Remover,80,160,80,1,00136,India
192795,2023-06-03,1002,Mascara,200,400,200,1,00306,India
192795,2023-06-03,1001,Lipstick,150,300,150,1,00306,India
192795,2023-06-03,1008,Makeup Remover,80,160,80,1,00306,India
192795,2023-06-03,1005,Nail Polish,50,100,50,1,00306,India
814833,2023-06-03,1001,Lipstick,150,300,150,1,00040,India
814833,2023-06-03,1005,Nail Polish,50,100,50,1,00040,India
814833,2023-06-03,1007,Eyeshadow,200,400,200,1,00040,India
319268,2023-06-03,1012,Body Lotion,200,400,200,1,00389,India
319268,2023-06-03,1001,Lipstick,150,300,150,1,00389,India
319268,2023-06-03,1005,Nail Polish,50,100,50,1,00389,India
942626,2023-06-03,1007,Eyeshadow,200,400,200,1,00493,India
942626,2023-06-03,1002,Mascara,200,400,200,1,00493,India
942626,2023-06-03,1009,Moisturizer,250,500,250,1,00493,India
898806,2023-06-03,1002,Mascara,200,400,200,1,00113,India
898806,2023-06-03,1008,Makeup Remover,80,160,80,1,00113,India
898806,2023-06-03,1006,Blush,150,300,150,1,00113,India
898806,2023-06-03,1001,Lipstick,150,300,150,1,00113,India
379040,2023-06-03,1003,Foundation,300,600,300,1,00173,India
379040,2023-06-03,1002,Mascara,200,400,200,1,00173,India
379040,2023-06-03,1008,Makeup Remover,80,160,80,1,00173,India
379040,2023-06-03,1006,Blush,150,300,150,1,00173,India
794786,2023-06-03,1002,Mascara,200,400,200,1,00302,India
532636,2023-06-03,1004,Eyeliner,100,200,100,1,00292,India
108909,2023-06-03,1004,Eyeliner,100,200,100,1,00207,India
108909,2023-06-03,1001,Lipstick,150,300,150,1,00207,India
108909,2023-06-03,1007,Eyeshadow,200,400,200,1,00207,India
958190,2023-06-03,1004,Eyeliner,100,200,100,1,00459,India
958190,2023-06-03,1001,Lipstick,150,300,150,1,00459,India
958190,2023-06-03,1006,Blush,150,300,150,1,00459,India
795172,2023-06-03,1002,Mascara,200,400,200,1,00442,India
512987,2023-06-03,1005,Nail Polish,50,100,50,1,00415,India
512987,2023-06-03,1004,Eyeliner,100,200,100,1,00415,India
512987,2023-06-03,1001,Lipstick,150,300,150,1,00415,India
512987,2023-06-03,1006,Blush,150,300,150,1,00415,India
512987,2023-06-03,1003,Foundation,300,600,300,1,00415,India
857272,2023-06-03,1005,Nail Polish,50,100,50,1,00232,India
857272,2023-06-03,1003,Foundation,300,600,300,1,00232,India
857272,2023-06-03,1006,Blush,150,300,150,1,00232,India
857272,2023-06-03,1007,Eyeshadow,200,400,200,1,00232,India
194034,2023-06-03,1002,Mascara,200,400,200,1,00347,India
194034,2023-06-03,1005,Nail Polish,50,100,50,1,00347,India
194034,2023-06-03,1009,Moisturizer,250,500,250,1,00347,India
194034,2023-06-03,1006,Blush,150,300,150,1,00347,India
793439,2023-06-03,1004,Eyeliner,100,200,100,1,00368,India
793439,2023-06-03,1008,Makeup Remover,80,160,80,1,00368,India
793439,2023-06-03,1003,Foundation,300,600,300,1,00368,India
793439,2023-06-03,1001,Lipstick,150,300,150,1,00368,India
105375,2023-06-03,1008,Makeup Remover,80,160,80,1,00056,India
909084,2023-06-03,1005,Nail Polish,50,100,50,1,00103,India
909084,2023-06-03,1002,Mascara,200,400,200,1,00103,India
909084,2023-06-03,1008,Makeup Remover,80,160,80,1,00103,India
909084,2023-06-03,1003,Foundation,300,600,300,1,00103,India
573345,2023-06-03,1001,Lipstick,150,300,150,1,00398,India
573345,2023-06-03,1009,Moisturizer,250,500,250,1,00398,India
573345,2023-06-03,1007,Eyeshadow,200,400,200,1,00398,India
185036,2023-06-03,1001,Lipstick,150,300,150,1,00149,India
185036,2023-06-03,1005,Nail Polish,50,100,50,1,00149,India
185036,2023-06-03,1007,Eyeshadow,200,400,200,1,00149,India
540427,2023-06-03,1012,Body Lotion,200,400,200,1,00060,India
440327,2023-06-03,1004,Eyeliner,100,200,100,1,00498,India
440327,2023-06-03,1008,Makeup Remover,80,160,80,1,00498,India
440327,2023-06-03,1002,Mascara,200,400,200,1,00498,India
700499,2023-06-03,1007,Eyeshadow,200,400,200,1,00257,India
700499,2023-06-03,1005,Nail Polish,50,100,50,1,00257,India
700499,2023-06-03,1009,Moisturizer,250,500,250,1,00257,India
700499,2023-06-03,1008,Makeup Remover,80,160,80,1,00257,India
766990,2023-06-03,1001,Lipstick,150,300,150,1,00328,India
766990,2023-06-03,1012,Body Lotion,200,400,200,1,00328,India
766990,2023-06-03,1006,Blush,150,300,150,1,00328,India
138182,2023-06-03,1009,Moisturizer,250,500,250,1,00283,India
138182,2023-06-03,1003,Foundation,300,600,300,1,00283,India
138182,2023-06-03,1002,Mascara,200,400,200,1,00283,India
138182,2023-06-03,1012,Body Lotion,200,400,200,1,00283,India
234854,2023-06-03,1005,Nail Polish,50,100,50,1,00095,India
234854,2023-06-03,1012,Body Lotion,200,400,200,1,00095,India
234854,2023-06-03,1008,Makeup Remover,80,160,80,1,00095,India
586475,2023-06-03,1005,Nail Polish,50,100,50,1,00147,India
685464,2023-06-03,1008,Makeup Remover,80,160,80,1,00390,India
685464,2023-06-03,1007,Eyeshadow,200,400,200,1,00390,India
685464,2023-06-03,1012,Body Lotion,200,400,200,1,00390,India
563152,2023-06-03,1005,Nail Polish,50,100,50,1,00015,India
563152,2023-06-03,1003,Foundation,300,600,300,1,00015,India
335022,2023-06-03,1003,Foundation,300,600,300,1,00376,India
335022,2023-06-03,1006,Blush,150,300,150,1,00376,India
335022,2023-06-03,1002,Mascara,200,400,200,1,00376,India
335022,2023-06-03,1004,Eyeliner,100,200,100,1,00376,India
335022,2023-06-03,1012,Body Lotion,200,400,200,1,00376,India
828203,2023-06-03,1007,Eyeshadow,200,400,200,1,00056,India
828203,2023-06-03,1004,Eyeliner,100,200,100,1,00056,India
828203,2023-06-03,1005,Nail Polish,50,100,50,1,00056,India
669407,2023-06-03,1002,Mascara,200,400,200,1,00046,India
312863,2023-06-03,1012,Body Lotion,200,400,200,1,00056,India
312863,2023-06-03,1008,Makeup Remover,80,160,80,1,00056,India
312863,2023-06-03,1006,Blush,150,300,150,1,00056,India
312863,2023-06-03,1004,Eyeliner,100,200,100,1,00056,India
312863,2023-06-03,1003,Foundation,300,600,300,1,00056,India
535612,2023-06-03,1008,Makeup Remover,80,160,80,1,00023,India
535612,2023-06-03,1003,Foundation,300,600,300,1,00023,India
535612,2023-06-03,1007,Eyeshadow,200,400,200,1,00023,India
535612,2023-06-03,1009,Moisturizer,250,500,250,1,00023,India
628163,2023-06-03,1006,Blush,150,300,150,1,00086,India
628163,2023-06-03,1001,Lipstick,150,300,150,1,00086,India
628163,2023-06-03,1003,Foundation,300,600,300,1,00086,India
628163,2023-06-03,1005,Nail Polish,50,100,50,1,00086,India
756646,2023-06-03,1006,Blush,150,300,150,1,00131,India
725677,2023-06-03,1002,Mascara,200,400,200,1,00475,India
725677,2023-06-03,1003,Foundation,300,600,300,1,00475,India
725677,2023-06-03,1005,Nail Polish,50,100,50,1,00475,India
725677,2023-06-03,1006,Blush,150,300,150,1,00475,India
237693,2023-06-04,1012,Body Lotion,200,400,200,1,00029,India
995667,2023-06-04,1009,Moisturizer,250,500,250,1,00410,India
995667,2023-06-04,1001,Lipstick,150,300,150,1,00410,India
995667,2023-06-04,1002,Mascara,200,400,200,1,00410,India
995667,2023-06-04,1008,Makeup Remover,80,160,80,1,00410,India
362371,2023-06-04,1007,Eyeshadow,200,400,200,1,00134,India
362371,2023-06-04,1004,Eyeliner,100,200,100,1,00134,India
362371,2023-06-04,1006,Blush,150,300,150,1,00134,India
362371,2023-06-04,1008,Makeup Remover,80,160,80,1,00134,India
476413,2023-06-04,1001,Lipstick,150,300,150,1,00089,India
594494,2023-06-04,1006,Blush,150,300,150,1,00154,India
594494,2023-06-04,1008,Makeup Remover,80,160,80,1,00154,India
793788,2023-06-04,1002,Mascara,200,400,200,1,00136,India
173159,2023-06-04,1002,Mascara,200,400,200,1,00108,India
173159,2023-06-04,1009,Moisturizer,250,500,250,1,00108,India
173159,2023-06-04,1003,Foundation,300,600,300,1,00108,India
616850,2023-06-04,1005,Nail Polish,50,100,50,1,00146,India
616850,2023-06-04,1003,Foundation,300,600,300,1,00146,India
616850,2023-06-04,1007,Eyeshadow,200,400,200,1,00146,India
250183,2023-06-04,1007,Eyeshadow,200,400,200,1,00277,India
250183,2023-06-04,1005,Nail Polish,50,100,50,1,00277,India
598969,2023-06-04,1009,Moisturizer,250,500,250,1,00392,India
598969,2023-06-04,1007,Eyeshadow,200,400,200,1,00392,India
598969,2023-06-04,1002,Mascara,200,400,200,1,00392,India
598969,2023-06-04,1005,Nail Polish,50,100,50,1,00392,India
707677,2023-06-04,1008,Makeup Remover,80,160,80,1,00394,India
707677,2023-06-04,1005,Nail Polish,50,100,50,1,00394,India
445999,2023-06-04,1009,Moisturizer,250,500,250,1,00228,India
445999,2023-06-04,1006,Blush,150,300,150,1,00228,India
456667,2023-06-04,1009,Moisturizer,250,500,250,1,00433,India
456667,2023-06-04,1001,Lipstick,150,300,150,1,00433,India
456667,2023-06-04,1012,Body Lotion,200,400,200,1,00433,India
456667,2023-06-04,1002,Mascara,200,400,200,1,00433,India
197491,2023-06-04,1004,Eyeliner,100,200,100,1,00289,India
883079,2023-06-04,1001,Lipstick,150,300,150,1,00203,India
883079,2023-06-04,1008,Makeup Remover,80,160,80,1,00203,India
883079,2023-06-04,1002,Mascara,200,400,200,1,00203,India
960736,2023-06-04,1003,Foundation,300,600,300,1,00370,India
960736,2023-06-04,1004,Eyeliner,100,200,100,1,00370,India
960736,2023-06-04,1006,Blush,150,300,150,1,00370,India
960736,2023-06-04,1007,Eyeshadow,200,400,200,1,00370,India
855837,2023-06-04,1002,Mascara,200,400,200,1,00433,India
855837,2023-06-04,1003,Foundation,300,600,300,1,00433,India
855837,2023-06-04,1001,Lipstick,150,300,150,1,00433,India
813976,2023-06-04,1007,Eyeshadow,200,400,200,1,00253,India
292497,2023-06-04,1009,Moisturizer,250,500,250,1,00032,India
292497,2023-06-04,1004,Eyeliner,100,200,100,1,00032,India
292497,2023-06-04,1005,Nail Polish,50,100,50,1,00032,India
292497,2023-06-04,1012,Body Lotion,200,400,200,1,00032,India
706575,2023-06-04,1001,Lipstick,150,300,150,1,00099,India
481242,2023-06-04,1002,Mascara,200,400,200,1,00402,India
481242,2023-06-04,1008,Makeup Remover,80,160,80,1,00402,India
481242,2023-06-04,1001,Lipstick,150,300,150,1,00402,India
481242,2023-06-04,1004,Eyeliner,100,200,100,1,00402,India
626839,2023-06-04,1012,Body Lotion,200,400,200,1,00447,India
626839,2023-06-04,1006,Blush,150,300,150,1,00447,India
626839,2023-06-04,1002,Mascara,200,400,200,1,00447,India
518424,2023-06-04,1003,Foundation,300,600,300,1,00089,India
518424,2023-06-04,1005,Nail Polish,50,100,50,1,00089,India
518424,2023-06-04,1009,Moisturizer,250,500,250,1,00089,India
518424,2023-06-04,1008,Makeup Remover,80,160,80,1,00089,India
518424,2023-06-04,1007,Eyeshadow,200,400,200,1,00089,India
188364,2023-06-04,1009,Moisturizer,250,500,250,1,00186,India
552439,2023-06-04,1005,Nail Polish,50,100,50,1,00292,India
552439,2023-06-04,1007,Eyeshadow,200,400,200,1,00292,India
552439,2023-06-04,1006,Blush,150,300,150,1,00292,India
368301,2023-06-04,1005,Nail Polish,50,100,50,1,00226,India
368301,2023-06-04,1004,Eyeliner,100,200,100,1,00226,India
368301,2023-06-04,1012,Body Lotion,200,400,200,1,00226,India
368301,2023-06-04,1009,Moisturizer,250,500,250,1,00226,India
757547,2023-06-04,1007,Eyeshadow,200,400,200,1,00171,India
757547,2023-06-04,1005,Nail Polish,50,100,50,1,00171,India
779232,2023-06-04,1009,Moisturizer,250,500,250,1,00350,India
779232,2023-06-04,1004,Eyeliner,100,200,100,1,00350,India
779232,2023-06-04,1007,Eyeshadow,200,400,200,1,00350,India
779232,2023-06-04,1005,Nail Polish,50,100,50,1,00350,India
653787,2023-06-04,1006,Blush,150,300,150,1,00001,India
653787,2023-06-04,1002,Mascara,200,400,200,1,00001,India
653787,2023-06-04,1008,Makeup Remover,80,160,80,1,00001,India
653787,2023-06-04,1005,Nail Polish,50,100,50,1,00001,India
150252,2023-06-04,1009,Moisturizer,250,500,250,1,00091,India
150252,2023-06-04,1007,Eyeshadow,200,400,200,1,00091,India
150252,2023-06-04,1006,Blush,150,300,150,1,00091,India
150252,2023-06-04,1012,Body Lotion,200,400,200,1,00091,India
150252,2023-06-04,1003,Foundation,300,600,300,1,00091,India
697565,2023-06-04,1004,Eyeliner,100,200,100,1,00213,India
697565,2023-06-04,1007,Eyeshadow,200,400,200,1,00213,India
697565,2023-06-04,1012,Body Lotion,200,400,200,1,00213,India
697565,2023-06-04,1002,Mascara,200,400,200,1,00213,India
690216,2023-06-04,1005,Nail Polish,50,100,50,1,00002,India
690216,2023-06-04,1008,Makeup Remover,80,160,80,1,00002,India
532688,2023-06-04,1012,Body Lotion,200,400,200,1,00176,India
532688,2023-06-04,1002,Mascara,200,400,200,1,00176,India
532688,2023-06-04,1005,Nail Polish,50,100,50,1,00176,India
532688,2023-06-04,1008,Makeup Remover,80,160,80,1,00176,India
420720,2023-06-04,1001,Lipstick,150,300,150,1,00101,India
420720,2023-06-04,1003,Foundation,300,600,300,1,00101,India
420720,2023-06-04,1008,Makeup Remover,80,160,80,1,00101,India
356286,2023-06-04,1005,Nail Polish,50,100,50,1,00125,India
814896,2023-06-04,1009,Moisturizer,250,500,250,1,00269,India
814896,2023-06-04,1002,Mascara,200,400,200,1,00269,India
207969,2023-06-05,1001,Lipstick,150,300,150,1,00092,India
207969,2023-06-05,1012,Body Lotion,200,400,200,1,00092,India
110061,2023-06-05,1001,Lipstick,150,300,150,1,00149,India
110061,2023-06-05,1008,Makeup Remover,80,160,80,1,00149,India
460978,2023-06-05,1012,Body Lotion,200,400,200,1,00066,India
640557,2023-06-05,1005,Nail Polish,50,100,50,1,00155,India
640557,2023-06-05,1003,Foundation,300,600,300,1,00155,India
640557,2023-06-05,1012,Body Lotion,200,400,200,1,00155,India
640557,2023-06-05,1001,Lipstick,150,300,150,1,00155,India
688879,2023-06-05,1004,Eyeliner,100,200,100,1,00230,India
125757,2023-06-05,1003,Foundation,300,600,300,1,00222,India
125757,2023-06-05,1006,Blush,150,300,150,1,00222,India
238330,2023-06-05,1004,Eyeliner,100,200,100,1,00256,India
238330,2023-06-05,1009,Moisturizer,250,500,250,1,00256,India
238330,2023-06-05,1008,Makeup Remover,80,160,80,1,00256,India
172150,2023-06-05,1009,Moisturizer,250,500,250,1,00418,India
172150,2023-06-05,1008,Makeup Remover,80,160,80,1,00418,India
172150,2023-06-05,1005,Nail Polish,50,100,50,1,00418,India
172150,2023-06-05,1003,Foundation,300,600,300,1,00418,India
694390,2023-06-05,1006,Blush,150,300,150,1,00128,India
694390,2023-06-05,1003,Foundation,300,600,300,1,00128,India
694390,2023-06-05,1007,Eyeshadow,200,400,200,1,00128,India
241111,2023-06-05,1012,Body Lotion,200,400,200,1,00418,India
241111,2023-06-05,1004,Eyeliner,100,200,100,1,00418,India
241111,2023-06-05,1007,Eyeshadow,200,400,200,1,00418,India
442214,2023-06-05,1003,Foundation,300,600,300,1,00326,India
442214,2023-06-05,1009,Moisturizer,250,500,250,1,00326,India
203292,2023-06-05,1012,Body Lotion,200,400,200,1,00208,India
139692,2023-06-05,1002,Mascara,200,400,200,1,00163,India
139692,2023-06-05,1006,Blush,150,300,150,1,00163,India
139692,2023-06-05,1007,Eyeshadow,200,400,200,1,00163,India
496410,2023-06-05,1006,Blush,150,300,150,1,00072,India
496410,2023-06-05,1007,Eyeshadow,200,400,200,1,00072,India
956893,2023-06-05,1009,Moisturizer,250,500,250,1,00164,India
956893,2023-06-05,1002,Mascara,200,400,200,1,00164,India
956893,2023-06-05,1004,Eyeliner,100,200,100,1,00164,India
956893,2023-06-05,1007,Eyeshadow,200,400,200,1,00164,India
956893,2023-06-05,1012,Body Lotion,200,400,200,1,00164,India
775597,2023-06-05,1001,Lipstick,150,300,150,1,00146,India
445277,2023-06-05,1004,Eyeliner,100,200,100,1,00131,India
445277,2023-06-05,1005,Nail Polish,50,100,50,1,00131,India
445277,2023-06-05,1009,Moisturizer,250,500,250,1,00131,India
683135,2023-06-05,1002,Mascara,200,400,200,1,00438,India
683135,2023-06-05,1005,Nail Polish,50,100,50,1,00438,India
975099,2023-06-05,1003,Foundation,300,600,300,1,00369,India
975099,2023-06-05,1007,Eyeshadow,200,400,200,1,00369,India
324828,2023-06-05,1012,Body Lotion,200,400,200,1,00210,India
324828,2023-06-05,1008,Makeup Remover,80,160,80,1,00210,India
324828,2023-06-05,1005,Nail Polish,50,100,50,1,00210,India
543978,2023-06-05,1008,Makeup Remover,80,160,80,1,00117,India
543978,2023-06-05,1002,Mascara,200,400,200,1,00117,India
543978,2023-06-05,1004,Eyeliner,100,200,100,1,00117,India
609477,2023-06-05,1002,Mascara,200,400,200,1,00352,India
609477,2023-06-05,1012,Body Lotion,200,400,200,1,00352,India
609477,2023-06-05,1004,Eyeliner,100,200,100,1,00352,India
609477,2023-06-05,1003,Foundation,300,600,300,1,00352,India
597680,2023-06-05,1007,Eyeshadow,200,400,200,1,00084,India
597680,2023-06-05,1006,Blush,150,300,150,1,00084,India
597680,2023-06-05,1001,Lipstick,150,300,150,1,00084,India
473771,2023-06-05,1009,Moisturizer,250,500,250,1,00303,India
360062,2023-06-05,1004,Eyeliner,100,200,100,1,00448,India
360062,2023-06-05,1003,Foundation,300,600,300,1,00448,India
316816,2023-06-05,1003,Foundation,300,600,300,1,00470,India
316816,2023-06-05,1005,Nail Polish,50,100,50,1,00470,India
316816,2023-06-05,1006,Blush,150,300,150,1,00470,India
316816,2023-06-05,1007,Eyeshadow,200,400,200,1,00470,India
903748,2023-06-05,1005,Nail Polish,50,100,50,1,00296,India
903748,2023-06-05,1004,Eyeliner,100,200,100,1,00296,India
903748,2023-06-05,1002,Mascara,200,400,200,1,00296,India
903748,2023-06-05,1006,Blush,150,300,150,1,00296,India
903748,2023-06-05,1003,Foundation,300,600,300,1,00296,India
491404,2023-06-05,1004,Eyeliner,100,200,100,1,00086,India
342841,2023-06-05,1004,Eyeliner,100,200,100,1,00083,India
342841,2023-06-05,1003,Foundation,300,600,300,1,00083,India
464613,2023-06-05,1009,Moisturizer,250,500,250,1,00146,India
464613,2023-06-05,1002,Mascara,200,400,200,1,00146,India
297800,2023-06-06,1008,Makeup Remover,80,160,80,1,00273,India
297800,2023-06-06,1004,Eyeliner,100,200,100,1,00273,India
297800,2023-06-06,1001,Lipstick,150,300,150,1,00273,India
297800,2023-06-06,1012,Body Lotion,200,400,200,1,00273,India
266054,2023-06-06,1007,Eyeshadow,200,400,200,1,00379,India
266054,2023-06-06,1012,Body Lotion,200,400,200,1,00379,India
547904,2023-06-06,1012,Body Lotion,200,400,200,1,00386,India
328393,2023-06-06,1007,Eyeshadow,200,400,200,1,00361,India
200428,2023-06-06,1007,Eyeshadow,200,400,200,1,00023,India
470243,2023-06-06,1008,Makeup Remover,80,160,80,1,00335,India
470243,2023-06-06,1006,Blush,150,300,150,1,00335,India
303799,2023-06-06,1007,Eyeshadow,200,400,200,1,00010,India
303799,2023-06-06,1003,Foundation,300,600,300,1,00010,India
303799,2023-06-06,1004,Eyeliner,100,200,100,1,00010,India
385267,2023-06-06,1002,Mascara,200,400,200,1,00064,India
385267,2023-06-06,1012,Body Lotion,200,400,200,1,00064,India
385267,2023-06-06,1007,Eyeshadow,200,400,200,1,00064,India
385267,2023-06-06,1004,Eyeliner,100,200,100,1,00064,India
449363,2023-06-06,1009,Moisturizer,250,500,250,1,00062,India
449363,2023-06-06,1002,Mascara,200,400,200,1,00062,India
343686,2023-06-06,1001,Lipstick,150,300,150,1,00312,India
322359,2023-06-06,1009,Moisturizer,250,500,250,1,00289,India
322359,2023-06-06,1004,Eyeliner,100,200,100,1,00289,India
322359,2023-06-06,1001,Lipstick,150,300,150,1,00289,India
322359,2023-06-06,1002,Mascara,200,400,200,1,00289,India
631842,2023-06-06,1007,Eyeshadow,200,400,200,1,00079,India
631842,2023-06-06,1009,Moisturizer,250,500,250,1,00079,India
882641,2023-06-06,1001,Lipstick,150,300,150,1,00310,India
882641,2023-06-06,1009,Moisturizer,250,500,250,1,00310,India
882641,2023-06-06,1004,Eyeliner,100,200,100,1,00310,India
338201,2023-06-06,1005,Nail Polish,50,100,50,1,00385,India
628139,2023-06-06,1008,Makeup Remover,80,160,80,1,00001,India
628139,2023-06-06,1007,Eyeshadow,200,400,200,1,00001,India
628139,2023-06-06,1006,Blush,150,300,150,1,00001,India
628139,2023-06-06,1001,Lipstick,150,300,150,1,00001,India
628139,2023-06-06,1004,Eyeliner,100,200,100,1,00001,India
975038,2023-06-06,1002,Mascara,200,400,200,1,00480,India
975038,2023-06-06,1005,Nail Polish,50,100,50,1,00480,India
975038,2023-06-06,1001,Lipstick,150,300,150,1,00480,India
975038,2023-06-06,1009,Moisturizer,250,500,250,1,00480,India
723217,2023-06-06,1003,Foundation,300,600,300,1,00017,India
723217,2023-06-06,1012,Body Lotion,200,400,200,1,00017,India
723217,2023-06-06,1004,Eyeliner,100,200,100,1,00017,India
723217,2023-06-06,1007,Eyeshadow,200,400,200,1,00017,India
685333,2023-06-06,1009,Moisturizer,250,500,250,1,00294,India
368528,2023-06-06,1002,Mascara,200,400,200,1,00284,India
368528,2023-06-06,1005,Nail Polish,50,100,50,1,00284,India
250935,2023-06-06,1009,Moisturizer,250,500,250,1,00052,India
946880,2023-06-06,1001,Lipstick,150,300,150,1,00381,India
946880,2023-06-06,1007,Eyeshadow,200,400,200,1,00381,India
985897,2023-06-06,1001,Lipstick,150,300,150,1,00305,India
985897,2023-06-06,1002,Mascara,200,400,200,1,00305,India
985897,2023-06-06,1005,Nail Polish,50,100,50,1,00305,India
358603,2023-06-06,1012,Body Lotion,200,400,200,1,00364,India
358603,2023-06-06,1008,Makeup Remover,80,160,80,1,00364,India
358603,2023-06-06,1009,Moisturizer,250,500,250,1,00364,India
358603,2023-06-06,1003,Foundation,300,600,300,1,00364,India
358603,2023-06-06,1001,Lipstick,150,300,150,1,00364,India
756727,2023-06-06,1003,Foundation,300,600,300,1,00225,India
756727,2023-06-06,1007,Eyeshadow,200,400,200,1,00225,India
756727,2023-06-06,1006,Blush,150,300,150,1,00225,India
258183,2023-06-06,1006,Blush,150,300,150,1,00292,India
258183,2023-06-06,1002,Mascara,200,400,200,1,00292,India
258183,2023-06-06,1001,Lipstick,150,300,150,1,00292,India
258183,2023-06-06,1003,Foundation,300,600,300,1,00292,India
681856,2023-06-06,1005,Nail Polish,50,100,50,1,00209,India
681856,2023-06-06,1004,Eyeliner,100,200,100,1,00209,India
182523,2023-06-06,1008,Makeup Remover,80,160,80,1,00401,India
182523,2023-06-06,1001,Lipstick,150,300,150,1,00401,India
182523,2023-06-06,1006,Blush,150,300,150,1,00401,India
451655,2023-06-06,1005,Nail Polish,50,100,50,1,00479,India
451655,2023-06-06,1004,Eyeliner,100,200,100,1,00479,India
333405,2023-06-06,1004,Eyeliner,100,200,100,1,00491,India
333405,2023-06-06,1006,Blush,150,300,150,1,00491,India
471794,2023-06-06,1002,Mascara,200,400,200,1,00341,India
471794,2023-06-06,1006,Blush,150,300,150,1,00341,India
471794,2023-06-06,1007,Eyeshadow,200,400,200,1,00341,India
308978,2023-06-06,1003,Foundation,300,600,300,1,00458,India
308978,2023-06-06,1001,Lipstick,150,300,150,1,00458,India
308978,2023-06-06,1008,Makeup Remover,80,160,80,1,00458,India
661180,2023-06-06,1001,Lipstick,150,300,150,1,00358,India
661180,2023-06-06,1006,Blush,150,300,150,1,00358,India
525350,2023-06-06,1009,Moisturizer,250,500,250,1,00231,India
525350,2023-06-06,1002,Mascara,200,400,200,1,00231,India
525350,2023-06-06,1001,Lipstick,150,300,150,1,00231,India
525350,2023-06-06,1003,Foundation,300,600,300,1,00231,India
918597,2023-06-06,1005,Nail Polish,50,100,50,1,00189,India
918597,2023-06-06,1008,Makeup Remover,80,160,80,1,00189,India
663358,2023-06-06,1008,Makeup Remover,80,160,80,1,00052,India
663358,2023-06-06,1001,Lipstick,150,300,150,1,00052,India
663358,2023-06-06,1006,Blush,150,300,150,1,00052,India
584660,2023-06-06,1007,Eyeshadow,200,400,200,1,00228,India
584660,2023-06-06,1008,Makeup Remover,80,160,80,1,00228,India
584660,2023-06-06,1006,Blush,150,300,150,1,00228,India
173891,2023-06-06,1001,Lipstick,150,300,150,1,00414,India
173891,2023-06-06,1009,Moisturizer,250,500,250,1,00414,India
365872,2023-06-06,1002,Mascara,200,400,200,1,00264,India
365872,2023-06-06,1007,Eyeshadow,200,400,200,1,00264,India
955881,2023-06-06,1002,Mascara,200,400,200,1,00201,India
700144,2023-06-06,1003,Foundation,300,600,300,1,00353,India
700144,2023-06-06,1008,Makeup Remover,80,160,80,1,00353,India
700144,2023-06-06,1002,Mascara,200,400,200,1,00353,India
700144,2023-06-06,1012,Body Lotion,200,400,200,1,00353,India
181017,2023-06-07,1012,Body Lotion,200,400,200,1,00016,India
689964,2023-06-07,1012,Body Lotion,200,400,200,1,00453,India
689964,2023-06-07,1004,Eyeliner,100,200,100,1,00453,India
689964,2023-06-07,1007,Eyeshadow,200,400,200,1,00453,India
689964,2023-06-07,1006,Blush,150,300,150,1,00453,India
833293,2023-06-07,1007,Eyeshadow,200,400,200,1,00352,India
833293,2023-06-07,1008,Makeup Remover,80,160,80,1,00352,India
833293,2023-06-07,1005,Nail Polish,50,100,50,1,00352,India
544340,2023-06-07,1012,Body Lotion,200,400,200,1,00096,India
544340,2023-06-07,1002,Mascara,200,400,200,1,00096,India
544340,2023-06-07,1003,Foundation,300,600,300,1,00096,India
203130,2023-06-07,1004,Eyeliner,100,200,100,1,00224,India
203130,2023-06-07,1006,Blush,150,300,150,1,00224,India
203130,2023-06-07,1012,Body Lotion,200,400,200,1,00224,India
203130,2023-06-07,1005,Nail Polish,50,100,50,1,00224,India
408644,2023-06-07,1005,Nail Polish,50,100,50,1,00131,India
408644,2023-06-07,1001,Lipstick,150,300,150,1,00131,India
408644,2023-06-07,1002,Mascara,200,400,200,1,00131,India
135327,2023-06-07,1001,Lipstick,150,300,150,1,00028,India
135327,2023-06-07,1008,Makeup Remover,80,160,80,1,00028,India
518718,2023-06-07,1012,Body Lotion,200,400,200,1,00348,India
518718,2023-06-07,1006,Blush,150,300,150,1,00348,India
775914,2023-06-07,1006,Blush,150,300,150,1,00228,India
775914,2023-06-07,1012,Body Lotion,200,400,200,1,00228,India
775914,2023-06-07,1009,Moisturizer,250,500,250,1,00228,India
808347,2023-06-07,1009,Moisturizer,250,500,250,1,00449,India
635760,2023-06-07,1004,Eyeliner,100,200,100,1,00217,India
715298,2023-06-07,1006,Blush,150,300,150,1,00462,India
715298,2023-06-07,1008,Makeup Remover,80,160,80,1,00462,India
800113,2023-06-07,1003,Foundation,300,600,300,1,00261,India
800113,2023-06-07,1005,Nail Polish,50,100,50,1,00261,India
800113,2023-06-07,1002,Mascara,200,400,200,1,00261,India
800113,2023-06-07,1004,Eyeliner,100,200,100,1,00261,India
252804,2023-06-07,1008,Makeup Remover,80,160,80,1,00162,India
252804,2023-06-07,1012,Body Lotion,200,400,200,1,00162,India
272429,2023-06-07,1012,Body Lotion,200,400,200,1,00446,India
272429,2023-06-07,1007,Eyeshadow,200,400,200,1,00446,India
335072,2023-06-07,1009,Moisturizer,250,500,250,1,00119,India
335072,2023-06-07,1001,Lipstick,150,300,150,1,00119,India
335072,2023-06-07,1004,Eyeliner,100,200,100,1,00119,India
335072,2023-06-07,1005,Nail Polish,50,100,50,1,00119,India
335072,2023-06-07,1007,Eyeshadow,200,400,200,1,00119,India
612887,2023-06-07,1006,Blush,150,300,150,1,00129,India
612887,2023-06-07,1007,Eyeshadow,200,400,200,1,00129,India
607068,2023-06-07,1006,Blush,150,300,150,1,00043,India
607068,2023-06-07,1003,Foundation,300,600,300,1,00043,India
607068,2023-06-07,1008,Makeup Remover,80,160,80,1,00043,India
607068,2023-06-07,1005,Nail Polish,50,100,50,1,00043,India
389410,2023-06-07,1009,Moisturizer,250,500,250,1,00332,India
389410,2023-06-07,1007,Eyeshadow,200,400,200,1,00332,India
389410,2023-06-07,1003,Foundation,300,600,300,1,00332,India
895156,2023-06-07,1007,Eyeshadow,200,400,200,1,00216,India
817592,2023-06-07,1012,Body Lotion,200,400,200,1,00130,India
817592,2023-06-07,1009,Moisturizer,250,500,250,1,00130,India
680766,2023-06-07,1008,Makeup Remover,80,160,80,1,00406,India
680766,2023-06-07,1009,Moisturizer,250,500,250,1,00406,India
691092,2023-06-07,1007,Eyeshadow,200,400,200,1,00472,India
691092,2023-06-07,1003,Foundation,300,600,300,1,00472,India
433940,2023-06-07,1003,Foundation,300,600,300,1,00332,India
433940,2023-06-07,1001,Lipstick,150,300,150,1,00332,India
433940,2023-06-07,1002,Mascara,200,400,200,1,00332,India
433940,2023-06-07,1006,Blush,150,300,150,1,00332,India
433940,2023-06-07,1004,Eyeliner,100,200,100,1,00332,India
624685,2023-06-07,1004,Eyeliner,100,200,100,1,00289,India
624685,2023-06-07,1007,Eyeshadow,200,400,200,1,00289,India
624685,2023-06-07,1001,Lipstick,150,300,150,1,00289,India
610981,2023-06-07,1001,Lipstick,150,300,150,1,00030,India
610981,2023-06-07,1005,Nail Polish,50,100,50,1,00030,India
325153,2023-06-07,1008,Makeup Remover,80,160,80,1,00019,India
325153,2023-06-07,1009,Moisturizer,250,500,250,1,00019,India
325153,2023-06-07,1006,Blush,150,300,150,1,00019,India
901604,2023-06-07,1006,Blush,150,300,150,1,00075,India
771167,2023-06-07,1009,Moisturizer,250,500,250,1,00011,India
771167,2023-06-07,1001,Lipstick,150,300,150,1,00011,India
771167,2023-06-07,1008,Makeup Remover,80,160,80,1,00011,India
771167,2023-06-07,1006,Blush,150,300,150,1,00011,India
785990,2023-06-07,1002,Mascara,200,400,200,1,00346,India
785990,2023-06-07,1008,Makeup Remover,80,160,80,1,00346,India
785990,2023-06-07,1001,Lipstick,150,300,150,1,00346,India
840043,2023-06-07,1005,Nail Polish,50,100,50,1,00167,India
840043,2023-06-07,1001,Lipstick,150,300,150,1,00167,India
840043,2023-06-07,1002,Mascara,200,400,200,1,00167,India
840043,2023-06-07,1012,Body Lotion,200,400,200,1,00167,India
239414,2023-06-07,1009,Moisturizer,250,500,250,1,00099,India
239414,2023-06-07,1007,Eyeshadow,200,400,200,1,00099,India
909447,2023-06-07,1006,Blush,150,300,150,1,00256,India
909447,2023-06-07,1004,Eyeliner,100,200,100,1,00256,India
909447,2023-06-07,1009,Moisturizer,250,500,250,1,00256,India
103554,2023-06-07,1007,Eyeshadow,200,400,200,1,00166,India
117569,2023-06-07,1008,Makeup Remover,80,160,80,1,00159,India
117569,2023-06-07,1001,Lipstick,150,300,150,1,00159,India
117569,2023-06-07,1006,Blush,150,300,150,1,00159,India
393714,2023-06-07,1006,Blush,150,300,150,1,00167,India
393714,2023-06-07,1001,Lipstick,150,300,150,1,00167,India
393714,2023-06-07,1005,Nail Polish,50,100,50,1,00167,India
393714,2023-06-07,1003,Foundation,300,600,300,1,00167,India
974106,2023-06-08,1006,Blush,150,300,150,1,00345,India
974106,2023-06-08,1002,Mascara,200,400,200,1,00345,India
354128,2023-06-08,1001,Lipstick,150,300,150,1,00492,India
821722,2023-06-08,1007,Eyeshadow,200,400,200,1,00197,India
672109,2023-06-08,1007,Eyeshadow,200,400,200,1,00375,India
672109,2023-06-08,1012,Body Lotion,200,400,200,1,00375,India
672109,2023-06-08,1005,Nail Polish,50,100,50,1,00375,India
647909,2023-06-08,1008,Makeup Remover,80,160,80,1,00433,India
647909,2023-06-08,1005,Nail Polish,50,100,50,1,00433,India
834307,2023-06-08,1005,Nail Polish,50,100,50,1,00384,India
361369,2023-06-08,1006,Blush,150,300,150,1,00362,India
814787,2023-06-08,1002,Mascara,200,400,200,1,00498,India
814787,2023-06-08,1005,Nail Polish,50,100,50,1,00498,India
814787,2023-06-08,1003,Foundation,300,600,300,1,00498,India
814787,2023-06-08,1006,Blush,150,300,150,1,00498,India
814787,2023-06-08,1012,Body Lotion,200,400,200,1,00498,India
895787,2023-06-08,1003,Foundation,300,600,300,1,00128,India
895787,2023-06-08,1002,Mascara,200,400,200,1,00128,India
431638,2023-06-08,1009,Moisturizer,250,500,250,1,00081,India
431638,2023-06-08,1004,Eyeliner,100,200,100,1,00081,India
118431,2023-06-08,1008,Makeup Remover,80,160,80,1,00167,India
118431,2023-06-08,1004,Eyeliner,100,200,100,1,00167,India
118431,2023-06-08,1003,Foundation,300,600,300,1,00167,India
930413,2023-06-08,1003,Foundation,300,600,300,1,00041,India
930413,2023-06-08,1002,Mascara,200,400,200,1,00041,India
930413,2023-06-08,1008,Makeup Remover,80,160,80,1,00041,India
930413,2023-06-08,1007,Eyeshadow,200,400,200,1,00041,India
818402,2023-06-08,1001,Lipstick,150,300,150,1,00134,India
818402,2023-06-08,1008,Makeup Remover,80,160,80,1,00134,India
778087,2023-06-08,1009,Moisturizer,250,500,250,1,00278,India
778087,2023-06-08,1004,Eyeliner,100,200,100,1,00278,India
778087,2023-06-08,1008,Makeup Remover,80,160,80,1,00278,India
778087,2023-06-08,1007,Eyeshadow,200,400,200,1,00278,India
821758,2023-06-08,1001,Lipstick,150,300,150,1,00401,India
821758,2023-06-08,1005,Nail Polish,50,100,50,1,00401,India
821758,2023-06-08,1008,Makeup Remover,80,160,80,1,00401,India
821758,2023-06-08,1003,Foundation,300,600,300,1,00401,India
550102,2023-06-08,1003,Foundation,300,600,300,1,00185,India
550102,2023-06-08,1002,Mascara,200,400,200,1,00185,India
795916,2023-06-08,1002,Mascara,200,400,200,1,00432,India
386746,2023-06-08,1012,Body Lotion,200,400,200,1,00143,India
386746,2023-06-08,1007,Eyeshadow,200,400,200,1,00143,India
774866,2023-06-08,1002,Mascara,200,400,200,1,00386,India
774866,2023-06-08,1006,Blush,150,300,150,1,00386,India
774866,2023-06-08,1005,Nail Polish,50,100,50,1,00386,India
471734,2023-06-08,1001,Lipstick,150,300,150,1,00033,India
471734,2023-06-08,1004,Eyeliner,100,200,100,1,00033,India
471734,2023-06-08,1006,Blush,150,300,150,1,00033,India
471734,2023-06-08,1008,Makeup Remover,80,160,80,1,00033,India
870193,2023-06-08,1009,Moisturizer,250,500,250,1,00193,India
870193,2023-06-08,1007,Eyeshadow,200,400,200,1,00193,India
588281,2023-06-08,1004,Eyeliner,100,200,100,1,00087,India
588281,2023-06-08,1006,Blush,150,300,150,1,00087,India
588281,2023-06-08,1005,Nail Polish,50,100,50,1,00087,India
869666,2023-06-08,1008,Makeup Remover,80,160,80,1,00415,India
869666,2023-06-08,1012,Body Lotion,200,400,200,1,00415,India
484594,2023-06-08,1008,Makeup Remover,80,160,80,1,00472,India
484594,2023-06-08,1003,Foundation,300,600,300,1,00472,India
490869,2023-06-08,1008,Makeup Remover,80,160,80,1,00063,India
490869,2023-06-08,1002,Mascara,200,400,200,1,00063,India
490869,2023-06-08,1006,Blush,150,300,150,1,00063,India
676801,2023-06-08,1009,Moisturizer,250,500,250,1,00210,India
676801,2023-06-08,1007,Eyeshadow,200,400,200,1,00210,India
200051,2023-06-08,1001,Lipstick,150,300,150,1,00309,India
200051,2023-06-08,1009,Moisturizer,250,500,250,1,00309,India
706475,2023-06-08,1003,Foundation,300,600,300,1,00098,India
706475,2023-06-08,1007,Eyeshadow,200,400,200,1,00098,India
706475,2023-06-08,1002,Mascara,200,400,200,1,00098,India
987749,2023-06-08,1004,Eyeliner,100,200,100,1,00382,India
987749,2023-06-08,1009,Moisturizer,250,500,250,1,00382,India
987749,2023-06-08,1005,Nail Polish,50,100,50,1,00382,India
638900,2023-06-08,1002,Mascara,200,400,200,1,00231,India
638900,2023-06-08,1009,Moisturizer,250,500,250,1,00231,India
661488,2023-06-08,1006,Blush,150,300,150,1,00486,India
661488,2023-06-08,1001,Lipstick,150,300,150,1,00486,India
661488,2023-06-08,1012,Body Lotion,200,400,200,1,00486,India
633092,2023-06-08,1007,Eyeshadow,200,400,200,1,00467,India
433780,2023-06-08,1008,Makeup Remover,80,160,80,1,00105,India
486150,2023-06-08,1009,Moisturizer,250,500,250,1,00104,India
486150,2023-06-08,1006,Blush,150,300,150,1,00104,India
486150,2023-06-08,1007,Eyeshadow,200,400,200,1,00104,India
975658,2023-06-08,1005,Nail Polish,50,100,50,1,00307,India
975658,2023-06-08,1003,Foundation,300,600,300,1,00307,India
192632,2023-06-08,1006,Blush,150,300,150,1,00128,India
192632,2023-06-08,1005,Nail Polish,50,100,50,1,00128,India
655721,2023-06-08,1012,Body Lotion,200,400,200,1,00355,India
655721,2023-06-08,1004,Eyeliner,100,200,100,1,00355,India
214612,2023-06-08,1006,Blush,150,300,150,1,00256,India
214612,2023-06-08,1009,Moisturizer,250,500,250,1,00256,India
214612,2023-06-08,1001,Lipstick,150,300,150,1,00256,India
214612,2023-06-08,1008,Makeup Remover,80,160,80,1,00256,India
840042,2023-06-08,1003,Foundation,300,600,300,1,00098,India
840042,2023-06-08,1002,Mascara,200,400,200,1,00098,India
840042,2023-06-08,1001,Lipstick,150,300,150,1,00098,India
752594,2023-06-08,1005,Nail Polish,50,100,50,1,00367,India
752594,2023-06-08,1007,Eyeshadow,200,400,200,1,00367,India
752594,2023-06-08,1001,Lipstick,150,300,150,1,00367,India
189767,2023-06-08,1008,Makeup Remover,80,160,80,1,00226,India
189767,2023-06-08,1007,Eyeshadow,200,400,200,1,00226,India
189767,2023-06-08,1006,Blush,150,300,150,1,00226,India
787910,2023-06-09,1005,Nail Polish,50,100,50,1,00099,India
787910,2023-06-09,1004,Eyeliner,100,200,100,1,00099,India
787910,2023-06-09,1003,Foundation,300,600,300,1,00099,India
195330,2023-06-09,1004,Eyeliner,100,200,100,1,00006,India
195330,2023-06-09,1012,Body Lotion,200,400,200,1,00006,India
195330,2023-06-09,1009,Moisturizer,250,500,250,1,00006,India
686143,2023-06-09,1003,Foundation,300,600,300,1,00209,India
686143,2023-06-09,1009,Moisturizer,250,500,250,1,00209,India
686143,2023-06-09,1006,Blush,150,300,150,1,00209,India
686143,2023-06-09,1004,Eyeliner,100,200,100,1,00209,India
557653,2023-06-09,1005,Nail Polish,50,100,50,1,00015,India
557653,2023-06-09,1004,Eyeliner,100,200,100,1,00015,India
910566,2023-06-09,1009,Moisturizer,250,500,250,1,00119,India
570673,2023-06-09,1009,Moisturizer,250,500,250,1,00122,India
570673,2023-06-09,1004,Eyeliner,100,200,100,1,00122,India
570673,2023-06-09,1001,Lipstick,150,300,150,1,00122,India
531333,2023-06-09,1009,Moisturizer,250,500,250,1,00355,India
531333,2023-06-09,1004,Eyeliner,100,200,100,1,00355,India
531333,2023-06-09,1002,Mascara,200,400,200,1,00355,India
398642,2023-06-09,1008,Makeup Remover,80,160,80,1,00185,India
766962,2023-06-09,1003,Foundation,300,600,300,1,00457,India
766962,2023-06-09,1006,Blush,150,300,150,1,00457,India
766962,2023-06-09,1004,Eyeliner,100,200,100,1,00457,India
766962,2023-06-09,1012,Body Lotion,200,400,200,1,00457,India
434383,2023-06-09,1006,Blush,150,300,150,1,00065,India
488260,2023-06-09,1007,Eyeshadow,200,400,200,1,00243,India
408132,2023-06-09,1002,Mascara,200,400,200,1,00401,India
408132,2023-06-09,1009,Moisturizer,250,500,250,1,00401,India
976362,2023-06-09,1008,Makeup Remover,80,160,80,1,00102,India
896177,2023-06-09,1008,Makeup Remover,80,160,80,1,00230,India
398314,2023-06-09,1012,Body Lotion,200,400,200,1,00324,India
398314,2023-06-09,1004,Eyeliner,100,200,100,1,00324,India
398314,2023-06-09,1001,Lipstick,150,300,150,1,00324,India
398314,2023-06-09,1008,Makeup Remover,80,160,80,1,00324,India
286178,2023-06-09,1003,Foundation,300,600,300,1,00437,India
401422,2023-06-09,1003,Foundation,300,600,300,1,00183,India
401422,2023-06-09,1004,Eyeliner,100,200,100,1,00183,India
401422,2023-06-09,1012,Body Lotion,200,400,200,1,00183,India
401422,2023-06-09,1005,Nail Polish,50,100,50,1,00183,India
961974,2023-06-09,1001,Lipstick,150,300,150,1,00044,India
961974,2023-06-09,1006,Blush,150,300,150,1,00044,India
468992,2023-06-09,1009,Moisturizer,250,500,250,1,00016,India
468992,2023-06-09,1006,Blush,150,300,150,1,00016,India
468992,2023-06-09,1012,Body Lotion,200,400,200,1,00016,India
468992,2023-06-09,1005,Nail Polish,50,100,50,1,00016,India
468992,2023-06-09,1001,Lipstick,150,300,150,1,00016,India
752642,2023-06-09,1012,Body Lotion,200,400,200,1,00472,India
752642,2023-06-09,1003,Foundation,300,600,300,1,00472,India
752642,2023-06-09,1002,Mascara,200,400,200,1,00472,India
752642,2023-06-09,1008,Makeup Remover,80,160,80,1,00472,India
727328,2023-06-09,1008,Makeup Remover,80,160,80,1,00104,India
727328,2023-06-09,1009,Moisturizer,250,500,250,1,00104,India
727328,2023-06-09,1002,Mascara,200,400,200,1,00104,India
727328,2023-06-09,1001,Lipstick,150,300,150,1,00104,India
885549,2023-06-09,1012,Body Lotion,200,400,200,1,00476,India
885549,2023-06-09,1008,Makeup Remover,80,160,80,1,00476,India
879259,2023-06-09,1012,Body Lotion,200,400,200,1,00045,India
879259,2023-06-09,1009,Moisturizer,250,500,250,1,00045,India
879259,2023-06-09,1007,Eyeshadow,200,400,200,1,00045,India
213845,2023-06-09,1009,Moisturizer,250,500,250,1,00087,India
591321,2023-06-09,1006,Blush,150,300,150,1,00038,India
779471,2023-06-09,1006,Blush,150,300,150,1,00280,India
779471,2023-06-09,1005,Nail Polish,50,100,50,1,00280,India
779471,2023-06-09,1002,Mascara,200,400,200,1,00280,India
779471,2023-06-09,1009,Moisturizer,250,500,250,1,00280,India
759283,2023-06-09,1005,Nail Polish,50,100,50,1,00072,India
759283,2023-06-09,1012,Body Lotion,200,400,200,1,00072,India
759283,2023-06-09,1009,Moisturizer,250,500,250,1,00072,India
645574,2023-06-09,1012,Body Lotion,200,400,200,1,00031,India
645574,2023-06-09,1008,Makeup Remover,80,160,80,1,00031,India
645574,2023-06-09,1009,Moisturizer,250,500,250,1,00031,India
793914,2023-06-09,1006,Blush,150,300,150,1,00485,India
793914,2023-06-09,1001,Lipstick,150,300,150,1,00485,India
793914,2023-06-09,1003,Foundation,300,600,300,1,00485,India
793914,2023-06-09,1009,Moisturizer,250,500,250,1,00485,India
744145,2023-06-09,1004,Eyeliner,100,200,100,1,00424,India
744145,2023-06-09,1006,Blush,150,300,150,1,00424,India
744145,2023-06-09,1008,Makeup Remover,80,160,80,1,00424,India
744145,2023-06-09,1005,Nail Polish,50,100,50,1,00424,India
333455,2023-06-09,1006,Blush,150,300,150,1,00091,India
745463,2023-06-09,1004,Eyeliner,100,200,100,1,00086,India
745463,2023-06-09,1009,Moisturizer,250,500,250,1,00086,India
745463,2023-06-09,1007,Eyeshadow,200,400,200,1,00086,India
745463,2023-06-09,1008,Makeup Remover,80,160,80,1,00086,India
347317,2023-06-09,1006,Blush,150,300,150,1,00059,India
347317,2023-06-09,1007,Eyeshadow,200,400,200,1,00059,India
347317,2023-06-09,1005,Nail Polish,50,100,50,1,00059,India
347317,2023-06-09,1003,Foundation,300,600,300,1,00059,India
347317,2023-06-09,1001,Lipstick,150,300,150,1,00059,India
741474,2023-06-09,1008,Makeup Remover,80,160,80,1,00116,India
741474,2023-06-09,1004,Eyeliner,100,200,100,1,00116,India
103047,2023-06-09,1004,Eyeliner,100,200,100,1,00208,India
103047,2023-06-09,1012,Body Lotion,200,400,200,1,00208,India
103047,2023-06-09,1001,Lipstick,150,300,150,1,00208,India
103047,2023-06-09,1009,Moisturizer,250,500,250,1,00208,India
713293,2023-06-09,1004,Eyeliner,100,200,100,1,00112,India
156982,2023-06-09,1009,Moisturizer,250,500,250,1,00450,India
156982,2023-06-09,1001,Lipstick,150,300,150,1,00450,India
880546,2023-06-10,1004,Eyeliner,100,200,100,1,00468,India
880546,2023-06-10,1006,Blush,150,300,150,1,00468,India
880546,2023-06-10,1005,Nail Polish,50,100,50,1,00468,India
880546,2023-06-10,1002,Mascara,200,400,200,1,00468,India
136566,2023-06-10,1007,Eyeshadow,200,400,200,1,00486,India
136566,2023-06-10,1002,Mascara,200,400,200,1,00486,India
136566,2023-06-10,1012,Body Lotion,200,400,200,1,00486,India
347008,2023-06-10,1006,Blush,150,300,150,1,00462,India
688772,2023-06-10,1006,Blush,150,300,150,1,00287,India
688772,2023-06-10,1003,Foundation,300,600,300,1,00287,India
688772,2023-06-10,1002,Mascara,200,400,200,1,00287,India
940912,2023-06-10,1001,Lipstick,150,300,150,1,00470,India
940912,2023-06-10,1003,Foundation,300,600,300,1,00470,India
940912,2023-06-10,1002,Mascara,200,400,200,1,00470,India
940912,2023-06-10,1007,Eyeshadow,200,400,200,1,00470,India
940912,2023-06-10,1004,Eyeliner,100,200,100,1,00470,India
675463,2023-06-10,1006,Blush,150,300,150,1,00085,India
675463,2023-06-10,1009,Moisturizer,250,500,250,1,00085,India
675463,2023-06-10,1001,Lipstick,150,300,150,1,00085,India
973735,2023-06-10,1002,Mascara,200,400,200,1,00466,India
973735,2023-06-10,1007,Eyeshadow,200,400,200,1,00466,India
973735,2023-06-10,1005,Nail Polish,50,100,50,1,00466,India
973735,2023-06-10,1004,Eyeliner,100,200,100,1,00466,India
908496,2023-06-10,1002,Mascara,200,400,200,1,00226,India
908496,2023-06-10,1006,Blush,150,300,150,1,00226,India
191920,2023-06-10,1008,Makeup Remover,80,160,80,1,00106,India
191920,2023-06-10,1003,Foundation,300,600,300,1,00106,India
191920,2023-06-10,1001,Lipstick,150,300,150,1,00106,India
191920,2023-06-10,1006,Blush,150,300,150,1,00106,India
466107,2023-06-10,1005,Nail Polish,50,100,50,1,00112,India
716588,2023-06-10,1012,Body Lotion,200,400,200,1,00436,India
716588,2023-06-10,1006,Blush,150,300,150,1,00436,India
145515,2023-06-10,1006,Blush,150,300,150,1,00483,India
234131,2023-06-10,1009,Moisturizer,250,500,250,1,00312,India
418816,2023-06-10,1004,Eyeliner,100,200,100,1,00057,India
715779,2023-06-10,1009,Moisturizer,250,500,250,1,00040,India
715779,2023-06-10,1006,Blush,150,300,150,1,00040,India
715779,2023-06-10,1007,Eyeshadow,200,400,200,1,00040,India
715779,2023-06-10,1001,Lipstick,150,300,150,1,00040,India
815220,2023-06-10,1009,Moisturizer,250,500,250,1,00164,India
815220,2023-06-10,1003,Foundation,300,600,300,1,00164,India
815220,2023-06-10,1001,Lipstick,150,300,150,1,00164,India
815220,2023-06-10,1005,Nail Polish,50,100,50,1,00164,India
815220,2023-06-10,1008,Makeup Remover,80,160,80,1,00164,India
960773,2023-06-10,1007,Eyeshadow,200,400,200,1,00295,India
960773,2023-06-10,1006,Blush,150,300,150,1,00295,India
960773,2023-06-10,1004,Eyeliner,100,200,100,1,00295,India
298159,2023-06-10,1002,Mascara,200,400,200,1,00419,India
766997,2023-06-10,1009,Moisturizer,250,500,250,1,00055,India
351250,2023-06-10,1006,Blush,150,300,150,1,00453,India
320107,2023-06-10,1008,Makeup Remover,80,160,80,1,00421,India
320107,2023-06-10,1012,Body Lotion,200,400,200,1,00421,India
320107,2023-06-10,1005,Nail Polish,50,100,50,1,00421,India
320107,2023-06-10,1009,Moisturizer,250,500,250,1,00421,India
717580,2023-06-10,1004,Eyeliner,100,200,100,1,00431,India
607870,2023-06-10,1006,Blush,150,300,150,1,00061,India
607870,2023-06-10,1008,Makeup Remover,80,160,80,1,00061,India
607870,2023-06-10,1012,Body Lotion,200,400,200,1,00061,India
607870,2023-06-10,1003,Foundation,300,600,300,1,00061,India
483208,2023-06-10,1005,Nail Polish,50,100,50,1,00075,India
483208,2023-06-10,1001,Lipstick,150,300,150,1,00075,India
249856,2023-06-10,1004,Eyeliner,100,200,100,1,00393,India
249856,2023-06-10,1005,Nail Polish,50,100,50,1,00393,India
249856,2023-06-10,1008,Makeup Remover,80,160,80,1,00393,India
593126,2023-06-10,1003,Foundation,300,600,300,1,00115,India
593126,2023-06-10,1006,Blush,150,300,150,1,00115,India
593126,2023-06-10,1002,Mascara,200,400,200,1,00115,India
593126,2023-06-10,1009,Moisturizer,250,500,250,1,00115,India
593126,2023-06-10,1012,Body Lotion,200,400,200,1,00115,India
371595,2023-06-10,1001,Lipstick,150,300,150,1,00027,India
371595,2023-06-10,1008,Makeup Remover,80,160,80,1,00027,India
371595,2023-06-10,1009,Moisturizer,250,500,250,1,00027,India
371595,2023-06-10,1002,Mascara,200,400,200,1,00027,India
317612,2023-06-10,1009,Moisturizer,250,500,250,1,00220,India
671858,2023-06-10,1001,Lipstick,150,300,150,1,00034,India
671858,2023-06-10,1006,Blush,150,300,150,1,00034,India
488411,2023-06-10,1009,Moisturizer,250,500,250,1,00479,India
488411,2023-06-10,1005,Nail Polish,50,100,50,1,00479,India
488411,2023-06-10,1003,Foundation,300,600,300,1,00479,India
522384,2023-06-10,1009,Moisturizer,250,500,250,1,00460,India
532899,2023-06-10,1009,Moisturizer,250,500,250,1,00382,India
532899,2023-06-10,1012,Body Lotion,200,400,200,1,00382,India
532899,2023-06-10,1006,Blush,150,300,150,1,00382,India
532899,2023-06-10,1002,Mascara,200,400,200,1,00382,India
958155,2023-06-10,1008,Makeup Remover,80,160,80,1,00030,India
991069,2023-06-10,1012,Body Lotion,200,400,200,1,00055,India
991069,2023-06-10,1009,Moisturizer,250,500,250,1,00055,India
991069,2023-06-10,1001,Lipstick,150,300,150,1,00055,India
991069,2023-06-10,1007,Eyeshadow,200,400,200,1,00055,India
449192,2023-06-10,1006,Blush,150,300,150,1,00119,India
449192,2023-06-10,1005,Nail Polish,50,100,50,1,00119,India
449192,2023-06-10,1003,Foundation,300,600,300,1,00119,India
503343,2023-06-10,1009,Moisturizer,250,500,250,1,00279,India
503343,2023-06-10,1005,Nail Polish,50,100,50,1,00279,India
503343,2023-06-10,1006,Blush,150,300,150,1,00279,India
503343,2023-06-10,1002,Mascara,200,400,200,1,00279,India
503343,2023-06-10,1012,Body Lotion,200,400,200,1,00279,India
605363,2023-06-11,1005,Nail Polish,50,100,50,1,00277,India
605363,2023-06-11,1007,Eyeshadow,200,400,200,1,00277,India
605363,2023-06-11,1008,Makeup Remover,80,160,80,1,00277,India
179141,2023-06-11,1003,Foundation,300,600,300,1,00426,India
179141,2023-06-11,1012,Body Lotion,200,400,200,1,00426,India
103759,2023-06-11,1004,Eyeliner,100,200,100,1,00500,India
103759,2023-06-11,1003,Foundation,300,600,300,1,00500,India
847790,2023-06-11,1004,Eyeliner,100,200,100,1,00183,India
847790,2023-06-11,1003,Foundation,300,600,300,1,00183,India
847790,2023-06-11,1009,Moisturizer,250,500,250,1,00183,India
847790,2023-06-11,1002,Mascara,200,400,200,1,00183,India
749008,2023-06-11,1005,Nail Polish,50,100,50,1,00069,India
749008,2023-06-11,1009,Moisturizer,250,500,250,1,00069,India
206065,2023-06-11,1008,Makeup Remover,80,160,80,1,00376,India
206065,2023-06-11,1002,Mascara,200,400,200,1,00376,India
484951,2023-06-11,1008,Makeup Remover,80,160,80,1,00092,India
484951,2023-06-11,1002,Mascara,200,400,200,1,00092,India
484951,2023-06-11,1012,Body Lotion,200,400,200,1,00092,India
484951,2023-06-11,1001,Lipstick,150,300,150,1,00092,India
812633,2023-06-11,1003,Foundation,300,600,300,1,00290,India
812633,2023-06-11,1006,Blush,150,300,150,1,00290,India
812633,2023-06-11,1012,Body Lotion,200,400,200,1,00290,India
812633,2023-06-11,1005,Nail Polish,50,100,50,1,00290,India
416008,2023-06-11,1006,Blush,150,300,150,1,00443,India
416008,2023-06-11,1002,Mascara,200,400,200,1,00443,India
797183,2023-06-11,1006,Blush,150,300,150,1,00268,India
797183,2023-06-11,1009,Moisturizer,250,500,250,1,00268,India
797183,2023-06-11,1005,Nail Polish,50,100,50,1,00268,India
769141,2023-06-11,1006,Blush,150,300,150,1,00263,India
769141,2023-06-11,1003,Foundation,300,600,300,1,00263,India
769141,2023-06-11,1007,Eyeshadow,200,400,200,1,00263,India
989093,2023-06-11,1001,Lipstick,150,300,150,1,00071,India
989093,2023-06-11,1006,Blush,150,300,150,1,00071,India
930113,2023-06-11,1012,Body Lotion,200,400,200,1,00174,India
930113,2023-06-11,1004,Eyeliner,100,200,100,1,00174,India
930113,2023-06-11,1003,Foundation,300,600,300,1,00174,India
930113,2023-06-11,1002,Mascara,200,400,200,1,00174,India
398577,2023-06-11,1004,Eyeliner,100,200,100,1,00403,India
398577,2023-06-11,1006,Blush,150,300,150,1,00403,India
398577,2023-06-11,1007,Eyeshadow,200,400,200,1,00403,India
294396,2023-06-11,1008,Makeup Remover,80,160,80,1,00409,India
294396,2023-06-11,1002,Mascara,200,400,200,1,00409,India
557124,2023-06-11,1007,Eyeshadow,200,400,200,1,00486,India
743684,2023-06-11,1008,Makeup Remover,80,160,80,1,00071,India
743684,2023-06-11,1005,Nail Polish,50,100,50,1,00071,India
743684,2023-06-11,1012,Body Lotion,200,400,200,1,00071,India
303641,2023-06-11,1012,Body Lotion,200,400,200,1,00357,India
105913,2023-06-11,1002,Mascara,200,400,200,1,00272,India
105913,2023-06-11,1012,Body Lotion,200,400,200,1,00272,India
823144,2023-06-11,1002,Mascara,200,400,200,1,00345,India
823144,2023-06-11,1001,Lipstick,150,300,150,1,00345,India
823144,2023-06-11,1004,Eyeliner,100,200,100,1,00345,India
823144,2023-06-11,1005,Nail Polish,50,100,50,1,00345,India
299147,2023-06-11,1002,Mascara,200,400,200,1,00439,India
299147,2023-06-11,1006,Blush,150,300,150,1,00439,India
935827,2023-06-11,1006,Blush,150,300,150,1,00309,India
935827,2023-06-11,1012,Body Lotion,200,400,200,1,00309,India
649459,2023-06-11,1006,Blush,150,300,150,1,00165,India
713030,2023-06-11,1003,Foundation,300,600,300,1,00064,India
713030,2023-06-11,1008,Makeup Remover,80,160,80,1,00064,India
713030,2023-06-11,1004,Eyeliner,100,200,100,1,00064,India
640414,2023-06-11,1007,Eyeshadow,200,400,200,1,00206,India
640414,2023-06-11,1004,Eyeliner,100,200,100,1,00206,India
918650,2023-06-11,1009,Moisturizer,250,500,250,1,00026,India
918650,2023-06-11,1005,Nail Polish,50,100,50,1,00026,India
918650,2023-06-11,1004,Eyeliner,100,200,100,1,00026,India
277429,2023-06-11,1009,Moisturizer,250,500,250,1,00455,India
277429,2023-06-11,1012,Body Lotion,200,400,200,1,00455,India
912278,2023-06-11,1012,Body Lotion,200,400,200,1,00346,India
912278,2023-06-11,1002,Mascara,200,400,200,1,00346,India
912278,2023-06-11,1006,Blush,150,300,150,1,00346,India
627932,2023-06-11,1012,Body Lotion,200,400,200,1,00315,India
627932,2023-06-11,1001,Lipstick,150,300,150,1,00315,India
556222,2023-06-11,1006,Blush,150,300,150,1,00206,India
556222,2023-06-11,1008,Makeup Remover,80,160,80,1,00206,India
556222,2023-06-11,1009,Moisturizer,250,500,250,1,00206,India
123155,2023-06-11,1012,Body Lotion,200,400,200,1,00091,India
123155,2023-06-11,1004,Eyeliner,100,200,100,1,00091,India
123155,2023-06-11,1005,Nail Polish,50,100,50,1,00091,India
617579,2023-06-11,1007,Eyeshadow,200,400,200,1,00333,India
617579,2023-06-11,1001,Lipstick,150,300,150,1,00333,India
617579,2023-06-11,1006,Blush,150,300,150,1,00333,India
617579,2023-06-11,1012,Body Lotion,200,400,200,1,00333,India
283613,2023-06-11,1006,Blush,150,300,150,1,00016,India
283613,2023-06-11,1005,Nail Polish,50,100,50,1,00016,India
283613,2023-06-11,1004,Eyeliner,100,200,100,1,00016,India
283613,2023-06-11,1001,Lipstick,150,300,150,1,00016,India
795048,2023-06-11,1012,Body Lotion,200,400,200,1,00026,India
795048,2023-06-11,1006,Blush,150,300,150,1,00026,India
842821,2023-06-11,1002,Mascara,200,400,200,1,00202,India
988372,2023-06-11,1002,Mascara,200,400,200,1,00265,India
355298,2023-06-11,1009,Moisturizer,250,500,250,1,00306,India
355298,2023-06-11,1003,Foundation,300,600,300,1,00306,India
355298,2023-06-11,1012,Body Lotion,200,400,200,1,00306,India
355298,2023-06-11,1001,Lipstick,150,300,150,1,00306,India
984581,2023-06-11,1008,Makeup Remover,80,160,80,1,00279,India
251775,2023-06-11,1005,Nail Polish,50,100,50,1,00168,India
251775,2023-06-11,1008,Makeup Remover,80,160,80,1,00168,India
251775,2023-06-11,1003,Foundation,300,600,300,1,00168,India
646891,2023-06-11,1002,Mascara,200,400,200,1,00460,India
646891,2023-06-11,1001,Lipstick,150,300,150,1,00460,India
646891,2023-06-11,1012,Body Lotion,200,400,200,1,00460,India
579524,2023-06-12,1004,Eyeliner,100,200,100,1,00339,India
579524,2023-06-12,1007,Eyeshadow,200,400,200,1,00339,India
579524,2023-06-12,1003,Foundation,300,600,300,1,00339,India
579524,2023-06-12,1009,Moisturizer,250,500,250,1,00339,India
876448,2023-06-12,1009,Moisturizer,250,500,250,1,00117,India
876448,2023-06-12,1012,Body Lotion,200,400,200,1,00117,India
901838,2023-06-12,1003,Foundation,300,600,300,1,00346,India
901838,2023-06-12,1008,Makeup Remover,80,160,80,1,00346,India
901838,2023-06-12,1002,Mascara,200,400,200,1,00346,India
296705,2023-06-12,1005,Nail Polish,50,100,50,1,00407,India
296705,2023-06-12,1002,Mascara,200,400,200,1,00407,India
296705,2023-06-12,1007,Eyeshadow,200,400,200,1,00407,India
296705,2023-06-12,1008,Makeup Remover,80,160,80,1,00407,India
296705,2023-06-12,1001,Lipstick,150,300,150,1,00407,India
412321,2023-06-12,1001,Lipstick,150,300,150,1,00199,India
371918,2023-06-12,1008,Makeup Remover,80,160,80,1,00394,India
371918,2023-06-12,1002,Mascara,200,400,200,1,00394,India
405651,2023-06-12,1007,Eyeshadow,200,400,200,1,00215,India
405651,2023-06-12,1006,Blush,150,300,150,1,00215,India
405651,2023-06-12,1002,Mascara,200,400,200,1,00215,India
405651,2023-06-12,1008,Makeup Remover,80,160,80,1,00215,India
940455,2023-06-12,1006,Blush,150,300,150,1,00137,India
703000,2023-06-12,1006,Blush,150,300,150,1,00367,India
703000,2023-06-12,1002,Mascara,200,400,200,1,00367,India
715672,2023-06-12,1006,Blush,150,300,150,1,00116,India
715672,2023-06-12,1005,Nail Polish,50,100,50,1,00116,India
410728,2023-06-12,1009,Moisturizer,250,500,250,1,00055,India
410728,2023-06-12,1002,Mascara,200,400,200,1,00055,India
410728,2023-06-12,1005,Nail Polish,50,100,50,1,00055,India
546573,2023-06-12,1008,Makeup Remover,80,160,80,1,00191,India
546573,2023-06-12,1004,Eyeliner,100,200,100,1,00191,India
546573,2023-06-12,1002,Mascara,200,400,200,1,00191,India
126455,2023-06-12,1012,Body Lotion,200,400,200,1,00100,India
817424,2023-06-12,1006,Blush,150,300,150,1,00046,India
817424,2023-06-12,1009,Moisturizer,250,500,250,1,00046,India
993825,2023-06-12,1008,Makeup Remover,80,160,80,1,00327,India
993825,2023-06-12,1004,Eyeliner,100,200,100,1,00327,India
993825,2023-06-12,1009,Moisturizer,250,500,250,1,00327,India
618633,2023-06-12,1007,Eyeshadow,200,400,200,1,00356,India
618633,2023-06-12,1004,Eyeliner,100,200,100,1,00356,India
618633,2023-06-12,1001,Lipstick,150,300,150,1,00356,India
618633,2023-06-12,1005,Nail Polish,50,100,50,1,00356,India
637146,2023-06-12,1004,Eyeliner,100,200,100,1,00186,India
637146,2023-06-12,1007,Eyeshadow,200,400,200,1,00186,India
714114,2023-06-12,1009,Moisturizer,250,500,250,1,00383,India
714114,2023-06-12,1001,Lipstick,150,300,150,1,00383,India
894031,2023-06-12,1005,Nail Polish,50,100,50,1,00072,India
390780,2023-06-12,1001,Lipstick,150,300,150,1,00363,India
390780,2023-06-12,1003,Foundation,300,600,300,1,00363,India
160812,2023-06-12,1009,Moisturizer,250,500,250,1,00470,India
901157,2023-06-12,1003,Foundation,300,600,300,1,00311,India
901157,2023-06-12,1006,Blush,150,300,150,1,00311,India
901157,2023-06-12,1001,Lipstick,150,300,150,1,00311,India
722346,2023-06-12,1012,Body Lotion,200,400,200,1,00406,India
305975,2023-06-12,1008,Makeup Remover,80,160,80,1,00292,India
979443,2023-06-12,1009,Moisturizer,250,500,250,1,00318,India
979443,2023-06-12,1001,Lipstick,150,300,150,1,00318,India
979443,2023-06-12,1004,Eyeliner,100,200,100,1,00318,India
979443,2023-06-12,1002,Mascara,200,400,200,1,00318,India
190944,2023-06-12,1004,Eyeliner,100,200,100,1,00454,India
777854,2023-06-12,1004,Eyeliner,100,200,100,1,00289,India
777854,2023-06-12,1012,Body Lotion,200,400,200,1,00289,India
777854,2023-06-12,1008,Makeup Remover,80,160,80,1,00289,India
606392,2023-06-12,1008,Makeup Remover,80,160,80,1,00073,India
606392,2023-06-12,1003,Foundation,300,600,300,1,00073,India
606392,2023-06-12,1012,Body Lotion,200,400,200,1,00073,India
606392,2023-06-12,1004,Eyeliner,100,200,100,1,00073,India
448701,2023-06-12,1003,Foundation,300,600,300,1,00030,India
448701,2023-06-12,1002,Mascara,200,400,200,1,00030,India
353024,2023-06-12,1009,Moisturizer,250,500,250,1,00468,India
353024,2023-06-12,1007,Eyeshadow,200,400,200,1,00468,India
353024,2023-06-12,1008,Makeup Remover,80,160,80,1,00468,India
599827,2023-06-12,1012,Body Lotion,200,400,200,1,00149,India
487064,2023-06-12,1006,Blush,150,300,150,1,00466,India
487064,2023-06-12,1012,Body Lotion,200,400,200,1,00466,India
487064,2023-06-12,1005,Nail Polish,50,100,50,1,00466,India
487064,2023-06-12,1007,Eyeshadow,200,400,200,1,00466,India
617717,2023-06-12,1003,Foundation,300,600,300,1,00183,India
617717,2023-06-12,1009,Moisturizer,250,500,250,1,00183,India
617717,2023-06-12,1012,Body Lotion,200,400,200,1,00183,India
212018,2023-06-12,1005,Nail Polish,50,100,50,1,00441,India
212018,2023-06-12,1001,Lipstick,150,300,150,1,00441,India
212018,2023-06-12,1004,Eyeliner,100,200,100,1,00441,India
212018,2023-06-12,1009,Moisturizer,250,500,250,1,00441,India
326147,2023-06-12,1001,Lipstick,150,300,150,1,00147,India
326147,2023-06-12,1009,Moisturizer,250,500,250,1,00147,India
326147,2023-06-12,1012,Body Lotion,200,400,200,1,00147,India
326147,2023-06-12,1008,Makeup Remover,80,160,80,1,00147,India
968903,2023-06-12,1008,Makeup Remover,80,160,80,1,00257,India
968903,2023-06-12,1006,Blush,150,300,150,1,00257,India
968903,2023-06-12,1002,Mascara,200,400,200,1,00257,India
968903,2023-06-12,1003,Foundation,300,600,300,1,00257,India
968903,2023-06-12,1007,Eyeshadow,200,400,200,1,00257,India
267212,2023-06-13,1004,Eyeliner,100,200,100,1,00359,India
267212,2023-06-13,1006,Blush,150,300,150,1,00359,India
259611,2023-06-13,1001,Lipstick,150,300,150,1,00034,India
259611,2023-06-13,1009,Moisturizer,250,500,250,1,00034,India
729811,2023-06-13,1009,Moisturizer,250,500,250,1,00427,India
729811,2023-06-13,1012,Body Lotion,200,400,200,1,00427,India
729811,2023-06-13,1003,Foundation,300,600,300,1,00427,India
729811,2023-06-13,1007,Eyeshadow,200,400,200,1,00427,India
437539,2023-06-13,1006,Blush,150,300,150,1,00094,India
712049,2023-06-13,1007,Eyeshadow,200,400,200,1,00318,India
362112,2023-06-13,1009,Moisturizer,250,500,250,1,00385,India
537929,2023-06-13,1003,Foundation,300,600,300,1,00324,India
537929,2023-06-13,1007,Eyeshadow,200,400,200,1,00324,India
537929,2023-06-13,1002,Mascara,200,400,200,1,00324,India
537929,2023-06-13,1005,Nail Polish,50,100,50,1,00324,India
257559,2023-06-13,1009,Moisturizer,250,500,250,1,00220,India
257559,2023-06-13,1005,Nail Polish,50,100,50,1,00220,India
257559,2023-06-13,1007,Eyeshadow,200,400,200,1,00220,India
257559,2023-06-13,1003,Foundation,300,600,300,1,00220,India
587017,2023-06-13,1012,Body Lotion,200,400,200,1,00049,India
587017,2023-06-13,1002,Mascara,200,400,200,1,00049,India
587017,2023-06-13,1003,Foundation,300,600,300,1,00049,India
587017,2023-06-13,1001,Lipstick,150,300,150,1,00049,India
989779,2023-06-13,1003,Foundation,300,600,300,1,00466,India
989779,2023-06-13,1005,Nail Polish,50,100,50,1,00466,India
989779,2023-06-13,1002,Mascara,200,400,200,1,00466,India
989779,2023-06-13,1008,Makeup Remover,80,160,80,1,00466,India
989779,2023-06-13,1004,Eyeliner,100,200,100,1,00466,India
135421,2023-06-13,1009,Moisturizer,250,500,250,1,00408,India
135421,2023-06-13,1005,Nail Polish,50,100,50,1,00408,India
135421,2023-06-13,1006,Blush,150,300,150,1,00408,India
135421,2023-06-13,1003,Foundation,300,600,300,1,00408,India
466020,2023-06-13,1005,Nail Polish,50,100,50,1,00350,India
466020,2023-06-13,1012,Body Lotion,200,400,200,1,00350,India
466020,2023-06-13,1003,Foundation,300,600,300,1,00350,India
106917,2023-06-13,1002,Mascara,200,400,200,1,00495,India
106917,2023-06-13,1012,Body Lotion,200,400,200,1,00495,India
106917,2023-06-13,1007,Eyeshadow,200,400,200,1,00495,India
106917,2023-06-13,1003,Foundation,300,600,300,1,00495,India
837278,2023-06-13,1002,Mascara,200,400,200,1,00333,India
837278,2023-06-13,1004,Eyeliner,100,200,100,1,00333,India
837278,2023-06-13,1012,Body Lotion,200,400,200,1,00333,India
837278,2023-06-13,1008,Makeup Remover,80,160,80,1,00333,India
837278,2023-06-13,1003,Foundation,300,600,300,1,00333,India
700997,2023-06-13,1006,Blush,150,300,150,1,00101,India
700997,2023-06-13,1009,Moisturizer,250,500,250,1,00101,India
700997,2023-06-13,1008,Makeup Remover,80,160,80,1,00101,India
700997,2023-06-13,1012,Body Lotion,200,400,200,1,00101,India
700997,2023-06-13,1007,Eyeshadow,200,400,200,1,00101,India
506980,2023-06-13,1008,Makeup Remover,80,160,80,1,00009,India
506980,2023-06-13,1012,Body Lotion,200,400,200,1,00009,India
581014,2023-06-13,1009,Moisturizer,250,500,250,1,00250,India
581014,2023-06-13,1007,Eyeshadow,200,400,200,1,00250,India
971399,2023-06-13,1002,Mascara,200,400,200,1,00492,India
971399,2023-06-13,1004,Eyeliner,100,200,100,1,00492,India
971399,2023-06-13,1012,Body Lotion,200,400,200,1,00492,India
971399,2023-06-13,1005,Nail Polish,50,100,50,1,00492,India
614085,2023-06-13,1003,Foundation,300,600,300,1,00408,India
642703,2023-06-13,1007,Eyeshadow,200,400,200,1,00064,India
642703,2023-06-13,1012,Body Lotion,200,400,200,1,00064,India
642703,2023-06-13,1005,Nail Polish,50,100,50,1,00064,India
950568,2023-06-13,1006,Blush,150,300,150,1,00405,India
950568,2023-06-13,1009,Moisturizer,250,500,250,1,00405,India
950568,2023-06-13,1001,Lipstick,150,300,150,1,00405,India
950568,2023-06-13,1004,Eyeliner,100,200,100,1,00405,India
950568,2023-06-13,1005,Nail Polish,50,100,50,1,00405,India
838725,2023-06-13,1009,Moisturizer,250,500,250,1,00142,India
838725,2023-06-13,1007,Eyeshadow,200,400,200,1,00142,India
838725,2023-06-13,1002,Mascara,200,400,200,1,00142,India
838725,2023-06-13,1008,Makeup Remover,80,160,80,1,00142,India
709876,2023-06-13,1005,Nail Polish,50,100,50,1,00188,India
709876,2023-06-13,1003,Foundation,300,600,300,1,00188,India
709876,2023-06-13,1009,Moisturizer,250,500,250,1,00188,India
228595,2023-06-13,1012,Body Lotion,200,400,200,1,00498,India
228595,2023-06-13,1007,Eyeshadow,200,400,200,1,00498,India
228595,2023-06-13,1004,Eyeliner,100,200,100,1,00498,India
369048,2023-06-13,1002,Mascara,200,400,200,1,00080,India
369048,2023-06-13,1003,Foundation,300,600,300,1,00080,India
369048,2023-06-13,1001,Lipstick,150,300,150,1,00080,India
369048,2023-06-13,1006,Blush,150,300,150,1,00080,India
900819,2023-06-13,1002,Mascara,200,400,200,1,00332,India
900819,2023-06-13,1003,Foundation,300,600,300,1,00332,India
900819,2023-06-13,1004,Eyeliner,100,200,100,1,00332,India
483063,2023-06-13,1002,Mascara,200,400,200,1,00417,India
483063,2023-06-13,1003,Foundation,300,600,300,1,00417,India
483063,2023-06-13,1001,Lipstick,150,300,150,1,00417,India
343500,2023-06-13,1012,Body Lotion,200,400,200,1,00484,India
343500,2023-06-13,1007,Eyeshadow,200,400,200,1,00484,India
343500,2023-06-13,1009,Moisturizer,250,500,250,1,00484,India
908354,2023-06-13,1012,Body Lotion,200,400,200,1,00424,India
908354,2023-06-13,1006,Blush,150,300,150,1,00424,India
908354,2023-06-13,1003,Foundation,300,600,300,1,00424,India
908354,2023-06-13,1009,Moisturizer,250,500,250,1,00424,India
908354,2023-06-13,1004,Eyeliner,100,200,100,1,00424,India
406327,2023-06-13,1012,Body Lotion,200,400,200,1,00452,India
915300,2023-06-13,1003,Foundation,300,600,300,1,00248,India
915300,2023-06-13,1007,Eyeshadow,200,400,200,1,00248,India
915300,2023-06-13,1002,Mascara,200,400,200,1,00248,India
808812,2023-06-13,1006,Blush,150,300,150,1,00129,India
294006,2023-06-13,1001,Lipstick,150,300,150,1,00123,India
628772,2023-06-13,1012,Body Lotion,200,400,200,1,00225,India
628772,2023-06-13,1007,Eyeshadow,200,400,200,1,00225,India
408372,2023-06-13,1001,Lipstick,150,300,150,1,00099,India
408372,2023-06-13,1006,Blush,150,300,150,1,00099,India
408372,2023-06-13,1008,Makeup Remover,80,160,80,1,00099,India
908402,2023-06-13,1002,Mascara,200,400,200,1,00467,India
908402,2023-06-13,1005,Nail Polish,50,100,50,1,00467,India
908402,2023-06-13,1008,Makeup Remover,80,160,80,1,00467,India
908402,2023-06-13,1012,Body Lotion,200,400,200,1,00467,India
908402,2023-06-13,1007,Eyeshadow,200,400,200,1,00467,India
182883,2023-06-13,1003,Foundation,300,600,300,1,00150,India
636243,2023-06-13,1005,Nail Polish,50,100,50,1,00193,India
894262,2023-06-13,1001,Lipstick,150,300,150,1,00292,India
894262,2023-06-13,1004,Eyeliner,100,200,100,1,00292,India
894262,2023-06-13,1006,Blush,150,300,150,1,00292,India
291556,2023-06-13,1003,Foundation,300,600,300,1,00338,India
291556,2023-06-13,1012,Body Lotion,200,400,200,1,00338,India
856508,2023-06-13,1004,Eyeliner,100,200,100,1,00378,India
333094,2023-06-13,1006,Blush,150,300,150,1,00092,India
421929,2023-06-13,1008,Makeup Remover,80,160,80,1,00401,India
421929,2023-06-13,1002,Mascara,200,400,200,1,00401,India
421929,2023-06-13,1009,Moisturizer,250,500,250,1,00401,India
151313,2023-06-13,1002,Mascara,200,400,200,1,00279,India
151313,2023-06-13,1009,Moisturizer,250,500,250,1,00279,India
511906,2023-06-13,1004,Eyeliner,100,200,100,1,00224,India
511906,2023-06-13,1003,Foundation,300,600,300,1,00224,India
511906,2023-06-13,1001,Lipstick,150,300,150,1,00224,India
511906,2023-06-13,1007,Eyeshadow,200,400,200,1,00224,India
785795,2023-06-13,1012,Body Lotion,200,400,200,1,00392,India
785795,2023-06-13,1005,Nail Polish,50,100,50,1,00392,India
785795,2023-06-13,1004,Eyeliner,100,200,100,1,00392,India
785795,2023-06-13,1001,Lipstick,150,300,150,1,00392,India
788470,2023-06-13,1007,Eyeshadow,200,400,200,1,00270,India
649977,2023-06-13,1012,Body Lotion,200,400,200,1,00283,India
535494,2023-06-14,1001,Lipstick,150,300,150,1,00380,India
535494,2023-06-14,1006,Blush,150,300,150,1,00380,India
535494,2023-06-14,1002,Mascara,200,400,200,1,00380,India
535494,2023-06-14,1008,Makeup Remover,80,160,80,1,00380,India
510176,2023-06-14,1006,Blush,150,300,150,1,00156,India
510176,2023-06-14,1005,Nail Polish,50,100,50,1,00156,India
510176,2023-06-14,1002,Mascara,200,400,200,1,00156,India
510176,2023-06-14,1008,Makeup Remover,80,160,80,1,00156,India
510176,2023-06-14,1007,Eyeshadow,200,400,200,1,00156,India
464709,2023-06-14,1008,Makeup Remover,80,160,80,1,00220,India
464709,2023-06-14,1006,Blush,150,300,150,1,00220,India
464709,2023-06-14,1002,Mascara,200,400,200,1,00220,India
464709,2023-06-14,1012,Body Lotion,200,400,200,1,00220,India
327196,2023-06-14,1008,Makeup Remover,80,160,80,1,00125,India
327196,2023-06-14,1009,Moisturizer,250,500,250,1,00125,India
327196,2023-06-14,1006,Blush,150,300,150,1,00125,India
327196,2023-06-14,1007,Eyeshadow,200,400,200,1,00125,India
237186,2023-06-14,1007,Eyeshadow,200,400,200,1,00227,India
237186,2023-06-14,1006,Blush,150,300,150,1,00227,India
591254,2023-06-14,1001,Lipstick,150,300,150,1,00165,India
591254,2023-06-14,1007,Eyeshadow,200,400,200,1,00165,India
591254,2023-06-14,1008,Makeup Remover,80,160,80,1,00165,India
591254,2023-06-14,1005,Nail Polish,50,100,50,1,00165,India
386231,2023-06-14,1001,Lipstick,150,300,150,1,00009,India
386231,2023-06-14,1004,Eyeliner,100,200,100,1,00009,India
386231,2023-06-14,1012,Body Lotion,200,400,200,1,00009,India
386231,2023-06-14,1007,Eyeshadow,200,400,200,1,00009,India
138369,2023-06-14,1003,Foundation,300,600,300,1,00066,India
138369,2023-06-14,1004,Eyeliner,100,200,100,1,00066,India
138369,2023-06-14,1001,Lipstick,150,300,150,1,00066,India
145121,2023-06-14,1007,Eyeshadow,200,400,200,1,00095,India
145121,2023-06-14,1005,Nail Polish,50,100,50,1,00095,India
550219,2023-06-14,1004,Eyeliner,100,200,100,1,00362,India
550219,2023-06-14,1007,Eyeshadow,200,400,200,1,00362,India
550219,2023-06-14,1006,Blush,150,300,150,1,00362,India
890255,2023-06-14,1001,Lipstick,150,300,150,1,00397,India
890255,2023-06-14,1008,Makeup Remover,80,160,80,1,00397,India
913060,2023-06-14,1005,Nail Polish,50,100,50,1,00380,India
232559,2023-06-14,1004,Eyeliner,100,200,100,1,00188,India
966909,2023-06-14,1003,Foundation,300,600,300,1,00164,India
955280,2023-06-14,1012,Body Lotion,200,400,200,1,00044,India
955280,2023-06-14,1007,Eyeshadow,200,400,200,1,00044,India
955280,2023-06-14,1009,Moisturizer,250,500,250,1,00044,India
955280,2023-06-14,1003,Foundation,300,600,300,1,00044,India
365174,2023-06-14,1007,Eyeshadow,200,400,200,1,00444,India
365174,2023-06-14,1004,Eyeliner,100,200,100,1,00444,India
148282,2023-06-14,1007,Eyeshadow,200,400,200,1,00057,India
148282,2023-06-14,1002,Mascara,200,400,200,1,00057,India
825736,2023-06-14,1012,Body Lotion,200,400,200,1,00015,India
825736,2023-06-14,1008,Makeup Remover,80,160,80,1,00015,India
825736,2023-06-14,1004,Eyeliner,100,200,100,1,00015,India
825736,2023-06-14,1002,Mascara,200,400,200,1,00015,India
289537,2023-06-14,1001,Lipstick,150,300,150,1,00483,India
651325,2023-06-14,1009,Moisturizer,250,500,250,1,00220,India
651325,2023-06-14,1006,Blush,150,300,150,1,00220,India
651325,2023-06-14,1003,Foundation,300,600,300,1,00220,India
237434,2023-06-14,1004,Eyeliner,100,200,100,1,00345,India
237434,2023-06-14,1001,Lipstick,150,300,150,1,00345,India
544173,2023-06-14,1008,Makeup Remover,80,160,80,1,00382,India
544173,2023-06-14,1002,Mascara,200,400,200,1,00382,India
872483,2023-06-14,1002,Mascara,200,400,200,1,00466,India
872483,2023-06-14,1001,Lipstick,150,300,150,1,00466,India
833675,2023-06-14,1006,Blush,150,300,150,1,00221,India
998862,2023-06-14,1009,Moisturizer,250,500,250,1,00448,India
998862,2023-06-14,1008,Makeup Remover,80,160,80,1,00448,India
998862,2023-06-14,1002,Mascara,200,400,200,1,00448,India
998862,2023-06-14,1012,Body Lotion,200,400,200,1,00448,India
685849,2023-06-14,1008,Makeup Remover,80,160,80,1,00055,India
685849,2023-06-14,1001,Lipstick,150,300,150,1,00055,India
319879,2023-06-14,1007,Eyeshadow,200,400,200,1,00328,India
319879,2023-06-14,1005,Nail Polish,50,100,50,1,00328,India
319879,2023-06-14,1006,Blush,150,300,150,1,00328,India
561880,2023-06-14,1002,Mascara,200,400,200,1,00089,India
561880,2023-06-14,1008,Makeup Remover,80,160,80,1,00089,India
561880,2023-06-14,1001,Lipstick,150,300,150,1,00089,India
561880,2023-06-14,1006,Blush,150,300,150,1,00089,India
724102,2023-06-14,1012,Body Lotion,200,400,200,1,00132,India
724102,2023-06-14,1005,Nail Polish,50,100,50,1,00132,India
724102,2023-06-14,1004,Eyeliner,100,200,100,1,00132,India
844565,2023-06-14,1002,Mascara,200,400,200,1,00017,India
601338,2023-06-14,1009,Moisturizer,250,500,250,1,00210,India
601338,2023-06-14,1001,Lipstick,150,300,150,1,00210,India
601338,2023-06-14,1003,Foundation,300,600,300,1,00210,India
245617,2023-06-14,1004,Eyeliner,100,200,100,1,00307,India
245617,2023-06-14,1006,Blush,150,300,150,1,00307,India
609761,2023-06-14,1004,Eyeliner,100,200,100,1,00342,India
609761,2023-06-14,1002,Mascara,200,400,200,1,00342,India
953828,2023-06-14,1003,Foundation,300,600,300,1,00477,India
339852,2023-06-14,1001,Lipstick,150,300,150,1,00376,India
339852,2023-06-14,1004,Eyeliner,100,200,100,1,00376,India
339852,2023-06-14,1002,Mascara,200,400,200,1,00376,India
668210,2023-06-14,1006,Blush,150,300,150,1,00122,India
668210,2023-06-14,1012,Body Lotion,200,400,200,1,00122,India
668210,2023-06-14,1008,Makeup Remover,80,160,80,1,00122,India
668210,2023-06-14,1003,Foundation,300,600,300,1,00122,India
668210,2023-06-14,1009,Moisturizer,250,500,250,1,00122,India
143995,2023-06-14,1003,Foundation,300,600,300,1,00337,India
447906,2023-06-14,1002,Mascara,200,400,200,1,00281,India
447906,2023-06-14,1012,Body Lotion,200,400,200,1,00281,India
447906,2023-06-14,1009,Moisturizer,250,500,250,1,00281,India
461912,2023-06-14,1012,Body Lotion,200,400,200,1,00166,India
461912,2023-06-14,1003,Foundation,300,600,300,1,00166,India
287894,2023-06-14,1001,Lipstick,150,300,150,1,00077,India
802174,2023-06-14,1006,Blush,150,300,150,1,00094,India
167189,2023-06-14,1008,Makeup Remover,80,160,80,1,00197,India
167189,2023-06-14,1006,Blush,150,300,150,1,00197,India
853172,2023-06-14,1004,Eyeliner,100,200,100,1,00390,India
853172,2023-06-14,1001,Lipstick,150,300,150,1,00390,India
853172,2023-06-14,1005,Nail Polish,50,100,50,1,00390,India
561630,2023-06-14,1005,Nail Polish,50,100,50,1,00194,India
561630,2023-06-14,1007,Eyeshadow,200,400,200,1,00194,India
561630,2023-06-14,1001,Lipstick,150,300,150,1,00194,India
750581,2023-06-14,1012,Body Lotion,200,400,200,1,00126,India
750581,2023-06-14,1006,Blush,150,300,150,1,00126,India
750581,2023-06-14,1002,Mascara,200,400,200,1,00126,India
871410,2023-06-14,1007,Eyeshadow,200,400,200,1,00116,India
871410,2023-06-14,1003,Foundation,300,600,300,1,00116,India
550336,2023-06-14,1007,Eyeshadow,200,400,200,1,00005,India
550336,2023-06-14,1012,Body Lotion,200,400,200,1,00005,India
550336,2023-06-14,1001,Lipstick,150,300,150,1,00005,India
550336,2023-06-14,1008,Makeup Remover,80,160,80,1,00005,India
674882,2023-06-15,1007,Eyeshadow,200,400,200,1,00098,India
452724,2023-06-15,1008,Makeup Remover,80,160,80,1,00039,India
452724,2023-06-15,1006,Blush,150,300,150,1,00039,India
452724,2023-06-15,1012,Body Lotion,200,400,200,1,00039,India
452724,2023-06-15,1007,Eyeshadow,200,400,200,1,00039,India
390169,2023-06-15,1012,Body Lotion,200,400,200,1,00075,India
390169,2023-06-15,1002,Mascara,200,400,200,1,00075,India
286689,2023-06-15,1012,Body Lotion,200,400,200,1,00410,India
585620,2023-06-15,1005,Nail Polish,50,100,50,1,00308,India
585620,2023-06-15,1006,Blush,150,300,150,1,00308,India
585620,2023-06-15,1007,Eyeshadow,200,400,200,1,00308,India
585620,2023-06-15,1009,Moisturizer,250,500,250,1,00308,India
585620,2023-06-15,1012,Body Lotion,200,400,200,1,00308,India
606356,2023-06-15,1002,Mascara,200,400,200,1,00005,India
606356,2023-06-15,1004,Eyeliner,100,200,100,1,00005,India
606356,2023-06-15,1006,Blush,150,300,150,1,00005,India
931903,2023-06-15,1005,Nail Polish,50,100,50,1,00477,India
931903,2023-06-15,1006,Blush,150,300,150,1,00477,India
931903,2023-06-15,1002,Mascara,200,400,200,1,00477,India
931903,2023-06-15,1007,Eyeshadow,200,400,200,1,00477,India
207362,2023-06-15,1012,Body Lotion,200,400,200,1,00342,India
207362,2023-06-15,1006,Blush,150,300,150,1,00342,India
207362,2023-06-15,1002,Mascara,200,400,200,1,00342,India
207362,2023-06-15,1005,Nail Polish,50,100,50,1,00342,India
207362,2023-06-15,1001,Lipstick,150,300,150,1,00342,India
889526,2023-06-15,1005,Nail Polish,50,100,50,1,00330,India
889526,2023-06-15,1008,Makeup Remover,80,160,80,1,00330,India
889526,2023-06-15,1006,Blush,150,300,150,1,00330,India
889526,2023-06-15,1007,Eyeshadow,200,400,200,1,00330,India
685836,2023-06-15,1008,Makeup Remover,80,160,80,1,00120,India
685836,2023-06-15,1009,Moisturizer,250,500,250,1,00120,India
401986,2023-06-15,1001,Lipstick,150,300,150,1,00075,India
401986,2023-06-15,1004,Eyeliner,100,200,100,1,00075,India
401986,2023-06-15,1009,Moisturizer,250,500,250,1,00075,India
659549,2023-06-15,1001,Lipstick,150,300,150,1,00110,India
659549,2023-06-15,1006,Blush,150,300,150,1,00110,India
659549,2023-06-15,1002,Mascara,200,400,200,1,00110,India
659549,2023-06-15,1007,Eyeshadow,200,400,200,1,00110,India
224303,2023-06-15,1001,Lipstick,150,300,150,1,00049,India
224303,2023-06-15,1003,Foundation,300,600,300,1,00049,India
224303,2023-06-15,1005,Nail Polish,50,100,50,1,00049,India
224303,2023-06-15,1012,Body Lotion,200,400,200,1,00049,India
940341,2023-06-15,1007,Eyeshadow,200,400,200,1,00170,India
940341,2023-06-15,1004,Eyeliner,100,200,100,1,00170,India
940341,2023-06-15,1008,Makeup Remover,80,160,80,1,00170,India
940341,2023-06-15,1012,Body Lotion,200,400,200,1,00170,India
940341,2023-06-15,1005,Nail Polish,50,100,50,1,00170,India
684359,2023-06-15,1005,Nail Polish,50,100,50,1,00396,India
684359,2023-06-15,1008,Makeup Remover,80,160,80,1,00396,India
684359,2023-06-15,1007,Eyeshadow,200,400,200,1,00396,India
684359,2023-06-15,1004,Eyeliner,100,200,100,1,00396,India
398781,2023-06-15,1007,Eyeshadow,200,400,200,1,00017,India
492066,2023-06-15,1001,Lipstick,150,300,150,1,00362,India
663060,2023-06-15,1003,Foundation,300,600,300,1,00400,India
663060,2023-06-15,1009,Moisturizer,250,500,250,1,00400,India
663060,2023-06-15,1001,Lipstick,150,300,150,1,00400,India
663060,2023-06-15,1005,Nail Polish,50,100,50,1,00400,India
953138,2023-06-15,1007,Eyeshadow,200,400,200,1,00130,India
141546,2023-06-15,1002,Mascara,200,400,200,1,00200,India
141546,2023-06-15,1001,Lipstick,150,300,150,1,00200,India
141546,2023-06-15,1008,Makeup Remover,80,160,80,1,00200,India
141546,2023-06-15,1005,Nail Polish,50,100,50,1,00200,India
447374,2023-06-15,1009,Moisturizer,250,500,250,1,00175,India
447374,2023-06-15,1002,Mascara,200,400,200,1,00175,India
447374,2023-06-15,1007,Eyeshadow,200,400,200,1,00175,India
447374,2023-06-15,1008,Makeup Remover,80,160,80,1,00175,India
387845,2023-06-15,1001,Lipstick,150,300,150,1,00125,India
387845,2023-06-15,1005,Nail Polish,50,100,50,1,00125,India
387845,2023-06-15,1012,Body Lotion,200,400,200,1,00125,India
880189,2023-06-15,1003,Foundation,300,600,300,1,00042,India
533180,2023-06-15,1005,Nail Polish,50,100,50,1,00100,India
271302,2023-06-15,1003,Foundation,300,600,300,1,00470,India
271302,2023-06-15,1009,Moisturizer,250,500,250,1,00470,India
271302,2023-06-15,1007,Eyeshadow,200,400,200,1,00470,India
170344,2023-06-15,1007,Eyeshadow,200,400,200,1,00351,India
800371,2023-06-15,1001,Lipstick,150,300,150,1,00061,India
800371,2023-06-15,1005,Nail Polish,50,100,50,1,00061,India
856994,2023-06-15,1004,Eyeliner,100,200,100,1,00164,India
856994,2023-06-15,1008,Makeup Remover,80,160,80,1,00164,India
856994,2023-06-15,1002,Mascara,200,400,200,1,00164,India
401301,2023-06-15,1004,Eyeliner,100,200,100,1,00495,India
401301,2023-06-15,1006,Blush,150,300,150,1,00495,India
401301,2023-06-15,1003,Foundation,300,600,300,1,00495,India
195693,2023-06-15,1005,Nail Polish,50,100,50,1,00474,India
195693,2023-06-15,1009,Moisturizer,250,500,250,1,00474,India
195693,2023-06-15,1003,Foundation,300,600,300,1,00474,India
163499,2023-06-15,1002,Mascara,200,400,200,1,00094,India
163499,2023-06-15,1004,Eyeliner,100,200,100,1,00094,India
163499,2023-06-15,1012,Body Lotion,200,400,200,1,00094,India
163499,2023-06-15,1008,Makeup Remover,80,160,80,1,00094,India
742928,2023-06-15,1003,Foundation,300,600,300,1,00434,India
742928,2023-06-15,1004,Eyeliner,100,200,100,1,00434,India
742928,2023-06-15,1009,Moisturizer,250,500,250,1,00434,India
742928,2023-06-15,1007,Eyeshadow,200,400,200,1,00434,India
567606,2023-06-15,1005,Nail Polish,50,100,50,1,00290,India
567606,2023-06-15,1004,Eyeliner,100,200,100,1,00290,India
567606,2023-06-15,1009,Moisturizer,250,500,250,1,00290,India
299642,2023-06-15,1001,Lipstick,150,300,150,1,00165,India
649665,2023-06-15,1007,Eyeshadow,200,400,200,1,00289,India
649665,2023-06-15,1002,Mascara,200,400,200,1,00289,India
649665,2023-06-15,1009,Moisturizer,250,500,250,1,00289,India
471247,2023-06-15,1008,Makeup Remover,80,160,80,1,00376,India
471247,2023-06-15,1007,Eyeshadow,200,400,200,1,00376,India
471247,2023-06-15,1006,Blush,150,300,150,1,00376,India
471247,2023-06-15,1012,Body Lotion,200,400,200,1,00376,India
464064,2023-06-15,1001,Lipstick,150,300,150,1,00393,India
464064,2023-06-15,1009,Moisturizer,250,500,250,1,00393,India
464064,2023-06-15,1008,Makeup Remover,80,160,80,1,00393,India
464064,2023-06-15,1002,Mascara,200,400,200,1,00393,India
464064,2023-06-15,1005,Nail Polish,50,100,50,1,00393,India
120595,2023-06-15,1004,Eyeliner,100,200,100,1,00429,India
120595,2023-06-15,1005,Nail Polish,50,100,50,1,00429,India
120595,2023-06-15,1006,Blush,150,300,150,1,00429,India
664848,2023-06-16,1003,Foundation,300,600,300,1,00045,India
890364,2023-06-16,1012,Body Lotion,200,400,200,1,00190,India
890364,2023-06-16,1008,Makeup Remover,80,160,80,1,00190,India
890364,2023-06-16,1009,Moisturizer,250,500,250,1,00190,India
500747,2023-06-16,1006,Blush,150,300,150,1,00379,India
500747,2023-06-16,1001,Lipstick,150,300,150,1,00379,India
131958,2023-06-16,1012,Body Lotion,200,400,200,1,00058,India
131958,2023-06-16,1006,Blush,150,300,150,1,00058,India
131958,2023-06-16,1005,Nail Polish,50,100,50,1,00058,India
404255,2023-06-16,1004,Eyeliner,100,200,100,1,00186,India
404255,2023-06-16,1005,Nail Polish,50,100,50,1,00186,India
404255,2023-06-16,1002,Mascara,200,400,200,1,00186,India
348455,2023-06-16,1009,Moisturizer,250,500,250,1,00006,India
348455,2023-06-16,1001,Lipstick,150,300,150,1,00006,India
348455,2023-06-16,1003,Foundation,300,600,300,1,00006,India
602312,2023-06-16,1009,Moisturizer,250,500,250,1,00408,India
602312,2023-06-16,1008,Makeup Remover,80,160,80,1,00408,India
403381,2023-06-16,1004,Eyeliner,100,200,100,1,00348,India
403381,2023-06-16,1007,Eyeshadow,200,400,200,1,00348,India
125962,2023-06-16,1012,Body Lotion,200,400,200,1,00289,India
125962,2023-06-16,1003,Foundation,300,600,300,1,00289,India
125962,2023-06-16,1008,Makeup Remover,80,160,80,1,00289,India
125962,2023-06-16,1005,Nail Polish,50,100,50,1,00289,India
857435,2023-06-16,1004,Eyeliner,100,200,100,1,00471,India
857435,2023-06-16,1007,Eyeshadow,200,400,200,1,00471,India
638483,2023-06-16,1012,Body Lotion,200,400,200,1,00092,India
638483,2023-06-16,1004,Eyeliner,100,200,100,1,00092,India
638483,2023-06-16,1006,Blush,150,300,150,1,00092,India
936997,2023-06-16,1007,Eyeshadow,200,400,200,1,00372,India
936997,2023-06-16,1006,Blush,150,300,150,1,00372,India
936997,2023-06-16,1008,Makeup Remover,80,160,80,1,00372,India
606781,2023-06-16,1006,Blush,150,300,150,1,00382,India
703524,2023-06-16,1003,Foundation,300,600,300,1,00027,India
558107,2023-06-16,1007,Eyeshadow,200,400,200,1,00018,India
558107,2023-06-16,1006,Blush,150,300,150,1,00018,India
558107,2023-06-16,1012,Body Lotion,200,400,200,1,00018,India
229815,2023-06-16,1002,Mascara,200,400,200,1,00253,India
229815,2023-06-16,1003,Foundation,300,600,300,1,00253,India
229815,2023-06-16,1004,Eyeliner,100,200,100,1,00253,India
782347,2023-06-16,1012,Body Lotion,200,400,200,1,00377,India
782347,2023-06-16,1001,Lipstick,150,300,150,1,00377,India
782347,2023-06-16,1006,Blush,150,300,150,1,00377,India
782347,2023-06-16,1009,Moisturizer,250,500,250,1,00377,India
782347,2023-06-16,1005,Nail Polish,50,100,50,1,00377,India
319290,2023-06-16,1005,Nail Polish,50,100,50,1,00266,India
319290,2023-06-16,1002,Mascara,200,400,200,1,00266,India
319290,2023-06-16,1001,Lipstick,150,300,150,1,00266,India
319290,2023-06-16,1003,Foundation,300,600,300,1,00266,India
127167,2023-06-16,1009,Moisturizer,250,500,250,1,00477,India
127167,2023-06-16,1005,Nail Polish,50,100,50,1,00477,India
967872,2023-06-16,1004,Eyeliner,100,200,100,1,00075,India
967872,2023-06-16,1002,Mascara,200,400,200,1,00075,India
178764,2023-06-16,1003,Foundation,300,600,300,1,00479,India
178764,2023-06-16,1008,Makeup Remover,80,160,80,1,00479,India
178764,2023-06-16,1009,Moisturizer,250,500,250,1,00479,India
178764,2023-06-16,1004,Eyeliner,100,200,100,1,00479,India
237280,2023-06-16,1007,Eyeshadow,200,400,200,1,00487,India
237280,2023-06-16,1008,Makeup Remover,80,160,80,1,00487,India
237280,2023-06-16,1005,Nail Polish,50,100,50,1,00487,India
237280,2023-06-16,1001,Lipstick,150,300,150,1,00487,India
237280,2023-06-16,1002,Mascara,200,400,200,1,00487,India
779084,2023-06-16,1012,Body Lotion,200,400,200,1,00142,India
498957,2023-06-16,1001,Lipstick,150,300,150,1,00126,India
312285,2023-06-16,1005,Nail Polish,50,100,50,1,00301,India
115374,2023-06-16,1007,Eyeshadow,200,400,200,1,00416,India
115374,2023-06-16,1003,Foundation,300,600,300,1,00416,India
633261,2023-06-16,1005,Nail Polish,50,100,50,1,00127,India
633261,2023-06-16,1002,Mascara,200,400,200,1,00127,India
832216,2023-06-16,1007,Eyeshadow,200,400,200,1,00328,India
478148,2023-06-16,1003,Foundation,300,600,300,1,00476,India
478148,2023-06-16,1006,Blush,150,300,150,1,00476,India
478148,2023-06-16,1008,Makeup Remover,80,160,80,1,00476,India
767949,2023-06-16,1005,Nail Polish,50,100,50,1,00483,India
767949,2023-06-16,1003,Foundation,300,600,300,1,00483,India
438599,2023-06-16,1004,Eyeliner,100,200,100,1,00341,India
438599,2023-06-16,1008,Makeup Remover,80,160,80,1,00341,India
776651,2023-06-16,1006,Blush,150,300,150,1,00435,India
776651,2023-06-16,1008,Makeup Remover,80,160,80,1,00435,India
776651,2023-06-16,1002,Mascara,200,400,200,1,00435,India
784535,2023-06-16,1012,Body Lotion,200,400,200,1,00339,India
784535,2023-06-16,1004,Eyeliner,100,200,100,1,00339,India
358885,2023-06-16,1008,Makeup Remover,80,160,80,1,00031,India
358885,2023-06-16,1007,Eyeshadow,200,400,200,1,00031,India
773929,2023-06-16,1001,Lipstick,150,300,150,1,00225,India
773929,2023-06-16,1002,Mascara,200,400,200,1,00225,India
389355,2023-06-16,1006,Blush,150,300,150,1,00190,India
389355,2023-06-16,1004,Eyeliner,100,200,100,1,00190,India
389355,2023-06-16,1003,Foundation,300,600,300,1,00190,India
907239,2023-06-17,1004,Eyeliner,100,200,100,1,00469,India
907239,2023-06-17,1008,Makeup Remover,80,160,80,1,00469,India
939139,2023-06-17,1009,Moisturizer,250,500,250,1,00044,India
939139,2023-06-17,1003,Foundation,300,600,300,1,00044,India
939139,2023-06-17,1002,Mascara,200,400,200,1,00044,India
788580,2023-06-17,1005,Nail Polish,50,100,50,1,00434,India
788580,2023-06-17,1006,Blush,150,300,150,1,00434,India
600016,2023-06-17,1007,Eyeshadow,200,400,200,1,00153,India
600016,2023-06-17,1009,Moisturizer,250,500,250,1,00153,India
600016,2023-06-17,1001,Lipstick,150,300,150,1,00153,India
804150,2023-06-17,1006,Blush,150,300,150,1,00188,India
804150,2023-06-17,1007,Eyeshadow,200,400,200,1,00188,India
804150,2023-06-17,1009,Moisturizer,250,500,250,1,00188,India
909372,2023-06-17,1008,Makeup Remover,80,160,80,1,00346,India
513494,2023-06-17,1001,Lipstick,150,300,150,1,00041,India
513494,2023-06-17,1007,Eyeshadow,200,400,200,1,00041,India
150130,2023-06-17,1004,Eyeliner,100,200,100,1,00088,India
150130,2023-06-17,1008,Makeup Remover,80,160,80,1,00088,India
345569,2023-06-17,1009,Moisturizer,250,500,250,1,00231,India
345569,2023-06-17,1006,Blush,150,300,150,1,00231,India
345569,2023-06-17,1001,Lipstick,150,300,150,1,00231,India
611605,2023-06-17,1002,Mascara,200,400,200,1,00313,India
560110,2023-06-17,1008,Makeup Remover,80,160,80,1,00307,India
560110,2023-06-17,1005,Nail Polish,50,100,50,1,00307,India
560110,2023-06-17,1001,Lipstick,150,300,150,1,00307,India
569701,2023-06-17,1009,Moisturizer,250,500,250,1,00280,India
569701,2023-06-17,1004,Eyeliner,100,200,100,1,00280,India
363974,2023-06-17,1004,Eyeliner,100,200,100,1,00445,India
363974,2023-06-17,1002,Mascara,200,400,200,1,00445,India
251313,2023-06-17,1007,Eyeshadow,200,400,200,1,00245,India
251313,2023-06-17,1005,Nail Polish,50,100,50,1,00245,India
251313,2023-06-17,1002,Mascara,200,400,200,1,00245,India
251313,2023-06-17,1006,Blush,150,300,150,1,00245,India
965124,2023-06-17,1007,Eyeshadow,200,400,200,1,00428,India
965124,2023-06-17,1006,Blush,150,300,150,1,00428,India
965124,2023-06-17,1004,Eyeliner,100,200,100,1,00428,India
540113,2023-06-17,1012,Body Lotion,200,400,200,1,00334,India
540113,2023-06-17,1004,Eyeliner,100,200,100,1,00334,India
540113,2023-06-17,1003,Foundation,300,600,300,1,00334,India
540113,2023-06-17,1009,Moisturizer,250,500,250,1,00334,India
540113,2023-06-17,1006,Blush,150,300,150,1,00334,India
950585,2023-06-17,1012,Body Lotion,200,400,200,1,00441,India
527816,2023-06-17,1005,Nail Polish,50,100,50,1,00072,India
527816,2023-06-17,1004,Eyeliner,100,200,100,1,00072,India
527816,2023-06-17,1003,Foundation,300,600,300,1,00072,India
634917,2023-06-17,1001,Lipstick,150,300,150,1,00022,India
634917,2023-06-17,1005,Nail Polish,50,100,50,1,00022,India
407066,2023-06-17,1005,Nail Polish,50,100,50,1,00477,India
407066,2023-06-17,1006,Blush,150,300,150,1,00477,India
407066,2023-06-17,1001,Lipstick,150,300,150,1,00477,India
407066,2023-06-17,1009,Moisturizer,250,500,250,1,00477,India
304429,2023-06-17,1009,Moisturizer,250,500,250,1,00320,India
302460,2023-06-17,1007,Eyeshadow,200,400,200,1,00323,India
302460,2023-06-17,1003,Foundation,300,600,300,1,00323,India
256930,2023-06-17,1004,Eyeliner,100,200,100,1,00089,India
256930,2023-06-17,1001,Lipstick,150,300,150,1,00089,India
619793,2023-06-17,1001,Lipstick,150,300,150,1,00052,India
619793,2023-06-17,1008,Makeup Remover,80,160,80,1,00052,India
619793,2023-06-17,1002,Mascara,200,400,200,1,00052,India
471624,2023-06-17,1002,Mascara,200,400,200,1,00228,India
471624,2023-06-17,1007,Eyeshadow,200,400,200,1,00228,India
471624,2023-06-17,1008,Makeup Remover,80,160,80,1,00228,India
195672,2023-06-17,1012,Body Lotion,200,400,200,1,00392,India
195672,2023-06-17,1007,Eyeshadow,200,400,200,1,00392,India
811441,2023-06-17,1001,Lipstick,150,300,150,1,00408,India
811441,2023-06-17,1009,Moisturizer,250,500,250,1,00408,India
811441,2023-06-17,1008,Makeup Remover,80,160,80,1,00408,India
811441,2023-06-17,1002,Mascara,200,400,200,1,00408,India
811441,2023-06-17,1012,Body Lotion,200,400,200,1,00408,India
924240,2023-06-17,1001,Lipstick,150,300,150,1,00275,India
924240,2023-06-17,1005,Nail Polish,50,100,50,1,00275,India
924240,2023-06-17,1009,Moisturizer,250,500,250,1,00275,India
426610,2023-06-17,1004,Eyeliner,100,200,100,1,00460,India
426610,2023-06-17,1012,Body Lotion,200,400,200,1,00460,India
426610,2023-06-17,1003,Foundation,300,600,300,1,00460,India
426610,2023-06-17,1005,Nail Polish,50,100,50,1,00460,India
426610,2023-06-17,1006,Blush,150,300,150,1,00460,India
567407,2023-06-17,1003,Foundation,300,600,300,1,00361,India
567407,2023-06-17,1008,Makeup Remover,80,160,80,1,00361,India
567407,2023-06-17,1002,Mascara,200,400,200,1,00361,India
567407,2023-06-17,1001,Lipstick,150,300,150,1,00361,India
567407,2023-06-17,1007,Eyeshadow,200,400,200,1,00361,India
239797,2023-06-17,1003,Foundation,300,600,300,1,00114,India
239797,2023-06-17,1012,Body Lotion,200,400,200,1,00114,India
239797,2023-06-17,1001,Lipstick,150,300,150,1,00114,India
239797,2023-06-17,1002,Mascara,200,400,200,1,00114,India
784185,2023-06-17,1002,Mascara,200,400,200,1,00275,India
784185,2023-06-17,1001,Lipstick,150,300,150,1,00275,India
784185,2023-06-17,1006,Blush,150,300,150,1,00275,India
784185,2023-06-17,1003,Foundation,300,600,300,1,00275,India
579718,2023-06-17,1003,Foundation,300,600,300,1,00338,India
579718,2023-06-17,1008,Makeup Remover,80,160,80,1,00338,India
579718,2023-06-17,1012,Body Lotion,200,400,200,1,00338,India
579718,2023-06-17,1001,Lipstick,150,300,150,1,00338,India
579718,2023-06-17,1007,Eyeshadow,200,400,200,1,00338,India
862745,2023-06-17,1005,Nail Polish,50,100,50,1,00430,India
862745,2023-06-17,1004,Eyeliner,100,200,100,1,00430,India
862745,2023-06-17,1008,Makeup Remover,80,160,80,1,00430,India
862745,2023-06-17,1009,Moisturizer,250,500,250,1,00430,India
339114,2023-06-17,1005,Nail Polish,50,100,50,1,00195,India
339114,2023-06-17,1002,Mascara,200,400,200,1,00195,India
339114,2023-06-17,1004,Eyeliner,100,200,100,1,00195,India
339114,2023-06-17,1009,Moisturizer,250,500,250,1,00195,India
554539,2023-06-17,1008,Makeup Remover,80,160,80,1,00178,India
554539,2023-06-17,1001,Lipstick,150,300,150,1,00178,India
554539,2023-06-17,1004,Eyeliner,100,200,100,1,00178,India
382279,2023-06-17,1004,Eyeliner,100,200,100,1,00317,India
382279,2023-06-17,1005,Nail Polish,50,100,50,1,00317,India
382279,2023-06-17,1009,Moisturizer,250,500,250,1,00317,India
821241,2023-06-18,1008,Makeup Remover,80,160,80,1,00170,India
821241,2023-06-18,1007,Eyeshadow,200,400,200,1,00170,India
965629,2023-06-18,1003,Foundation,300,600,300,1,00329,India
565861,2023-06-18,1005,Nail Polish,50,100,50,1,00032,India
565861,2023-06-18,1003,Foundation,300,600,300,1,00032,India
565861,2023-06-18,1001,Lipstick,150,300,150,1,00032,India
565861,2023-06-18,1004,Eyeliner,100,200,100,1,00032,India
510547,2023-06-18,1006,Blush,150,300,150,1,00286,India
510547,2023-06-18,1012,Body Lotion,200,400,200,1,00286,India
510547,2023-06-18,1001,Lipstick,150,300,150,1,00286,India
510547,2023-06-18,1009,Moisturizer,250,500,250,1,00286,India
964850,2023-06-18,1007,Eyeshadow,200,400,200,1,00401,India
964850,2023-06-18,1009,Moisturizer,250,500,250,1,00401,India
964850,2023-06-18,1006,Blush,150,300,150,1,00401,India
964850,2023-06-18,1012,Body Lotion,200,400,200,1,00401,India
701758,2023-06-18,1012,Body Lotion,200,400,200,1,00469,India
432147,2023-06-18,1008,Makeup Remover,80,160,80,1,00312,India
432147,2023-06-18,1009,Moisturizer,250,500,250,1,00312,India
777752,2023-06-18,1001,Lipstick,150,300,150,1,00005,India
777752,2023-06-18,1008,Makeup Remover,80,160,80,1,00005,India
644182,2023-06-18,1003,Foundation,300,600,300,1,00199,India
644182,2023-06-18,1009,Moisturizer,250,500,250,1,00199,India
644182,2023-06-18,1005,Nail Polish,50,100,50,1,00199,India
446752,2023-06-18,1004,Eyeliner,100,200,100,1,00154,India
446752,2023-06-18,1005,Nail Polish,50,100,50,1,00154,India
446752,2023-06-18,1008,Makeup Remover,80,160,80,1,00154,India
991261,2023-06-18,1001,Lipstick,150,300,150,1,00418,India
313575,2023-06-18,1008,Makeup Remover,80,160,80,1,00441,India
313575,2023-06-18,1001,Lipstick,150,300,150,1,00441,India
483834,2023-06-18,1002,Mascara,200,400,200,1,00450,India
483834,2023-06-18,1001,Lipstick,150,300,150,1,00450,India
483834,2023-06-18,1007,Eyeshadow,200,400,200,1,00450,India
608921,2023-06-18,1003,Foundation,300,600,300,1,00103,India
608921,2023-06-18,1004,Eyeliner,100,200,100,1,00103,India
608921,2023-06-18,1008,Makeup Remover,80,160,80,1,00103,India
608921,2023-06-18,1007,Eyeshadow,200,400,200,1,00103,India
677188,2023-06-18,1005,Nail Polish,50,100,50,1,00006,India
939656,2023-06-18,1006,Blush,150,300,150,1,00312,India
939656,2023-06-18,1005,Nail Polish,50,100,50,1,00312,India
939656,2023-06-18,1009,Moisturizer,250,500,250,1,00312,India
462185,2023-06-18,1006,Blush,150,300,150,1,00302,India
462185,2023-06-18,1005,Nail Polish,50,100,50,1,00302,India
462185,2023-06-18,1004,Eyeliner,100,200,100,1,00302,India
462185,2023-06-18,1007,Eyeshadow,200,400,200,1,00302,India
196699,2023-06-18,1007,Eyeshadow,200,400,200,1,00488,India
196699,2023-06-18,1006,Blush,150,300,150,1,00488,India
196699,2023-06-18,1012,Body Lotion,200,400,200,1,00488,India
705596,2023-06-18,1007,Eyeshadow,200,400,200,1,00324,India
378689,2023-06-18,1001,Lipstick,150,300,150,1,00305,India
378689,2023-06-18,1006,Blush,150,300,150,1,00305,India
378689,2023-06-18,1008,Makeup Remover,80,160,80,1,00305,India
662314,2023-06-18,1002,Mascara,200,400,200,1,00266,India
662314,2023-06-18,1009,Moisturizer,250,500,250,1,00266,India
139027,2023-06-18,1008,Makeup Remover,80,160,80,1,00431,India
139027,2023-06-18,1009,Moisturizer,250,500,250,1,00431,India
306990,2023-06-18,1012,Body Lotion,200,400,200,1,00199,India
306990,2023-06-18,1004,Eyeliner,100,200,100,1,00199,India
321325,2023-06-18,1012,Body Lotion,200,400,200,1,00095,India
627946,2023-06-18,1003,Foundation,300,600,300,1,00100,India
627946,2023-06-18,1012,Body Lotion,200,400,200,1,00100,India
627946,2023-06-18,1004,Eyeliner,100,200,100,1,00100,India
627946,2023-06-18,1005,Nail Polish,50,100,50,1,00100,India
734606,2023-06-18,1005,Nail Polish,50,100,50,1,00017,India
734606,2023-06-18,1004,Eyeliner,100,200,100,1,00017,India
734606,2023-06-18,1009,Moisturizer,250,500,250,1,00017,India
911891,2023-06-18,1005,Nail Polish,50,100,50,1,00488,India
911891,2023-06-18,1001,Lipstick,150,300,150,1,00488,India
911891,2023-06-18,1007,Eyeshadow,200,400,200,1,00488,India
911891,2023-06-18,1008,Makeup Remover,80,160,80,1,00488,India
642340,2023-06-18,1003,Foundation,300,600,300,1,00437,India
385057,2023-06-18,1012,Body Lotion,200,400,200,1,00339,India
569689,2023-06-18,1002,Mascara,200,400,200,1,00408,India
569689,2023-06-18,1007,Eyeshadow,200,400,200,1,00408,India
569689,2023-06-18,1005,Nail Polish,50,100,50,1,00408,India
569689,2023-06-18,1004,Eyeliner,100,200,100,1,00408,India
964423,2023-06-18,1006,Blush,150,300,150,1,00057,India
964423,2023-06-18,1012,Body Lotion,200,400,200,1,00057,India
964423,2023-06-18,1002,Mascara,200,400,200,1,00057,India
915993,2023-06-18,1008,Makeup Remover,80,160,80,1,00077,India
915993,2023-06-18,1007,Eyeshadow,200,400,200,1,00077,India
915993,2023-06-18,1002,Mascara,200,400,200,1,00077,India
915993,2023-06-18,1006,Blush,150,300,150,1,00077,India
804352,2023-06-18,1009,Moisturizer,250,500,250,1,00099,India
396738,2023-06-18,1001,Lipstick,150,300,150,1,00004,India
396738,2023-06-18,1002,Mascara,200,400,200,1,00004,India
396738,2023-06-18,1003,Foundation,300,600,300,1,00004,India
854090,2023-06-18,1004,Eyeliner,100,200,100,1,00049,India
854090,2023-06-18,1003,Foundation,300,600,300,1,00049,India
854090,2023-06-18,1009,Moisturizer,250,500,250,1,00049,India
854090,2023-06-18,1008,Makeup Remover,80,160,80,1,00049,India
183815,2023-06-18,1004,Eyeliner,100,200,100,1,00350,India
814285,2023-06-18,1004,Eyeliner,100,200,100,1,00194,India
814285,2023-06-18,1006,Blush,150,300,150,1,00194,India
814285,2023-06-18,1007,Eyeshadow,200,400,200,1,00194,India
848632,2023-06-18,1005,Nail Polish,50,100,50,1,00394,India
848632,2023-06-18,1002,Mascara,200,400,200,1,00394,India
848632,2023-06-18,1006,Blush,150,300,150,1,00394,India
848632,2023-06-18,1001,Lipstick,150,300,150,1,00394,India
469907,2023-06-18,1007,Eyeshadow,200,400,200,1,00280,India
927088,2023-06-19,1001,Lipstick,150,300,150,1,00396,India
210273,2023-06-19,1006,Blush,150,300,150,1,00482,India
210273,2023-06-19,1002,Mascara,200,400,200,1,00482,India
845070,2023-06-19,1002,Mascara,200,400,200,1,00482,India
845070,2023-06-19,1005,Nail Polish,50,100,50,1,00482,India
747039,2023-06-19,1003,Foundation,300,600,300,1,00400,India
747039,2023-06-19,1009,Moisturizer,250,500,250,1,00400,India
747039,2023-06-19,1004,Eyeliner,100,200,100,1,00400,India
390886,2023-06-19,1012,Body Lotion,200,400,200,1,00297,India
390886,2023-06-19,1001,Lipstick,150,300,150,1,00297,India
368402,2023-06-19,1004,Eyeliner,100,200,100,1,00114,India
705392,2023-06-19,1001,Lipstick,150,300,150,1,00378,India
860863,2023-06-19,1009,Moisturizer,250,500,250,1,00439,India
860863,2023-06-19,1003,Foundation,300,600,300,1,00439,India
860863,2023-06-19,1007,Eyeshadow,200,400,200,1,00439,India
710917,2023-06-19,1003,Foundation,300,600,300,1,00499,India
710917,2023-06-19,1001,Lipstick,150,300,150,1,00499,India
710917,2023-06-19,1004,Eyeliner,100,200,100,1,00499,India
710917,2023-06-19,1006,Blush,150,300,150,1,00499,India
676134,2023-06-19,1002,Mascara,200,400,200,1,00363,India
676134,2023-06-19,1012,Body Lotion,200,400,200,1,00363,India
911851,2023-06-19,1002,Mascara,200,400,200,1,00107,India
690144,2023-06-19,1007,Eyeshadow,200,400,200,1,00309,India
690144,2023-06-19,1004,Eyeliner,100,200,100,1,00309,India
690144,2023-06-19,1003,Foundation,300,600,300,1,00309,India
690144,2023-06-19,1001,Lipstick,150,300,150,1,00309,India
867089,2023-06-19,1003,Foundation,300,600,300,1,00458,India
867089,2023-06-19,1002,Mascara,200,400,200,1,00458,India
867089,2023-06-19,1009,Moisturizer,250,500,250,1,00458,India
867089,2023-06-19,1012,Body Lotion,200,400,200,1,00458,India
571935,2023-06-19,1006,Blush,150,300,150,1,00297,India
571935,2023-06-19,1002,Mascara,200,400,200,1,00297,India
571935,2023-06-19,1003,Foundation,300,600,300,1,00297,India
721179,2023-06-19,1005,Nail Polish,50,100,50,1,00386,India
721179,2023-06-19,1012,Body Lotion,200,400,200,1,00386,India
721179,2023-06-19,1002,Mascara,200,400,200,1,00386,India
899217,2023-06-19,1008,Makeup Remover,80,160,80,1,00135,India
899217,2023-06-19,1006,Blush,150,300,150,1,00135,India
899217,2023-06-19,1004,Eyeliner,100,200,100,1,00135,India
415832,2023-06-19,1005,Nail Polish,50,100,50,1,00307,India
415832,2023-06-19,1004,Eyeliner,100,200,100,1,00307,India
415832,2023-06-19,1001,Lipstick,150,300,150,1,00307,India
642340,2023-06-19,1009,Moisturizer,250,500,250,1,00437,India
296150,2023-06-19,1008,Makeup Remover,80,160,80,1,00319,India
296150,2023-06-19,1009,Moisturizer,250,500,250,1,00319,India
296150,2023-06-19,1006,Blush,150,300,150,1,00319,India
973696,2023-06-19,1005,Nail Polish,50,100,50,1,00036,India
973696,2023-06-19,1009,Moisturizer,250,500,250,1,00036,India
973696,2023-06-19,1002,Mascara,200,400,200,1,00036,India
973696,2023-06-19,1012,Body Lotion,200,400,200,1,00036,India
968794,2023-06-19,1009,Moisturizer,250,500,250,1,00127,India
968794,2023-06-19,1006,Blush,150,300,150,1,00127,India
968794,2023-06-19,1008,Makeup Remover,80,160,80,1,00127,India
321982,2023-06-19,1009,Moisturizer,250,500,250,1,00224,India
321982,2023-06-19,1005,Nail Polish,50,100,50,1,00224,India
321982,2023-06-19,1001,Lipstick,150,300,150,1,00224,India
321982,2023-06-19,1006,Blush,150,300,150,1,00224,India
321982,2023-06-19,1004,Eyeliner,100,200,100,1,00224,India
205515,2023-06-19,1001,Lipstick,150,300,150,1,00011,India
205515,2023-06-19,1008,Makeup Remover,80,160,80,1,00011,India
552570,2023-06-19,1002,Mascara,200,400,200,1,00035,India
552570,2023-06-19,1012,Body Lotion,200,400,200,1,00035,India
552570,2023-06-19,1008,Makeup Remover,80,160,80,1,00035,India
552570,2023-06-19,1004,Eyeliner,100,200,100,1,00035,India
995638,2023-06-19,1006,Blush,150,300,150,1,00481,India
995638,2023-06-19,1002,Mascara,200,400,200,1,00481,India
995638,2023-06-19,1008,Makeup Remover,80,160,80,1,00481,India
629286,2023-06-19,1006,Blush,150,300,150,1,00280,India
604708,2023-06-19,1007,Eyeshadow,200,400,200,1,00371,India
604708,2023-06-19,1008,Makeup Remover,80,160,80,1,00371,India
604708,2023-06-19,1001,Lipstick,150,300,150,1,00371,India
604708,2023-06-19,1005,Nail Polish,50,100,50,1,00371,India
374564,2023-06-19,1007,Eyeshadow,200,400,200,1,00485,India
374564,2023-06-19,1008,Makeup Remover,80,160,80,1,00485,India
374564,2023-06-19,1005,Nail Polish,50,100,50,1,00485,India
815552,2023-06-19,1008,Makeup Remover,80,160,80,1,00394,India
815552,2023-06-19,1003,Foundation,300,600,300,1,00394,India
815552,2023-06-19,1012,Body Lotion,200,400,200,1,00394,India
815552,2023-06-19,1009,Moisturizer,250,500,250,1,00394,India
888356,2023-06-19,1005,Nail Polish,50,100,50,1,00408,India
888356,2023-06-19,1008,Makeup Remover,80,160,80,1,00408,India
888356,2023-06-19,1002,Mascara,200,400,200,1,00408,India
888356,2023-06-19,1007,Eyeshadow,200,400,200,1,00408,India
888356,2023-06-19,1004,Eyeliner,100,200,100,1,00408,India
549241,2023-06-19,1007,Eyeshadow,200,400,200,1,00374,India
549241,2023-06-19,1002,Mascara,200,400,200,1,00374,India
942241,2023-06-19,1009,Moisturizer,250,500,250,1,00416,India
498684,2023-06-19,1001,Lipstick,150,300,150,1,00385,India
498684,2023-06-19,1009,Moisturizer,250,500,250,1,00385,India
498684,2023-06-19,1004,Eyeliner,100,200,100,1,00385,India
540451,2023-06-19,1012,Body Lotion,200,400,200,1,00472,India
540451,2023-06-19,1001,Lipstick,150,300,150,1,00472,India
540451,2023-06-19,1005,Nail Polish,50,100,50,1,00472,India
103624,2023-06-20,1008,Makeup Remover,80,160,80,1,00146,India
103624,2023-06-20,1006,Blush,150,300,150,1,00146,India
103624,2023-06-20,1002,Mascara,200,400,200,1,00146,India
257900,2023-06-20,1012,Body Lotion,200,400,200,1,00495,India
186397,2023-06-20,1006,Blush,150,300,150,1,00438,India
186397,2023-06-20,1007,Eyeshadow,200,400,200,1,00438,India
186397,2023-06-20,1003,Foundation,300,600,300,1,00438,India
186397,2023-06-20,1009,Moisturizer,250,500,250,1,00438,India
186397,2023-06-20,1012,Body Lotion,200,400,200,1,00438,India
334659,2023-06-20,1012,Body Lotion,200,400,200,1,00082,India
334659,2023-06-20,1009,Moisturizer,250,500,250,1,00082,India
334659,2023-06-20,1005,Nail Polish,50,100,50,1,00082,India
745050,2023-06-20,1009,Moisturizer,250,500,250,1,00358,India
745050,2023-06-20,1003,Foundation,300,600,300,1,00358,India
694343,2023-06-20,1008,Makeup Remover,80,160,80,1,00492,India
694343,2023-06-20,1007,Eyeshadow,200,400,200,1,00492,India
315061,2023-06-20,1009,Moisturizer,250,500,250,1,00213,India
315061,2023-06-20,1006,Blush,150,300,150,1,00213,India
315061,2023-06-20,1004,Eyeliner,100,200,100,1,00213,India
445196,2023-06-20,1001,Lipstick,150,300,150,1,00120,India
310453,2023-06-20,1004,Eyeliner,100,200,100,1,00060,India
310453,2023-06-20,1001,Lipstick,150,300,150,1,00060,India
146241,2023-06-20,1012,Body Lotion,200,400,200,1,00117,India
146241,2023-06-20,1009,Moisturizer,250,500,250,1,00117,India
146241,2023-06-20,1005,Nail Polish,50,100,50,1,00117,India
276831,2023-06-20,1006,Blush,150,300,150,1,00465,India
276831,2023-06-20,1007,Eyeshadow,200,400,200,1,00465,India
276831,2023-06-20,1001,Lipstick,150,300,150,1,00465,India
708594,2023-06-20,1008,Makeup Remover,80,160,80,1,00341,India
708594,2023-06-20,1009,Moisturizer,250,500,250,1,00341,India
708594,2023-06-20,1001,Lipstick,150,300,150,1,00341,India
373489,2023-06-20,1005,Nail Polish,50,100,50,1,00276,India
373489,2023-06-20,1008,Makeup Remover,80,160,80,1,00276,India
373489,2023-06-20,1006,Blush,150,300,150,1,00276,India
373489,2023-06-20,1002,Mascara,200,400,200,1,00276,India
870263,2023-06-20,1004,Eyeliner,100,200,100,1,00436,India
870263,2023-06-20,1009,Moisturizer,250,500,250,1,00436,India
870263,2023-06-20,1008,Makeup Remover,80,160,80,1,00436,India
870263,2023-06-20,1007,Eyeshadow,200,400,200,1,00436,India
613014,2023-06-20,1012,Body Lotion,200,400,200,1,00032,India
550644,2023-06-20,1006,Blush,150,300,150,1,00331,India
550644,2023-06-20,1004,Eyeliner,100,200,100,1,00331,India
550644,2023-06-20,1003,Foundation,300,600,300,1,00331,India
550644,2023-06-20,1007,Eyeshadow,200,400,200,1,00331,India
932342,2023-06-20,1007,Eyeshadow,200,400,200,1,00162,India
932342,2023-06-20,1008,Makeup Remover,80,160,80,1,00162,India
349106,2023-06-20,1009,Moisturizer,250,500,250,1,00258,India
349106,2023-06-20,1002,Mascara,200,400,200,1,00258,India
349106,2023-06-20,1005,Nail Polish,50,100,50,1,00258,India
349106,2023-06-20,1012,Body Lotion,200,400,200,1,00258,India
185551,2023-06-20,1001,Lipstick,150,300,150,1,00442,India
185551,2023-06-20,1007,Eyeshadow,200,400,200,1,00442,India
185551,2023-06-20,1005,Nail Polish,50,100,50,1,00442,India
185551,2023-06-20,1003,Foundation,300,600,300,1,00442,India
897435,2023-06-20,1004,Eyeliner,100,200,100,1,00106,India
897435,2023-06-20,1008,Makeup Remover,80,160,80,1,00106,India
897435,2023-06-20,1005,Nail Polish,50,100,50,1,00106,India
897435,2023-06-20,1002,Mascara,200,400,200,1,00106,India
730610,2023-06-20,1002,Mascara,200,400,200,1,00338,India
730610,2023-06-20,1004,Eyeliner,100,200,100,1,00338,India
730610,2023-06-20,1003,Foundation,300,600,300,1,00338,India
576946,2023-06-20,1012,Body Lotion,200,400,200,1,00115,India
576946,2023-06-20,1007,Eyeshadow,200,400,200,1,00115,India
840874,2023-06-20,1002,Mascara,200,400,200,1,00149,India
840874,2023-06-20,1003,Foundation,300,600,300,1,00149,India
840874,2023-06-20,1006,Blush,150,300,150,1,00149,India
840874,2023-06-20,1008,Makeup Remover,80,160,80,1,00149,India
474338,2023-06-20,1012,Body Lotion,200,400,200,1,00063,India
474338,2023-06-20,1009,Moisturizer,250,500,250,1,00063,India
332556,2023-06-20,1009,Moisturizer,250,500,250,1,00066,India
332556,2023-06-20,1008,Makeup Remover,80,160,80,1,00066,India
332556,2023-06-20,1012,Body Lotion,200,400,200,1,00066,India
332556,2023-06-20,1005,Nail Polish,50,100,50,1,00066,India
332556,2023-06-20,1006,Blush,150,300,150,1,00066,India
260336,2023-06-20,1006,Blush,150,300,150,1,00278,India
260336,2023-06-20,1012,Body Lotion,200,400,200,1,00278,India
260336,2023-06-20,1005,Nail Polish,50,100,50,1,00278,India
214698,2023-06-20,1007,Eyeshadow,200,400,200,1,00292,India
147816,2023-06-20,1002,Mascara,200,400,200,1,00077,India
147816,2023-06-20,1001,Lipstick,150,300,150,1,00077,India
147816,2023-06-20,1005,Nail Polish,50,100,50,1,00077,India
508909,2023-06-20,1006,Blush,150,300,150,1,00360,India
508909,2023-06-20,1007,Eyeshadow,200,400,200,1,00360,India
508909,2023-06-20,1005,Nail Polish,50,100,50,1,00360,India
398309,2023-06-20,1004,Eyeliner,100,200,100,1,00047,India
398309,2023-06-20,1012,Body Lotion,200,400,200,1,00047,India
398309,2023-06-20,1008,Makeup Remover,80,160,80,1,00047,India
985467,2023-06-20,1007,Eyeshadow,200,400,200,1,00033,India
985467,2023-06-20,1003,Foundation,300,600,300,1,00033,India
541024,2023-06-20,1003,Foundation,300,600,300,1,00221,India
541024,2023-06-20,1008,Makeup Remover,80,160,80,1,00221,India
541024,2023-06-20,1005,Nail Polish,50,100,50,1,00221,India
541024,2023-06-20,1007,Eyeshadow,200,400,200,1,00221,India
157501,2023-06-20,1007,Eyeshadow,200,400,200,1,00102,India
157501,2023-06-20,1005,Nail Polish,50,100,50,1,00102,India
157501,2023-06-20,1008,Makeup Remover,80,160,80,1,00102,India
130777,2023-06-20,1002,Mascara,200,400,200,1,00060,India
130777,2023-06-20,1008,Makeup Remover,80,160,80,1,00060,India
130777,2023-06-20,1003,Foundation,300,600,300,1,00060,India
453688,2023-06-20,1007,Eyeshadow,200,400,200,1,00241,India
453688,2023-06-20,1004,Eyeliner,100,200,100,1,00241,India
437213,2023-06-20,1009,Moisturizer,250,500,250,1,00124,India
437213,2023-06-20,1002,Mascara,200,400,200,1,00124,India
437213,2023-06-20,1006,Blush,150,300,150,1,00124,India
437213,2023-06-20,1003,Foundation,300,600,300,1,00124,India
237618,2023-06-20,1001,Lipstick,150,300,150,1,00475,India
237618,2023-06-20,1003,Foundation,300,600,300,1,00475,India
471720,2023-06-20,1008,Makeup Remover,80,160,80,1,00302,India
471720,2023-06-20,1012,Body Lotion,200,400,200,1,00302,India
471720,2023-06-20,1009,Moisturizer,250,500,250,1,00302,India
471720,2023-06-20,1005,Nail Polish,50,100,50,1,00302,India
670548,2023-06-20,1008,Makeup Remover,80,160,80,1,00039,India
353792,2023-06-20,1001,Lipstick,150,300,150,1,00335,India
353792,2023-06-20,1009,Moisturizer,250,500,250,1,00335,India
353792,2023-06-20,1004,Eyeliner,100,200,100,1,00335,India
353792,2023-06-20,1007,Eyeshadow,200,400,200,1,00335,India
354483,2023-06-20,1006,Blush,150,300,150,1,00005,India
354483,2023-06-20,1008,Makeup Remover,80,160,80,1,00005,India
337266,2023-06-20,1001,Lipstick,150,300,150,1,00194,India
688593,2023-06-20,1012,Body Lotion,200,400,200,1,00224,India
965983,2023-06-20,1003,Foundation,300,600,300,1,00058,India
581073,2023-06-20,1012,Body Lotion,200,400,200,1,00144,India
581073,2023-06-20,1005,Nail Polish,50,100,50,1,00144,India
334567,2023-06-20,1003,Foundation,300,600,300,1,00467,India
334567,2023-06-20,1009,Moisturizer,250,500,250,1,00467,India
334567,2023-06-20,1002,Mascara,200,400,200,1,00467,India
910645,2023-06-20,1002,Mascara,200,400,200,1,00375,India
910645,2023-06-20,1001,Lipstick,150,300,150,1,00375,India
910645,2023-06-20,1008,Makeup Remover,80,160,80,1,00375,India
910645,2023-06-20,1005,Nail Polish,50,100,50,1,00375,India
118750,2023-06-20,1012,Body Lotion,200,400,200,1,00082,India
118750,2023-06-20,1003,Foundation,300,600,300,1,00082,India
340822,2023-06-20,1008,Makeup Remover,80,160,80,1,00120,India
340822,2023-06-20,1007,Eyeshadow,200,400,200,1,00120,India
340822,2023-06-20,1003,Foundation,300,600,300,1,00120,India
340822,2023-06-20,1002,Mascara,200,400,200,1,00120,India
874156,2023-06-21,1006,Blush,150,300,150,1,00488,India
874156,2023-06-21,1001,Lipstick,150,300,150,1,00488,India
874156,2023-06-21,1002,Mascara,200,400,200,1,00488,India
874156,2023-06-21,1007,Eyeshadow,200,400,200,1,00488,India
874156,2023-06-21,1008,Makeup Remover,80,160,80,1,00488,India
630387,2023-06-21,1003,Foundation,300,600,300,1,00333,India
630387,2023-06-21,1004,Eyeliner,100,200,100,1,00333,India
630387,2023-06-21,1008,Makeup Remover,80,160,80,1,00333,India
630387,2023-06-21,1005,Nail Polish,50,100,50,1,00333,India
500498,2023-06-21,1008,Makeup Remover,80,160,80,1,00062,India
500498,2023-06-21,1004,Eyeliner,100,200,100,1,00062,India
658465,2023-06-21,1008,Makeup Remover,80,160,80,1,00140,India
658465,2023-06-21,1012,Body Lotion,200,400,200,1,00140,India
658465,2023-06-21,1007,Eyeshadow,200,400,200,1,00140,India
238888,2023-06-21,1012,Body Lotion,200,400,200,1,00259,India
238888,2023-06-21,1003,Foundation,300,600,300,1,00259,India
238888,2023-06-21,1001,Lipstick,150,300,150,1,00259,India
711031,2023-06-21,1012,Body Lotion,200,400,200,1,00454,India
711031,2023-06-21,1008,Makeup Remover,80,160,80,1,00454,India
711031,2023-06-21,1009,Moisturizer,250,500,250,1,00454,India
372640,2023-06-21,1003,Foundation,300,600,300,1,00466,India
905257,2023-06-21,1006,Blush,150,300,150,1,00024,India
551515,2023-06-21,1001,Lipstick,150,300,150,1,00220,India
456541,2023-06-21,1002,Mascara,200,400,200,1,00068,India
456541,2023-06-21,1005,Nail Polish,50,100,50,1,00068,India
456541,2023-06-21,1003,Foundation,300,600,300,1,00068,India
456541,2023-06-21,1012,Body Lotion,200,400,200,1,00068,India
894378,2023-06-21,1009,Moisturizer,250,500,250,1,00002,India
894378,2023-06-21,1012,Body Lotion,200,400,200,1,00002,India
419309,2023-06-21,1006,Blush,150,300,150,1,00485,India
419309,2023-06-21,1009,Moisturizer,250,500,250,1,00485,India
419309,2023-06-21,1001,Lipstick,150,300,150,1,00485,India
419309,2023-06-21,1002,Mascara,200,400,200,1,00485,India
961817,2023-06-21,1001,Lipstick,150,300,150,1,00470,India
961817,2023-06-21,1006,Blush,150,300,150,1,00470,India
961817,2023-06-21,1009,Moisturizer,250,500,250,1,00470,India
923846,2023-06-21,1008,Makeup Remover,80,160,80,1,00326,India
923846,2023-06-21,1005,Nail Polish,50,100,50,1,00326,India
923846,2023-06-21,1004,Eyeliner,100,200,100,1,00326,India
759648,2023-06-21,1012,Body Lotion,200,400,200,1,00467,India
759648,2023-06-21,1001,Lipstick,150,300,150,1,00467,India
452011,2023-06-21,1004,Eyeliner,100,200,100,1,00261,India
452011,2023-06-21,1009,Moisturizer,250,500,250,1,00261,India
452011,2023-06-21,1006,Blush,150,300,150,1,00261,India
419020,2023-06-21,1005,Nail Polish,50,100,50,1,00116,India
419020,2023-06-21,1008,Makeup Remover,80,160,80,1,00116,India
419020,2023-06-21,1001,Lipstick,150,300,150,1,00116,India
419020,2023-06-21,1004,Eyeliner,100,200,100,1,00116,India
184856,2023-06-21,1009,Moisturizer,250,500,250,1,00378,India
184856,2023-06-21,1012,Body Lotion,200,400,200,1,00378,India
184856,2023-06-21,1002,Mascara,200,400,200,1,00378,India
297081,2023-06-21,1006,Blush,150,300,150,1,00345,India
297081,2023-06-21,1002,Mascara,200,400,200,1,00345,India
277703,2023-06-21,1005,Nail Polish,50,100,50,1,00116,India
277703,2023-06-21,1007,Eyeshadow,200,400,200,1,00116,India
277703,2023-06-21,1012,Body Lotion,200,400,200,1,00116,India
277703,2023-06-21,1003,Foundation,300,600,300,1,00116,India
271946,2023-06-21,1004,Eyeliner,100,200,100,1,00200,India
271946,2023-06-21,1006,Blush,150,300,150,1,00200,India
811925,2023-06-21,1007,Eyeshadow,200,400,200,1,00329,India
811925,2023-06-21,1002,Mascara,200,400,200,1,00329,India
915354,2023-06-21,1004,Eyeliner,100,200,100,1,00361,India
794725,2023-06-21,1001,Lipstick,150,300,150,1,00439,India
794725,2023-06-21,1002,Mascara,200,400,200,1,00439,India
794725,2023-06-21,1006,Blush,150,300,150,1,00439,India
838846,2023-06-21,1005,Nail Polish,50,100,50,1,00019,India
849667,2023-06-21,1001,Lipstick,150,300,150,1,00064,India
310665,2023-06-21,1005,Nail Polish,50,100,50,1,00401,India
310665,2023-06-21,1012,Body Lotion,200,400,200,1,00401,India
310665,2023-06-21,1006,Blush,150,300,150,1,00401,India
921359,2023-06-21,1005,Nail Polish,50,100,50,1,00273,India
936858,2023-06-21,1012,Body Lotion,200,400,200,1,00292,India
343939,2023-06-21,1006,Blush,150,300,150,1,00372,India
343939,2023-06-21,1009,Moisturizer,250,500,250,1,00372,India
343939,2023-06-21,1008,Makeup Remover,80,160,80,1,00372,India
343939,2023-06-21,1001,Lipstick,150,300,150,1,00372,India
459340,2023-06-21,1008,Makeup Remover,80,160,80,1,00361,India
459340,2023-06-21,1006,Blush,150,300,150,1,00361,India
459340,2023-06-21,1005,Nail Polish,50,100,50,1,00361,India
459340,2023-06-21,1002,Mascara,200,400,200,1,00361,India
459340,2023-06-21,1003,Foundation,300,600,300,1,00361,India
713209,2023-06-21,1005,Nail Polish,50,100,50,1,00180,India
713209,2023-06-21,1001,Lipstick,150,300,150,1,00180,India
713209,2023-06-21,1007,Eyeshadow,200,400,200,1,00180,India
103646,2023-06-21,1005,Nail Polish,50,100,50,1,00286,India
103646,2023-06-21,1012,Body Lotion,200,400,200,1,00286,India
103646,2023-06-21,1001,Lipstick,150,300,150,1,00286,India
103646,2023-06-21,1008,Makeup Remover,80,160,80,1,00286,India
883765,2023-06-21,1006,Blush,150,300,150,1,00056,India
883765,2023-06-21,1007,Eyeshadow,200,400,200,1,00056,India
181040,2023-06-21,1002,Mascara,200,400,200,1,00220,India
181040,2023-06-21,1009,Moisturizer,250,500,250,1,00220,India
758075,2023-06-21,1009,Moisturizer,250,500,250,1,00013,India
293511,2023-06-21,1012,Body Lotion,200,400,200,1,00140,India
853454,2023-06-21,1008,Makeup Remover,80,160,80,1,00222,India
853454,2023-06-21,1006,Blush,150,300,150,1,00222,India
853454,2023-06-21,1001,Lipstick,150,300,150,1,00222,India
219463,2023-06-21,1007,Eyeshadow,200,400,200,1,00020,India
164695,2023-06-21,1008,Makeup Remover,80,160,80,1,00421,India
445934,2023-06-21,1005,Nail Polish,50,100,50,1,00351,India
445934,2023-06-21,1012,Body Lotion,200,400,200,1,00351,India
445934,2023-06-21,1002,Mascara,200,400,200,1,00351,India
524053,2023-06-21,1005,Nail Polish,50,100,50,1,00249,India
524053,2023-06-21,1009,Moisturizer,250,500,250,1,00249,India
287388,2023-06-21,1006,Blush,150,300,150,1,00253,India
287388,2023-06-21,1001,Lipstick,150,300,150,1,00253,India
262810,2023-06-21,1001,Lipstick,150,300,150,1,00365,India
262810,2023-06-21,1002,Mascara,200,400,200,1,00365,India
262810,2023-06-21,1005,Nail Polish,50,100,50,1,00365,India
170123,2023-06-21,1012,Body Lotion,200,400,200,1,00306,India
170123,2023-06-21,1003,Foundation,300,600,300,1,00306,India
170123,2023-06-21,1002,Mascara,200,400,200,1,00306,India
334205,2023-06-21,1007,Eyeshadow,200,400,200,1,00381,India
334205,2023-06-21,1012,Body Lotion,200,400,200,1,00381,India
334205,2023-06-21,1009,Moisturizer,250,500,250,1,00381,India
334205,2023-06-21,1001,Lipstick,150,300,150,1,00381,India
334205,2023-06-21,1002,Mascara,200,400,200,1,00381,India
830747,2023-06-21,1005,Nail Polish,50,100,50,1,00120,India
830747,2023-06-21,1007,Eyeshadow,200,400,200,1,00120,India
750411,2023-06-21,1003,Foundation,300,600,300,1,00463,India
750411,2023-06-21,1006,Blush,150,300,150,1,00463,India
750411,2023-06-21,1002,Mascara,200,400,200,1,00463,India
750411,2023-06-21,1009,Moisturizer,250,500,250,1,00463,India
870680,2023-06-21,1007,Eyeshadow,200,400,200,1,00100,India
870680,2023-06-21,1008,Makeup Remover,80,160,80,1,00100,India
870680,2023-06-21,1012,Body Lotion,200,400,200,1,00100,India
870680,2023-06-21,1004,Eyeliner,100,200,100,1,00100,India
540653,2023-06-21,1009,Moisturizer,250,500,250,1,00106,India
540653,2023-06-21,1006,Blush,150,300,150,1,00106,India
128879,2023-06-22,1009,Moisturizer,250,500,250,1,00196,India
128879,2023-06-22,1004,Eyeliner,100,200,100,1,00196,India
128879,2023-06-22,1005,Nail Polish,50,100,50,1,00196,India
470545,2023-06-22,1007,Eyeshadow,200,400,200,1,00363,India
470545,2023-06-22,1003,Foundation,300,600,300,1,00363,India
470545,2023-06-22,1005,Nail Polish,50,100,50,1,00363,India
453162,2023-06-22,1003,Foundation,300,600,300,1,00043,India
453162,2023-06-22,1007,Eyeshadow,200,400,200,1,00043,India
453162,2023-06-22,1009,Moisturizer,250,500,250,1,00043,India
453162,2023-06-22,1004,Eyeliner,100,200,100,1,00043,India
897779,2023-06-22,1012,Body Lotion,200,400,200,1,00493,India
975137,2023-06-22,1007,Eyeshadow,200,400,200,1,00215,India
975137,2023-06-22,1006,Blush,150,300,150,1,00215,India
975137,2023-06-22,1004,Eyeliner,100,200,100,1,00215,India
304970,2023-06-22,1005,Nail Polish,50,100,50,1,00481,India
308694,2023-06-22,1009,Moisturizer,250,500,250,1,00202,India
308694,2023-06-22,1012,Body Lotion,200,400,200,1,00202,India
491021,2023-06-22,1001,Lipstick,150,300,150,1,00148,India
491021,2023-06-22,1003,Foundation,300,600,300,1,00148,India
191729,2023-06-22,1008,Makeup Remover,80,160,80,1,00275,India
345654,2023-06-22,1005,Nail Polish,50,100,50,1,00285,India
345654,2023-06-22,1004,Eyeliner,100,200,100,1,00285,India
964557,2023-06-22,1009,Moisturizer,250,500,250,1,00422,India
964557,2023-06-22,1012,Body Lotion,200,400,200,1,00422,India
912632,2023-06-22,1008,Makeup Remover,80,160,80,1,00222,India
912632,2023-06-22,1009,Moisturizer,250,500,250,1,00222,India
870257,2023-06-22,1008,Makeup Remover,80,160,80,1,00372,India
870257,2023-06-22,1012,Body Lotion,200,400,200,1,00372,India
230084,2023-06-22,1012,Body Lotion,200,400,200,1,00051,India
467164,2023-06-22,1003,Foundation,300,600,300,1,00349,India
467164,2023-06-22,1012,Body Lotion,200,400,200,1,00349,India
467164,2023-06-22,1001,Lipstick,150,300,150,1,00349,India
833043,2023-06-22,1001,Lipstick,150,300,150,1,00356,India
440166,2023-06-22,1009,Moisturizer,250,500,250,1,00117,India
440166,2023-06-22,1004,Eyeliner,100,200,100,1,00117,India
440166,2023-06-22,1002,Mascara,200,400,200,1,00117,India
331057,2023-06-22,1009,Moisturizer,250,500,250,1,00226,India
709694,2023-06-22,1009,Moisturizer,250,500,250,1,00067,India
519537,2023-06-22,1002,Mascara,200,400,200,1,00140,India
519537,2023-06-22,1005,Nail Polish,50,100,50,1,00140,India
519537,2023-06-22,1006,Blush,150,300,150,1,00140,India
754668,2023-06-22,1009,Moisturizer,250,500,250,1,00010,India
754668,2023-06-22,1002,Mascara,200,400,200,1,00010,India
754668,2023-06-22,1003,Foundation,300,600,300,1,00010,India
489296,2023-06-22,1003,Foundation,300,600,300,1,00480,India
489296,2023-06-22,1012,Body Lotion,200,400,200,1,00480,India
489296,2023-06-22,1001,Lipstick,150,300,150,1,00480,India
861994,2023-06-22,1003,Foundation,300,600,300,1,00354,India
986915,2023-06-22,1006,Blush,150,300,150,1,00261,India
986915,2023-06-22,1001,Lipstick,150,300,150,1,00261,India
986915,2023-06-22,1009,Moisturizer,250,500,250,1,00261,India
775019,2023-06-22,1008,Makeup Remover,80,160,80,1,00012,India
144284,2023-06-22,1012,Body Lotion,200,400,200,1,00452,India
558558,2023-06-22,1003,Foundation,300,600,300,1,00488,India
558558,2023-06-22,1012,Body Lotion,200,400,200,1,00488,India
885438,2023-06-22,1002,Mascara,200,400,200,1,00176,India
885438,2023-06-22,1005,Nail Polish,50,100,50,1,00176,India
885438,2023-06-22,1009,Moisturizer,250,500,250,1,00176,India
885438,2023-06-22,1007,Eyeshadow,200,400,200,1,00176,India
208957,2023-06-22,1005,Nail Polish,50,100,50,1,00224,India
208957,2023-06-22,1012,Body Lotion,200,400,200,1,00224,India
208957,2023-06-22,1008,Makeup Remover,80,160,80,1,00224,India
208957,2023-06-22,1004,Eyeliner,100,200,100,1,00224,India
657878,2023-06-22,1003,Foundation,300,600,300,1,00103,India
657878,2023-06-22,1001,Lipstick,150,300,150,1,00103,India
649064,2023-06-22,1006,Blush,150,300,150,1,00482,India
649064,2023-06-22,1003,Foundation,300,600,300,1,00482,India
649064,2023-06-22,1002,Mascara,200,400,200,1,00482,India
649064,2023-06-22,1007,Eyeshadow,200,400,200,1,00482,India
566406,2023-06-22,1001,Lipstick,150,300,150,1,00049,India
877606,2023-06-22,1007,Eyeshadow,200,400,200,1,00095,India
877606,2023-06-22,1008,Makeup Remover,80,160,80,1,00095,India
250750,2023-06-22,1004,Eyeliner,100,200,100,1,00015,India
250750,2023-06-22,1012,Body Lotion,200,400,200,1,00015,India
250750,2023-06-22,1006,Blush,150,300,150,1,00015,India
460380,2023-06-22,1004,Eyeliner,100,200,100,1,00475,India
460380,2023-06-22,1005,Nail Polish,50,100,50,1,00475,India
460380,2023-06-22,1008,Makeup Remover,80,160,80,1,00475,India
436561,2023-06-22,1008,Makeup Remover,80,160,80,1,00426,India
436561,2023-06-22,1009,Moisturizer,250,500,250,1,00426,India
436561,2023-06-22,1006,Blush,150,300,150,1,00426,India
291148,2023-06-22,1008,Makeup Remover,80,160,80,1,00266,India
291148,2023-06-22,1007,Eyeshadow,200,400,200,1,00266,India
323506,2023-06-22,1003,Foundation,300,600,300,1,00253,India
323506,2023-06-22,1001,Lipstick,150,300,150,1,00253,India
928029,2023-06-22,1005,Nail Polish,50,100,50,1,00350,India
928029,2023-06-22,1006,Blush,150,300,150,1,00350,India
928029,2023-06-22,1004,Eyeliner,100,200,100,1,00350,India
928029,2023-06-22,1007,Eyeshadow,200,400,200,1,00350,India
185889,2023-06-22,1004,Eyeliner,100,200,100,1,00435,India
185889,2023-06-22,1006,Blush,150,300,150,1,00435,India
548608,2023-06-22,1009,Moisturizer,250,500,250,1,00218,India
548608,2023-06-22,1006,Blush,150,300,150,1,00218,India
294361,2023-06-22,1001,Lipstick,150,300,150,1,00080,India
263144,2023-06-22,1007,Eyeshadow,200,400,200,1,00343,India
263144,2023-06-22,1006,Blush,150,300,150,1,00343,India
263144,2023-06-22,1002,Mascara,200,400,200,1,00343,India
807323,2023-06-22,1002,Mascara,200,400,200,1,00489,India
807323,2023-06-22,1012,Body Lotion,200,400,200,1,00489,India
807323,2023-06-22,1004,Eyeliner,100,200,100,1,00489,India
807323,2023-06-22,1005,Nail Polish,50,100,50,1,00489,India
807323,2023-06-22,1008,Makeup Remover,80,160,80,1,00489,India
175078,2023-06-22,1009,Moisturizer,250,500,250,1,00377,India
175078,2023-06-22,1003,Foundation,300,600,300,1,00377,India
175078,2023-06-22,1002,Mascara,200,400,200,1,00377,India
669762,2023-06-22,1004,Eyeliner,100,200,100,1,00388,India
669762,2023-06-22,1003,Foundation,300,600,300,1,00388,India
669762,2023-06-22,1008,Makeup Remover,80,160,80,1,00388,India
669762,2023-06-22,1007,Eyeshadow,200,400,200,1,00388,India
897359,2023-06-22,1004,Eyeliner,100,200,100,1,00005,India
897359,2023-06-22,1002,Mascara,200,400,200,1,00005,India
897359,2023-06-22,1001,Lipstick,150,300,150,1,00005,India
897359,2023-06-22,1006,Blush,150,300,150,1,00005,India
858466,2023-06-22,1003,Foundation,300,600,300,1,00019,India
858466,2023-06-22,1005,Nail Polish,50,100,50,1,00019,India
858466,2023-06-22,1004,Eyeliner,100,200,100,1,00019,India
858466,2023-06-22,1006,Blush,150,300,150,1,00019,India
683222,2023-06-22,1009,Moisturizer,250,500,250,1,00071,India
683222,2023-06-22,1004,Eyeliner,100,200,100,1,00071,India
290353,2023-06-23,1004,Eyeliner,100,200,100,1,00120,India
290353,2023-06-23,1003,Foundation,300,600,300,1,00120,India
290353,2023-06-23,1006,Blush,150,300,150,1,00120,India
290353,2023-06-23,1009,Moisturizer,250,500,250,1,00120,India
547771,2023-06-23,1008,Makeup Remover,80,160,80,1,00428,India
547771,2023-06-23,1009,Moisturizer,250,500,250,1,00428,India
547771,2023-06-23,1004,Eyeliner,100,200,100,1,00428,India
547771,2023-06-23,1005,Nail Polish,50,100,50,1,00428,India
260249,2023-06-23,1007,Eyeshadow,200,400,200,1,00384,India
260249,2023-06-23,1005,Nail Polish,50,100,50,1,00384,India
979549,2023-06-23,1004,Eyeliner,100,200,100,1,00195,India
979549,2023-06-23,1001,Lipstick,150,300,150,1,00195,India
979549,2023-06-23,1012,Body Lotion,200,400,200,1,00195,India
979549,2023-06-23,1006,Blush,150,300,150,1,00195,India
979549,2023-06-23,1009,Moisturizer,250,500,250,1,00195,India
740433,2023-06-23,1004,Eyeliner,100,200,100,1,00128,India
754013,2023-06-23,1003,Foundation,300,600,300,1,00018,India
754013,2023-06-23,1005,Nail Polish,50,100,50,1,00018,India
301467,2023-06-23,1009,Moisturizer,250,500,250,1,00339,India
301467,2023-06-23,1007,Eyeshadow,200,400,200,1,00339,India
301467,2023-06-23,1008,Makeup Remover,80,160,80,1,00339,India
644891,2023-06-23,1003,Foundation,300,600,300,1,00167,India
615706,2023-06-23,1001,Lipstick,150,300,150,1,00469,India
673073,2023-06-23,1008,Makeup Remover,80,160,80,1,00163,India
673073,2023-06-23,1003,Foundation,300,600,300,1,00163,India
673073,2023-06-23,1007,Eyeshadow,200,400,200,1,00163,India
225471,2023-06-23,1009,Moisturizer,250,500,250,1,00347,India
225471,2023-06-23,1012,Body Lotion,200,400,200,1,00347,India
225471,2023-06-23,1001,Lipstick,150,300,150,1,00347,India
494279,2023-06-23,1003,Foundation,300,600,300,1,00445,India
494279,2023-06-23,1009,Moisturizer,250,500,250,1,00445,India
494279,2023-06-23,1001,Lipstick,150,300,150,1,00445,India
494279,2023-06-23,1004,Eyeliner,100,200,100,1,00445,India
369050,2023-06-23,1003,Foundation,300,600,300,1,00271,India
654371,2023-06-23,1006,Blush,150,300,150,1,00256,India
654371,2023-06-23,1012,Body Lotion,200,400,200,1,00256,India
654371,2023-06-23,1007,Eyeshadow,200,400,200,1,00256,India
654371,2023-06-23,1005,Nail Polish,50,100,50,1,00256,India
559539,2023-06-23,1007,Eyeshadow,200,400,200,1,00260,India
559539,2023-06-23,1012,Body Lotion,200,400,200,1,00260,India
559539,2023-06-23,1008,Makeup Remover,80,160,80,1,00260,India
559539,2023-06-23,1001,Lipstick,150,300,150,1,00260,India
956776,2023-06-23,1009,Moisturizer,250,500,250,1,00190,India
419552,2023-06-23,1009,Moisturizer,250,500,250,1,00319,India
419552,2023-06-23,1004,Eyeliner,100,200,100,1,00319,India
419552,2023-06-23,1008,Makeup Remover,80,160,80,1,00319,India
181068,2023-06-23,1003,Foundation,300,600,300,1,00362,India
181068,2023-06-23,1007,Eyeshadow,200,400,200,1,00362,India
181068,2023-06-23,1009,Moisturizer,250,500,250,1,00362,India
181068,2023-06-23,1006,Blush,150,300,150,1,00362,India
321381,2023-06-23,1007,Eyeshadow,200,400,200,1,00062,India
321381,2023-06-23,1002,Mascara,200,400,200,1,00062,India
321381,2023-06-23,1005,Nail Polish,50,100,50,1,00062,India
433980,2023-06-23,1002,Mascara,200,400,200,1,00377,India
861959,2023-06-23,1004,Eyeliner,100,200,100,1,00496,India
861959,2023-06-23,1006,Blush,150,300,150,1,00496,India
711914,2023-06-23,1003,Foundation,300,600,300,1,00173,India
711914,2023-06-23,1002,Mascara,200,400,200,1,00173,India
711914,2023-06-23,1004,Eyeliner,100,200,100,1,00173,India
711914,2023-06-23,1009,Moisturizer,250,500,250,1,00173,India
839707,2023-06-23,1006,Blush,150,300,150,1,00412,India
839707,2023-06-23,1008,Makeup Remover,80,160,80,1,00412,India
839707,2023-06-23,1004,Eyeliner,100,200,100,1,00412,India
839707,2023-06-23,1001,Lipstick,150,300,150,1,00412,India
654896,2023-06-23,1009,Moisturizer,250,500,250,1,00218,India
654896,2023-06-23,1005,Nail Polish,50,100,50,1,00218,India
677562,2023-06-23,1004,Eyeliner,100,200,100,1,00476,India
677562,2023-06-23,1006,Blush,150,300,150,1,00476,India
677562,2023-06-23,1012,Body Lotion,200,400,200,1,00476,India
248672,2023-06-23,1001,Lipstick,150,300,150,1,00269,India
248672,2023-06-23,1005,Nail Polish,50,100,50,1,00269,India
248672,2023-06-23,1008,Makeup Remover,80,160,80,1,00269,India
944154,2023-06-23,1012,Body Lotion,200,400,200,1,00485,India
944154,2023-06-23,1004,Eyeliner,100,200,100,1,00485,India
944154,2023-06-23,1001,Lipstick,150,300,150,1,00485,India
908525,2023-06-23,1001,Lipstick,150,300,150,1,00322,India
835607,2023-06-23,1009,Moisturizer,250,500,250,1,00431,India
335657,2023-06-23,1008,Makeup Remover,80,160,80,1,00206,India
337364,2023-06-23,1003,Foundation,300,600,300,1,00473,India
337364,2023-06-23,1005,Nail Polish,50,100,50,1,00473,India
337364,2023-06-23,1002,Mascara,200,400,200,1,00473,India
337364,2023-06-23,1004,Eyeliner,100,200,100,1,00473,India
337364,2023-06-23,1001,Lipstick,150,300,150,1,00473,India
678819,2023-06-23,1001,Lipstick,150,300,150,1,00491,India
678819,2023-06-23,1007,Eyeshadow,200,400,200,1,00491,India
678819,2023-06-23,1008,Makeup Remover,80,160,80,1,00491,India
678819,2023-06-23,1004,Eyeliner,100,200,100,1,00491,India
678819,2023-06-23,1003,Foundation,300,600,300,1,00491,India
332745,2023-06-23,1009,Moisturizer,250,500,250,1,00313,India
332745,2023-06-23,1003,Foundation,300,600,300,1,00313,India
332745,2023-06-23,1007,Eyeshadow,200,400,200,1,00313,India
332745,2023-06-23,1006,Blush,150,300,150,1,00313,India
775499,2023-06-23,1002,Mascara,200,400,200,1,00255,India
775499,2023-06-23,1004,Eyeliner,100,200,100,1,00255,India
507884,2023-06-23,1004,Eyeliner,100,200,100,1,00009,India
642217,2023-06-23,1006,Blush,150,300,150,1,00050,India
698272,2023-06-23,1012,Body Lotion,200,400,200,1,00232,India
698272,2023-06-23,1004,Eyeliner,100,200,100,1,00232,India
199944,2023-06-23,1004,Eyeliner,100,200,100,1,00125,India
199944,2023-06-23,1005,Nail Polish,50,100,50,1,00125,India
199944,2023-06-23,1012,Body Lotion,200,400,200,1,00125,India
199944,2023-06-23,1007,Eyeshadow,200,400,200,1,00125,India
199944,2023-06-23,1006,Blush,150,300,150,1,00125,India
400756,2023-06-23,1004,Eyeliner,100,200,100,1,00244,India
400756,2023-06-23,1001,Lipstick,150,300,150,1,00244,India
400756,2023-06-23,1008,Makeup Remover,80,160,80,1,00244,India
400756,2023-06-23,1006,Blush,150,300,150,1,00244,India
871322,2023-06-23,1004,Eyeliner,100,200,100,1,00384,India
871322,2023-06-23,1012,Body Lotion,200,400,200,1,00384,India
228724,2023-06-23,1001,Lipstick,150,300,150,1,00460,India
228724,2023-06-23,1009,Moisturizer,250,500,250,1,00460,India
408743,2023-06-23,1012,Body Lotion,200,400,200,1,00189,India
408743,2023-06-23,1003,Foundation,300,600,300,1,00189,India
408743,2023-06-23,1007,Eyeshadow,200,400,200,1,00189,India
408743,2023-06-23,1005,Nail Polish,50,100,50,1,00189,India
210222,2023-06-23,1001,Lipstick,150,300,150,1,00278,India
210222,2023-06-23,1008,Makeup Remover,80,160,80,1,00278,India
210222,2023-06-23,1007,Eyeshadow,200,400,200,1,00278,India
701109,2023-06-23,1006,Blush,150,300,150,1,00362,India
530846,2023-06-23,1006,Blush,150,300,150,1,00471,India
814615,2023-06-23,1005,Nail Polish,50,100,50,1,00208,India
231027,2023-06-23,1009,Moisturizer,250,500,250,1,00334,India
231027,2023-06-23,1004,Eyeliner,100,200,100,1,00334,India
708548,2023-06-23,1001,Lipstick,150,300,150,1,00197,India
708548,2023-06-23,1002,Mascara,200,400,200,1,00197,India
708548,2023-06-23,1004,Eyeliner,100,200,100,1,00197,India
708548,2023-06-23,1003,Foundation,300,600,300,1,00197,India
722842,2023-06-24,1002,Mascara,200,400,200,1,00290,India
722842,2023-06-24,1008,Makeup Remover,80,160,80,1,00290,India
722842,2023-06-24,1012,Body Lotion,200,400,200,1,00290,India
266741,2023-06-24,1007,Eyeshadow,200,400,200,1,00451,India
266741,2023-06-24,1004,Eyeliner,100,200,100,1,00451,India
266741,2023-06-24,1003,Foundation,300,600,300,1,00451,India
644364,2023-06-24,1012,Body Lotion,200,400,200,1,00202,India
647507,2023-06-24,1009,Moisturizer,250,500,250,1,00226,India
647507,2023-06-24,1012,Body Lotion,200,400,200,1,00226,India
739525,2023-06-24,1009,Moisturizer,250,500,250,1,00026,India
739525,2023-06-24,1003,Foundation,300,600,300,1,00026,India
739525,2023-06-24,1008,Makeup Remover,80,160,80,1,00026,India
733722,2023-06-24,1009,Moisturizer,250,500,250,1,00156,India
733722,2023-06-24,1003,Foundation,300,600,300,1,00156,India
293459,2023-06-24,1004,Eyeliner,100,200,100,1,00089,India
293459,2023-06-24,1009,Moisturizer,250,500,250,1,00089,India
293459,2023-06-24,1012,Body Lotion,200,400,200,1,00089,India
521165,2023-06-24,1006,Blush,150,300,150,1,00037,India
521165,2023-06-24,1007,Eyeshadow,200,400,200,1,00037,India
521165,2023-06-24,1002,Mascara,200,400,200,1,00037,India
378007,2023-06-24,1008,Makeup Remover,80,160,80,1,00226,India
972874,2023-06-24,1008,Makeup Remover,80,160,80,1,00022,India
972874,2023-06-24,1007,Eyeshadow,200,400,200,1,00022,India
972874,2023-06-24,1003,Foundation,300,600,300,1,00022,India
972874,2023-06-24,1012,Body Lotion,200,400,200,1,00022,India
576396,2023-06-24,1009,Moisturizer,250,500,250,1,00463,India
576396,2023-06-24,1001,Lipstick,150,300,150,1,00463,India
561423,2023-06-24,1001,Lipstick,150,300,150,1,00033,India
284505,2023-06-24,1012,Body Lotion,200,400,200,1,00236,India
284505,2023-06-24,1002,Mascara,200,400,200,1,00236,India
284505,2023-06-24,1005,Nail Polish,50,100,50,1,00236,India
721266,2023-06-24,1004,Eyeliner,100,200,100,1,00111,India
721266,2023-06-24,1012,Body Lotion,200,400,200,1,00111,India
721266,2023-06-24,1002,Mascara,200,400,200,1,00111,India
721266,2023-06-24,1003,Foundation,300,600,300,1,00111,India
995933,2023-06-24,1002,Mascara,200,400,200,1,00098,India
995933,2023-06-24,1004,Eyeliner,100,200,100,1,00098,India
319508,2023-06-24,1006,Blush,150,300,150,1,00259,India
319508,2023-06-24,1008,Makeup Remover,80,160,80,1,00259,India
496414,2023-06-24,1003,Foundation,300,600,300,1,00094,India
496414,2023-06-24,1004,Eyeliner,100,200,100,1,00094,India
972648,2023-06-24,1009,Moisturizer,250,500,250,1,00362,India
120804,2023-06-24,1005,Nail Polish,50,100,50,1,00498,India
120804,2023-06-24,1004,Eyeliner,100,200,100,1,00498,India
120804,2023-06-24,1009,Moisturizer,250,500,250,1,00498,India
120804,2023-06-24,1006,Blush,150,300,150,1,00498,India
558182,2023-06-24,1008,Makeup Remover,80,160,80,1,00379,India
303185,2023-06-24,1012,Body Lotion,200,400,200,1,00338,India
888540,2023-06-24,1002,Mascara,200,400,200,1,00367,India
888540,2023-06-24,1003,Foundation,300,600,300,1,00367,India
888540,2023-06-24,1007,Eyeshadow,200,400,200,1,00367,India
888540,2023-06-24,1006,Blush,150,300,150,1,00367,India
259976,2023-06-24,1001,Lipstick,150,300,150,1,00100,India
259976,2023-06-24,1009,Moisturizer,250,500,250,1,00100,India
107974,2023-06-24,1004,Eyeliner,100,200,100,1,00361,India
107974,2023-06-24,1009,Moisturizer,250,500,250,1,00361,India
107974,2023-06-24,1002,Mascara,200,400,200,1,00361,India
107974,2023-06-24,1007,Eyeshadow,200,400,200,1,00361,India
342006,2023-06-24,1005,Nail Polish,50,100,50,1,00080,India
342006,2023-06-24,1003,Foundation,300,600,300,1,00080,India
543760,2023-06-24,1002,Mascara,200,400,200,1,00215,India
543760,2023-06-24,1005,Nail Polish,50,100,50,1,00215,India
543760,2023-06-24,1007,Eyeshadow,200,400,200,1,00215,India
872306,2023-06-24,1009,Moisturizer,250,500,250,1,00222,India
872306,2023-06-24,1006,Blush,150,300,150,1,00222,India
872306,2023-06-24,1004,Eyeliner,100,200,100,1,00222,India
747937,2023-06-24,1006,Blush,150,300,150,1,00087,India
747937,2023-06-24,1002,Mascara,200,400,200,1,00087,India
747937,2023-06-24,1005,Nail Polish,50,100,50,1,00087,India
464440,2023-06-24,1012,Body Lotion,200,400,200,1,00278,India
464440,2023-06-24,1001,Lipstick,150,300,150,1,00278,India
422545,2023-06-24,1001,Lipstick,150,300,150,1,00240,India
422545,2023-06-24,1004,Eyeliner,100,200,100,1,00240,India
422545,2023-06-24,1005,Nail Polish,50,100,50,1,00240,India
422545,2023-06-24,1002,Mascara,200,400,200,1,00240,India
723216,2023-06-24,1001,Lipstick,150,300,150,1,00121,India
723216,2023-06-24,1008,Makeup Remover,80,160,80,1,00121,India
326351,2023-06-24,1007,Eyeshadow,200,400,200,1,00132,India
275150,2023-06-24,1007,Eyeshadow,200,400,200,1,00269,India
275150,2023-06-24,1003,Foundation,300,600,300,1,00269,India
845116,2023-06-24,1003,Foundation,300,600,300,1,00478,India
845116,2023-06-24,1002,Mascara,200,400,200,1,00478,India
845116,2023-06-24,1009,Moisturizer,250,500,250,1,00478,India
845116,2023-06-24,1006,Blush,150,300,150,1,00478,India
845116,2023-06-24,1012,Body Lotion,200,400,200,1,00478,India
974503,2023-06-24,1004,Eyeliner,100,200,100,1,00487,India
974503,2023-06-24,1001,Lipstick,150,300,150,1,00487,India
974503,2023-06-24,1006,Blush,150,300,150,1,00487,India
974503,2023-06-24,1002,Mascara,200,400,200,1,00487,India
305484,2023-06-24,1004,Eyeliner,100,200,100,1,00425,India
305484,2023-06-24,1009,Moisturizer,250,500,250,1,00425,India
305484,2023-06-24,1006,Blush,150,300,150,1,00425,India
305484,2023-06-24,1002,Mascara,200,400,200,1,00425,India
897566,2023-06-24,1009,Moisturizer,250,500,250,1,00103,India
307175,2023-06-25,1009,Moisturizer,250,500,250,1,00292,India
713338,2023-06-25,1009,Moisturizer,250,500,250,1,00483,India
690484,2023-06-25,1003,Foundation,300,600,300,1,00294,India
690484,2023-06-25,1005,Nail Polish,50,100,50,1,00294,India
690484,2023-06-25,1012,Body Lotion,200,400,200,1,00294,India
690484,2023-06-25,1004,Eyeliner,100,200,100,1,00294,India
466443,2023-06-25,1001,Lipstick,150,300,150,1,00227,India
466443,2023-06-25,1005,Nail Polish,50,100,50,1,00227,India
541582,2023-06-25,1004,Eyeliner,100,200,100,1,00020,India
541582,2023-06-25,1009,Moisturizer,250,500,250,1,00020,India
910686,2023-06-25,1003,Foundation,300,600,300,1,00364,India
490807,2023-06-25,1003,Foundation,300,600,300,1,00289,India
490807,2023-06-25,1012,Body Lotion,200,400,200,1,00289,India
195192,2023-06-25,1009,Moisturizer,250,500,250,1,00461,India
751271,2023-06-25,1005,Nail Polish,50,100,50,1,00174,India
451254,2023-06-25,1008,Makeup Remover,80,160,80,1,00214,India
451254,2023-06-25,1001,Lipstick,150,300,150,1,00214,India
451254,2023-06-25,1003,Foundation,300,600,300,1,00214,India
909092,2023-06-25,1005,Nail Polish,50,100,50,1,00017,India
909092,2023-06-25,1009,Moisturizer,250,500,250,1,00017,India
671529,2023-06-25,1005,Nail Polish,50,100,50,1,00393,India
492788,2023-06-25,1001,Lipstick,150,300,150,1,00283,India
297613,2023-06-25,1003,Foundation,300,600,300,1,00171,India
297613,2023-06-25,1009,Moisturizer,250,500,250,1,00171,India
614423,2023-06-25,1009,Moisturizer,250,500,250,1,00139,India
614423,2023-06-25,1007,Eyeshadow,200,400,200,1,00139,India
614423,2023-06-25,1005,Nail Polish,50,100,50,1,00139,India
614423,2023-06-25,1008,Makeup Remover,80,160,80,1,00139,India
614423,2023-06-25,1004,Eyeliner,100,200,100,1,00139,India
899647,2023-06-25,1007,Eyeshadow,200,400,200,1,00454,India
766921,2023-06-25,1003,Foundation,300,600,300,1,00039,India
766921,2023-06-25,1002,Mascara,200,400,200,1,00039,India
978518,2023-06-25,1003,Foundation,300,600,300,1,00113,India
978518,2023-06-25,1001,Lipstick,150,300,150,1,00113,India
978518,2023-06-25,1002,Mascara,200,400,200,1,00113,India
978518,2023-06-25,1005,Nail Polish,50,100,50,1,00113,India
912953,2023-06-25,1003,Foundation,300,600,300,1,00010,India
912953,2023-06-25,1006,Blush,150,300,150,1,00010,India
912953,2023-06-25,1009,Moisturizer,250,500,250,1,00010,India
912953,2023-06-25,1005,Nail Polish,50,100,50,1,00010,India
877394,2023-06-25,1008,Makeup Remover,80,160,80,1,00190,India
877394,2023-06-25,1004,Eyeliner,100,200,100,1,00190,India
968216,2023-06-25,1006,Blush,150,300,150,1,00402,India
968216,2023-06-25,1012,Body Lotion,200,400,200,1,00402,India
217579,2023-06-25,1004,Eyeliner,100,200,100,1,00179,India
217579,2023-06-25,1007,Eyeshadow,200,400,200,1,00179,India
217579,2023-06-25,1002,Mascara,200,400,200,1,00179,India
217579,2023-06-25,1005,Nail Polish,50,100,50,1,00179,India
217579,2023-06-25,1003,Foundation,300,600,300,1,00179,India
148866,2023-06-25,1009,Moisturizer,250,500,250,1,00007,India
148866,2023-06-25,1012,Body Lotion,200,400,200,1,00007,India
148866,2023-06-25,1006,Blush,150,300,150,1,00007,India
148866,2023-06-25,1003,Foundation,300,600,300,1,00007,India
148866,2023-06-25,1005,Nail Polish,50,100,50,1,00007,India
496695,2023-06-25,1003,Foundation,300,600,300,1,00173,India
496695,2023-06-25,1005,Nail Polish,50,100,50,1,00173,India
496695,2023-06-25,1002,Mascara,200,400,200,1,00173,India
256320,2023-06-25,1006,Blush,150,300,150,1,00222,India
256320,2023-06-25,1007,Eyeshadow,200,400,200,1,00222,India
256320,2023-06-25,1003,Foundation,300,600,300,1,00222,India
256320,2023-06-25,1001,Lipstick,150,300,150,1,00222,India
580561,2023-06-25,1007,Eyeshadow,200,400,200,1,00180,India
580561,2023-06-25,1009,Moisturizer,250,500,250,1,00180,India
217540,2023-06-25,1005,Nail Polish,50,100,50,1,00021,India
217540,2023-06-25,1003,Foundation,300,600,300,1,00021,India
217540,2023-06-25,1002,Mascara,200,400,200,1,00021,India
126806,2023-06-25,1001,Lipstick,150,300,150,1,00476,India
148219,2023-06-25,1001,Lipstick,150,300,150,1,00024,India
148219,2023-06-25,1006,Blush,150,300,150,1,00024,India
148219,2023-06-25,1007,Eyeshadow,200,400,200,1,00024,India
148219,2023-06-25,1003,Foundation,300,600,300,1,00024,India
600168,2023-06-25,1006,Blush,150,300,150,1,00165,India
456209,2023-06-25,1006,Blush,150,300,150,1,00290,India
456209,2023-06-25,1001,Lipstick,150,300,150,1,00290,India
456209,2023-06-25,1003,Foundation,300,600,300,1,00290,India
456209,2023-06-25,1009,Moisturizer,250,500,250,1,00290,India
199856,2023-06-25,1008,Makeup Remover,80,160,80,1,00478,India
199856,2023-06-25,1001,Lipstick,150,300,150,1,00478,India
457751,2023-06-25,1002,Mascara,200,400,200,1,00242,India
457751,2023-06-25,1006,Blush,150,300,150,1,00242,India
152953,2023-06-25,1008,Makeup Remover,80,160,80,1,00496,India
535002,2023-06-25,1009,Moisturizer,250,500,250,1,00056,India
535002,2023-06-25,1003,Foundation,300,600,300,1,00056,India
535002,2023-06-25,1005,Nail Polish,50,100,50,1,00056,India
535002,2023-06-25,1007,Eyeshadow,200,400,200,1,00056,India
593510,2023-06-25,1006,Blush,150,300,150,1,00007,India
593510,2023-06-25,1008,Makeup Remover,80,160,80,1,00007,India
593510,2023-06-25,1007,Eyeshadow,200,400,200,1,00007,India
350100,2023-06-25,1012,Body Lotion,200,400,200,1,00334,India
350100,2023-06-25,1009,Moisturizer,250,500,250,1,00334,India
412266,2023-06-25,1009,Moisturizer,250,500,250,1,00326,India
834843,2023-06-25,1008,Makeup Remover,80,160,80,1,00356,India
834843,2023-06-25,1005,Nail Polish,50,100,50,1,00356,India
190802,2023-06-25,1007,Eyeshadow,200,400,200,1,00014,India
190802,2023-06-25,1004,Eyeliner,100,200,100,1,00014,India
190802,2023-06-25,1002,Mascara,200,400,200,1,00014,India
670058,2023-06-25,1006,Blush,150,300,150,1,00258,India
670058,2023-06-25,1004,Eyeliner,100,200,100,1,00258,India
670058,2023-06-25,1007,Eyeshadow,200,400,200,1,00258,India
755319,2023-06-25,1008,Makeup Remover,80,160,80,1,00288,India
755319,2023-06-25,1006,Blush,150,300,150,1,00288,India
755319,2023-06-25,1001,Lipstick,150,300,150,1,00288,India
755319,2023-06-25,1004,Eyeliner,100,200,100,1,00288,India
519497,2023-06-25,1002,Mascara,200,400,200,1,00462,India
519497,2023-06-25,1012,Body Lotion,200,400,200,1,00462,India
702398,2023-06-25,1012,Body Lotion,200,400,200,1,00358,India
702398,2023-06-25,1005,Nail Polish,50,100,50,1,00358,India
702398,2023-06-25,1007,Eyeshadow,200,400,200,1,00358,India
576055,2023-06-25,1009,Moisturizer,250,500,250,1,00346,India
576055,2023-06-25,1003,Foundation,300,600,300,1,00346,India
576055,2023-06-25,1007,Eyeshadow,200,400,200,1,00346,India
438416,2023-06-25,1008,Makeup Remover,80,160,80,1,00163,India
438416,2023-06-25,1012,Body Lotion,200,400,200,1,00163,India
143075,2023-06-25,1008,Makeup Remover,80,160,80,1,00095,India
143075,2023-06-25,1003,Foundation,300,600,300,1,00095,India
143075,2023-06-25,1012,Body Lotion,200,400,200,1,00095,India
983303,2023-06-26,1009,Moisturizer,250,500,250,1,00359,India
732811,2023-06-26,1012,Body Lotion,200,400,200,1,00356,India
732811,2023-06-26,1004,Eyeliner,100,200,100,1,00356,India
428916,2023-06-26,1002,Mascara,200,400,200,1,00234,India
428916,2023-06-26,1003,Foundation,300,600,300,1,00234,India
877502,2023-06-26,1006,Blush,150,300,150,1,00018,India
220632,2023-06-26,1005,Nail Polish,50,100,50,1,00333,India
952592,2023-06-26,1005,Nail Polish,50,100,50,1,00438,India
952592,2023-06-26,1001,Lipstick,150,300,150,1,00438,India
952592,2023-06-26,1003,Foundation,300,600,300,1,00438,India
818277,2023-06-26,1003,Foundation,300,600,300,1,00321,India
818277,2023-06-26,1002,Mascara,200,400,200,1,00321,India
818277,2023-06-26,1005,Nail Polish,50,100,50,1,00321,India
818277,2023-06-26,1012,Body Lotion,200,400,200,1,00321,India
818277,2023-06-26,1009,Moisturizer,250,500,250,1,00321,India
279622,2023-06-26,1003,Foundation,300,600,300,1,00185,India
279622,2023-06-26,1005,Nail Polish,50,100,50,1,00185,India
279622,2023-06-26,1001,Lipstick,150,300,150,1,00185,India
785931,2023-06-26,1006,Blush,150,300,150,1,00148,India
445943,2023-06-26,1008,Makeup Remover,80,160,80,1,00022,India
445943,2023-06-26,1012,Body Lotion,200,400,200,1,00022,India
445943,2023-06-26,1004,Eyeliner,100,200,100,1,00022,India
445943,2023-06-26,1001,Lipstick,150,300,150,1,00022,India
445943,2023-06-26,1007,Eyeshadow,200,400,200,1,00022,India
763545,2023-06-26,1006,Blush,150,300,150,1,00467,India
763545,2023-06-26,1005,Nail Polish,50,100,50,1,00467,India
763545,2023-06-26,1007,Eyeshadow,200,400,200,1,00467,India
442364,2023-06-26,1005,Nail Polish,50,100,50,1,00373,India
442364,2023-06-26,1008,Makeup Remover,80,160,80,1,00373,India
952570,2023-06-26,1003,Foundation,300,600,300,1,00120,India
952570,2023-06-26,1001,Lipstick,150,300,150,1,00120,India
952570,2023-06-26,1002,Mascara,200,400,200,1,00120,India
907737,2023-06-26,1001,Lipstick,150,300,150,1,00271,India
907737,2023-06-26,1003,Foundation,300,600,300,1,00271,India
860399,2023-06-26,1002,Mascara,200,400,200,1,00457,India
860399,2023-06-26,1003,Foundation,300,600,300,1,00457,India
659294,2023-06-26,1002,Mascara,200,400,200,1,00136,India
282034,2023-06-26,1005,Nail Polish,50,100,50,1,00402,India
282034,2023-06-26,1003,Foundation,300,600,300,1,00402,India
282034,2023-06-26,1009,Moisturizer,250,500,250,1,00402,India
561216,2023-06-26,1003,Foundation,300,600,300,1,00482,India
563824,2023-06-26,1004,Eyeliner,100,200,100,1,00013,India
563824,2023-06-26,1001,Lipstick,150,300,150,1,00013,India
936271,2023-06-26,1009,Moisturizer,250,500,250,1,00313,India
519138,2023-06-26,1005,Nail Polish,50,100,50,1,00479,India
566842,2023-06-26,1005,Nail Polish,50,100,50,1,00063,India
566842,2023-06-26,1002,Mascara,200,400,200,1,00063,India
574590,2023-06-26,1005,Nail Polish,50,100,50,1,00317,India
574590,2023-06-26,1007,Eyeshadow,200,400,200,1,00317,India
950044,2023-06-26,1003,Foundation,300,600,300,1,00370,India
398478,2023-06-26,1002,Mascara,200,400,200,1,00264,India
398478,2023-06-26,1003,Foundation,300,600,300,1,00264,India
398478,2023-06-26,1012,Body Lotion,200,400,200,1,00264,India
811566,2023-06-26,1007,Eyeshadow,200,400,200,1,00299,India
811566,2023-06-26,1008,Makeup Remover,80,160,80,1,00299,India
811566,2023-06-26,1009,Moisturizer,250,500,250,1,00299,India
811566,2023-06-26,1012,Body Lotion,200,400,200,1,00299,India
477133,2023-06-26,1002,Mascara,200,400,200,1,00033,India
477133,2023-06-26,1009,Moisturizer,250,500,250,1,00033,India
766948,2023-06-26,1002,Mascara,200,400,200,1,00076,India
766948,2023-06-26,1005,Nail Polish,50,100,50,1,00076,India
766948,2023-06-26,1004,Eyeliner,100,200,100,1,00076,India
296713,2023-06-26,1001,Lipstick,150,300,150,1,00301,India
296713,2023-06-26,1012,Body Lotion,200,400,200,1,00301,India
296713,2023-06-26,1002,Mascara,200,400,200,1,00301,India
296713,2023-06-26,1009,Moisturizer,250,500,250,1,00301,India
296713,2023-06-26,1005,Nail Polish,50,100,50,1,00301,India
531210,2023-06-26,1003,Foundation,300,600,300,1,00430,India
531210,2023-06-26,1007,Eyeshadow,200,400,200,1,00430,India
168992,2023-06-26,1001,Lipstick,150,300,150,1,00355,India
168992,2023-06-26,1008,Makeup Remover,80,160,80,1,00355,India
168992,2023-06-26,1005,Nail Polish,50,100,50,1,00355,India
168992,2023-06-26,1003,Foundation,300,600,300,1,00355,India
210672,2023-06-26,1004,Eyeliner,100,200,100,1,00378,India
210672,2023-06-26,1002,Mascara,200,400,200,1,00378,India
210672,2023-06-26,1008,Makeup Remover,80,160,80,1,00378,India
262094,2023-06-26,1002,Mascara,200,400,200,1,00189,India
262094,2023-06-26,1005,Nail Polish,50,100,50,1,00189,India
262094,2023-06-26,1004,Eyeliner,100,200,100,1,00189,India
545557,2023-06-26,1001,Lipstick,150,300,150,1,00025,India
545557,2023-06-26,1006,Blush,150,300,150,1,00025,India
263874,2023-06-26,1007,Eyeshadow,200,400,200,1,00315,India
263874,2023-06-26,1003,Foundation,300,600,300,1,00315,India
806427,2023-06-26,1006,Blush,150,300,150,1,00291,India
806427,2023-06-26,1005,Nail Polish,50,100,50,1,00291,India
806427,2023-06-26,1007,Eyeshadow,200,400,200,1,00291,India
932024,2023-06-27,1005,Nail Polish,50,100,50,1,00493,India
747915,2023-06-27,1009,Moisturizer,250,500,250,1,00044,India
747915,2023-06-27,1012,Body Lotion,200,400,200,1,00044,India
108152,2023-06-27,1008,Makeup Remover,80,160,80,1,00040,India
108152,2023-06-27,1006,Blush,150,300,150,1,00040,India
108152,2023-06-27,1009,Moisturizer,250,500,250,1,00040,India
108152,2023-06-27,1004,Eyeliner,100,200,100,1,00040,India
360432,2023-06-27,1002,Mascara,200,400,200,1,00245,India
746146,2023-06-27,1009,Moisturizer,250,500,250,1,00180,India
746146,2023-06-27,1006,Blush,150,300,150,1,00180,India
746146,2023-06-27,1003,Foundation,300,600,300,1,00180,India
746146,2023-06-27,1008,Makeup Remover,80,160,80,1,00180,India
746146,2023-06-27,1012,Body Lotion,200,400,200,1,00180,India
326725,2023-06-27,1001,Lipstick,150,300,150,1,00183,India
326725,2023-06-27,1007,Eyeshadow,200,400,200,1,00183,India
326725,2023-06-27,1005,Nail Polish,50,100,50,1,00183,India
326725,2023-06-27,1003,Foundation,300,600,300,1,00183,India
669672,2023-06-27,1012,Body Lotion,200,400,200,1,00467,India
669672,2023-06-27,1003,Foundation,300,600,300,1,00467,India
669672,2023-06-27,1004,Eyeliner,100,200,100,1,00467,India
626075,2023-06-27,1008,Makeup Remover,80,160,80,1,00119,India
673241,2023-06-27,1001,Lipstick,150,300,150,1,00044,India
673241,2023-06-27,1005,Nail Polish,50,100,50,1,00044,India
673241,2023-06-27,1004,Eyeliner,100,200,100,1,00044,India
518592,2023-06-27,1003,Foundation,300,600,300,1,00084,India
518592,2023-06-27,1008,Makeup Remover,80,160,80,1,00084,India
987876,2023-06-27,1004,Eyeliner,100,200,100,1,00028,India
987876,2023-06-27,1007,Eyeshadow,200,400,200,1,00028,India
555066,2023-06-27,1012,Body Lotion,200,400,200,1,00416,India
555066,2023-06-27,1006,Blush,150,300,150,1,00416,India
555066,2023-06-27,1009,Moisturizer,250,500,250,1,00416,India
555066,2023-06-27,1005,Nail Polish,50,100,50,1,00416,India
947760,2023-06-27,1002,Mascara,200,400,200,1,00352,India
208308,2023-06-27,1001,Lipstick,150,300,150,1,00145,India
208308,2023-06-27,1003,Foundation,300,600,300,1,00145,India
268696,2023-06-27,1004,Eyeliner,100,200,100,1,00265,India
268696,2023-06-27,1002,Mascara,200,400,200,1,00265,India
268696,2023-06-27,1005,Nail Polish,50,100,50,1,00265,India
268696,2023-06-27,1009,Moisturizer,250,500,250,1,00265,India
106296,2023-06-27,1004,Eyeliner,100,200,100,1,00085,India
106296,2023-06-27,1001,Lipstick,150,300,150,1,00085,India
377865,2023-06-27,1003,Foundation,300,600,300,1,00061,India
377865,2023-06-27,1004,Eyeliner,100,200,100,1,00061,India
377865,2023-06-27,1002,Mascara,200,400,200,1,00061,India
180505,2023-06-27,1008,Makeup Remover,80,160,80,1,00467,India
180505,2023-06-27,1003,Foundation,300,600,300,1,00467,India
180505,2023-06-27,1009,Moisturizer,250,500,250,1,00467,India
472857,2023-06-27,1003,Foundation,300,600,300,1,00054,India
472857,2023-06-27,1001,Lipstick,150,300,150,1,00054,India
472857,2023-06-27,1007,Eyeshadow,200,400,200,1,00054,India
189743,2023-06-27,1008,Makeup Remover,80,160,80,1,00118,India
189743,2023-06-27,1012,Body Lotion,200,400,200,1,00118,India
189743,2023-06-27,1003,Foundation,300,600,300,1,00118,India
192117,2023-06-27,1009,Moisturizer,250,500,250,1,00374,India
192117,2023-06-27,1006,Blush,150,300,150,1,00374,India
769363,2023-06-27,1001,Lipstick,150,300,150,1,00332,India
769363,2023-06-27,1003,Foundation,300,600,300,1,00332,India
769363,2023-06-27,1005,Nail Polish,50,100,50,1,00332,India
769363,2023-06-27,1009,Moisturizer,250,500,250,1,00332,India
477074,2023-06-27,1012,Body Lotion,200,400,200,1,00269,India
361556,2023-06-27,1003,Foundation,300,600,300,1,00431,India
361556,2023-06-27,1004,Eyeliner,100,200,100,1,00431,India
361556,2023-06-27,1007,Eyeshadow,200,400,200,1,00431,India
361556,2023-06-27,1005,Nail Polish,50,100,50,1,00431,India
624881,2023-06-27,1002,Mascara,200,400,200,1,00043,India
333842,2023-06-27,1002,Mascara,200,400,200,1,00133,India
333842,2023-06-27,1003,Foundation,300,600,300,1,00133,India
855336,2023-06-27,1008,Makeup Remover,80,160,80,1,00031,India
855336,2023-06-27,1012,Body Lotion,200,400,200,1,00031,India
180239,2023-06-27,1001,Lipstick,150,300,150,1,00097,India
180239,2023-06-27,1006,Blush,150,300,150,1,00097,India
180239,2023-06-27,1002,Mascara,200,400,200,1,00097,India
298815,2023-06-27,1003,Foundation,300,600,300,1,00302,India
298815,2023-06-27,1005,Nail Polish,50,100,50,1,00302,India
298815,2023-06-27,1001,Lipstick,150,300,150,1,00302,India
585976,2023-06-27,1009,Moisturizer,250,500,250,1,00269,India
585976,2023-06-27,1006,Blush,150,300,150,1,00269,India
585976,2023-06-27,1001,Lipstick,150,300,150,1,00269,India
732175,2023-06-27,1004,Eyeliner,100,200,100,1,00123,India
732175,2023-06-27,1006,Blush,150,300,150,1,00123,India
907400,2023-06-27,1002,Mascara,200,400,200,1,00255,India
907400,2023-06-27,1005,Nail Polish,50,100,50,1,00255,India
359266,2023-06-27,1005,Nail Polish,50,100,50,1,00029,India
359266,2023-06-27,1008,Makeup Remover,80,160,80,1,00029,India
359266,2023-06-27,1006,Blush,150,300,150,1,00029,India
154940,2023-06-27,1012,Body Lotion,200,400,200,1,00350,India
154940,2023-06-27,1005,Nail Polish,50,100,50,1,00350,India
771945,2023-06-27,1009,Moisturizer,250,500,250,1,00257,India
771945,2023-06-27,1002,Mascara,200,400,200,1,00257,India
771945,2023-06-27,1008,Makeup Remover,80,160,80,1,00257,India
278407,2023-06-27,1009,Moisturizer,250,500,250,1,00418,India
278407,2023-06-27,1006,Blush,150,300,150,1,00418,India
278407,2023-06-27,1002,Mascara,200,400,200,1,00418,India
278407,2023-06-27,1005,Nail Polish,50,100,50,1,00418,India
864298,2023-06-27,1004,Eyeliner,100,200,100,1,00095,India
864298,2023-06-27,1012,Body Lotion,200,400,200,1,00095,India
864298,2023-06-27,1003,Foundation,300,600,300,1,00095,India
885883,2023-06-27,1008,Makeup Remover,80,160,80,1,00006,India
885883,2023-06-27,1005,Nail Polish,50,100,50,1,00006,India
808708,2023-06-27,1007,Eyeshadow,200,400,200,1,00126,India
808708,2023-06-27,1012,Body Lotion,200,400,200,1,00126,India
791323,2023-06-27,1005,Nail Polish,50,100,50,1,00344,India
791323,2023-06-27,1006,Blush,150,300,150,1,00344,India
791323,2023-06-27,1012,Body Lotion,200,400,200,1,00344,India
791323,2023-06-27,1008,Makeup Remover,80,160,80,1,00344,India
397502,2023-06-27,1001,Lipstick,150,300,150,1,00136,India
397502,2023-06-27,1008,Makeup Remover,80,160,80,1,00136,India
294147,2023-06-28,1012,Body Lotion,200,400,200,1,00226,India
919749,2023-06-28,1009,Moisturizer,250,500,250,1,00048,India
919749,2023-06-28,1001,Lipstick,150,300,150,1,00048,India
919749,2023-06-28,1002,Mascara,200,400,200,1,00048,India
919749,2023-06-28,1004,Eyeliner,100,200,100,1,00048,India
584527,2023-06-28,1009,Moisturizer,250,500,250,1,00337,India
675420,2023-06-28,1009,Moisturizer,250,500,250,1,00299,India
675420,2023-06-28,1002,Mascara,200,400,200,1,00299,India
521077,2023-06-28,1007,Eyeshadow,200,400,200,1,00386,India
521077,2023-06-28,1005,Nail Polish,50,100,50,1,00386,India
521077,2023-06-28,1004,Eyeliner,100,200,100,1,00386,India
691422,2023-06-28,1012,Body Lotion,200,400,200,1,00476,India
758801,2023-06-28,1006,Blush,150,300,150,1,00096,India
758801,2023-06-28,1005,Nail Polish,50,100,50,1,00096,India
644366,2023-06-28,1001,Lipstick,150,300,150,1,00434,India
644366,2023-06-28,1003,Foundation,300,600,300,1,00434,India
644366,2023-06-28,1006,Blush,150,300,150,1,00434,India
644366,2023-06-28,1012,Body Lotion,200,400,200,1,00434,India
137369,2023-06-28,1002,Mascara,200,400,200,1,00203,India
234980,2023-06-28,1009,Moisturizer,250,500,250,1,00294,India
234980,2023-06-28,1008,Makeup Remover,80,160,80,1,00294,India
234980,2023-06-28,1002,Mascara,200,400,200,1,00294,India
234980,2023-06-28,1001,Lipstick,150,300,150,1,00294,India
234980,2023-06-28,1006,Blush,150,300,150,1,00294,India
866941,2023-06-28,1003,Foundation,300,600,300,1,00210,India
936229,2023-06-28,1003,Foundation,300,600,300,1,00179,India
165711,2023-06-28,1009,Moisturizer,250,500,250,1,00390,India
795876,2023-06-28,1003,Foundation,300,600,300,1,00069,India
315783,2023-06-28,1007,Eyeshadow,200,400,200,1,00324,India
315783,2023-06-28,1002,Mascara,200,400,200,1,00324,India
315783,2023-06-28,1004,Eyeliner,100,200,100,1,00324,India
315783,2023-06-28,1005,Nail Polish,50,100,50,1,00324,India
315783,2023-06-28,1006,Blush,150,300,150,1,00324,India
812241,2023-06-28,1009,Moisturizer,250,500,250,1,00313,India
812241,2023-06-28,1004,Eyeliner,100,200,100,1,00313,India
821029,2023-06-28,1001,Lipstick,150,300,150,1,00414,India
821029,2023-06-28,1003,Foundation,300,600,300,1,00414,India
113830,2023-06-28,1004,Eyeliner,100,200,100,1,00196,India
897314,2023-06-28,1005,Nail Polish,50,100,50,1,00482,India
897314,2023-06-28,1001,Lipstick,150,300,150,1,00482,India
897314,2023-06-28,1012,Body Lotion,200,400,200,1,00482,India
897314,2023-06-28,1007,Eyeshadow,200,400,200,1,00482,India
897314,2023-06-28,1003,Foundation,300,600,300,1,00482,India
994618,2023-06-28,1005,Nail Polish,50,100,50,1,00427,India
994618,2023-06-28,1002,Mascara,200,400,200,1,00427,India
238894,2023-06-28,1006,Blush,150,300,150,1,00013,India
238894,2023-06-28,1003,Foundation,300,600,300,1,00013,India
181202,2023-06-28,1007,Eyeshadow,200,400,200,1,00233,India
181202,2023-06-28,1009,Moisturizer,250,500,250,1,00233,India
181202,2023-06-28,1003,Foundation,300,600,300,1,00233,India
256936,2023-06-28,1002,Mascara,200,400,200,1,00379,India
256936,2023-06-28,1003,Foundation,300,600,300,1,00379,India
256936,2023-06-28,1009,Moisturizer,250,500,250,1,00379,India
147176,2023-06-28,1004,Eyeliner,100,200,100,1,00293,India
684432,2023-06-28,1002,Mascara,200,400,200,1,00324,India
684432,2023-06-28,1009,Moisturizer,250,500,250,1,00324,India
684432,2023-06-28,1001,Lipstick,150,300,150,1,00324,India
684432,2023-06-28,1007,Eyeshadow,200,400,200,1,00324,India
684432,2023-06-28,1012,Body Lotion,200,400,200,1,00324,India
965331,2023-06-28,1004,Eyeliner,100,200,100,1,00123,India
687530,2023-06-28,1012,Body Lotion,200,400,200,1,00019,India
687530,2023-06-28,1001,Lipstick,150,300,150,1,00019,India
687530,2023-06-28,1005,Nail Polish,50,100,50,1,00019,India
687530,2023-06-28,1007,Eyeshadow,200,400,200,1,00019,India
705454,2023-06-28,1005,Nail Polish,50,100,50,1,00305,India
554228,2023-06-28,1004,Eyeliner,100,200,100,1,00118,India
733291,2023-06-28,1003,Foundation,300,600,300,1,00066,India
733291,2023-06-28,1004,Eyeliner,100,200,100,1,00066,India
733291,2023-06-28,1009,Moisturizer,250,500,250,1,00066,India
733291,2023-06-28,1007,Eyeshadow,200,400,200,1,00066,India
733291,2023-06-28,1005,Nail Polish,50,100,50,1,00066,India
973029,2023-06-28,1005,Nail Polish,50,100,50,1,00301,India
973029,2023-06-28,1006,Blush,150,300,150,1,00301,India
245147,2023-06-28,1008,Makeup Remover,80,160,80,1,00251,India
245147,2023-06-28,1006,Blush,150,300,150,1,00251,India
739164,2023-06-28,1012,Body Lotion,200,400,200,1,00049,India
739164,2023-06-28,1006,Blush,150,300,150,1,00049,India
739164,2023-06-28,1008,Makeup Remover,80,160,80,1,00049,India
739164,2023-06-28,1009,Moisturizer,250,500,250,1,00049,India
418507,2023-06-29,1004,Eyeliner,100,200,100,1,00344,India
418507,2023-06-29,1002,Mascara,200,400,200,1,00344,India
418507,2023-06-29,1006,Blush,150,300,150,1,00344,India
418507,2023-06-29,1005,Nail Polish,50,100,50,1,00344,India
317299,2023-06-29,1004,Eyeliner,100,200,100,1,00273,India
317299,2023-06-29,1008,Makeup Remover,80,160,80,1,00273,India
813982,2023-06-29,1006,Blush,150,300,150,1,00335,India
813982,2023-06-29,1004,Eyeliner,100,200,100,1,00335,India
430123,2023-06-29,1012,Body Lotion,200,400,200,1,00020,India
430123,2023-06-29,1006,Blush,150,300,150,1,00020,India
430123,2023-06-29,1002,Mascara,200,400,200,1,00020,India
430123,2023-06-29,1008,Makeup Remover,80,160,80,1,00020,India
850690,2023-06-29,1005,Nail Polish,50,100,50,1,00170,India
850690,2023-06-29,1008,Makeup Remover,80,160,80,1,00170,India
850690,2023-06-29,1001,Lipstick,150,300,150,1,00170,India
850690,2023-06-29,1003,Foundation,300,600,300,1,00170,India
426673,2023-06-29,1012,Body Lotion,200,400,200,1,00029,India
986364,2023-06-29,1012,Body Lotion,200,400,200,1,00485,India
986364,2023-06-29,1008,Makeup Remover,80,160,80,1,00485,India
986364,2023-06-29,1007,Eyeshadow,200,400,200,1,00485,India
986364,2023-06-29,1005,Nail Polish,50,100,50,1,00485,India
217129,2023-06-29,1005,Nail Polish,50,100,50,1,00457,India
217129,2023-06-29,1007,Eyeshadow,200,400,200,1,00457,India
302933,2023-06-29,1003,Foundation,300,600,300,1,00127,India
302933,2023-06-29,1002,Mascara,200,400,200,1,00127,India
371024,2023-06-29,1008,Makeup Remover,80,160,80,1,00479,India
371024,2023-06-29,1004,Eyeliner,100,200,100,1,00479,India
371024,2023-06-29,1001,Lipstick,150,300,150,1,00479,India
371024,2023-06-29,1007,Eyeshadow,200,400,200,1,00479,India
823798,2023-06-29,1012,Body Lotion,200,400,200,1,00480,India
823798,2023-06-29,1004,Eyeliner,100,200,100,1,00480,India
236338,2023-06-29,1003,Foundation,300,600,300,1,00156,India
236338,2023-06-29,1008,Makeup Remover,80,160,80,1,00156,India
236338,2023-06-29,1009,Moisturizer,250,500,250,1,00156,India
236338,2023-06-29,1004,Eyeliner,100,200,100,1,00156,India
195893,2023-06-29,1012,Body Lotion,200,400,200,1,00145,India
195893,2023-06-29,1006,Blush,150,300,150,1,00145,India
195893,2023-06-29,1008,Makeup Remover,80,160,80,1,00145,India
724206,2023-06-29,1006,Blush,150,300,150,1,00453,India
676037,2023-06-29,1004,Eyeliner,100,200,100,1,00265,India
676037,2023-06-29,1003,Foundation,300,600,300,1,00265,India
676037,2023-06-29,1007,Eyeshadow,200,400,200,1,00265,India
676037,2023-06-29,1008,Makeup Remover,80,160,80,1,00265,India
676037,2023-06-29,1001,Lipstick,150,300,150,1,00265,India
267107,2023-06-29,1008,Makeup Remover,80,160,80,1,00354,India
719010,2023-06-29,1002,Mascara,200,400,200,1,00289,India
719010,2023-06-29,1001,Lipstick,150,300,150,1,00289,India
998711,2023-06-29,1012,Body Lotion,200,400,200,1,00232,India
397250,2023-06-29,1012,Body Lotion,200,400,200,1,00092,India
397250,2023-06-29,1005,Nail Polish,50,100,50,1,00092,India
172414,2023-06-29,1012,Body Lotion,200,400,200,1,00332,India
435175,2023-06-29,1006,Blush,150,300,150,1,00472,India
435175,2023-06-29,1002,Mascara,200,400,200,1,00472,India
435175,2023-06-29,1012,Body Lotion,200,400,200,1,00472,India
392952,2023-06-29,1008,Makeup Remover,80,160,80,1,00496,India
392952,2023-06-29,1012,Body Lotion,200,400,200,1,00496,India
392952,2023-06-29,1009,Moisturizer,250,500,250,1,00496,India
392952,2023-06-29,1002,Mascara,200,400,200,1,00496,India
469338,2023-06-29,1005,Nail Polish,50,100,50,1,00420,India
469338,2023-06-29,1003,Foundation,300,600,300,1,00420,India
469338,2023-06-29,1002,Mascara,200,400,200,1,00420,India
797955,2023-06-29,1009,Moisturizer,250,500,250,1,00458,India
797955,2023-06-29,1004,Eyeliner,100,200,100,1,00458,India
797955,2023-06-29,1002,Mascara,200,400,200,1,00458,India
797955,2023-06-29,1001,Lipstick,150,300,150,1,00458,India
184283,2023-06-29,1002,Mascara,200,400,200,1,00074,India
551257,2023-06-29,1007,Eyeshadow,200,400,200,1,00374,India
551257,2023-06-29,1009,Moisturizer,250,500,250,1,00374,India
551257,2023-06-29,1003,Foundation,300,600,300,1,00374,India
551257,2023-06-29,1005,Nail Polish,50,100,50,1,00374,India
356183,2023-06-29,1007,Eyeshadow,200,400,200,1,00166,India
356183,2023-06-29,1003,Foundation,300,600,300,1,00166,India
356183,2023-06-29,1012,Body Lotion,200,400,200,1,00166,India
947046,2023-06-29,1012,Body Lotion,200,400,200,1,00188,India
947046,2023-06-29,1002,Mascara,200,400,200,1,00188,India
947046,2023-06-29,1008,Makeup Remover,80,160,80,1,00188,India
749178,2023-06-29,1012,Body Lotion,200,400,200,1,00226,India
749178,2023-06-29,1007,Eyeshadow,200,400,200,1,00226,India
749178,2023-06-29,1002,Mascara,200,400,200,1,00226,India
259338,2023-06-29,1003,Foundation,300,600,300,1,00490,India
259338,2023-06-29,1012,Body Lotion,200,400,200,1,00490,India
918879,2023-06-29,1012,Body Lotion,200,400,200,1,00175,India
918879,2023-06-29,1009,Moisturizer,250,500,250,1,00175,India
766866,2023-06-29,1006,Blush,150,300,150,1,00238,India
790139,2023-06-29,1012,Body Lotion,200,400,200,1,00240,India
433035,2023-06-29,1008,Makeup Remover,80,160,80,1,00017,India
433035,2023-06-29,1001,Lipstick,150,300,150,1,00017,India
433035,2023-06-29,1012,Body Lotion,200,400,200,1,00017,India
433035,2023-06-29,1009,Moisturizer,250,500,250,1,00017,India
171765,2023-06-30,1002,Mascara,200,400,200,1,00295,India
171765,2023-06-30,1012,Body Lotion,200,400,200,1,00295,India
171765,2023-06-30,1005,Nail Polish,50,100,50,1,00295,India
171765,2023-06-30,1003,Foundation,300,600,300,1,00295,India
171765,2023-06-30,1008,Makeup Remover,80,160,80,1,00295,India
884409,2023-06-30,1002,Mascara,200,400,200,1,00316,India
884409,2023-06-30,1001,Lipstick,150,300,150,1,00316,India
445725,2023-06-30,1012,Body Lotion,200,400,200,1,00486,India
966030,2023-06-30,1001,Lipstick,150,300,150,1,00239,India
966030,2023-06-30,1002,Mascara,200,400,200,1,00239,India
966030,2023-06-30,1003,Foundation,300,600,300,1,00239,India
966030,2023-06-30,1009,Moisturizer,250,500,250,1,00239,India
199532,2023-06-30,1012,Body Lotion,200,400,200,1,00385,India
199532,2023-06-30,1007,Eyeshadow,200,400,200,1,00385,India
199532,2023-06-30,1006,Blush,150,300,150,1,00385,India
199532,2023-06-30,1001,Lipstick,150,300,150,1,00385,India
222181,2023-06-30,1004,Eyeliner,100,200,100,1,00458,India
222181,2023-06-30,1009,Moisturizer,250,500,250,1,00458,India
222181,2023-06-30,1006,Blush,150,300,150,1,00458,India
222181,2023-06-30,1012,Body Lotion,200,400,200,1,00458,India
889786,2023-06-30,1008,Makeup Remover,80,160,80,1,00157,India
132772,2023-06-30,1009,Moisturizer,250,500,250,1,00383,India
132772,2023-06-30,1002,Mascara,200,400,200,1,00383,India
132772,2023-06-30,1008,Makeup Remover,80,160,80,1,00383,India
132772,2023-06-30,1012,Body Lotion,200,400,200,1,00383,India
132772,2023-06-30,1007,Eyeshadow,200,400,200,1,00383,India
783154,2023-06-30,1001,Lipstick,150,300,150,1,00157,India
783154,2023-06-30,1005,Nail Polish,50,100,50,1,00157,India
783154,2023-06-30,1008,Makeup Remover,80,160,80,1,00157,India
783154,2023-06-30,1009,Moisturizer,250,500,250,1,00157,India
755408,2023-06-30,1004,Eyeliner,100,200,100,1,00334,India
755408,2023-06-30,1012,Body Lotion,200,400,200,1,00334,India
116189,2023-06-30,1007,Eyeshadow,200,400,200,1,00418,India
116189,2023-06-30,1001,Lipstick,150,300,150,1,00418,India
329573,2023-06-30,1008,Makeup Remover,80,160,80,1,00166,India
329573,2023-06-30,1004,Eyeliner,100,200,100,1,00166,India
329573,2023-06-30,1006,Blush,150,300,150,1,00166,India
329573,2023-06-30,1012,Body Lotion,200,400,200,1,00166,India
722895,2023-06-30,1005,Nail Polish,50,100,50,1,00286,India
722895,2023-06-30,1006,Blush,150,300,150,1,00286,India
722895,2023-06-30,1004,Eyeliner,100,200,100,1,00286,India
722895,2023-06-30,1008,Makeup Remover,80,160,80,1,00286,India
448275,2023-06-30,1008,Makeup Remover,80,160,80,1,00422,India
448275,2023-06-30,1004,Eyeliner,100,200,100,1,00422,India
448275,2023-06-30,1005,Nail Polish,50,100,50,1,00422,India
448275,2023-06-30,1007,Eyeshadow,200,400,200,1,00422,India
448275,2023-06-30,1012,Body Lotion,200,400,200,1,00422,India
658841,2023-06-30,1003,Foundation,300,600,300,1,00357,India
658841,2023-06-30,1009,Moisturizer,250,500,250,1,00357,India
658841,2023-06-30,1004,Eyeliner,100,200,100,1,00357,India
553647,2023-06-30,1001,Lipstick,150,300,150,1,00399,India
553647,2023-06-30,1002,Mascara,200,400,200,1,00399,India
553647,2023-06-30,1006,Blush,150,300,150,1,00399,India
806292,2023-06-30,1004,Eyeliner,100,200,100,1,00235,India
806292,2023-06-30,1012,Body Lotion,200,400,200,1,00235,India
806292,2023-06-30,1006,Blush,150,300,150,1,00235,India
707353,2023-06-30,1003,Foundation,300,600,300,1,00103,India
707353,2023-06-30,1004,Eyeliner,100,200,100,1,00103,India
707353,2023-06-30,1007,Eyeshadow,200,400,200,1,00103,India
707353,2023-06-30,1006,Blush,150,300,150,1,00103,India
912359,2023-06-30,1008,Makeup Remover,80,160,80,1,00463,India
912359,2023-06-30,1003,Foundation,300,600,300,1,00463,India
912359,2023-06-30,1004,Eyeliner,100,200,100,1,00463,India
912359,2023-06-30,1006,Blush,150,300,150,1,00463,India
912359,2023-06-30,1007,Eyeshadow,200,400,200,1,00463,India
748947,2023-06-30,1005,Nail Polish,50,100,50,1,00369,India
748947,2023-06-30,1012,Body Lotion,200,400,200,1,00369,India
748947,2023-06-30,1004,Eyeliner,100,200,100,1,00369,India
748947,2023-06-30,1009,Moisturizer,250,500,250,1,00369,India
748947,2023-06-30,1008,Makeup Remover,80,160,80,1,00369,India
481262,2023-06-30,1006,Blush,150,300,150,1,00139,India
481262,2023-06-30,1002,Mascara,200,400,200,1,00139,India
481262,2023-06-30,1007,Eyeshadow,200,400,200,1,00139,India
588645,2023-06-30,1002,Mascara,200,400,200,1,00197,India
588645,2023-06-30,1003,Foundation,300,600,300,1,00197,India
588645,2023-06-30,1001,Lipstick,150,300,150,1,00197,India
947545,2023-06-30,1008,Makeup Remover,80,160,80,1,00162,India
947545,2023-06-30,1001,Lipstick,150,300,150,1,00162,India
594579,2023-06-30,1007,Eyeshadow,200,400,200,1,00128,India
594579,2023-06-30,1004,Eyeliner,100,200,100,1,00128,India
899386,2023-06-30,1001,Lipstick,150,300,150,1,00248,India
899386,2023-06-30,1003,Foundation,300,600,300,1,00248,India
775116,2023-06-30,1001,Lipstick,150,300,150,1,00444,India
775116,2023-06-30,1005,Nail Polish,50,100,50,1,00444,India
775116,2023-06-30,1008,Makeup Remover,80,160,80,1,00444,India
775116,2023-06-30,1012,Body Lotion,200,400,200,1,00444,India
496517,2023-06-30,1004,Eyeliner,100,200,100,1,00449,India
496517,2023-06-30,1005,Nail Polish,50,100,50,1,00449,India
496517,2023-06-30,1006,Blush,150,300,150,1,00449,India
883350,2023-06-30,1009,Moisturizer,250,500,250,1,00423,India
883350,2023-06-30,1008,Makeup Remover,80,160,80,1,00423,India
883350,2023-06-30,1005,Nail Polish,50,100,50,1,00423,India
883350,2023-06-30,1003,Foundation,300,600,300,1,00423,India
775474,2023-06-30,1004,Eyeliner,100,200,100,1,00241,India
775474,2023-06-30,1008,Makeup Remover,80,160,80,1,00241,India
775474,2023-06-30,1001,Lipstick,150,300,150,1,00241,India
775474,2023-06-30,1005,Nail Polish,50,100,50,1,00241,India
649285,2023-06-30,1003,Foundation,300,600,300,1,00421,India
649285,2023-06-30,1008,Makeup Remover,80,160,80,1,00421,India
793596,2023-06-30,1007,Eyeshadow,200,400,200,1,00305,India
793596,2023-06-30,1009,Moisturizer,250,500,250,1,00305,India
335664,2023-06-30,1006,Blush,150,300,150,1,00194,India
224392,2023-06-30,1007,Eyeshadow,200,400,200,1,00373,India
224392,2023-06-30,1012,Body Lotion,200,400,200,1,00373,India
145557,2023-06-30,1001,Lipstick,150,300,150,1,00021,India
145557,2023-06-30,1006,Blush,150,300,150,1,00021,India
145557,2023-06-30,1005,Nail Polish,50,100,50,1,00021,India
971436,2023-06-30,1001,Lipstick,150,300,150,1,00143,India
971436,2023-06-30,1006,Blush,150,300,150,1,00143,India
971436,2023-06-30,1008,Makeup Remover,80,160,80,1,00143,India
633468,2023-06-30,1003,Foundation,300,600,300,1,00059,India
633468,2023-06-30,1002,Mascara,200,400,200,1,00059,India
330785,2023-06-30,1008,Makeup Remover,80,160,80,1,00306,India
330785,2023-06-30,1001,Lipstick,150,300,150,1,00306,India
698914,2023-06-30,1005,Nail Polish,50,100,50,1,00224,India
698914,2023-06-30,1006,Blush,150,300,150,1,00224,India
698914,2023-06-30,1008,Makeup Remover,80,160,80,1,00224,India
508719,2023-06-30,1003,Foundation,300,600,300,1,00368,India
508719,2023-06-30,1012,Body Lotion,200,400,200,1,00368,India
508719,2023-06-30,1005,Nail Polish,50,100,50,1,00368,India
924767,2023-06-30,1005,Nail Polish,50,100,50,1,00271,India
924767,2023-06-30,1006,Blush,150,300,150,1,00271,India
924767,2023-06-30,1002,Mascara,200,400,200,1,00271,India
747804,2023-06-30,1002,Mascara,200,400,200,1,00059,India
747804,2023-06-30,1003,Foundation,300,600,300,1,00059,India
747804,2023-06-30,1001,Lipstick,150,300,150,1,00059,India
747804,2023-06-30,1005,Nail Polish,50,100,50,1,00059,India
429162,2023-06-30,1005,Nail Polish,50,100,50,1,00351,India
429162,2023-06-30,1002,Mascara,200,400,200,1,00351,India
429162,2023-06-30,1009,Moisturizer,250,500,250,1,00351,India
429162,2023-06-30,1012,Body Lotion,200,400,200,1,00351,India
836726,2023-06-30,1004,Eyeliner,100,200,100,1,00086,India
836726,2023-06-30,1002,Mascara,200,400,200,1,00086,India
836726,2023-06-30,1001,Lipstick,150,300,150,1,00086,India
152583,2023-06-30,1002,Mascara,200,400,200,1,00079,India
152583,2023-06-30,1005,Nail Polish,50,100,50,1,00079,India
152583,2023-06-30,1009,Moisturizer,250,500,250,1,00079,India
152583,2023-06-30,1006,Blush,150,300,150,1,00079,India
462980,2023-07-01,1008,Makeup Remover,80,160,80,1,00078,India
462980,2023-07-01,1004,Eyeliner,100,200,100,1,00078,India
246992,2023-07-01,1007,Eyeshadow,200,400,200,1,00430,India
246992,2023-07-01,1005,Nail Polish,50,100,50,1,00430,India
246992,2023-07-01,1009,Moisturizer,250,500,250,1,00430,India
135373,2023-07-01,1005,Nail Polish,50,100,50,1,00405,India
135373,2023-07-01,1002,Mascara,200,400,200,1,00405,India
135373,2023-07-01,1004,Eyeliner,100,200,100,1,00405,India
135373,2023-07-01,1007,Eyeshadow,200,400,200,1,00405,India
960752,2023-07-01,1006,Blush,150,300,150,1,00245,India
960752,2023-07-01,1007,Eyeshadow,200,400,200,1,00245,India
960752,2023-07-01,1005,Nail Polish,50,100,50,1,00245,India
960752,2023-07-01,1001,Lipstick,150,300,150,1,00245,India
483595,2023-07-01,1006,Blush,150,300,150,1,00438,India
483595,2023-07-01,1003,Foundation,300,600,300,1,00438,India
231376,2023-07-01,1005,Nail Polish,50,100,50,1,00041,India
708192,2023-07-01,1005,Nail Polish,50,100,50,1,00478,India
708192,2023-07-01,1002,Mascara,200,400,200,1,00478,India
949639,2023-07-01,1012,Body Lotion,200,400,200,1,00206,India
949639,2023-07-01,1008,Makeup Remover,80,160,80,1,00206,India
949639,2023-07-01,1007,Eyeshadow,200,400,200,1,00206,India
401776,2023-07-01,1007,Eyeshadow,200,400,200,1,00063,India
401776,2023-07-01,1009,Moisturizer,250,500,250,1,00063,India
401776,2023-07-01,1002,Mascara,200,400,200,1,00063,India
839140,2023-07-01,1008,Makeup Remover,80,160,80,1,00263,India
839140,2023-07-01,1006,Blush,150,300,150,1,00263,India
214652,2023-07-01,1006,Blush,150,300,150,1,00244,India
988096,2023-07-01,1012,Body Lotion,200,400,200,1,00037,India
988096,2023-07-01,1001,Lipstick,150,300,150,1,00037,India
988096,2023-07-01,1008,Makeup Remover,80,160,80,1,00037,India
988096,2023-07-01,1004,Eyeliner,100,200,100,1,00037,India
348025,2023-07-01,1003,Foundation,300,600,300,1,00210,India
348025,2023-07-01,1006,Blush,150,300,150,1,00210,India
348025,2023-07-01,1001,Lipstick,150,300,150,1,00210,India
348025,2023-07-01,1007,Eyeshadow,200,400,200,1,00210,India
348025,2023-07-01,1008,Makeup Remover,80,160,80,1,00210,India
601145,2023-07-01,1003,Foundation,300,600,300,1,00086,India
601145,2023-07-01,1006,Blush,150,300,150,1,00086,India
601145,2023-07-01,1002,Mascara,200,400,200,1,00086,India
601145,2023-07-01,1004,Eyeliner,100,200,100,1,00086,India
709723,2023-07-01,1002,Mascara,200,400,200,1,00460,India
709723,2023-07-01,1012,Body Lotion,200,400,200,1,00460,India
709723,2023-07-01,1003,Foundation,300,600,300,1,00460,India
709723,2023-07-01,1006,Blush,150,300,150,1,00460,India
709723,2023-07-01,1009,Moisturizer,250,500,250,1,00460,India
909409,2023-07-01,1004,Eyeliner,100,200,100,1,00067,India
909409,2023-07-01,1002,Mascara,200,400,200,1,00067,India
909409,2023-07-01,1008,Makeup Remover,80,160,80,1,00067,India
909409,2023-07-01,1006,Blush,150,300,150,1,00067,India
909409,2023-07-01,1009,Moisturizer,250,500,250,1,00067,India
522540,2023-07-01,1004,Eyeliner,100,200,100,1,00217,India
522540,2023-07-01,1007,Eyeshadow,200,400,200,1,00217,India
244052,2023-07-01,1001,Lipstick,150,300,150,1,00305,India
244052,2023-07-01,1005,Nail Polish,50,100,50,1,00305,India
244052,2023-07-01,1008,Makeup Remover,80,160,80,1,00305,India
825767,2023-07-01,1005,Nail Polish,50,100,50,1,00028,India
825767,2023-07-01,1006,Blush,150,300,150,1,00028,India
210270,2023-07-01,1007,Eyeshadow,200,400,200,1,00297,India
210270,2023-07-01,1001,Lipstick,150,300,150,1,00297,India
210270,2023-07-01,1004,Eyeliner,100,200,100,1,00297,India
210270,2023-07-01,1008,Makeup Remover,80,160,80,1,00297,India
219745,2023-07-01,1001,Lipstick,150,300,150,1,00150,India
219745,2023-07-01,1003,Foundation,300,600,300,1,00150,India
261577,2023-07-01,1009,Moisturizer,250,500,250,1,00479,India
261577,2023-07-01,1004,Eyeliner,100,200,100,1,00479,India
261577,2023-07-01,1008,Makeup Remover,80,160,80,1,00479,India
888266,2023-07-01,1004,Eyeliner,100,200,100,1,00271,India
209095,2023-07-01,1004,Eyeliner,100,200,100,1,00453,India
209095,2023-07-01,1012,Body Lotion,200,400,200,1,00453,India
209095,2023-07-01,1003,Foundation,300,600,300,1,00453,India
647103,2023-07-01,1012,Body Lotion,200,400,200,1,00422,India
647103,2023-07-01,1007,Eyeshadow,200,400,200,1,00422,India
647103,2023-07-01,1006,Blush,150,300,150,1,00422,India
647103,2023-07-01,1001,Lipstick,150,300,150,1,00422,India
647103,2023-07-01,1004,Eyeliner,100,200,100,1,00422,India
850252,2023-07-01,1007,Eyeshadow,200,400,200,1,00135,India
406279,2023-07-01,1012,Body Lotion,200,400,200,1,00055,India
418094,2023-07-01,1007,Eyeshadow,200,400,200,1,00034,India
102981,2023-07-01,1005,Nail Polish,50,100,50,1,00072,India
839014,2023-07-01,1003,Foundation,300,600,300,1,00006,India
839014,2023-07-01,1006,Blush,150,300,150,1,00006,India
880760,2023-07-01,1001,Lipstick,150,300,150,1,00223,India
880760,2023-07-01,1004,Eyeliner,100,200,100,1,00223,India
637220,2023-07-01,1005,Nail Polish,50,100,50,1,00454,India
637220,2023-07-01,1002,Mascara,200,400,200,1,00454,India
637220,2023-07-01,1009,Moisturizer,250,500,250,1,00454,India
637220,2023-07-01,1008,Makeup Remover,80,160,80,1,00454,India
659100,2023-07-01,1004,Eyeliner,100,200,100,1,00071,India
659100,2023-07-01,1012,Body Lotion,200,400,200,1,00071,India
659100,2023-07-01,1001,Lipstick,150,300,150,1,00071,India
659100,2023-07-01,1002,Mascara,200,400,200,1,00071,India
658719,2023-07-01,1003,Foundation,300,600,300,1,00191,India
658719,2023-07-01,1012,Body Lotion,200,400,200,1,00191,India
658719,2023-07-01,1006,Blush,150,300,150,1,00191,India
658719,2023-07-01,1002,Mascara,200,400,200,1,00191,India
522815,2023-07-01,1009,Moisturizer,250,500,250,1,00239,India
522815,2023-07-01,1005,Nail Polish,50,100,50,1,00239,India
522815,2023-07-01,1006,Blush,150,300,150,1,00239,India
522815,2023-07-01,1007,Eyeshadow,200,400,200,1,00239,India
522815,2023-07-01,1004,Eyeliner,100,200,100,1,00239,India
894372,2023-07-01,1006,Blush,150,300,150,1,00131,India
170076,2023-07-01,1012,Body Lotion,200,400,200,1,00484,India
170076,2023-07-01,1008,Makeup Remover,80,160,80,1,00484,India
257665,2023-07-01,1006,Blush,150,300,150,1,00047,India
257665,2023-07-01,1012,Body Lotion,200,400,200,1,00047,India
916930,2023-07-01,1004,Eyeliner,100,200,100,1,00117,India
916930,2023-07-01,1002,Mascara,200,400,200,1,00117,India
916930,2023-07-01,1001,Lipstick,150,300,150,1,00117,India
916930,2023-07-01,1008,Makeup Remover,80,160,80,1,00117,India
701867,2023-07-01,1004,Eyeliner,100,200,100,1,00463,India
701867,2023-07-01,1007,Eyeshadow,200,400,200,1,00463,India
701867,2023-07-01,1006,Blush,150,300,150,1,00463,India
701867,2023-07-01,1001,Lipstick,150,300,150,1,00463,India
200266,2023-07-01,1008,Makeup Remover,80,160,80,1,00349,India
200266,2023-07-01,1001,Lipstick,150,300,150,1,00349,India
767190,2023-07-01,1006,Blush,150,300,150,1,00313,India
413959,2023-07-01,1005,Nail Polish,50,100,50,1,00068,India
413959,2023-07-01,1008,Makeup Remover,80,160,80,1,00068,India
413959,2023-07-01,1001,Lipstick,150,300,150,1,00068,India
115028,2023-07-01,1002,Mascara,200,400,200,1,00097,India
115028,2023-07-01,1006,Blush,150,300,150,1,00097,India
115028,2023-07-01,1001,Lipstick,150,300,150,1,00097,India
418312,2023-07-01,1002,Mascara,200,400,200,1,00321,India
418312,2023-07-01,1009,Moisturizer,250,500,250,1,00321,India
931111,2023-07-01,1005,Nail Polish,50,100,50,1,00397,India
931111,2023-07-01,1004,Eyeliner,100,200,100,1,00397,India
861141,2023-07-01,1005,Nail Polish,50,100,50,1,00279,India
861141,2023-07-01,1008,Makeup Remover,80,160,80,1,00279,India
966030,2023-07-02,1008,Makeup Remover,80,160,80,1,00239,India
162672,2023-07-02,1009,Moisturizer,250,500,250,1,00357,India
162672,2023-07-02,1001,Lipstick,150,300,150,1,00357,India
162672,2023-07-02,1008,Makeup Remover,80,160,80,1,00357,India
162672,2023-07-02,1005,Nail Polish,50,100,50,1,00357,India
413668,2023-07-02,1007,Eyeshadow,200,400,200,1,00019,India
413668,2023-07-02,1004,Eyeliner,100,200,100,1,00019,India
413668,2023-07-02,1003,Foundation,300,600,300,1,00019,India
705508,2023-07-02,1012,Body Lotion,200,400,200,1,00133,India
705508,2023-07-02,1005,Nail Polish,50,100,50,1,00133,India
798221,2023-07-02,1007,Eyeshadow,200,400,200,1,00271,India
798221,2023-07-02,1008,Makeup Remover,80,160,80,1,00271,India
798221,2023-07-02,1003,Foundation,300,600,300,1,00271,India
798221,2023-07-02,1012,Body Lotion,200,400,200,1,00271,India
584134,2023-07-02,1008,Makeup Remover,80,160,80,1,00229,India
372906,2023-07-02,1012,Body Lotion,200,400,200,1,00128,India
116094,2023-07-02,1004,Eyeliner,100,200,100,1,00216,India
853707,2023-07-02,1012,Body Lotion,200,400,200,1,00099,India
434354,2023-07-02,1003,Foundation,300,600,300,1,00053,India
434354,2023-07-02,1009,Moisturizer,250,500,250,1,00053,India
434354,2023-07-02,1001,Lipstick,150,300,150,1,00053,India
926436,2023-07-02,1007,Eyeshadow,200,400,200,1,00408,India
926436,2023-07-02,1008,Makeup Remover,80,160,80,1,00408,India
926436,2023-07-02,1001,Lipstick,150,300,150,1,00408,India
277301,2023-07-02,1005,Nail Polish,50,100,50,1,00013,India
597520,2023-07-02,1006,Blush,150,300,150,1,00216,India
893468,2023-07-02,1003,Foundation,300,600,300,1,00445,India
233786,2023-07-02,1007,Eyeshadow,200,400,200,1,00386,India
233786,2023-07-02,1002,Mascara,200,400,200,1,00386,India
233786,2023-07-02,1004,Eyeliner,100,200,100,1,00386,India
926940,2023-07-02,1003,Foundation,300,600,300,1,00010,India
926940,2023-07-02,1001,Lipstick,150,300,150,1,00010,India
926940,2023-07-02,1006,Blush,150,300,150,1,00010,India
926940,2023-07-02,1008,Makeup Remover,80,160,80,1,00010,India
926940,2023-07-02,1012,Body Lotion,200,400,200,1,00010,India
256998,2023-07-02,1005,Nail Polish,50,100,50,1,00009,India
256998,2023-07-02,1002,Mascara,200,400,200,1,00009,India
740959,2023-07-02,1012,Body Lotion,200,400,200,1,00442,India
331876,2023-07-02,1004,Eyeliner,100,200,100,1,00035,India
331876,2023-07-02,1001,Lipstick,150,300,150,1,00035,India
331876,2023-07-02,1009,Moisturizer,250,500,250,1,00035,India
761616,2023-07-02,1003,Foundation,300,600,300,1,00457,India
761616,2023-07-02,1004,Eyeliner,100,200,100,1,00457,India
761616,2023-07-02,1012,Body Lotion,200,400,200,1,00457,India
761616,2023-07-02,1008,Makeup Remover,80,160,80,1,00457,India
322016,2023-07-02,1002,Mascara,200,400,200,1,00160,India
322016,2023-07-02,1006,Blush,150,300,150,1,00160,India
322016,2023-07-02,1012,Body Lotion,200,400,200,1,00160,India
322016,2023-07-02,1003,Foundation,300,600,300,1,00160,India
374295,2023-07-02,1006,Blush,150,300,150,1,00359,India
789426,2023-07-02,1005,Nail Polish,50,100,50,1,00230,India
789426,2023-07-02,1009,Moisturizer,250,500,250,1,00230,India
589132,2023-07-02,1009,Moisturizer,250,500,250,1,00461,India
589132,2023-07-02,1004,Eyeliner,100,200,100,1,00461,India
536885,2023-07-02,1004,Eyeliner,100,200,100,1,00009,India
536885,2023-07-02,1002,Mascara,200,400,200,1,00009,India
949752,2023-07-02,1007,Eyeshadow,200,400,200,1,00378,India
966001,2023-07-02,1009,Moisturizer,250,500,250,1,00059,India
966001,2023-07-02,1002,Mascara,200,400,200,1,00059,India
966001,2023-07-02,1012,Body Lotion,200,400,200,1,00059,India
966001,2023-07-02,1007,Eyeshadow,200,400,200,1,00059,India
607603,2023-07-02,1006,Blush,150,300,150,1,00228,India
607603,2023-07-02,1008,Makeup Remover,80,160,80,1,00228,India
839715,2023-07-02,1008,Makeup Remover,80,160,80,1,00117,India
839715,2023-07-02,1009,Moisturizer,250,500,250,1,00117,India
839715,2023-07-02,1003,Foundation,300,600,300,1,00117,India
186324,2023-07-02,1012,Body Lotion,200,400,200,1,00241,India
186324,2023-07-02,1005,Nail Polish,50,100,50,1,00241,India
195193,2023-07-02,1006,Blush,150,300,150,1,00044,India
195193,2023-07-02,1007,Eyeshadow,200,400,200,1,00044,India
601291,2023-07-02,1005,Nail Polish,50,100,50,1,00130,India
601291,2023-07-02,1009,Moisturizer,250,500,250,1,00130,India
788400,2023-07-02,1001,Lipstick,150,300,150,1,00260,India
788400,2023-07-02,1005,Nail Polish,50,100,50,1,00260,India
788400,2023-07-02,1003,Foundation,300,600,300,1,00260,India
875863,2023-07-02,1006,Blush,150,300,150,1,00103,India
875863,2023-07-02,1009,Moisturizer,250,500,250,1,00103,India
875863,2023-07-02,1004,Eyeliner,100,200,100,1,00103,India
875863,2023-07-02,1012,Body Lotion,200,400,200,1,00103,India
471532,2023-07-02,1001,Lipstick,150,300,150,1,00002,India
471532,2023-07-02,1004,Eyeliner,100,200,100,1,00002,India
471532,2023-07-02,1006,Blush,150,300,150,1,00002,India
564101,2023-07-02,1002,Mascara,200,400,200,1,00190,India
564101,2023-07-02,1012,Body Lotion,200,400,200,1,00190,India
564101,2023-07-02,1006,Blush,150,300,150,1,00190,India
310347,2023-07-02,1005,Nail Polish,50,100,50,1,00194,India
310347,2023-07-02,1006,Blush,150,300,150,1,00194,India
457701,2023-07-02,1006,Blush,150,300,150,1,00475,India
457701,2023-07-02,1008,Makeup Remover,80,160,80,1,00475,India
457701,2023-07-02,1005,Nail Polish,50,100,50,1,00475,India
168407,2023-07-02,1009,Moisturizer,250,500,250,1,00270,India
843933,2023-07-02,1004,Eyeliner,100,200,100,1,00374,India
843933,2023-07-02,1012,Body Lotion,200,400,200,1,00374,India
843933,2023-07-02,1001,Lipstick,150,300,150,1,00374,India
289529,2023-07-02,1001,Lipstick,150,300,150,1,00051,India
289529,2023-07-02,1007,Eyeshadow,200,400,200,1,00051,India
713289,2023-07-02,1008,Makeup Remover,80,160,80,1,00464,India
713289,2023-07-02,1005,Nail Polish,50,100,50,1,00464,India
713289,2023-07-02,1002,Mascara,200,400,200,1,00464,India
196698,2023-07-02,1009,Moisturizer,250,500,250,1,00048,India
545306,2023-07-02,1008,Makeup Remover,80,160,80,1,00445,India
545306,2023-07-02,1002,Mascara,200,400,200,1,00445,India
545306,2023-07-02,1005,Nail Polish,50,100,50,1,00445,India
545306,2023-07-02,1007,Eyeshadow,200,400,200,1,00445,India
681406,2023-07-02,1009,Moisturizer,250,500,250,1,00382,India
681406,2023-07-02,1003,Foundation,300,600,300,1,00382,India
681406,2023-07-02,1007,Eyeshadow,200,400,200,1,00382,India
681406,2023-07-02,1008,Makeup Remover,80,160,80,1,00382,India
681406,2023-07-02,1012,Body Lotion,200,400,200,1,00382,India
762312,2023-07-02,1003,Foundation,300,600,300,1,00410,India
762312,2023-07-02,1012,Body Lotion,200,400,200,1,00410,India
762312,2023-07-02,1009,Moisturizer,250,500,250,1,00410,India
762312,2023-07-02,1006,Blush,150,300,150,1,00410,India
410852,2023-07-02,1001,Lipstick,150,300,150,1,00049,India
410852,2023-07-02,1002,Mascara,200,400,200,1,00049,India
410852,2023-07-02,1007,Eyeshadow,200,400,200,1,00049,India
410852,2023-07-02,1004,Eyeliner,100,200,100,1,00049,India
770543,2023-07-02,1002,Mascara,200,400,200,1,00305,India
770543,2023-07-02,1001,Lipstick,150,300,150,1,00305,India
770543,2023-07-02,1007,Eyeshadow,200,400,200,1,00305,India
399174,2023-07-02,1003,Foundation,300,600,300,1,00183,India
399174,2023-07-02,1004,Eyeliner,100,200,100,1,00183,India
399174,2023-07-02,1001,Lipstick,150,300,150,1,00183,India
634304,2023-07-03,1004,Eyeliner,100,200,100,1,00065,India
634304,2023-07-03,1009,Moisturizer,250,500,250,1,00065,India
634304,2023-07-03,1006,Blush,150,300,150,1,00065,India
254023,2023-07-03,1007,Eyeshadow,200,400,200,1,00220,India
254023,2023-07-03,1003,Foundation,300,600,300,1,00220,India
829421,2023-07-03,1004,Eyeliner,100,200,100,1,00245,India
829421,2023-07-03,1007,Eyeshadow,200,400,200,1,00245,India
829421,2023-07-03,1009,Moisturizer,250,500,250,1,00245,India
213628,2023-07-03,1009,Moisturizer,250,500,250,1,00023,India
928163,2023-07-03,1001,Lipstick,150,300,150,1,00247,India
928163,2023-07-03,1005,Nail Polish,50,100,50,1,00247,India
824384,2023-07-03,1012,Body Lotion,200,400,200,1,00206,India
824384,2023-07-03,1009,Moisturizer,250,500,250,1,00206,India
415719,2023-07-03,1008,Makeup Remover,80,160,80,1,00419,India
415719,2023-07-03,1003,Foundation,300,600,300,1,00419,India
162821,2023-07-03,1004,Eyeliner,100,200,100,1,00199,India
162821,2023-07-03,1006,Blush,150,300,150,1,00199,India
998090,2023-07-03,1008,Makeup Remover,80,160,80,1,00384,India
998090,2023-07-03,1003,Foundation,300,600,300,1,00384,India
998090,2023-07-03,1006,Blush,150,300,150,1,00384,India
998090,2023-07-03,1012,Body Lotion,200,400,200,1,00384,India
147609,2023-07-03,1002,Mascara,200,400,200,1,00016,India
147609,2023-07-03,1004,Eyeliner,100,200,100,1,00016,India
888857,2023-07-03,1004,Eyeliner,100,200,100,1,00085,India
888857,2023-07-03,1002,Mascara,200,400,200,1,00085,India
241749,2023-07-03,1004,Eyeliner,100,200,100,1,00399,India
241749,2023-07-03,1009,Moisturizer,250,500,250,1,00399,India
836019,2023-07-03,1012,Body Lotion,200,400,200,1,00018,India
836019,2023-07-03,1003,Foundation,300,600,300,1,00018,India
836019,2023-07-03,1008,Makeup Remover,80,160,80,1,00018,India
671285,2023-07-03,1008,Makeup Remover,80,160,80,1,00082,India
671285,2023-07-03,1009,Moisturizer,250,500,250,1,00082,India
671285,2023-07-03,1002,Mascara,200,400,200,1,00082,India
186011,2023-07-03,1007,Eyeshadow,200,400,200,1,00231,India
186011,2023-07-03,1012,Body Lotion,200,400,200,1,00231,India
186011,2023-07-03,1001,Lipstick,150,300,150,1,00231,India
186011,2023-07-03,1004,Eyeliner,100,200,100,1,00231,India
861994,2023-07-03,1001,Lipstick,150,300,150,1,00354,India
861994,2023-07-03,1009,Moisturizer,250,500,250,1,00354,India
767431,2023-07-03,1001,Lipstick,150,300,150,1,00074,India
767431,2023-07-03,1003,Foundation,300,600,300,1,00074,India
221172,2023-07-03,1009,Moisturizer,250,500,250,1,00181,India
221172,2023-07-03,1001,Lipstick,150,300,150,1,00181,India
221172,2023-07-03,1002,Mascara,200,400,200,1,00181,India
221172,2023-07-03,1003,Foundation,300,600,300,1,00181,India
212578,2023-07-03,1004,Eyeliner,100,200,100,1,00222,India
212578,2023-07-03,1006,Blush,150,300,150,1,00222,India
212578,2023-07-03,1012,Body Lotion,200,400,200,1,00222,India
125945,2023-07-03,1009,Moisturizer,250,500,250,1,00297,India
125945,2023-07-03,1001,Lipstick,150,300,150,1,00297,India
125945,2023-07-03,1004,Eyeliner,100,200,100,1,00297,India
125945,2023-07-03,1002,Mascara,200,400,200,1,00297,India
572399,2023-07-03,1001,Lipstick,150,300,150,1,00029,India
572399,2023-07-03,1002,Mascara,200,400,200,1,00029,India
879313,2023-07-03,1012,Body Lotion,200,400,200,1,00132,India
971169,2023-07-03,1012,Body Lotion,200,400,200,1,00414,India
971169,2023-07-03,1001,Lipstick,150,300,150,1,00414,India
971169,2023-07-03,1009,Moisturizer,250,500,250,1,00414,India
273305,2023-07-03,1009,Moisturizer,250,500,250,1,00347,India
273305,2023-07-03,1012,Body Lotion,200,400,200,1,00347,India
273305,2023-07-03,1006,Blush,150,300,150,1,00347,India
143693,2023-07-03,1001,Lipstick,150,300,150,1,00242,India
143693,2023-07-03,1012,Body Lotion,200,400,200,1,00242,India
143693,2023-07-03,1003,Foundation,300,600,300,1,00242,India
420624,2023-07-03,1002,Mascara,200,400,200,1,00350,India
420624,2023-07-03,1009,Moisturizer,250,500,250,1,00350,India
420624,2023-07-03,1003,Foundation,300,600,300,1,00350,India
952045,2023-07-03,1009,Moisturizer,250,500,250,1,00164,India
952045,2023-07-03,1001,Lipstick,150,300,150,1,00164,India
952045,2023-07-03,1005,Nail Polish,50,100,50,1,00164,India
952045,2023-07-03,1003,Foundation,300,600,300,1,00164,India
622018,2023-07-03,1008,Makeup Remover,80,160,80,1,00472,India
622018,2023-07-03,1005,Nail Polish,50,100,50,1,00472,India
622018,2023-07-03,1004,Eyeliner,100,200,100,1,00472,India
600291,2023-07-03,1007,Eyeshadow,200,400,200,1,00313,India
600291,2023-07-03,1012,Body Lotion,200,400,200,1,00313,India
600291,2023-07-03,1005,Nail Polish,50,100,50,1,00313,India
600291,2023-07-03,1004,Eyeliner,100,200,100,1,00313,India
458323,2023-07-03,1007,Eyeshadow,200,400,200,1,00013,India
458323,2023-07-03,1008,Makeup Remover,80,160,80,1,00013,India
458323,2023-07-03,1006,Blush,150,300,150,1,00013,India
810378,2023-07-03,1004,Eyeliner,100,200,100,1,00097,India
810378,2023-07-03,1007,Eyeshadow,200,400,200,1,00097,India
810378,2023-07-03,1001,Lipstick,150,300,150,1,00097,India
810378,2023-07-03,1012,Body Lotion,200,400,200,1,00097,India
345219,2023-07-03,1012,Body Lotion,200,400,200,1,00431,India
345219,2023-07-03,1008,Makeup Remover,80,160,80,1,00431,India
345219,2023-07-03,1005,Nail Polish,50,100,50,1,00431,India
345219,2023-07-03,1009,Moisturizer,250,500,250,1,00431,India
345219,2023-07-03,1001,Lipstick,150,300,150,1,00431,India
906562,2023-07-03,1002,Mascara,200,400,200,1,00383,India
906562,2023-07-03,1003,Foundation,300,600,300,1,00383,India
749729,2023-07-04,1004,Eyeliner,100,200,100,1,00334,India
749729,2023-07-04,1002,Mascara,200,400,200,1,00334,India
653011,2023-07-04,1001,Lipstick,150,300,150,1,00489,India
653011,2023-07-04,1002,Mascara,200,400,200,1,00489,India
653011,2023-07-04,1003,Foundation,300,600,300,1,00489,India
515476,2023-07-04,1001,Lipstick,150,300,150,1,00243,India
515476,2023-07-04,1005,Nail Polish,50,100,50,1,00243,India
803848,2023-07-04,1004,Eyeliner,100,200,100,1,00144,India
803848,2023-07-04,1002,Mascara,200,400,200,1,00144,India
803848,2023-07-04,1003,Foundation,300,600,300,1,00144,India
633693,2023-07-04,1006,Blush,150,300,150,1,00473,India
633693,2023-07-04,1007,Eyeshadow,200,400,200,1,00473,India
633693,2023-07-04,1004,Eyeliner,100,200,100,1,00473,India
807570,2023-07-04,1004,Eyeliner,100,200,100,1,00307,India
807570,2023-07-04,1008,Makeup Remover,80,160,80,1,00307,India
807570,2023-07-04,1003,Foundation,300,600,300,1,00307,India
115089,2023-07-04,1005,Nail Polish,50,100,50,1,00089,India
771750,2023-07-04,1002,Mascara,200,400,200,1,00187,India
771750,2023-07-04,1001,Lipstick,150,300,150,1,00187,India
533075,2023-07-04,1006,Blush,150,300,150,1,00206,India
533075,2023-07-04,1009,Moisturizer,250,500,250,1,00206,India
583146,2023-07-04,1001,Lipstick,150,300,150,1,00458,India
583146,2023-07-04,1007,Eyeshadow,200,400,200,1,00458,India
583146,2023-07-04,1004,Eyeliner,100,200,100,1,00458,India
556498,2023-07-04,1009,Moisturizer,250,500,250,1,00123,India
556498,2023-07-04,1005,Nail Polish,50,100,50,1,00123,India
785554,2023-07-04,1005,Nail Polish,50,100,50,1,00058,India
785554,2023-07-04,1007,Eyeshadow,200,400,200,1,00058,India
234947,2023-07-04,1008,Makeup Remover,80,160,80,1,00144,India
234947,2023-07-04,1005,Nail Polish,50,100,50,1,00144,India
234947,2023-07-04,1006,Blush,150,300,150,1,00144,India
234947,2023-07-04,1009,Moisturizer,250,500,250,1,00144,India
234947,2023-07-04,1002,Mascara,200,400,200,1,00144,India
265190,2023-07-04,1005,Nail Polish,50,100,50,1,00294,India
877167,2023-07-04,1004,Eyeliner,100,200,100,1,00358,India
454806,2023-07-04,1005,Nail Polish,50,100,50,1,00494,India
684130,2023-07-04,1009,Moisturizer,250,500,250,1,00485,India
684130,2023-07-04,1004,Eyeliner,100,200,100,1,00485,India
684130,2023-07-04,1006,Blush,150,300,150,1,00485,India
776675,2023-07-04,1001,Lipstick,150,300,150,1,00353,India
344319,2023-07-04,1003,Foundation,300,600,300,1,00029,India
344319,2023-07-04,1007,Eyeshadow,200,400,200,1,00029,India
344319,2023-07-04,1012,Body Lotion,200,400,200,1,00029,India
344319,2023-07-04,1008,Makeup Remover,80,160,80,1,00029,India
453716,2023-07-04,1001,Lipstick,150,300,150,1,00480,India
453716,2023-07-04,1007,Eyeshadow,200,400,200,1,00480,India
453716,2023-07-04,1005,Nail Polish,50,100,50,1,00480,India
986044,2023-07-04,1001,Lipstick,150,300,150,1,00445,India
986044,2023-07-04,1006,Blush,150,300,150,1,00445,India
986044,2023-07-04,1008,Makeup Remover,80,160,80,1,00445,India
986044,2023-07-04,1004,Eyeliner,100,200,100,1,00445,India
986044,2023-07-04,1005,Nail Polish,50,100,50,1,00445,India
794647,2023-07-04,1001,Lipstick,150,300,150,1,00141,India
794647,2023-07-04,1004,Eyeliner,100,200,100,1,00141,India
794647,2023-07-04,1002,Mascara,200,400,200,1,00141,India
794647,2023-07-04,1008,Makeup Remover,80,160,80,1,00141,India
479015,2023-07-04,1008,Makeup Remover,80,160,80,1,00470,India
479015,2023-07-04,1005,Nail Polish,50,100,50,1,00470,India
479015,2023-07-04,1003,Foundation,300,600,300,1,00470,India
167258,2023-07-04,1007,Eyeshadow,200,400,200,1,00428,India
167258,2023-07-04,1005,Nail Polish,50,100,50,1,00428,India
167258,2023-07-04,1006,Blush,150,300,150,1,00428,India
167258,2023-07-04,1003,Foundation,300,600,300,1,00428,India
167258,2023-07-04,1008,Makeup Remover,80,160,80,1,00428,India
291009,2023-07-04,1001,Lipstick,150,300,150,1,00314,India
291009,2023-07-04,1005,Nail Polish,50,100,50,1,00314,India
291009,2023-07-04,1012,Body Lotion,200,400,200,1,00314,India
291009,2023-07-04,1002,Mascara,200,400,200,1,00314,India
953274,2023-07-04,1008,Makeup Remover,80,160,80,1,00102,India
953274,2023-07-04,1004,Eyeliner,100,200,100,1,00102,India
224477,2023-07-04,1006,Blush,150,300,150,1,00288,India
224477,2023-07-04,1012,Body Lotion,200,400,200,1,00288,India
224477,2023-07-04,1008,Makeup Remover,80,160,80,1,00288,India
224477,2023-07-04,1005,Nail Polish,50,100,50,1,00288,India
715199,2023-07-04,1003,Foundation,300,600,300,1,00443,India
468665,2023-07-04,1007,Eyeshadow,200,400,200,1,00038,India
468665,2023-07-04,1002,Mascara,200,400,200,1,00038,India
997108,2023-07-04,1002,Mascara,200,400,200,1,00007,India
997108,2023-07-04,1005,Nail Polish,50,100,50,1,00007,India
997108,2023-07-04,1003,Foundation,300,600,300,1,00007,India
997108,2023-07-04,1006,Blush,150,300,150,1,00007,India
997108,2023-07-04,1004,Eyeliner,100,200,100,1,00007,India
390763,2023-07-04,1008,Makeup Remover,80,160,80,1,00458,India
354784,2023-07-04,1003,Foundation,300,600,300,1,00375,India
354784,2023-07-04,1008,Makeup Remover,80,160,80,1,00375,India
511589,2023-07-04,1005,Nail Polish,50,100,50,1,00091,India
511589,2023-07-04,1002,Mascara,200,400,200,1,00091,India
701405,2023-07-04,1008,Makeup Remover,80,160,80,1,00062,India
701405,2023-07-04,1007,Eyeshadow,200,400,200,1,00062,India
701405,2023-07-04,1004,Eyeliner,100,200,100,1,00062,India
701405,2023-07-04,1012,Body Lotion,200,400,200,1,00062,India
305217,2023-07-04,1001,Lipstick,150,300,150,1,00156,India
305217,2023-07-04,1009,Moisturizer,250,500,250,1,00156,India
305217,2023-07-04,1002,Mascara,200,400,200,1,00156,India
215736,2023-07-04,1006,Blush,150,300,150,1,00155,India
215736,2023-07-04,1002,Mascara,200,400,200,1,00155,India
215736,2023-07-04,1001,Lipstick,150,300,150,1,00155,India
546987,2023-07-04,1006,Blush,150,300,150,1,00199,India
546987,2023-07-04,1009,Moisturizer,250,500,250,1,00199,India
791803,2023-07-04,1007,Eyeshadow,200,400,200,1,00028,India
791803,2023-07-04,1008,Makeup Remover,80,160,80,1,00028,India
192259,2023-07-04,1003,Foundation,300,600,300,1,00258,India
192259,2023-07-04,1006,Blush,150,300,150,1,00258,India
192259,2023-07-04,1001,Lipstick,150,300,150,1,00258,India
192259,2023-07-04,1004,Eyeliner,100,200,100,1,00258,India
776964,2023-07-04,1005,Nail Polish,50,100,50,1,00329,India
136115,2023-07-04,1008,Makeup Remover,80,160,80,1,00159,India
136115,2023-07-04,1005,Nail Polish,50,100,50,1,00159,India
136115,2023-07-04,1001,Lipstick,150,300,150,1,00159,India
722908,2023-07-04,1004,Eyeliner,100,200,100,1,00059,India
722908,2023-07-04,1003,Foundation,300,600,300,1,00059,India
101201,2023-07-04,1004,Eyeliner,100,200,100,1,00277,India
101201,2023-07-04,1008,Makeup Remover,80,160,80,1,00277,India
101201,2023-07-04,1009,Moisturizer,250,500,250,1,00277,India
101201,2023-07-04,1005,Nail Polish,50,100,50,1,00277,India
717367,2023-07-04,1002,Mascara,200,400,200,1,00001,India
717367,2023-07-04,1012,Body Lotion,200,400,200,1,00001,India
717367,2023-07-04,1006,Blush,150,300,150,1,00001,India
219167,2023-07-04,1012,Body Lotion,200,400,200,1,00361,India
219167,2023-07-04,1002,Mascara,200,400,200,1,00361,India
219167,2023-07-04,1008,Makeup Remover,80,160,80,1,00361,India
219167,2023-07-04,1007,Eyeshadow,200,400,200,1,00361,India
459186,2023-07-04,1002,Mascara,200,400,200,1,00401,India
403308,2023-07-04,1007,Eyeshadow,200,400,200,1,00398,India
403308,2023-07-04,1002,Mascara,200,400,200,1,00398,India
403308,2023-07-04,1008,Makeup Remover,80,160,80,1,00398,India
403308,2023-07-04,1001,Lipstick,150,300,150,1,00398,India
615590,2023-07-04,1006,Blush,150,300,150,1,00255,India
615590,2023-07-04,1012,Body Lotion,200,400,200,1,00255,India
608805,2023-07-05,1004,Eyeliner,100,200,100,1,00111,India
608805,2023-07-05,1001,Lipstick,150,300,150,1,00111,India
665242,2023-07-05,1008,Makeup Remover,80,160,80,1,00274,India
665242,2023-07-05,1005,Nail Polish,50,100,50,1,00274,India
665242,2023-07-05,1001,Lipstick,150,300,150,1,00274,India
665242,2023-07-05,1007,Eyeshadow,200,400,200,1,00274,India
484058,2023-07-05,1003,Foundation,300,600,300,1,00069,India
484058,2023-07-05,1009,Moisturizer,250,500,250,1,00069,India
484058,2023-07-05,1004,Eyeliner,100,200,100,1,00069,India
484058,2023-07-05,1012,Body Lotion,200,400,200,1,00069,India
614136,2023-07-05,1002,Mascara,200,400,200,1,00224,India
876105,2023-07-05,1002,Mascara,200,400,200,1,00159,India
876105,2023-07-05,1007,Eyeshadow,200,400,200,1,00159,India
213211,2023-07-05,1007,Eyeshadow,200,400,200,1,00416,India
866120,2023-07-05,1012,Body Lotion,200,400,200,1,00072,India
866120,2023-07-05,1004,Eyeliner,100,200,100,1,00072,India
866120,2023-07-05,1005,Nail Polish,50,100,50,1,00072,India
866120,2023-07-05,1008,Makeup Remover,80,160,80,1,00072,India
976293,2023-07-05,1002,Mascara,200,400,200,1,00472,India
771170,2023-07-05,1001,Lipstick,150,300,150,1,00086,India
771170,2023-07-05,1005,Nail Polish,50,100,50,1,00086,India
241917,2023-07-05,1004,Eyeliner,100,200,100,1,00086,India
241917,2023-07-05,1002,Mascara,200,400,200,1,00086,India
815687,2023-07-05,1001,Lipstick,150,300,150,1,00234,India
815687,2023-07-05,1005,Nail Polish,50,100,50,1,00234,India
815687,2023-07-05,1009,Moisturizer,250,500,250,1,00234,India
815687,2023-07-05,1006,Blush,150,300,150,1,00234,India
514089,2023-07-05,1012,Body Lotion,200,400,200,1,00254,India
514089,2023-07-05,1008,Makeup Remover,80,160,80,1,00254,India
514089,2023-07-05,1007,Eyeshadow,200,400,200,1,00254,India
514089,2023-07-05,1002,Mascara,200,400,200,1,00254,India
955688,2023-07-05,1008,Makeup Remover,80,160,80,1,00411,India
254274,2023-07-05,1005,Nail Polish,50,100,50,1,00162,India
225384,2023-07-05,1007,Eyeshadow,200,400,200,1,00142,India
225384,2023-07-05,1012,Body Lotion,200,400,200,1,00142,India
225384,2023-07-05,1009,Moisturizer,250,500,250,1,00142,India
654155,2023-07-05,1007,Eyeshadow,200,400,200,1,00066,India
654155,2023-07-05,1005,Nail Polish,50,100,50,1,00066,India
782696,2023-07-05,1003,Foundation,300,600,300,1,00026,India
184389,2023-07-05,1006,Blush,150,300,150,1,00124,India
184389,2023-07-05,1007,Eyeshadow,200,400,200,1,00124,India
639325,2023-07-05,1009,Moisturizer,250,500,250,1,00445,India
639325,2023-07-05,1001,Lipstick,150,300,150,1,00445,India
167099,2023-07-05,1002,Mascara,200,400,200,1,00190,India
312588,2023-07-05,1005,Nail Polish,50,100,50,1,00287,India
605006,2023-07-05,1001,Lipstick,150,300,150,1,00433,India
605006,2023-07-05,1005,Nail Polish,50,100,50,1,00433,India
425564,2023-07-05,1003,Foundation,300,600,300,1,00047,India
425564,2023-07-05,1012,Body Lotion,200,400,200,1,00047,India
425564,2023-07-05,1009,Moisturizer,250,500,250,1,00047,India
425564,2023-07-05,1007,Eyeshadow,200,400,200,1,00047,India
462504,2023-07-05,1009,Moisturizer,250,500,250,1,00336,India
462504,2023-07-05,1007,Eyeshadow,200,400,200,1,00336,India
462504,2023-07-05,1003,Foundation,300,600,300,1,00336,India
976783,2023-07-05,1004,Eyeliner,100,200,100,1,00033,India
976783,2023-07-05,1009,Moisturizer,250,500,250,1,00033,India
976783,2023-07-05,1002,Mascara,200,400,200,1,00033,India
976783,2023-07-05,1012,Body Lotion,200,400,200,1,00033,India
322963,2023-07-05,1012,Body Lotion,200,400,200,1,00171,India
322963,2023-07-05,1005,Nail Polish,50,100,50,1,00171,India
322963,2023-07-05,1003,Foundation,300,600,300,1,00171,India
322963,2023-07-05,1002,Mascara,200,400,200,1,00171,India
205904,2023-07-05,1005,Nail Polish,50,100,50,1,00383,India
205904,2023-07-05,1007,Eyeshadow,200,400,200,1,00383,India
205904,2023-07-05,1006,Blush,150,300,150,1,00383,India
205904,2023-07-05,1009,Moisturizer,250,500,250,1,00383,India
205904,2023-07-05,1012,Body Lotion,200,400,200,1,00383,India
785168,2023-07-05,1012,Body Lotion,200,400,200,1,00375,India
785168,2023-07-05,1009,Moisturizer,250,500,250,1,00375,India
778807,2023-07-05,1012,Body Lotion,200,400,200,1,00347,India
778807,2023-07-05,1006,Blush,150,300,150,1,00347,India
778807,2023-07-05,1008,Makeup Remover,80,160,80,1,00347,India
778807,2023-07-05,1001,Lipstick,150,300,150,1,00347,India
834112,2023-07-05,1002,Mascara,200,400,200,1,00328,India
834112,2023-07-05,1012,Body Lotion,200,400,200,1,00328,India
874058,2023-07-05,1009,Moisturizer,250,500,250,1,00355,India
874058,2023-07-05,1005,Nail Polish,50,100,50,1,00355,India
874058,2023-07-05,1008,Makeup Remover,80,160,80,1,00355,India
874058,2023-07-05,1004,Eyeliner,100,200,100,1,00355,India
474538,2023-07-05,1012,Body Lotion,200,400,200,1,00484,India
474538,2023-07-05,1008,Makeup Remover,80,160,80,1,00484,India
402901,2023-07-05,1009,Moisturizer,250,500,250,1,00169,India
997231,2023-07-05,1006,Blush,150,300,150,1,00483,India
997231,2023-07-05,1007,Eyeshadow,200,400,200,1,00483,India
218768,2023-07-05,1003,Foundation,300,600,300,1,00020,India
218768,2023-07-05,1002,Mascara,200,400,200,1,00020,India
218768,2023-07-05,1009,Moisturizer,250,500,250,1,00020,India
218768,2023-07-05,1005,Nail Polish,50,100,50,1,00020,India
112961,2023-07-05,1008,Makeup Remover,80,160,80,1,00493,India
112961,2023-07-05,1012,Body Lotion,200,400,200,1,00493,India
367352,2023-07-05,1008,Makeup Remover,80,160,80,1,00347,India
367352,2023-07-05,1002,Mascara,200,400,200,1,00347,India
367352,2023-07-05,1012,Body Lotion,200,400,200,1,00347,India
992955,2023-07-05,1005,Nail Polish,50,100,50,1,00170,India
992955,2023-07-05,1007,Eyeshadow,200,400,200,1,00170,India
992955,2023-07-05,1006,Blush,150,300,150,1,00170,India
992955,2023-07-05,1001,Lipstick,150,300,150,1,00170,India
810659,2023-07-05,1012,Body Lotion,200,400,200,1,00270,India
311450,2023-07-05,1009,Moisturizer,250,500,250,1,00249,India
311450,2023-07-05,1006,Blush,150,300,150,1,00249,India
311450,2023-07-05,1008,Makeup Remover,80,160,80,1,00249,India
654799,2023-07-05,1007,Eyeshadow,200,400,200,1,00054,India
654799,2023-07-05,1003,Foundation,300,600,300,1,00054,India
654799,2023-07-05,1012,Body Lotion,200,400,200,1,00054,India
372466,2023-07-05,1002,Mascara,200,400,200,1,00273,India
372466,2023-07-05,1001,Lipstick,150,300,150,1,00273,India
372466,2023-07-05,1004,Eyeliner,100,200,100,1,00273,India
733820,2023-07-05,1008,Makeup Remover,80,160,80,1,00379,India
733820,2023-07-05,1004,Eyeliner,100,200,100,1,00379,India
733820,2023-07-05,1009,Moisturizer,250,500,250,1,00379,India
555475,2023-07-05,1008,Makeup Remover,80,160,80,1,00443,India
862798,2023-07-05,1002,Mascara,200,400,200,1,00392,India
843916,2023-07-05,1003,Foundation,300,600,300,1,00075,India
843916,2023-07-05,1012,Body Lotion,200,400,200,1,00075,India
776740,2023-07-05,1003,Foundation,300,600,300,1,00024,India
776740,2023-07-05,1009,Moisturizer,250,500,250,1,00024,India
791179,2023-07-05,1008,Makeup Remover,80,160,80,1,00111,India
104226,2023-07-05,1003,Foundation,300,600,300,1,00274,India
104226,2023-07-05,1005,Nail Polish,50,100,50,1,00274,India
104226,2023-07-05,1002,Mascara,200,400,200,1,00274,India
104226,2023-07-05,1007,Eyeshadow,200,400,200,1,00274,India
729820,2023-07-06,1007,Eyeshadow,200,400,200,1,00069,India
729820,2023-07-06,1005,Nail Polish,50,100,50,1,00069,India
729820,2023-07-06,1001,Lipstick,150,300,150,1,00069,India
189822,2023-07-06,1005,Nail Polish,50,100,50,1,00265,India
189822,2023-07-06,1007,Eyeshadow,200,400,200,1,00265,India
189822,2023-07-06,1002,Mascara,200,400,200,1,00265,India
189822,2023-07-06,1006,Blush,150,300,150,1,00265,India
189822,2023-07-06,1012,Body Lotion,200,400,200,1,00265,India
350081,2023-07-06,1008,Makeup Remover,80,160,80,1,00131,India
350081,2023-07-06,1012,Body Lotion,200,400,200,1,00131,India
350081,2023-07-06,1009,Moisturizer,250,500,250,1,00131,India
350081,2023-07-06,1005,Nail Polish,50,100,50,1,00131,India
335778,2023-07-06,1009,Moisturizer,250,500,250,1,00013,India
110752,2023-07-06,1012,Body Lotion,200,400,200,1,00198,India
342499,2023-07-06,1007,Eyeshadow,200,400,200,1,00218,India
562333,2023-07-06,1008,Makeup Remover,80,160,80,1,00047,India
562333,2023-07-06,1003,Foundation,300,600,300,1,00047,India
562333,2023-07-06,1012,Body Lotion,200,400,200,1,00047,India
194245,2023-07-06,1004,Eyeliner,100,200,100,1,00415,India
194245,2023-07-06,1008,Makeup Remover,80,160,80,1,00415,India
194245,2023-07-06,1012,Body Lotion,200,400,200,1,00415,India
461863,2023-07-06,1009,Moisturizer,250,500,250,1,00229,India
461863,2023-07-06,1007,Eyeshadow,200,400,200,1,00229,India
461863,2023-07-06,1005,Nail Polish,50,100,50,1,00229,India
980197,2023-07-06,1004,Eyeliner,100,200,100,1,00399,India
980197,2023-07-06,1007,Eyeshadow,200,400,200,1,00399,India
980197,2023-07-06,1006,Blush,150,300,150,1,00399,India
929120,2023-07-06,1005,Nail Polish,50,100,50,1,00115,India
929120,2023-07-06,1003,Foundation,300,600,300,1,00115,India
929120,2023-07-06,1002,Mascara,200,400,200,1,00115,India
803002,2023-07-06,1007,Eyeshadow,200,400,200,1,00245,India
803002,2023-07-06,1004,Eyeliner,100,200,100,1,00245,India
803002,2023-07-06,1006,Blush,150,300,150,1,00245,India
599781,2023-07-06,1007,Eyeshadow,200,400,200,1,00226,India
599781,2023-07-06,1003,Foundation,300,600,300,1,00226,India
599781,2023-07-06,1004,Eyeliner,100,200,100,1,00226,India
599781,2023-07-06,1012,Body Lotion,200,400,200,1,00226,India
819350,2023-07-06,1002,Mascara,200,400,200,1,00312,India
819350,2023-07-06,1005,Nail Polish,50,100,50,1,00312,India
819350,2023-07-06,1003,Foundation,300,600,300,1,00312,India
819350,2023-07-06,1006,Blush,150,300,150,1,00312,India
699276,2023-07-06,1003,Foundation,300,600,300,1,00165,India
699276,2023-07-06,1002,Mascara,200,400,200,1,00165,India
419121,2023-07-06,1001,Lipstick,150,300,150,1,00467,India
419121,2023-07-06,1003,Foundation,300,600,300,1,00467,India
419121,2023-07-06,1008,Makeup Remover,80,160,80,1,00467,India
205180,2023-07-06,1006,Blush,150,300,150,1,00010,India
205180,2023-07-06,1005,Nail Polish,50,100,50,1,00010,India
967740,2023-07-06,1005,Nail Polish,50,100,50,1,00092,India
967740,2023-07-06,1002,Mascara,200,400,200,1,00092,India
286263,2023-07-06,1005,Nail Polish,50,100,50,1,00083,India
655241,2023-07-06,1012,Body Lotion,200,400,200,1,00413,India
518765,2023-07-06,1007,Eyeshadow,200,400,200,1,00016,India
518765,2023-07-06,1005,Nail Polish,50,100,50,1,00016,India
625815,2023-07-06,1005,Nail Polish,50,100,50,1,00114,India
625815,2023-07-06,1009,Moisturizer,250,500,250,1,00114,India
926660,2023-07-06,1007,Eyeshadow,200,400,200,1,00188,India
926660,2023-07-06,1009,Moisturizer,250,500,250,1,00188,India
926660,2023-07-06,1008,Makeup Remover,80,160,80,1,00188,India
926660,2023-07-06,1002,Mascara,200,400,200,1,00188,India
101132,2023-07-06,1009,Moisturizer,250,500,250,1,00110,India
157001,2023-07-06,1001,Lipstick,150,300,150,1,00476,India
157001,2023-07-06,1003,Foundation,300,600,300,1,00476,India
157001,2023-07-06,1012,Body Lotion,200,400,200,1,00476,India
157001,2023-07-06,1008,Makeup Remover,80,160,80,1,00476,India
966360,2023-07-06,1008,Makeup Remover,80,160,80,1,00161,India
966360,2023-07-06,1007,Eyeshadow,200,400,200,1,00161,India
966360,2023-07-06,1012,Body Lotion,200,400,200,1,00161,India
224192,2023-07-06,1006,Blush,150,300,150,1,00290,India
536226,2023-07-06,1006,Blush,150,300,150,1,00093,India
732516,2023-07-06,1008,Makeup Remover,80,160,80,1,00461,India
732516,2023-07-06,1003,Foundation,300,600,300,1,00461,India
732516,2023-07-06,1001,Lipstick,150,300,150,1,00461,India
779430,2023-07-06,1009,Moisturizer,250,500,250,1,00028,India
779430,2023-07-06,1006,Blush,150,300,150,1,00028,India
779430,2023-07-06,1008,Makeup Remover,80,160,80,1,00028,India
847600,2023-07-06,1007,Eyeshadow,200,400,200,1,00073,India
847600,2023-07-06,1012,Body Lotion,200,400,200,1,00073,India
847600,2023-07-06,1001,Lipstick,150,300,150,1,00073,India
847600,2023-07-06,1008,Makeup Remover,80,160,80,1,00073,India
933927,2023-07-07,1004,Eyeliner,100,200,100,1,00016,India
933927,2023-07-07,1009,Moisturizer,250,500,250,1,00016,India
933927,2023-07-07,1002,Mascara,200,400,200,1,00016,India
933927,2023-07-07,1007,Eyeshadow,200,400,200,1,00016,India
580949,2023-07-07,1007,Eyeshadow,200,400,200,1,00243,India
580949,2023-07-07,1006,Blush,150,300,150,1,00243,India
580949,2023-07-07,1008,Makeup Remover,80,160,80,1,00243,India
580949,2023-07-07,1005,Nail Polish,50,100,50,1,00243,India
139710,2023-07-07,1005,Nail Polish,50,100,50,1,00493,India
139710,2023-07-07,1004,Eyeliner,100,200,100,1,00493,India
139710,2023-07-07,1001,Lipstick,150,300,150,1,00493,India
589896,2023-07-07,1005,Nail Polish,50,100,50,1,00379,India
589896,2023-07-07,1007,Eyeshadow,200,400,200,1,00379,India
589896,2023-07-07,1008,Makeup Remover,80,160,80,1,00379,India
271023,2023-07-07,1009,Moisturizer,250,500,250,1,00341,India
271023,2023-07-07,1008,Makeup Remover,80,160,80,1,00341,India
712353,2023-07-07,1001,Lipstick,150,300,150,1,00130,India
712353,2023-07-07,1006,Blush,150,300,150,1,00130,India
256108,2023-07-07,1008,Makeup Remover,80,160,80,1,00130,India
955323,2023-07-07,1003,Foundation,300,600,300,1,00164,India
955323,2023-07-07,1009,Moisturizer,250,500,250,1,00164,India
955323,2023-07-07,1004,Eyeliner,100,200,100,1,00164,India
955323,2023-07-07,1005,Nail Polish,50,100,50,1,00164,India
688682,2023-07-07,1007,Eyeshadow,200,400,200,1,00163,India
688682,2023-07-07,1008,Makeup Remover,80,160,80,1,00163,India
447632,2023-07-07,1002,Mascara,200,400,200,1,00342,India
447632,2023-07-07,1006,Blush,150,300,150,1,00342,India
447632,2023-07-07,1004,Eyeliner,100,200,100,1,00342,India
578991,2023-07-07,1003,Foundation,300,600,300,1,00187,India
578991,2023-07-07,1001,Lipstick,150,300,150,1,00187,India
578991,2023-07-07,1007,Eyeshadow,200,400,200,1,00187,India
578991,2023-07-07,1005,Nail Polish,50,100,50,1,00187,India
272474,2023-07-07,1004,Eyeliner,100,200,100,1,00392,India
272474,2023-07-07,1002,Mascara,200,400,200,1,00392,India
404078,2023-07-07,1009,Moisturizer,250,500,250,1,00418,India
404078,2023-07-07,1006,Blush,150,300,150,1,00418,India
319041,2023-07-07,1008,Makeup Remover,80,160,80,1,00225,India
579580,2023-07-07,1009,Moisturizer,250,500,250,1,00127,India
579580,2023-07-07,1002,Mascara,200,400,200,1,00127,India
579580,2023-07-07,1004,Eyeliner,100,200,100,1,00127,India
579580,2023-07-07,1012,Body Lotion,200,400,200,1,00127,India
579580,2023-07-07,1001,Lipstick,150,300,150,1,00127,India
671106,2023-07-07,1001,Lipstick,150,300,150,1,00149,India
671106,2023-07-07,1006,Blush,150,300,150,1,00149,India
147111,2023-07-07,1009,Moisturizer,250,500,250,1,00331,India
147111,2023-07-07,1004,Eyeliner,100,200,100,1,00331,India
437021,2023-07-07,1003,Foundation,300,600,300,1,00054,India
437021,2023-07-07,1007,Eyeshadow,200,400,200,1,00054,India
437021,2023-07-07,1002,Mascara,200,400,200,1,00054,India
437021,2023-07-07,1009,Moisturizer,250,500,250,1,00054,India
455179,2023-07-07,1001,Lipstick,150,300,150,1,00179,India
562012,2023-07-07,1012,Body Lotion,200,400,200,1,00392,India
562012,2023-07-07,1001,Lipstick,150,300,150,1,00392,India
562012,2023-07-07,1007,Eyeshadow,200,400,200,1,00392,India
705491,2023-07-07,1012,Body Lotion,200,400,200,1,00453,India
262074,2023-07-07,1005,Nail Polish,50,100,50,1,00376,India
266751,2023-07-07,1002,Mascara,200,400,200,1,00438,India
266751,2023-07-07,1001,Lipstick,150,300,150,1,00438,India
266751,2023-07-07,1004,Eyeliner,100,200,100,1,00438,India
266751,2023-07-07,1008,Makeup Remover,80,160,80,1,00438,India
266751,2023-07-07,1012,Body Lotion,200,400,200,1,00438,India
976679,2023-07-07,1012,Body Lotion,200,400,200,1,00286,India
976679,2023-07-07,1009,Moisturizer,250,500,250,1,00286,India
976679,2023-07-07,1003,Foundation,300,600,300,1,00286,India
913024,2023-07-07,1009,Moisturizer,250,500,250,1,00454,India
913024,2023-07-07,1003,Foundation,300,600,300,1,00454,India
913024,2023-07-07,1008,Makeup Remover,80,160,80,1,00454,India
913024,2023-07-07,1004,Eyeliner,100,200,100,1,00454,India
893560,2023-07-07,1003,Foundation,300,600,300,1,00018,India
893560,2023-07-07,1002,Mascara,200,400,200,1,00018,India
893560,2023-07-07,1007,Eyeshadow,200,400,200,1,00018,India
893560,2023-07-07,1006,Blush,150,300,150,1,00018,India
893560,2023-07-07,1001,Lipstick,150,300,150,1,00018,India
479678,2023-07-07,1004,Eyeliner,100,200,100,1,00444,India
378634,2023-07-07,1008,Makeup Remover,80,160,80,1,00442,India
580556,2023-07-07,1007,Eyeshadow,200,400,200,1,00005,India
580556,2023-07-07,1012,Body Lotion,200,400,200,1,00005,India
580556,2023-07-07,1003,Foundation,300,600,300,1,00005,India
580556,2023-07-07,1008,Makeup Remover,80,160,80,1,00005,India
242785,2023-07-07,1009,Moisturizer,250,500,250,1,00346,India
509635,2023-07-07,1005,Nail Polish,50,100,50,1,00310,India
509635,2023-07-07,1002,Mascara,200,400,200,1,00310,India
509635,2023-07-07,1007,Eyeshadow,200,400,200,1,00310,India
218482,2023-07-07,1005,Nail Polish,50,100,50,1,00351,India
437235,2023-07-07,1012,Body Lotion,200,400,200,1,00436,India
437235,2023-07-07,1003,Foundation,300,600,300,1,00436,India
877387,2023-07-07,1001,Lipstick,150,300,150,1,00243,India
877387,2023-07-07,1006,Blush,150,300,150,1,00243,India
547814,2023-07-07,1002,Mascara,200,400,200,1,00389,India
708304,2023-07-07,1002,Mascara,200,400,200,1,00110,India
882356,2023-07-07,1003,Foundation,300,600,300,1,00393,India
882356,2023-07-07,1006,Blush,150,300,150,1,00393,India
882356,2023-07-07,1007,Eyeshadow,200,400,200,1,00393,India
344214,2023-07-07,1005,Nail Polish,50,100,50,1,00322,India
344214,2023-07-07,1012,Body Lotion,200,400,200,1,00322,India
344214,2023-07-07,1002,Mascara,200,400,200,1,00322,India
344214,2023-07-07,1001,Lipstick,150,300,150,1,00322,India
976136,2023-07-07,1008,Makeup Remover,80,160,80,1,00003,India
820819,2023-07-07,1004,Eyeliner,100,200,100,1,00057,India
330648,2023-07-07,1007,Eyeshadow,200,400,200,1,00301,India
330648,2023-07-07,1006,Blush,150,300,150,1,00301,India
330648,2023-07-07,1005,Nail Polish,50,100,50,1,00301,India
130814,2023-07-07,1008,Makeup Remover,80,160,80,1,00427,India
498386,2023-07-07,1009,Moisturizer,250,500,250,1,00030,India
498386,2023-07-07,1002,Mascara,200,400,200,1,00030,India
159321,2023-07-07,1004,Eyeliner,100,200,100,1,00371,India
159321,2023-07-07,1009,Moisturizer,250,500,250,1,00371,India
159321,2023-07-07,1012,Body Lotion,200,400,200,1,00371,India
489781,2023-07-07,1007,Eyeshadow,200,400,200,1,00399,India
489781,2023-07-07,1006,Blush,150,300,150,1,00399,India
489781,2023-07-07,1008,Makeup Remover,80,160,80,1,00399,India
686557,2023-07-07,1006,Blush,150,300,150,1,00093,India
686557,2023-07-07,1012,Body Lotion,200,400,200,1,00093,India
686557,2023-07-07,1009,Moisturizer,250,500,250,1,00093,India
810580,2023-07-07,1002,Mascara,200,400,200,1,00335,India
810580,2023-07-07,1009,Moisturizer,250,500,250,1,00335,India
810580,2023-07-07,1003,Foundation,300,600,300,1,00335,India
810580,2023-07-07,1007,Eyeshadow,200,400,200,1,00335,India
675866,2023-07-07,1003,Foundation,300,600,300,1,00310,India
675866,2023-07-07,1008,Makeup Remover,80,160,80,1,00310,India
675866,2023-07-07,1001,Lipstick,150,300,150,1,00310,India
675866,2023-07-07,1002,Mascara,200,400,200,1,00310,India
175283,2023-07-07,1009,Moisturizer,250,500,250,1,00315,India
175283,2023-07-07,1007,Eyeshadow,200,400,200,1,00315,India
175283,2023-07-07,1003,Foundation,300,600,300,1,00315,India
175283,2023-07-07,1006,Blush,150,300,150,1,00315,India
422134,2023-07-08,1006,Blush,150,300,150,1,00115,India
422134,2023-07-08,1002,Mascara,200,400,200,1,00115,India
422134,2023-07-08,1003,Foundation,300,600,300,1,00115,India
185742,2023-07-08,1012,Body Lotion,200,400,200,1,00242,India
185742,2023-07-08,1005,Nail Polish,50,100,50,1,00242,India
640993,2023-07-08,1005,Nail Polish,50,100,50,1,00236,India
852561,2023-07-08,1001,Lipstick,150,300,150,1,00241,India
852561,2023-07-08,1009,Moisturizer,250,500,250,1,00241,India
852561,2023-07-08,1007,Eyeshadow,200,400,200,1,00241,India
334107,2023-07-08,1005,Nail Polish,50,100,50,1,00343,India
334107,2023-07-08,1003,Foundation,300,600,300,1,00343,India
334107,2023-07-08,1002,Mascara,200,400,200,1,00343,India
473368,2023-07-08,1002,Mascara,200,400,200,1,00225,India
473368,2023-07-08,1008,Makeup Remover,80,160,80,1,00225,India
473368,2023-07-08,1009,Moisturizer,250,500,250,1,00225,India
767723,2023-07-08,1009,Moisturizer,250,500,250,1,00433,India
767723,2023-07-08,1008,Makeup Remover,80,160,80,1,00433,India
767723,2023-07-08,1007,Eyeshadow,200,400,200,1,00433,India
767723,2023-07-08,1001,Lipstick,150,300,150,1,00433,India
962557,2023-07-08,1012,Body Lotion,200,400,200,1,00254,India
962557,2023-07-08,1001,Lipstick,150,300,150,1,00254,India
962557,2023-07-08,1006,Blush,150,300,150,1,00254,India
206657,2023-07-08,1007,Eyeshadow,200,400,200,1,00019,India
239209,2023-07-08,1007,Eyeshadow,200,400,200,1,00437,India
239209,2023-07-08,1002,Mascara,200,400,200,1,00437,India
964390,2023-07-08,1006,Blush,150,300,150,1,00361,India
964390,2023-07-08,1005,Nail Polish,50,100,50,1,00361,India
964390,2023-07-08,1008,Makeup Remover,80,160,80,1,00361,India
964390,2023-07-08,1004,Eyeliner,100,200,100,1,00361,India
802428,2023-07-08,1003,Foundation,300,600,300,1,00315,India
802428,2023-07-08,1005,Nail Polish,50,100,50,1,00315,India
446864,2023-07-08,1002,Mascara,200,400,200,1,00449,India
446864,2023-07-08,1006,Blush,150,300,150,1,00449,India
446864,2023-07-08,1012,Body Lotion,200,400,200,1,00449,India
291889,2023-07-08,1006,Blush,150,300,150,1,00047,India
291889,2023-07-08,1012,Body Lotion,200,400,200,1,00047,India
291889,2023-07-08,1008,Makeup Remover,80,160,80,1,00047,India
725907,2023-07-08,1002,Mascara,200,400,200,1,00011,India
725907,2023-07-08,1008,Makeup Remover,80,160,80,1,00011,India
725907,2023-07-08,1004,Eyeliner,100,200,100,1,00011,India
725907,2023-07-08,1007,Eyeshadow,200,400,200,1,00011,India
789969,2023-07-08,1012,Body Lotion,200,400,200,1,00019,India
789969,2023-07-08,1004,Eyeliner,100,200,100,1,00019,India
789969,2023-07-08,1003,Foundation,300,600,300,1,00019,India
789969,2023-07-08,1005,Nail Polish,50,100,50,1,00019,India
789969,2023-07-08,1009,Moisturizer,250,500,250,1,00019,India
649423,2023-07-08,1007,Eyeshadow,200,400,200,1,00411,India
649423,2023-07-08,1012,Body Lotion,200,400,200,1,00411,India
672302,2023-07-08,1001,Lipstick,150,300,150,1,00040,India
672302,2023-07-08,1012,Body Lotion,200,400,200,1,00040,India
672302,2023-07-08,1005,Nail Polish,50,100,50,1,00040,India
540229,2023-07-08,1003,Foundation,300,600,300,1,00041,India
540229,2023-07-08,1006,Blush,150,300,150,1,00041,India
540229,2023-07-08,1005,Nail Polish,50,100,50,1,00041,India
540229,2023-07-08,1009,Moisturizer,250,500,250,1,00041,India
540229,2023-07-08,1002,Mascara,200,400,200,1,00041,India
570710,2023-07-08,1001,Lipstick,150,300,150,1,00184,India
570710,2023-07-08,1006,Blush,150,300,150,1,00184,India
570710,2023-07-08,1008,Makeup Remover,80,160,80,1,00184,India
103450,2023-07-08,1009,Moisturizer,250,500,250,1,00448,India
103450,2023-07-08,1002,Mascara,200,400,200,1,00448,India
103450,2023-07-08,1001,Lipstick,150,300,150,1,00448,India
192557,2023-07-08,1009,Moisturizer,250,500,250,1,00073,India
192557,2023-07-08,1012,Body Lotion,200,400,200,1,00073,India
846999,2023-07-08,1003,Foundation,300,600,300,1,00207,India
846999,2023-07-08,1006,Blush,150,300,150,1,00207,India
846999,2023-07-08,1007,Eyeshadow,200,400,200,1,00207,India
846999,2023-07-08,1012,Body Lotion,200,400,200,1,00207,India
132109,2023-07-08,1004,Eyeliner,100,200,100,1,00425,India
132109,2023-07-08,1002,Mascara,200,400,200,1,00425,India
132109,2023-07-08,1006,Blush,150,300,150,1,00425,India
132109,2023-07-08,1008,Makeup Remover,80,160,80,1,00425,India
132109,2023-07-08,1009,Moisturizer,250,500,250,1,00425,India
625485,2023-07-08,1012,Body Lotion,200,400,200,1,00490,India
625485,2023-07-08,1001,Lipstick,150,300,150,1,00490,India
625485,2023-07-08,1004,Eyeliner,100,200,100,1,00490,India
182259,2023-07-08,1003,Foundation,300,600,300,1,00106,India
795396,2023-07-08,1005,Nail Polish,50,100,50,1,00446,India
795396,2023-07-08,1006,Blush,150,300,150,1,00446,India
795396,2023-07-08,1004,Eyeliner,100,200,100,1,00446,India
123636,2023-07-08,1007,Eyeshadow,200,400,200,1,00463,India
123636,2023-07-08,1006,Blush,150,300,150,1,00463,India
123636,2023-07-08,1002,Mascara,200,400,200,1,00463,India
216944,2023-07-08,1008,Makeup Remover,80,160,80,1,00471,India
216944,2023-07-08,1001,Lipstick,150,300,150,1,00471,India
216944,2023-07-08,1003,Foundation,300,600,300,1,00471,India
636716,2023-07-08,1004,Eyeliner,100,200,100,1,00019,India
636716,2023-07-08,1005,Nail Polish,50,100,50,1,00019,India
359764,2023-07-08,1005,Nail Polish,50,100,50,1,00378,India
528569,2023-07-08,1012,Body Lotion,200,400,200,1,00117,India
528569,2023-07-08,1007,Eyeshadow,200,400,200,1,00117,India
528569,2023-07-08,1009,Moisturizer,250,500,250,1,00117,India
957188,2023-07-08,1006,Blush,150,300,150,1,00355,India
712131,2023-07-08,1012,Body Lotion,200,400,200,1,00405,India
766685,2023-07-08,1008,Makeup Remover,80,160,80,1,00216,India
766685,2023-07-08,1005,Nail Polish,50,100,50,1,00216,India
766685,2023-07-08,1004,Eyeliner,100,200,100,1,00216,India
571551,2023-07-08,1005,Nail Polish,50,100,50,1,00499,India
571551,2023-07-08,1001,Lipstick,150,300,150,1,00499,India
979289,2023-07-08,1006,Blush,150,300,150,1,00111,India
542419,2023-07-08,1003,Foundation,300,600,300,1,00171,India
542419,2023-07-08,1012,Body Lotion,200,400,200,1,00171,India
542419,2023-07-08,1006,Blush,150,300,150,1,00171,India
542419,2023-07-08,1001,Lipstick,150,300,150,1,00171,India
542419,2023-07-08,1002,Mascara,200,400,200,1,00171,India
778177,2023-07-08,1002,Mascara,200,400,200,1,00264,India
778177,2023-07-08,1012,Body Lotion,200,400,200,1,00264,India
778177,2023-07-08,1001,Lipstick,150,300,150,1,00264,India
778177,2023-07-08,1009,Moisturizer,250,500,250,1,00264,India
817475,2023-07-09,1009,Moisturizer,250,500,250,1,00437,India
817475,2023-07-09,1008,Makeup Remover,80,160,80,1,00437,India
143170,2023-07-09,1004,Eyeliner,100,200,100,1,00467,India
143170,2023-07-09,1001,Lipstick,150,300,150,1,00467,India
478230,2023-07-09,1005,Nail Polish,50,100,50,1,00216,India
478230,2023-07-09,1002,Mascara,200,400,200,1,00216,India
478230,2023-07-09,1003,Foundation,300,600,300,1,00216,India
474659,2023-07-09,1004,Eyeliner,100,200,100,1,00103,India
474659,2023-07-09,1003,Foundation,300,600,300,1,00103,India
423589,2023-07-09,1003,Foundation,300,600,300,1,00052,India
423589,2023-07-09,1002,Mascara,200,400,200,1,00052,India
423937,2023-07-09,1009,Moisturizer,250,500,250,1,00111,India
423937,2023-07-09,1012,Body Lotion,200,400,200,1,00111,India
423937,2023-07-09,1005,Nail Polish,50,100,50,1,00111,India
423937,2023-07-09,1008,Makeup Remover,80,160,80,1,00111,India
506755,2023-07-09,1007,Eyeshadow,200,400,200,1,00079,India
506755,2023-07-09,1006,Blush,150,300,150,1,00079,India
506755,2023-07-09,1003,Foundation,300,600,300,1,00079,India
254124,2023-07-09,1002,Mascara,200,400,200,1,00049,India
254124,2023-07-09,1009,Moisturizer,250,500,250,1,00049,India
254124,2023-07-09,1004,Eyeliner,100,200,100,1,00049,India
268305,2023-07-09,1009,Moisturizer,250,500,250,1,00176,India
268305,2023-07-09,1006,Blush,150,300,150,1,00176,India
268305,2023-07-09,1005,Nail Polish,50,100,50,1,00176,India
500690,2023-07-09,1005,Nail Polish,50,100,50,1,00311,India
500690,2023-07-09,1002,Mascara,200,400,200,1,00311,India
500690,2023-07-09,1004,Eyeliner,100,200,100,1,00311,India
500690,2023-07-09,1012,Body Lotion,200,400,200,1,00311,India
869667,2023-07-09,1009,Moisturizer,250,500,250,1,00179,India
869667,2023-07-09,1012,Body Lotion,200,400,200,1,00179,India
869667,2023-07-09,1003,Foundation,300,600,300,1,00179,India
475609,2023-07-09,1005,Nail Polish,50,100,50,1,00241,India
475609,2023-07-09,1001,Lipstick,150,300,150,1,00241,India
735027,2023-07-09,1004,Eyeliner,100,200,100,1,00135,India
735027,2023-07-09,1006,Blush,150,300,150,1,00135,India
735027,2023-07-09,1007,Eyeshadow,200,400,200,1,00135,India
735027,2023-07-09,1001,Lipstick,150,300,150,1,00135,India
735027,2023-07-09,1002,Mascara,200,400,200,1,00135,India
218298,2023-07-09,1001,Lipstick,150,300,150,1,00397,India
218298,2023-07-09,1002,Mascara,200,400,200,1,00397,India
218298,2023-07-09,1009,Moisturizer,250,500,250,1,00397,India
122869,2023-07-09,1004,Eyeliner,100,200,100,1,00287,India
122869,2023-07-09,1009,Moisturizer,250,500,250,1,00287,India
122869,2023-07-09,1012,Body Lotion,200,400,200,1,00287,India
284747,2023-07-09,1001,Lipstick,150,300,150,1,00357,India
284747,2023-07-09,1003,Foundation,300,600,300,1,00357,India
651609,2023-07-09,1007,Eyeshadow,200,400,200,1,00176,India
651609,2023-07-09,1009,Moisturizer,250,500,250,1,00176,India
651609,2023-07-09,1012,Body Lotion,200,400,200,1,00176,India
651609,2023-07-09,1004,Eyeliner,100,200,100,1,00176,India
536397,2023-07-09,1005,Nail Polish,50,100,50,1,00217,India
536397,2023-07-09,1006,Blush,150,300,150,1,00217,India
536397,2023-07-09,1002,Mascara,200,400,200,1,00217,India
536397,2023-07-09,1008,Makeup Remover,80,160,80,1,00217,India
416270,2023-07-09,1007,Eyeshadow,200,400,200,1,00208,India
416270,2023-07-09,1004,Eyeliner,100,200,100,1,00208,India
861956,2023-07-09,1003,Foundation,300,600,300,1,00338,India
789584,2023-07-09,1003,Foundation,300,600,300,1,00030,India
789584,2023-07-09,1002,Mascara,200,400,200,1,00030,India
789584,2023-07-09,1007,Eyeshadow,200,400,200,1,00030,India
789584,2023-07-09,1012,Body Lotion,200,400,200,1,00030,India
424435,2023-07-09,1007,Eyeshadow,200,400,200,1,00124,India
511402,2023-07-09,1012,Body Lotion,200,400,200,1,00234,India
511402,2023-07-09,1001,Lipstick,150,300,150,1,00234,India
511402,2023-07-09,1002,Mascara,200,400,200,1,00234,India
511402,2023-07-09,1003,Foundation,300,600,300,1,00234,India
667739,2023-07-09,1004,Eyeliner,100,200,100,1,00401,India
667739,2023-07-09,1006,Blush,150,300,150,1,00401,India
667739,2023-07-09,1009,Moisturizer,250,500,250,1,00401,India
858125,2023-07-09,1002,Mascara,200,400,200,1,00024,India
858125,2023-07-09,1012,Body Lotion,200,400,200,1,00024,India
865758,2023-07-09,1007,Eyeshadow,200,400,200,1,00489,India
694362,2023-07-09,1004,Eyeliner,100,200,100,1,00452,India
694362,2023-07-09,1008,Makeup Remover,80,160,80,1,00452,India
694362,2023-07-09,1002,Mascara,200,400,200,1,00452,India
616629,2023-07-09,1008,Makeup Remover,80,160,80,1,00094,India
899661,2023-07-09,1002,Mascara,200,400,200,1,00310,India
899661,2023-07-09,1005,Nail Polish,50,100,50,1,00310,India
546776,2023-07-09,1007,Eyeshadow,200,400,200,1,00337,India
166470,2023-07-09,1002,Mascara,200,400,200,1,00036,India
166470,2023-07-09,1004,Eyeliner,100,200,100,1,00036,India
166470,2023-07-09,1012,Body Lotion,200,400,200,1,00036,India
166470,2023-07-09,1007,Eyeshadow,200,400,200,1,00036,India
166470,2023-07-09,1006,Blush,150,300,150,1,00036,India
236663,2023-07-10,1005,Nail Polish,50,100,50,1,00456,India
861756,2023-07-10,1008,Makeup Remover,80,160,80,1,00087,India
861756,2023-07-10,1001,Lipstick,150,300,150,1,00087,India
861756,2023-07-10,1004,Eyeliner,100,200,100,1,00087,India
620422,2023-07-10,1008,Makeup Remover,80,160,80,1,00116,India
620422,2023-07-10,1007,Eyeshadow,200,400,200,1,00116,India
568641,2023-07-10,1008,Makeup Remover,80,160,80,1,00132,India
568641,2023-07-10,1012,Body Lotion,200,400,200,1,00132,India
568641,2023-07-10,1001,Lipstick,150,300,150,1,00132,India
568641,2023-07-10,1007,Eyeshadow,200,400,200,1,00132,India
439636,2023-07-10,1002,Mascara,200,400,200,1,00163,India
439636,2023-07-10,1006,Blush,150,300,150,1,00163,India
621209,2023-07-10,1012,Body Lotion,200,400,200,1,00168,India
621209,2023-07-10,1009,Moisturizer,250,500,250,1,00168,India
961843,2023-07-10,1004,Eyeliner,100,200,100,1,00500,India
223981,2023-07-10,1007,Eyeshadow,200,400,200,1,00386,India
223981,2023-07-10,1008,Makeup Remover,80,160,80,1,00386,India
223981,2023-07-10,1001,Lipstick,150,300,150,1,00386,India
519228,2023-07-10,1009,Moisturizer,250,500,250,1,00030,India
519228,2023-07-10,1003,Foundation,300,600,300,1,00030,India
519228,2023-07-10,1012,Body Lotion,200,400,200,1,00030,India
519228,2023-07-10,1007,Eyeshadow,200,400,200,1,00030,India
519228,2023-07-10,1005,Nail Polish,50,100,50,1,00030,India
630724,2023-07-10,1002,Mascara,200,400,200,1,00115,India
630724,2023-07-10,1007,Eyeshadow,200,400,200,1,00115,India
630724,2023-07-10,1005,Nail Polish,50,100,50,1,00115,India
232357,2023-07-10,1004,Eyeliner,100,200,100,1,00006,India
232357,2023-07-10,1009,Moisturizer,250,500,250,1,00006,India
143895,2023-07-10,1006,Blush,150,300,150,1,00139,India
143895,2023-07-10,1003,Foundation,300,600,300,1,00139,India
143895,2023-07-10,1008,Makeup Remover,80,160,80,1,00139,India
657705,2023-07-10,1003,Foundation,300,600,300,1,00265,India
141157,2023-07-10,1008,Makeup Remover,80,160,80,1,00023,India
141157,2023-07-10,1002,Mascara,200,400,200,1,00023,India
141157,2023-07-10,1007,Eyeshadow,200,400,200,1,00023,India
266283,2023-07-10,1005,Nail Polish,50,100,50,1,00096,India
266283,2023-07-10,1012,Body Lotion,200,400,200,1,00096,India
266283,2023-07-10,1006,Blush,150,300,150,1,00096,India
452337,2023-07-10,1003,Foundation,300,600,300,1,00406,India
452337,2023-07-10,1007,Eyeshadow,200,400,200,1,00406,India
452337,2023-07-10,1001,Lipstick,150,300,150,1,00406,India
452337,2023-07-10,1006,Blush,150,300,150,1,00406,India
795315,2023-07-10,1002,Mascara,200,400,200,1,00485,India
795315,2023-07-10,1009,Moisturizer,250,500,250,1,00485,India
259226,2023-07-10,1012,Body Lotion,200,400,200,1,00351,India
259226,2023-07-10,1005,Nail Polish,50,100,50,1,00351,India
670781,2023-07-10,1002,Mascara,200,400,200,1,00278,India
670781,2023-07-10,1003,Foundation,300,600,300,1,00278,India
670781,2023-07-10,1004,Eyeliner,100,200,100,1,00278,India
819158,2023-07-10,1012,Body Lotion,200,400,200,1,00340,India
819158,2023-07-10,1001,Lipstick,150,300,150,1,00340,India
481540,2023-07-10,1008,Makeup Remover,80,160,80,1,00424,India
324628,2023-07-10,1007,Eyeshadow,200,400,200,1,00016,India
324628,2023-07-10,1005,Nail Polish,50,100,50,1,00016,India
787932,2023-07-10,1001,Lipstick,150,300,150,1,00270,India
787932,2023-07-10,1003,Foundation,300,600,300,1,00270,India
787932,2023-07-10,1008,Makeup Remover,80,160,80,1,00270,India
795914,2023-07-10,1002,Mascara,200,400,200,1,00414,India
795914,2023-07-10,1005,Nail Polish,50,100,50,1,00414,India
795914,2023-07-10,1004,Eyeliner,100,200,100,1,00414,India
310728,2023-07-10,1008,Makeup Remover,80,160,80,1,00061,India
310728,2023-07-10,1001,Lipstick,150,300,150,1,00061,India
307361,2023-07-10,1007,Eyeshadow,200,400,200,1,00278,India
307361,2023-07-10,1006,Blush,150,300,150,1,00278,India
411526,2023-07-10,1006,Blush,150,300,150,1,00351,India
411526,2023-07-10,1008,Makeup Remover,80,160,80,1,00351,India
851642,2023-07-10,1001,Lipstick,150,300,150,1,00160,India
856367,2023-07-10,1004,Eyeliner,100,200,100,1,00087,India
856367,2023-07-10,1012,Body Lotion,200,400,200,1,00087,India
856367,2023-07-10,1007,Eyeshadow,200,400,200,1,00087,India
856367,2023-07-10,1006,Blush,150,300,150,1,00087,India
492593,2023-07-10,1005,Nail Polish,50,100,50,1,00401,India
492593,2023-07-10,1006,Blush,150,300,150,1,00401,India
492593,2023-07-10,1007,Eyeshadow,200,400,200,1,00401,India
360657,2023-07-10,1003,Foundation,300,600,300,1,00429,India
360657,2023-07-10,1002,Mascara,200,400,200,1,00429,India
360657,2023-07-10,1007,Eyeshadow,200,400,200,1,00429,India
360657,2023-07-10,1009,Moisturizer,250,500,250,1,00429,India
145570,2023-07-10,1009,Moisturizer,250,500,250,1,00413,India
145570,2023-07-10,1005,Nail Polish,50,100,50,1,00413,India
145570,2023-07-10,1008,Makeup Remover,80,160,80,1,00413,India
145570,2023-07-10,1012,Body Lotion,200,400,200,1,00413,India
189450,2023-07-10,1003,Foundation,300,600,300,1,00118,India
189450,2023-07-10,1002,Mascara,200,400,200,1,00118,India
189450,2023-07-10,1004,Eyeliner,100,200,100,1,00118,India
189450,2023-07-10,1008,Makeup Remover,80,160,80,1,00118,India
813832,2023-07-10,1006,Blush,150,300,150,1,00327,India
813832,2023-07-10,1004,Eyeliner,100,200,100,1,00327,India
362427,2023-07-10,1008,Makeup Remover,80,160,80,1,00500,India
362427,2023-07-10,1002,Mascara,200,400,200,1,00500,India
742876,2023-07-10,1007,Eyeshadow,200,400,200,1,00365,India
742876,2023-07-10,1012,Body Lotion,200,400,200,1,00365,India
742876,2023-07-10,1006,Blush,150,300,150,1,00365,India
742876,2023-07-10,1001,Lipstick,150,300,150,1,00365,India
659497,2023-07-10,1009,Moisturizer,250,500,250,1,00475,India
659497,2023-07-10,1004,Eyeliner,100,200,100,1,00475,India
659497,2023-07-10,1006,Blush,150,300,150,1,00475,India
659497,2023-07-10,1003,Foundation,300,600,300,1,00475,India
659497,2023-07-10,1012,Body Lotion,200,400,200,1,00475,India
105758,2023-07-10,1009,Moisturizer,250,500,250,1,00224,India
105758,2023-07-10,1003,Foundation,300,600,300,1,00224,India
105758,2023-07-10,1001,Lipstick,150,300,150,1,00224,India
536043,2023-07-10,1003,Foundation,300,600,300,1,00361,India
536043,2023-07-10,1012,Body Lotion,200,400,200,1,00361,India
538717,2023-07-10,1005,Nail Polish,50,100,50,1,00413,India
538717,2023-07-10,1003,Foundation,300,600,300,1,00413,India
173754,2023-07-10,1003,Foundation,300,600,300,1,00278,India
173754,2023-07-10,1002,Mascara,200,400,200,1,00278,India
173754,2023-07-10,1006,Blush,150,300,150,1,00278,India
173754,2023-07-10,1005,Nail Polish,50,100,50,1,00278,India
332650,2023-07-10,1005,Nail Polish,50,100,50,1,00112,India
404819,2023-07-10,1001,Lipstick,150,300,150,1,00018,India
404819,2023-07-10,1004,Eyeliner,100,200,100,1,00018,India
404819,2023-07-10,1008,Makeup Remover,80,160,80,1,00018,India
404819,2023-07-10,1002,Mascara,200,400,200,1,00018,India
246577,2023-07-10,1007,Eyeshadow,200,400,200,1,00271,India
246577,2023-07-10,1008,Makeup Remover,80,160,80,1,00271,India
246577,2023-07-10,1002,Mascara,200,400,200,1,00271,India
246577,2023-07-10,1003,Foundation,300,600,300,1,00271,India
994383,2023-07-10,1007,Eyeshadow,200,400,200,1,00244,India
994383,2023-07-10,1001,Lipstick,150,300,150,1,00244,India
551597,2023-07-10,1004,Eyeliner,100,200,100,1,00199,India
551597,2023-07-10,1002,Mascara,200,400,200,1,00199,India
551597,2023-07-10,1008,Makeup Remover,80,160,80,1,00199,India
669085,2023-07-10,1004,Eyeliner,100,200,100,1,00140,India
669085,2023-07-10,1003,Foundation,300,600,300,1,00140,India
669085,2023-07-10,1012,Body Lotion,200,400,200,1,00140,India
630253,2023-07-10,1007,Eyeshadow,200,400,200,1,00424,India
630253,2023-07-10,1009,Moisturizer,250,500,250,1,00424,India
630253,2023-07-10,1005,Nail Polish,50,100,50,1,00424,India
630253,2023-07-10,1003,Foundation,300,600,300,1,00424,India
426931,2023-07-10,1006,Blush,150,300,150,1,00134,India
426931,2023-07-10,1004,Eyeliner,100,200,100,1,00134,India
514760,2023-07-11,1003,Foundation,300,600,300,1,00061,India
514760,2023-07-11,1009,Moisturizer,250,500,250,1,00061,India
687017,2023-07-11,1005,Nail Polish,50,100,50,1,00434,India
687017,2023-07-11,1004,Eyeliner,100,200,100,1,00434,India
687017,2023-07-11,1001,Lipstick,150,300,150,1,00434,India
531029,2023-07-11,1008,Makeup Remover,80,160,80,1,00417,India
473152,2023-07-11,1004,Eyeliner,100,200,100,1,00290,India
426696,2023-07-11,1003,Foundation,300,600,300,1,00174,India
500504,2023-07-11,1001,Lipstick,150,300,150,1,00356,India
750104,2023-07-11,1008,Makeup Remover,80,160,80,1,00242,India
750104,2023-07-11,1001,Lipstick,150,300,150,1,00242,India
750104,2023-07-11,1005,Nail Polish,50,100,50,1,00242,India
867507,2023-07-11,1009,Moisturizer,250,500,250,1,00192,India
453193,2023-07-11,1003,Foundation,300,600,300,1,00213,India
453193,2023-07-11,1012,Body Lotion,200,400,200,1,00213,India
453193,2023-07-11,1005,Nail Polish,50,100,50,1,00213,India
992958,2023-07-11,1006,Blush,150,300,150,1,00183,India
992958,2023-07-11,1007,Eyeshadow,200,400,200,1,00183,India
158432,2023-07-11,1004,Eyeliner,100,200,100,1,00301,India
158432,2023-07-11,1009,Moisturizer,250,500,250,1,00301,India
978084,2023-07-11,1009,Moisturizer,250,500,250,1,00082,India
978084,2023-07-11,1003,Foundation,300,600,300,1,00082,India
978084,2023-07-11,1005,Nail Polish,50,100,50,1,00082,India
421770,2023-07-11,1007,Eyeshadow,200,400,200,1,00154,India
421770,2023-07-11,1003,Foundation,300,600,300,1,00154,India
421770,2023-07-11,1001,Lipstick,150,300,150,1,00154,India
302960,2023-07-11,1008,Makeup Remover,80,160,80,1,00273,India
302960,2023-07-11,1001,Lipstick,150,300,150,1,00273,India
302960,2023-07-11,1006,Blush,150,300,150,1,00273,India
302960,2023-07-11,1004,Eyeliner,100,200,100,1,00273,India
723210,2023-07-11,1009,Moisturizer,250,500,250,1,00013,India
723210,2023-07-11,1012,Body Lotion,200,400,200,1,00013,India
723210,2023-07-11,1008,Makeup Remover,80,160,80,1,00013,India
451108,2023-07-11,1012,Body Lotion,200,400,200,1,00041,India
451108,2023-07-11,1009,Moisturizer,250,500,250,1,00041,India
104726,2023-07-11,1008,Makeup Remover,80,160,80,1,00322,India
104726,2023-07-11,1003,Foundation,300,600,300,1,00322,India
104726,2023-07-11,1001,Lipstick,150,300,150,1,00322,India
104726,2023-07-11,1006,Blush,150,300,150,1,00322,India
466702,2023-07-11,1006,Blush,150,300,150,1,00176,India
466702,2023-07-11,1003,Foundation,300,600,300,1,00176,India
466702,2023-07-11,1005,Nail Polish,50,100,50,1,00176,India
400842,2023-07-11,1009,Moisturizer,250,500,250,1,00017,India
400842,2023-07-11,1004,Eyeliner,100,200,100,1,00017,India
894770,2023-07-11,1007,Eyeshadow,200,400,200,1,00122,India
894770,2023-07-11,1012,Body Lotion,200,400,200,1,00122,India
894770,2023-07-11,1008,Makeup Remover,80,160,80,1,00122,India
430070,2023-07-11,1003,Foundation,300,600,300,1,00001,India
430070,2023-07-11,1002,Mascara,200,400,200,1,00001,India
735189,2023-07-11,1002,Mascara,200,400,200,1,00041,India
735189,2023-07-11,1008,Makeup Remover,80,160,80,1,00041,India
735189,2023-07-11,1007,Eyeshadow,200,400,200,1,00041,India
379344,2023-07-11,1001,Lipstick,150,300,150,1,00045,India
379344,2023-07-11,1002,Mascara,200,400,200,1,00045,India
379344,2023-07-11,1003,Foundation,300,600,300,1,00045,India
379344,2023-07-11,1009,Moisturizer,250,500,250,1,00045,India
379344,2023-07-11,1004,Eyeliner,100,200,100,1,00045,India
709168,2023-07-11,1003,Foundation,300,600,300,1,00141,India
709168,2023-07-11,1004,Eyeliner,100,200,100,1,00141,India
104289,2023-07-11,1005,Nail Polish,50,100,50,1,00448,India
324863,2023-07-11,1006,Blush,150,300,150,1,00181,India
324863,2023-07-11,1012,Body Lotion,200,400,200,1,00181,India
324863,2023-07-11,1005,Nail Polish,50,100,50,1,00181,India
935851,2023-07-11,1003,Foundation,300,600,300,1,00307,India
935851,2023-07-11,1012,Body Lotion,200,400,200,1,00307,India
935851,2023-07-11,1009,Moisturizer,250,500,250,1,00307,India
415686,2023-07-11,1012,Body Lotion,200,400,200,1,00374,India
415686,2023-07-11,1008,Makeup Remover,80,160,80,1,00374,India
805418,2023-07-11,1001,Lipstick,150,300,150,1,00281,India
805418,2023-07-11,1005,Nail Polish,50,100,50,1,00281,India
432001,2023-07-11,1004,Eyeliner,100,200,100,1,00274,India
432001,2023-07-11,1005,Nail Polish,50,100,50,1,00274,India
422105,2023-07-11,1009,Moisturizer,250,500,250,1,00386,India
422105,2023-07-11,1006,Blush,150,300,150,1,00386,India
422105,2023-07-11,1001,Lipstick,150,300,150,1,00386,India
422105,2023-07-11,1004,Eyeliner,100,200,100,1,00386,India
168474,2023-07-11,1005,Nail Polish,50,100,50,1,00449,India
643624,2023-07-11,1004,Eyeliner,100,200,100,1,00338,India
157988,2023-07-11,1002,Mascara,200,400,200,1,00325,India
157988,2023-07-11,1007,Eyeshadow,200,400,200,1,00325,India
157988,2023-07-11,1012,Body Lotion,200,400,200,1,00325,India
851068,2023-07-11,1003,Foundation,300,600,300,1,00190,India
851068,2023-07-11,1007,Eyeshadow,200,400,200,1,00190,India
851068,2023-07-11,1001,Lipstick,150,300,150,1,00190,India
851068,2023-07-11,1005,Nail Polish,50,100,50,1,00190,India
621192,2023-07-11,1001,Lipstick,150,300,150,1,00197,India
621192,2023-07-11,1003,Foundation,300,600,300,1,00197,India
621192,2023-07-11,1002,Mascara,200,400,200,1,00197,India
621192,2023-07-11,1005,Nail Polish,50,100,50,1,00197,India
130248,2023-07-11,1009,Moisturizer,250,500,250,1,00196,India
271191,2023-07-11,1012,Body Lotion,200,400,200,1,00362,India
271191,2023-07-11,1003,Foundation,300,600,300,1,00362,India
271191,2023-07-11,1004,Eyeliner,100,200,100,1,00362,India
739789,2023-07-11,1001,Lipstick,150,300,150,1,00051,India
739789,2023-07-11,1002,Mascara,200,400,200,1,00051,India
739789,2023-07-11,1006,Blush,150,300,150,1,00051,India
974907,2023-07-11,1006,Blush,150,300,150,1,00033,India
554158,2023-07-12,1009,Moisturizer,250,500,250,1,00309,India
554158,2023-07-12,1006,Blush,150,300,150,1,00309,India
554158,2023-07-12,1001,Lipstick,150,300,150,1,00309,India
554158,2023-07-12,1003,Foundation,300,600,300,1,00309,India
151667,2023-07-12,1007,Eyeshadow,200,400,200,1,00498,India
949395,2023-07-12,1008,Makeup Remover,80,160,80,1,00448,India
949395,2023-07-12,1009,Moisturizer,250,500,250,1,00448,India
949395,2023-07-12,1003,Foundation,300,600,300,1,00448,India
949395,2023-07-12,1001,Lipstick,150,300,150,1,00448,India
453784,2023-07-12,1002,Mascara,200,400,200,1,00283,India
453784,2023-07-12,1005,Nail Polish,50,100,50,1,00283,India
453784,2023-07-12,1004,Eyeliner,100,200,100,1,00283,India
453784,2023-07-12,1007,Eyeshadow,200,400,200,1,00283,India
758690,2023-07-12,1009,Moisturizer,250,500,250,1,00148,India
758690,2023-07-12,1004,Eyeliner,100,200,100,1,00148,India
758690,2023-07-12,1006,Blush,150,300,150,1,00148,India
758690,2023-07-12,1003,Foundation,300,600,300,1,00148,India
234509,2023-07-12,1003,Foundation,300,600,300,1,00399,India
735011,2023-07-12,1001,Lipstick,150,300,150,1,00441,India
735011,2023-07-12,1012,Body Lotion,200,400,200,1,00441,India
735011,2023-07-12,1007,Eyeshadow,200,400,200,1,00441,India
735011,2023-07-12,1003,Foundation,300,600,300,1,00441,India
735011,2023-07-12,1005,Nail Polish,50,100,50,1,00441,India
729927,2023-07-12,1001,Lipstick,150,300,150,1,00126,India
729927,2023-07-12,1007,Eyeshadow,200,400,200,1,00126,India
729927,2023-07-12,1012,Body Lotion,200,400,200,1,00126,India
948088,2023-07-12,1009,Moisturizer,250,500,250,1,00431,India
948088,2023-07-12,1007,Eyeshadow,200,400,200,1,00431,India
236838,2023-07-12,1002,Mascara,200,400,200,1,00049,India
236838,2023-07-12,1004,Eyeliner,100,200,100,1,00049,India
236838,2023-07-12,1007,Eyeshadow,200,400,200,1,00049,India
236838,2023-07-12,1005,Nail Polish,50,100,50,1,00049,India
443774,2023-07-12,1005,Nail Polish,50,100,50,1,00308,India
443774,2023-07-12,1001,Lipstick,150,300,150,1,00308,India
976829,2023-07-12,1006,Blush,150,300,150,1,00130,India
976829,2023-07-12,1007,Eyeshadow,200,400,200,1,00130,India
976829,2023-07-12,1001,Lipstick,150,300,150,1,00130,India
699268,2023-07-12,1006,Blush,150,300,150,1,00214,India
699268,2023-07-12,1002,Mascara,200,400,200,1,00214,India
736098,2023-07-12,1005,Nail Polish,50,100,50,1,00174,India
736098,2023-07-12,1007,Eyeshadow,200,400,200,1,00174,India
608531,2023-07-12,1012,Body Lotion,200,400,200,1,00178,India
608531,2023-07-12,1008,Makeup Remover,80,160,80,1,00178,India
608531,2023-07-12,1001,Lipstick,150,300,150,1,00178,India
608531,2023-07-12,1002,Mascara,200,400,200,1,00178,India
719551,2023-07-12,1008,Makeup Remover,80,160,80,1,00273,India
719551,2023-07-12,1007,Eyeshadow,200,400,200,1,00273,India
399256,2023-07-12,1008,Makeup Remover,80,160,80,1,00303,India
399256,2023-07-12,1005,Nail Polish,50,100,50,1,00303,India
399256,2023-07-12,1009,Moisturizer,250,500,250,1,00303,India
243202,2023-07-12,1009,Moisturizer,250,500,250,1,00300,India
243202,2023-07-12,1008,Makeup Remover,80,160,80,1,00300,India
243202,2023-07-12,1012,Body Lotion,200,400,200,1,00300,India
243202,2023-07-12,1003,Foundation,300,600,300,1,00300,India
243202,2023-07-12,1005,Nail Polish,50,100,50,1,00300,India
850939,2023-07-12,1007,Eyeshadow,200,400,200,1,00064,India
850939,2023-07-12,1002,Mascara,200,400,200,1,00064,India
183838,2023-07-12,1007,Eyeshadow,200,400,200,1,00180,India
183838,2023-07-12,1002,Mascara,200,400,200,1,00180,India
161212,2023-07-12,1009,Moisturizer,250,500,250,1,00040,India
161212,2023-07-12,1006,Blush,150,300,150,1,00040,India
161212,2023-07-12,1012,Body Lotion,200,400,200,1,00040,India
161212,2023-07-12,1007,Eyeshadow,200,400,200,1,00040,India
715394,2023-07-12,1002,Mascara,200,400,200,1,00262,India
715394,2023-07-12,1005,Nail Polish,50,100,50,1,00262,India
484447,2023-07-12,1009,Moisturizer,250,500,250,1,00295,India
484447,2023-07-12,1006,Blush,150,300,150,1,00295,India
484447,2023-07-12,1001,Lipstick,150,300,150,1,00295,India
484447,2023-07-12,1007,Eyeshadow,200,400,200,1,00295,India
244207,2023-07-12,1005,Nail Polish,50,100,50,1,00274,India
244207,2023-07-12,1006,Blush,150,300,150,1,00274,India
696110,2023-07-12,1012,Body Lotion,200,400,200,1,00391,India
613414,2023-07-12,1012,Body Lotion,200,400,200,1,00083,India
613414,2023-07-12,1009,Moisturizer,250,500,250,1,00083,India
613414,2023-07-12,1006,Blush,150,300,150,1,00083,India
183318,2023-07-12,1008,Makeup Remover,80,160,80,1,00474,India
183318,2023-07-12,1007,Eyeshadow,200,400,200,1,00474,India
183318,2023-07-12,1002,Mascara,200,400,200,1,00474,India
183318,2023-07-12,1012,Body Lotion,200,400,200,1,00474,India
173009,2023-07-12,1001,Lipstick,150,300,150,1,00012,India
173009,2023-07-12,1003,Foundation,300,600,300,1,00012,India
896929,2023-07-12,1005,Nail Polish,50,100,50,1,00282,India
896929,2023-07-12,1002,Mascara,200,400,200,1,00282,India
896929,2023-07-12,1009,Moisturizer,250,500,250,1,00282,India
896929,2023-07-12,1003,Foundation,300,600,300,1,00282,India
896929,2023-07-12,1004,Eyeliner,100,200,100,1,00282,India
171994,2023-07-12,1009,Moisturizer,250,500,250,1,00123,India
171994,2023-07-12,1005,Nail Polish,50,100,50,1,00123,India
171994,2023-07-12,1002,Mascara,200,400,200,1,00123,India
171994,2023-07-12,1006,Blush,150,300,150,1,00123,India
510313,2023-07-12,1008,Makeup Remover,80,160,80,1,00459,India
510313,2023-07-12,1002,Mascara,200,400,200,1,00459,India
510313,2023-07-12,1007,Eyeshadow,200,400,200,1,00459,India
510313,2023-07-12,1009,Moisturizer,250,500,250,1,00459,India
980319,2023-07-12,1012,Body Lotion,200,400,200,1,00308,India
980319,2023-07-12,1006,Blush,150,300,150,1,00308,India
980319,2023-07-12,1009,Moisturizer,250,500,250,1,00308,India
980319,2023-07-12,1007,Eyeshadow,200,400,200,1,00308,India
733516,2023-07-12,1005,Nail Polish,50,100,50,1,00264,India
733516,2023-07-12,1006,Blush,150,300,150,1,00264,India
639952,2023-07-12,1009,Moisturizer,250,500,250,1,00012,India
639952,2023-07-12,1004,Eyeliner,100,200,100,1,00012,India
226322,2023-07-12,1003,Foundation,300,600,300,1,00314,India
226322,2023-07-12,1007,Eyeshadow,200,400,200,1,00314,India
222078,2023-07-13,1002,Mascara,200,400,200,1,00337,India
222078,2023-07-13,1003,Foundation,300,600,300,1,00337,India
140655,2023-07-13,1002,Mascara,200,400,200,1,00418,India
140655,2023-07-13,1004,Eyeliner,100,200,100,1,00418,India
140655,2023-07-13,1008,Makeup Remover,80,160,80,1,00418,India
140655,2023-07-13,1005,Nail Polish,50,100,50,1,00418,India
763086,2023-07-13,1006,Blush,150,300,150,1,00195,India
763086,2023-07-13,1009,Moisturizer,250,500,250,1,00195,India
763086,2023-07-13,1001,Lipstick,150,300,150,1,00195,India
763086,2023-07-13,1008,Makeup Remover,80,160,80,1,00195,India
392927,2023-07-13,1007,Eyeshadow,200,400,200,1,00080,India
392927,2023-07-13,1001,Lipstick,150,300,150,1,00080,India
392927,2023-07-13,1006,Blush,150,300,150,1,00080,India
637641,2023-07-13,1002,Mascara,200,400,200,1,00430,India
637641,2023-07-13,1005,Nail Polish,50,100,50,1,00430,India
637641,2023-07-13,1009,Moisturizer,250,500,250,1,00430,India
338466,2023-07-13,1001,Lipstick,150,300,150,1,00492,India
338466,2023-07-13,1008,Makeup Remover,80,160,80,1,00492,India
675887,2023-07-13,1003,Foundation,300,600,300,1,00094,India
675887,2023-07-13,1005,Nail Polish,50,100,50,1,00094,India
306404,2023-07-13,1009,Moisturizer,250,500,250,1,00163,India
306404,2023-07-13,1005,Nail Polish,50,100,50,1,00163,India
306404,2023-07-13,1006,Blush,150,300,150,1,00163,India
495835,2023-07-13,1004,Eyeliner,100,200,100,1,00001,India
495835,2023-07-13,1005,Nail Polish,50,100,50,1,00001,India
495835,2023-07-13,1007,Eyeshadow,200,400,200,1,00001,India
495835,2023-07-13,1012,Body Lotion,200,400,200,1,00001,India
495835,2023-07-13,1002,Mascara,200,400,200,1,00001,India
493361,2023-07-13,1008,Makeup Remover,80,160,80,1,00379,India
493361,2023-07-13,1005,Nail Polish,50,100,50,1,00379,India
493361,2023-07-13,1001,Lipstick,150,300,150,1,00379,India
493361,2023-07-13,1007,Eyeshadow,200,400,200,1,00379,India
493361,2023-07-13,1004,Eyeliner,100,200,100,1,00379,India
673231,2023-07-13,1003,Foundation,300,600,300,1,00007,India
673231,2023-07-13,1012,Body Lotion,200,400,200,1,00007,India
673231,2023-07-13,1005,Nail Polish,50,100,50,1,00007,India
673231,2023-07-13,1004,Eyeliner,100,200,100,1,00007,India
425587,2023-07-13,1001,Lipstick,150,300,150,1,00220,India
425587,2023-07-13,1007,Eyeshadow,200,400,200,1,00220,India
167607,2023-07-13,1007,Eyeshadow,200,400,200,1,00182,India
839544,2023-07-13,1012,Body Lotion,200,400,200,1,00072,India
839544,2023-07-13,1001,Lipstick,150,300,150,1,00072,India
839544,2023-07-13,1004,Eyeliner,100,200,100,1,00072,India
606366,2023-07-13,1003,Foundation,300,600,300,1,00313,India
606366,2023-07-13,1004,Eyeliner,100,200,100,1,00313,India
878152,2023-07-13,1002,Mascara,200,400,200,1,00453,India
878152,2023-07-13,1005,Nail Polish,50,100,50,1,00453,India
878152,2023-07-13,1003,Foundation,300,600,300,1,00453,India
642337,2023-07-13,1012,Body Lotion,200,400,200,1,00382,India
642337,2023-07-13,1007,Eyeshadow,200,400,200,1,00382,India
642337,2023-07-13,1004,Eyeliner,100,200,100,1,00382,India
642337,2023-07-13,1002,Mascara,200,400,200,1,00382,India
339737,2023-07-13,1004,Eyeliner,100,200,100,1,00318,India
263683,2023-07-13,1012,Body Lotion,200,400,200,1,00323,India
906062,2023-07-13,1004,Eyeliner,100,200,100,1,00357,India
906062,2023-07-13,1001,Lipstick,150,300,150,1,00357,India
906062,2023-07-13,1002,Mascara,200,400,200,1,00357,India
906062,2023-07-13,1003,Foundation,300,600,300,1,00357,India
223038,2023-07-13,1008,Makeup Remover,80,160,80,1,00118,India
449502,2023-07-13,1005,Nail Polish,50,100,50,1,00067,India
449502,2023-07-13,1003,Foundation,300,600,300,1,00067,India
449502,2023-07-13,1002,Mascara,200,400,200,1,00067,India
449502,2023-07-13,1006,Blush,150,300,150,1,00067,India
449502,2023-07-13,1009,Moisturizer,250,500,250,1,00067,India
579471,2023-07-13,1001,Lipstick,150,300,150,1,00172,India
579471,2023-07-13,1012,Body Lotion,200,400,200,1,00172,India
579471,2023-07-13,1005,Nail Polish,50,100,50,1,00172,India
671634,2023-07-13,1003,Foundation,300,600,300,1,00078,India
671634,2023-07-13,1007,Eyeshadow,200,400,200,1,00078,India
912576,2023-07-13,1006,Blush,150,300,150,1,00370,India
912576,2023-07-13,1004,Eyeliner,100,200,100,1,00370,India
471980,2023-07-13,1007,Eyeshadow,200,400,200,1,00217,India
471980,2023-07-13,1005,Nail Polish,50,100,50,1,00217,India
471980,2023-07-13,1012,Body Lotion,200,400,200,1,00217,India
181890,2023-07-13,1003,Foundation,300,600,300,1,00448,India
181890,2023-07-13,1006,Blush,150,300,150,1,00448,India
181890,2023-07-13,1012,Body Lotion,200,400,200,1,00448,India
181890,2023-07-13,1008,Makeup Remover,80,160,80,1,00448,India
181890,2023-07-13,1002,Mascara,200,400,200,1,00448,India
871595,2023-07-13,1009,Moisturizer,250,500,250,1,00443,India
871595,2023-07-13,1012,Body Lotion,200,400,200,1,00443,India
871595,2023-07-13,1001,Lipstick,150,300,150,1,00443,India
871595,2023-07-13,1002,Mascara,200,400,200,1,00443,India
120623,2023-07-13,1005,Nail Polish,50,100,50,1,00425,India
120623,2023-07-13,1007,Eyeshadow,200,400,200,1,00425,India
367278,2023-07-13,1012,Body Lotion,200,400,200,1,00449,India
367278,2023-07-13,1006,Blush,150,300,150,1,00449,India
367278,2023-07-13,1008,Makeup Remover,80,160,80,1,00449,India
367278,2023-07-13,1003,Foundation,300,600,300,1,00449,India
287350,2023-07-13,1009,Moisturizer,250,500,250,1,00197,India
413866,2023-07-13,1003,Foundation,300,600,300,1,00286,India
413866,2023-07-13,1004,Eyeliner,100,200,100,1,00286,India
413866,2023-07-13,1005,Nail Polish,50,100,50,1,00286,India
413866,2023-07-13,1008,Makeup Remover,80,160,80,1,00286,India
413866,2023-07-13,1002,Mascara,200,400,200,1,00286,India
915009,2023-07-13,1006,Blush,150,300,150,1,00290,India
915009,2023-07-13,1003,Foundation,300,600,300,1,00290,India
915009,2023-07-13,1008,Makeup Remover,80,160,80,1,00290,India
915009,2023-07-13,1007,Eyeshadow,200,400,200,1,00290,India
403968,2023-07-13,1003,Foundation,300,600,300,1,00356,India
673725,2023-07-13,1005,Nail Polish,50,100,50,1,00134,India
673725,2023-07-13,1002,Mascara,200,400,200,1,00134,India
572612,2023-07-13,1005,Nail Polish,50,100,50,1,00166,India
615775,2023-07-13,1009,Moisturizer,250,500,250,1,00307,India
661774,2023-07-13,1008,Makeup Remover,80,160,80,1,00463,India
931581,2023-07-13,1001,Lipstick,150,300,150,1,00414,India
931581,2023-07-13,1003,Foundation,300,600,300,1,00414,India
931581,2023-07-13,1009,Moisturizer,250,500,250,1,00414,India
843202,2023-07-13,1006,Blush,150,300,150,1,00206,India
843202,2023-07-13,1008,Makeup Remover,80,160,80,1,00206,India
843202,2023-07-13,1007,Eyeshadow,200,400,200,1,00206,India
843202,2023-07-13,1002,Mascara,200,400,200,1,00206,India
843202,2023-07-13,1012,Body Lotion,200,400,200,1,00206,India
319413,2023-07-13,1012,Body Lotion,200,400,200,1,00241,India
319413,2023-07-13,1005,Nail Polish,50,100,50,1,00241,India
771290,2023-07-13,1005,Nail Polish,50,100,50,1,00158,India
771290,2023-07-13,1008,Makeup Remover,80,160,80,1,00158,India
771290,2023-07-13,1012,Body Lotion,200,400,200,1,00158,India
771290,2023-07-13,1003,Foundation,300,600,300,1,00158,India
771290,2023-07-13,1006,Blush,150,300,150,1,00158,India
456596,2023-07-13,1007,Eyeshadow,200,400,200,1,00150,India
456596,2023-07-13,1002,Mascara,200,400,200,1,00150,India
184571,2023-07-13,1006,Blush,150,300,150,1,00408,India
184571,2023-07-13,1002,Mascara,200,400,200,1,00408,India
184571,2023-07-13,1003,Foundation,300,600,300,1,00408,India
184571,2023-07-13,1005,Nail Polish,50,100,50,1,00408,India
445475,2023-07-13,1005,Nail Polish,50,100,50,1,00030,India
445475,2023-07-13,1002,Mascara,200,400,200,1,00030,India
243810,2023-07-13,1007,Eyeshadow,200,400,200,1,00437,India
243810,2023-07-13,1001,Lipstick,150,300,150,1,00437,India
256593,2023-07-13,1012,Body Lotion,200,400,200,1,00068,India
256593,2023-07-13,1008,Makeup Remover,80,160,80,1,00068,India
256593,2023-07-13,1002,Mascara,200,400,200,1,00068,India
258408,2023-07-13,1009,Moisturizer,250,500,250,1,00054,India
258408,2023-07-13,1001,Lipstick,150,300,150,1,00054,India
258408,2023-07-13,1002,Mascara,200,400,200,1,00054,India
261913,2023-07-13,1006,Blush,150,300,150,1,00002,India
345912,2023-07-13,1007,Eyeshadow,200,400,200,1,00424,India
345912,2023-07-13,1008,Makeup Remover,80,160,80,1,00424,India
345912,2023-07-13,1002,Mascara,200,400,200,1,00424,India
286102,2023-07-14,1009,Moisturizer,250,500,250,1,00232,India
286102,2023-07-14,1005,Nail Polish,50,100,50,1,00232,India
908226,2023-07-14,1012,Body Lotion,200,400,200,1,00305,India
908226,2023-07-14,1002,Mascara,200,400,200,1,00305,India
749307,2023-07-14,1012,Body Lotion,200,400,200,1,00443,India
942001,2023-07-14,1002,Mascara,200,400,200,1,00209,India
942001,2023-07-14,1009,Moisturizer,250,500,250,1,00209,India
556004,2023-07-14,1001,Lipstick,150,300,150,1,00341,India
556004,2023-07-14,1012,Body Lotion,200,400,200,1,00341,India
556004,2023-07-14,1002,Mascara,200,400,200,1,00341,India
556004,2023-07-14,1006,Blush,150,300,150,1,00341,India
556004,2023-07-14,1005,Nail Polish,50,100,50,1,00341,India
415863,2023-07-14,1001,Lipstick,150,300,150,1,00239,India
415863,2023-07-14,1004,Eyeliner,100,200,100,1,00239,India
415863,2023-07-14,1005,Nail Polish,50,100,50,1,00239,India
415863,2023-07-14,1003,Foundation,300,600,300,1,00239,India
415863,2023-07-14,1008,Makeup Remover,80,160,80,1,00239,India
940166,2023-07-14,1008,Makeup Remover,80,160,80,1,00344,India
940166,2023-07-14,1002,Mascara,200,400,200,1,00344,India
940166,2023-07-14,1006,Blush,150,300,150,1,00344,India
940166,2023-07-14,1004,Eyeliner,100,200,100,1,00344,India
976395,2023-07-14,1002,Mascara,200,400,200,1,00264,India
976395,2023-07-14,1007,Eyeshadow,200,400,200,1,00264,India
976395,2023-07-14,1003,Foundation,300,600,300,1,00264,India
183190,2023-07-14,1008,Makeup Remover,80,160,80,1,00374,India
183190,2023-07-14,1012,Body Lotion,200,400,200,1,00374,India
183190,2023-07-14,1004,Eyeliner,100,200,100,1,00374,India
358000,2023-07-14,1007,Eyeshadow,200,400,200,1,00158,India
358000,2023-07-14,1012,Body Lotion,200,400,200,1,00158,India
358000,2023-07-14,1009,Moisturizer,250,500,250,1,00158,India
799031,2023-07-14,1006,Blush,150,300,150,1,00322,India
799031,2023-07-14,1012,Body Lotion,200,400,200,1,00322,India
799031,2023-07-14,1001,Lipstick,150,300,150,1,00322,India
468978,2023-07-14,1007,Eyeshadow,200,400,200,1,00187,India
468978,2023-07-14,1001,Lipstick,150,300,150,1,00187,India
468978,2023-07-14,1004,Eyeliner,100,200,100,1,00187,India
468978,2023-07-14,1005,Nail Polish,50,100,50,1,00187,India
122738,2023-07-14,1003,Foundation,300,600,300,1,00052,India
122738,2023-07-14,1005,Nail Polish,50,100,50,1,00052,India
122738,2023-07-14,1006,Blush,150,300,150,1,00052,India
491438,2023-07-14,1002,Mascara,200,400,200,1,00178,India
491438,2023-07-14,1009,Moisturizer,250,500,250,1,00178,India
491438,2023-07-14,1008,Makeup Remover,80,160,80,1,00178,India
491438,2023-07-14,1005,Nail Polish,50,100,50,1,00178,India
491438,2023-07-14,1003,Foundation,300,600,300,1,00178,India
305615,2023-07-14,1002,Mascara,200,400,200,1,00125,India
532801,2023-07-14,1007,Eyeshadow,200,400,200,1,00213,India
532801,2023-07-14,1004,Eyeliner,100,200,100,1,00213,India
532801,2023-07-14,1008,Makeup Remover,80,160,80,1,00213,India
528751,2023-07-14,1009,Moisturizer,250,500,250,1,00004,India
528751,2023-07-14,1001,Lipstick,150,300,150,1,00004,India
528751,2023-07-14,1005,Nail Polish,50,100,50,1,00004,India
528751,2023-07-14,1008,Makeup Remover,80,160,80,1,00004,India
228352,2023-07-14,1006,Blush,150,300,150,1,00068,India
228352,2023-07-14,1003,Foundation,300,600,300,1,00068,India
228352,2023-07-14,1009,Moisturizer,250,500,250,1,00068,India
228352,2023-07-14,1001,Lipstick,150,300,150,1,00068,India
357370,2023-07-14,1012,Body Lotion,200,400,200,1,00046,India
425952,2023-07-14,1001,Lipstick,150,300,150,1,00457,India
425952,2023-07-14,1012,Body Lotion,200,400,200,1,00457,India
425952,2023-07-14,1006,Blush,150,300,150,1,00457,India
425952,2023-07-14,1005,Nail Polish,50,100,50,1,00457,India
139009,2023-07-14,1012,Body Lotion,200,400,200,1,00165,India
139009,2023-07-14,1008,Makeup Remover,80,160,80,1,00165,India
139009,2023-07-14,1007,Eyeshadow,200,400,200,1,00165,India
823168,2023-07-14,1012,Body Lotion,200,400,200,1,00231,India
823168,2023-07-14,1006,Blush,150,300,150,1,00231,India
823168,2023-07-14,1003,Foundation,300,600,300,1,00231,India
979689,2023-07-14,1012,Body Lotion,200,400,200,1,00312,India
752392,2023-07-14,1009,Moisturizer,250,500,250,1,00440,India
752392,2023-07-14,1005,Nail Polish,50,100,50,1,00440,India
752392,2023-07-14,1002,Mascara,200,400,200,1,00440,India
744119,2023-07-14,1008,Makeup Remover,80,160,80,1,00064,India
763403,2023-07-14,1001,Lipstick,150,300,150,1,00114,India
763403,2023-07-14,1007,Eyeshadow,200,400,200,1,00114,India
763403,2023-07-14,1004,Eyeliner,100,200,100,1,00114,India
530675,2023-07-14,1007,Eyeshadow,200,400,200,1,00343,India
530675,2023-07-14,1012,Body Lotion,200,400,200,1,00343,India
665731,2023-07-14,1006,Blush,150,300,150,1,00085,India
884649,2023-07-14,1003,Foundation,300,600,300,1,00144,India
884649,2023-07-14,1002,Mascara,200,400,200,1,00144,India
401581,2023-07-14,1002,Mascara,200,400,200,1,00347,India
401581,2023-07-14,1003,Foundation,300,600,300,1,00347,India
401581,2023-07-14,1007,Eyeshadow,200,400,200,1,00347,India
741953,2023-07-14,1002,Mascara,200,400,200,1,00424,India
741953,2023-07-14,1001,Lipstick,150,300,150,1,00424,India
741953,2023-07-14,1005,Nail Polish,50,100,50,1,00424,India
289727,2023-07-14,1002,Mascara,200,400,200,1,00168,India
289727,2023-07-14,1007,Eyeshadow,200,400,200,1,00168,India
289727,2023-07-14,1005,Nail Polish,50,100,50,1,00168,India
289727,2023-07-14,1003,Foundation,300,600,300,1,00168,India
289727,2023-07-14,1001,Lipstick,150,300,150,1,00168,India
543545,2023-07-14,1008,Makeup Remover,80,160,80,1,00115,India
543545,2023-07-14,1005,Nail Polish,50,100,50,1,00115,India
543545,2023-07-14,1001,Lipstick,150,300,150,1,00115,India
543545,2023-07-14,1012,Body Lotion,200,400,200,1,00115,India
544863,2023-07-14,1004,Eyeliner,100,200,100,1,00110,India
544863,2023-07-14,1012,Body Lotion,200,400,200,1,00110,India
207633,2023-07-14,1005,Nail Polish,50,100,50,1,00119,India
207633,2023-07-14,1002,Mascara,200,400,200,1,00119,India
207633,2023-07-14,1003,Foundation,300,600,300,1,00119,India
340662,2023-07-14,1003,Foundation,300,600,300,1,00094,India
197590,2023-07-14,1005,Nail Polish,50,100,50,1,00446,India
197590,2023-07-14,1001,Lipstick,150,300,150,1,00446,India
197590,2023-07-14,1009,Moisturizer,250,500,250,1,00446,India
874823,2023-07-14,1003,Foundation,300,600,300,1,00406,India
954828,2023-07-14,1004,Eyeliner,100,200,100,1,00253,India
954828,2023-07-14,1001,Lipstick,150,300,150,1,00253,India
954828,2023-07-14,1008,Makeup Remover,80,160,80,1,00253,India
657923,2023-07-14,1001,Lipstick,150,300,150,1,00269,India
657923,2023-07-14,1002,Mascara,200,400,200,1,00269,India
732840,2023-07-14,1008,Makeup Remover,80,160,80,1,00451,India
732840,2023-07-14,1002,Mascara,200,400,200,1,00451,India
732840,2023-07-14,1003,Foundation,300,600,300,1,00451,India
732840,2023-07-14,1001,Lipstick,150,300,150,1,00451,India
463082,2023-07-14,1006,Blush,150,300,150,1,00073,India
463082,2023-07-14,1001,Lipstick,150,300,150,1,00073,India
539038,2023-07-14,1004,Eyeliner,100,200,100,1,00414,India
539038,2023-07-14,1001,Lipstick,150,300,150,1,00414,India
539038,2023-07-14,1003,Foundation,300,600,300,1,00414,India
539038,2023-07-14,1007,Eyeshadow,200,400,200,1,00414,India
245030,2023-07-14,1012,Body Lotion,200,400,200,1,00319,India
245030,2023-07-14,1001,Lipstick,150,300,150,1,00319,India
367316,2023-07-14,1006,Blush,150,300,150,1,00088,India
367316,2023-07-14,1012,Body Lotion,200,400,200,1,00088,India
367316,2023-07-14,1005,Nail Polish,50,100,50,1,00088,India
350294,2023-07-14,1005,Nail Polish,50,100,50,1,00467,India
350294,2023-07-14,1007,Eyeshadow,200,400,200,1,00467,India
350294,2023-07-14,1006,Blush,150,300,150,1,00467,India
735184,2023-07-14,1007,Eyeshadow,200,400,200,1,00459,India
735184,2023-07-14,1005,Nail Polish,50,100,50,1,00459,India
735184,2023-07-14,1002,Mascara,200,400,200,1,00459,India
735184,2023-07-14,1008,Makeup Remover,80,160,80,1,00459,India
220128,2023-07-14,1005,Nail Polish,50,100,50,1,00321,India
220128,2023-07-14,1003,Foundation,300,600,300,1,00321,India
220128,2023-07-14,1002,Mascara,200,400,200,1,00321,India
220128,2023-07-14,1007,Eyeshadow,200,400,200,1,00321,India
251837,2023-07-14,1008,Makeup Remover,80,160,80,1,00083,India
251837,2023-07-14,1003,Foundation,300,600,300,1,00083,India
516985,2023-07-15,1006,Blush,150,300,150,1,00224,India
516985,2023-07-15,1009,Moisturizer,250,500,250,1,00224,India
634477,2023-07-15,1008,Makeup Remover,80,160,80,1,00166,India
634477,2023-07-15,1009,Moisturizer,250,500,250,1,00166,India
634477,2023-07-15,1002,Mascara,200,400,200,1,00166,India
135017,2023-07-15,1004,Eyeliner,100,200,100,1,00201,India
135017,2023-07-15,1003,Foundation,300,600,300,1,00201,India
267792,2023-07-15,1003,Foundation,300,600,300,1,00043,India
818231,2023-07-15,1004,Eyeliner,100,200,100,1,00008,India
818231,2023-07-15,1005,Nail Polish,50,100,50,1,00008,India
818231,2023-07-15,1003,Foundation,300,600,300,1,00008,India
310135,2023-07-15,1002,Mascara,200,400,200,1,00169,India
310135,2023-07-15,1007,Eyeshadow,200,400,200,1,00169,India
310135,2023-07-15,1008,Makeup Remover,80,160,80,1,00169,India
472697,2023-07-15,1003,Foundation,300,600,300,1,00317,India
472697,2023-07-15,1009,Moisturizer,250,500,250,1,00317,India
896610,2023-07-15,1004,Eyeliner,100,200,100,1,00051,India
896610,2023-07-15,1008,Makeup Remover,80,160,80,1,00051,India
896610,2023-07-15,1001,Lipstick,150,300,150,1,00051,India
857763,2023-07-15,1009,Moisturizer,250,500,250,1,00348,India
857763,2023-07-15,1005,Nail Polish,50,100,50,1,00348,India
857763,2023-07-15,1007,Eyeshadow,200,400,200,1,00348,India
890640,2023-07-15,1012,Body Lotion,200,400,200,1,00073,India
890640,2023-07-15,1001,Lipstick,150,300,150,1,00073,India
890640,2023-07-15,1007,Eyeshadow,200,400,200,1,00073,India
890640,2023-07-15,1008,Makeup Remover,80,160,80,1,00073,India
890640,2023-07-15,1004,Eyeliner,100,200,100,1,00073,India
475229,2023-07-15,1003,Foundation,300,600,300,1,00126,India
475229,2023-07-15,1012,Body Lotion,200,400,200,1,00126,India
475229,2023-07-15,1007,Eyeshadow,200,400,200,1,00126,India
922230,2023-07-15,1005,Nail Polish,50,100,50,1,00112,India
922230,2023-07-15,1009,Moisturizer,250,500,250,1,00112,India
922230,2023-07-15,1008,Makeup Remover,80,160,80,1,00112,India
488959,2023-07-15,1003,Foundation,300,600,300,1,00300,India
488959,2023-07-15,1012,Body Lotion,200,400,200,1,00300,India
488959,2023-07-15,1005,Nail Polish,50,100,50,1,00300,India
631302,2023-07-15,1007,Eyeshadow,200,400,200,1,00222,India
631302,2023-07-15,1001,Lipstick,150,300,150,1,00222,India
631302,2023-07-15,1004,Eyeliner,100,200,100,1,00222,India
631302,2023-07-15,1002,Mascara,200,400,200,1,00222,India
642466,2023-07-15,1008,Makeup Remover,80,160,80,1,00096,India
642466,2023-07-15,1012,Body Lotion,200,400,200,1,00096,India
642466,2023-07-15,1003,Foundation,300,600,300,1,00096,India
642466,2023-07-15,1001,Lipstick,150,300,150,1,00096,India
137155,2023-07-15,1008,Makeup Remover,80,160,80,1,00478,India
137155,2023-07-15,1012,Body Lotion,200,400,200,1,00478,India
137155,2023-07-15,1006,Blush,150,300,150,1,00478,India
102490,2023-07-15,1009,Moisturizer,250,500,250,1,00207,India
257217,2023-07-15,1006,Blush,150,300,150,1,00251,India
257217,2023-07-15,1002,Mascara,200,400,200,1,00251,India
322694,2023-07-15,1008,Makeup Remover,80,160,80,1,00319,India
322694,2023-07-15,1005,Nail Polish,50,100,50,1,00319,India
524678,2023-07-15,1012,Body Lotion,200,400,200,1,00196,India
524678,2023-07-15,1007,Eyeshadow,200,400,200,1,00196,India
621068,2023-07-15,1007,Eyeshadow,200,400,200,1,00260,India
621068,2023-07-15,1001,Lipstick,150,300,150,1,00260,India
621068,2023-07-15,1003,Foundation,300,600,300,1,00260,India
621068,2023-07-15,1008,Makeup Remover,80,160,80,1,00260,India
452040,2023-07-15,1012,Body Lotion,200,400,200,1,00233,India
452040,2023-07-15,1007,Eyeshadow,200,400,200,1,00233,India
452040,2023-07-15,1002,Mascara,200,400,200,1,00233,India
452040,2023-07-15,1006,Blush,150,300,150,1,00233,India
452040,2023-07-15,1003,Foundation,300,600,300,1,00233,India
871469,2023-07-15,1008,Makeup Remover,80,160,80,1,00394,India
706879,2023-07-15,1008,Makeup Remover,80,160,80,1,00444,India
706879,2023-07-15,1007,Eyeshadow,200,400,200,1,00444,India
831560,2023-07-15,1006,Blush,150,300,150,1,00315,India
313942,2023-07-15,1003,Foundation,300,600,300,1,00459,India
313942,2023-07-15,1008,Makeup Remover,80,160,80,1,00459,India
313942,2023-07-15,1012,Body Lotion,200,400,200,1,00459,India
430423,2023-07-15,1006,Blush,150,300,150,1,00284,India
430423,2023-07-15,1008,Makeup Remover,80,160,80,1,00284,India
430423,2023-07-15,1009,Moisturizer,250,500,250,1,00284,India
430423,2023-07-15,1005,Nail Polish,50,100,50,1,00284,India
943670,2023-07-15,1008,Makeup Remover,80,160,80,1,00369,India
943670,2023-07-15,1009,Moisturizer,250,500,250,1,00369,India
943670,2023-07-15,1003,Foundation,300,600,300,1,00369,India
943670,2023-07-15,1004,Eyeliner,100,200,100,1,00369,India
295598,2023-07-15,1003,Foundation,300,600,300,1,00009,India
295598,2023-07-15,1001,Lipstick,150,300,150,1,00009,India
295598,2023-07-15,1006,Blush,150,300,150,1,00009,India
493786,2023-07-15,1003,Foundation,300,600,300,1,00157,India
493786,2023-07-15,1004,Eyeliner,100,200,100,1,00157,India
493786,2023-07-15,1007,Eyeshadow,200,400,200,1,00157,India
493786,2023-07-15,1009,Moisturizer,250,500,250,1,00157,India
420960,2023-07-15,1003,Foundation,300,600,300,1,00023,India
141101,2023-07-15,1009,Moisturizer,250,500,250,1,00111,India
371036,2023-07-15,1001,Lipstick,150,300,150,1,00262,India
371036,2023-07-15,1012,Body Lotion,200,400,200,1,00262,India
371036,2023-07-15,1008,Makeup Remover,80,160,80,1,00262,India
371036,2023-07-15,1005,Nail Polish,50,100,50,1,00262,India
441442,2023-07-15,1007,Eyeshadow,200,400,200,1,00047,India
441442,2023-07-15,1003,Foundation,300,600,300,1,00047,India
441442,2023-07-15,1009,Moisturizer,250,500,250,1,00047,India
441442,2023-07-15,1012,Body Lotion,200,400,200,1,00047,India
398849,2023-07-15,1007,Eyeshadow,200,400,200,1,00086,India
398849,2023-07-15,1004,Eyeliner,100,200,100,1,00086,India
398849,2023-07-15,1001,Lipstick,150,300,150,1,00086,India
398849,2023-07-15,1008,Makeup Remover,80,160,80,1,00086,India
196254,2023-07-15,1008,Makeup Remover,80,160,80,1,00487,India
196254,2023-07-15,1004,Eyeliner,100,200,100,1,00487,India
872014,2023-07-15,1012,Body Lotion,200,400,200,1,00458,India
872014,2023-07-15,1009,Moisturizer,250,500,250,1,00458,India
872014,2023-07-15,1006,Blush,150,300,150,1,00458,India
900124,2023-07-15,1003,Foundation,300,600,300,1,00152,India
900124,2023-07-15,1004,Eyeliner,100,200,100,1,00152,India
900124,2023-07-15,1002,Mascara,200,400,200,1,00152,India
730246,2023-07-15,1009,Moisturizer,250,500,250,1,00212,India
730246,2023-07-15,1012,Body Lotion,200,400,200,1,00212,India
730246,2023-07-15,1007,Eyeshadow,200,400,200,1,00212,India
396481,2023-07-15,1005,Nail Polish,50,100,50,1,00406,India
396481,2023-07-15,1001,Lipstick,150,300,150,1,00406,India
200534,2023-07-16,1005,Nail Polish,50,100,50,1,00201,India
200534,2023-07-16,1003,Foundation,300,600,300,1,00201,India
200534,2023-07-16,1001,Lipstick,150,300,150,1,00201,India
200534,2023-07-16,1002,Mascara,200,400,200,1,00201,India
737672,2023-07-16,1001,Lipstick,150,300,150,1,00035,India
737672,2023-07-16,1003,Foundation,300,600,300,1,00035,India
737672,2023-07-16,1007,Eyeshadow,200,400,200,1,00035,India
737672,2023-07-16,1002,Mascara,200,400,200,1,00035,India
737672,2023-07-16,1006,Blush,150,300,150,1,00035,India
938305,2023-07-16,1004,Eyeliner,100,200,100,1,00339,India
938305,2023-07-16,1003,Foundation,300,600,300,1,00339,India
824611,2023-07-16,1005,Nail Polish,50,100,50,1,00278,India
824611,2023-07-16,1004,Eyeliner,100,200,100,1,00278,India
824611,2023-07-16,1001,Lipstick,150,300,150,1,00278,India
824611,2023-07-16,1009,Moisturizer,250,500,250,1,00278,India
389581,2023-07-16,1009,Moisturizer,250,500,250,1,00156,India
389581,2023-07-16,1003,Foundation,300,600,300,1,00156,India
212151,2023-07-16,1001,Lipstick,150,300,150,1,00264,India
197949,2023-07-16,1012,Body Lotion,200,400,200,1,00337,India
197949,2023-07-16,1003,Foundation,300,600,300,1,00337,India
197949,2023-07-16,1005,Nail Polish,50,100,50,1,00337,India
197949,2023-07-16,1002,Mascara,200,400,200,1,00337,India
711706,2023-07-16,1005,Nail Polish,50,100,50,1,00122,India
711706,2023-07-16,1009,Moisturizer,250,500,250,1,00122,India
711706,2023-07-16,1008,Makeup Remover,80,160,80,1,00122,India
711706,2023-07-16,1007,Eyeshadow,200,400,200,1,00122,India
711706,2023-07-16,1003,Foundation,300,600,300,1,00122,India
691222,2023-07-16,1004,Eyeliner,100,200,100,1,00052,India
691222,2023-07-16,1001,Lipstick,150,300,150,1,00052,India
691222,2023-07-16,1006,Blush,150,300,150,1,00052,India
691222,2023-07-16,1008,Makeup Remover,80,160,80,1,00052,India
424139,2023-07-16,1012,Body Lotion,200,400,200,1,00008,India
424139,2023-07-16,1008,Makeup Remover,80,160,80,1,00008,India
424139,2023-07-16,1003,Foundation,300,600,300,1,00008,India
424139,2023-07-16,1006,Blush,150,300,150,1,00008,India
424139,2023-07-16,1001,Lipstick,150,300,150,1,00008,India
772938,2023-07-16,1008,Makeup Remover,80,160,80,1,00154,India
772938,2023-07-16,1003,Foundation,300,600,300,1,00154,India
772938,2023-07-16,1009,Moisturizer,250,500,250,1,00154,India
312283,2023-07-16,1012,Body Lotion,200,400,200,1,00451,India
312283,2023-07-16,1005,Nail Polish,50,100,50,1,00451,India
714505,2023-07-16,1003,Foundation,300,600,300,1,00419,India
714505,2023-07-16,1009,Moisturizer,250,500,250,1,00419,India
642898,2023-07-16,1002,Mascara,200,400,200,1,00346,India
446412,2023-07-16,1001,Lipstick,150,300,150,1,00408,India
446412,2023-07-16,1005,Nail Polish,50,100,50,1,00408,India
446412,2023-07-16,1003,Foundation,300,600,300,1,00408,India
780523,2023-07-16,1002,Mascara,200,400,200,1,00080,India
368210,2023-07-16,1012,Body Lotion,200,400,200,1,00406,India
415141,2023-07-16,1012,Body Lotion,200,400,200,1,00002,India
415141,2023-07-16,1001,Lipstick,150,300,150,1,00002,India
415141,2023-07-16,1005,Nail Polish,50,100,50,1,00002,India
565708,2023-07-16,1009,Moisturizer,250,500,250,1,00238,India
856120,2023-07-16,1006,Blush,150,300,150,1,00013,India
314159,2023-07-16,1012,Body Lotion,200,400,200,1,00335,India
314159,2023-07-16,1005,Nail Polish,50,100,50,1,00335,India
158289,2023-07-16,1002,Mascara,200,400,200,1,00257,India
158289,2023-07-16,1012,Body Lotion,200,400,200,1,00257,India
158289,2023-07-16,1005,Nail Polish,50,100,50,1,00257,India
592540,2023-07-16,1004,Eyeliner,100,200,100,1,00189,India
592540,2023-07-16,1001,Lipstick,150,300,150,1,00189,India
836725,2023-07-16,1002,Mascara,200,400,200,1,00445,India
836725,2023-07-16,1008,Makeup Remover,80,160,80,1,00445,India
629520,2023-07-16,1004,Eyeliner,100,200,100,1,00357,India
629520,2023-07-16,1012,Body Lotion,200,400,200,1,00357,India
629520,2023-07-16,1009,Moisturizer,250,500,250,1,00357,India
695346,2023-07-16,1012,Body Lotion,200,400,200,1,00234,India
695346,2023-07-16,1002,Mascara,200,400,200,1,00234,India
695346,2023-07-16,1004,Eyeliner,100,200,100,1,00234,India
725515,2023-07-16,1007,Eyeshadow,200,400,200,1,00038,India
725515,2023-07-16,1002,Mascara,200,400,200,1,00038,India
662715,2023-07-16,1009,Moisturizer,250,500,250,1,00084,India
662715,2023-07-16,1001,Lipstick,150,300,150,1,00084,India
662715,2023-07-16,1007,Eyeshadow,200,400,200,1,00084,India
670352,2023-07-16,1003,Foundation,300,600,300,1,00500,India
670352,2023-07-16,1004,Eyeliner,100,200,100,1,00500,India
208740,2023-07-16,1001,Lipstick,150,300,150,1,00425,India
208740,2023-07-16,1008,Makeup Remover,80,160,80,1,00425,India
208740,2023-07-16,1004,Eyeliner,100,200,100,1,00425,India
248276,2023-07-16,1007,Eyeshadow,200,400,200,1,00456,India
248276,2023-07-16,1002,Mascara,200,400,200,1,00456,India
248276,2023-07-16,1008,Makeup Remover,80,160,80,1,00456,India
248276,2023-07-16,1003,Foundation,300,600,300,1,00456,India
413339,2023-07-16,1002,Mascara,200,400,200,1,00352,India
413339,2023-07-16,1001,Lipstick,150,300,150,1,00352,India
153617,2023-07-16,1006,Blush,150,300,150,1,00454,India
153617,2023-07-16,1001,Lipstick,150,300,150,1,00454,India
153617,2023-07-16,1007,Eyeshadow,200,400,200,1,00454,India
153617,2023-07-16,1004,Eyeliner,100,200,100,1,00454,India
574184,2023-07-17,1003,Foundation,300,600,300,1,00332,India
574184,2023-07-17,1012,Body Lotion,200,400,200,1,00332,India
574184,2023-07-17,1008,Makeup Remover,80,160,80,1,00332,India
574184,2023-07-17,1002,Mascara,200,400,200,1,00332,India
222491,2023-07-17,1001,Lipstick,150,300,150,1,00441,India
222491,2023-07-17,1012,Body Lotion,200,400,200,1,00441,India
616136,2023-07-17,1008,Makeup Remover,80,160,80,1,00406,India
616136,2023-07-17,1004,Eyeliner,100,200,100,1,00406,India
616136,2023-07-17,1002,Mascara,200,400,200,1,00406,India
616136,2023-07-17,1007,Eyeshadow,200,400,200,1,00406,India
513002,2023-07-17,1004,Eyeliner,100,200,100,1,00268,India
696132,2023-07-17,1007,Eyeshadow,200,400,200,1,00433,India
696132,2023-07-17,1001,Lipstick,150,300,150,1,00433,India
123580,2023-07-17,1005,Nail Polish,50,100,50,1,00216,India
123580,2023-07-17,1008,Makeup Remover,80,160,80,1,00216,India
123580,2023-07-17,1007,Eyeshadow,200,400,200,1,00216,India
610843,2023-07-17,1002,Mascara,200,400,200,1,00379,India
610843,2023-07-17,1012,Body Lotion,200,400,200,1,00379,India
610843,2023-07-17,1001,Lipstick,150,300,150,1,00379,India
371606,2023-07-17,1001,Lipstick,150,300,150,1,00222,India
371606,2023-07-17,1008,Makeup Remover,80,160,80,1,00222,India
898688,2023-07-17,1009,Moisturizer,250,500,250,1,00173,India
898688,2023-07-17,1007,Eyeshadow,200,400,200,1,00173,India
898688,2023-07-17,1001,Lipstick,150,300,150,1,00173,India
681422,2023-07-17,1004,Eyeliner,100,200,100,1,00415,India
166551,2023-07-17,1007,Eyeshadow,200,400,200,1,00067,India
166551,2023-07-17,1009,Moisturizer,250,500,250,1,00067,India
192244,2023-07-17,1004,Eyeliner,100,200,100,1,00161,India
192244,2023-07-17,1009,Moisturizer,250,500,250,1,00161,India
192244,2023-07-17,1001,Lipstick,150,300,150,1,00161,India
192244,2023-07-17,1002,Mascara,200,400,200,1,00161,India
328720,2023-07-17,1002,Mascara,200,400,200,1,00367,India
328720,2023-07-17,1009,Moisturizer,250,500,250,1,00367,India
328720,2023-07-17,1008,Makeup Remover,80,160,80,1,00367,India
328720,2023-07-17,1005,Nail Polish,50,100,50,1,00367,India
457705,2023-07-17,1003,Foundation,300,600,300,1,00466,India
457705,2023-07-17,1009,Moisturizer,250,500,250,1,00466,India
457705,2023-07-17,1007,Eyeshadow,200,400,200,1,00466,India
977677,2023-07-17,1004,Eyeliner,100,200,100,1,00240,India
977677,2023-07-17,1002,Mascara,200,400,200,1,00240,India
977677,2023-07-17,1006,Blush,150,300,150,1,00240,India
486563,2023-07-17,1008,Makeup Remover,80,160,80,1,00267,India
486563,2023-07-17,1002,Mascara,200,400,200,1,00267,India
486563,2023-07-17,1006,Blush,150,300,150,1,00267,India
172928,2023-07-17,1003,Foundation,300,600,300,1,00301,India
172928,2023-07-17,1004,Eyeliner,100,200,100,1,00301,India
246204,2023-07-17,1009,Moisturizer,250,500,250,1,00419,India
246204,2023-07-17,1012,Body Lotion,200,400,200,1,00419,India
246204,2023-07-17,1006,Blush,150,300,150,1,00419,India
901680,2023-07-17,1003,Foundation,300,600,300,1,00195,India
901680,2023-07-17,1008,Makeup Remover,80,160,80,1,00195,India
901680,2023-07-17,1001,Lipstick,150,300,150,1,00195,India
901680,2023-07-17,1009,Moisturizer,250,500,250,1,00195,India
911601,2023-07-17,1001,Lipstick,150,300,150,1,00070,India
911601,2023-07-17,1008,Makeup Remover,80,160,80,1,00070,India
911601,2023-07-17,1005,Nail Polish,50,100,50,1,00070,India
999002,2023-07-17,1005,Nail Polish,50,100,50,1,00036,India
806732,2023-07-17,1007,Eyeshadow,200,400,200,1,00442,India
806732,2023-07-17,1006,Blush,150,300,150,1,00442,India
555553,2023-07-17,1003,Foundation,300,600,300,1,00255,India
519504,2023-07-17,1009,Moisturizer,250,500,250,1,00252,India
519504,2023-07-17,1012,Body Lotion,200,400,200,1,00252,India
519504,2023-07-17,1008,Makeup Remover,80,160,80,1,00252,India
378387,2023-07-17,1008,Makeup Remover,80,160,80,1,00368,India
378387,2023-07-17,1012,Body Lotion,200,400,200,1,00368,India
712348,2023-07-17,1012,Body Lotion,200,400,200,1,00381,India
712348,2023-07-17,1009,Moisturizer,250,500,250,1,00381,India
227959,2023-07-17,1001,Lipstick,150,300,150,1,00442,India
227959,2023-07-17,1009,Moisturizer,250,500,250,1,00442,India
618644,2023-07-17,1007,Eyeshadow,200,400,200,1,00181,India
618644,2023-07-17,1006,Blush,150,300,150,1,00181,India
618644,2023-07-17,1004,Eyeliner,100,200,100,1,00181,India
349970,2023-07-17,1002,Mascara,200,400,200,1,00208,India
164804,2023-07-17,1008,Makeup Remover,80,160,80,1,00468,India
164804,2023-07-17,1001,Lipstick,150,300,150,1,00468,India
164804,2023-07-17,1002,Mascara,200,400,200,1,00468,India
164804,2023-07-17,1006,Blush,150,300,150,1,00468,India
164804,2023-07-17,1007,Eyeshadow,200,400,200,1,00468,India
838759,2023-07-17,1006,Blush,150,300,150,1,00378,India
838759,2023-07-17,1007,Eyeshadow,200,400,200,1,00378,India
201373,2023-07-17,1007,Eyeshadow,200,400,200,1,00267,India
453364,2023-07-17,1009,Moisturizer,250,500,250,1,00184,India
453364,2023-07-17,1004,Eyeliner,100,200,100,1,00184,India
153086,2023-07-17,1007,Eyeshadow,200,400,200,1,00169,India
153086,2023-07-17,1002,Mascara,200,400,200,1,00169,India
700060,2023-07-17,1008,Makeup Remover,80,160,80,1,00242,India
700060,2023-07-17,1001,Lipstick,150,300,150,1,00242,India
925120,2023-07-17,1008,Makeup Remover,80,160,80,1,00394,India
334067,2023-07-17,1008,Makeup Remover,80,160,80,1,00228,India
334067,2023-07-17,1009,Moisturizer,250,500,250,1,00228,India
940417,2023-07-17,1003,Foundation,300,600,300,1,00162,India
940417,2023-07-17,1012,Body Lotion,200,400,200,1,00162,India
940417,2023-07-17,1004,Eyeliner,100,200,100,1,00162,India
940417,2023-07-17,1009,Moisturizer,250,500,250,1,00162,India
218106,2023-07-17,1006,Blush,150,300,150,1,00482,India
171623,2023-07-17,1001,Lipstick,150,300,150,1,00004,India
171623,2023-07-17,1005,Nail Polish,50,100,50,1,00004,India
171623,2023-07-17,1002,Mascara,200,400,200,1,00004,India
171623,2023-07-17,1009,Moisturizer,250,500,250,1,00004,India
880246,2023-07-17,1006,Blush,150,300,150,1,00055,India
880246,2023-07-17,1005,Nail Polish,50,100,50,1,00055,India
880246,2023-07-17,1002,Mascara,200,400,200,1,00055,India
738141,2023-07-17,1005,Nail Polish,50,100,50,1,00061,India
642062,2023-07-18,1008,Makeup Remover,80,160,80,1,00330,India
642062,2023-07-18,1006,Blush,150,300,150,1,00330,India
642062,2023-07-18,1005,Nail Polish,50,100,50,1,00330,India
642062,2023-07-18,1004,Eyeliner,100,200,100,1,00330,India
642062,2023-07-18,1012,Body Lotion,200,400,200,1,00330,India
678721,2023-07-18,1007,Eyeshadow,200,400,200,1,00432,India
815468,2023-07-18,1009,Moisturizer,250,500,250,1,00044,India
815468,2023-07-18,1006,Blush,150,300,150,1,00044,India
815468,2023-07-18,1004,Eyeliner,100,200,100,1,00044,India
440449,2023-07-18,1009,Moisturizer,250,500,250,1,00365,India
995719,2023-07-18,1012,Body Lotion,200,400,200,1,00096,India
995719,2023-07-18,1009,Moisturizer,250,500,250,1,00096,India
995719,2023-07-18,1003,Foundation,300,600,300,1,00096,India
995719,2023-07-18,1002,Mascara,200,400,200,1,00096,India
452017,2023-07-18,1001,Lipstick,150,300,150,1,00277,India
452017,2023-07-18,1002,Mascara,200,400,200,1,00277,India
452017,2023-07-18,1009,Moisturizer,250,500,250,1,00277,India
452017,2023-07-18,1012,Body Lotion,200,400,200,1,00277,India
452017,2023-07-18,1005,Nail Polish,50,100,50,1,00277,India
730624,2023-07-18,1007,Eyeshadow,200,400,200,1,00351,India
730624,2023-07-18,1005,Nail Polish,50,100,50,1,00351,India
730624,2023-07-18,1002,Mascara,200,400,200,1,00351,India
730624,2023-07-18,1008,Makeup Remover,80,160,80,1,00351,India
730624,2023-07-18,1012,Body Lotion,200,400,200,1,00351,India
925967,2023-07-18,1009,Moisturizer,250,500,250,1,00276,India
915936,2023-07-18,1012,Body Lotion,200,400,200,1,00467,India
915936,2023-07-18,1006,Blush,150,300,150,1,00467,India
915936,2023-07-18,1005,Nail Polish,50,100,50,1,00467,India
915936,2023-07-18,1004,Eyeliner,100,200,100,1,00467,India
968508,2023-07-18,1002,Mascara,200,400,200,1,00313,India
968508,2023-07-18,1006,Blush,150,300,150,1,00313,India
968508,2023-07-18,1003,Foundation,300,600,300,1,00313,India
970403,2023-07-18,1006,Blush,150,300,150,1,00477,India
970403,2023-07-18,1002,Mascara,200,400,200,1,00477,India
576394,2023-07-18,1012,Body Lotion,200,400,200,1,00236,India
574358,2023-07-18,1008,Makeup Remover,80,160,80,1,00271,India
574358,2023-07-18,1005,Nail Polish,50,100,50,1,00271,India
349487,2023-07-18,1006,Blush,150,300,150,1,00058,India
515690,2023-07-18,1005,Nail Polish,50,100,50,1,00226,India
515690,2023-07-18,1009,Moisturizer,250,500,250,1,00226,India
515690,2023-07-18,1007,Eyeshadow,200,400,200,1,00226,India
515690,2023-07-18,1012,Body Lotion,200,400,200,1,00226,India
438131,2023-07-18,1006,Blush,150,300,150,1,00360,India
438131,2023-07-18,1004,Eyeliner,100,200,100,1,00360,India
486510,2023-07-18,1004,Eyeliner,100,200,100,1,00227,India
486510,2023-07-18,1012,Body Lotion,200,400,200,1,00227,India
486510,2023-07-18,1005,Nail Polish,50,100,50,1,00227,India
486510,2023-07-18,1002,Mascara,200,400,200,1,00227,India
375417,2023-07-18,1004,Eyeliner,100,200,100,1,00127,India
375417,2023-07-18,1003,Foundation,300,600,300,1,00127,India
375417,2023-07-18,1005,Nail Polish,50,100,50,1,00127,India
481649,2023-07-18,1012,Body Lotion,200,400,200,1,00288,India
481649,2023-07-18,1009,Moisturizer,250,500,250,1,00288,India
481649,2023-07-18,1008,Makeup Remover,80,160,80,1,00288,India
753364,2023-07-18,1007,Eyeshadow,200,400,200,1,00251,India
807757,2023-07-18,1004,Eyeliner,100,200,100,1,00473,India
807757,2023-07-18,1012,Body Lotion,200,400,200,1,00473,India
807757,2023-07-18,1002,Mascara,200,400,200,1,00473,India
807757,2023-07-18,1005,Nail Polish,50,100,50,1,00473,India
422484,2023-07-18,1002,Mascara,200,400,200,1,00261,India
422484,2023-07-18,1012,Body Lotion,200,400,200,1,00261,India
422484,2023-07-18,1005,Nail Polish,50,100,50,1,00261,India
422484,2023-07-18,1007,Eyeshadow,200,400,200,1,00261,India
789144,2023-07-18,1004,Eyeliner,100,200,100,1,00408,India
789144,2023-07-18,1003,Foundation,300,600,300,1,00408,India
182194,2023-07-18,1007,Eyeshadow,200,400,200,1,00223,India
182194,2023-07-18,1008,Makeup Remover,80,160,80,1,00223,India
182194,2023-07-18,1003,Foundation,300,600,300,1,00223,India
182194,2023-07-18,1009,Moisturizer,250,500,250,1,00223,India
182194,2023-07-18,1004,Eyeliner,100,200,100,1,00223,India
184701,2023-07-18,1008,Makeup Remover,80,160,80,1,00214,India
184701,2023-07-18,1001,Lipstick,150,300,150,1,00214,India
214519,2023-07-18,1004,Eyeliner,100,200,100,1,00449,India
214519,2023-07-18,1009,Moisturizer,250,500,250,1,00449,India
214519,2023-07-18,1008,Makeup Remover,80,160,80,1,00449,India
331966,2023-07-18,1007,Eyeshadow,200,400,200,1,00070,India
331966,2023-07-18,1009,Moisturizer,250,500,250,1,00070,India
331966,2023-07-18,1002,Mascara,200,400,200,1,00070,India
197495,2023-07-18,1003,Foundation,300,600,300,1,00049,India
197495,2023-07-18,1008,Makeup Remover,80,160,80,1,00049,India
197495,2023-07-18,1004,Eyeliner,100,200,100,1,00049,India
231035,2023-07-18,1012,Body Lotion,200,400,200,1,00353,India
231035,2023-07-18,1005,Nail Polish,50,100,50,1,00353,India
231035,2023-07-18,1002,Mascara,200,400,200,1,00353,India
662027,2023-07-18,1001,Lipstick,150,300,150,1,00154,India
662027,2023-07-18,1003,Foundation,300,600,300,1,00154,India
662027,2023-07-18,1006,Blush,150,300,150,1,00154,India
111120,2023-07-18,1008,Makeup Remover,80,160,80,1,00350,India
111120,2023-07-18,1006,Blush,150,300,150,1,00350,India
145143,2023-07-18,1007,Eyeshadow,200,400,200,1,00206,India
787588,2023-07-18,1007,Eyeshadow,200,400,200,1,00122,India
787588,2023-07-18,1003,Foundation,300,600,300,1,00122,India
659433,2023-07-18,1002,Mascara,200,400,200,1,00269,India
238513,2023-07-18,1007,Eyeshadow,200,400,200,1,00125,India
238513,2023-07-18,1008,Makeup Remover,80,160,80,1,00125,India
238513,2023-07-18,1001,Lipstick,150,300,150,1,00125,India
238513,2023-07-18,1012,Body Lotion,200,400,200,1,00125,India
698222,2023-07-18,1007,Eyeshadow,200,400,200,1,00108,India
352353,2023-07-18,1012,Body Lotion,200,400,200,1,00015,India
352353,2023-07-18,1002,Mascara,200,400,200,1,00015,India
568092,2023-07-18,1004,Eyeliner,100,200,100,1,00458,India
454639,2023-07-18,1004,Eyeliner,100,200,100,1,00229,India
454639,2023-07-18,1008,Makeup Remover,80,160,80,1,00229,India
454639,2023-07-18,1003,Foundation,300,600,300,1,00229,India
454639,2023-07-18,1006,Blush,150,300,150,1,00229,India
829352,2023-07-18,1005,Nail Polish,50,100,50,1,00405,India
829352,2023-07-18,1008,Makeup Remover,80,160,80,1,00405,India
829352,2023-07-18,1006,Blush,150,300,150,1,00405,India
829352,2023-07-18,1004,Eyeliner,100,200,100,1,00405,India
711083,2023-07-19,1012,Body Lotion,200,400,200,1,00088,India
711083,2023-07-19,1002,Mascara,200,400,200,1,00088,India
711083,2023-07-19,1008,Makeup Remover,80,160,80,1,00088,India
806384,2023-07-19,1005,Nail Polish,50,100,50,1,00436,India
806384,2023-07-19,1002,Mascara,200,400,200,1,00436,India
806384,2023-07-19,1003,Foundation,300,600,300,1,00436,India
806384,2023-07-19,1006,Blush,150,300,150,1,00436,India
451190,2023-07-19,1006,Blush,150,300,150,1,00160,India
451190,2023-07-19,1001,Lipstick,150,300,150,1,00160,India
451190,2023-07-19,1004,Eyeliner,100,200,100,1,00160,India
451190,2023-07-19,1007,Eyeshadow,200,400,200,1,00160,India
583134,2023-07-19,1001,Lipstick,150,300,150,1,00486,India
583134,2023-07-19,1009,Moisturizer,250,500,250,1,00486,India
164283,2023-07-19,1006,Blush,150,300,150,1,00326,India
164283,2023-07-19,1008,Makeup Remover,80,160,80,1,00326,India
164283,2023-07-19,1007,Eyeshadow,200,400,200,1,00326,India
164283,2023-07-19,1003,Foundation,300,600,300,1,00326,India
164283,2023-07-19,1009,Moisturizer,250,500,250,1,00326,India
152632,2023-07-19,1009,Moisturizer,250,500,250,1,00370,India
152632,2023-07-19,1008,Makeup Remover,80,160,80,1,00370,India
152632,2023-07-19,1004,Eyeliner,100,200,100,1,00370,India
152632,2023-07-19,1002,Mascara,200,400,200,1,00370,India
938073,2023-07-19,1009,Moisturizer,250,500,250,1,00258,India
938073,2023-07-19,1003,Foundation,300,600,300,1,00258,India
938073,2023-07-19,1002,Mascara,200,400,200,1,00258,India
938073,2023-07-19,1006,Blush,150,300,150,1,00258,India
938073,2023-07-19,1005,Nail Polish,50,100,50,1,00258,India
984670,2023-07-19,1006,Blush,150,300,150,1,00040,India
984670,2023-07-19,1012,Body Lotion,200,400,200,1,00040,India
984670,2023-07-19,1001,Lipstick,150,300,150,1,00040,India
984670,2023-07-19,1002,Mascara,200,400,200,1,00040,India
455200,2023-07-19,1003,Foundation,300,600,300,1,00067,India
455200,2023-07-19,1009,Moisturizer,250,500,250,1,00067,India
455200,2023-07-19,1007,Eyeshadow,200,400,200,1,00067,India
455200,2023-07-19,1012,Body Lotion,200,400,200,1,00067,India
943933,2023-07-19,1009,Moisturizer,250,500,250,1,00164,India
943933,2023-07-19,1002,Mascara,200,400,200,1,00164,India
943933,2023-07-19,1012,Body Lotion,200,400,200,1,00164,India
943933,2023-07-19,1004,Eyeliner,100,200,100,1,00164,India
182149,2023-07-19,1012,Body Lotion,200,400,200,1,00287,India
182149,2023-07-19,1009,Moisturizer,250,500,250,1,00287,India
804820,2023-07-19,1001,Lipstick,150,300,150,1,00259,India
804820,2023-07-19,1009,Moisturizer,250,500,250,1,00259,India
551934,2023-07-19,1006,Blush,150,300,150,1,00133,India
551934,2023-07-19,1001,Lipstick,150,300,150,1,00133,India
551934,2023-07-19,1012,Body Lotion,200,400,200,1,00133,India
551934,2023-07-19,1004,Eyeliner,100,200,100,1,00133,India
370766,2023-07-19,1003,Foundation,300,600,300,1,00064,India
867292,2023-07-19,1012,Body Lotion,200,400,200,1,00324,India
984134,2023-07-19,1004,Eyeliner,100,200,100,1,00442,India
984134,2023-07-19,1012,Body Lotion,200,400,200,1,00442,India
772799,2023-07-19,1001,Lipstick,150,300,150,1,00204,India
732800,2023-07-19,1007,Eyeshadow,200,400,200,1,00294,India
881891,2023-07-19,1009,Moisturizer,250,500,250,1,00044,India
881891,2023-07-19,1008,Makeup Remover,80,160,80,1,00044,India
881891,2023-07-19,1001,Lipstick,150,300,150,1,00044,India
881891,2023-07-19,1005,Nail Polish,50,100,50,1,00044,India
954435,2023-07-19,1007,Eyeshadow,200,400,200,1,00240,India
954435,2023-07-19,1004,Eyeliner,100,200,100,1,00240,India
678006,2023-07-19,1009,Moisturizer,250,500,250,1,00015,India
678006,2023-07-19,1007,Eyeshadow,200,400,200,1,00015,India
678006,2023-07-19,1002,Mascara,200,400,200,1,00015,India
691627,2023-07-19,1009,Moisturizer,250,500,250,1,00289,India
691627,2023-07-19,1005,Nail Polish,50,100,50,1,00289,India
873157,2023-07-19,1009,Moisturizer,250,500,250,1,00063,India
275026,2023-07-19,1007,Eyeshadow,200,400,200,1,00490,India
275026,2023-07-19,1004,Eyeliner,100,200,100,1,00490,India
924914,2023-07-19,1002,Mascara,200,400,200,1,00161,India
678291,2023-07-19,1004,Eyeliner,100,200,100,1,00080,India
582184,2023-07-19,1012,Body Lotion,200,400,200,1,00333,India
582184,2023-07-19,1007,Eyeshadow,200,400,200,1,00333,India
555665,2023-07-19,1004,Eyeliner,100,200,100,1,00346,India
130848,2023-07-19,1003,Foundation,300,600,300,1,00219,India
130848,2023-07-19,1009,Moisturizer,250,500,250,1,00219,India
642393,2023-07-19,1004,Eyeliner,100,200,100,1,00468,India
642393,2023-07-19,1008,Makeup Remover,80,160,80,1,00468,India
642393,2023-07-19,1005,Nail Polish,50,100,50,1,00468,India
138057,2023-07-19,1007,Eyeshadow,200,400,200,1,00263,India
138057,2023-07-19,1003,Foundation,300,600,300,1,00263,India
138057,2023-07-19,1001,Lipstick,150,300,150,1,00263,India
920911,2023-07-19,1004,Eyeliner,100,200,100,1,00265,India
336611,2023-07-19,1012,Body Lotion,200,400,200,1,00349,India
336611,2023-07-19,1006,Blush,150,300,150,1,00349,India
336611,2023-07-19,1003,Foundation,300,600,300,1,00349,India
336611,2023-07-19,1007,Eyeshadow,200,400,200,1,00349,India
492283,2023-07-19,1004,Eyeliner,100,200,100,1,00023,India
492283,2023-07-19,1002,Mascara,200,400,200,1,00023,India
369989,2023-07-19,1007,Eyeshadow,200,400,200,1,00306,India
740057,2023-07-19,1003,Foundation,300,600,300,1,00113,India
740057,2023-07-19,1007,Eyeshadow,200,400,200,1,00113,India
601578,2023-07-19,1001,Lipstick,150,300,150,1,00350,India
601578,2023-07-19,1007,Eyeshadow,200,400,200,1,00350,India
180911,2023-07-19,1003,Foundation,300,600,300,1,00328,India
180911,2023-07-19,1002,Mascara,200,400,200,1,00328,India
148434,2023-07-19,1003,Foundation,300,600,300,1,00047,India
148434,2023-07-19,1004,Eyeliner,100,200,100,1,00047,India
817795,2023-07-19,1002,Mascara,200,400,200,1,00156,India
817795,2023-07-19,1007,Eyeshadow,200,400,200,1,00156,India
817795,2023-07-19,1008,Makeup Remover,80,160,80,1,00156,India
817795,2023-07-19,1009,Moisturizer,250,500,250,1,00156,India
593129,2023-07-19,1003,Foundation,300,600,300,1,00288,India
593129,2023-07-19,1008,Makeup Remover,80,160,80,1,00288,India
593129,2023-07-19,1006,Blush,150,300,150,1,00288,India
593129,2023-07-19,1007,Eyeshadow,200,400,200,1,00288,India
108101,2023-07-19,1002,Mascara,200,400,200,1,00015,India
108101,2023-07-19,1003,Foundation,300,600,300,1,00015,India
108101,2023-07-19,1005,Nail Polish,50,100,50,1,00015,India
486261,2023-07-19,1003,Foundation,300,600,300,1,00343,India
897389,2023-07-19,1012,Body Lotion,200,400,200,1,00410,India
897389,2023-07-19,1001,Lipstick,150,300,150,1,00410,India
897389,2023-07-19,1008,Makeup Remover,80,160,80,1,00410,India
897389,2023-07-19,1005,Nail Polish,50,100,50,1,00410,India
417231,2023-07-19,1007,Eyeshadow,200,400,200,1,00238,India
417231,2023-07-19,1003,Foundation,300,600,300,1,00238,India
236194,2023-07-19,1007,Eyeshadow,200,400,200,1,00397,India
236194,2023-07-19,1006,Blush,150,300,150,1,00397,India
339274,2023-07-19,1008,Makeup Remover,80,160,80,1,00207,India
963601,2023-07-19,1004,Eyeliner,100,200,100,1,00385,India
963601,2023-07-19,1002,Mascara,200,400,200,1,00385,India
963601,2023-07-19,1006,Blush,150,300,150,1,00385,India
191691,2023-07-19,1002,Mascara,200,400,200,1,00080,India
506816,2023-07-20,1008,Makeup Remover,80,160,80,1,00270,India
523509,2023-07-20,1004,Eyeliner,100,200,100,1,00271,India
523509,2023-07-20,1003,Foundation,300,600,300,1,00271,India
523509,2023-07-20,1009,Moisturizer,250,500,250,1,00271,India
528869,2023-07-20,1008,Makeup Remover,80,160,80,1,00126,India
528869,2023-07-20,1006,Blush,150,300,150,1,00126,India
544396,2023-07-20,1009,Moisturizer,250,500,250,1,00182,India
243834,2023-07-20,1005,Nail Polish,50,100,50,1,00348,India
243834,2023-07-20,1003,Foundation,300,600,300,1,00348,India
243834,2023-07-20,1007,Eyeshadow,200,400,200,1,00348,India
243834,2023-07-20,1001,Lipstick,150,300,150,1,00348,India
277249,2023-07-20,1004,Eyeliner,100,200,100,1,00135,India
277249,2023-07-20,1007,Eyeshadow,200,400,200,1,00135,India
629636,2023-07-20,1005,Nail Polish,50,100,50,1,00294,India
629636,2023-07-20,1009,Moisturizer,250,500,250,1,00294,India
629636,2023-07-20,1008,Makeup Remover,80,160,80,1,00294,India
997524,2023-07-20,1001,Lipstick,150,300,150,1,00206,India
997524,2023-07-20,1006,Blush,150,300,150,1,00206,India
997524,2023-07-20,1009,Moisturizer,250,500,250,1,00206,India
997524,2023-07-20,1002,Mascara,200,400,200,1,00206,India
340762,2023-07-20,1007,Eyeshadow,200,400,200,1,00498,India
340762,2023-07-20,1012,Body Lotion,200,400,200,1,00498,India
340762,2023-07-20,1006,Blush,150,300,150,1,00498,India
947474,2023-07-20,1001,Lipstick,150,300,150,1,00080,India
618816,2023-07-20,1001,Lipstick,150,300,150,1,00296,India
618816,2023-07-20,1009,Moisturizer,250,500,250,1,00296,India
618816,2023-07-20,1012,Body Lotion,200,400,200,1,00296,India
309302,2023-07-20,1001,Lipstick,150,300,150,1,00062,India
309302,2023-07-20,1003,Foundation,300,600,300,1,00062,India
309302,2023-07-20,1008,Makeup Remover,80,160,80,1,00062,India
309302,2023-07-20,1002,Mascara,200,400,200,1,00062,India
351593,2023-07-20,1008,Makeup Remover,80,160,80,1,00317,India
351593,2023-07-20,1006,Blush,150,300,150,1,00317,India
351593,2023-07-20,1003,Foundation,300,600,300,1,00317,India
351593,2023-07-20,1012,Body Lotion,200,400,200,1,00317,India
351593,2023-07-20,1009,Moisturizer,250,500,250,1,00317,India
714715,2023-07-20,1003,Foundation,300,600,300,1,00033,India
714715,2023-07-20,1008,Makeup Remover,80,160,80,1,00033,India
714715,2023-07-20,1005,Nail Polish,50,100,50,1,00033,India
761177,2023-07-20,1012,Body Lotion,200,400,200,1,00328,India
761177,2023-07-20,1004,Eyeliner,100,200,100,1,00328,India
826783,2023-07-20,1002,Mascara,200,400,200,1,00383,India
826783,2023-07-20,1007,Eyeshadow,200,400,200,1,00383,India
653730,2023-07-20,1002,Mascara,200,400,200,1,00415,India
984561,2023-07-20,1008,Makeup Remover,80,160,80,1,00205,India
984561,2023-07-20,1001,Lipstick,150,300,150,1,00205,India
984561,2023-07-20,1006,Blush,150,300,150,1,00205,India
984561,2023-07-20,1003,Foundation,300,600,300,1,00205,India
984561,2023-07-20,1002,Mascara,200,400,200,1,00205,India
688764,2023-07-20,1008,Makeup Remover,80,160,80,1,00072,India
688764,2023-07-20,1003,Foundation,300,600,300,1,00072,India
688764,2023-07-20,1001,Lipstick,150,300,150,1,00072,India
688764,2023-07-20,1007,Eyeshadow,200,400,200,1,00072,India
912723,2023-07-20,1004,Eyeliner,100,200,100,1,00289,India
912723,2023-07-20,1006,Blush,150,300,150,1,00289,India
912723,2023-07-20,1001,Lipstick,150,300,150,1,00289,India
912723,2023-07-20,1003,Foundation,300,600,300,1,00289,India
912723,2023-07-20,1007,Eyeshadow,200,400,200,1,00289,India
187403,2023-07-20,1001,Lipstick,150,300,150,1,00018,India
187403,2023-07-20,1009,Moisturizer,250,500,250,1,00018,India
187403,2023-07-20,1002,Mascara,200,400,200,1,00018,India
268466,2023-07-20,1003,Foundation,300,600,300,1,00097,India
268466,2023-07-20,1006,Blush,150,300,150,1,00097,India
268466,2023-07-20,1007,Eyeshadow,200,400,200,1,00097,India
268466,2023-07-20,1008,Makeup Remover,80,160,80,1,00097,India
691365,2023-07-20,1006,Blush,150,300,150,1,00127,India
691365,2023-07-20,1005,Nail Polish,50,100,50,1,00127,India
244950,2023-07-20,1006,Blush,150,300,150,1,00335,India
244950,2023-07-20,1003,Foundation,300,600,300,1,00335,India
244950,2023-07-20,1001,Lipstick,150,300,150,1,00335,India
244950,2023-07-20,1008,Makeup Remover,80,160,80,1,00335,India
999517,2023-07-20,1003,Foundation,300,600,300,1,00117,India
999517,2023-07-20,1004,Eyeliner,100,200,100,1,00117,India
999517,2023-07-20,1002,Mascara,200,400,200,1,00117,India
151761,2023-07-20,1001,Lipstick,150,300,150,1,00356,India
558078,2023-07-20,1004,Eyeliner,100,200,100,1,00422,India
558078,2023-07-20,1009,Moisturizer,250,500,250,1,00422,India
558078,2023-07-20,1005,Nail Polish,50,100,50,1,00422,India
558078,2023-07-20,1002,Mascara,200,400,200,1,00422,India
309702,2023-07-20,1012,Body Lotion,200,400,200,1,00358,India
309702,2023-07-20,1004,Eyeliner,100,200,100,1,00358,India
309702,2023-07-20,1008,Makeup Remover,80,160,80,1,00358,India
891308,2023-07-20,1006,Blush,150,300,150,1,00115,India
891308,2023-07-20,1009,Moisturizer,250,500,250,1,00115,India
891308,2023-07-20,1004,Eyeliner,100,200,100,1,00115,India
192335,2023-07-20,1005,Nail Polish,50,100,50,1,00121,India
192335,2023-07-20,1007,Eyeshadow,200,400,200,1,00121,India
516896,2023-07-20,1005,Nail Polish,50,100,50,1,00284,India
516896,2023-07-20,1009,Moisturizer,250,500,250,1,00284,India
462003,2023-07-20,1002,Mascara,200,400,200,1,00126,India
462003,2023-07-20,1009,Moisturizer,250,500,250,1,00126,India
462003,2023-07-20,1001,Lipstick,150,300,150,1,00126,India
349420,2023-07-20,1008,Makeup Remover,80,160,80,1,00044,India
854761,2023-07-20,1006,Blush,150,300,150,1,00281,India
854761,2023-07-20,1005,Nail Polish,50,100,50,1,00281,India
854761,2023-07-20,1002,Mascara,200,400,200,1,00281,India
854761,2023-07-20,1012,Body Lotion,200,400,200,1,00281,India
854761,2023-07-20,1003,Foundation,300,600,300,1,00281,India
482916,2023-07-20,1009,Moisturizer,250,500,250,1,00050,India
482916,2023-07-20,1006,Blush,150,300,150,1,00050,India
482916,2023-07-20,1001,Lipstick,150,300,150,1,00050,India
526017,2023-07-21,1001,Lipstick,150,300,150,1,00331,India
526017,2023-07-21,1006,Blush,150,300,150,1,00331,India
526017,2023-07-21,1012,Body Lotion,200,400,200,1,00331,India
876193,2023-07-21,1006,Blush,150,300,150,1,00187,India
876193,2023-07-21,1009,Moisturizer,250,500,250,1,00187,India
785705,2023-07-21,1001,Lipstick,150,300,150,1,00199,India
785705,2023-07-21,1007,Eyeshadow,200,400,200,1,00199,India
785705,2023-07-21,1009,Moisturizer,250,500,250,1,00199,India
785705,2023-07-21,1003,Foundation,300,600,300,1,00199,India
531779,2023-07-21,1006,Blush,150,300,150,1,00155,India
531779,2023-07-21,1002,Mascara,200,400,200,1,00155,India
499340,2023-07-21,1003,Foundation,300,600,300,1,00058,India
499340,2023-07-21,1002,Mascara,200,400,200,1,00058,India
723555,2023-07-21,1001,Lipstick,150,300,150,1,00112,India
723555,2023-07-21,1003,Foundation,300,600,300,1,00112,India
723555,2023-07-21,1012,Body Lotion,200,400,200,1,00112,India
151549,2023-07-21,1002,Mascara,200,400,200,1,00372,India
151549,2023-07-21,1008,Makeup Remover,80,160,80,1,00372,India
151549,2023-07-21,1009,Moisturizer,250,500,250,1,00372,India
151549,2023-07-21,1006,Blush,150,300,150,1,00372,India
291742,2023-07-21,1003,Foundation,300,600,300,1,00156,India
291742,2023-07-21,1008,Makeup Remover,80,160,80,1,00156,India
291742,2023-07-21,1012,Body Lotion,200,400,200,1,00156,India
279818,2023-07-21,1002,Mascara,200,400,200,1,00309,India
279818,2023-07-21,1012,Body Lotion,200,400,200,1,00309,India
193311,2023-07-21,1006,Blush,150,300,150,1,00210,India
193311,2023-07-21,1008,Makeup Remover,80,160,80,1,00210,India
193311,2023-07-21,1007,Eyeshadow,200,400,200,1,00210,India
193311,2023-07-21,1004,Eyeliner,100,200,100,1,00210,India
193311,2023-07-21,1012,Body Lotion,200,400,200,1,00210,India
541073,2023-07-21,1003,Foundation,300,600,300,1,00277,India
541073,2023-07-21,1001,Lipstick,150,300,150,1,00277,India
541073,2023-07-21,1005,Nail Polish,50,100,50,1,00277,India
166734,2023-07-21,1007,Eyeshadow,200,400,200,1,00021,India
166734,2023-07-21,1005,Nail Polish,50,100,50,1,00021,India
166734,2023-07-21,1004,Eyeliner,100,200,100,1,00021,India
611692,2023-07-21,1003,Foundation,300,600,300,1,00063,India
611692,2023-07-21,1007,Eyeshadow,200,400,200,1,00063,India
611692,2023-07-21,1001,Lipstick,150,300,150,1,00063,India
936745,2023-07-21,1002,Mascara,200,400,200,1,00349,India
936745,2023-07-21,1005,Nail Polish,50,100,50,1,00349,India
405158,2023-07-21,1001,Lipstick,150,300,150,1,00066,India
405158,2023-07-21,1008,Makeup Remover,80,160,80,1,00066,India
405158,2023-07-21,1012,Body Lotion,200,400,200,1,00066,India
938657,2023-07-21,1004,Eyeliner,100,200,100,1,00211,India
938657,2023-07-21,1002,Mascara,200,400,200,1,00211,India
106253,2023-07-21,1004,Eyeliner,100,200,100,1,00023,India
853962,2023-07-21,1004,Eyeliner,100,200,100,1,00246,India
853962,2023-07-21,1001,Lipstick,150,300,150,1,00246,India
145259,2023-07-21,1006,Blush,150,300,150,1,00333,India
777119,2023-07-21,1003,Foundation,300,600,300,1,00497,India
777119,2023-07-21,1008,Makeup Remover,80,160,80,1,00497,India
777119,2023-07-21,1009,Moisturizer,250,500,250,1,00497,India
922607,2023-07-21,1002,Mascara,200,400,200,1,00120,India
486725,2023-07-21,1012,Body Lotion,200,400,200,1,00164,India
853249,2023-07-21,1001,Lipstick,150,300,150,1,00300,India
853249,2023-07-21,1008,Makeup Remover,80,160,80,1,00300,India
853249,2023-07-21,1012,Body Lotion,200,400,200,1,00300,India
853249,2023-07-21,1002,Mascara,200,400,200,1,00300,India
853249,2023-07-21,1006,Blush,150,300,150,1,00300,India
557721,2023-07-21,1009,Moisturizer,250,500,250,1,00267,India
557721,2023-07-21,1002,Mascara,200,400,200,1,00267,India
557721,2023-07-21,1006,Blush,150,300,150,1,00267,India
315718,2023-07-21,1009,Moisturizer,250,500,250,1,00211,India
315718,2023-07-21,1012,Body Lotion,200,400,200,1,00211,India
921646,2023-07-21,1002,Mascara,200,400,200,1,00489,India
921646,2023-07-21,1001,Lipstick,150,300,150,1,00489,India
921646,2023-07-21,1009,Moisturizer,250,500,250,1,00489,India
501342,2023-07-21,1005,Nail Polish,50,100,50,1,00011,India
501342,2023-07-21,1006,Blush,150,300,150,1,00011,India
501342,2023-07-21,1002,Mascara,200,400,200,1,00011,India
198529,2023-07-21,1001,Lipstick,150,300,150,1,00267,India
198529,2023-07-21,1012,Body Lotion,200,400,200,1,00267,India
198529,2023-07-21,1006,Blush,150,300,150,1,00267,India
198529,2023-07-21,1007,Eyeshadow,200,400,200,1,00267,India
829058,2023-07-21,1005,Nail Polish,50,100,50,1,00004,India
829058,2023-07-21,1004,Eyeliner,100,200,100,1,00004,India
829058,2023-07-21,1002,Mascara,200,400,200,1,00004,India
161708,2023-07-21,1007,Eyeshadow,200,400,200,1,00353,India
161708,2023-07-21,1008,Makeup Remover,80,160,80,1,00353,India
161708,2023-07-21,1009,Moisturizer,250,500,250,1,00353,India
161708,2023-07-21,1003,Foundation,300,600,300,1,00353,India
616749,2023-07-21,1005,Nail Polish,50,100,50,1,00414,India
616749,2023-07-21,1009,Moisturizer,250,500,250,1,00414,India
616749,2023-07-21,1006,Blush,150,300,150,1,00414,India
373404,2023-07-21,1002,Mascara,200,400,200,1,00447,India
152055,2023-07-21,1008,Makeup Remover,80,160,80,1,00336,India
152055,2023-07-21,1012,Body Lotion,200,400,200,1,00336,India
152055,2023-07-21,1009,Moisturizer,250,500,250,1,00336,India
395575,2023-07-21,1003,Foundation,300,600,300,1,00330,India
395575,2023-07-21,1004,Eyeliner,100,200,100,1,00330,India
395575,2023-07-21,1001,Lipstick,150,300,150,1,00330,India
395575,2023-07-21,1007,Eyeshadow,200,400,200,1,00330,India
395575,2023-07-21,1008,Makeup Remover,80,160,80,1,00330,India
517087,2023-07-21,1003,Foundation,300,600,300,1,00136,India
517087,2023-07-21,1002,Mascara,200,400,200,1,00136,India
605416,2023-07-21,1012,Body Lotion,200,400,200,1,00200,India
605416,2023-07-21,1009,Moisturizer,250,500,250,1,00200,India
605416,2023-07-21,1001,Lipstick,150,300,150,1,00200,India
724059,2023-07-21,1004,Eyeliner,100,200,100,1,00157,India
873777,2023-07-21,1005,Nail Polish,50,100,50,1,00412,India
873777,2023-07-21,1012,Body Lotion,200,400,200,1,00412,India
873777,2023-07-21,1006,Blush,150,300,150,1,00412,India
154688,2023-07-21,1007,Eyeshadow,200,400,200,1,00408,India
477615,2023-07-21,1005,Nail Polish,50,100,50,1,00041,India
477615,2023-07-21,1004,Eyeliner,100,200,100,1,00041,India
477615,2023-07-21,1007,Eyeshadow,200,400,200,1,00041,India
477615,2023-07-21,1003,Foundation,300,600,300,1,00041,India
893121,2023-07-21,1008,Makeup Remover,80,160,80,1,00352,India
831217,2023-07-22,1008,Makeup Remover,80,160,80,1,00308,India
831217,2023-07-22,1001,Lipstick,150,300,150,1,00308,India
831217,2023-07-22,1006,Blush,150,300,150,1,00308,India
831217,2023-07-22,1002,Mascara,200,400,200,1,00308,India
831217,2023-07-22,1007,Eyeshadow,200,400,200,1,00308,India
766750,2023-07-22,1003,Foundation,300,600,300,1,00396,India
766750,2023-07-22,1001,Lipstick,150,300,150,1,00396,India
766750,2023-07-22,1004,Eyeliner,100,200,100,1,00396,India
766750,2023-07-22,1008,Makeup Remover,80,160,80,1,00396,India
721571,2023-07-22,1009,Moisturizer,250,500,250,1,00476,India
721571,2023-07-22,1006,Blush,150,300,150,1,00476,India
344119,2023-07-22,1001,Lipstick,150,300,150,1,00209,India
344119,2023-07-22,1012,Body Lotion,200,400,200,1,00209,India
344119,2023-07-22,1008,Makeup Remover,80,160,80,1,00209,India
344119,2023-07-22,1003,Foundation,300,600,300,1,00209,India
433092,2023-07-22,1004,Eyeliner,100,200,100,1,00149,India
433092,2023-07-22,1007,Eyeshadow,200,400,200,1,00149,India
433092,2023-07-22,1005,Nail Polish,50,100,50,1,00149,India
753601,2023-07-22,1002,Mascara,200,400,200,1,00397,India
753601,2023-07-22,1006,Blush,150,300,150,1,00397,India
753601,2023-07-22,1003,Foundation,300,600,300,1,00397,India
753601,2023-07-22,1012,Body Lotion,200,400,200,1,00397,India
753601,2023-07-22,1004,Eyeliner,100,200,100,1,00397,India
299606,2023-07-22,1007,Eyeshadow,200,400,200,1,00102,India
299606,2023-07-22,1004,Eyeliner,100,200,100,1,00102,India
299606,2023-07-22,1005,Nail Polish,50,100,50,1,00102,India
959811,2023-07-22,1012,Body Lotion,200,400,200,1,00476,India
959811,2023-07-22,1006,Blush,150,300,150,1,00476,India
959811,2023-07-22,1003,Foundation,300,600,300,1,00476,India
959811,2023-07-22,1008,Makeup Remover,80,160,80,1,00476,India
959811,2023-07-22,1005,Nail Polish,50,100,50,1,00476,India
617232,2023-07-22,1008,Makeup Remover,80,160,80,1,00024,India
617232,2023-07-22,1006,Blush,150,300,150,1,00024,India
617232,2023-07-22,1004,Eyeliner,100,200,100,1,00024,India
617232,2023-07-22,1003,Foundation,300,600,300,1,00024,India
198314,2023-07-22,1012,Body Lotion,200,400,200,1,00109,India
198314,2023-07-22,1008,Makeup Remover,80,160,80,1,00109,India
410587,2023-07-22,1012,Body Lotion,200,400,200,1,00232,India
410587,2023-07-22,1007,Eyeshadow,200,400,200,1,00232,India
410587,2023-07-22,1003,Foundation,300,600,300,1,00232,India
136966,2023-07-22,1005,Nail Polish,50,100,50,1,00209,India
136966,2023-07-22,1002,Mascara,200,400,200,1,00209,India
136966,2023-07-22,1006,Blush,150,300,150,1,00209,India
136966,2023-07-22,1012,Body Lotion,200,400,200,1,00209,India
435340,2023-07-22,1009,Moisturizer,250,500,250,1,00154,India
586861,2023-07-22,1002,Mascara,200,400,200,1,00330,India
586861,2023-07-22,1001,Lipstick,150,300,150,1,00330,India
586861,2023-07-22,1012,Body Lotion,200,400,200,1,00330,India
431883,2023-07-22,1005,Nail Polish,50,100,50,1,00019,India
431883,2023-07-22,1008,Makeup Remover,80,160,80,1,00019,India
431883,2023-07-22,1012,Body Lotion,200,400,200,1,00019,India
593149,2023-07-22,1008,Makeup Remover,80,160,80,1,00365,India
278849,2023-07-22,1004,Eyeliner,100,200,100,1,00304,India
278849,2023-07-22,1001,Lipstick,150,300,150,1,00304,India
278849,2023-07-22,1009,Moisturizer,250,500,250,1,00304,India
356383,2023-07-22,1008,Makeup Remover,80,160,80,1,00350,India
356383,2023-07-22,1007,Eyeshadow,200,400,200,1,00350,India
828613,2023-07-22,1009,Moisturizer,250,500,250,1,00293,India
828613,2023-07-22,1008,Makeup Remover,80,160,80,1,00293,India
828613,2023-07-22,1006,Blush,150,300,150,1,00293,India
577382,2023-07-22,1009,Moisturizer,250,500,250,1,00174,India
780519,2023-07-22,1006,Blush,150,300,150,1,00446,India
716857,2023-07-22,1006,Blush,150,300,150,1,00378,India
716857,2023-07-22,1009,Moisturizer,250,500,250,1,00378,India
716857,2023-07-22,1001,Lipstick,150,300,150,1,00378,India
941683,2023-07-22,1004,Eyeliner,100,200,100,1,00168,India
941683,2023-07-22,1005,Nail Polish,50,100,50,1,00168,India
330110,2023-07-22,1002,Mascara,200,400,200,1,00429,India
839224,2023-07-22,1005,Nail Polish,50,100,50,1,00492,India
122123,2023-07-22,1001,Lipstick,150,300,150,1,00377,India
384145,2023-07-22,1008,Makeup Remover,80,160,80,1,00340,India
384145,2023-07-22,1007,Eyeshadow,200,400,200,1,00340,India
384145,2023-07-22,1006,Blush,150,300,150,1,00340,India
384145,2023-07-22,1004,Eyeliner,100,200,100,1,00340,India
671409,2023-07-22,1008,Makeup Remover,80,160,80,1,00462,India
320028,2023-07-22,1003,Foundation,300,600,300,1,00379,India
320028,2023-07-22,1008,Makeup Remover,80,160,80,1,00379,India
334299,2023-07-22,1007,Eyeshadow,200,400,200,1,00193,India
334299,2023-07-22,1004,Eyeliner,100,200,100,1,00193,India
334299,2023-07-22,1003,Foundation,300,600,300,1,00193,India
133059,2023-07-22,1006,Blush,150,300,150,1,00071,India
133059,2023-07-22,1004,Eyeliner,100,200,100,1,00071,India
133059,2023-07-22,1005,Nail Polish,50,100,50,1,00071,India
133059,2023-07-22,1009,Moisturizer,250,500,250,1,00071,India
133059,2023-07-22,1012,Body Lotion,200,400,200,1,00071,India
462914,2023-07-22,1006,Blush,150,300,150,1,00102,India
462914,2023-07-22,1009,Moisturizer,250,500,250,1,00102,India
462914,2023-07-22,1004,Eyeliner,100,200,100,1,00102,India
726791,2023-07-22,1008,Makeup Remover,80,160,80,1,00411,India
726791,2023-07-22,1004,Eyeliner,100,200,100,1,00411,India
726791,2023-07-22,1007,Eyeshadow,200,400,200,1,00411,India
726791,2023-07-22,1002,Mascara,200,400,200,1,00411,India
726791,2023-07-22,1003,Foundation,300,600,300,1,00411,India
505737,2023-07-22,1006,Blush,150,300,150,1,00364,India
932918,2023-07-22,1008,Makeup Remover,80,160,80,1,00103,India
932918,2023-07-22,1002,Mascara,200,400,200,1,00103,India
932918,2023-07-22,1006,Blush,150,300,150,1,00103,India
932918,2023-07-22,1004,Eyeliner,100,200,100,1,00103,India
822875,2023-07-22,1008,Makeup Remover,80,160,80,1,00154,India
822875,2023-07-22,1003,Foundation,300,600,300,1,00154,India
822875,2023-07-22,1005,Nail Polish,50,100,50,1,00154,India
602587,2023-07-22,1004,Eyeliner,100,200,100,1,00051,India
602587,2023-07-22,1002,Mascara,200,400,200,1,00051,India
602587,2023-07-22,1009,Moisturizer,250,500,250,1,00051,India
602587,2023-07-22,1008,Makeup Remover,80,160,80,1,00051,India
575160,2023-07-22,1002,Mascara,200,400,200,1,00028,India
575160,2023-07-22,1009,Moisturizer,250,500,250,1,00028,India
575160,2023-07-22,1008,Makeup Remover,80,160,80,1,00028,India
400383,2023-07-22,1001,Lipstick,150,300,150,1,00067,India
400383,2023-07-22,1007,Eyeshadow,200,400,200,1,00067,India
400383,2023-07-22,1003,Foundation,300,600,300,1,00067,India
400383,2023-07-22,1012,Body Lotion,200,400,200,1,00067,India
598995,2023-07-22,1002,Mascara,200,400,200,1,00439,India
598995,2023-07-22,1008,Makeup Remover,80,160,80,1,00439,India
598995,2023-07-22,1009,Moisturizer,250,500,250,1,00439,India
151435,2023-07-22,1006,Blush,150,300,150,1,00079,India
151435,2023-07-22,1008,Makeup Remover,80,160,80,1,00079,India
151435,2023-07-22,1009,Moisturizer,250,500,250,1,00079,India
500813,2023-07-22,1012,Body Lotion,200,400,200,1,00271,India
500813,2023-07-22,1005,Nail Polish,50,100,50,1,00271,India
500813,2023-07-22,1009,Moisturizer,250,500,250,1,00271,India
500813,2023-07-22,1008,Makeup Remover,80,160,80,1,00271,India
962677,2023-07-22,1008,Makeup Remover,80,160,80,1,00163,India
711636,2023-07-22,1012,Body Lotion,200,400,200,1,00398,India
745355,2023-07-22,1003,Foundation,300,600,300,1,00381,India
306903,2023-07-22,1009,Moisturizer,250,500,250,1,00319,India
306903,2023-07-22,1001,Lipstick,150,300,150,1,00319,India
306903,2023-07-22,1003,Foundation,300,600,300,1,00319,India
306903,2023-07-22,1005,Nail Polish,50,100,50,1,00319,India
306903,2023-07-22,1008,Makeup Remover,80,160,80,1,00319,India
734314,2023-07-22,1004,Eyeliner,100,200,100,1,00141,India
734314,2023-07-22,1012,Body Lotion,200,400,200,1,00141,India
734314,2023-07-22,1002,Mascara,200,400,200,1,00141,India
212011,2023-07-22,1012,Body Lotion,200,400,200,1,00137,India
212011,2023-07-22,1005,Nail Polish,50,100,50,1,00137,India
869489,2023-07-23,1007,Eyeshadow,200,400,200,1,00027,India
869489,2023-07-23,1001,Lipstick,150,300,150,1,00027,India
295396,2023-07-23,1002,Mascara,200,400,200,1,00168,India
295396,2023-07-23,1009,Moisturizer,250,500,250,1,00168,India
371351,2023-07-23,1005,Nail Polish,50,100,50,1,00319,India
371351,2023-07-23,1003,Foundation,300,600,300,1,00319,India
371351,2023-07-23,1002,Mascara,200,400,200,1,00319,India
371351,2023-07-23,1004,Eyeliner,100,200,100,1,00319,India
602066,2023-07-23,1005,Nail Polish,50,100,50,1,00307,India
602066,2023-07-23,1008,Makeup Remover,80,160,80,1,00307,India
602066,2023-07-23,1006,Blush,150,300,150,1,00307,India
211435,2023-07-23,1007,Eyeshadow,200,400,200,1,00253,India
490694,2023-07-23,1005,Nail Polish,50,100,50,1,00422,India
490694,2023-07-23,1006,Blush,150,300,150,1,00422,India
490694,2023-07-23,1003,Foundation,300,600,300,1,00422,India
490694,2023-07-23,1002,Mascara,200,400,200,1,00422,India
461127,2023-07-23,1006,Blush,150,300,150,1,00217,India
461127,2023-07-23,1012,Body Lotion,200,400,200,1,00217,India
461127,2023-07-23,1007,Eyeshadow,200,400,200,1,00217,India
461127,2023-07-23,1005,Nail Polish,50,100,50,1,00217,India
995601,2023-07-23,1008,Makeup Remover,80,160,80,1,00005,India
995601,2023-07-23,1012,Body Lotion,200,400,200,1,00005,India
995601,2023-07-23,1007,Eyeshadow,200,400,200,1,00005,India
820623,2023-07-23,1001,Lipstick,150,300,150,1,00475,India
820623,2023-07-23,1003,Foundation,300,600,300,1,00475,India
142728,2023-07-23,1005,Nail Polish,50,100,50,1,00362,India
142728,2023-07-23,1009,Moisturizer,250,500,250,1,00362,India
596687,2023-07-23,1006,Blush,150,300,150,1,00044,India
461085,2023-07-23,1009,Moisturizer,250,500,250,1,00159,India
461085,2023-07-23,1006,Blush,150,300,150,1,00159,India
342731,2023-07-23,1004,Eyeliner,100,200,100,1,00106,India
342731,2023-07-23,1003,Foundation,300,600,300,1,00106,India
342731,2023-07-23,1006,Blush,150,300,150,1,00106,India
342731,2023-07-23,1005,Nail Polish,50,100,50,1,00106,India
929208,2023-07-23,1008,Makeup Remover,80,160,80,1,00231,India
929208,2023-07-23,1006,Blush,150,300,150,1,00231,India
929208,2023-07-23,1002,Mascara,200,400,200,1,00231,India
894626,2023-07-23,1001,Lipstick,150,300,150,1,00226,India
894626,2023-07-23,1006,Blush,150,300,150,1,00226,India
894626,2023-07-23,1004,Eyeliner,100,200,100,1,00226,India
894626,2023-07-23,1002,Mascara,200,400,200,1,00226,India
264949,2023-07-23,1012,Body Lotion,200,400,200,1,00024,India
318553,2023-07-23,1001,Lipstick,150,300,150,1,00436,India
117984,2023-07-23,1005,Nail Polish,50,100,50,1,00213,India
117984,2023-07-23,1004,Eyeliner,100,200,100,1,00213,India
117984,2023-07-23,1003,Foundation,300,600,300,1,00213,India
468774,2023-07-23,1006,Blush,150,300,150,1,00431,India
468774,2023-07-23,1002,Mascara,200,400,200,1,00431,India
468774,2023-07-23,1003,Foundation,300,600,300,1,00431,India
194998,2023-07-23,1003,Foundation,300,600,300,1,00129,India
194998,2023-07-23,1012,Body Lotion,200,400,200,1,00129,India
194998,2023-07-23,1005,Nail Polish,50,100,50,1,00129,India
194998,2023-07-23,1009,Moisturizer,250,500,250,1,00129,India
194998,2023-07-23,1001,Lipstick,150,300,150,1,00129,India
441148,2023-07-23,1008,Makeup Remover,80,160,80,1,00305,India
441148,2023-07-23,1001,Lipstick,150,300,150,1,00305,India
441148,2023-07-23,1012,Body Lotion,200,400,200,1,00305,India
441148,2023-07-23,1005,Nail Polish,50,100,50,1,00305,India
441148,2023-07-23,1003,Foundation,300,600,300,1,00305,India
762536,2023-07-23,1006,Blush,150,300,150,1,00373,India
762536,2023-07-23,1009,Moisturizer,250,500,250,1,00373,India
762536,2023-07-23,1007,Eyeshadow,200,400,200,1,00373,India
762536,2023-07-23,1003,Foundation,300,600,300,1,00373,India
335529,2023-07-23,1005,Nail Polish,50,100,50,1,00475,India
335529,2023-07-23,1008,Makeup Remover,80,160,80,1,00475,India
335529,2023-07-23,1007,Eyeshadow,200,400,200,1,00475,India
335529,2023-07-23,1006,Blush,150,300,150,1,00475,India
335529,2023-07-23,1009,Moisturizer,250,500,250,1,00475,India
504290,2023-07-23,1002,Mascara,200,400,200,1,00426,India
504290,2023-07-23,1001,Lipstick,150,300,150,1,00426,India
231255,2023-07-23,1008,Makeup Remover,80,160,80,1,00151,India
791796,2023-07-23,1001,Lipstick,150,300,150,1,00422,India
791796,2023-07-23,1003,Foundation,300,600,300,1,00422,India
791796,2023-07-23,1002,Mascara,200,400,200,1,00422,India
572979,2023-07-23,1004,Eyeliner,100,200,100,1,00003,India
572979,2023-07-23,1012,Body Lotion,200,400,200,1,00003,India
127751,2023-07-23,1001,Lipstick,150,300,150,1,00177,India
127751,2023-07-23,1012,Body Lotion,200,400,200,1,00177,India
654028,2023-07-23,1007,Eyeshadow,200,400,200,1,00487,India
654028,2023-07-23,1003,Foundation,300,600,300,1,00487,India
731051,2023-07-23,1007,Eyeshadow,200,400,200,1,00383,India
731051,2023-07-23,1012,Body Lotion,200,400,200,1,00383,India
731051,2023-07-23,1005,Nail Polish,50,100,50,1,00383,India
711701,2023-07-23,1001,Lipstick,150,300,150,1,00360,India
551765,2023-07-23,1001,Lipstick,150,300,150,1,00027,India
551765,2023-07-23,1004,Eyeliner,100,200,100,1,00027,India
551765,2023-07-23,1008,Makeup Remover,80,160,80,1,00027,India
551765,2023-07-23,1012,Body Lotion,200,400,200,1,00027,India
551765,2023-07-23,1005,Nail Polish,50,100,50,1,00027,India
290815,2023-07-23,1006,Blush,150,300,150,1,00049,India
290815,2023-07-23,1012,Body Lotion,200,400,200,1,00049,India
290815,2023-07-23,1003,Foundation,300,600,300,1,00049,India
290815,2023-07-23,1004,Eyeliner,100,200,100,1,00049,India
835163,2023-07-23,1004,Eyeliner,100,200,100,1,00314,India
835163,2023-07-23,1005,Nail Polish,50,100,50,1,00314,India
513846,2023-07-23,1001,Lipstick,150,300,150,1,00103,India
513846,2023-07-23,1002,Mascara,200,400,200,1,00103,India
635198,2023-07-23,1006,Blush,150,300,150,1,00431,India
635198,2023-07-23,1009,Moisturizer,250,500,250,1,00431,India
635198,2023-07-23,1002,Mascara,200,400,200,1,00431,India
626339,2023-07-23,1012,Body Lotion,200,400,200,1,00347,India
626339,2023-07-23,1008,Makeup Remover,80,160,80,1,00347,India
569330,2023-07-23,1009,Moisturizer,250,500,250,1,00132,India
569330,2023-07-23,1001,Lipstick,150,300,150,1,00132,India
569330,2023-07-23,1004,Eyeliner,100,200,100,1,00132,India
972950,2023-07-23,1003,Foundation,300,600,300,1,00250,India
972950,2023-07-23,1008,Makeup Remover,80,160,80,1,00250,India
972950,2023-07-23,1005,Nail Polish,50,100,50,1,00250,India
697256,2023-07-23,1003,Foundation,300,600,300,1,00275,India
697256,2023-07-23,1007,Eyeshadow,200,400,200,1,00275,India
697256,2023-07-23,1006,Blush,150,300,150,1,00275,India
697256,2023-07-23,1008,Makeup Remover,80,160,80,1,00275,India
697256,2023-07-23,1009,Moisturizer,250,500,250,1,00275,India
886151,2023-07-24,1005,Nail Polish,50,100,50,1,00033,India
886151,2023-07-24,1001,Lipstick,150,300,150,1,00033,India
886151,2023-07-24,1004,Eyeliner,100,200,100,1,00033,India
439346,2023-07-24,1006,Blush,150,300,150,1,00373,India
439346,2023-07-24,1002,Mascara,200,400,200,1,00373,India
439346,2023-07-24,1003,Foundation,300,600,300,1,00373,India
594450,2023-07-24,1012,Body Lotion,200,400,200,1,00051,India
594450,2023-07-24,1008,Makeup Remover,80,160,80,1,00051,India
683225,2023-07-24,1012,Body Lotion,200,400,200,1,00221,India
902423,2023-07-24,1005,Nail Polish,50,100,50,1,00261,India
902423,2023-07-24,1002,Mascara,200,400,200,1,00261,India
756446,2023-07-24,1008,Makeup Remover,80,160,80,1,00135,India
103616,2023-07-24,1001,Lipstick,150,300,150,1,00488,India
103616,2023-07-24,1009,Moisturizer,250,500,250,1,00488,India
103616,2023-07-24,1008,Makeup Remover,80,160,80,1,00488,India
103616,2023-07-24,1006,Blush,150,300,150,1,00488,India
435389,2023-07-24,1004,Eyeliner,100,200,100,1,00324,India
435389,2023-07-24,1007,Eyeshadow,200,400,200,1,00324,India
770167,2023-07-24,1002,Mascara,200,400,200,1,00242,India
770167,2023-07-24,1001,Lipstick,150,300,150,1,00242,India
770167,2023-07-24,1008,Makeup Remover,80,160,80,1,00242,India
770167,2023-07-24,1006,Blush,150,300,150,1,00242,India
270165,2023-07-24,1012,Body Lotion,200,400,200,1,00380,India
270165,2023-07-24,1007,Eyeshadow,200,400,200,1,00380,India
270165,2023-07-24,1002,Mascara,200,400,200,1,00380,India
270165,2023-07-24,1009,Moisturizer,250,500,250,1,00380,India
132729,2023-07-24,1001,Lipstick,150,300,150,1,00110,India
664708,2023-07-24,1006,Blush,150,300,150,1,00474,India
664708,2023-07-24,1009,Moisturizer,250,500,250,1,00474,India
664708,2023-07-24,1007,Eyeshadow,200,400,200,1,00474,India
779736,2023-07-24,1012,Body Lotion,200,400,200,1,00262,India
779736,2023-07-24,1001,Lipstick,150,300,150,1,00262,India
263108,2023-07-24,1002,Mascara,200,400,200,1,00125,India
263108,2023-07-24,1003,Foundation,300,600,300,1,00125,India
263108,2023-07-24,1004,Eyeliner,100,200,100,1,00125,India
781283,2023-07-24,1012,Body Lotion,200,400,200,1,00138,India
781283,2023-07-24,1005,Nail Polish,50,100,50,1,00138,India
781283,2023-07-24,1003,Foundation,300,600,300,1,00138,India
751751,2023-07-24,1007,Eyeshadow,200,400,200,1,00156,India
751751,2023-07-24,1003,Foundation,300,600,300,1,00156,India
651345,2023-07-24,1007,Eyeshadow,200,400,200,1,00426,India
417446,2023-07-24,1005,Nail Polish,50,100,50,1,00164,India
417446,2023-07-24,1003,Foundation,300,600,300,1,00164,India
417446,2023-07-24,1012,Body Lotion,200,400,200,1,00164,India
807487,2023-07-24,1009,Moisturizer,250,500,250,1,00284,India
807487,2023-07-24,1002,Mascara,200,400,200,1,00284,India
807487,2023-07-24,1008,Makeup Remover,80,160,80,1,00284,India
807487,2023-07-24,1005,Nail Polish,50,100,50,1,00284,India
522384,2023-07-24,1004,Eyeliner,100,200,100,1,00460,India
522384,2023-07-24,1006,Blush,150,300,150,1,00460,India
522384,2023-07-24,1003,Foundation,300,600,300,1,00460,India
689832,2023-07-24,1002,Mascara,200,400,200,1,00178,India
206647,2023-07-24,1004,Eyeliner,100,200,100,1,00206,India
206647,2023-07-24,1008,Makeup Remover,80,160,80,1,00206,India
564923,2023-07-24,1004,Eyeliner,100,200,100,1,00481,India
564923,2023-07-24,1001,Lipstick,150,300,150,1,00481,India
564923,2023-07-24,1006,Blush,150,300,150,1,00481,India
776947,2023-07-24,1006,Blush,150,300,150,1,00342,India
776947,2023-07-24,1003,Foundation,300,600,300,1,00342,India
887029,2023-07-24,1006,Blush,150,300,150,1,00207,India
887029,2023-07-24,1007,Eyeshadow,200,400,200,1,00207,India
887029,2023-07-24,1004,Eyeliner,100,200,100,1,00207,India
887029,2023-07-24,1001,Lipstick,150,300,150,1,00207,India
887029,2023-07-24,1008,Makeup Remover,80,160,80,1,00207,India
501916,2023-07-24,1001,Lipstick,150,300,150,1,00291,India
501916,2023-07-24,1005,Nail Polish,50,100,50,1,00291,India
501916,2023-07-24,1006,Blush,150,300,150,1,00291,India
229747,2023-07-24,1001,Lipstick,150,300,150,1,00288,India
229747,2023-07-24,1007,Eyeshadow,200,400,200,1,00288,India
229747,2023-07-24,1005,Nail Polish,50,100,50,1,00288,India
941265,2023-07-24,1001,Lipstick,150,300,150,1,00484,India
941265,2023-07-24,1006,Blush,150,300,150,1,00484,India
941265,2023-07-24,1007,Eyeshadow,200,400,200,1,00484,India
941265,2023-07-24,1005,Nail Polish,50,100,50,1,00484,India
295345,2023-07-24,1004,Eyeliner,100,200,100,1,00159,India
295345,2023-07-24,1002,Mascara,200,400,200,1,00159,India
295345,2023-07-24,1008,Makeup Remover,80,160,80,1,00159,India
611605,2023-07-24,1009,Moisturizer,250,500,250,1,00313,India
611605,2023-07-24,1003,Foundation,300,600,300,1,00313,India
611605,2023-07-24,1012,Body Lotion,200,400,200,1,00313,India
904219,2023-07-24,1007,Eyeshadow,200,400,200,1,00314,India
904219,2023-07-24,1005,Nail Polish,50,100,50,1,00314,India
904219,2023-07-24,1003,Foundation,300,600,300,1,00314,India
311502,2023-07-25,1012,Body Lotion,200,400,200,1,00491,India
311502,2023-07-25,1006,Blush,150,300,150,1,00491,India
311502,2023-07-25,1008,Makeup Remover,80,160,80,1,00491,India
230273,2023-07-25,1009,Moisturizer,250,500,250,1,00245,India
679821,2023-07-25,1006,Blush,150,300,150,1,00286,India
679821,2023-07-25,1002,Mascara,200,400,200,1,00286,India
679821,2023-07-25,1005,Nail Polish,50,100,50,1,00286,India
932676,2023-07-25,1003,Foundation,300,600,300,1,00191,India
685824,2023-07-25,1009,Moisturizer,250,500,250,1,00364,India
610780,2023-07-25,1001,Lipstick,150,300,150,1,00232,India
610780,2023-07-25,1007,Eyeshadow,200,400,200,1,00232,India
343003,2023-07-25,1004,Eyeliner,100,200,100,1,00042,India
343003,2023-07-25,1002,Mascara,200,400,200,1,00042,India
343003,2023-07-25,1009,Moisturizer,250,500,250,1,00042,India
343003,2023-07-25,1006,Blush,150,300,150,1,00042,India
857110,2023-07-25,1004,Eyeliner,100,200,100,1,00032,India
857110,2023-07-25,1006,Blush,150,300,150,1,00032,India
889604,2023-07-25,1003,Foundation,300,600,300,1,00478,India
889604,2023-07-25,1001,Lipstick,150,300,150,1,00478,India
499409,2023-07-25,1001,Lipstick,150,300,150,1,00023,India
499409,2023-07-25,1008,Makeup Remover,80,160,80,1,00023,India
499409,2023-07-25,1005,Nail Polish,50,100,50,1,00023,India
499409,2023-07-25,1007,Eyeshadow,200,400,200,1,00023,India
515826,2023-07-25,1009,Moisturizer,250,500,250,1,00348,India
515826,2023-07-25,1007,Eyeshadow,200,400,200,1,00348,India
515826,2023-07-25,1012,Body Lotion,200,400,200,1,00348,India
630262,2023-07-25,1004,Eyeliner,100,200,100,1,00027,India
630262,2023-07-25,1006,Blush,150,300,150,1,00027,India
630262,2023-07-25,1012,Body Lotion,200,400,200,1,00027,India
630262,2023-07-25,1002,Mascara,200,400,200,1,00027,India
232397,2023-07-25,1006,Blush,150,300,150,1,00003,India
232397,2023-07-25,1005,Nail Polish,50,100,50,1,00003,India
330299,2023-07-25,1004,Eyeliner,100,200,100,1,00032,India
330299,2023-07-25,1003,Foundation,300,600,300,1,00032,India
330299,2023-07-25,1002,Mascara,200,400,200,1,00032,India
183941,2023-07-25,1002,Mascara,200,400,200,1,00118,India
183941,2023-07-25,1004,Eyeliner,100,200,100,1,00118,India
183941,2023-07-25,1005,Nail Polish,50,100,50,1,00118,India
183941,2023-07-25,1012,Body Lotion,200,400,200,1,00118,India
227904,2023-07-25,1001,Lipstick,150,300,150,1,00151,India
227904,2023-07-25,1005,Nail Polish,50,100,50,1,00151,India
227904,2023-07-25,1003,Foundation,300,600,300,1,00151,India
299535,2023-07-25,1007,Eyeshadow,200,400,200,1,00015,India
299535,2023-07-25,1006,Blush,150,300,150,1,00015,India
930692,2023-07-25,1009,Moisturizer,250,500,250,1,00477,India
930692,2023-07-25,1012,Body Lotion,200,400,200,1,00477,India
144020,2023-07-25,1001,Lipstick,150,300,150,1,00076,India
144020,2023-07-25,1007,Eyeshadow,200,400,200,1,00076,India
589245,2023-07-25,1004,Eyeliner,100,200,100,1,00138,India
379207,2023-07-25,1001,Lipstick,150,300,150,1,00037,India
379207,2023-07-25,1007,Eyeshadow,200,400,200,1,00037,India
379207,2023-07-25,1006,Blush,150,300,150,1,00037,India
379207,2023-07-25,1005,Nail Polish,50,100,50,1,00037,India
379207,2023-07-25,1008,Makeup Remover,80,160,80,1,00037,India
267316,2023-07-25,1002,Mascara,200,400,200,1,00213,India
790264,2023-07-25,1006,Blush,150,300,150,1,00403,India
790264,2023-07-25,1003,Foundation,300,600,300,1,00403,India
591298,2023-07-25,1004,Eyeliner,100,200,100,1,00177,India
591298,2023-07-25,1001,Lipstick,150,300,150,1,00177,India
591298,2023-07-25,1009,Moisturizer,250,500,250,1,00177,India
591298,2023-07-25,1005,Nail Polish,50,100,50,1,00177,India
893098,2023-07-25,1007,Eyeshadow,200,400,200,1,00011,India
893098,2023-07-25,1006,Blush,150,300,150,1,00011,India
893098,2023-07-25,1012,Body Lotion,200,400,200,1,00011,India
893098,2023-07-25,1001,Lipstick,150,300,150,1,00011,India
153507,2023-07-25,1012,Body Lotion,200,400,200,1,00494,India
153507,2023-07-25,1002,Mascara,200,400,200,1,00494,India
466885,2023-07-25,1005,Nail Polish,50,100,50,1,00107,India
466885,2023-07-25,1006,Blush,150,300,150,1,00107,India
466885,2023-07-25,1003,Foundation,300,600,300,1,00107,India
466885,2023-07-25,1007,Eyeshadow,200,400,200,1,00107,India
466885,2023-07-25,1004,Eyeliner,100,200,100,1,00107,India
443563,2023-07-25,1009,Moisturizer,250,500,250,1,00009,India
443563,2023-07-25,1001,Lipstick,150,300,150,1,00009,India
980836,2023-07-25,1009,Moisturizer,250,500,250,1,00487,India
980836,2023-07-25,1005,Nail Polish,50,100,50,1,00487,India
980836,2023-07-25,1012,Body Lotion,200,400,200,1,00487,India
316917,2023-07-25,1005,Nail Polish,50,100,50,1,00343,India
316917,2023-07-25,1001,Lipstick,150,300,150,1,00343,India
316917,2023-07-25,1012,Body Lotion,200,400,200,1,00343,India
316917,2023-07-25,1006,Blush,150,300,150,1,00343,India
316917,2023-07-25,1004,Eyeliner,100,200,100,1,00343,India
141991,2023-07-25,1007,Eyeshadow,200,400,200,1,00500,India
141991,2023-07-25,1001,Lipstick,150,300,150,1,00500,India
847773,2023-07-25,1004,Eyeliner,100,200,100,1,00324,India
847773,2023-07-25,1012,Body Lotion,200,400,200,1,00324,India
847773,2023-07-25,1009,Moisturizer,250,500,250,1,00324,India
847773,2023-07-25,1006,Blush,150,300,150,1,00324,India
454151,2023-07-25,1006,Blush,150,300,150,1,00103,India
223525,2023-07-25,1008,Makeup Remover,80,160,80,1,00135,India
223525,2023-07-25,1005,Nail Polish,50,100,50,1,00135,India
485297,2023-07-25,1006,Blush,150,300,150,1,00038,India
485297,2023-07-25,1003,Foundation,300,600,300,1,00038,India
485297,2023-07-25,1004,Eyeliner,100,200,100,1,00038,India
620147,2023-07-25,1007,Eyeshadow,200,400,200,1,00373,India
620147,2023-07-25,1002,Mascara,200,400,200,1,00373,India
620147,2023-07-25,1009,Moisturizer,250,500,250,1,00373,India
620147,2023-07-25,1012,Body Lotion,200,400,200,1,00373,India
300062,2023-07-25,1009,Moisturizer,250,500,250,1,00116,India
300062,2023-07-25,1008,Makeup Remover,80,160,80,1,00116,India
953196,2023-07-25,1005,Nail Polish,50,100,50,1,00102,India
874354,2023-07-25,1001,Lipstick,150,300,150,1,00072,India
874354,2023-07-25,1003,Foundation,300,600,300,1,00072,India
466521,2023-07-25,1008,Makeup Remover,80,160,80,1,00371,India
466521,2023-07-25,1005,Nail Polish,50,100,50,1,00371,India
466521,2023-07-25,1002,Mascara,200,400,200,1,00371,India
270273,2023-07-25,1006,Blush,150,300,150,1,00400,India
270273,2023-07-25,1001,Lipstick,150,300,150,1,00400,India
270273,2023-07-25,1005,Nail Polish,50,100,50,1,00400,India
270273,2023-07-25,1012,Body Lotion,200,400,200,1,00400,India
287270,2023-07-25,1007,Eyeshadow,200,400,200,1,00277,India
287270,2023-07-25,1006,Blush,150,300,150,1,00277,India
287270,2023-07-25,1005,Nail Polish,50,100,50,1,00277,India
287270,2023-07-25,1012,Body Lotion,200,400,200,1,00277,India
502844,2023-07-25,1009,Moisturizer,250,500,250,1,00080,India
502844,2023-07-25,1001,Lipstick,150,300,150,1,00080,India
502844,2023-07-25,1012,Body Lotion,200,400,200,1,00080,India
502844,2023-07-25,1003,Foundation,300,600,300,1,00080,India
931214,2023-07-26,1004,Eyeliner,100,200,100,1,00181,India
663218,2023-07-26,1002,Mascara,200,400,200,1,00276,India
663218,2023-07-26,1004,Eyeliner,100,200,100,1,00276,India
663218,2023-07-26,1005,Nail Polish,50,100,50,1,00276,India
144469,2023-07-26,1012,Body Lotion,200,400,200,1,00257,India
144469,2023-07-26,1006,Blush,150,300,150,1,00257,India
450026,2023-07-26,1007,Eyeshadow,200,400,200,1,00022,India
450026,2023-07-26,1004,Eyeliner,100,200,100,1,00022,India
450026,2023-07-26,1002,Mascara,200,400,200,1,00022,India
586191,2023-07-26,1012,Body Lotion,200,400,200,1,00359,India
586191,2023-07-26,1003,Foundation,300,600,300,1,00359,India
586191,2023-07-26,1004,Eyeliner,100,200,100,1,00359,India
661033,2023-07-26,1007,Eyeshadow,200,400,200,1,00363,India
661033,2023-07-26,1006,Blush,150,300,150,1,00363,India
661033,2023-07-26,1005,Nail Polish,50,100,50,1,00363,India
797446,2023-07-26,1004,Eyeliner,100,200,100,1,00384,India
459187,2023-07-26,1012,Body Lotion,200,400,200,1,00276,India
837006,2023-07-26,1007,Eyeshadow,200,400,200,1,00172,India
837006,2023-07-26,1003,Foundation,300,600,300,1,00172,India
837006,2023-07-26,1012,Body Lotion,200,400,200,1,00172,India
837006,2023-07-26,1009,Moisturizer,250,500,250,1,00172,India
572539,2023-07-26,1008,Makeup Remover,80,160,80,1,00417,India
569186,2023-07-26,1012,Body Lotion,200,400,200,1,00204,India
569186,2023-07-26,1004,Eyeliner,100,200,100,1,00204,India
569186,2023-07-26,1003,Foundation,300,600,300,1,00204,India
569186,2023-07-26,1002,Mascara,200,400,200,1,00204,India
677698,2023-07-26,1005,Nail Polish,50,100,50,1,00152,India
677698,2023-07-26,1006,Blush,150,300,150,1,00152,India
915918,2023-07-26,1007,Eyeshadow,200,400,200,1,00458,India
915918,2023-07-26,1003,Foundation,300,600,300,1,00458,India
647209,2023-07-26,1008,Makeup Remover,80,160,80,1,00102,India
647209,2023-07-26,1007,Eyeshadow,200,400,200,1,00102,India
647209,2023-07-26,1006,Blush,150,300,150,1,00102,India
795037,2023-07-26,1012,Body Lotion,200,400,200,1,00398,India
795037,2023-07-26,1005,Nail Polish,50,100,50,1,00398,India
795037,2023-07-26,1002,Mascara,200,400,200,1,00398,India
104330,2023-07-26,1003,Foundation,300,600,300,1,00352,India
104330,2023-07-26,1002,Mascara,200,400,200,1,00352,India
507956,2023-07-26,1009,Moisturizer,250,500,250,1,00298,India
507956,2023-07-26,1006,Blush,150,300,150,1,00298,India
507956,2023-07-26,1002,Mascara,200,400,200,1,00298,India
507956,2023-07-26,1008,Makeup Remover,80,160,80,1,00298,India
881639,2023-07-26,1005,Nail Polish,50,100,50,1,00322,India
881639,2023-07-26,1001,Lipstick,150,300,150,1,00322,India
881639,2023-07-26,1009,Moisturizer,250,500,250,1,00322,India
971842,2023-07-26,1005,Nail Polish,50,100,50,1,00323,India
971842,2023-07-26,1007,Eyeshadow,200,400,200,1,00323,India
971842,2023-07-26,1008,Makeup Remover,80,160,80,1,00323,India
131327,2023-07-26,1005,Nail Polish,50,100,50,1,00353,India
131327,2023-07-26,1007,Eyeshadow,200,400,200,1,00353,India
131327,2023-07-26,1003,Foundation,300,600,300,1,00353,India
131327,2023-07-26,1002,Mascara,200,400,200,1,00353,India
319566,2023-07-26,1008,Makeup Remover,80,160,80,1,00246,India
319566,2023-07-26,1007,Eyeshadow,200,400,200,1,00246,India
528590,2023-07-26,1008,Makeup Remover,80,160,80,1,00244,India
528590,2023-07-26,1012,Body Lotion,200,400,200,1,00244,India
528590,2023-07-26,1002,Mascara,200,400,200,1,00244,India
473154,2023-07-26,1009,Moisturizer,250,500,250,1,00164,India
473154,2023-07-26,1001,Lipstick,150,300,150,1,00164,India
473154,2023-07-26,1003,Foundation,300,600,300,1,00164,India
569882,2023-07-26,1012,Body Lotion,200,400,200,1,00475,India
948592,2023-07-26,1005,Nail Polish,50,100,50,1,00003,India
948592,2023-07-26,1006,Blush,150,300,150,1,00003,India
944882,2023-07-26,1003,Foundation,300,600,300,1,00455,India
944882,2023-07-26,1007,Eyeshadow,200,400,200,1,00455,India
944882,2023-07-26,1002,Mascara,200,400,200,1,00455,India
944882,2023-07-26,1012,Body Lotion,200,400,200,1,00455,India
368062,2023-07-26,1008,Makeup Remover,80,160,80,1,00342,India
476618,2023-07-26,1009,Moisturizer,250,500,250,1,00242,India
605830,2023-07-26,1005,Nail Polish,50,100,50,1,00279,India
605830,2023-07-26,1003,Foundation,300,600,300,1,00279,India
605830,2023-07-26,1002,Mascara,200,400,200,1,00279,India
605830,2023-07-26,1007,Eyeshadow,200,400,200,1,00279,India
837815,2023-07-26,1009,Moisturizer,250,500,250,1,00447,India
837815,2023-07-26,1004,Eyeliner,100,200,100,1,00447,India
537057,2023-07-26,1004,Eyeliner,100,200,100,1,00362,India
537057,2023-07-26,1009,Moisturizer,250,500,250,1,00362,India
537057,2023-07-26,1008,Makeup Remover,80,160,80,1,00362,India
537057,2023-07-26,1002,Mascara,200,400,200,1,00362,India
537057,2023-07-26,1012,Body Lotion,200,400,200,1,00362,India
946969,2023-07-26,1006,Blush,150,300,150,1,00184,India
946969,2023-07-26,1004,Eyeliner,100,200,100,1,00184,India
946969,2023-07-26,1002,Mascara,200,400,200,1,00184,India
901239,2023-07-26,1006,Blush,150,300,150,1,00411,India
901239,2023-07-26,1005,Nail Polish,50,100,50,1,00411,India
901239,2023-07-26,1008,Makeup Remover,80,160,80,1,00411,India
901239,2023-07-26,1001,Lipstick,150,300,150,1,00411,India
476148,2023-07-26,1002,Mascara,200,400,200,1,00385,India
355782,2023-07-26,1003,Foundation,300,600,300,1,00006,India
318928,2023-07-26,1004,Eyeliner,100,200,100,1,00227,India
318928,2023-07-26,1001,Lipstick,150,300,150,1,00227,India
318928,2023-07-26,1006,Blush,150,300,150,1,00227,India
877388,2023-07-26,1003,Foundation,300,600,300,1,00313,India
877388,2023-07-26,1005,Nail Polish,50,100,50,1,00313,India
877388,2023-07-26,1001,Lipstick,150,300,150,1,00313,India
136445,2023-07-26,1008,Makeup Remover,80,160,80,1,00088,India
136445,2023-07-26,1001,Lipstick,150,300,150,1,00088,India
977996,2023-07-26,1004,Eyeliner,100,200,100,1,00013,India
977996,2023-07-26,1001,Lipstick,150,300,150,1,00013,India
977996,2023-07-26,1003,Foundation,300,600,300,1,00013,India
521331,2023-07-26,1003,Foundation,300,600,300,1,00496,India
521331,2023-07-26,1002,Mascara,200,400,200,1,00496,India
521331,2023-07-26,1005,Nail Polish,50,100,50,1,00496,India
521331,2023-07-26,1007,Eyeshadow,200,400,200,1,00496,India
521331,2023-07-26,1009,Moisturizer,250,500,250,1,00496,India
756917,2023-07-27,1006,Blush,150,300,150,1,00023,India
281713,2023-07-27,1004,Eyeliner,100,200,100,1,00353,India
520613,2023-07-27,1002,Mascara,200,400,200,1,00458,India
520613,2023-07-27,1009,Moisturizer,250,500,250,1,00458,India
646670,2023-07-27,1001,Lipstick,150,300,150,1,00135,India
858636,2023-07-27,1001,Lipstick,150,300,150,1,00216,India
858636,2023-07-27,1003,Foundation,300,600,300,1,00216,India
858636,2023-07-27,1012,Body Lotion,200,400,200,1,00216,India
822160,2023-07-27,1008,Makeup Remover,80,160,80,1,00143,India
822543,2023-07-27,1007,Eyeshadow,200,400,200,1,00019,India
822543,2023-07-27,1002,Mascara,200,400,200,1,00019,India
299133,2023-07-27,1003,Foundation,300,600,300,1,00247,India
299133,2023-07-27,1007,Eyeshadow,200,400,200,1,00247,India
722425,2023-07-27,1012,Body Lotion,200,400,200,1,00499,India
722425,2023-07-27,1006,Blush,150,300,150,1,00499,India
722425,2023-07-27,1008,Makeup Remover,80,160,80,1,00499,India
722425,2023-07-27,1004,Eyeliner,100,200,100,1,00499,India
722425,2023-07-27,1002,Mascara,200,400,200,1,00499,India
286558,2023-07-27,1005,Nail Polish,50,100,50,1,00162,India
549323,2023-07-27,1003,Foundation,300,600,300,1,00017,India
549323,2023-07-27,1009,Moisturizer,250,500,250,1,00017,India
965444,2023-07-27,1001,Lipstick,150,300,150,1,00156,India
965444,2023-07-27,1007,Eyeshadow,200,400,200,1,00156,India
965444,2023-07-27,1002,Mascara,200,400,200,1,00156,India
792757,2023-07-27,1008,Makeup Remover,80,160,80,1,00493,India
792757,2023-07-27,1005,Nail Polish,50,100,50,1,00493,India
792757,2023-07-27,1002,Mascara,200,400,200,1,00493,India
792757,2023-07-27,1003,Foundation,300,600,300,1,00493,India
818415,2023-07-27,1004,Eyeliner,100,200,100,1,00121,India
818415,2023-07-27,1002,Mascara,200,400,200,1,00121,India
818415,2023-07-27,1001,Lipstick,150,300,150,1,00121,India
119695,2023-07-27,1003,Foundation,300,600,300,1,00408,India
119695,2023-07-27,1007,Eyeshadow,200,400,200,1,00408,India
119695,2023-07-27,1004,Eyeliner,100,200,100,1,00408,India
119695,2023-07-27,1001,Lipstick,150,300,150,1,00408,India
561804,2023-07-27,1005,Nail Polish,50,100,50,1,00349,India
561804,2023-07-27,1006,Blush,150,300,150,1,00349,India
920255,2023-07-27,1007,Eyeshadow,200,400,200,1,00194,India
729194,2023-07-27,1009,Moisturizer,250,500,250,1,00120,India
729194,2023-07-27,1006,Blush,150,300,150,1,00120,India
571343,2023-07-27,1012,Body Lotion,200,400,200,1,00175,India
407052,2023-07-27,1003,Foundation,300,600,300,1,00315,India
407052,2023-07-27,1001,Lipstick,150,300,150,1,00315,India
407052,2023-07-27,1006,Blush,150,300,150,1,00315,India
876023,2023-07-27,1008,Makeup Remover,80,160,80,1,00046,India
526601,2023-07-27,1006,Blush,150,300,150,1,00127,India
526601,2023-07-27,1012,Body Lotion,200,400,200,1,00127,India
526601,2023-07-27,1008,Makeup Remover,80,160,80,1,00127,India
526601,2023-07-27,1001,Lipstick,150,300,150,1,00127,India
237892,2023-07-27,1004,Eyeliner,100,200,100,1,00252,India
237892,2023-07-27,1012,Body Lotion,200,400,200,1,00252,India
721937,2023-07-27,1003,Foundation,300,600,300,1,00143,India
721937,2023-07-27,1007,Eyeshadow,200,400,200,1,00143,India
264134,2023-07-27,1001,Lipstick,150,300,150,1,00318,India
264134,2023-07-27,1008,Makeup Remover,80,160,80,1,00318,India
264134,2023-07-27,1009,Moisturizer,250,500,250,1,00318,India
264134,2023-07-27,1012,Body Lotion,200,400,200,1,00318,India
126100,2023-07-27,1004,Eyeliner,100,200,100,1,00038,India
126100,2023-07-27,1008,Makeup Remover,80,160,80,1,00038,India
126100,2023-07-27,1007,Eyeshadow,200,400,200,1,00038,India
181140,2023-07-27,1002,Mascara,200,400,200,1,00414,India
181140,2023-07-27,1005,Nail Polish,50,100,50,1,00414,India
181140,2023-07-27,1008,Makeup Remover,80,160,80,1,00414,India
659519,2023-07-27,1003,Foundation,300,600,300,1,00180,India
659519,2023-07-27,1012,Body Lotion,200,400,200,1,00180,India
954351,2023-07-27,1005,Nail Polish,50,100,50,1,00094,India
954351,2023-07-27,1007,Eyeshadow,200,400,200,1,00094,India
948080,2023-07-27,1009,Moisturizer,250,500,250,1,00437,India
948080,2023-07-27,1001,Lipstick,150,300,150,1,00437,India
948080,2023-07-27,1004,Eyeliner,100,200,100,1,00437,India
443059,2023-07-27,1002,Mascara,200,400,200,1,00032,India
443059,2023-07-27,1006,Blush,150,300,150,1,00032,India
938121,2023-07-27,1012,Body Lotion,200,400,200,1,00100,India
938121,2023-07-27,1007,Eyeshadow,200,400,200,1,00100,India
938121,2023-07-27,1003,Foundation,300,600,300,1,00100,India
591710,2023-07-27,1005,Nail Polish,50,100,50,1,00121,India
591710,2023-07-27,1009,Moisturizer,250,500,250,1,00121,India
591710,2023-07-27,1004,Eyeliner,100,200,100,1,00121,India
591710,2023-07-27,1006,Blush,150,300,150,1,00121,India
384816,2023-07-27,1012,Body Lotion,200,400,200,1,00094,India
384816,2023-07-27,1005,Nail Polish,50,100,50,1,00094,India
384816,2023-07-27,1008,Makeup Remover,80,160,80,1,00094,India
674689,2023-07-27,1008,Makeup Remover,80,160,80,1,00442,India
530148,2023-07-27,1008,Makeup Remover,80,160,80,1,00486,India
530148,2023-07-27,1004,Eyeliner,100,200,100,1,00486,India
530148,2023-07-27,1009,Moisturizer,250,500,250,1,00486,India
530148,2023-07-27,1003,Foundation,300,600,300,1,00486,India
269372,2023-07-27,1002,Mascara,200,400,200,1,00245,India
269372,2023-07-27,1009,Moisturizer,250,500,250,1,00245,India
870896,2023-07-27,1012,Body Lotion,200,400,200,1,00397,India
870896,2023-07-27,1008,Makeup Remover,80,160,80,1,00397,India
870896,2023-07-27,1003,Foundation,300,600,300,1,00397,India
870896,2023-07-27,1002,Mascara,200,400,200,1,00397,India
870896,2023-07-27,1006,Blush,150,300,150,1,00397,India
402804,2023-07-27,1008,Makeup Remover,80,160,80,1,00227,India
402804,2023-07-27,1004,Eyeliner,100,200,100,1,00227,India
402804,2023-07-27,1007,Eyeshadow,200,400,200,1,00227,India
402804,2023-07-27,1012,Body Lotion,200,400,200,1,00227,India
873617,2023-07-27,1006,Blush,150,300,150,1,00404,India
873617,2023-07-27,1007,Eyeshadow,200,400,200,1,00404,India
872926,2023-07-27,1002,Mascara,200,400,200,1,00375,India
948969,2023-07-27,1006,Blush,150,300,150,1,00488,India
948969,2023-07-27,1002,Mascara,200,400,200,1,00488,India
948969,2023-07-27,1008,Makeup Remover,80,160,80,1,00488,India
948969,2023-07-27,1007,Eyeshadow,200,400,200,1,00488,India
948969,2023-07-27,1005,Nail Polish,50,100,50,1,00488,India
332868,2023-07-27,1007,Eyeshadow,200,400,200,1,00168,India
332868,2023-07-27,1006,Blush,150,300,150,1,00168,India
332868,2023-07-27,1001,Lipstick,150,300,150,1,00168,India
380909,2023-07-27,1008,Makeup Remover,80,160,80,1,00187,India
380909,2023-07-27,1006,Blush,150,300,150,1,00187,India
380909,2023-07-27,1001,Lipstick,150,300,150,1,00187,India
221518,2023-07-27,1005,Nail Polish,50,100,50,1,00272,India
221518,2023-07-27,1001,Lipstick,150,300,150,1,00272,India
221518,2023-07-27,1006,Blush,150,300,150,1,00272,India
221518,2023-07-27,1008,Makeup Remover,80,160,80,1,00272,India
401943,2023-07-27,1003,Foundation,300,600,300,1,00437,India
401943,2023-07-27,1002,Mascara,200,400,200,1,00437,India
504706,2023-07-27,1002,Mascara,200,400,200,1,00165,India
113428,2023-07-27,1007,Eyeshadow,200,400,200,1,00350,India
113428,2023-07-27,1002,Mascara,200,400,200,1,00350,India
113428,2023-07-27,1001,Lipstick,150,300,150,1,00350,India
113428,2023-07-27,1003,Foundation,300,600,300,1,00350,India
181679,2023-07-27,1003,Foundation,300,600,300,1,00249,India
181679,2023-07-27,1002,Mascara,200,400,200,1,00249,India
181679,2023-07-27,1005,Nail Polish,50,100,50,1,00249,India
817490,2023-07-27,1004,Eyeliner,100,200,100,1,00477,India
446424,2023-07-28,1008,Makeup Remover,80,160,80,1,00164,India
446424,2023-07-28,1006,Blush,150,300,150,1,00164,India
446424,2023-07-28,1003,Foundation,300,600,300,1,00164,India
446424,2023-07-28,1007,Eyeshadow,200,400,200,1,00164,India
156724,2023-07-28,1003,Foundation,300,600,300,1,00126,India
121563,2023-07-28,1003,Foundation,300,600,300,1,00144,India
121563,2023-07-28,1008,Makeup Remover,80,160,80,1,00144,India
121563,2023-07-28,1009,Moisturizer,250,500,250,1,00144,India
121563,2023-07-28,1006,Blush,150,300,150,1,00144,India
271766,2023-07-28,1012,Body Lotion,200,400,200,1,00106,India
271766,2023-07-28,1007,Eyeshadow,200,400,200,1,00106,India
271766,2023-07-28,1009,Moisturizer,250,500,250,1,00106,India
271766,2023-07-28,1001,Lipstick,150,300,150,1,00106,India
763038,2023-07-28,1004,Eyeliner,100,200,100,1,00346,India
763038,2023-07-28,1006,Blush,150,300,150,1,00346,India
763038,2023-07-28,1007,Eyeshadow,200,400,200,1,00346,India
381574,2023-07-28,1008,Makeup Remover,80,160,80,1,00366,India
381574,2023-07-28,1003,Foundation,300,600,300,1,00366,India
579398,2023-07-28,1002,Mascara,200,400,200,1,00209,India
579398,2023-07-28,1005,Nail Polish,50,100,50,1,00209,India
579398,2023-07-28,1012,Body Lotion,200,400,200,1,00209,India
579398,2023-07-28,1003,Foundation,300,600,300,1,00209,India
476436,2023-07-28,1012,Body Lotion,200,400,200,1,00424,India
309614,2023-07-28,1002,Mascara,200,400,200,1,00396,India
309614,2023-07-28,1007,Eyeshadow,200,400,200,1,00396,India
309614,2023-07-28,1006,Blush,150,300,150,1,00396,India
309614,2023-07-28,1012,Body Lotion,200,400,200,1,00396,India
564077,2023-07-28,1002,Mascara,200,400,200,1,00015,India
623829,2023-07-28,1008,Makeup Remover,80,160,80,1,00271,India
885079,2023-07-28,1006,Blush,150,300,150,1,00022,India
885079,2023-07-28,1003,Foundation,300,600,300,1,00022,India
885079,2023-07-28,1012,Body Lotion,200,400,200,1,00022,India
885079,2023-07-28,1002,Mascara,200,400,200,1,00022,India
885079,2023-07-28,1008,Makeup Remover,80,160,80,1,00022,India
883373,2023-07-28,1006,Blush,150,300,150,1,00364,India
883373,2023-07-28,1001,Lipstick,150,300,150,1,00364,India
901526,2023-07-28,1009,Moisturizer,250,500,250,1,00323,India
106191,2023-07-28,1007,Eyeshadow,200,400,200,1,00443,India
106191,2023-07-28,1003,Foundation,300,600,300,1,00443,India
106191,2023-07-28,1012,Body Lotion,200,400,200,1,00443,India
303622,2023-07-28,1007,Eyeshadow,200,400,200,1,00373,India
303622,2023-07-28,1008,Makeup Remover,80,160,80,1,00373,India
303622,2023-07-28,1003,Foundation,300,600,300,1,00373,India
140882,2023-07-28,1009,Moisturizer,250,500,250,1,00237,India
140882,2023-07-28,1007,Eyeshadow,200,400,200,1,00237,India
140882,2023-07-28,1006,Blush,150,300,150,1,00237,India
140882,2023-07-28,1002,Mascara,200,400,200,1,00237,India
536699,2023-07-28,1001,Lipstick,150,300,150,1,00295,India
536699,2023-07-28,1006,Blush,150,300,150,1,00295,India
559179,2023-07-28,1002,Mascara,200,400,200,1,00327,India
559179,2023-07-28,1012,Body Lotion,200,400,200,1,00327,India
222059,2023-07-28,1012,Body Lotion,200,400,200,1,00096,India
350255,2023-07-28,1002,Mascara,200,400,200,1,00423,India
350255,2023-07-28,1012,Body Lotion,200,400,200,1,00423,India
350255,2023-07-28,1006,Blush,150,300,150,1,00423,India
350255,2023-07-28,1004,Eyeliner,100,200,100,1,00423,India
932339,2023-07-28,1008,Makeup Remover,80,160,80,1,00458,India
932339,2023-07-28,1005,Nail Polish,50,100,50,1,00458,India
932339,2023-07-28,1007,Eyeshadow,200,400,200,1,00458,India
932339,2023-07-28,1006,Blush,150,300,150,1,00458,India
661371,2023-07-28,1007,Eyeshadow,200,400,200,1,00091,India
661371,2023-07-28,1006,Blush,150,300,150,1,00091,India
661371,2023-07-28,1009,Moisturizer,250,500,250,1,00091,India
661371,2023-07-28,1001,Lipstick,150,300,150,1,00091,India
145524,2023-07-28,1005,Nail Polish,50,100,50,1,00444,India
145524,2023-07-28,1001,Lipstick,150,300,150,1,00444,India
145524,2023-07-28,1002,Mascara,200,400,200,1,00444,India
145524,2023-07-28,1006,Blush,150,300,150,1,00444,India
468716,2023-07-28,1003,Foundation,300,600,300,1,00447,India
468716,2023-07-28,1009,Moisturizer,250,500,250,1,00447,India
782881,2023-07-28,1004,Eyeliner,100,200,100,1,00247,India
250693,2023-07-28,1007,Eyeshadow,200,400,200,1,00500,India
507880,2023-07-28,1006,Blush,150,300,150,1,00449,India
507880,2023-07-28,1003,Foundation,300,600,300,1,00449,India
491575,2023-07-28,1012,Body Lotion,200,400,200,1,00473,India
491575,2023-07-28,1003,Foundation,300,600,300,1,00473,India
491575,2023-07-28,1005,Nail Polish,50,100,50,1,00473,India
491575,2023-07-28,1002,Mascara,200,400,200,1,00473,India
173325,2023-07-28,1004,Eyeliner,100,200,100,1,00377,India
173325,2023-07-28,1009,Moisturizer,250,500,250,1,00377,India
173325,2023-07-28,1002,Mascara,200,400,200,1,00377,India
941335,2023-07-29,1002,Mascara,200,400,200,1,00098,India
941335,2023-07-29,1009,Moisturizer,250,500,250,1,00098,India
753765,2023-07-29,1007,Eyeshadow,200,400,200,1,00236,India
767253,2023-07-29,1007,Eyeshadow,200,400,200,1,00415,India
767253,2023-07-29,1001,Lipstick,150,300,150,1,00415,India
767253,2023-07-29,1012,Body Lotion,200,400,200,1,00415,India
767253,2023-07-29,1004,Eyeliner,100,200,100,1,00415,India
254452,2023-07-29,1004,Eyeliner,100,200,100,1,00271,India
254452,2023-07-29,1009,Moisturizer,250,500,250,1,00271,India
732073,2023-07-29,1006,Blush,150,300,150,1,00328,India
342104,2023-07-29,1006,Blush,150,300,150,1,00359,India
342104,2023-07-29,1009,Moisturizer,250,500,250,1,00359,India
854478,2023-07-29,1012,Body Lotion,200,400,200,1,00132,India
854478,2023-07-29,1008,Makeup Remover,80,160,80,1,00132,India
267866,2023-07-29,1009,Moisturizer,250,500,250,1,00222,India
267866,2023-07-29,1001,Lipstick,150,300,150,1,00222,India
221321,2023-07-29,1001,Lipstick,150,300,150,1,00005,India
858613,2023-07-29,1005,Nail Polish,50,100,50,1,00376,India
858613,2023-07-29,1001,Lipstick,150,300,150,1,00376,India
858613,2023-07-29,1004,Eyeliner,100,200,100,1,00376,India
983019,2023-07-29,1007,Eyeshadow,200,400,200,1,00141,India
983019,2023-07-29,1004,Eyeliner,100,200,100,1,00141,India
719450,2023-07-29,1008,Makeup Remover,80,160,80,1,00229,India
719450,2023-07-29,1001,Lipstick,150,300,150,1,00229,India
719450,2023-07-29,1009,Moisturizer,250,500,250,1,00229,India
719450,2023-07-29,1012,Body Lotion,200,400,200,1,00229,India
578510,2023-07-29,1002,Mascara,200,400,200,1,00067,India
578510,2023-07-29,1004,Eyeliner,100,200,100,1,00067,India
578510,2023-07-29,1003,Foundation,300,600,300,1,00067,India
578510,2023-07-29,1007,Eyeshadow,200,400,200,1,00067,India
578510,2023-07-29,1005,Nail Polish,50,100,50,1,00067,India
123497,2023-07-29,1004,Eyeliner,100,200,100,1,00039,India
123497,2023-07-29,1007,Eyeshadow,200,400,200,1,00039,India
167575,2023-07-29,1008,Makeup Remover,80,160,80,1,00409,India
167575,2023-07-29,1009,Moisturizer,250,500,250,1,00409,India
167575,2023-07-29,1006,Blush,150,300,150,1,00409,India
167575,2023-07-29,1004,Eyeliner,100,200,100,1,00409,India
865546,2023-07-29,1007,Eyeshadow,200,400,200,1,00416,India
308211,2023-07-29,1007,Eyeshadow,200,400,200,1,00250,India
308211,2023-07-29,1012,Body Lotion,200,400,200,1,00250,India
308211,2023-07-29,1009,Moisturizer,250,500,250,1,00250,India
308211,2023-07-29,1002,Mascara,200,400,200,1,00250,India
785114,2023-07-29,1002,Mascara,200,400,200,1,00122,India
785114,2023-07-29,1007,Eyeshadow,200,400,200,1,00122,India
785114,2023-07-29,1004,Eyeliner,100,200,100,1,00122,India
348690,2023-07-29,1006,Blush,150,300,150,1,00220,India
348690,2023-07-29,1005,Nail Polish,50,100,50,1,00220,India
348690,2023-07-29,1001,Lipstick,150,300,150,1,00220,India
348690,2023-07-29,1003,Foundation,300,600,300,1,00220,India
688717,2023-07-29,1012,Body Lotion,200,400,200,1,00228,India
688717,2023-07-29,1008,Makeup Remover,80,160,80,1,00228,India
688717,2023-07-29,1001,Lipstick,150,300,150,1,00228,India
688717,2023-07-29,1005,Nail Polish,50,100,50,1,00228,India
870498,2023-07-29,1006,Blush,150,300,150,1,00282,India
870498,2023-07-29,1004,Eyeliner,100,200,100,1,00282,India
870498,2023-07-29,1012,Body Lotion,200,400,200,1,00282,India
470853,2023-07-29,1012,Body Lotion,200,400,200,1,00249,India
470853,2023-07-29,1004,Eyeliner,100,200,100,1,00249,India
470853,2023-07-29,1006,Blush,150,300,150,1,00249,India
894033,2023-07-29,1005,Nail Polish,50,100,50,1,00151,India
894033,2023-07-29,1008,Makeup Remover,80,160,80,1,00151,India
670531,2023-07-29,1008,Makeup Remover,80,160,80,1,00224,India
670531,2023-07-29,1009,Moisturizer,250,500,250,1,00224,India
670531,2023-07-29,1012,Body Lotion,200,400,200,1,00224,India
670531,2023-07-29,1004,Eyeliner,100,200,100,1,00224,India
331848,2023-07-29,1006,Blush,150,300,150,1,00202,India
331848,2023-07-29,1004,Eyeliner,100,200,100,1,00202,India
331848,2023-07-29,1001,Lipstick,150,300,150,1,00202,India
331848,2023-07-29,1003,Foundation,300,600,300,1,00202,India
331848,2023-07-29,1009,Moisturizer,250,500,250,1,00202,India
610793,2023-07-29,1006,Blush,150,300,150,1,00474,India
610793,2023-07-29,1001,Lipstick,150,300,150,1,00474,India
610793,2023-07-29,1002,Mascara,200,400,200,1,00474,India
610793,2023-07-29,1012,Body Lotion,200,400,200,1,00474,India
920467,2023-07-29,1001,Lipstick,150,300,150,1,00210,India
920467,2023-07-29,1008,Makeup Remover,80,160,80,1,00210,India
121911,2023-07-29,1006,Blush,150,300,150,1,00468,India
687082,2023-07-29,1004,Eyeliner,100,200,100,1,00015,India
655646,2023-07-29,1004,Eyeliner,100,200,100,1,00486,India
701802,2023-07-29,1005,Nail Polish,50,100,50,1,00397,India
701802,2023-07-29,1002,Mascara,200,400,200,1,00397,India
534603,2023-07-29,1008,Makeup Remover,80,160,80,1,00206,India
534603,2023-07-29,1002,Mascara,200,400,200,1,00206,India
284303,2023-07-29,1003,Foundation,300,600,300,1,00418,India
284303,2023-07-29,1008,Makeup Remover,80,160,80,1,00418,India
284303,2023-07-29,1004,Eyeliner,100,200,100,1,00418,India
993180,2023-07-29,1012,Body Lotion,200,400,200,1,00027,India
993180,2023-07-29,1001,Lipstick,150,300,150,1,00027,India
993180,2023-07-29,1008,Makeup Remover,80,160,80,1,00027,India
993180,2023-07-29,1002,Mascara,200,400,200,1,00027,India
289660,2023-07-29,1008,Makeup Remover,80,160,80,1,00365,India
289660,2023-07-29,1009,Moisturizer,250,500,250,1,00365,India
726504,2023-07-29,1003,Foundation,300,600,300,1,00418,India
726504,2023-07-29,1004,Eyeliner,100,200,100,1,00418,India
301632,2023-07-29,1005,Nail Polish,50,100,50,1,00302,India
301632,2023-07-29,1007,Eyeshadow,200,400,200,1,00302,India
930349,2023-07-29,1005,Nail Polish,50,100,50,1,00252,India
930349,2023-07-29,1012,Body Lotion,200,400,200,1,00252,India
930349,2023-07-29,1008,Makeup Remover,80,160,80,1,00252,India
718433,2023-07-29,1008,Makeup Remover,80,160,80,1,00053,India
718433,2023-07-29,1007,Eyeshadow,200,400,200,1,00053,India
718433,2023-07-29,1002,Mascara,200,400,200,1,00053,India
799997,2023-07-29,1006,Blush,150,300,150,1,00412,India
756186,2023-07-29,1001,Lipstick,150,300,150,1,00485,India
242018,2023-07-29,1005,Nail Polish,50,100,50,1,00197,India
242018,2023-07-29,1007,Eyeshadow,200,400,200,1,00197,India
242018,2023-07-29,1009,Moisturizer,250,500,250,1,00197,India
242018,2023-07-29,1002,Mascara,200,400,200,1,00197,India
331146,2023-07-29,1012,Body Lotion,200,400,200,1,00326,India
331146,2023-07-29,1005,Nail Polish,50,100,50,1,00326,India
331146,2023-07-29,1007,Eyeshadow,200,400,200,1,00326,India
331146,2023-07-29,1009,Moisturizer,250,500,250,1,00326,India
948579,2023-07-29,1009,Moisturizer,250,500,250,1,00303,India
948579,2023-07-29,1001,Lipstick,150,300,150,1,00303,India
948579,2023-07-29,1008,Makeup Remover,80,160,80,1,00303,India
303686,2023-07-29,1004,Eyeliner,100,200,100,1,00446,India
901294,2023-07-29,1012,Body Lotion,200,400,200,1,00142,India
901294,2023-07-29,1001,Lipstick,150,300,150,1,00142,India
901294,2023-07-29,1009,Moisturizer,250,500,250,1,00142,India
227631,2023-07-29,1001,Lipstick,150,300,150,1,00112,India
859661,2023-07-29,1008,Makeup Remover,80,160,80,1,00033,India
868581,2023-07-29,1008,Makeup Remover,80,160,80,1,00377,India
916969,2023-07-29,1009,Moisturizer,250,500,250,1,00438,India
916969,2023-07-29,1012,Body Lotion,200,400,200,1,00438,India
916969,2023-07-29,1006,Blush,150,300,150,1,00438,India
604589,2023-07-30,1007,Eyeshadow,200,400,200,1,00274,India
604589,2023-07-30,1009,Moisturizer,250,500,250,1,00274,India
604589,2023-07-30,1012,Body Lotion,200,400,200,1,00274,India
268347,2023-07-30,1008,Makeup Remover,80,160,80,1,00092,India
268347,2023-07-30,1004,Eyeliner,100,200,100,1,00092,India
268347,2023-07-30,1003,Foundation,300,600,300,1,00092,India
613882,2023-07-30,1009,Moisturizer,250,500,250,1,00083,India
613882,2023-07-30,1012,Body Lotion,200,400,200,1,00083,India
613882,2023-07-30,1008,Makeup Remover,80,160,80,1,00083,India
613882,2023-07-30,1002,Mascara,200,400,200,1,00083,India
613882,2023-07-30,1006,Blush,150,300,150,1,00083,India
838910,2023-07-30,1008,Makeup Remover,80,160,80,1,00183,India
838910,2023-07-30,1001,Lipstick,150,300,150,1,00183,India
838910,2023-07-30,1003,Foundation,300,600,300,1,00183,India
122531,2023-07-30,1009,Moisturizer,250,500,250,1,00331,India
122531,2023-07-30,1008,Makeup Remover,80,160,80,1,00331,India
122531,2023-07-30,1012,Body Lotion,200,400,200,1,00331,India
122531,2023-07-30,1003,Foundation,300,600,300,1,00331,India
425484,2023-07-30,1004,Eyeliner,100,200,100,1,00256,India
566760,2023-07-30,1006,Blush,150,300,150,1,00016,India
566760,2023-07-30,1012,Body Lotion,200,400,200,1,00016,India
566760,2023-07-30,1009,Moisturizer,250,500,250,1,00016,India
905103,2023-07-30,1001,Lipstick,150,300,150,1,00141,India
905103,2023-07-30,1005,Nail Polish,50,100,50,1,00141,India
905103,2023-07-30,1009,Moisturizer,250,500,250,1,00141,India
354091,2023-07-30,1007,Eyeshadow,200,400,200,1,00389,India
830030,2023-07-30,1008,Makeup Remover,80,160,80,1,00373,India
702337,2023-07-30,1001,Lipstick,150,300,150,1,00345,India
702337,2023-07-30,1008,Makeup Remover,80,160,80,1,00345,India
471751,2023-07-30,1008,Makeup Remover,80,160,80,1,00336,India
471751,2023-07-30,1003,Foundation,300,600,300,1,00336,India
471751,2023-07-30,1009,Moisturizer,250,500,250,1,00336,India
471751,2023-07-30,1012,Body Lotion,200,400,200,1,00336,India
471751,2023-07-30,1002,Mascara,200,400,200,1,00336,India
958890,2023-07-30,1002,Mascara,200,400,200,1,00072,India
958890,2023-07-30,1008,Makeup Remover,80,160,80,1,00072,India
484794,2023-07-30,1007,Eyeshadow,200,400,200,1,00407,India
484794,2023-07-30,1006,Blush,150,300,150,1,00407,India
888905,2023-07-30,1002,Mascara,200,400,200,1,00448,India
313912,2023-07-30,1009,Moisturizer,250,500,250,1,00413,India
313912,2023-07-30,1007,Eyeshadow,200,400,200,1,00413,India
356171,2023-07-30,1007,Eyeshadow,200,400,200,1,00226,India
356171,2023-07-30,1005,Nail Polish,50,100,50,1,00226,India
356171,2023-07-30,1006,Blush,150,300,150,1,00226,India
744397,2023-07-30,1008,Makeup Remover,80,160,80,1,00138,India
786216,2023-07-30,1008,Makeup Remover,80,160,80,1,00245,India
786216,2023-07-30,1012,Body Lotion,200,400,200,1,00245,India
206639,2023-07-30,1002,Mascara,200,400,200,1,00495,India
206639,2023-07-30,1001,Lipstick,150,300,150,1,00495,India
514483,2023-07-30,1008,Makeup Remover,80,160,80,1,00063,India
514483,2023-07-30,1006,Blush,150,300,150,1,00063,India
237102,2023-07-30,1005,Nail Polish,50,100,50,1,00033,India
237102,2023-07-30,1009,Moisturizer,250,500,250,1,00033,India
237102,2023-07-30,1007,Eyeshadow,200,400,200,1,00033,India
807473,2023-07-30,1009,Moisturizer,250,500,250,1,00360,India
807473,2023-07-30,1007,Eyeshadow,200,400,200,1,00360,India
348509,2023-07-30,1003,Foundation,300,600,300,1,00216,India
348509,2023-07-30,1005,Nail Polish,50,100,50,1,00216,India
348509,2023-07-30,1006,Blush,150,300,150,1,00216,India
348509,2023-07-30,1007,Eyeshadow,200,400,200,1,00216,India
755709,2023-07-30,1007,Eyeshadow,200,400,200,1,00335,India
755709,2023-07-30,1005,Nail Polish,50,100,50,1,00335,India
755709,2023-07-30,1001,Lipstick,150,300,150,1,00335,India
268250,2023-07-30,1009,Moisturizer,250,500,250,1,00225,India
268250,2023-07-30,1005,Nail Polish,50,100,50,1,00225,India
414579,2023-07-30,1005,Nail Polish,50,100,50,1,00359,India
414579,2023-07-30,1012,Body Lotion,200,400,200,1,00359,India
352284,2023-07-30,1003,Foundation,300,600,300,1,00140,India
352284,2023-07-30,1001,Lipstick,150,300,150,1,00140,India
352284,2023-07-30,1012,Body Lotion,200,400,200,1,00140,India
352284,2023-07-30,1004,Eyeliner,100,200,100,1,00140,India
492072,2023-07-30,1003,Foundation,300,600,300,1,00186,India
492072,2023-07-30,1012,Body Lotion,200,400,200,1,00186,India
356741,2023-07-30,1005,Nail Polish,50,100,50,1,00042,India
356741,2023-07-30,1012,Body Lotion,200,400,200,1,00042,India
356741,2023-07-30,1001,Lipstick,150,300,150,1,00042,India
356741,2023-07-30,1009,Moisturizer,250,500,250,1,00042,India
923101,2023-07-30,1001,Lipstick,150,300,150,1,00028,India
923101,2023-07-30,1007,Eyeshadow,200,400,200,1,00028,India
923101,2023-07-30,1008,Makeup Remover,80,160,80,1,00028,India
381556,2023-07-30,1007,Eyeshadow,200,400,200,1,00260,India
945130,2023-07-30,1009,Moisturizer,250,500,250,1,00230,India
945130,2023-07-30,1002,Mascara,200,400,200,1,00230,India
945130,2023-07-30,1004,Eyeliner,100,200,100,1,00230,India
945130,2023-07-30,1006,Blush,150,300,150,1,00230,India
969955,2023-07-30,1003,Foundation,300,600,300,1,00393,India
969955,2023-07-30,1001,Lipstick,150,300,150,1,00393,India
969955,2023-07-30,1002,Mascara,200,400,200,1,00393,India
969955,2023-07-30,1004,Eyeliner,100,200,100,1,00393,India
597377,2023-07-30,1002,Mascara,200,400,200,1,00370,India
597377,2023-07-30,1001,Lipstick,150,300,150,1,00370,India
911388,2023-07-30,1005,Nail Polish,50,100,50,1,00161,India
911388,2023-07-30,1004,Eyeliner,100,200,100,1,00161,India
185503,2023-07-30,1006,Blush,150,300,150,1,00448,India
185503,2023-07-30,1005,Nail Polish,50,100,50,1,00448,India
185503,2023-07-30,1008,Makeup Remover,80,160,80,1,00448,India
705110,2023-07-30,1001,Lipstick,150,300,150,1,00007,India
705110,2023-07-30,1004,Eyeliner,100,200,100,1,00007,India
705110,2023-07-30,1007,Eyeshadow,200,400,200,1,00007,India
220704,2023-07-31,1002,Mascara,200,400,200,1,00139,India
220704,2023-07-31,1001,Lipstick,150,300,150,1,00139,India
201583,2023-07-31,1006,Blush,150,300,150,1,00292,India
201583,2023-07-31,1008,Makeup Remover,80,160,80,1,00292,India
201583,2023-07-31,1001,Lipstick,150,300,150,1,00292,India
201583,2023-07-31,1003,Foundation,300,600,300,1,00292,India
298264,2023-07-31,1012,Body Lotion,200,400,200,1,00327,India
860836,2023-07-31,1009,Moisturizer,250,500,250,1,00059,India
860836,2023-07-31,1008,Makeup Remover,80,160,80,1,00059,India
860836,2023-07-31,1002,Mascara,200,400,200,1,00059,India
590938,2023-07-31,1008,Makeup Remover,80,160,80,1,00051,India
590938,2023-07-31,1006,Blush,150,300,150,1,00051,India
251490,2023-07-31,1001,Lipstick,150,300,150,1,00099,India
407851,2023-07-31,1007,Eyeshadow,200,400,200,1,00143,India
407851,2023-07-31,1006,Blush,150,300,150,1,00143,India
407851,2023-07-31,1004,Eyeliner,100,200,100,1,00143,India
286737,2023-07-31,1009,Moisturizer,250,500,250,1,00240,India
286737,2023-07-31,1004,Eyeliner,100,200,100,1,00240,India
286737,2023-07-31,1006,Blush,150,300,150,1,00240,India
286737,2023-07-31,1007,Eyeshadow,200,400,200,1,00240,India
286737,2023-07-31,1008,Makeup Remover,80,160,80,1,00240,India
996031,2023-07-31,1003,Foundation,300,600,300,1,00075,India
283992,2023-07-31,1001,Lipstick,150,300,150,1,00003,India
283992,2023-07-31,1002,Mascara,200,400,200,1,00003,India
736339,2023-07-31,1004,Eyeliner,100,200,100,1,00332,India
736339,2023-07-31,1006,Blush,150,300,150,1,00332,India
736339,2023-07-31,1009,Moisturizer,250,500,250,1,00332,India
736339,2023-07-31,1008,Makeup Remover,80,160,80,1,00332,India
861699,2023-07-31,1005,Nail Polish,50,100,50,1,00125,India
878840,2023-07-31,1003,Foundation,300,600,300,1,00111,India
878840,2023-07-31,1002,Mascara,200,400,200,1,00111,India
878840,2023-07-31,1012,Body Lotion,200,400,200,1,00111,India
731296,2023-07-31,1002,Mascara,200,400,200,1,00327,India
266988,2023-07-31,1005,Nail Polish,50,100,50,1,00013,India
266988,2023-07-31,1012,Body Lotion,200,400,200,1,00013,India
266988,2023-07-31,1001,Lipstick,150,300,150,1,00013,India
166897,2023-07-31,1009,Moisturizer,250,500,250,1,00455,India
709994,2023-07-31,1012,Body Lotion,200,400,200,1,00499,India
709994,2023-07-31,1005,Nail Polish,50,100,50,1,00499,India
709994,2023-07-31,1004,Eyeliner,100,200,100,1,00499,India
283691,2023-07-31,1008,Makeup Remover,80,160,80,1,00453,India
941233,2023-07-31,1001,Lipstick,150,300,150,1,00172,India
941233,2023-07-31,1012,Body Lotion,200,400,200,1,00172,India
497639,2023-07-31,1005,Nail Polish,50,100,50,1,00047,India
497639,2023-07-31,1007,Eyeshadow,200,400,200,1,00047,India
497639,2023-07-31,1003,Foundation,300,600,300,1,00047,India
497639,2023-07-31,1012,Body Lotion,200,400,200,1,00047,India
296939,2023-07-31,1012,Body Lotion,200,400,200,1,00072,India
296939,2023-07-31,1001,Lipstick,150,300,150,1,00072,India
962286,2023-07-31,1012,Body Lotion,200,400,200,1,00408,India
962286,2023-07-31,1001,Lipstick,150,300,150,1,00408,India
962286,2023-07-31,1004,Eyeliner,100,200,100,1,00408,India
962286,2023-07-31,1009,Moisturizer,250,500,250,1,00408,India
962286,2023-07-31,1006,Blush,150,300,150,1,00408,India
714428,2023-07-31,1007,Eyeshadow,200,400,200,1,00427,India
714428,2023-07-31,1008,Makeup Remover,80,160,80,1,00427,India
518591,2023-07-31,1003,Foundation,300,600,300,1,00151,India
518591,2023-07-31,1001,Lipstick,150,300,150,1,00151,India
518591,2023-07-31,1004,Eyeliner,100,200,100,1,00151,India
236152,2023-07-31,1009,Moisturizer,250,500,250,1,00086,India
236152,2023-07-31,1006,Blush,150,300,150,1,00086,India
236152,2023-07-31,1005,Nail Polish,50,100,50,1,00086,India
236152,2023-07-31,1007,Eyeshadow,200,400,200,1,00086,India
839905,2023-07-31,1001,Lipstick,150,300,150,1,00428,India
839905,2023-07-31,1009,Moisturizer,250,500,250,1,00428,India
839905,2023-07-31,1006,Blush,150,300,150,1,00428,India
839905,2023-07-31,1004,Eyeliner,100,200,100,1,00428,India
523733,2023-07-31,1007,Eyeshadow,200,400,200,1,00362,India
523733,2023-07-31,1001,Lipstick,150,300,150,1,00362,India
922362,2023-07-31,1008,Makeup Remover,80,160,80,1,00230,India
922362,2023-07-31,1003,Foundation,300,600,300,1,00230,India
830502,2023-07-31,1009,Moisturizer,250,500,250,1,00386,India
830502,2023-07-31,1008,Makeup Remover,80,160,80,1,00386,India
830502,2023-07-31,1002,Mascara,200,400,200,1,00386,India
429731,2023-07-31,1012,Body Lotion,200,400,200,1,00002,India
429731,2023-07-31,1007,Eyeshadow,200,400,200,1,00002,India
234858,2023-07-31,1008,Makeup Remover,80,160,80,1,00394,India
234858,2023-07-31,1002,Mascara,200,400,200,1,00394,India
234858,2023-07-31,1006,Blush,150,300,150,1,00394,India
234858,2023-07-31,1009,Moisturizer,250,500,250,1,00394,India
910972,2023-07-31,1008,Makeup Remover,80,160,80,1,00320,India
910972,2023-07-31,1006,Blush,150,300,150,1,00320,India
910972,2023-07-31,1009,Moisturizer,250,500,250,1,00320,India
881554,2023-07-31,1007,Eyeshadow,200,400,200,1,00150,India
881554,2023-07-31,1003,Foundation,300,600,300,1,00150,India
881554,2023-07-31,1012,Body Lotion,200,400,200,1,00150,India
881554,2023-07-31,1002,Mascara,200,400,200,1,00150,India
366971,2023-07-31,1008,Makeup Remover,80,160,80,1,00414,India
366971,2023-07-31,1009,Moisturizer,250,500,250,1,00414,India
464928,2023-07-31,1007,Eyeshadow,200,400,200,1,00026,India
464928,2023-07-31,1004,Eyeliner,100,200,100,1,00026,India
464928,2023-07-31,1009,Moisturizer,250,500,250,1,00026,India
484515,2023-07-31,1003,Foundation,300,600,300,1,00432,India
690940,2023-07-31,1007,Eyeshadow,200,400,200,1,00391,India
221591,2023-07-31,1008,Makeup Remover,80,160,80,1,00459,India
251495,2023-07-31,1003,Foundation,300,600,300,1,00310,India
251495,2023-07-31,1005,Nail Polish,50,100,50,1,00310,India
251495,2023-07-31,1009,Moisturizer,250,500,250,1,00310,India
251495,2023-07-31,1001,Lipstick,150,300,150,1,00310,India
137656,2023-07-31,1004,Eyeliner,100,200,100,1,00029,India
137656,2023-07-31,1002,Mascara,200,400,200,1,00029,India
853749,2023-07-31,1006,Blush,150,300,150,1,00092,India
853749,2023-07-31,1008,Makeup Remover,80,160,80,1,00092,India
853749,2023-07-31,1005,Nail Polish,50,100,50,1,00092,India
838360,2023-07-31,1005,Nail Polish,50,100,50,1,00034,India
281262,2023-07-31,1003,Foundation,300,600,300,1,00374,India
281262,2023-07-31,1009,Moisturizer,250,500,250,1,00374,India
281262,2023-07-31,1008,Makeup Remover,80,160,80,1,00374,India
281262,2023-07-31,1001,Lipstick,150,300,150,1,00374,India
603890,2023-07-31,1012,Body Lotion,200,400,200,1,00026,India
603890,2023-07-31,1008,Makeup Remover,80,160,80,1,00026,India
603890,2023-07-31,1004,Eyeliner,100,200,100,1,00026,India
603890,2023-07-31,1006,Blush,150,300,150,1,00026,India
947961,2023-07-31,1003,Foundation,300,600,300,1,00073,India
947961,2023-07-31,1008,Makeup Remover,80,160,80,1,00073,India
947961,2023-07-31,1006,Blush,150,300,150,1,00073,India
947961,2023-07-31,1002,Mascara,200,400,200,1,00073,India
947961,2023-07-31,1005,Nail Polish,50,100,50,1,00073,India
127185,2023-07-31,1012,Body Lotion,200,400,200,1,00021,India
127185,2023-07-31,1007,Eyeshadow,200,400,200,1,00021,India
957482,2023-07-31,1008,Makeup Remover,80,160,80,1,00133,India
957482,2023-07-31,1002,Mascara,200,400,200,1,00133,India
957482,2023-07-31,1009,Moisturizer,250,500,250,1,00133,India
957482,2023-07-31,1006,Blush,150,300,150,1,00133,India
957482,2023-07-31,1001,Lipstick,150,300,150,1,00133,India
160280,2023-07-31,1003,Foundation,300,600,300,1,00417,India
160280,2023-07-31,1012,Body Lotion,200,400,200,1,00417,India
160280,2023-07-31,1009,Moisturizer,250,500,250,1,00417,India
236438,2023-08-01,1002,Mascara,200,400,200,1,00410,India
236438,2023-08-01,1004,Eyeliner,100,200,100,1,00410,India
444431,2023-08-01,1004,Eyeliner,100,200,100,1,00403,India
444431,2023-08-01,1007,Eyeshadow,200,400,200,1,00403,India
444431,2023-08-01,1008,Makeup Remover,80,160,80,1,00403,India
232972,2023-08-01,1002,Mascara,200,400,200,1,00314,India
232972,2023-08-01,1009,Moisturizer,250,500,250,1,00314,India
232972,2023-08-01,1012,Body Lotion,200,400,200,1,00314,India
167239,2023-08-01,1001,Lipstick,150,300,150,1,00374,India
167239,2023-08-01,1004,Eyeliner,100,200,100,1,00374,India
167239,2023-08-01,1005,Nail Polish,50,100,50,1,00374,India
167239,2023-08-01,1008,Makeup Remover,80,160,80,1,00374,India
943555,2023-08-01,1003,Foundation,300,600,300,1,00369,India
943555,2023-08-01,1012,Body Lotion,200,400,200,1,00369,India
508862,2023-08-01,1001,Lipstick,150,300,150,1,00303,India
508862,2023-08-01,1005,Nail Polish,50,100,50,1,00303,India
508862,2023-08-01,1003,Foundation,300,600,300,1,00303,India
738740,2023-08-01,1001,Lipstick,150,300,150,1,00311,India
738740,2023-08-01,1004,Eyeliner,100,200,100,1,00311,India
273721,2023-08-01,1002,Mascara,200,400,200,1,00194,India
232847,2023-08-01,1009,Moisturizer,250,500,250,1,00344,India
232847,2023-08-01,1003,Foundation,300,600,300,1,00344,India
232847,2023-08-01,1004,Eyeliner,100,200,100,1,00344,India
577119,2023-08-01,1007,Eyeshadow,200,400,200,1,00313,India
577119,2023-08-01,1001,Lipstick,150,300,150,1,00313,India
577119,2023-08-01,1004,Eyeliner,100,200,100,1,00313,India
850977,2023-08-01,1009,Moisturizer,250,500,250,1,00417,India
850977,2023-08-01,1012,Body Lotion,200,400,200,1,00417,India
850977,2023-08-01,1004,Eyeliner,100,200,100,1,00417,India
850977,2023-08-01,1005,Nail Polish,50,100,50,1,00417,India
362161,2023-08-01,1001,Lipstick,150,300,150,1,00251,India
362161,2023-08-01,1008,Makeup Remover,80,160,80,1,00251,India
362161,2023-08-01,1004,Eyeliner,100,200,100,1,00251,India
818990,2023-08-01,1009,Moisturizer,250,500,250,1,00209,India
333382,2023-08-01,1008,Makeup Remover,80,160,80,1,00171,India
333382,2023-08-01,1006,Blush,150,300,150,1,00171,India
333382,2023-08-01,1012,Body Lotion,200,400,200,1,00171,India
677906,2023-08-01,1009,Moisturizer,250,500,250,1,00386,India
677906,2023-08-01,1001,Lipstick,150,300,150,1,00386,India
509645,2023-08-01,1003,Foundation,300,600,300,1,00490,India
509645,2023-08-01,1004,Eyeliner,100,200,100,1,00490,India
509645,2023-08-01,1001,Lipstick,150,300,150,1,00490,India
509645,2023-08-01,1007,Eyeshadow,200,400,200,1,00490,India
546540,2023-08-01,1003,Foundation,300,600,300,1,00120,India
411819,2023-08-01,1003,Foundation,300,600,300,1,00479,India
411819,2023-08-01,1001,Lipstick,150,300,150,1,00479,India
714822,2023-08-01,1005,Nail Polish,50,100,50,1,00257,India
714822,2023-08-01,1006,Blush,150,300,150,1,00257,India
714822,2023-08-01,1008,Makeup Remover,80,160,80,1,00257,India
173703,2023-08-01,1002,Mascara,200,400,200,1,00217,India
173703,2023-08-01,1006,Blush,150,300,150,1,00217,India
173703,2023-08-01,1007,Eyeshadow,200,400,200,1,00217,India
519376,2023-08-01,1001,Lipstick,150,300,150,1,00358,India
519376,2023-08-01,1012,Body Lotion,200,400,200,1,00358,India
811577,2023-08-01,1007,Eyeshadow,200,400,200,1,00168,India
107260,2023-08-01,1009,Moisturizer,250,500,250,1,00342,India
107260,2023-08-01,1003,Foundation,300,600,300,1,00342,India
107260,2023-08-01,1012,Body Lotion,200,400,200,1,00342,India
107260,2023-08-01,1008,Makeup Remover,80,160,80,1,00342,India
812089,2023-08-01,1001,Lipstick,150,300,150,1,00083,India
812089,2023-08-01,1003,Foundation,300,600,300,1,00083,India
272803,2023-08-01,1001,Lipstick,150,300,150,1,00311,India
531647,2023-08-01,1004,Eyeliner,100,200,100,1,00054,India
979967,2023-08-01,1001,Lipstick,150,300,150,1,00312,India
180878,2023-08-01,1008,Makeup Remover,80,160,80,1,00329,India
180878,2023-08-01,1003,Foundation,300,600,300,1,00329,India
298499,2023-08-01,1005,Nail Polish,50,100,50,1,00244,India
298499,2023-08-01,1012,Body Lotion,200,400,200,1,00244,India
298499,2023-08-01,1009,Moisturizer,250,500,250,1,00244,India
298499,2023-08-01,1004,Eyeliner,100,200,100,1,00244,India
119678,2023-08-01,1006,Blush,150,300,150,1,00270,India
824387,2023-08-01,1012,Body Lotion,200,400,200,1,00305,India
824387,2023-08-01,1007,Eyeshadow,200,400,200,1,00305,India
824387,2023-08-01,1001,Lipstick,150,300,150,1,00305,India
112220,2023-08-01,1006,Blush,150,300,150,1,00446,India
112220,2023-08-01,1005,Nail Polish,50,100,50,1,00446,India
112220,2023-08-01,1007,Eyeshadow,200,400,200,1,00446,India
837981,2023-08-01,1004,Eyeliner,100,200,100,1,00173,India
837981,2023-08-01,1001,Lipstick,150,300,150,1,00173,India
837981,2023-08-01,1005,Nail Polish,50,100,50,1,00173,India
327712,2023-08-02,1004,Eyeliner,100,200,100,1,00041,India
327712,2023-08-02,1009,Moisturizer,250,500,250,1,00041,India
327712,2023-08-02,1002,Mascara,200,400,200,1,00041,India
372878,2023-08-02,1003,Foundation,300,600,300,1,00286,India
793312,2023-08-02,1003,Foundation,300,600,300,1,00180,India
793312,2023-08-02,1009,Moisturizer,250,500,250,1,00180,India
866097,2023-08-02,1005,Nail Polish,50,100,50,1,00199,India
866097,2023-08-02,1007,Eyeshadow,200,400,200,1,00199,India
866097,2023-08-02,1009,Moisturizer,250,500,250,1,00199,India
866097,2023-08-02,1001,Lipstick,150,300,150,1,00199,India
866097,2023-08-02,1008,Makeup Remover,80,160,80,1,00199,India
990824,2023-08-02,1005,Nail Polish,50,100,50,1,00049,India
990824,2023-08-02,1001,Lipstick,150,300,150,1,00049,India
990824,2023-08-02,1007,Eyeshadow,200,400,200,1,00049,India
107059,2023-08-02,1003,Foundation,300,600,300,1,00315,India
107059,2023-08-02,1007,Eyeshadow,200,400,200,1,00315,India
107059,2023-08-02,1008,Makeup Remover,80,160,80,1,00315,India
107059,2023-08-02,1009,Moisturizer,250,500,250,1,00315,India
230117,2023-08-02,1006,Blush,150,300,150,1,00019,India
230117,2023-08-02,1007,Eyeshadow,200,400,200,1,00019,India
230117,2023-08-02,1005,Nail Polish,50,100,50,1,00019,India
230117,2023-08-02,1012,Body Lotion,200,400,200,1,00019,India
230117,2023-08-02,1003,Foundation,300,600,300,1,00019,India
302127,2023-08-02,1002,Mascara,200,400,200,1,00084,India
302127,2023-08-02,1001,Lipstick,150,300,150,1,00084,India
302127,2023-08-02,1009,Moisturizer,250,500,250,1,00084,India
302127,2023-08-02,1006,Blush,150,300,150,1,00084,India
442087,2023-08-02,1002,Mascara,200,400,200,1,00359,India
442087,2023-08-02,1003,Foundation,300,600,300,1,00359,India
442087,2023-08-02,1001,Lipstick,150,300,150,1,00359,India
442087,2023-08-02,1009,Moisturizer,250,500,250,1,00359,India
870481,2023-08-02,1001,Lipstick,150,300,150,1,00277,India
870481,2023-08-02,1006,Blush,150,300,150,1,00277,India
870481,2023-08-02,1008,Makeup Remover,80,160,80,1,00277,India
106148,2023-08-02,1005,Nail Polish,50,100,50,1,00110,India
106148,2023-08-02,1009,Moisturizer,250,500,250,1,00110,India
129736,2023-08-02,1012,Body Lotion,200,400,200,1,00370,India
129736,2023-08-02,1006,Blush,150,300,150,1,00370,India
129736,2023-08-02,1004,Eyeliner,100,200,100,1,00370,India
129736,2023-08-02,1007,Eyeshadow,200,400,200,1,00370,India
129736,2023-08-02,1001,Lipstick,150,300,150,1,00370,India
538609,2023-08-02,1004,Eyeliner,100,200,100,1,00352,India
538609,2023-08-02,1006,Blush,150,300,150,1,00352,India
538609,2023-08-02,1001,Lipstick,150,300,150,1,00352,India
538609,2023-08-02,1007,Eyeshadow,200,400,200,1,00352,India
538609,2023-08-02,1003,Foundation,300,600,300,1,00352,India
893594,2023-08-02,1003,Foundation,300,600,300,1,00213,India
893594,2023-08-02,1002,Mascara,200,400,200,1,00213,India
893594,2023-08-02,1012,Body Lotion,200,400,200,1,00213,India
893594,2023-08-02,1008,Makeup Remover,80,160,80,1,00213,India
910387,2023-08-02,1007,Eyeshadow,200,400,200,1,00322,India
910387,2023-08-02,1004,Eyeliner,100,200,100,1,00322,India
492724,2023-08-02,1007,Eyeshadow,200,400,200,1,00046,India
492724,2023-08-02,1002,Mascara,200,400,200,1,00046,India
492724,2023-08-02,1004,Eyeliner,100,200,100,1,00046,India
440381,2023-08-02,1008,Makeup Remover,80,160,80,1,00314,India
440381,2023-08-02,1007,Eyeshadow,200,400,200,1,00314,India
440381,2023-08-02,1006,Blush,150,300,150,1,00314,India
921847,2023-08-02,1002,Mascara,200,400,200,1,00080,India
921847,2023-08-02,1003,Foundation,300,600,300,1,00080,India
923545,2023-08-02,1001,Lipstick,150,300,150,1,00236,India
923545,2023-08-02,1012,Body Lotion,200,400,200,1,00236,India
923545,2023-08-02,1007,Eyeshadow,200,400,200,1,00236,India
134546,2023-08-02,1006,Blush,150,300,150,1,00012,India
134546,2023-08-02,1007,Eyeshadow,200,400,200,1,00012,India
134546,2023-08-02,1008,Makeup Remover,80,160,80,1,00012,India
177715,2023-08-02,1008,Makeup Remover,80,160,80,1,00395,India
177715,2023-08-02,1001,Lipstick,150,300,150,1,00395,India
907669,2023-08-02,1002,Mascara,200,400,200,1,00180,India
907669,2023-08-02,1006,Blush,150,300,150,1,00180,India
396872,2023-08-02,1004,Eyeliner,100,200,100,1,00095,India
396872,2023-08-02,1001,Lipstick,150,300,150,1,00095,India
396872,2023-08-02,1006,Blush,150,300,150,1,00095,India
396872,2023-08-02,1002,Mascara,200,400,200,1,00095,India
757079,2023-08-02,1012,Body Lotion,200,400,200,1,00004,India
757079,2023-08-02,1005,Nail Polish,50,100,50,1,00004,India
268270,2023-08-02,1008,Makeup Remover,80,160,80,1,00214,India
268270,2023-08-02,1001,Lipstick,150,300,150,1,00214,India
268270,2023-08-02,1006,Blush,150,300,150,1,00214,India
268270,2023-08-02,1007,Eyeshadow,200,400,200,1,00214,India
237367,2023-08-02,1009,Moisturizer,250,500,250,1,00239,India
237367,2023-08-02,1004,Eyeliner,100,200,100,1,00239,India
237367,2023-08-02,1002,Mascara,200,400,200,1,00239,India
840742,2023-08-02,1005,Nail Polish,50,100,50,1,00170,India
840742,2023-08-02,1007,Eyeshadow,200,400,200,1,00170,India
840742,2023-08-02,1003,Foundation,300,600,300,1,00170,India
840742,2023-08-02,1009,Moisturizer,250,500,250,1,00170,India
840742,2023-08-02,1002,Mascara,200,400,200,1,00170,India
608201,2023-08-02,1006,Blush,150,300,150,1,00442,India
673815,2023-08-02,1008,Makeup Remover,80,160,80,1,00478,India
632681,2023-08-02,1005,Nail Polish,50,100,50,1,00048,India
632681,2023-08-02,1001,Lipstick,150,300,150,1,00048,India
632681,2023-08-02,1009,Moisturizer,250,500,250,1,00048,India
653397,2023-08-02,1007,Eyeshadow,200,400,200,1,00241,India
653397,2023-08-02,1004,Eyeliner,100,200,100,1,00241,India
308212,2023-08-02,1002,Mascara,200,400,200,1,00178,India
308212,2023-08-02,1008,Makeup Remover,80,160,80,1,00178,India
308212,2023-08-02,1003,Foundation,300,600,300,1,00178,India
321331,2023-08-02,1007,Eyeshadow,200,400,200,1,00128,India
142350,2023-08-02,1008,Makeup Remover,80,160,80,1,00158,India
142350,2023-08-02,1005,Nail Polish,50,100,50,1,00158,India
142350,2023-08-02,1006,Blush,150,300,150,1,00158,India
142350,2023-08-02,1012,Body Lotion,200,400,200,1,00158,India
800973,2023-08-02,1005,Nail Polish,50,100,50,1,00311,India
800973,2023-08-02,1004,Eyeliner,100,200,100,1,00311,India
800973,2023-08-02,1012,Body Lotion,200,400,200,1,00311,India
788585,2023-08-02,1007,Eyeshadow,200,400,200,1,00099,India
788585,2023-08-02,1012,Body Lotion,200,400,200,1,00099,India
788585,2023-08-02,1004,Eyeliner,100,200,100,1,00099,India
788585,2023-08-02,1006,Blush,150,300,150,1,00099,India
788585,2023-08-02,1005,Nail Polish,50,100,50,1,00099,India
953199,2023-08-02,1004,Eyeliner,100,200,100,1,00095,India
953199,2023-08-02,1009,Moisturizer,250,500,250,1,00095,India
953199,2023-08-02,1006,Blush,150,300,150,1,00095,India
953199,2023-08-02,1001,Lipstick,150,300,150,1,00095,India
346298,2023-08-02,1003,Foundation,300,600,300,1,00285,India
346298,2023-08-02,1007,Eyeshadow,200,400,200,1,00285,India
136160,2023-08-02,1008,Makeup Remover,80,160,80,1,00250,India
136160,2023-08-02,1005,Nail Polish,50,100,50,1,00250,India
136160,2023-08-02,1006,Blush,150,300,150,1,00250,India
509800,2023-08-02,1004,Eyeliner,100,200,100,1,00373,India
509800,2023-08-02,1012,Body Lotion,200,400,200,1,00373,India
509800,2023-08-02,1002,Mascara,200,400,200,1,00373,India
509800,2023-08-02,1006,Blush,150,300,150,1,00373,India
600489,2023-08-02,1009,Moisturizer,250,500,250,1,00322,India
422710,2023-08-02,1009,Moisturizer,250,500,250,1,00329,India
422710,2023-08-02,1006,Blush,150,300,150,1,00329,India
226675,2023-08-02,1005,Nail Polish,50,100,50,1,00481,India
343236,2023-08-03,1002,Mascara,200,400,200,1,00080,India
343236,2023-08-03,1007,Eyeshadow,200,400,200,1,00080,India
343236,2023-08-03,1001,Lipstick,150,300,150,1,00080,India
910256,2023-08-03,1005,Nail Polish,50,100,50,1,00259,India
910256,2023-08-03,1004,Eyeliner,100,200,100,1,00259,India
546657,2023-08-03,1002,Mascara,200,400,200,1,00130,India
546657,2023-08-03,1008,Makeup Remover,80,160,80,1,00130,India
696355,2023-08-03,1012,Body Lotion,200,400,200,1,00316,India
745258,2023-08-03,1002,Mascara,200,400,200,1,00019,India
745258,2023-08-03,1012,Body Lotion,200,400,200,1,00019,India
745258,2023-08-03,1009,Moisturizer,250,500,250,1,00019,India
745258,2023-08-03,1004,Eyeliner,100,200,100,1,00019,India
294293,2023-08-03,1007,Eyeshadow,200,400,200,1,00418,India
294293,2023-08-03,1003,Foundation,300,600,300,1,00418,India
534302,2023-08-03,1003,Foundation,300,600,300,1,00009,India
534302,2023-08-03,1002,Mascara,200,400,200,1,00009,India
354552,2023-08-03,1007,Eyeshadow,200,400,200,1,00421,India
771989,2023-08-03,1003,Foundation,300,600,300,1,00160,India
771989,2023-08-03,1007,Eyeshadow,200,400,200,1,00160,India
771989,2023-08-03,1008,Makeup Remover,80,160,80,1,00160,India
468448,2023-08-03,1004,Eyeliner,100,200,100,1,00442,India
468448,2023-08-03,1002,Mascara,200,400,200,1,00442,India
468448,2023-08-03,1006,Blush,150,300,150,1,00442,India
206824,2023-08-03,1006,Blush,150,300,150,1,00352,India
206824,2023-08-03,1007,Eyeshadow,200,400,200,1,00352,India
206824,2023-08-03,1009,Moisturizer,250,500,250,1,00352,India
902872,2023-08-03,1003,Foundation,300,600,300,1,00053,India
902872,2023-08-03,1004,Eyeliner,100,200,100,1,00053,India
902872,2023-08-03,1009,Moisturizer,250,500,250,1,00053,India
892945,2023-08-03,1008,Makeup Remover,80,160,80,1,00323,India
892945,2023-08-03,1004,Eyeliner,100,200,100,1,00323,India
892945,2023-08-03,1009,Moisturizer,250,500,250,1,00323,India
408955,2023-08-03,1002,Mascara,200,400,200,1,00271,India
263698,2023-08-03,1007,Eyeshadow,200,400,200,1,00270,India
120492,2023-08-03,1005,Nail Polish,50,100,50,1,00238,India
120492,2023-08-03,1012,Body Lotion,200,400,200,1,00238,India
916702,2023-08-03,1005,Nail Polish,50,100,50,1,00161,India
916702,2023-08-03,1003,Foundation,300,600,300,1,00161,India
517634,2023-08-03,1005,Nail Polish,50,100,50,1,00444,India
517634,2023-08-03,1004,Eyeliner,100,200,100,1,00444,India
597643,2023-08-03,1007,Eyeshadow,200,400,200,1,00260,India
597643,2023-08-03,1009,Moisturizer,250,500,250,1,00260,India
101409,2023-08-03,1003,Foundation,300,600,300,1,00209,India
101409,2023-08-03,1001,Lipstick,150,300,150,1,00209,India
101409,2023-08-03,1008,Makeup Remover,80,160,80,1,00209,India
101409,2023-08-03,1004,Eyeliner,100,200,100,1,00209,India
187926,2023-08-03,1008,Makeup Remover,80,160,80,1,00004,India
187926,2023-08-03,1004,Eyeliner,100,200,100,1,00004,India
187926,2023-08-03,1006,Blush,150,300,150,1,00004,India
187926,2023-08-03,1002,Mascara,200,400,200,1,00004,India
810160,2023-08-03,1007,Eyeshadow,200,400,200,1,00306,India
810160,2023-08-03,1006,Blush,150,300,150,1,00306,India
810160,2023-08-03,1001,Lipstick,150,300,150,1,00306,India
810160,2023-08-03,1008,Makeup Remover,80,160,80,1,00306,India
102501,2023-08-03,1007,Eyeshadow,200,400,200,1,00189,India
102501,2023-08-03,1002,Mascara,200,400,200,1,00189,India
102501,2023-08-03,1012,Body Lotion,200,400,200,1,00189,India
824976,2023-08-03,1006,Blush,150,300,150,1,00239,India
824976,2023-08-03,1002,Mascara,200,400,200,1,00239,India
655295,2023-08-03,1005,Nail Polish,50,100,50,1,00151,India
655295,2023-08-03,1003,Foundation,300,600,300,1,00151,India
655295,2023-08-03,1007,Eyeshadow,200,400,200,1,00151,India
655295,2023-08-03,1009,Moisturizer,250,500,250,1,00151,India
744060,2023-08-03,1007,Eyeshadow,200,400,200,1,00171,India
744060,2023-08-03,1009,Moisturizer,250,500,250,1,00171,India
744060,2023-08-03,1002,Mascara,200,400,200,1,00171,India
744060,2023-08-03,1012,Body Lotion,200,400,200,1,00171,India
621514,2023-08-03,1009,Moisturizer,250,500,250,1,00459,India
621514,2023-08-03,1005,Nail Polish,50,100,50,1,00459,India
621514,2023-08-03,1001,Lipstick,150,300,150,1,00459,India
621514,2023-08-03,1006,Blush,150,300,150,1,00459,India
621514,2023-08-03,1003,Foundation,300,600,300,1,00459,India
681264,2023-08-03,1005,Nail Polish,50,100,50,1,00216,India
681264,2023-08-03,1001,Lipstick,150,300,150,1,00216,India
681264,2023-08-03,1002,Mascara,200,400,200,1,00216,India
681264,2023-08-03,1003,Foundation,300,600,300,1,00216,India
461797,2023-08-03,1012,Body Lotion,200,400,200,1,00272,India
482585,2023-08-03,1006,Blush,150,300,150,1,00414,India
482585,2023-08-03,1009,Moisturizer,250,500,250,1,00414,India
579006,2023-08-03,1008,Makeup Remover,80,160,80,1,00378,India
206950,2023-08-03,1005,Nail Polish,50,100,50,1,00240,India
206950,2023-08-03,1001,Lipstick,150,300,150,1,00240,India
206950,2023-08-03,1008,Makeup Remover,80,160,80,1,00240,India
206950,2023-08-03,1006,Blush,150,300,150,1,00240,India
656717,2023-08-03,1012,Body Lotion,200,400,200,1,00189,India
656717,2023-08-03,1005,Nail Polish,50,100,50,1,00189,India
656717,2023-08-03,1001,Lipstick,150,300,150,1,00189,India
305636,2023-08-03,1009,Moisturizer,250,500,250,1,00407,India
305636,2023-08-03,1012,Body Lotion,200,400,200,1,00407,India
305636,2023-08-03,1001,Lipstick,150,300,150,1,00407,India
643083,2023-08-03,1004,Eyeliner,100,200,100,1,00446,India
754170,2023-08-03,1004,Eyeliner,100,200,100,1,00203,India
754170,2023-08-03,1005,Nail Polish,50,100,50,1,00203,India
754170,2023-08-03,1002,Mascara,200,400,200,1,00203,India
754170,2023-08-03,1006,Blush,150,300,150,1,00203,India
298228,2023-08-04,1001,Lipstick,150,300,150,1,00428,India
298228,2023-08-04,1012,Body Lotion,200,400,200,1,00428,India
808421,2023-08-04,1004,Eyeliner,100,200,100,1,00180,India
808421,2023-08-04,1012,Body Lotion,200,400,200,1,00180,India
629862,2023-08-04,1005,Nail Polish,50,100,50,1,00321,India
629862,2023-08-04,1001,Lipstick,150,300,150,1,00321,India
629862,2023-08-04,1009,Moisturizer,250,500,250,1,00321,India
629862,2023-08-04,1012,Body Lotion,200,400,200,1,00321,India
990071,2023-08-04,1008,Makeup Remover,80,160,80,1,00366,India
990071,2023-08-04,1009,Moisturizer,250,500,250,1,00366,India
990071,2023-08-04,1001,Lipstick,150,300,150,1,00366,India
990071,2023-08-04,1012,Body Lotion,200,400,200,1,00366,India
630010,2023-08-04,1003,Foundation,300,600,300,1,00124,India
630010,2023-08-04,1004,Eyeliner,100,200,100,1,00124,India
630010,2023-08-04,1001,Lipstick,150,300,150,1,00124,India
674953,2023-08-04,1009,Moisturizer,250,500,250,1,00357,India
674953,2023-08-04,1007,Eyeshadow,200,400,200,1,00357,India
794648,2023-08-04,1012,Body Lotion,200,400,200,1,00293,India
794648,2023-08-04,1005,Nail Polish,50,100,50,1,00293,India
200351,2023-08-04,1008,Makeup Remover,80,160,80,1,00433,India
200351,2023-08-04,1006,Blush,150,300,150,1,00433,India
200351,2023-08-04,1009,Moisturizer,250,500,250,1,00433,India
620375,2023-08-04,1002,Mascara,200,400,200,1,00348,India
620375,2023-08-04,1005,Nail Polish,50,100,50,1,00348,India
455651,2023-08-04,1004,Eyeliner,100,200,100,1,00029,India
455651,2023-08-04,1009,Moisturizer,250,500,250,1,00029,India
580714,2023-08-04,1005,Nail Polish,50,100,50,1,00414,India
580714,2023-08-04,1007,Eyeshadow,200,400,200,1,00414,India
580714,2023-08-04,1004,Eyeliner,100,200,100,1,00414,India
668072,2023-08-04,1008,Makeup Remover,80,160,80,1,00037,India
668072,2023-08-04,1009,Moisturizer,250,500,250,1,00037,India
668072,2023-08-04,1004,Eyeliner,100,200,100,1,00037,India
504497,2023-08-04,1004,Eyeliner,100,200,100,1,00023,India
504497,2023-08-04,1006,Blush,150,300,150,1,00023,India
504497,2023-08-04,1012,Body Lotion,200,400,200,1,00023,India
504497,2023-08-04,1002,Mascara,200,400,200,1,00023,India
504497,2023-08-04,1003,Foundation,300,600,300,1,00023,India
373775,2023-08-04,1004,Eyeliner,100,200,100,1,00487,India
373775,2023-08-04,1005,Nail Polish,50,100,50,1,00487,India
373775,2023-08-04,1002,Mascara,200,400,200,1,00487,India
373775,2023-08-04,1007,Eyeshadow,200,400,200,1,00487,India
526624,2023-08-04,1006,Blush,150,300,150,1,00214,India
526624,2023-08-04,1007,Eyeshadow,200,400,200,1,00214,India
526624,2023-08-04,1003,Foundation,300,600,300,1,00214,India
526624,2023-08-04,1002,Mascara,200,400,200,1,00214,India
842680,2023-08-04,1008,Makeup Remover,80,160,80,1,00323,India
842680,2023-08-04,1007,Eyeshadow,200,400,200,1,00323,India
842680,2023-08-04,1012,Body Lotion,200,400,200,1,00323,India
842680,2023-08-04,1005,Nail Polish,50,100,50,1,00323,India
167027,2023-08-04,1007,Eyeshadow,200,400,200,1,00014,India
397409,2023-08-04,1004,Eyeliner,100,200,100,1,00186,India
397409,2023-08-04,1009,Moisturizer,250,500,250,1,00186,India
397409,2023-08-04,1002,Mascara,200,400,200,1,00186,India
397409,2023-08-04,1005,Nail Polish,50,100,50,1,00186,India
664295,2023-08-04,1004,Eyeliner,100,200,100,1,00275,India
433519,2023-08-04,1004,Eyeliner,100,200,100,1,00337,India
433519,2023-08-04,1012,Body Lotion,200,400,200,1,00337,India
259670,2023-08-04,1002,Mascara,200,400,200,1,00350,India
955698,2023-08-04,1009,Moisturizer,250,500,250,1,00031,India
955698,2023-08-04,1007,Eyeshadow,200,400,200,1,00031,India
381529,2023-08-04,1003,Foundation,300,600,300,1,00484,India
381529,2023-08-04,1004,Eyeliner,100,200,100,1,00484,India
381529,2023-08-04,1012,Body Lotion,200,400,200,1,00484,India
381529,2023-08-04,1002,Mascara,200,400,200,1,00484,India
881823,2023-08-04,1003,Foundation,300,600,300,1,00108,India
881823,2023-08-04,1002,Mascara,200,400,200,1,00108,India
866639,2023-08-04,1008,Makeup Remover,80,160,80,1,00399,India
866639,2023-08-04,1004,Eyeliner,100,200,100,1,00399,India
866639,2023-08-04,1003,Foundation,300,600,300,1,00399,India
866639,2023-08-04,1007,Eyeshadow,200,400,200,1,00399,India
352248,2023-08-04,1003,Foundation,300,600,300,1,00415,India
352248,2023-08-04,1005,Nail Polish,50,100,50,1,00415,India
331194,2023-08-04,1006,Blush,150,300,150,1,00187,India
331194,2023-08-04,1007,Eyeshadow,200,400,200,1,00187,India
331194,2023-08-04,1002,Mascara,200,400,200,1,00187,India
331194,2023-08-04,1001,Lipstick,150,300,150,1,00187,India
168339,2023-08-04,1008,Makeup Remover,80,160,80,1,00115,India
168339,2023-08-04,1012,Body Lotion,200,400,200,1,00115,India
868441,2023-08-04,1007,Eyeshadow,200,400,200,1,00138,India
868441,2023-08-04,1009,Moisturizer,250,500,250,1,00138,India
954990,2023-08-04,1002,Mascara,200,400,200,1,00162,India
954990,2023-08-04,1012,Body Lotion,200,400,200,1,00162,India
954990,2023-08-04,1007,Eyeshadow,200,400,200,1,00162,India
604824,2023-08-04,1004,Eyeliner,100,200,100,1,00302,India
604824,2023-08-04,1002,Mascara,200,400,200,1,00302,India
604824,2023-08-04,1003,Foundation,300,600,300,1,00302,India
825857,2023-08-04,1008,Makeup Remover,80,160,80,1,00020,India
892959,2023-08-04,1012,Body Lotion,200,400,200,1,00151,India
892959,2023-08-04,1008,Makeup Remover,80,160,80,1,00151,India
419177,2023-08-04,1001,Lipstick,150,300,150,1,00099,India
791529,2023-08-04,1002,Mascara,200,400,200,1,00063,India
791529,2023-08-04,1007,Eyeshadow,200,400,200,1,00063,India
791529,2023-08-04,1005,Nail Polish,50,100,50,1,00063,India
109881,2023-08-04,1008,Makeup Remover,80,160,80,1,00032,India
109881,2023-08-04,1005,Nail Polish,50,100,50,1,00032,India
109881,2023-08-04,1012,Body Lotion,200,400,200,1,00032,India
109881,2023-08-04,1001,Lipstick,150,300,150,1,00032,India
987243,2023-08-05,1012,Body Lotion,200,400,200,1,00307,India
447821,2023-08-05,1007,Eyeshadow,200,400,200,1,00029,India
863304,2023-08-05,1002,Mascara,200,400,200,1,00209,India
863304,2023-08-05,1006,Blush,150,300,150,1,00209,India
863304,2023-08-05,1008,Makeup Remover,80,160,80,1,00209,India
863304,2023-08-05,1007,Eyeshadow,200,400,200,1,00209,India
613017,2023-08-05,1001,Lipstick,150,300,150,1,00177,India
613017,2023-08-05,1009,Moisturizer,250,500,250,1,00177,India
917686,2023-08-05,1002,Mascara,200,400,200,1,00219,India
917686,2023-08-05,1009,Moisturizer,250,500,250,1,00219,India
217867,2023-08-05,1005,Nail Polish,50,100,50,1,00037,India
217867,2023-08-05,1012,Body Lotion,200,400,200,1,00037,India
604594,2023-08-05,1004,Eyeliner,100,200,100,1,00116,India
730797,2023-08-05,1001,Lipstick,150,300,150,1,00252,India
730797,2023-08-05,1003,Foundation,300,600,300,1,00252,India
730797,2023-08-05,1008,Makeup Remover,80,160,80,1,00252,India
730797,2023-08-05,1009,Moisturizer,250,500,250,1,00252,India
455336,2023-08-05,1001,Lipstick,150,300,150,1,00065,India
889995,2023-08-05,1001,Lipstick,150,300,150,1,00243,India
889995,2023-08-05,1002,Mascara,200,400,200,1,00243,India
889995,2023-08-05,1008,Makeup Remover,80,160,80,1,00243,India
372655,2023-08-05,1009,Moisturizer,250,500,250,1,00074,India
175799,2023-08-05,1008,Makeup Remover,80,160,80,1,00044,India
175799,2023-08-05,1005,Nail Polish,50,100,50,1,00044,India
175799,2023-08-05,1004,Eyeliner,100,200,100,1,00044,India
294988,2023-08-05,1012,Body Lotion,200,400,200,1,00437,India
294988,2023-08-05,1006,Blush,150,300,150,1,00437,India
294988,2023-08-05,1005,Nail Polish,50,100,50,1,00437,India
294988,2023-08-05,1007,Eyeshadow,200,400,200,1,00437,India
682460,2023-08-05,1002,Mascara,200,400,200,1,00197,India
682460,2023-08-05,1004,Eyeliner,100,200,100,1,00197,India
682460,2023-08-05,1005,Nail Polish,50,100,50,1,00197,India
682460,2023-08-05,1007,Eyeshadow,200,400,200,1,00197,India
682460,2023-08-05,1009,Moisturizer,250,500,250,1,00197,India
660207,2023-08-05,1007,Eyeshadow,200,400,200,1,00424,India
660207,2023-08-05,1003,Foundation,300,600,300,1,00424,India
864942,2023-08-05,1001,Lipstick,150,300,150,1,00059,India
864942,2023-08-05,1009,Moisturizer,250,500,250,1,00059,India
864942,2023-08-05,1007,Eyeshadow,200,400,200,1,00059,India
864942,2023-08-05,1005,Nail Polish,50,100,50,1,00059,India
358861,2023-08-05,1005,Nail Polish,50,100,50,1,00370,India
358861,2023-08-05,1003,Foundation,300,600,300,1,00370,India
358861,2023-08-05,1001,Lipstick,150,300,150,1,00370,India
358861,2023-08-05,1012,Body Lotion,200,400,200,1,00370,India
145672,2023-08-05,1009,Moisturizer,250,500,250,1,00111,India
145672,2023-08-05,1012,Body Lotion,200,400,200,1,00111,India
567933,2023-08-05,1009,Moisturizer,250,500,250,1,00006,India
887447,2023-08-05,1005,Nail Polish,50,100,50,1,00276,India
887447,2023-08-05,1001,Lipstick,150,300,150,1,00276,India
887447,2023-08-05,1006,Blush,150,300,150,1,00276,India
127725,2023-08-05,1003,Foundation,300,600,300,1,00017,India
127725,2023-08-05,1007,Eyeshadow,200,400,200,1,00017,India
778328,2023-08-05,1008,Makeup Remover,80,160,80,1,00006,India
322519,2023-08-05,1006,Blush,150,300,150,1,00158,India
322519,2023-08-05,1004,Eyeliner,100,200,100,1,00158,India
322519,2023-08-05,1007,Eyeshadow,200,400,200,1,00158,India
322519,2023-08-05,1008,Makeup Remover,80,160,80,1,00158,India
671566,2023-08-05,1009,Moisturizer,250,500,250,1,00356,India
768277,2023-08-05,1005,Nail Polish,50,100,50,1,00320,India
768277,2023-08-05,1012,Body Lotion,200,400,200,1,00320,India
768277,2023-08-05,1001,Lipstick,150,300,150,1,00320,India
768277,2023-08-05,1003,Foundation,300,600,300,1,00320,India
692971,2023-08-05,1009,Moisturizer,250,500,250,1,00135,India
692971,2023-08-05,1007,Eyeshadow,200,400,200,1,00135,India
692971,2023-08-05,1004,Eyeliner,100,200,100,1,00135,India
127786,2023-08-05,1006,Blush,150,300,150,1,00062,India
447804,2023-08-05,1008,Makeup Remover,80,160,80,1,00258,India
104484,2023-08-05,1006,Blush,150,300,150,1,00046,India
104484,2023-08-05,1005,Nail Polish,50,100,50,1,00046,India
104484,2023-08-05,1008,Makeup Remover,80,160,80,1,00046,India
888032,2023-08-05,1005,Nail Polish,50,100,50,1,00488,India
888032,2023-08-05,1003,Foundation,300,600,300,1,00488,India
888032,2023-08-05,1009,Moisturizer,250,500,250,1,00488,India
226920,2023-08-05,1002,Mascara,200,400,200,1,00024,India
226920,2023-08-05,1004,Eyeliner,100,200,100,1,00024,India
226920,2023-08-05,1005,Nail Polish,50,100,50,1,00024,India
697689,2023-08-05,1002,Mascara,200,400,200,1,00277,India
697689,2023-08-05,1001,Lipstick,150,300,150,1,00277,India
697689,2023-08-05,1004,Eyeliner,100,200,100,1,00277,India
550071,2023-08-06,1007,Eyeshadow,200,400,200,1,00060,India
550071,2023-08-06,1006,Blush,150,300,150,1,00060,India
550071,2023-08-06,1002,Mascara,200,400,200,1,00060,India
634389,2023-08-06,1001,Lipstick,150,300,150,1,00099,India
148382,2023-08-06,1012,Body Lotion,200,400,200,1,00133,India
148382,2023-08-06,1004,Eyeliner,100,200,100,1,00133,India
148382,2023-08-06,1001,Lipstick,150,300,150,1,00133,India
552545,2023-08-06,1002,Mascara,200,400,200,1,00153,India
552545,2023-08-06,1012,Body Lotion,200,400,200,1,00153,India
546907,2023-08-06,1007,Eyeshadow,200,400,200,1,00113,India
904745,2023-08-06,1009,Moisturizer,250,500,250,1,00297,India
904745,2023-08-06,1002,Mascara,200,400,200,1,00297,India
671566,2023-08-06,1012,Body Lotion,200,400,200,1,00356,India
671566,2023-08-06,1007,Eyeshadow,200,400,200,1,00356,India
671566,2023-08-06,1009,Moisturizer,250,500,250,1,00356,India
352707,2023-08-06,1005,Nail Polish,50,100,50,1,00182,India
352707,2023-08-06,1003,Foundation,300,600,300,1,00182,India
761000,2023-08-06,1005,Nail Polish,50,100,50,1,00246,India
761000,2023-08-06,1003,Foundation,300,600,300,1,00246,India
762413,2023-08-06,1009,Moisturizer,250,500,250,1,00277,India
762413,2023-08-06,1006,Blush,150,300,150,1,00277,India
762413,2023-08-06,1002,Mascara,200,400,200,1,00277,India
468806,2023-08-06,1003,Foundation,300,600,300,1,00471,India
468806,2023-08-06,1001,Lipstick,150,300,150,1,00471,India
509519,2023-08-06,1005,Nail Polish,50,100,50,1,00173,India
174913,2023-08-06,1007,Eyeshadow,200,400,200,1,00257,India
785194,2023-08-06,1007,Eyeshadow,200,400,200,1,00157,India
785194,2023-08-06,1005,Nail Polish,50,100,50,1,00157,India
785194,2023-08-06,1008,Makeup Remover,80,160,80,1,00157,India
785194,2023-08-06,1004,Eyeliner,100,200,100,1,00157,India
626085,2023-08-06,1008,Makeup Remover,80,160,80,1,00284,India
626085,2023-08-06,1003,Foundation,300,600,300,1,00284,India
626085,2023-08-06,1006,Blush,150,300,150,1,00284,India
626085,2023-08-06,1001,Lipstick,150,300,150,1,00284,India
135462,2023-08-06,1001,Lipstick,150,300,150,1,00167,India
815374,2023-08-06,1004,Eyeliner,100,200,100,1,00449,India
815374,2023-08-06,1012,Body Lotion,200,400,200,1,00449,India
815374,2023-08-06,1002,Mascara,200,400,200,1,00449,India
936168,2023-08-06,1001,Lipstick,150,300,150,1,00392,India
936168,2023-08-06,1003,Foundation,300,600,300,1,00392,India
936168,2023-08-06,1002,Mascara,200,400,200,1,00392,India
936168,2023-08-06,1012,Body Lotion,200,400,200,1,00392,India
819728,2023-08-06,1005,Nail Polish,50,100,50,1,00483,India
819728,2023-08-06,1008,Makeup Remover,80,160,80,1,00483,India
819728,2023-08-06,1003,Foundation,300,600,300,1,00483,India
819728,2023-08-06,1006,Blush,150,300,150,1,00483,India
397218,2023-08-06,1004,Eyeliner,100,200,100,1,00369,India
397218,2023-08-06,1008,Makeup Remover,80,160,80,1,00369,India
397218,2023-08-06,1001,Lipstick,150,300,150,1,00369,India
397218,2023-08-06,1009,Moisturizer,250,500,250,1,00369,India
904076,2023-08-06,1004,Eyeliner,100,200,100,1,00084,India
904076,2023-08-06,1006,Blush,150,300,150,1,00084,India
904076,2023-08-06,1005,Nail Polish,50,100,50,1,00084,India
397256,2023-08-06,1004,Eyeliner,100,200,100,1,00211,India
786859,2023-08-06,1007,Eyeshadow,200,400,200,1,00164,India
786859,2023-08-06,1001,Lipstick,150,300,150,1,00164,India
807413,2023-08-06,1007,Eyeshadow,200,400,200,1,00362,India
807413,2023-08-06,1003,Foundation,300,600,300,1,00362,India
179484,2023-08-06,1002,Mascara,200,400,200,1,00150,India
179484,2023-08-06,1009,Moisturizer,250,500,250,1,00150,India
179484,2023-08-06,1004,Eyeliner,100,200,100,1,00150,India
179484,2023-08-06,1006,Blush,150,300,150,1,00150,India
667263,2023-08-06,1008,Makeup Remover,80,160,80,1,00075,India
667263,2023-08-06,1005,Nail Polish,50,100,50,1,00075,India
667263,2023-08-06,1003,Foundation,300,600,300,1,00075,India
302178,2023-08-06,1006,Blush,150,300,150,1,00321,India
552020,2023-08-06,1012,Body Lotion,200,400,200,1,00378,India
552020,2023-08-06,1004,Eyeliner,100,200,100,1,00378,India
552020,2023-08-06,1003,Foundation,300,600,300,1,00378,India
552020,2023-08-06,1007,Eyeshadow,200,400,200,1,00378,India
855598,2023-08-06,1008,Makeup Remover,80,160,80,1,00236,India
855598,2023-08-06,1001,Lipstick,150,300,150,1,00236,India
592924,2023-08-06,1005,Nail Polish,50,100,50,1,00411,India
592924,2023-08-06,1001,Lipstick,150,300,150,1,00411,India
592924,2023-08-06,1004,Eyeliner,100,200,100,1,00411,India
517797,2023-08-06,1001,Lipstick,150,300,150,1,00086,India
106688,2023-08-06,1007,Eyeshadow,200,400,200,1,00050,India
106688,2023-08-06,1001,Lipstick,150,300,150,1,00050,India
256202,2023-08-06,1001,Lipstick,150,300,150,1,00270,India
256202,2023-08-06,1009,Moisturizer,250,500,250,1,00270,India
104415,2023-08-06,1005,Nail Polish,50,100,50,1,00245,India
380765,2023-08-06,1006,Blush,150,300,150,1,00475,India
380765,2023-08-06,1004,Eyeliner,100,200,100,1,00475,India
380765,2023-08-06,1001,Lipstick,150,300,150,1,00475,India
498429,2023-08-06,1002,Mascara,200,400,200,1,00072,India
498429,2023-08-06,1004,Eyeliner,100,200,100,1,00072,India
498429,2023-08-06,1003,Foundation,300,600,300,1,00072,India
965656,2023-08-06,1008,Makeup Remover,80,160,80,1,00274,India
182719,2023-08-06,1007,Eyeshadow,200,400,200,1,00442,India
182719,2023-08-06,1005,Nail Polish,50,100,50,1,00442,India
182719,2023-08-06,1003,Foundation,300,600,300,1,00442,India
898931,2023-08-06,1001,Lipstick,150,300,150,1,00093,India
898931,2023-08-06,1012,Body Lotion,200,400,200,1,00093,India
898931,2023-08-06,1009,Moisturizer,250,500,250,1,00093,India
898931,2023-08-06,1005,Nail Polish,50,100,50,1,00093,India
412471,2023-08-06,1002,Mascara,200,400,200,1,00494,India
412471,2023-08-06,1005,Nail Polish,50,100,50,1,00494,India
412471,2023-08-06,1001,Lipstick,150,300,150,1,00494,India
573637,2023-08-06,1006,Blush,150,300,150,1,00480,India
573637,2023-08-06,1004,Eyeliner,100,200,100,1,00480,India
573637,2023-08-06,1012,Body Lotion,200,400,200,1,00480,India
573637,2023-08-06,1008,Makeup Remover,80,160,80,1,00480,India
496095,2023-08-06,1006,Blush,150,300,150,1,00081,India
496095,2023-08-06,1012,Body Lotion,200,400,200,1,00081,India
496095,2023-08-06,1004,Eyeliner,100,200,100,1,00081,India
496095,2023-08-06,1007,Eyeshadow,200,400,200,1,00081,India
496095,2023-08-06,1002,Mascara,200,400,200,1,00081,India
373746,2023-08-06,1008,Makeup Remover,80,160,80,1,00113,India
373746,2023-08-06,1004,Eyeliner,100,200,100,1,00113,India
373746,2023-08-06,1012,Body Lotion,200,400,200,1,00113,India
373746,2023-08-06,1001,Lipstick,150,300,150,1,00113,India
373746,2023-08-06,1002,Mascara,200,400,200,1,00113,India
870074,2023-08-06,1007,Eyeshadow,200,400,200,1,00093,India
413227,2023-08-06,1012,Body Lotion,200,400,200,1,00444,India
413227,2023-08-06,1007,Eyeshadow,200,400,200,1,00444,India
413227,2023-08-06,1008,Makeup Remover,80,160,80,1,00444,India
413227,2023-08-06,1009,Moisturizer,250,500,250,1,00444,India
205407,2023-08-06,1002,Mascara,200,400,200,1,00211,India
205407,2023-08-06,1003,Foundation,300,600,300,1,00211,India
205407,2023-08-06,1008,Makeup Remover,80,160,80,1,00211,India
662003,2023-08-06,1009,Moisturizer,250,500,250,1,00157,India
662003,2023-08-06,1006,Blush,150,300,150,1,00157,India
331310,2023-08-07,1002,Mascara,200,400,200,1,00243,India
159169,2023-08-07,1001,Lipstick,150,300,150,1,00049,India
162790,2023-08-07,1012,Body Lotion,200,400,200,1,00336,India
162790,2023-08-07,1009,Moisturizer,250,500,250,1,00336,India
162790,2023-08-07,1001,Lipstick,150,300,150,1,00336,India
427916,2023-08-07,1009,Moisturizer,250,500,250,1,00203,India
427916,2023-08-07,1005,Nail Polish,50,100,50,1,00203,India
427916,2023-08-07,1012,Body Lotion,200,400,200,1,00203,India
427916,2023-08-07,1001,Lipstick,150,300,150,1,00203,India
466436,2023-08-07,1003,Foundation,300,600,300,1,00371,India
466436,2023-08-07,1008,Makeup Remover,80,160,80,1,00371,India
466436,2023-08-07,1006,Blush,150,300,150,1,00371,India
466436,2023-08-07,1001,Lipstick,150,300,150,1,00371,India
371508,2023-08-07,1002,Mascara,200,400,200,1,00134,India
371508,2023-08-07,1001,Lipstick,150,300,150,1,00134,India
236058,2023-08-07,1003,Foundation,300,600,300,1,00328,India
236058,2023-08-07,1005,Nail Polish,50,100,50,1,00328,India
140561,2023-08-07,1008,Makeup Remover,80,160,80,1,00251,India
140561,2023-08-07,1004,Eyeliner,100,200,100,1,00251,India
815806,2023-08-07,1012,Body Lotion,200,400,200,1,00265,India
815806,2023-08-07,1006,Blush,150,300,150,1,00265,India
929642,2023-08-07,1002,Mascara,200,400,200,1,00458,India
929642,2023-08-07,1012,Body Lotion,200,400,200,1,00458,India
984622,2023-08-07,1008,Makeup Remover,80,160,80,1,00322,India
984622,2023-08-07,1002,Mascara,200,400,200,1,00322,India
984622,2023-08-07,1009,Moisturizer,250,500,250,1,00322,India
984622,2023-08-07,1006,Blush,150,300,150,1,00322,India
813370,2023-08-07,1009,Moisturizer,250,500,250,1,00091,India
813370,2023-08-07,1005,Nail Polish,50,100,50,1,00091,India
109960,2023-08-07,1009,Moisturizer,250,500,250,1,00396,India
109960,2023-08-07,1004,Eyeliner,100,200,100,1,00396,India
109960,2023-08-07,1012,Body Lotion,200,400,200,1,00396,India
109960,2023-08-07,1006,Blush,150,300,150,1,00396,India
999068,2023-08-07,1003,Foundation,300,600,300,1,00085,India
999068,2023-08-07,1008,Makeup Remover,80,160,80,1,00085,India
999068,2023-08-07,1012,Body Lotion,200,400,200,1,00085,India
999068,2023-08-07,1001,Lipstick,150,300,150,1,00085,India
999068,2023-08-07,1007,Eyeshadow,200,400,200,1,00085,India
969699,2023-08-07,1008,Makeup Remover,80,160,80,1,00122,India
121328,2023-08-07,1009,Moisturizer,250,500,250,1,00358,India
121328,2023-08-07,1005,Nail Polish,50,100,50,1,00358,India
330410,2023-08-07,1007,Eyeshadow,200,400,200,1,00291,India
330410,2023-08-07,1012,Body Lotion,200,400,200,1,00291,India
816025,2023-08-07,1003,Foundation,300,600,300,1,00492,India
345772,2023-08-07,1004,Eyeliner,100,200,100,1,00379,India
345772,2023-08-07,1006,Blush,150,300,150,1,00379,India
345772,2023-08-07,1009,Moisturizer,250,500,250,1,00379,India
345772,2023-08-07,1002,Mascara,200,400,200,1,00379,India
182959,2023-08-07,1012,Body Lotion,200,400,200,1,00427,India
182959,2023-08-07,1009,Moisturizer,250,500,250,1,00427,India
182959,2023-08-07,1004,Eyeliner,100,200,100,1,00427,India
648760,2023-08-07,1012,Body Lotion,200,400,200,1,00241,India
648760,2023-08-07,1009,Moisturizer,250,500,250,1,00241,India
648760,2023-08-07,1007,Eyeshadow,200,400,200,1,00241,India
648760,2023-08-07,1001,Lipstick,150,300,150,1,00241,India
635339,2023-08-07,1003,Foundation,300,600,300,1,00422,India
635339,2023-08-07,1005,Nail Polish,50,100,50,1,00422,India
450229,2023-08-07,1004,Eyeliner,100,200,100,1,00301,India
450229,2023-08-07,1001,Lipstick,150,300,150,1,00301,India
450229,2023-08-07,1003,Foundation,300,600,300,1,00301,India
450229,2023-08-07,1009,Moisturizer,250,500,250,1,00301,India
696254,2023-08-07,1012,Body Lotion,200,400,200,1,00027,India
696254,2023-08-07,1009,Moisturizer,250,500,250,1,00027,India
750159,2023-08-07,1012,Body Lotion,200,400,200,1,00487,India
750159,2023-08-07,1008,Makeup Remover,80,160,80,1,00487,India
750159,2023-08-07,1006,Blush,150,300,150,1,00487,India
750159,2023-08-07,1003,Foundation,300,600,300,1,00487,India
999909,2023-08-07,1003,Foundation,300,600,300,1,00032,India
999909,2023-08-07,1001,Lipstick,150,300,150,1,00032,India
717061,2023-08-07,1012,Body Lotion,200,400,200,1,00032,India
717061,2023-08-07,1005,Nail Polish,50,100,50,1,00032,India
812590,2023-08-07,1012,Body Lotion,200,400,200,1,00152,India
812590,2023-08-07,1002,Mascara,200,400,200,1,00152,India
812590,2023-08-07,1001,Lipstick,150,300,150,1,00152,India
354588,2023-08-07,1002,Mascara,200,400,200,1,00425,India
354588,2023-08-07,1004,Eyeliner,100,200,100,1,00425,India
354588,2023-08-07,1001,Lipstick,150,300,150,1,00425,India
354588,2023-08-07,1005,Nail Polish,50,100,50,1,00425,India
858479,2023-08-07,1002,Mascara,200,400,200,1,00327,India
206109,2023-08-07,1002,Mascara,200,400,200,1,00379,India
206109,2023-08-07,1003,Foundation,300,600,300,1,00379,India
206109,2023-08-07,1006,Blush,150,300,150,1,00379,India
102183,2023-08-07,1008,Makeup Remover,80,160,80,1,00200,India
102183,2023-08-07,1012,Body Lotion,200,400,200,1,00200,India
102183,2023-08-07,1009,Moisturizer,250,500,250,1,00200,India
307392,2023-08-07,1001,Lipstick,150,300,150,1,00133,India
475093,2023-08-07,1008,Makeup Remover,80,160,80,1,00301,India
475093,2023-08-07,1009,Moisturizer,250,500,250,1,00301,India
475093,2023-08-07,1002,Mascara,200,400,200,1,00301,India
475093,2023-08-07,1007,Eyeshadow,200,400,200,1,00301,India
465967,2023-08-08,1001,Lipstick,150,300,150,1,00354,India
576937,2023-08-08,1003,Foundation,300,600,300,1,00010,India
576937,2023-08-08,1012,Body Lotion,200,400,200,1,00010,India
576937,2023-08-08,1002,Mascara,200,400,200,1,00010,India
300669,2023-08-08,1012,Body Lotion,200,400,200,1,00362,India
300669,2023-08-08,1004,Eyeliner,100,200,100,1,00362,India
300669,2023-08-08,1002,Mascara,200,400,200,1,00362,India
720614,2023-08-08,1004,Eyeliner,100,200,100,1,00120,India
139776,2023-08-08,1004,Eyeliner,100,200,100,1,00359,India
800257,2023-08-08,1004,Eyeliner,100,200,100,1,00137,India
800257,2023-08-08,1008,Makeup Remover,80,160,80,1,00137,India
416113,2023-08-08,1009,Moisturizer,250,500,250,1,00151,India
416113,2023-08-08,1007,Eyeshadow,200,400,200,1,00151,India
416113,2023-08-08,1001,Lipstick,150,300,150,1,00151,India
764535,2023-08-08,1009,Moisturizer,250,500,250,1,00071,India
764535,2023-08-08,1004,Eyeliner,100,200,100,1,00071,India
764535,2023-08-08,1006,Blush,150,300,150,1,00071,India
617296,2023-08-08,1005,Nail Polish,50,100,50,1,00423,India
362172,2023-08-08,1003,Foundation,300,600,300,1,00418,India
767539,2023-08-08,1008,Makeup Remover,80,160,80,1,00073,India
767539,2023-08-08,1004,Eyeliner,100,200,100,1,00073,India
767539,2023-08-08,1006,Blush,150,300,150,1,00073,India
767539,2023-08-08,1007,Eyeshadow,200,400,200,1,00073,India
506793,2023-08-08,1012,Body Lotion,200,400,200,1,00323,India
506793,2023-08-08,1009,Moisturizer,250,500,250,1,00323,India
677601,2023-08-08,1001,Lipstick,150,300,150,1,00159,India
677601,2023-08-08,1004,Eyeliner,100,200,100,1,00159,India
461614,2023-08-08,1004,Eyeliner,100,200,100,1,00329,India
461614,2023-08-08,1009,Moisturizer,250,500,250,1,00329,India
461614,2023-08-08,1001,Lipstick,150,300,150,1,00329,India
314522,2023-08-08,1009,Moisturizer,250,500,250,1,00071,India
223085,2023-08-08,1002,Mascara,200,400,200,1,00176,India
223085,2023-08-08,1006,Blush,150,300,150,1,00176,India
220399,2023-08-08,1003,Foundation,300,600,300,1,00219,India
220399,2023-08-08,1004,Eyeliner,100,200,100,1,00219,India
220399,2023-08-08,1012,Body Lotion,200,400,200,1,00219,India
220399,2023-08-08,1009,Moisturizer,250,500,250,1,00219,India
800273,2023-08-08,1009,Moisturizer,250,500,250,1,00212,India
800273,2023-08-08,1007,Eyeshadow,200,400,200,1,00212,India
800273,2023-08-08,1001,Lipstick,150,300,150,1,00212,India
814546,2023-08-08,1007,Eyeshadow,200,400,200,1,00332,India
814546,2023-08-08,1003,Foundation,300,600,300,1,00332,India
814546,2023-08-08,1008,Makeup Remover,80,160,80,1,00332,India
185174,2023-08-08,1002,Mascara,200,400,200,1,00172,India
185174,2023-08-08,1001,Lipstick,150,300,150,1,00172,India
497340,2023-08-08,1004,Eyeliner,100,200,100,1,00282,India
523447,2023-08-08,1012,Body Lotion,200,400,200,1,00442,India
425788,2023-08-08,1009,Moisturizer,250,500,250,1,00306,India
425788,2023-08-08,1007,Eyeshadow,200,400,200,1,00306,India
425788,2023-08-08,1012,Body Lotion,200,400,200,1,00306,India
594730,2023-08-08,1008,Makeup Remover,80,160,80,1,00195,India
594730,2023-08-08,1012,Body Lotion,200,400,200,1,00195,India
594730,2023-08-08,1003,Foundation,300,600,300,1,00195,India
597793,2023-08-08,1003,Foundation,300,600,300,1,00188,India
597793,2023-08-08,1007,Eyeshadow,200,400,200,1,00188,India
654003,2023-08-08,1001,Lipstick,150,300,150,1,00179,India
654003,2023-08-08,1005,Nail Polish,50,100,50,1,00179,India
654003,2023-08-08,1007,Eyeshadow,200,400,200,1,00179,India
479602,2023-08-08,1009,Moisturizer,250,500,250,1,00044,India
479602,2023-08-08,1005,Nail Polish,50,100,50,1,00044,India
479602,2023-08-08,1012,Body Lotion,200,400,200,1,00044,India
210133,2023-08-08,1006,Blush,150,300,150,1,00040,India
210133,2023-08-08,1008,Makeup Remover,80,160,80,1,00040,India
210133,2023-08-08,1002,Mascara,200,400,200,1,00040,India
980672,2023-08-08,1001,Lipstick,150,300,150,1,00027,India
980672,2023-08-08,1005,Nail Polish,50,100,50,1,00027,India
980672,2023-08-08,1006,Blush,150,300,150,1,00027,India
980672,2023-08-08,1009,Moisturizer,250,500,250,1,00027,India
391904,2023-08-08,1007,Eyeshadow,200,400,200,1,00057,India
391904,2023-08-08,1008,Makeup Remover,80,160,80,1,00057,India
123849,2023-08-08,1002,Mascara,200,400,200,1,00438,India
123849,2023-08-08,1005,Nail Polish,50,100,50,1,00438,India
123849,2023-08-08,1004,Eyeliner,100,200,100,1,00438,India
662802,2023-08-08,1003,Foundation,300,600,300,1,00358,India
131860,2023-08-08,1007,Eyeshadow,200,400,200,1,00433,India
131860,2023-08-08,1009,Moisturizer,250,500,250,1,00433,India
619293,2023-08-09,1007,Eyeshadow,200,400,200,1,00247,India
619293,2023-08-09,1003,Foundation,300,600,300,1,00247,India
619293,2023-08-09,1005,Nail Polish,50,100,50,1,00247,India
839863,2023-08-09,1001,Lipstick,150,300,150,1,00043,India
839863,2023-08-09,1004,Eyeliner,100,200,100,1,00043,India
839863,2023-08-09,1007,Eyeshadow,200,400,200,1,00043,India
839863,2023-08-09,1009,Moisturizer,250,500,250,1,00043,India
578792,2023-08-09,1008,Makeup Remover,80,160,80,1,00346,India
578792,2023-08-09,1003,Foundation,300,600,300,1,00346,India
561049,2023-08-09,1012,Body Lotion,200,400,200,1,00208,India
561049,2023-08-09,1004,Eyeliner,100,200,100,1,00208,India
561049,2023-08-09,1003,Foundation,300,600,300,1,00208,India
953009,2023-08-09,1003,Foundation,300,600,300,1,00470,India
953009,2023-08-09,1006,Blush,150,300,150,1,00470,India
953009,2023-08-09,1004,Eyeliner,100,200,100,1,00470,India
684911,2023-08-09,1008,Makeup Remover,80,160,80,1,00370,India
684911,2023-08-09,1006,Blush,150,300,150,1,00370,India
684911,2023-08-09,1012,Body Lotion,200,400,200,1,00370,India
107708,2023-08-09,1004,Eyeliner,100,200,100,1,00452,India
888297,2023-08-09,1002,Mascara,200,400,200,1,00445,India
888297,2023-08-09,1004,Eyeliner,100,200,100,1,00445,India
888297,2023-08-09,1012,Body Lotion,200,400,200,1,00445,India
888297,2023-08-09,1006,Blush,150,300,150,1,00445,India
643017,2023-08-09,1012,Body Lotion,200,400,200,1,00174,India
643017,2023-08-09,1006,Blush,150,300,150,1,00174,India
643017,2023-08-09,1008,Makeup Remover,80,160,80,1,00174,India
693688,2023-08-09,1002,Mascara,200,400,200,1,00417,India
832297,2023-08-09,1001,Lipstick,150,300,150,1,00149,India
832297,2023-08-09,1003,Foundation,300,600,300,1,00149,India
832297,2023-08-09,1006,Blush,150,300,150,1,00149,India
832297,2023-08-09,1007,Eyeshadow,200,400,200,1,00149,India
239263,2023-08-09,1008,Makeup Remover,80,160,80,1,00073,India
239263,2023-08-09,1002,Mascara,200,400,200,1,00073,India
239263,2023-08-09,1009,Moisturizer,250,500,250,1,00073,India
343601,2023-08-09,1003,Foundation,300,600,300,1,00212,India
343601,2023-08-09,1009,Moisturizer,250,500,250,1,00212,India
343601,2023-08-09,1004,Eyeliner,100,200,100,1,00212,India
343601,2023-08-09,1007,Eyeshadow,200,400,200,1,00212,India
343601,2023-08-09,1012,Body Lotion,200,400,200,1,00212,India
726214,2023-08-09,1005,Nail Polish,50,100,50,1,00037,India
726214,2023-08-09,1008,Makeup Remover,80,160,80,1,00037,India
680551,2023-08-09,1006,Blush,150,300,150,1,00224,India
680551,2023-08-09,1007,Eyeshadow,200,400,200,1,00224,India
545597,2023-08-09,1009,Moisturizer,250,500,250,1,00145,India
545597,2023-08-09,1008,Makeup Remover,80,160,80,1,00145,India
798512,2023-08-09,1003,Foundation,300,600,300,1,00202,India
121258,2023-08-09,1001,Lipstick,150,300,150,1,00388,India
688444,2023-08-09,1004,Eyeliner,100,200,100,1,00130,India
470594,2023-08-09,1009,Moisturizer,250,500,250,1,00300,India
470594,2023-08-09,1008,Makeup Remover,80,160,80,1,00300,India
470594,2023-08-09,1007,Eyeshadow,200,400,200,1,00300,India
932886,2023-08-09,1005,Nail Polish,50,100,50,1,00250,India
932886,2023-08-09,1012,Body Lotion,200,400,200,1,00250,India
729362,2023-08-09,1005,Nail Polish,50,100,50,1,00412,India
474887,2023-08-09,1002,Mascara,200,400,200,1,00090,India
687233,2023-08-09,1003,Foundation,300,600,300,1,00413,India
293614,2023-08-09,1007,Eyeshadow,200,400,200,1,00119,India
293614,2023-08-09,1009,Moisturizer,250,500,250,1,00119,India
833513,2023-08-09,1001,Lipstick,150,300,150,1,00301,India
833513,2023-08-09,1003,Foundation,300,600,300,1,00301,India
833513,2023-08-09,1002,Mascara,200,400,200,1,00301,India
711142,2023-08-09,1004,Eyeliner,100,200,100,1,00277,India
145122,2023-08-09,1005,Nail Polish,50,100,50,1,00425,India
145122,2023-08-09,1003,Foundation,300,600,300,1,00425,India
145122,2023-08-09,1006,Blush,150,300,150,1,00425,India
145122,2023-08-09,1002,Mascara,200,400,200,1,00425,India
145122,2023-08-09,1001,Lipstick,150,300,150,1,00425,India
938646,2023-08-09,1002,Mascara,200,400,200,1,00358,India
938646,2023-08-09,1009,Moisturizer,250,500,250,1,00358,India
938646,2023-08-09,1005,Nail Polish,50,100,50,1,00358,India
807797,2023-08-09,1007,Eyeshadow,200,400,200,1,00287,India
807797,2023-08-09,1002,Mascara,200,400,200,1,00287,India
185124,2023-08-09,1007,Eyeshadow,200,400,200,1,00160,India
185124,2023-08-09,1008,Makeup Remover,80,160,80,1,00160,India
185124,2023-08-09,1004,Eyeliner,100,200,100,1,00160,India
185124,2023-08-09,1009,Moisturizer,250,500,250,1,00160,India
780086,2023-08-09,1001,Lipstick,150,300,150,1,00068,India
868266,2023-08-09,1005,Nail Polish,50,100,50,1,00372,India
868266,2023-08-09,1001,Lipstick,150,300,150,1,00372,India
868266,2023-08-09,1009,Moisturizer,250,500,250,1,00372,India
868266,2023-08-09,1006,Blush,150,300,150,1,00372,India
874440,2023-08-09,1006,Blush,150,300,150,1,00346,India
844445,2023-08-09,1002,Mascara,200,400,200,1,00003,India
844445,2023-08-09,1009,Moisturizer,250,500,250,1,00003,India
844445,2023-08-09,1005,Nail Polish,50,100,50,1,00003,India
587877,2023-08-09,1007,Eyeshadow,200,400,200,1,00239,India
587877,2023-08-09,1001,Lipstick,150,300,150,1,00239,India
587877,2023-08-09,1004,Eyeliner,100,200,100,1,00239,India
801473,2023-08-09,1006,Blush,150,300,150,1,00184,India
467806,2023-08-09,1012,Body Lotion,200,400,200,1,00081,India
666159,2023-08-10,1002,Mascara,200,400,200,1,00385,India
512596,2023-08-10,1002,Mascara,200,400,200,1,00456,India
697191,2023-08-10,1012,Body Lotion,200,400,200,1,00241,India
697191,2023-08-10,1008,Makeup Remover,80,160,80,1,00241,India
697191,2023-08-10,1007,Eyeshadow,200,400,200,1,00241,India
697191,2023-08-10,1009,Moisturizer,250,500,250,1,00241,India
562779,2023-08-10,1005,Nail Polish,50,100,50,1,00106,India
562779,2023-08-10,1006,Blush,150,300,150,1,00106,India
562779,2023-08-10,1009,Moisturizer,250,500,250,1,00106,India
562779,2023-08-10,1007,Eyeshadow,200,400,200,1,00106,India
910039,2023-08-10,1006,Blush,150,300,150,1,00261,India
873885,2023-08-10,1007,Eyeshadow,200,400,200,1,00496,India
873885,2023-08-10,1008,Makeup Remover,80,160,80,1,00496,India
873885,2023-08-10,1003,Foundation,300,600,300,1,00496,India
217876,2023-08-10,1006,Blush,150,300,150,1,00220,India
217876,2023-08-10,1009,Moisturizer,250,500,250,1,00220,India
217876,2023-08-10,1003,Foundation,300,600,300,1,00220,India
217876,2023-08-10,1008,Makeup Remover,80,160,80,1,00220,India
217876,2023-08-10,1004,Eyeliner,100,200,100,1,00220,India
493966,2023-08-10,1002,Mascara,200,400,200,1,00105,India
747591,2023-08-10,1002,Mascara,200,400,200,1,00425,India
747591,2023-08-10,1008,Makeup Remover,80,160,80,1,00425,India
747591,2023-08-10,1001,Lipstick,150,300,150,1,00425,India
629400,2023-08-10,1004,Eyeliner,100,200,100,1,00259,India
629400,2023-08-10,1006,Blush,150,300,150,1,00259,India
629400,2023-08-10,1007,Eyeshadow,200,400,200,1,00259,India
381219,2023-08-10,1012,Body Lotion,200,400,200,1,00302,India
381219,2023-08-10,1004,Eyeliner,100,200,100,1,00302,India
381219,2023-08-10,1001,Lipstick,150,300,150,1,00302,India
936103,2023-08-10,1004,Eyeliner,100,200,100,1,00242,India
936103,2023-08-10,1006,Blush,150,300,150,1,00242,India
936103,2023-08-10,1009,Moisturizer,250,500,250,1,00242,India
936103,2023-08-10,1005,Nail Polish,50,100,50,1,00242,India
571812,2023-08-10,1007,Eyeshadow,200,400,200,1,00150,India
571812,2023-08-10,1001,Lipstick,150,300,150,1,00150,India
571812,2023-08-10,1012,Body Lotion,200,400,200,1,00150,India
571812,2023-08-10,1006,Blush,150,300,150,1,00150,India
373479,2023-08-10,1008,Makeup Remover,80,160,80,1,00205,India
373479,2023-08-10,1001,Lipstick,150,300,150,1,00205,India
373479,2023-08-10,1007,Eyeshadow,200,400,200,1,00205,India
661786,2023-08-10,1003,Foundation,300,600,300,1,00268,India
661786,2023-08-10,1008,Makeup Remover,80,160,80,1,00268,India
586939,2023-08-10,1009,Moisturizer,250,500,250,1,00132,India
324973,2023-08-10,1005,Nail Polish,50,100,50,1,00150,India
324973,2023-08-10,1004,Eyeliner,100,200,100,1,00150,India
324973,2023-08-10,1003,Foundation,300,600,300,1,00150,India
679334,2023-08-10,1006,Blush,150,300,150,1,00041,India
679334,2023-08-10,1005,Nail Polish,50,100,50,1,00041,India
679334,2023-08-10,1012,Body Lotion,200,400,200,1,00041,India
679334,2023-08-10,1008,Makeup Remover,80,160,80,1,00041,India
679334,2023-08-10,1002,Mascara,200,400,200,1,00041,India
312368,2023-08-10,1012,Body Lotion,200,400,200,1,00094,India
312368,2023-08-10,1007,Eyeshadow,200,400,200,1,00094,India
350690,2023-08-10,1008,Makeup Remover,80,160,80,1,00041,India
350690,2023-08-10,1006,Blush,150,300,150,1,00041,India
350690,2023-08-10,1003,Foundation,300,600,300,1,00041,India
350690,2023-08-10,1001,Lipstick,150,300,150,1,00041,India
184849,2023-08-10,1001,Lipstick,150,300,150,1,00060,India
184849,2023-08-10,1003,Foundation,300,600,300,1,00060,India
184849,2023-08-10,1005,Nail Polish,50,100,50,1,00060,India
936913,2023-08-10,1002,Mascara,200,400,200,1,00073,India
936913,2023-08-10,1001,Lipstick,150,300,150,1,00073,India
936913,2023-08-10,1009,Moisturizer,250,500,250,1,00073,India
392784,2023-08-10,1008,Makeup Remover,80,160,80,1,00174,India
195972,2023-08-10,1008,Makeup Remover,80,160,80,1,00145,India
318335,2023-08-10,1008,Makeup Remover,80,160,80,1,00156,India
221008,2023-08-10,1003,Foundation,300,600,300,1,00108,India
221008,2023-08-10,1004,Eyeliner,100,200,100,1,00108,India
280816,2023-08-10,1001,Lipstick,150,300,150,1,00268,India
280816,2023-08-10,1005,Nail Polish,50,100,50,1,00268,India
926587,2023-08-10,1007,Eyeshadow,200,400,200,1,00033,India
498963,2023-08-10,1006,Blush,150,300,150,1,00390,India
523969,2023-08-10,1007,Eyeshadow,200,400,200,1,00351,India
523969,2023-08-10,1004,Eyeliner,100,200,100,1,00351,India
523969,2023-08-10,1002,Mascara,200,400,200,1,00351,India
523969,2023-08-10,1003,Foundation,300,600,300,1,00351,India
273694,2023-08-10,1004,Eyeliner,100,200,100,1,00479,India
273694,2023-08-10,1005,Nail Polish,50,100,50,1,00479,India
273694,2023-08-10,1007,Eyeshadow,200,400,200,1,00479,India
112971,2023-08-10,1008,Makeup Remover,80,160,80,1,00357,India
112971,2023-08-10,1003,Foundation,300,600,300,1,00357,India
112971,2023-08-10,1006,Blush,150,300,150,1,00357,India
201270,2023-08-10,1007,Eyeshadow,200,400,200,1,00410,India
201270,2023-08-10,1001,Lipstick,150,300,150,1,00410,India
201270,2023-08-10,1008,Makeup Remover,80,160,80,1,00410,India
201270,2023-08-10,1002,Mascara,200,400,200,1,00410,India
228717,2023-08-10,1003,Foundation,300,600,300,1,00277,India
802616,2023-08-10,1003,Foundation,300,600,300,1,00338,India
802616,2023-08-10,1002,Mascara,200,400,200,1,00338,India
802616,2023-08-10,1007,Eyeshadow,200,400,200,1,00338,India
802616,2023-08-10,1008,Makeup Remover,80,160,80,1,00338,India
818310,2023-08-10,1003,Foundation,300,600,300,1,00132,India
818310,2023-08-10,1005,Nail Polish,50,100,50,1,00132,India
690875,2023-08-10,1012,Body Lotion,200,400,200,1,00412,India
690875,2023-08-10,1001,Lipstick,150,300,150,1,00412,India
855908,2023-08-10,1006,Blush,150,300,150,1,00214,India
855908,2023-08-10,1003,Foundation,300,600,300,1,00214,India
855908,2023-08-10,1001,Lipstick,150,300,150,1,00214,India
763093,2023-08-11,1009,Moisturizer,250,500,250,1,00295,India
763093,2023-08-11,1012,Body Lotion,200,400,200,1,00295,India
574724,2023-08-11,1008,Makeup Remover,80,160,80,1,00389,India
574724,2023-08-11,1002,Mascara,200,400,200,1,00389,India
574724,2023-08-11,1001,Lipstick,150,300,150,1,00389,India
857555,2023-08-11,1007,Eyeshadow,200,400,200,1,00106,India
857555,2023-08-11,1002,Mascara,200,400,200,1,00106,India
857555,2023-08-11,1003,Foundation,300,600,300,1,00106,India
918877,2023-08-11,1006,Blush,150,300,150,1,00046,India
918877,2023-08-11,1008,Makeup Remover,80,160,80,1,00046,India
918877,2023-08-11,1001,Lipstick,150,300,150,1,00046,India
918877,2023-08-11,1007,Eyeshadow,200,400,200,1,00046,India
653269,2023-08-11,1009,Moisturizer,250,500,250,1,00209,India
653269,2023-08-11,1003,Foundation,300,600,300,1,00209,India
653269,2023-08-11,1002,Mascara,200,400,200,1,00209,India
333452,2023-08-11,1004,Eyeliner,100,200,100,1,00191,India
333452,2023-08-11,1007,Eyeshadow,200,400,200,1,00191,India
333452,2023-08-11,1001,Lipstick,150,300,150,1,00191,India
812550,2023-08-11,1008,Makeup Remover,80,160,80,1,00037,India
812550,2023-08-11,1005,Nail Polish,50,100,50,1,00037,India
812550,2023-08-11,1007,Eyeshadow,200,400,200,1,00037,India
812550,2023-08-11,1003,Foundation,300,600,300,1,00037,India
812550,2023-08-11,1006,Blush,150,300,150,1,00037,India
533596,2023-08-11,1002,Mascara,200,400,200,1,00026,India
533596,2023-08-11,1004,Eyeliner,100,200,100,1,00026,India
533596,2023-08-11,1007,Eyeshadow,200,400,200,1,00026,India
533596,2023-08-11,1005,Nail Polish,50,100,50,1,00026,India
576438,2023-08-11,1005,Nail Polish,50,100,50,1,00457,India
576438,2023-08-11,1009,Moisturizer,250,500,250,1,00457,India
576438,2023-08-11,1004,Eyeliner,100,200,100,1,00457,India
536776,2023-08-11,1012,Body Lotion,200,400,200,1,00100,India
536776,2023-08-11,1007,Eyeshadow,200,400,200,1,00100,India
536776,2023-08-11,1009,Moisturizer,250,500,250,1,00100,India
536776,2023-08-11,1003,Foundation,300,600,300,1,00100,India
536776,2023-08-11,1004,Eyeliner,100,200,100,1,00100,India
714398,2023-08-11,1012,Body Lotion,200,400,200,1,00380,India
714398,2023-08-11,1009,Moisturizer,250,500,250,1,00380,India
714398,2023-08-11,1001,Lipstick,150,300,150,1,00380,India
714398,2023-08-11,1005,Nail Polish,50,100,50,1,00380,India
714398,2023-08-11,1006,Blush,150,300,150,1,00380,India
741184,2023-08-11,1004,Eyeliner,100,200,100,1,00435,India
655827,2023-08-11,1001,Lipstick,150,300,150,1,00261,India
655827,2023-08-11,1009,Moisturizer,250,500,250,1,00261,India
655827,2023-08-11,1004,Eyeliner,100,200,100,1,00261,India
391847,2023-08-11,1006,Blush,150,300,150,1,00321,India
391847,2023-08-11,1001,Lipstick,150,300,150,1,00321,India
391847,2023-08-11,1004,Eyeliner,100,200,100,1,00321,India
448513,2023-08-11,1001,Lipstick,150,300,150,1,00212,India
216035,2023-08-11,1007,Eyeshadow,200,400,200,1,00184,India
216035,2023-08-11,1003,Foundation,300,600,300,1,00184,India
216035,2023-08-11,1009,Moisturizer,250,500,250,1,00184,India
216035,2023-08-11,1005,Nail Polish,50,100,50,1,00184,India
216035,2023-08-11,1006,Blush,150,300,150,1,00184,India
404518,2023-08-11,1009,Moisturizer,250,500,250,1,00409,India
404518,2023-08-11,1008,Makeup Remover,80,160,80,1,00409,India
404518,2023-08-11,1007,Eyeshadow,200,400,200,1,00409,India
354393,2023-08-11,1008,Makeup Remover,80,160,80,1,00460,India
386809,2023-08-11,1001,Lipstick,150,300,150,1,00020,India
386809,2023-08-11,1003,Foundation,300,600,300,1,00020,India
386809,2023-08-11,1009,Moisturizer,250,500,250,1,00020,India
367527,2023-08-11,1003,Foundation,300,600,300,1,00206,India
367527,2023-08-11,1006,Blush,150,300,150,1,00206,India
367527,2023-08-11,1004,Eyeliner,100,200,100,1,00206,India
649569,2023-08-11,1005,Nail Polish,50,100,50,1,00368,India
649569,2023-08-11,1008,Makeup Remover,80,160,80,1,00368,India
649569,2023-08-11,1003,Foundation,300,600,300,1,00368,India
450278,2023-08-11,1008,Makeup Remover,80,160,80,1,00162,India
450278,2023-08-11,1007,Eyeshadow,200,400,200,1,00162,India
161734,2023-08-11,1001,Lipstick,150,300,150,1,00100,India
161734,2023-08-11,1008,Makeup Remover,80,160,80,1,00100,India
161734,2023-08-11,1002,Mascara,200,400,200,1,00100,India
559987,2023-08-11,1008,Makeup Remover,80,160,80,1,00430,India
496408,2023-08-11,1005,Nail Polish,50,100,50,1,00367,India
496408,2023-08-11,1006,Blush,150,300,150,1,00367,India
752687,2023-08-11,1005,Nail Polish,50,100,50,1,00232,India
752687,2023-08-11,1001,Lipstick,150,300,150,1,00232,India
532412,2023-08-11,1009,Moisturizer,250,500,250,1,00095,India
532412,2023-08-11,1003,Foundation,300,600,300,1,00095,India
986792,2023-08-11,1003,Foundation,300,600,300,1,00130,India
986792,2023-08-11,1005,Nail Polish,50,100,50,1,00130,India
853623,2023-08-11,1005,Nail Polish,50,100,50,1,00442,India
853623,2023-08-11,1004,Eyeliner,100,200,100,1,00442,India
853623,2023-08-11,1012,Body Lotion,200,400,200,1,00442,India
925395,2023-08-11,1004,Eyeliner,100,200,100,1,00425,India
379490,2023-08-11,1001,Lipstick,150,300,150,1,00371,India
379490,2023-08-11,1004,Eyeliner,100,200,100,1,00371,India
379490,2023-08-11,1012,Body Lotion,200,400,200,1,00371,India
379490,2023-08-11,1007,Eyeshadow,200,400,200,1,00371,India
606783,2023-08-11,1006,Blush,150,300,150,1,00317,India
606783,2023-08-11,1012,Body Lotion,200,400,200,1,00317,India
606783,2023-08-11,1007,Eyeshadow,200,400,200,1,00317,India
445857,2023-08-11,1008,Makeup Remover,80,160,80,1,00211,India
696379,2023-08-11,1008,Makeup Remover,80,160,80,1,00347,India
529213,2023-08-11,1009,Moisturizer,250,500,250,1,00229,India
529213,2023-08-11,1008,Makeup Remover,80,160,80,1,00229,India
529213,2023-08-11,1004,Eyeliner,100,200,100,1,00229,India
529213,2023-08-11,1012,Body Lotion,200,400,200,1,00229,India
103180,2023-08-11,1003,Foundation,300,600,300,1,00168,India
103180,2023-08-11,1007,Eyeshadow,200,400,200,1,00168,India
394188,2023-08-11,1004,Eyeliner,100,200,100,1,00026,India
394188,2023-08-11,1008,Makeup Remover,80,160,80,1,00026,India
394188,2023-08-11,1006,Blush,150,300,150,1,00026,India
307698,2023-08-11,1001,Lipstick,150,300,150,1,00128,India
307698,2023-08-11,1002,Mascara,200,400,200,1,00128,India
307698,2023-08-11,1008,Makeup Remover,80,160,80,1,00128,India
307698,2023-08-11,1009,Moisturizer,250,500,250,1,00128,India
307698,2023-08-11,1012,Body Lotion,200,400,200,1,00128,India
950349,2023-08-11,1006,Blush,150,300,150,1,00168,India
950349,2023-08-11,1007,Eyeshadow,200,400,200,1,00168,India
580246,2023-08-11,1009,Moisturizer,250,500,250,1,00353,India
580246,2023-08-11,1006,Blush,150,300,150,1,00353,India
101662,2023-08-11,1004,Eyeliner,100,200,100,1,00006,India
101662,2023-08-11,1009,Moisturizer,250,500,250,1,00006,India
671666,2023-08-11,1009,Moisturizer,250,500,250,1,00112,India
671666,2023-08-11,1003,Foundation,300,600,300,1,00112,India
671666,2023-08-11,1004,Eyeliner,100,200,100,1,00112,India
671666,2023-08-11,1002,Mascara,200,400,200,1,00112,India
234920,2023-08-11,1004,Eyeliner,100,200,100,1,00092,India
234920,2023-08-11,1003,Foundation,300,600,300,1,00092,India
173637,2023-08-11,1002,Mascara,200,400,200,1,00207,India
173637,2023-08-11,1009,Moisturizer,250,500,250,1,00207,India
173637,2023-08-11,1005,Nail Polish,50,100,50,1,00207,India
687716,2023-08-11,1007,Eyeshadow,200,400,200,1,00052,India
687716,2023-08-11,1008,Makeup Remover,80,160,80,1,00052,India
806772,2023-08-11,1004,Eyeliner,100,200,100,1,00370,India
778561,2023-08-11,1002,Mascara,200,400,200,1,00224,India
284717,2023-08-11,1004,Eyeliner,100,200,100,1,00160,India
284717,2023-08-11,1012,Body Lotion,200,400,200,1,00160,India
284717,2023-08-11,1006,Blush,150,300,150,1,00160,India
977474,2023-08-12,1012,Body Lotion,200,400,200,1,00295,India
790543,2023-08-12,1008,Makeup Remover,80,160,80,1,00101,India
329951,2023-08-12,1004,Eyeliner,100,200,100,1,00474,India
329951,2023-08-12,1001,Lipstick,150,300,150,1,00474,India
329951,2023-08-12,1002,Mascara,200,400,200,1,00474,India
329951,2023-08-12,1005,Nail Polish,50,100,50,1,00474,India
216580,2023-08-12,1002,Mascara,200,400,200,1,00196,India
106247,2023-08-12,1008,Makeup Remover,80,160,80,1,00242,India
106247,2023-08-12,1007,Eyeshadow,200,400,200,1,00242,India
106247,2023-08-12,1009,Moisturizer,250,500,250,1,00242,India
106247,2023-08-12,1001,Lipstick,150,300,150,1,00242,India
532442,2023-08-12,1004,Eyeliner,100,200,100,1,00412,India
311412,2023-08-12,1004,Eyeliner,100,200,100,1,00294,India
311412,2023-08-12,1009,Moisturizer,250,500,250,1,00294,India
311412,2023-08-12,1012,Body Lotion,200,400,200,1,00294,India
932542,2023-08-12,1005,Nail Polish,50,100,50,1,00474,India
449489,2023-08-12,1007,Eyeshadow,200,400,200,1,00074,India
393859,2023-08-12,1005,Nail Polish,50,100,50,1,00456,India
393859,2023-08-12,1006,Blush,150,300,150,1,00456,India
393859,2023-08-12,1009,Moisturizer,250,500,250,1,00456,India
834141,2023-08-12,1005,Nail Polish,50,100,50,1,00392,India
834141,2023-08-12,1003,Foundation,300,600,300,1,00392,India
304918,2023-08-12,1005,Nail Polish,50,100,50,1,00178,India
304918,2023-08-12,1003,Foundation,300,600,300,1,00178,India
304918,2023-08-12,1008,Makeup Remover,80,160,80,1,00178,India
886161,2023-08-12,1003,Foundation,300,600,300,1,00390,India
176397,2023-08-12,1005,Nail Polish,50,100,50,1,00028,India
176397,2023-08-12,1003,Foundation,300,600,300,1,00028,India
176397,2023-08-12,1012,Body Lotion,200,400,200,1,00028,India
176397,2023-08-12,1009,Moisturizer,250,500,250,1,00028,India
512178,2023-08-12,1004,Eyeliner,100,200,100,1,00478,India
512178,2023-08-12,1002,Mascara,200,400,200,1,00478,India
512178,2023-08-12,1005,Nail Polish,50,100,50,1,00478,India
512178,2023-08-12,1012,Body Lotion,200,400,200,1,00478,India
792691,2023-08-12,1005,Nail Polish,50,100,50,1,00145,India
792691,2023-08-12,1009,Moisturizer,250,500,250,1,00145,India
792691,2023-08-12,1007,Eyeshadow,200,400,200,1,00145,India
792691,2023-08-12,1003,Foundation,300,600,300,1,00145,India
792691,2023-08-12,1008,Makeup Remover,80,160,80,1,00145,India
129974,2023-08-12,1004,Eyeliner,100,200,100,1,00330,India
519671,2023-08-12,1001,Lipstick,150,300,150,1,00284,India
519671,2023-08-12,1012,Body Lotion,200,400,200,1,00284,India
519671,2023-08-12,1005,Nail Polish,50,100,50,1,00284,India
598000,2023-08-12,1002,Mascara,200,400,200,1,00476,India
598000,2023-08-12,1008,Makeup Remover,80,160,80,1,00476,India
396671,2023-08-12,1005,Nail Polish,50,100,50,1,00073,India
396671,2023-08-12,1009,Moisturizer,250,500,250,1,00073,India
396671,2023-08-12,1003,Foundation,300,600,300,1,00073,India
266458,2023-08-12,1009,Moisturizer,250,500,250,1,00010,India
403871,2023-08-12,1009,Moisturizer,250,500,250,1,00394,India
926944,2023-08-12,1006,Blush,150,300,150,1,00315,India
771338,2023-08-12,1002,Mascara,200,400,200,1,00416,India
418328,2023-08-12,1003,Foundation,300,600,300,1,00287,India
418328,2023-08-12,1004,Eyeliner,100,200,100,1,00287,India
418328,2023-08-12,1008,Makeup Remover,80,160,80,1,00287,India
474544,2023-08-12,1002,Mascara,200,400,200,1,00183,India
474544,2023-08-12,1003,Foundation,300,600,300,1,00183,India
474544,2023-08-12,1008,Makeup Remover,80,160,80,1,00183,India
541338,2023-08-12,1001,Lipstick,150,300,150,1,00243,India
541338,2023-08-12,1006,Blush,150,300,150,1,00243,India
541338,2023-08-12,1012,Body Lotion,200,400,200,1,00243,India
541338,2023-08-12,1007,Eyeshadow,200,400,200,1,00243,India
492214,2023-08-12,1004,Eyeliner,100,200,100,1,00243,India
492214,2023-08-12,1006,Blush,150,300,150,1,00243,India
492214,2023-08-12,1007,Eyeshadow,200,400,200,1,00243,India
981235,2023-08-12,1007,Eyeshadow,200,400,200,1,00303,India
981235,2023-08-12,1003,Foundation,300,600,300,1,00303,India
334045,2023-08-12,1007,Eyeshadow,200,400,200,1,00065,India
888236,2023-08-12,1009,Moisturizer,250,500,250,1,00457,India
888236,2023-08-12,1004,Eyeliner,100,200,100,1,00457,India
888236,2023-08-12,1006,Blush,150,300,150,1,00457,India
888236,2023-08-12,1002,Mascara,200,400,200,1,00457,India
119982,2023-08-12,1007,Eyeshadow,200,400,200,1,00268,India
119982,2023-08-12,1003,Foundation,300,600,300,1,00268,India
119982,2023-08-12,1012,Body Lotion,200,400,200,1,00268,India
185860,2023-08-12,1004,Eyeliner,100,200,100,1,00361,India
185860,2023-08-12,1012,Body Lotion,200,400,200,1,00361,India
185860,2023-08-12,1003,Foundation,300,600,300,1,00361,India
185860,2023-08-12,1002,Mascara,200,400,200,1,00361,India
966123,2023-08-12,1007,Eyeshadow,200,400,200,1,00267,India
966123,2023-08-12,1012,Body Lotion,200,400,200,1,00267,India
446325,2023-08-12,1007,Eyeshadow,200,400,200,1,00139,India
446325,2023-08-12,1003,Foundation,300,600,300,1,00139,India
969066,2023-08-12,1003,Foundation,300,600,300,1,00351,India
969066,2023-08-12,1009,Moisturizer,250,500,250,1,00351,India
338791,2023-08-13,1008,Makeup Remover,80,160,80,1,00398,India
338791,2023-08-13,1001,Lipstick,150,300,150,1,00398,India
338791,2023-08-13,1009,Moisturizer,250,500,250,1,00398,India
894084,2023-08-13,1001,Lipstick,150,300,150,1,00270,India
894084,2023-08-13,1009,Moisturizer,250,500,250,1,00270,India
894084,2023-08-13,1008,Makeup Remover,80,160,80,1,00270,India
894084,2023-08-13,1004,Eyeliner,100,200,100,1,00270,India
591290,2023-08-13,1005,Nail Polish,50,100,50,1,00478,India
591290,2023-08-13,1004,Eyeliner,100,200,100,1,00478,India
591290,2023-08-13,1003,Foundation,300,600,300,1,00478,India
591290,2023-08-13,1002,Mascara,200,400,200,1,00478,India
960237,2023-08-13,1002,Mascara,200,400,200,1,00219,India
960237,2023-08-13,1007,Eyeshadow,200,400,200,1,00219,India
960237,2023-08-13,1009,Moisturizer,250,500,250,1,00219,India
262385,2023-08-13,1007,Eyeshadow,200,400,200,1,00373,India
262385,2023-08-13,1004,Eyeliner,100,200,100,1,00373,India
262385,2023-08-13,1001,Lipstick,150,300,150,1,00373,India
530430,2023-08-13,1005,Nail Polish,50,100,50,1,00361,India
530430,2023-08-13,1006,Blush,150,300,150,1,00361,India
530430,2023-08-13,1003,Foundation,300,600,300,1,00361,India
126058,2023-08-13,1003,Foundation,300,600,300,1,00381,India
126058,2023-08-13,1006,Blush,150,300,150,1,00381,India
349352,2023-08-13,1012,Body Lotion,200,400,200,1,00427,India
349352,2023-08-13,1006,Blush,150,300,150,1,00427,India
349352,2023-08-13,1008,Makeup Remover,80,160,80,1,00427,India
349352,2023-08-13,1004,Eyeliner,100,200,100,1,00427,India
121562,2023-08-13,1001,Lipstick,150,300,150,1,00162,India
121562,2023-08-13,1012,Body Lotion,200,400,200,1,00162,India
121562,2023-08-13,1009,Moisturizer,250,500,250,1,00162,India
983967,2023-08-13,1002,Mascara,200,400,200,1,00317,India
983967,2023-08-13,1004,Eyeliner,100,200,100,1,00317,India
983967,2023-08-13,1008,Makeup Remover,80,160,80,1,00317,India
983967,2023-08-13,1007,Eyeshadow,200,400,200,1,00317,India
983967,2023-08-13,1001,Lipstick,150,300,150,1,00317,India
390540,2023-08-13,1008,Makeup Remover,80,160,80,1,00358,India
390540,2023-08-13,1012,Body Lotion,200,400,200,1,00358,India
829660,2023-08-13,1012,Body Lotion,200,400,200,1,00121,India
829660,2023-08-13,1009,Moisturizer,250,500,250,1,00121,India
699633,2023-08-13,1008,Makeup Remover,80,160,80,1,00318,India
605763,2023-08-13,1007,Eyeshadow,200,400,200,1,00367,India
867768,2023-08-13,1001,Lipstick,150,300,150,1,00444,India
867768,2023-08-13,1003,Foundation,300,600,300,1,00444,India
867768,2023-08-13,1006,Blush,150,300,150,1,00444,India
860574,2023-08-13,1009,Moisturizer,250,500,250,1,00386,India
860574,2023-08-13,1005,Nail Polish,50,100,50,1,00386,India
860574,2023-08-13,1004,Eyeliner,100,200,100,1,00386,India
237508,2023-08-13,1004,Eyeliner,100,200,100,1,00311,India
237508,2023-08-13,1003,Foundation,300,600,300,1,00311,India
237508,2023-08-13,1006,Blush,150,300,150,1,00311,India
281942,2023-08-13,1008,Makeup Remover,80,160,80,1,00419,India
281942,2023-08-13,1001,Lipstick,150,300,150,1,00419,India
683769,2023-08-13,1008,Makeup Remover,80,160,80,1,00063,India
902696,2023-08-13,1007,Eyeshadow,200,400,200,1,00476,India
902696,2023-08-13,1008,Makeup Remover,80,160,80,1,00476,India
135348,2023-08-13,1001,Lipstick,150,300,150,1,00257,India
135348,2023-08-13,1005,Nail Polish,50,100,50,1,00257,India
135348,2023-08-13,1008,Makeup Remover,80,160,80,1,00257,India
135348,2023-08-13,1012,Body Lotion,200,400,200,1,00257,India
135348,2023-08-13,1009,Moisturizer,250,500,250,1,00257,India
402706,2023-08-13,1008,Makeup Remover,80,160,80,1,00276,India
402706,2023-08-13,1001,Lipstick,150,300,150,1,00276,India
402706,2023-08-13,1002,Mascara,200,400,200,1,00276,India
402706,2023-08-13,1007,Eyeshadow,200,400,200,1,00276,India
882804,2023-08-13,1006,Blush,150,300,150,1,00001,India
882804,2023-08-13,1009,Moisturizer,250,500,250,1,00001,India
324416,2023-08-13,1004,Eyeliner,100,200,100,1,00183,India
324416,2023-08-13,1009,Moisturizer,250,500,250,1,00183,India
324416,2023-08-13,1005,Nail Polish,50,100,50,1,00183,India
855542,2023-08-13,1008,Makeup Remover,80,160,80,1,00172,India
922368,2023-08-13,1007,Eyeshadow,200,400,200,1,00088,India
922368,2023-08-13,1009,Moisturizer,250,500,250,1,00088,India
569969,2023-08-13,1006,Blush,150,300,150,1,00004,India
569969,2023-08-13,1002,Mascara,200,400,200,1,00004,India
569969,2023-08-13,1008,Makeup Remover,80,160,80,1,00004,India
569969,2023-08-13,1009,Moisturizer,250,500,250,1,00004,India
662001,2023-08-13,1007,Eyeshadow,200,400,200,1,00098,India
662001,2023-08-13,1004,Eyeliner,100,200,100,1,00098,India
331591,2023-08-13,1002,Mascara,200,400,200,1,00353,India
331591,2023-08-13,1001,Lipstick,150,300,150,1,00353,India
331591,2023-08-13,1004,Eyeliner,100,200,100,1,00353,India
331591,2023-08-13,1003,Foundation,300,600,300,1,00353,India
155519,2023-08-13,1007,Eyeshadow,200,400,200,1,00363,India
155519,2023-08-13,1006,Blush,150,300,150,1,00363,India
155519,2023-08-13,1004,Eyeliner,100,200,100,1,00363,India
155519,2023-08-13,1008,Makeup Remover,80,160,80,1,00363,India
155519,2023-08-13,1012,Body Lotion,200,400,200,1,00363,India
790234,2023-08-13,1003,Foundation,300,600,300,1,00079,India
790234,2023-08-13,1012,Body Lotion,200,400,200,1,00079,India
994081,2023-08-13,1005,Nail Polish,50,100,50,1,00071,India
132654,2023-08-13,1004,Eyeliner,100,200,100,1,00038,India
132654,2023-08-13,1002,Mascara,200,400,200,1,00038,India
132654,2023-08-13,1012,Body Lotion,200,400,200,1,00038,India
605540,2023-08-13,1004,Eyeliner,100,200,100,1,00341,India
605540,2023-08-13,1002,Mascara,200,400,200,1,00341,India
605540,2023-08-13,1012,Body Lotion,200,400,200,1,00341,India
605540,2023-08-13,1009,Moisturizer,250,500,250,1,00341,India
574861,2023-08-13,1004,Eyeliner,100,200,100,1,00079,India
574861,2023-08-13,1001,Lipstick,150,300,150,1,00079,India
574861,2023-08-13,1009,Moisturizer,250,500,250,1,00079,India
924420,2023-08-13,1001,Lipstick,150,300,150,1,00215,India
924420,2023-08-13,1006,Blush,150,300,150,1,00215,India
924420,2023-08-13,1007,Eyeshadow,200,400,200,1,00215,India
953664,2023-08-13,1012,Body Lotion,200,400,200,1,00165,India
953664,2023-08-13,1009,Moisturizer,250,500,250,1,00165,India
933765,2023-08-13,1002,Mascara,200,400,200,1,00268,India
870763,2023-08-13,1003,Foundation,300,600,300,1,00212,India
948656,2023-08-13,1004,Eyeliner,100,200,100,1,00206,India
948656,2023-08-13,1012,Body Lotion,200,400,200,1,00206,India
948656,2023-08-13,1003,Foundation,300,600,300,1,00206,India
948656,2023-08-13,1002,Mascara,200,400,200,1,00206,India
673422,2023-08-13,1001,Lipstick,150,300,150,1,00304,India
673422,2023-08-13,1007,Eyeshadow,200,400,200,1,00304,India
673422,2023-08-13,1009,Moisturizer,250,500,250,1,00304,India
673422,2023-08-13,1005,Nail Polish,50,100,50,1,00304,India
361739,2023-08-13,1004,Eyeliner,100,200,100,1,00488,India
472402,2023-08-13,1001,Lipstick,150,300,150,1,00308,India
472402,2023-08-13,1004,Eyeliner,100,200,100,1,00308,India
472402,2023-08-13,1012,Body Lotion,200,400,200,1,00308,India
694088,2023-08-13,1004,Eyeliner,100,200,100,1,00073,India
694088,2023-08-13,1005,Nail Polish,50,100,50,1,00073,India
694088,2023-08-13,1012,Body Lotion,200,400,200,1,00073,India
694088,2023-08-13,1007,Eyeshadow,200,400,200,1,00073,India
694088,2023-08-13,1008,Makeup Remover,80,160,80,1,00073,India
777530,2023-08-13,1005,Nail Polish,50,100,50,1,00071,India
777530,2023-08-13,1009,Moisturizer,250,500,250,1,00071,India
777530,2023-08-13,1001,Lipstick,150,300,150,1,00071,India
838934,2023-08-13,1008,Makeup Remover,80,160,80,1,00039,India
838934,2023-08-13,1006,Blush,150,300,150,1,00039,India
323241,2023-08-13,1004,Eyeliner,100,200,100,1,00167,India
323241,2023-08-13,1012,Body Lotion,200,400,200,1,00167,India
353440,2023-08-14,1008,Makeup Remover,80,160,80,1,00152,India
353440,2023-08-14,1009,Moisturizer,250,500,250,1,00152,India
353440,2023-08-14,1006,Blush,150,300,150,1,00152,India
353440,2023-08-14,1001,Lipstick,150,300,150,1,00152,India
617202,2023-08-14,1007,Eyeshadow,200,400,200,1,00038,India
617202,2023-08-14,1001,Lipstick,150,300,150,1,00038,India
617202,2023-08-14,1004,Eyeliner,100,200,100,1,00038,India
628563,2023-08-14,1012,Body Lotion,200,400,200,1,00288,India
896767,2023-08-14,1005,Nail Polish,50,100,50,1,00471,India
896767,2023-08-14,1001,Lipstick,150,300,150,1,00471,India
896767,2023-08-14,1008,Makeup Remover,80,160,80,1,00471,India
896767,2023-08-14,1007,Eyeshadow,200,400,200,1,00471,India
179202,2023-08-14,1003,Foundation,300,600,300,1,00328,India
894092,2023-08-14,1007,Eyeshadow,200,400,200,1,00478,India
894092,2023-08-14,1012,Body Lotion,200,400,200,1,00478,India
894092,2023-08-14,1001,Lipstick,150,300,150,1,00478,India
894092,2023-08-14,1004,Eyeliner,100,200,100,1,00478,India
856140,2023-08-14,1008,Makeup Remover,80,160,80,1,00063,India
129441,2023-08-14,1012,Body Lotion,200,400,200,1,00148,India
129441,2023-08-14,1001,Lipstick,150,300,150,1,00148,India
655157,2023-08-14,1003,Foundation,300,600,300,1,00214,India
655157,2023-08-14,1002,Mascara,200,400,200,1,00214,India
655157,2023-08-14,1009,Moisturizer,250,500,250,1,00214,India
655157,2023-08-14,1008,Makeup Remover,80,160,80,1,00214,India
751143,2023-08-14,1006,Blush,150,300,150,1,00117,India
751143,2023-08-14,1004,Eyeliner,100,200,100,1,00117,India
495666,2023-08-14,1005,Nail Polish,50,100,50,1,00306,India
495666,2023-08-14,1008,Makeup Remover,80,160,80,1,00306,India
119011,2023-08-14,1003,Foundation,300,600,300,1,00346,India
543425,2023-08-14,1001,Lipstick,150,300,150,1,00271,India
543425,2023-08-14,1005,Nail Polish,50,100,50,1,00271,India
452975,2023-08-14,1001,Lipstick,150,300,150,1,00036,India
452975,2023-08-14,1007,Eyeshadow,200,400,200,1,00036,India
734821,2023-08-14,1007,Eyeshadow,200,400,200,1,00282,India
734821,2023-08-14,1001,Lipstick,150,300,150,1,00282,India
734821,2023-08-14,1004,Eyeliner,100,200,100,1,00282,India
734821,2023-08-14,1009,Moisturizer,250,500,250,1,00282,India
131528,2023-08-14,1002,Mascara,200,400,200,1,00222,India
131528,2023-08-14,1005,Nail Polish,50,100,50,1,00222,India
131528,2023-08-14,1007,Eyeshadow,200,400,200,1,00222,India
231035,2023-08-14,1009,Moisturizer,250,500,250,1,00353,India
231035,2023-08-14,1001,Lipstick,150,300,150,1,00353,India
231035,2023-08-14,1006,Blush,150,300,150,1,00353,India
231035,2023-08-14,1004,Eyeliner,100,200,100,1,00353,India
862020,2023-08-14,1003,Foundation,300,600,300,1,00106,India
862020,2023-08-14,1005,Nail Polish,50,100,50,1,00106,India
862020,2023-08-14,1006,Blush,150,300,150,1,00106,India
862020,2023-08-14,1002,Mascara,200,400,200,1,00106,India
151610,2023-08-14,1007,Eyeshadow,200,400,200,1,00297,India
151610,2023-08-14,1009,Moisturizer,250,500,250,1,00297,India
151610,2023-08-14,1004,Eyeliner,100,200,100,1,00297,India
736725,2023-08-14,1005,Nail Polish,50,100,50,1,00186,India
225214,2023-08-14,1008,Makeup Remover,80,160,80,1,00248,India
225214,2023-08-14,1009,Moisturizer,250,500,250,1,00248,India
891108,2023-08-14,1003,Foundation,300,600,300,1,00446,India
789692,2023-08-14,1006,Blush,150,300,150,1,00323,India
789692,2023-08-14,1003,Foundation,300,600,300,1,00323,India
789692,2023-08-14,1005,Nail Polish,50,100,50,1,00323,India
789692,2023-08-14,1007,Eyeshadow,200,400,200,1,00323,India
801769,2023-08-14,1009,Moisturizer,250,500,250,1,00018,India
801769,2023-08-14,1003,Foundation,300,600,300,1,00018,India
801769,2023-08-14,1006,Blush,150,300,150,1,00018,India
397323,2023-08-14,1002,Mascara,200,400,200,1,00220,India
397323,2023-08-14,1004,Eyeliner,100,200,100,1,00220,India
749789,2023-08-14,1001,Lipstick,150,300,150,1,00146,India
749789,2023-08-14,1003,Foundation,300,600,300,1,00146,India
848800,2023-08-14,1001,Lipstick,150,300,150,1,00379,India
848800,2023-08-14,1012,Body Lotion,200,400,200,1,00379,India
961654,2023-08-14,1008,Makeup Remover,80,160,80,1,00453,India
221606,2023-08-14,1007,Eyeshadow,200,400,200,1,00053,India
221606,2023-08-14,1012,Body Lotion,200,400,200,1,00053,India
221606,2023-08-14,1009,Moisturizer,250,500,250,1,00053,India
221606,2023-08-14,1008,Makeup Remover,80,160,80,1,00053,India
931333,2023-08-14,1001,Lipstick,150,300,150,1,00023,India
681462,2023-08-14,1005,Nail Polish,50,100,50,1,00206,India
681462,2023-08-14,1006,Blush,150,300,150,1,00206,India
681462,2023-08-14,1009,Moisturizer,250,500,250,1,00206,India
681462,2023-08-14,1004,Eyeliner,100,200,100,1,00206,India
845097,2023-08-14,1004,Eyeliner,100,200,100,1,00098,India
845097,2023-08-14,1012,Body Lotion,200,400,200,1,00098,India
845097,2023-08-14,1005,Nail Polish,50,100,50,1,00098,India
785590,2023-08-14,1007,Eyeshadow,200,400,200,1,00248,India
785590,2023-08-14,1005,Nail Polish,50,100,50,1,00248,India
785590,2023-08-14,1004,Eyeliner,100,200,100,1,00248,India
680269,2023-08-14,1005,Nail Polish,50,100,50,1,00277,India
680269,2023-08-14,1006,Blush,150,300,150,1,00277,India
680269,2023-08-14,1012,Body Lotion,200,400,200,1,00277,India
680269,2023-08-14,1003,Foundation,300,600,300,1,00277,India
565814,2023-08-14,1009,Moisturizer,250,500,250,1,00043,India
565814,2023-08-14,1004,Eyeliner,100,200,100,1,00043,India
565814,2023-08-14,1012,Body Lotion,200,400,200,1,00043,India
565814,2023-08-14,1003,Foundation,300,600,300,1,00043,India
430367,2023-08-14,1012,Body Lotion,200,400,200,1,00159,India
430367,2023-08-14,1003,Foundation,300,600,300,1,00159,India
430367,2023-08-14,1006,Blush,150,300,150,1,00159,India
880031,2023-08-14,1004,Eyeliner,100,200,100,1,00148,India
880031,2023-08-14,1012,Body Lotion,200,400,200,1,00148,India
100887,2023-08-14,1009,Moisturizer,250,500,250,1,00055,India
100887,2023-08-14,1002,Mascara,200,400,200,1,00055,India
100887,2023-08-14,1003,Foundation,300,600,300,1,00055,India
100887,2023-08-14,1007,Eyeshadow,200,400,200,1,00055,India
503004,2023-08-14,1002,Mascara,200,400,200,1,00114,India
601082,2023-08-14,1008,Makeup Remover,80,160,80,1,00123,India
601082,2023-08-14,1007,Eyeshadow,200,400,200,1,00123,India
601082,2023-08-14,1004,Eyeliner,100,200,100,1,00123,India
164372,2023-08-14,1002,Mascara,200,400,200,1,00216,India
164372,2023-08-14,1005,Nail Polish,50,100,50,1,00216,India
164372,2023-08-14,1003,Foundation,300,600,300,1,00216,India
378125,2023-08-14,1002,Mascara,200,400,200,1,00144,India
378125,2023-08-14,1012,Body Lotion,200,400,200,1,00144,India
986144,2023-08-14,1012,Body Lotion,200,400,200,1,00170,India
569429,2023-08-14,1003,Foundation,300,600,300,1,00389,India
569429,2023-08-14,1005,Nail Polish,50,100,50,1,00389,India
569429,2023-08-14,1004,Eyeliner,100,200,100,1,00389,India
569429,2023-08-14,1009,Moisturizer,250,500,250,1,00389,India
234005,2023-08-14,1004,Eyeliner,100,200,100,1,00256,India
234005,2023-08-14,1012,Body Lotion,200,400,200,1,00256,India
662912,2023-08-15,1003,Foundation,300,600,300,1,00388,India
662912,2023-08-15,1002,Mascara,200,400,200,1,00388,India
662912,2023-08-15,1007,Eyeshadow,200,400,200,1,00388,India
700063,2023-08-15,1005,Nail Polish,50,100,50,1,00368,India
700063,2023-08-15,1002,Mascara,200,400,200,1,00368,India
933819,2023-08-15,1008,Makeup Remover,80,160,80,1,00153,India
933819,2023-08-15,1002,Mascara,200,400,200,1,00153,India
920004,2023-08-15,1007,Eyeshadow,200,400,200,1,00054,India
920004,2023-08-15,1012,Body Lotion,200,400,200,1,00054,India
920004,2023-08-15,1005,Nail Polish,50,100,50,1,00054,India
374893,2023-08-15,1009,Moisturizer,250,500,250,1,00361,India
374893,2023-08-15,1007,Eyeshadow,200,400,200,1,00361,India
374893,2023-08-15,1004,Eyeliner,100,200,100,1,00361,India
904624,2023-08-15,1002,Mascara,200,400,200,1,00344,India
904624,2023-08-15,1003,Foundation,300,600,300,1,00344,India
904624,2023-08-15,1012,Body Lotion,200,400,200,1,00344,India
904624,2023-08-15,1005,Nail Polish,50,100,50,1,00344,India
904624,2023-08-15,1001,Lipstick,150,300,150,1,00344,India
905436,2023-08-15,1002,Mascara,200,400,200,1,00236,India
232918,2023-08-15,1006,Blush,150,300,150,1,00231,India
232918,2023-08-15,1012,Body Lotion,200,400,200,1,00231,India
232918,2023-08-15,1007,Eyeshadow,200,400,200,1,00231,India
917984,2023-08-15,1005,Nail Polish,50,100,50,1,00195,India
917984,2023-08-15,1006,Blush,150,300,150,1,00195,India
180262,2023-08-15,1008,Makeup Remover,80,160,80,1,00022,India
546764,2023-08-15,1008,Makeup Remover,80,160,80,1,00346,India
546764,2023-08-15,1004,Eyeliner,100,200,100,1,00346,India
546764,2023-08-15,1006,Blush,150,300,150,1,00346,India
546764,2023-08-15,1012,Body Lotion,200,400,200,1,00346,India
801573,2023-08-15,1004,Eyeliner,100,200,100,1,00361,India
801573,2023-08-15,1006,Blush,150,300,150,1,00361,India
801573,2023-08-15,1008,Makeup Remover,80,160,80,1,00361,India
801573,2023-08-15,1005,Nail Polish,50,100,50,1,00361,India
801573,2023-08-15,1002,Mascara,200,400,200,1,00361,India
287435,2023-08-15,1009,Moisturizer,250,500,250,1,00439,India
287435,2023-08-15,1003,Foundation,300,600,300,1,00439,India
710305,2023-08-15,1002,Mascara,200,400,200,1,00366,India
133268,2023-08-15,1012,Body Lotion,200,400,200,1,00344,India
374897,2023-08-15,1001,Lipstick,150,300,150,1,00087,India
374897,2023-08-15,1004,Eyeliner,100,200,100,1,00087,India
374897,2023-08-15,1002,Mascara,200,400,200,1,00087,India
374897,2023-08-15,1008,Makeup Remover,80,160,80,1,00087,India
619450,2023-08-15,1007,Eyeshadow,200,400,200,1,00426,India
619450,2023-08-15,1012,Body Lotion,200,400,200,1,00426,India
969482,2023-08-15,1007,Eyeshadow,200,400,200,1,00084,India
969482,2023-08-15,1001,Lipstick,150,300,150,1,00084,India
969482,2023-08-15,1012,Body Lotion,200,400,200,1,00084,India
969482,2023-08-15,1002,Mascara,200,400,200,1,00084,India
705544,2023-08-15,1009,Moisturizer,250,500,250,1,00048,India
705544,2023-08-15,1004,Eyeliner,100,200,100,1,00048,India
882175,2023-08-15,1003,Foundation,300,600,300,1,00267,India
882175,2023-08-15,1001,Lipstick,150,300,150,1,00267,India
882175,2023-08-15,1007,Eyeshadow,200,400,200,1,00267,India
110904,2023-08-15,1012,Body Lotion,200,400,200,1,00461,India
110904,2023-08-15,1009,Moisturizer,250,500,250,1,00461,India
110904,2023-08-15,1006,Blush,150,300,150,1,00461,India
494869,2023-08-15,1004,Eyeliner,100,200,100,1,00300,India
494869,2023-08-15,1002,Mascara,200,400,200,1,00300,India
494869,2023-08-15,1007,Eyeshadow,200,400,200,1,00300,India
188655,2023-08-15,1005,Nail Polish,50,100,50,1,00307,India
188655,2023-08-15,1006,Blush,150,300,150,1,00307,India
188655,2023-08-15,1003,Foundation,300,600,300,1,00307,India
188655,2023-08-15,1008,Makeup Remover,80,160,80,1,00307,India
188655,2023-08-15,1012,Body Lotion,200,400,200,1,00307,India
952022,2023-08-15,1006,Blush,150,300,150,1,00269,India
952022,2023-08-15,1001,Lipstick,150,300,150,1,00269,India
952022,2023-08-15,1012,Body Lotion,200,400,200,1,00269,India
952022,2023-08-15,1002,Mascara,200,400,200,1,00269,India
940893,2023-08-15,1002,Mascara,200,400,200,1,00461,India
940893,2023-08-15,1005,Nail Polish,50,100,50,1,00461,India
233381,2023-08-15,1003,Foundation,300,600,300,1,00338,India
402239,2023-08-15,1001,Lipstick,150,300,150,1,00222,India
402239,2023-08-15,1006,Blush,150,300,150,1,00222,India
575417,2023-08-15,1007,Eyeshadow,200,400,200,1,00307,India
575417,2023-08-15,1001,Lipstick,150,300,150,1,00307,India
657257,2023-08-15,1002,Mascara,200,400,200,1,00193,India
657257,2023-08-15,1003,Foundation,300,600,300,1,00193,India
657257,2023-08-15,1004,Eyeliner,100,200,100,1,00193,India
657257,2023-08-15,1007,Eyeshadow,200,400,200,1,00193,India
683871,2023-08-15,1007,Eyeshadow,200,400,200,1,00256,India
683871,2023-08-15,1004,Eyeliner,100,200,100,1,00256,India
683871,2023-08-15,1003,Foundation,300,600,300,1,00256,India
524775,2023-08-15,1005,Nail Polish,50,100,50,1,00135,India
524608,2023-08-15,1003,Foundation,300,600,300,1,00284,India
702541,2023-08-15,1005,Nail Polish,50,100,50,1,00294,India
545752,2023-08-15,1006,Blush,150,300,150,1,00418,India
545752,2023-08-15,1005,Nail Polish,50,100,50,1,00418,India
545752,2023-08-15,1012,Body Lotion,200,400,200,1,00418,India
722428,2023-08-15,1008,Makeup Remover,80,160,80,1,00109,India
722428,2023-08-15,1002,Mascara,200,400,200,1,00109,India
722428,2023-08-15,1006,Blush,150,300,150,1,00109,India
722428,2023-08-15,1003,Foundation,300,600,300,1,00109,India
722428,2023-08-15,1012,Body Lotion,200,400,200,1,00109,India
465984,2023-08-15,1004,Eyeliner,100,200,100,1,00131,India
465984,2023-08-15,1008,Makeup Remover,80,160,80,1,00131,India
465984,2023-08-15,1003,Foundation,300,600,300,1,00131,India
295185,2023-08-15,1001,Lipstick,150,300,150,1,00494,India
295185,2023-08-15,1005,Nail Polish,50,100,50,1,00494,India
860655,2023-08-15,1002,Mascara,200,400,200,1,00068,India
860655,2023-08-15,1004,Eyeliner,100,200,100,1,00068,India
860655,2023-08-15,1007,Eyeshadow,200,400,200,1,00068,India
488006,2023-08-15,1006,Blush,150,300,150,1,00034,India
488006,2023-08-15,1008,Makeup Remover,80,160,80,1,00034,India
960083,2023-08-15,1003,Foundation,300,600,300,1,00300,India
919660,2023-08-15,1001,Lipstick,150,300,150,1,00368,India
543796,2023-08-15,1003,Foundation,300,600,300,1,00284,India
543796,2023-08-15,1009,Moisturizer,250,500,250,1,00284,India
109313,2023-08-15,1004,Eyeliner,100,200,100,1,00309,India
109313,2023-08-15,1009,Moisturizer,250,500,250,1,00309,India
857375,2023-08-16,1005,Nail Polish,50,100,50,1,00456,India
857375,2023-08-16,1007,Eyeshadow,200,400,200,1,00456,India
857375,2023-08-16,1009,Moisturizer,250,500,250,1,00456,India
343506,2023-08-16,1001,Lipstick,150,300,150,1,00309,India
343506,2023-08-16,1008,Makeup Remover,80,160,80,1,00309,India
343506,2023-08-16,1002,Mascara,200,400,200,1,00309,India
343506,2023-08-16,1009,Moisturizer,250,500,250,1,00309,India
785459,2023-08-16,1004,Eyeliner,100,200,100,1,00017,India
785459,2023-08-16,1007,Eyeshadow,200,400,200,1,00017,India
785459,2023-08-16,1005,Nail Polish,50,100,50,1,00017,India
144494,2023-08-16,1006,Blush,150,300,150,1,00111,India
144494,2023-08-16,1003,Foundation,300,600,300,1,00111,India
144494,2023-08-16,1001,Lipstick,150,300,150,1,00111,India
338268,2023-08-16,1007,Eyeshadow,200,400,200,1,00061,India
134680,2023-08-16,1001,Lipstick,150,300,150,1,00105,India
290452,2023-08-16,1006,Blush,150,300,150,1,00400,India
126007,2023-08-16,1005,Nail Polish,50,100,50,1,00475,India
126007,2023-08-16,1009,Moisturizer,250,500,250,1,00475,India
126007,2023-08-16,1004,Eyeliner,100,200,100,1,00475,India
126007,2023-08-16,1001,Lipstick,150,300,150,1,00475,India
377684,2023-08-16,1008,Makeup Remover,80,160,80,1,00179,India
377684,2023-08-16,1005,Nail Polish,50,100,50,1,00179,India
377684,2023-08-16,1007,Eyeshadow,200,400,200,1,00179,India
700787,2023-08-16,1007,Eyeshadow,200,400,200,1,00351,India
700787,2023-08-16,1006,Blush,150,300,150,1,00351,India
700787,2023-08-16,1008,Makeup Remover,80,160,80,1,00351,India
273791,2023-08-16,1008,Makeup Remover,80,160,80,1,00407,India
273791,2023-08-16,1009,Moisturizer,250,500,250,1,00407,India
273791,2023-08-16,1006,Blush,150,300,150,1,00407,India
968995,2023-08-16,1005,Nail Polish,50,100,50,1,00468,India
968995,2023-08-16,1009,Moisturizer,250,500,250,1,00468,India
968995,2023-08-16,1004,Eyeliner,100,200,100,1,00468,India
968995,2023-08-16,1007,Eyeshadow,200,400,200,1,00468,India
600946,2023-08-16,1007,Eyeshadow,200,400,200,1,00087,India
600946,2023-08-16,1008,Makeup Remover,80,160,80,1,00087,India
600946,2023-08-16,1006,Blush,150,300,150,1,00087,India
600946,2023-08-16,1001,Lipstick,150,300,150,1,00087,India
869167,2023-08-16,1005,Nail Polish,50,100,50,1,00287,India
869167,2023-08-16,1004,Eyeliner,100,200,100,1,00287,India
869167,2023-08-16,1006,Blush,150,300,150,1,00287,India
869167,2023-08-16,1012,Body Lotion,200,400,200,1,00287,India
647391,2023-08-16,1008,Makeup Remover,80,160,80,1,00092,India
647391,2023-08-16,1003,Foundation,300,600,300,1,00092,India
647391,2023-08-16,1009,Moisturizer,250,500,250,1,00092,India
647391,2023-08-16,1004,Eyeliner,100,200,100,1,00092,India
577548,2023-08-16,1002,Mascara,200,400,200,1,00095,India
577548,2023-08-16,1004,Eyeliner,100,200,100,1,00095,India
577548,2023-08-16,1003,Foundation,300,600,300,1,00095,India
577548,2023-08-16,1012,Body Lotion,200,400,200,1,00095,India
577548,2023-08-16,1007,Eyeshadow,200,400,200,1,00095,India
813668,2023-08-16,1012,Body Lotion,200,400,200,1,00007,India
654956,2023-08-16,1008,Makeup Remover,80,160,80,1,00332,India
654956,2023-08-16,1001,Lipstick,150,300,150,1,00332,India
654956,2023-08-16,1007,Eyeshadow,200,400,200,1,00332,India
670109,2023-08-16,1008,Makeup Remover,80,160,80,1,00372,India
670109,2023-08-16,1001,Lipstick,150,300,150,1,00372,India
795180,2023-08-16,1005,Nail Polish,50,100,50,1,00458,India
795180,2023-08-16,1006,Blush,150,300,150,1,00458,India
795180,2023-08-16,1001,Lipstick,150,300,150,1,00458,India
795180,2023-08-16,1008,Makeup Remover,80,160,80,1,00458,India
472537,2023-08-16,1007,Eyeshadow,200,400,200,1,00280,India
258004,2023-08-16,1009,Moisturizer,250,500,250,1,00454,India
258004,2023-08-16,1004,Eyeliner,100,200,100,1,00454,India
258004,2023-08-16,1002,Mascara,200,400,200,1,00454,India
987065,2023-08-16,1002,Mascara,200,400,200,1,00447,India
987065,2023-08-16,1012,Body Lotion,200,400,200,1,00447,India
987065,2023-08-16,1004,Eyeliner,100,200,100,1,00447,India
541474,2023-08-16,1004,Eyeliner,100,200,100,1,00039,India
541474,2023-08-16,1003,Foundation,300,600,300,1,00039,India
541474,2023-08-16,1008,Makeup Remover,80,160,80,1,00039,India
541474,2023-08-16,1005,Nail Polish,50,100,50,1,00039,India
570535,2023-08-16,1004,Eyeliner,100,200,100,1,00317,India
570535,2023-08-16,1005,Nail Polish,50,100,50,1,00317,India
570535,2023-08-16,1001,Lipstick,150,300,150,1,00317,India
570535,2023-08-16,1007,Eyeshadow,200,400,200,1,00317,India
237562,2023-08-16,1003,Foundation,300,600,300,1,00063,India
237562,2023-08-16,1002,Mascara,200,400,200,1,00063,India
824467,2023-08-16,1003,Foundation,300,600,300,1,00338,India
824467,2023-08-16,1007,Eyeshadow,200,400,200,1,00338,India
824467,2023-08-16,1008,Makeup Remover,80,160,80,1,00338,India
136005,2023-08-16,1003,Foundation,300,600,300,1,00400,India
567513,2023-08-16,1004,Eyeliner,100,200,100,1,00076,India
567513,2023-08-16,1005,Nail Polish,50,100,50,1,00076,India
630836,2023-08-16,1004,Eyeliner,100,200,100,1,00267,India
630836,2023-08-16,1009,Moisturizer,250,500,250,1,00267,India
630836,2023-08-16,1006,Blush,150,300,150,1,00267,India
117665,2023-08-16,1002,Mascara,200,400,200,1,00362,India
117665,2023-08-16,1007,Eyeshadow,200,400,200,1,00362,India
992826,2023-08-17,1002,Mascara,200,400,200,1,00034,India
992826,2023-08-17,1005,Nail Polish,50,100,50,1,00034,India
992826,2023-08-17,1004,Eyeliner,100,200,100,1,00034,India
140458,2023-08-17,1012,Body Lotion,200,400,200,1,00020,India
140458,2023-08-17,1009,Moisturizer,250,500,250,1,00020,India
894170,2023-08-17,1003,Foundation,300,600,300,1,00059,India
894170,2023-08-17,1002,Mascara,200,400,200,1,00059,India
664949,2023-08-17,1008,Makeup Remover,80,160,80,1,00333,India
664949,2023-08-17,1006,Blush,150,300,150,1,00333,India
664949,2023-08-17,1004,Eyeliner,100,200,100,1,00333,India
664949,2023-08-17,1009,Moisturizer,250,500,250,1,00333,India
322551,2023-08-17,1005,Nail Polish,50,100,50,1,00101,India
322551,2023-08-17,1002,Mascara,200,400,200,1,00101,India
322551,2023-08-17,1009,Moisturizer,250,500,250,1,00101,India
108673,2023-08-17,1002,Mascara,200,400,200,1,00117,India
108673,2023-08-17,1007,Eyeshadow,200,400,200,1,00117,India
108673,2023-08-17,1004,Eyeliner,100,200,100,1,00117,India
779736,2023-08-17,1003,Foundation,300,600,300,1,00262,India
779736,2023-08-17,1002,Mascara,200,400,200,1,00262,India
779736,2023-08-17,1004,Eyeliner,100,200,100,1,00262,India
779736,2023-08-17,1008,Makeup Remover,80,160,80,1,00262,India
767499,2023-08-17,1008,Makeup Remover,80,160,80,1,00014,India
767499,2023-08-17,1004,Eyeliner,100,200,100,1,00014,India
895566,2023-08-17,1002,Mascara,200,400,200,1,00353,India
696155,2023-08-17,1008,Makeup Remover,80,160,80,1,00475,India
677387,2023-08-17,1009,Moisturizer,250,500,250,1,00205,India
677387,2023-08-17,1007,Eyeshadow,200,400,200,1,00205,India
677387,2023-08-17,1002,Mascara,200,400,200,1,00205,India
677387,2023-08-17,1012,Body Lotion,200,400,200,1,00205,India
323148,2023-08-17,1009,Moisturizer,250,500,250,1,00356,India
323148,2023-08-17,1005,Nail Polish,50,100,50,1,00356,India
323148,2023-08-17,1006,Blush,150,300,150,1,00356,India
454531,2023-08-17,1009,Moisturizer,250,500,250,1,00202,India
454531,2023-08-17,1008,Makeup Remover,80,160,80,1,00202,India
666904,2023-08-17,1001,Lipstick,150,300,150,1,00255,India
666904,2023-08-17,1004,Eyeliner,100,200,100,1,00255,India
666904,2023-08-17,1003,Foundation,300,600,300,1,00255,India
666904,2023-08-17,1012,Body Lotion,200,400,200,1,00255,India
680027,2023-08-17,1004,Eyeliner,100,200,100,1,00185,India
680027,2023-08-17,1006,Blush,150,300,150,1,00185,India
680027,2023-08-17,1003,Foundation,300,600,300,1,00185,India
845925,2023-08-17,1004,Eyeliner,100,200,100,1,00183,India
845925,2023-08-17,1003,Foundation,300,600,300,1,00183,India
845925,2023-08-17,1005,Nail Polish,50,100,50,1,00183,India
268135,2023-08-17,1012,Body Lotion,200,400,200,1,00305,India
414676,2023-08-17,1008,Makeup Remover,80,160,80,1,00069,India
414676,2023-08-17,1007,Eyeshadow,200,400,200,1,00069,India
414676,2023-08-17,1006,Blush,150,300,150,1,00069,India
414676,2023-08-17,1002,Mascara,200,400,200,1,00069,India
445094,2023-08-17,1008,Makeup Remover,80,160,80,1,00234,India
445094,2023-08-17,1003,Foundation,300,600,300,1,00234,India
126117,2023-08-17,1009,Moisturizer,250,500,250,1,00072,India
895410,2023-08-17,1007,Eyeshadow,200,400,200,1,00196,India
895410,2023-08-17,1001,Lipstick,150,300,150,1,00196,India
230888,2023-08-17,1007,Eyeshadow,200,400,200,1,00188,India
230888,2023-08-17,1012,Body Lotion,200,400,200,1,00188,India
718732,2023-08-17,1004,Eyeliner,100,200,100,1,00211,India
718732,2023-08-17,1002,Mascara,200,400,200,1,00211,India
718732,2023-08-17,1008,Makeup Remover,80,160,80,1,00211,India
116268,2023-08-17,1003,Foundation,300,600,300,1,00460,India
116268,2023-08-17,1006,Blush,150,300,150,1,00460,India
116268,2023-08-17,1004,Eyeliner,100,200,100,1,00460,India
116268,2023-08-17,1009,Moisturizer,250,500,250,1,00460,India
116268,2023-08-17,1005,Nail Polish,50,100,50,1,00460,India
683502,2023-08-17,1007,Eyeshadow,200,400,200,1,00278,India
683502,2023-08-17,1002,Mascara,200,400,200,1,00278,India
988744,2023-08-17,1007,Eyeshadow,200,400,200,1,00326,India
988744,2023-08-17,1005,Nail Polish,50,100,50,1,00326,India
360557,2023-08-17,1001,Lipstick,150,300,150,1,00263,India
360557,2023-08-17,1012,Body Lotion,200,400,200,1,00263,India
360557,2023-08-17,1005,Nail Polish,50,100,50,1,00263,India
839023,2023-08-17,1009,Moisturizer,250,500,250,1,00485,India
956883,2023-08-17,1012,Body Lotion,200,400,200,1,00072,India
956883,2023-08-17,1006,Blush,150,300,150,1,00072,India
956883,2023-08-17,1001,Lipstick,150,300,150,1,00072,India
525063,2023-08-17,1005,Nail Polish,50,100,50,1,00338,India
525063,2023-08-17,1012,Body Lotion,200,400,200,1,00338,India
525063,2023-08-17,1007,Eyeshadow,200,400,200,1,00338,India
525063,2023-08-17,1006,Blush,150,300,150,1,00338,India
648541,2023-08-17,1007,Eyeshadow,200,400,200,1,00143,India
648541,2023-08-17,1002,Mascara,200,400,200,1,00143,India
648541,2023-08-17,1009,Moisturizer,250,500,250,1,00143,India
648541,2023-08-17,1008,Makeup Remover,80,160,80,1,00143,India
606544,2023-08-17,1002,Mascara,200,400,200,1,00448,India
532938,2023-08-17,1001,Lipstick,150,300,150,1,00295,India
609182,2023-08-17,1006,Blush,150,300,150,1,00247,India
609182,2023-08-17,1003,Foundation,300,600,300,1,00247,India
814559,2023-08-17,1008,Makeup Remover,80,160,80,1,00069,India
814559,2023-08-17,1004,Eyeliner,100,200,100,1,00069,India
814559,2023-08-17,1002,Mascara,200,400,200,1,00069,India
609691,2023-08-17,1001,Lipstick,150,300,150,1,00342,India
609691,2023-08-17,1009,Moisturizer,250,500,250,1,00342,India
609691,2023-08-17,1005,Nail Polish,50,100,50,1,00342,India
609691,2023-08-17,1006,Blush,150,300,150,1,00342,India
609691,2023-08-17,1008,Makeup Remover,80,160,80,1,00342,India
151047,2023-08-17,1012,Body Lotion,200,400,200,1,00024,India
151047,2023-08-17,1009,Moisturizer,250,500,250,1,00024,India
567252,2023-08-17,1001,Lipstick,150,300,150,1,00134,India
567252,2023-08-17,1012,Body Lotion,200,400,200,1,00134,India
699989,2023-08-17,1001,Lipstick,150,300,150,1,00409,India
699989,2023-08-17,1012,Body Lotion,200,400,200,1,00409,India
391343,2023-08-17,1004,Eyeliner,100,200,100,1,00363,India
587154,2023-08-17,1012,Body Lotion,200,400,200,1,00180,India
587154,2023-08-17,1006,Blush,150,300,150,1,00180,India
587154,2023-08-17,1009,Moisturizer,250,500,250,1,00180,India
834196,2023-08-17,1009,Moisturizer,250,500,250,1,00187,India
208581,2023-08-17,1002,Mascara,200,400,200,1,00212,India
208581,2023-08-17,1001,Lipstick,150,300,150,1,00212,India
208581,2023-08-17,1004,Eyeliner,100,200,100,1,00212,India
373528,2023-08-17,1002,Mascara,200,400,200,1,00007,India
373528,2023-08-17,1008,Makeup Remover,80,160,80,1,00007,India
373528,2023-08-17,1007,Eyeshadow,200,400,200,1,00007,India
845149,2023-08-17,1003,Foundation,300,600,300,1,00088,India
845149,2023-08-17,1012,Body Lotion,200,400,200,1,00088,India
845149,2023-08-17,1007,Eyeshadow,200,400,200,1,00088,India
234733,2023-08-17,1012,Body Lotion,200,400,200,1,00318,India
234733,2023-08-17,1004,Eyeliner,100,200,100,1,00318,India
403250,2023-08-18,1007,Eyeshadow,200,400,200,1,00434,India
403250,2023-08-18,1012,Body Lotion,200,400,200,1,00434,India
106354,2023-08-18,1003,Foundation,300,600,300,1,00445,India
106354,2023-08-18,1008,Makeup Remover,80,160,80,1,00445,India
106354,2023-08-18,1012,Body Lotion,200,400,200,1,00445,India
872656,2023-08-18,1007,Eyeshadow,200,400,200,1,00129,India
872656,2023-08-18,1005,Nail Polish,50,100,50,1,00129,India
407472,2023-08-18,1001,Lipstick,150,300,150,1,00092,India
407472,2023-08-18,1012,Body Lotion,200,400,200,1,00092,India
407472,2023-08-18,1006,Blush,150,300,150,1,00092,India
407472,2023-08-18,1004,Eyeliner,100,200,100,1,00092,India
385366,2023-08-18,1012,Body Lotion,200,400,200,1,00287,India
385366,2023-08-18,1004,Eyeliner,100,200,100,1,00287,India
300814,2023-08-18,1002,Mascara,200,400,200,1,00486,India
413782,2023-08-18,1008,Makeup Remover,80,160,80,1,00350,India
413782,2023-08-18,1007,Eyeshadow,200,400,200,1,00350,India
631814,2023-08-18,1003,Foundation,300,600,300,1,00093,India
631814,2023-08-18,1006,Blush,150,300,150,1,00093,India
631814,2023-08-18,1008,Makeup Remover,80,160,80,1,00093,India
563028,2023-08-18,1003,Foundation,300,600,300,1,00253,India
563028,2023-08-18,1009,Moisturizer,250,500,250,1,00253,India
563028,2023-08-18,1012,Body Lotion,200,400,200,1,00253,India
563028,2023-08-18,1007,Eyeshadow,200,400,200,1,00253,India
183112,2023-08-18,1007,Eyeshadow,200,400,200,1,00315,India
183112,2023-08-18,1001,Lipstick,150,300,150,1,00315,India
183112,2023-08-18,1012,Body Lotion,200,400,200,1,00315,India
183112,2023-08-18,1005,Nail Polish,50,100,50,1,00315,India
134451,2023-08-18,1001,Lipstick,150,300,150,1,00421,India
134451,2023-08-18,1003,Foundation,300,600,300,1,00421,India
134451,2023-08-18,1008,Makeup Remover,80,160,80,1,00421,India
622364,2023-08-18,1001,Lipstick,150,300,150,1,00264,India
622364,2023-08-18,1003,Foundation,300,600,300,1,00264,India
622364,2023-08-18,1007,Eyeshadow,200,400,200,1,00264,India
622364,2023-08-18,1006,Blush,150,300,150,1,00264,India
754300,2023-08-18,1009,Moisturizer,250,500,250,1,00412,India
754300,2023-08-18,1008,Makeup Remover,80,160,80,1,00412,India
754300,2023-08-18,1005,Nail Polish,50,100,50,1,00412,India
340971,2023-08-18,1003,Foundation,300,600,300,1,00017,India
722357,2023-08-18,1007,Eyeshadow,200,400,200,1,00342,India
722357,2023-08-18,1006,Blush,150,300,150,1,00342,India
832435,2023-08-18,1006,Blush,150,300,150,1,00359,India
635889,2023-08-18,1005,Nail Polish,50,100,50,1,00069,India
913424,2023-08-18,1001,Lipstick,150,300,150,1,00493,India
283945,2023-08-18,1002,Mascara,200,400,200,1,00038,India
283945,2023-08-18,1006,Blush,150,300,150,1,00038,India
283945,2023-08-18,1001,Lipstick,150,300,150,1,00038,India
168789,2023-08-18,1003,Foundation,300,600,300,1,00192,India
168789,2023-08-18,1004,Eyeliner,100,200,100,1,00192,India
168789,2023-08-18,1012,Body Lotion,200,400,200,1,00192,India
168789,2023-08-18,1009,Moisturizer,250,500,250,1,00192,India
894529,2023-08-18,1006,Blush,150,300,150,1,00467,India
894529,2023-08-18,1004,Eyeliner,100,200,100,1,00467,India
894529,2023-08-18,1001,Lipstick,150,300,150,1,00467,India
894529,2023-08-18,1009,Moisturizer,250,500,250,1,00467,India
894529,2023-08-18,1005,Nail Polish,50,100,50,1,00467,India
998032,2023-08-18,1002,Mascara,200,400,200,1,00089,India
998032,2023-08-18,1009,Moisturizer,250,500,250,1,00089,India
332716,2023-08-18,1007,Eyeshadow,200,400,200,1,00425,India
332716,2023-08-18,1005,Nail Polish,50,100,50,1,00425,India
564949,2023-08-18,1007,Eyeshadow,200,400,200,1,00223,India
129128,2023-08-18,1009,Moisturizer,250,500,250,1,00188,India
129128,2023-08-18,1008,Makeup Remover,80,160,80,1,00188,India
129128,2023-08-18,1006,Blush,150,300,150,1,00188,India
129128,2023-08-18,1005,Nail Polish,50,100,50,1,00188,India
571594,2023-08-18,1005,Nail Polish,50,100,50,1,00015,India
571594,2023-08-18,1002,Mascara,200,400,200,1,00015,India
571594,2023-08-18,1008,Makeup Remover,80,160,80,1,00015,India
571594,2023-08-18,1007,Eyeshadow,200,400,200,1,00015,India
571594,2023-08-18,1012,Body Lotion,200,400,200,1,00015,India
838199,2023-08-18,1012,Body Lotion,200,400,200,1,00173,India
838199,2023-08-18,1007,Eyeshadow,200,400,200,1,00173,India
838199,2023-08-18,1004,Eyeliner,100,200,100,1,00173,India
929120,2023-08-18,1001,Lipstick,150,300,150,1,00115,India
874207,2023-08-18,1001,Lipstick,150,300,150,1,00191,India
874207,2023-08-18,1003,Foundation,300,600,300,1,00191,India
874207,2023-08-18,1002,Mascara,200,400,200,1,00191,India
874207,2023-08-18,1009,Moisturizer,250,500,250,1,00191,India
796963,2023-08-18,1007,Eyeshadow,200,400,200,1,00115,India
796963,2023-08-18,1005,Nail Polish,50,100,50,1,00115,India
662753,2023-08-18,1007,Eyeshadow,200,400,200,1,00111,India
662753,2023-08-18,1001,Lipstick,150,300,150,1,00111,India
662753,2023-08-18,1003,Foundation,300,600,300,1,00111,India
662753,2023-08-18,1005,Nail Polish,50,100,50,1,00111,India
420537,2023-08-18,1004,Eyeliner,100,200,100,1,00301,India
420537,2023-08-18,1001,Lipstick,150,300,150,1,00301,India
420537,2023-08-18,1003,Foundation,300,600,300,1,00301,India
423425,2023-08-18,1009,Moisturizer,250,500,250,1,00472,India
423425,2023-08-18,1007,Eyeshadow,200,400,200,1,00472,India
423425,2023-08-18,1008,Makeup Remover,80,160,80,1,00472,India
423425,2023-08-18,1012,Body Lotion,200,400,200,1,00472,India
423425,2023-08-18,1001,Lipstick,150,300,150,1,00472,India
337061,2023-08-18,1006,Blush,150,300,150,1,00120,India
337061,2023-08-18,1001,Lipstick,150,300,150,1,00120,India
337061,2023-08-18,1008,Makeup Remover,80,160,80,1,00120,India
337061,2023-08-18,1005,Nail Polish,50,100,50,1,00120,India
397772,2023-08-18,1008,Makeup Remover,80,160,80,1,00052,India
397772,2023-08-18,1012,Body Lotion,200,400,200,1,00052,India
850832,2023-08-18,1012,Body Lotion,200,400,200,1,00277,India
551205,2023-08-18,1008,Makeup Remover,80,160,80,1,00121,India
979680,2023-08-18,1009,Moisturizer,250,500,250,1,00252,India
979680,2023-08-18,1007,Eyeshadow,200,400,200,1,00252,India
979680,2023-08-18,1002,Mascara,200,400,200,1,00252,India
231621,2023-08-18,1008,Makeup Remover,80,160,80,1,00161,India
754800,2023-08-18,1009,Moisturizer,250,500,250,1,00102,India
754800,2023-08-18,1005,Nail Polish,50,100,50,1,00102,India
754800,2023-08-18,1008,Makeup Remover,80,160,80,1,00102,India
696660,2023-08-18,1004,Eyeliner,100,200,100,1,00337,India
696660,2023-08-18,1002,Mascara,200,400,200,1,00337,India
826117,2023-08-18,1005,Nail Polish,50,100,50,1,00440,India
826117,2023-08-18,1007,Eyeshadow,200,400,200,1,00440,India
826117,2023-08-18,1003,Foundation,300,600,300,1,00440,India
167519,2023-08-18,1006,Blush,150,300,150,1,00353,India
167519,2023-08-18,1012,Body Lotion,200,400,200,1,00353,India
540983,2023-08-18,1001,Lipstick,150,300,150,1,00387,India
540983,2023-08-18,1009,Moisturizer,250,500,250,1,00387,India
452296,2023-08-19,1005,Nail Polish,50,100,50,1,00288,India
452296,2023-08-19,1001,Lipstick,150,300,150,1,00288,India
452296,2023-08-19,1004,Eyeliner,100,200,100,1,00288,India
717769,2023-08-19,1007,Eyeshadow,200,400,200,1,00430,India
782222,2023-08-19,1007,Eyeshadow,200,400,200,1,00359,India
782222,2023-08-19,1009,Moisturizer,250,500,250,1,00359,India
782222,2023-08-19,1005,Nail Polish,50,100,50,1,00359,India
782222,2023-08-19,1012,Body Lotion,200,400,200,1,00359,India
541465,2023-08-19,1004,Eyeliner,100,200,100,1,00313,India
541465,2023-08-19,1003,Foundation,300,600,300,1,00313,India
541465,2023-08-19,1002,Mascara,200,400,200,1,00313,India
541465,2023-08-19,1007,Eyeshadow,200,400,200,1,00313,India
458603,2023-08-19,1009,Moisturizer,250,500,250,1,00190,India
458603,2023-08-19,1001,Lipstick,150,300,150,1,00190,India
692547,2023-08-19,1006,Blush,150,300,150,1,00066,India
692547,2023-08-19,1012,Body Lotion,200,400,200,1,00066,India
692547,2023-08-19,1005,Nail Polish,50,100,50,1,00066,India
441400,2023-08-19,1001,Lipstick,150,300,150,1,00449,India
441400,2023-08-19,1003,Foundation,300,600,300,1,00449,India
441400,2023-08-19,1005,Nail Polish,50,100,50,1,00449,India
441400,2023-08-19,1007,Eyeshadow,200,400,200,1,00449,India
350133,2023-08-19,1005,Nail Polish,50,100,50,1,00416,India
350133,2023-08-19,1003,Foundation,300,600,300,1,00416,India
350133,2023-08-19,1001,Lipstick,150,300,150,1,00416,India
350133,2023-08-19,1002,Mascara,200,400,200,1,00416,India
683359,2023-08-19,1007,Eyeshadow,200,400,200,1,00085,India
683359,2023-08-19,1008,Makeup Remover,80,160,80,1,00085,India
683359,2023-08-19,1003,Foundation,300,600,300,1,00085,India
683359,2023-08-19,1002,Mascara,200,400,200,1,00085,India
233969,2023-08-19,1008,Makeup Remover,80,160,80,1,00229,India
233969,2023-08-19,1009,Moisturizer,250,500,250,1,00229,India
233969,2023-08-19,1004,Eyeliner,100,200,100,1,00229,India
283529,2023-08-19,1008,Makeup Remover,80,160,80,1,00129,India
722742,2023-08-19,1001,Lipstick,150,300,150,1,00423,India
576582,2023-08-19,1005,Nail Polish,50,100,50,1,00239,India
576582,2023-08-19,1001,Lipstick,150,300,150,1,00239,India
576582,2023-08-19,1003,Foundation,300,600,300,1,00239,India
576582,2023-08-19,1006,Blush,150,300,150,1,00239,India
115707,2023-08-19,1004,Eyeliner,100,200,100,1,00078,India
115707,2023-08-19,1008,Makeup Remover,80,160,80,1,00078,India
115707,2023-08-19,1007,Eyeshadow,200,400,200,1,00078,India
115707,2023-08-19,1005,Nail Polish,50,100,50,1,00078,India
532447,2023-08-19,1007,Eyeshadow,200,400,200,1,00237,India
532447,2023-08-19,1006,Blush,150,300,150,1,00237,India
532447,2023-08-19,1009,Moisturizer,250,500,250,1,00237,India
532447,2023-08-19,1004,Eyeliner,100,200,100,1,00237,India
500296,2023-08-19,1006,Blush,150,300,150,1,00364,India
500296,2023-08-19,1005,Nail Polish,50,100,50,1,00364,India
819985,2023-08-19,1003,Foundation,300,600,300,1,00007,India
819985,2023-08-19,1007,Eyeshadow,200,400,200,1,00007,India
968414,2023-08-19,1003,Foundation,300,600,300,1,00049,India
921538,2023-08-19,1012,Body Lotion,200,400,200,1,00003,India
921538,2023-08-19,1004,Eyeliner,100,200,100,1,00003,India
921538,2023-08-19,1001,Lipstick,150,300,150,1,00003,India
246333,2023-08-19,1001,Lipstick,150,300,150,1,00217,India
246333,2023-08-19,1002,Mascara,200,400,200,1,00217,India
246333,2023-08-19,1005,Nail Polish,50,100,50,1,00217,India
246333,2023-08-19,1004,Eyeliner,100,200,100,1,00217,India
594132,2023-08-19,1001,Lipstick,150,300,150,1,00132,India
594132,2023-08-19,1008,Makeup Remover,80,160,80,1,00132,India
461681,2023-08-19,1006,Blush,150,300,150,1,00307,India
461681,2023-08-19,1003,Foundation,300,600,300,1,00307,India
461681,2023-08-19,1001,Lipstick,150,300,150,1,00307,India
461681,2023-08-19,1007,Eyeshadow,200,400,200,1,00307,India
411304,2023-08-19,1007,Eyeshadow,200,400,200,1,00093,India
411304,2023-08-19,1006,Blush,150,300,150,1,00093,India
411304,2023-08-19,1012,Body Lotion,200,400,200,1,00093,India
114630,2023-08-19,1007,Eyeshadow,200,400,200,1,00118,India
114630,2023-08-19,1009,Moisturizer,250,500,250,1,00118,India
114630,2023-08-19,1006,Blush,150,300,150,1,00118,India
114630,2023-08-19,1012,Body Lotion,200,400,200,1,00118,India
950138,2023-08-19,1002,Mascara,200,400,200,1,00021,India
950138,2023-08-19,1006,Blush,150,300,150,1,00021,India
950138,2023-08-19,1001,Lipstick,150,300,150,1,00021,India
970233,2023-08-19,1004,Eyeliner,100,200,100,1,00470,India
970233,2023-08-19,1005,Nail Polish,50,100,50,1,00470,India
970233,2023-08-19,1008,Makeup Remover,80,160,80,1,00470,India
665928,2023-08-19,1004,Eyeliner,100,200,100,1,00011,India
665928,2023-08-19,1002,Mascara,200,400,200,1,00011,India
665928,2023-08-19,1012,Body Lotion,200,400,200,1,00011,India
611738,2023-08-19,1004,Eyeliner,100,200,100,1,00223,India
611738,2023-08-19,1012,Body Lotion,200,400,200,1,00223,India
611738,2023-08-19,1007,Eyeshadow,200,400,200,1,00223,India
575472,2023-08-19,1005,Nail Polish,50,100,50,1,00105,India
803562,2023-08-19,1002,Mascara,200,400,200,1,00005,India
803562,2023-08-19,1006,Blush,150,300,150,1,00005,India
214234,2023-08-19,1012,Body Lotion,200,400,200,1,00401,India
214234,2023-08-19,1009,Moisturizer,250,500,250,1,00401,India
214234,2023-08-19,1005,Nail Polish,50,100,50,1,00401,India
660374,2023-08-19,1004,Eyeliner,100,200,100,1,00015,India
450445,2023-08-20,1008,Makeup Remover,80,160,80,1,00244,India
450445,2023-08-20,1003,Foundation,300,600,300,1,00244,India
733819,2023-08-20,1002,Mascara,200,400,200,1,00270,India
733819,2023-08-20,1003,Foundation,300,600,300,1,00270,India
733819,2023-08-20,1004,Eyeliner,100,200,100,1,00270,India
733819,2023-08-20,1001,Lipstick,150,300,150,1,00270,India
322716,2023-08-20,1012,Body Lotion,200,400,200,1,00153,India
322716,2023-08-20,1006,Blush,150,300,150,1,00153,India
322716,2023-08-20,1008,Makeup Remover,80,160,80,1,00153,India
322716,2023-08-20,1004,Eyeliner,100,200,100,1,00153,India
452950,2023-08-20,1009,Moisturizer,250,500,250,1,00064,India
452950,2023-08-20,1007,Eyeshadow,200,400,200,1,00064,India
452950,2023-08-20,1001,Lipstick,150,300,150,1,00064,India
452950,2023-08-20,1006,Blush,150,300,150,1,00064,India
452950,2023-08-20,1004,Eyeliner,100,200,100,1,00064,India
771539,2023-08-20,1001,Lipstick,150,300,150,1,00339,India
457155,2023-08-20,1008,Makeup Remover,80,160,80,1,00345,India
457155,2023-08-20,1012,Body Lotion,200,400,200,1,00345,India
457155,2023-08-20,1003,Foundation,300,600,300,1,00345,India
915627,2023-08-20,1007,Eyeshadow,200,400,200,1,00333,India
915627,2023-08-20,1008,Makeup Remover,80,160,80,1,00333,India
339117,2023-08-20,1006,Blush,150,300,150,1,00419,India
398721,2023-08-20,1012,Body Lotion,200,400,200,1,00179,India
398721,2023-08-20,1003,Foundation,300,600,300,1,00179,India
398721,2023-08-20,1002,Mascara,200,400,200,1,00179,India
398721,2023-08-20,1001,Lipstick,150,300,150,1,00179,India
398721,2023-08-20,1006,Blush,150,300,150,1,00179,India
469374,2023-08-20,1008,Makeup Remover,80,160,80,1,00289,India
469374,2023-08-20,1001,Lipstick,150,300,150,1,00289,India
864997,2023-08-20,1012,Body Lotion,200,400,200,1,00151,India
864997,2023-08-20,1007,Eyeshadow,200,400,200,1,00151,India
307740,2023-08-20,1001,Lipstick,150,300,150,1,00191,India
724935,2023-08-20,1008,Makeup Remover,80,160,80,1,00236,India
724935,2023-08-20,1005,Nail Polish,50,100,50,1,00236,India
909200,2023-08-20,1008,Makeup Remover,80,160,80,1,00327,India
909200,2023-08-20,1001,Lipstick,150,300,150,1,00327,India
909200,2023-08-20,1003,Foundation,300,600,300,1,00327,India
980680,2023-08-20,1009,Moisturizer,250,500,250,1,00090,India
980680,2023-08-20,1012,Body Lotion,200,400,200,1,00090,India
949933,2023-08-20,1002,Mascara,200,400,200,1,00088,India
949933,2023-08-20,1012,Body Lotion,200,400,200,1,00088,India
949933,2023-08-20,1007,Eyeshadow,200,400,200,1,00088,India
949933,2023-08-20,1004,Eyeliner,100,200,100,1,00088,India
139164,2023-08-20,1008,Makeup Remover,80,160,80,1,00094,India
139164,2023-08-20,1012,Body Lotion,200,400,200,1,00094,India
139164,2023-08-20,1009,Moisturizer,250,500,250,1,00094,India
298712,2023-08-20,1009,Moisturizer,250,500,250,1,00014,India
298712,2023-08-20,1006,Blush,150,300,150,1,00014,India
174184,2023-08-20,1007,Eyeshadow,200,400,200,1,00370,India
586243,2023-08-20,1007,Eyeshadow,200,400,200,1,00262,India
108314,2023-08-20,1004,Eyeliner,100,200,100,1,00196,India
364912,2023-08-20,1002,Mascara,200,400,200,1,00130,India
869767,2023-08-20,1003,Foundation,300,600,300,1,00162,India
869767,2023-08-20,1008,Makeup Remover,80,160,80,1,00162,India
869767,2023-08-20,1001,Lipstick,150,300,150,1,00162,India
897722,2023-08-20,1004,Eyeliner,100,200,100,1,00329,India
897722,2023-08-20,1006,Blush,150,300,150,1,00329,India
897722,2023-08-20,1009,Moisturizer,250,500,250,1,00329,India
897722,2023-08-20,1002,Mascara,200,400,200,1,00329,India
293703,2023-08-20,1004,Eyeliner,100,200,100,1,00109,India
873152,2023-08-20,1004,Eyeliner,100,200,100,1,00325,India
873152,2023-08-20,1012,Body Lotion,200,400,200,1,00325,India
156047,2023-08-20,1003,Foundation,300,600,300,1,00063,India
533737,2023-08-20,1007,Eyeshadow,200,400,200,1,00095,India
533737,2023-08-20,1004,Eyeliner,100,200,100,1,00095,India
213218,2023-08-20,1004,Eyeliner,100,200,100,1,00309,India
224262,2023-08-20,1007,Eyeshadow,200,400,200,1,00192,India
224262,2023-08-20,1006,Blush,150,300,150,1,00192,India
224262,2023-08-20,1012,Body Lotion,200,400,200,1,00192,India
598078,2023-08-20,1006,Blush,150,300,150,1,00109,India
411663,2023-08-20,1003,Foundation,300,600,300,1,00186,India
532951,2023-08-20,1009,Moisturizer,250,500,250,1,00327,India
109955,2023-08-20,1012,Body Lotion,200,400,200,1,00371,India
109955,2023-08-20,1004,Eyeliner,100,200,100,1,00371,India
109955,2023-08-20,1001,Lipstick,150,300,150,1,00371,India
109955,2023-08-20,1002,Mascara,200,400,200,1,00371,India
109955,2023-08-20,1003,Foundation,300,600,300,1,00371,India
602726,2023-08-20,1008,Makeup Remover,80,160,80,1,00446,India
602726,2023-08-20,1001,Lipstick,150,300,150,1,00446,India
602726,2023-08-20,1003,Foundation,300,600,300,1,00446,India
107742,2023-08-20,1009,Moisturizer,250,500,250,1,00057,India
107742,2023-08-20,1005,Nail Polish,50,100,50,1,00057,India
107742,2023-08-20,1007,Eyeshadow,200,400,200,1,00057,India
107742,2023-08-20,1008,Makeup Remover,80,160,80,1,00057,India
854933,2023-08-20,1006,Blush,150,300,150,1,00183,India
854933,2023-08-20,1009,Moisturizer,250,500,250,1,00183,India
790339,2023-08-20,1006,Blush,150,300,150,1,00076,India
790339,2023-08-20,1008,Makeup Remover,80,160,80,1,00076,India
790339,2023-08-20,1005,Nail Polish,50,100,50,1,00076,India
790339,2023-08-20,1007,Eyeshadow,200,400,200,1,00076,India
727209,2023-08-20,1002,Mascara,200,400,200,1,00265,India
623213,2023-08-20,1001,Lipstick,150,300,150,1,00205,India
623213,2023-08-20,1007,Eyeshadow,200,400,200,1,00205,India
623213,2023-08-20,1004,Eyeliner,100,200,100,1,00205,India
623213,2023-08-20,1012,Body Lotion,200,400,200,1,00205,India
623213,2023-08-20,1005,Nail Polish,50,100,50,1,00205,India
828371,2023-08-21,1006,Blush,150,300,150,1,00295,India
828371,2023-08-21,1008,Makeup Remover,80,160,80,1,00295,India
828371,2023-08-21,1002,Mascara,200,400,200,1,00295,India
367184,2023-08-21,1002,Mascara,200,400,200,1,00072,India
367184,2023-08-21,1003,Foundation,300,600,300,1,00072,India
692573,2023-08-21,1003,Foundation,300,600,300,1,00492,India
692573,2023-08-21,1005,Nail Polish,50,100,50,1,00492,India
692573,2023-08-21,1009,Moisturizer,250,500,250,1,00492,India
670271,2023-08-21,1012,Body Lotion,200,400,200,1,00282,India
670271,2023-08-21,1004,Eyeliner,100,200,100,1,00282,India
670271,2023-08-21,1009,Moisturizer,250,500,250,1,00282,India
670271,2023-08-21,1001,Lipstick,150,300,150,1,00282,India
670271,2023-08-21,1002,Mascara,200,400,200,1,00282,India
682020,2023-08-21,1012,Body Lotion,200,400,200,1,00035,India
885200,2023-08-21,1012,Body Lotion,200,400,200,1,00369,India
885200,2023-08-21,1003,Foundation,300,600,300,1,00369,India
885200,2023-08-21,1009,Moisturizer,250,500,250,1,00369,India
821076,2023-08-21,1003,Foundation,300,600,300,1,00234,India
821076,2023-08-21,1006,Blush,150,300,150,1,00234,India
346914,2023-08-21,1001,Lipstick,150,300,150,1,00428,India
346914,2023-08-21,1002,Mascara,200,400,200,1,00428,India
346914,2023-08-21,1005,Nail Polish,50,100,50,1,00428,India
346914,2023-08-21,1007,Eyeshadow,200,400,200,1,00428,India
494276,2023-08-21,1006,Blush,150,300,150,1,00500,India
494276,2023-08-21,1009,Moisturizer,250,500,250,1,00500,India
592019,2023-08-21,1007,Eyeshadow,200,400,200,1,00396,India
592019,2023-08-21,1003,Foundation,300,600,300,1,00396,India
592019,2023-08-21,1008,Makeup Remover,80,160,80,1,00396,India
158673,2023-08-21,1007,Eyeshadow,200,400,200,1,00118,India
771665,2023-08-21,1009,Moisturizer,250,500,250,1,00206,India
771665,2023-08-21,1002,Mascara,200,400,200,1,00206,India
771665,2023-08-21,1003,Foundation,300,600,300,1,00206,India
706192,2023-08-21,1012,Body Lotion,200,400,200,1,00112,India
706192,2023-08-21,1001,Lipstick,150,300,150,1,00112,India
797845,2023-08-21,1007,Eyeshadow,200,400,200,1,00096,India
797845,2023-08-21,1006,Blush,150,300,150,1,00096,India
797845,2023-08-21,1002,Mascara,200,400,200,1,00096,India
591770,2023-08-21,1004,Eyeliner,100,200,100,1,00134,India
591770,2023-08-21,1005,Nail Polish,50,100,50,1,00134,India
591770,2023-08-21,1006,Blush,150,300,150,1,00134,India
202022,2023-08-21,1009,Moisturizer,250,500,250,1,00182,India
408562,2023-08-21,1005,Nail Polish,50,100,50,1,00060,India
408562,2023-08-21,1002,Mascara,200,400,200,1,00060,India
408562,2023-08-21,1001,Lipstick,150,300,150,1,00060,India
408562,2023-08-21,1012,Body Lotion,200,400,200,1,00060,India
408562,2023-08-21,1009,Moisturizer,250,500,250,1,00060,India
933801,2023-08-21,1001,Lipstick,150,300,150,1,00193,India
933801,2023-08-21,1002,Mascara,200,400,200,1,00193,India
933801,2023-08-21,1007,Eyeshadow,200,400,200,1,00193,India
736776,2023-08-21,1008,Makeup Remover,80,160,80,1,00206,India
736776,2023-08-21,1005,Nail Polish,50,100,50,1,00206,India
736776,2023-08-21,1002,Mascara,200,400,200,1,00206,India
736776,2023-08-21,1007,Eyeshadow,200,400,200,1,00206,India
197495,2023-08-21,1009,Moisturizer,250,500,250,1,00049,India
197495,2023-08-21,1004,Eyeliner,100,200,100,1,00049,India
197495,2023-08-21,1003,Foundation,300,600,300,1,00049,India
197495,2023-08-21,1007,Eyeshadow,200,400,200,1,00049,India
738725,2023-08-21,1012,Body Lotion,200,400,200,1,00086,India
686318,2023-08-21,1009,Moisturizer,250,500,250,1,00299,India
686318,2023-08-21,1008,Makeup Remover,80,160,80,1,00299,India
686318,2023-08-21,1002,Mascara,200,400,200,1,00299,India
686318,2023-08-21,1004,Eyeliner,100,200,100,1,00299,India
686318,2023-08-21,1003,Foundation,300,600,300,1,00299,India
700227,2023-08-21,1001,Lipstick,150,300,150,1,00212,India
700227,2023-08-21,1005,Nail Polish,50,100,50,1,00212,India
700227,2023-08-21,1012,Body Lotion,200,400,200,1,00212,India
700227,2023-08-21,1009,Moisturizer,250,500,250,1,00212,India
251176,2023-08-21,1007,Eyeshadow,200,400,200,1,00413,India
835028,2023-08-21,1006,Blush,150,300,150,1,00200,India
835028,2023-08-21,1004,Eyeliner,100,200,100,1,00200,India
835028,2023-08-21,1001,Lipstick,150,300,150,1,00200,India
745509,2023-08-21,1003,Foundation,300,600,300,1,00129,India
745509,2023-08-21,1002,Mascara,200,400,200,1,00129,India
372225,2023-08-21,1012,Body Lotion,200,400,200,1,00395,India
372225,2023-08-21,1008,Makeup Remover,80,160,80,1,00395,India
372225,2023-08-21,1007,Eyeshadow,200,400,200,1,00395,India
372225,2023-08-21,1001,Lipstick,150,300,150,1,00395,India
575280,2023-08-21,1012,Body Lotion,200,400,200,1,00390,India
575280,2023-08-21,1006,Blush,150,300,150,1,00390,India
575280,2023-08-21,1008,Makeup Remover,80,160,80,1,00390,India
736288,2023-08-21,1008,Makeup Remover,80,160,80,1,00093,India
736288,2023-08-21,1003,Foundation,300,600,300,1,00093,India
736288,2023-08-21,1009,Moisturizer,250,500,250,1,00093,India
736288,2023-08-21,1004,Eyeliner,100,200,100,1,00093,India
499505,2023-08-21,1004,Eyeliner,100,200,100,1,00417,India
499505,2023-08-21,1007,Eyeshadow,200,400,200,1,00417,India
499505,2023-08-21,1006,Blush,150,300,150,1,00417,India
499505,2023-08-21,1012,Body Lotion,200,400,200,1,00417,India
904562,2023-08-21,1007,Eyeshadow,200,400,200,1,00227,India
904562,2023-08-21,1002,Mascara,200,400,200,1,00227,India
904562,2023-08-21,1001,Lipstick,150,300,150,1,00227,India
976352,2023-08-21,1009,Moisturizer,250,500,250,1,00241,India
976352,2023-08-21,1003,Foundation,300,600,300,1,00241,India
780704,2023-08-21,1012,Body Lotion,200,400,200,1,00092,India
319354,2023-08-21,1004,Eyeliner,100,200,100,1,00167,India
319354,2023-08-21,1007,Eyeshadow,200,400,200,1,00167,India
328614,2023-08-21,1012,Body Lotion,200,400,200,1,00321,India
328614,2023-08-21,1002,Mascara,200,400,200,1,00321,India
328614,2023-08-21,1009,Moisturizer,250,500,250,1,00321,India
328614,2023-08-21,1007,Eyeshadow,200,400,200,1,00321,India
745942,2023-08-21,1007,Eyeshadow,200,400,200,1,00222,India
745942,2023-08-21,1003,Foundation,300,600,300,1,00222,India
710241,2023-08-21,1012,Body Lotion,200,400,200,1,00497,India
710241,2023-08-21,1003,Foundation,300,600,300,1,00497,India
710241,2023-08-21,1007,Eyeshadow,200,400,200,1,00497,India
710241,2023-08-21,1006,Blush,150,300,150,1,00497,India
710241,2023-08-21,1004,Eyeliner,100,200,100,1,00497,India
845282,2023-08-21,1004,Eyeliner,100,200,100,1,00002,India
845282,2023-08-21,1005,Nail Polish,50,100,50,1,00002,India
845282,2023-08-21,1001,Lipstick,150,300,150,1,00002,India
652071,2023-08-22,1007,Eyeshadow,200,400,200,1,00218,India
652071,2023-08-22,1003,Foundation,300,600,300,1,00218,India
652071,2023-08-22,1005,Nail Polish,50,100,50,1,00218,India
652071,2023-08-22,1002,Mascara,200,400,200,1,00218,India
196844,2023-08-22,1007,Eyeshadow,200,400,200,1,00028,India
196844,2023-08-22,1005,Nail Polish,50,100,50,1,00028,India
256307,2023-08-22,1003,Foundation,300,600,300,1,00358,India
256307,2023-08-22,1012,Body Lotion,200,400,200,1,00358,India
251483,2023-08-22,1001,Lipstick,150,300,150,1,00087,India
251483,2023-08-22,1004,Eyeliner,100,200,100,1,00087,India
251483,2023-08-22,1002,Mascara,200,400,200,1,00087,India
483482,2023-08-22,1012,Body Lotion,200,400,200,1,00006,India
480669,2023-08-22,1002,Mascara,200,400,200,1,00280,India
480669,2023-08-22,1001,Lipstick,150,300,150,1,00280,India
480669,2023-08-22,1007,Eyeshadow,200,400,200,1,00280,India
967854,2023-08-22,1009,Moisturizer,250,500,250,1,00423,India
967854,2023-08-22,1005,Nail Polish,50,100,50,1,00423,India
906658,2023-08-22,1003,Foundation,300,600,300,1,00465,India
871008,2023-08-22,1009,Moisturizer,250,500,250,1,00352,India
407122,2023-08-22,1009,Moisturizer,250,500,250,1,00323,India
407122,2023-08-22,1001,Lipstick,150,300,150,1,00323,India
239776,2023-08-22,1012,Body Lotion,200,400,200,1,00076,India
239776,2023-08-22,1008,Makeup Remover,80,160,80,1,00076,India
239776,2023-08-22,1009,Moisturizer,250,500,250,1,00076,India
536796,2023-08-22,1007,Eyeshadow,200,400,200,1,00445,India
536796,2023-08-22,1003,Foundation,300,600,300,1,00445,India
536796,2023-08-22,1008,Makeup Remover,80,160,80,1,00445,India
536796,2023-08-22,1012,Body Lotion,200,400,200,1,00445,India
536796,2023-08-22,1009,Moisturizer,250,500,250,1,00445,India
895738,2023-08-22,1005,Nail Polish,50,100,50,1,00015,India
895738,2023-08-22,1009,Moisturizer,250,500,250,1,00015,India
895738,2023-08-22,1006,Blush,150,300,150,1,00015,India
733406,2023-08-22,1002,Mascara,200,400,200,1,00234,India
733406,2023-08-22,1004,Eyeliner,100,200,100,1,00234,India
410738,2023-08-22,1001,Lipstick,150,300,150,1,00363,India
410738,2023-08-22,1008,Makeup Remover,80,160,80,1,00363,India
410738,2023-08-22,1012,Body Lotion,200,400,200,1,00363,India
410738,2023-08-22,1003,Foundation,300,600,300,1,00363,India
410738,2023-08-22,1007,Eyeshadow,200,400,200,1,00363,India
941149,2023-08-22,1001,Lipstick,150,300,150,1,00126,India
254431,2023-08-22,1008,Makeup Remover,80,160,80,1,00020,India
254431,2023-08-22,1009,Moisturizer,250,500,250,1,00020,India
840550,2023-08-22,1008,Makeup Remover,80,160,80,1,00030,India
840550,2023-08-22,1007,Eyeshadow,200,400,200,1,00030,India
178075,2023-08-22,1001,Lipstick,150,300,150,1,00018,India
178075,2023-08-22,1009,Moisturizer,250,500,250,1,00018,India
247558,2023-08-22,1008,Makeup Remover,80,160,80,1,00372,India
185973,2023-08-22,1004,Eyeliner,100,200,100,1,00071,India
694644,2023-08-22,1004,Eyeliner,100,200,100,1,00088,India
694644,2023-08-22,1009,Moisturizer,250,500,250,1,00088,India
750041,2023-08-22,1008,Makeup Remover,80,160,80,1,00404,India
750041,2023-08-22,1005,Nail Polish,50,100,50,1,00404,India
750041,2023-08-22,1001,Lipstick,150,300,150,1,00404,India
750041,2023-08-22,1006,Blush,150,300,150,1,00404,India
355156,2023-08-22,1007,Eyeshadow,200,400,200,1,00079,India
699792,2023-08-22,1004,Eyeliner,100,200,100,1,00199,India
699792,2023-08-22,1002,Mascara,200,400,200,1,00199,India
699792,2023-08-22,1005,Nail Polish,50,100,50,1,00199,India
699792,2023-08-22,1012,Body Lotion,200,400,200,1,00199,India
612114,2023-08-22,1009,Moisturizer,250,500,250,1,00198,India
612114,2023-08-22,1001,Lipstick,150,300,150,1,00198,India
612114,2023-08-22,1005,Nail Polish,50,100,50,1,00198,India
612114,2023-08-22,1002,Mascara,200,400,200,1,00198,India
908756,2023-08-22,1003,Foundation,300,600,300,1,00381,India
908756,2023-08-22,1007,Eyeshadow,200,400,200,1,00381,India
821480,2023-08-22,1006,Blush,150,300,150,1,00277,India
255612,2023-08-22,1012,Body Lotion,200,400,200,1,00414,India
255612,2023-08-22,1003,Foundation,300,600,300,1,00414,India
255612,2023-08-22,1009,Moisturizer,250,500,250,1,00414,India
552556,2023-08-22,1004,Eyeliner,100,200,100,1,00096,India
552556,2023-08-22,1005,Nail Polish,50,100,50,1,00096,India
552556,2023-08-22,1006,Blush,150,300,150,1,00096,India
552556,2023-08-22,1012,Body Lotion,200,400,200,1,00096,India
552556,2023-08-22,1009,Moisturizer,250,500,250,1,00096,India
825309,2023-08-22,1003,Foundation,300,600,300,1,00253,India
825309,2023-08-22,1006,Blush,150,300,150,1,00253,India
825309,2023-08-22,1009,Moisturizer,250,500,250,1,00253,India
825309,2023-08-22,1004,Eyeliner,100,200,100,1,00253,India
686888,2023-08-22,1006,Blush,150,300,150,1,00263,India
686888,2023-08-22,1012,Body Lotion,200,400,200,1,00263,India
856664,2023-08-22,1006,Blush,150,300,150,1,00477,India
856664,2023-08-22,1012,Body Lotion,200,400,200,1,00477,India
856664,2023-08-22,1002,Mascara,200,400,200,1,00477,India
856664,2023-08-22,1003,Foundation,300,600,300,1,00477,India
407436,2023-08-22,1009,Moisturizer,250,500,250,1,00422,India
407436,2023-08-22,1003,Foundation,300,600,300,1,00422,India
790181,2023-08-22,1003,Foundation,300,600,300,1,00321,India
790181,2023-08-22,1008,Makeup Remover,80,160,80,1,00321,India
790181,2023-08-22,1004,Eyeliner,100,200,100,1,00321,India
956876,2023-08-22,1008,Makeup Remover,80,160,80,1,00304,India
956876,2023-08-22,1004,Eyeliner,100,200,100,1,00304,India
956876,2023-08-22,1003,Foundation,300,600,300,1,00304,India
956876,2023-08-22,1009,Moisturizer,250,500,250,1,00304,India
917002,2023-08-22,1002,Mascara,200,400,200,1,00026,India
917002,2023-08-22,1007,Eyeshadow,200,400,200,1,00026,India
985108,2023-08-22,1003,Foundation,300,600,300,1,00469,India
985108,2023-08-22,1006,Blush,150,300,150,1,00469,India
985108,2023-08-22,1012,Body Lotion,200,400,200,1,00469,India
985108,2023-08-22,1007,Eyeshadow,200,400,200,1,00469,India
573890,2023-08-22,1012,Body Lotion,200,400,200,1,00153,India
573890,2023-08-22,1006,Blush,150,300,150,1,00153,India
568342,2023-08-23,1004,Eyeliner,100,200,100,1,00357,India
568342,2023-08-23,1001,Lipstick,150,300,150,1,00357,India
568342,2023-08-23,1002,Mascara,200,400,200,1,00357,India
568342,2023-08-23,1007,Eyeshadow,200,400,200,1,00357,India
801655,2023-08-23,1008,Makeup Remover,80,160,80,1,00205,India
801655,2023-08-23,1001,Lipstick,150,300,150,1,00205,India
801655,2023-08-23,1012,Body Lotion,200,400,200,1,00205,India
836095,2023-08-23,1012,Body Lotion,200,400,200,1,00285,India
836095,2023-08-23,1002,Mascara,200,400,200,1,00285,India
836095,2023-08-23,1005,Nail Polish,50,100,50,1,00285,India
836095,2023-08-23,1009,Moisturizer,250,500,250,1,00285,India
365576,2023-08-23,1012,Body Lotion,200,400,200,1,00089,India
365576,2023-08-23,1009,Moisturizer,250,500,250,1,00089,India
794898,2023-08-23,1009,Moisturizer,250,500,250,1,00131,India
794898,2023-08-23,1008,Makeup Remover,80,160,80,1,00131,India
794898,2023-08-23,1005,Nail Polish,50,100,50,1,00131,India
580760,2023-08-23,1006,Blush,150,300,150,1,00110,India
580760,2023-08-23,1008,Makeup Remover,80,160,80,1,00110,India
258156,2023-08-23,1001,Lipstick,150,300,150,1,00036,India
258156,2023-08-23,1002,Mascara,200,400,200,1,00036,India
258156,2023-08-23,1009,Moisturizer,250,500,250,1,00036,India
258156,2023-08-23,1008,Makeup Remover,80,160,80,1,00036,India
204571,2023-08-23,1007,Eyeshadow,200,400,200,1,00498,India
204571,2023-08-23,1004,Eyeliner,100,200,100,1,00498,India
204571,2023-08-23,1003,Foundation,300,600,300,1,00498,India
204571,2023-08-23,1009,Moisturizer,250,500,250,1,00498,India
248281,2023-08-23,1004,Eyeliner,100,200,100,1,00088,India
248281,2023-08-23,1009,Moisturizer,250,500,250,1,00088,India
248281,2023-08-23,1005,Nail Polish,50,100,50,1,00088,India
708703,2023-08-23,1001,Lipstick,150,300,150,1,00141,India
708703,2023-08-23,1009,Moisturizer,250,500,250,1,00141,India
708703,2023-08-23,1002,Mascara,200,400,200,1,00141,India
708703,2023-08-23,1007,Eyeshadow,200,400,200,1,00141,India
316822,2023-08-23,1007,Eyeshadow,200,400,200,1,00163,India
316822,2023-08-23,1003,Foundation,300,600,300,1,00163,India
316822,2023-08-23,1001,Lipstick,150,300,150,1,00163,India
116106,2023-08-23,1012,Body Lotion,200,400,200,1,00175,India
640956,2023-08-23,1009,Moisturizer,250,500,250,1,00391,India
922988,2023-08-23,1001,Lipstick,150,300,150,1,00190,India
922988,2023-08-23,1003,Foundation,300,600,300,1,00190,India
488167,2023-08-23,1004,Eyeliner,100,200,100,1,00163,India
488167,2023-08-23,1002,Mascara,200,400,200,1,00163,India
937266,2023-08-23,1003,Foundation,300,600,300,1,00245,India
937266,2023-08-23,1004,Eyeliner,100,200,100,1,00245,India
937266,2023-08-23,1012,Body Lotion,200,400,200,1,00245,India
114366,2023-08-23,1012,Body Lotion,200,400,200,1,00496,India
114366,2023-08-23,1008,Makeup Remover,80,160,80,1,00496,India
748276,2023-08-23,1008,Makeup Remover,80,160,80,1,00179,India
748276,2023-08-23,1004,Eyeliner,100,200,100,1,00179,India
373424,2023-08-23,1006,Blush,150,300,150,1,00122,India
373424,2023-08-23,1005,Nail Polish,50,100,50,1,00122,India
373424,2023-08-23,1003,Foundation,300,600,300,1,00122,India
772503,2023-08-23,1003,Foundation,300,600,300,1,00092,India
772503,2023-08-23,1005,Nail Polish,50,100,50,1,00092,India
404394,2023-08-23,1003,Foundation,300,600,300,1,00316,India
404394,2023-08-23,1006,Blush,150,300,150,1,00316,India
404394,2023-08-23,1009,Moisturizer,250,500,250,1,00316,India
404394,2023-08-23,1004,Eyeliner,100,200,100,1,00316,India
167872,2023-08-23,1007,Eyeshadow,200,400,200,1,00239,India
167872,2023-08-23,1006,Blush,150,300,150,1,00239,India
167872,2023-08-23,1004,Eyeliner,100,200,100,1,00239,India
314627,2023-08-23,1003,Foundation,300,600,300,1,00023,India
314627,2023-08-23,1006,Blush,150,300,150,1,00023,India
642370,2023-08-23,1002,Mascara,200,400,200,1,00390,India
642370,2023-08-23,1008,Makeup Remover,80,160,80,1,00390,India
518034,2023-08-23,1005,Nail Polish,50,100,50,1,00413,India
586790,2023-08-23,1009,Moisturizer,250,500,250,1,00274,India
586790,2023-08-23,1002,Mascara,200,400,200,1,00274,India
602003,2023-08-23,1012,Body Lotion,200,400,200,1,00188,India
602003,2023-08-23,1006,Blush,150,300,150,1,00188,India
602003,2023-08-23,1002,Mascara,200,400,200,1,00188,India
406382,2023-08-23,1005,Nail Polish,50,100,50,1,00220,India
406382,2023-08-23,1012,Body Lotion,200,400,200,1,00220,India
406382,2023-08-23,1003,Foundation,300,600,300,1,00220,India
406382,2023-08-23,1001,Lipstick,150,300,150,1,00220,India
211054,2023-08-23,1002,Mascara,200,400,200,1,00483,India
211054,2023-08-23,1006,Blush,150,300,150,1,00483,India
211054,2023-08-23,1008,Makeup Remover,80,160,80,1,00483,India
895538,2023-08-23,1009,Moisturizer,250,500,250,1,00234,India
895538,2023-08-23,1007,Eyeshadow,200,400,200,1,00234,India
895538,2023-08-23,1001,Lipstick,150,300,150,1,00234,India
895538,2023-08-23,1004,Eyeliner,100,200,100,1,00234,India
433225,2023-08-23,1009,Moisturizer,250,500,250,1,00448,India
433225,2023-08-23,1012,Body Lotion,200,400,200,1,00448,India
940579,2023-08-23,1012,Body Lotion,200,400,200,1,00108,India
449189,2023-08-23,1005,Nail Polish,50,100,50,1,00438,India
449189,2023-08-23,1001,Lipstick,150,300,150,1,00438,India
180528,2023-08-24,1005,Nail Polish,50,100,50,1,00475,India
180528,2023-08-24,1004,Eyeliner,100,200,100,1,00475,India
180528,2023-08-24,1007,Eyeshadow,200,400,200,1,00475,India
743266,2023-08-24,1006,Blush,150,300,150,1,00448,India
743266,2023-08-24,1012,Body Lotion,200,400,200,1,00448,India
503578,2023-08-24,1002,Mascara,200,400,200,1,00167,India
128909,2023-08-24,1005,Nail Polish,50,100,50,1,00039,India
128909,2023-08-24,1002,Mascara,200,400,200,1,00039,India
128909,2023-08-24,1008,Makeup Remover,80,160,80,1,00039,India
128909,2023-08-24,1001,Lipstick,150,300,150,1,00039,India
147953,2023-08-24,1004,Eyeliner,100,200,100,1,00364,India
147953,2023-08-24,1007,Eyeshadow,200,400,200,1,00364,India
192267,2023-08-24,1008,Makeup Remover,80,160,80,1,00278,India
545748,2023-08-24,1007,Eyeshadow,200,400,200,1,00391,India
148213,2023-08-24,1004,Eyeliner,100,200,100,1,00044,India
148213,2023-08-24,1001,Lipstick,150,300,150,1,00044,India
317552,2023-08-24,1008,Makeup Remover,80,160,80,1,00408,India
370644,2023-08-24,1001,Lipstick,150,300,150,1,00454,India
370644,2023-08-24,1008,Makeup Remover,80,160,80,1,00454,India
370644,2023-08-24,1009,Moisturizer,250,500,250,1,00454,India
673077,2023-08-24,1004,Eyeliner,100,200,100,1,00450,India
673077,2023-08-24,1006,Blush,150,300,150,1,00450,India
466881,2023-08-24,1004,Eyeliner,100,200,100,1,00329,India
466881,2023-08-24,1005,Nail Polish,50,100,50,1,00329,India
466881,2023-08-24,1001,Lipstick,150,300,150,1,00329,India
466881,2023-08-24,1003,Foundation,300,600,300,1,00329,India
541957,2023-08-24,1002,Mascara,200,400,200,1,00061,India
541957,2023-08-24,1004,Eyeliner,100,200,100,1,00061,India
541957,2023-08-24,1001,Lipstick,150,300,150,1,00061,India
516407,2023-08-24,1001,Lipstick,150,300,150,1,00242,India
642514,2023-08-24,1004,Eyeliner,100,200,100,1,00235,India
642514,2023-08-24,1002,Mascara,200,400,200,1,00235,India
642514,2023-08-24,1012,Body Lotion,200,400,200,1,00235,India
642514,2023-08-24,1001,Lipstick,150,300,150,1,00235,India
720220,2023-08-24,1004,Eyeliner,100,200,100,1,00309,India
720220,2023-08-24,1006,Blush,150,300,150,1,00309,India
720220,2023-08-24,1003,Foundation,300,600,300,1,00309,India
234066,2023-08-24,1008,Makeup Remover,80,160,80,1,00071,India
234066,2023-08-24,1005,Nail Polish,50,100,50,1,00071,India
234066,2023-08-24,1006,Blush,150,300,150,1,00071,India
234066,2023-08-24,1012,Body Lotion,200,400,200,1,00071,India
234066,2023-08-24,1007,Eyeshadow,200,400,200,1,00071,India
527118,2023-08-24,1007,Eyeshadow,200,400,200,1,00447,India
527118,2023-08-24,1003,Foundation,300,600,300,1,00447,India
527118,2023-08-24,1005,Nail Polish,50,100,50,1,00447,India
131829,2023-08-24,1004,Eyeliner,100,200,100,1,00243,India
436820,2023-08-24,1006,Blush,150,300,150,1,00410,India
436820,2023-08-24,1009,Moisturizer,250,500,250,1,00410,India
677704,2023-08-24,1004,Eyeliner,100,200,100,1,00423,India
677704,2023-08-24,1002,Mascara,200,400,200,1,00423,India
677704,2023-08-24,1003,Foundation,300,600,300,1,00423,India
677704,2023-08-24,1007,Eyeshadow,200,400,200,1,00423,India
677704,2023-08-24,1005,Nail Polish,50,100,50,1,00423,India
321097,2023-08-24,1007,Eyeshadow,200,400,200,1,00458,India
321097,2023-08-24,1006,Blush,150,300,150,1,00458,India
321097,2023-08-24,1004,Eyeliner,100,200,100,1,00458,India
463463,2023-08-24,1004,Eyeliner,100,200,100,1,00405,India
791108,2023-08-24,1002,Mascara,200,400,200,1,00222,India
791108,2023-08-24,1003,Foundation,300,600,300,1,00222,India
189952,2023-08-24,1012,Body Lotion,200,400,200,1,00461,India
189952,2023-08-24,1003,Foundation,300,600,300,1,00461,India
362509,2023-08-24,1012,Body Lotion,200,400,200,1,00478,India
362509,2023-08-24,1001,Lipstick,150,300,150,1,00478,India
318157,2023-08-24,1012,Body Lotion,200,400,200,1,00291,India
837104,2023-08-24,1008,Makeup Remover,80,160,80,1,00402,India
513036,2023-08-24,1009,Moisturizer,250,500,250,1,00286,India
513036,2023-08-24,1008,Makeup Remover,80,160,80,1,00286,India
282228,2023-08-24,1006,Blush,150,300,150,1,00270,India
282228,2023-08-24,1007,Eyeshadow,200,400,200,1,00270,India
282228,2023-08-24,1003,Foundation,300,600,300,1,00270,India
782138,2023-08-25,1003,Foundation,300,600,300,1,00292,India
782138,2023-08-25,1005,Nail Polish,50,100,50,1,00292,India
782138,2023-08-25,1001,Lipstick,150,300,150,1,00292,India
952709,2023-08-25,1008,Makeup Remover,80,160,80,1,00121,India
454971,2023-08-25,1006,Blush,150,300,150,1,00280,India
454971,2023-08-25,1012,Body Lotion,200,400,200,1,00280,India
454971,2023-08-25,1004,Eyeliner,100,200,100,1,00280,India
454971,2023-08-25,1003,Foundation,300,600,300,1,00280,India
557903,2023-08-25,1007,Eyeshadow,200,400,200,1,00292,India
557903,2023-08-25,1008,Makeup Remover,80,160,80,1,00292,India
557903,2023-08-25,1012,Body Lotion,200,400,200,1,00292,India
557903,2023-08-25,1003,Foundation,300,600,300,1,00292,India
935372,2023-08-25,1001,Lipstick,150,300,150,1,00069,India
935372,2023-08-25,1003,Foundation,300,600,300,1,00069,India
935372,2023-08-25,1012,Body Lotion,200,400,200,1,00069,India
847301,2023-08-25,1005,Nail Polish,50,100,50,1,00268,India
774380,2023-08-25,1003,Foundation,300,600,300,1,00247,India
681094,2023-08-25,1003,Foundation,300,600,300,1,00044,India
681094,2023-08-25,1012,Body Lotion,200,400,200,1,00044,India
340257,2023-08-25,1004,Eyeliner,100,200,100,1,00480,India
340257,2023-08-25,1003,Foundation,300,600,300,1,00480,India
340257,2023-08-25,1005,Nail Polish,50,100,50,1,00480,India
337852,2023-08-25,1007,Eyeshadow,200,400,200,1,00083,India
386674,2023-08-25,1012,Body Lotion,200,400,200,1,00326,India
754905,2023-08-25,1009,Moisturizer,250,500,250,1,00111,India
754905,2023-08-25,1008,Makeup Remover,80,160,80,1,00111,India
142300,2023-08-25,1007,Eyeshadow,200,400,200,1,00328,India
142300,2023-08-25,1006,Blush,150,300,150,1,00328,India
142300,2023-08-25,1008,Makeup Remover,80,160,80,1,00328,India
142300,2023-08-25,1002,Mascara,200,400,200,1,00328,India
221589,2023-08-25,1002,Mascara,200,400,200,1,00359,India
221589,2023-08-25,1006,Blush,150,300,150,1,00359,India
221589,2023-08-25,1008,Makeup Remover,80,160,80,1,00359,India
279643,2023-08-25,1006,Blush,150,300,150,1,00170,India
371520,2023-08-25,1004,Eyeliner,100,200,100,1,00464,India
371520,2023-08-25,1001,Lipstick,150,300,150,1,00464,India
371520,2023-08-25,1002,Mascara,200,400,200,1,00464,India
371520,2023-08-25,1009,Moisturizer,250,500,250,1,00464,India
951056,2023-08-25,1004,Eyeliner,100,200,100,1,00028,India
951056,2023-08-25,1005,Nail Polish,50,100,50,1,00028,India
674193,2023-08-25,1008,Makeup Remover,80,160,80,1,00152,India
674193,2023-08-25,1005,Nail Polish,50,100,50,1,00152,India
674193,2023-08-25,1003,Foundation,300,600,300,1,00152,India
674193,2023-08-25,1004,Eyeliner,100,200,100,1,00152,India
718786,2023-08-25,1003,Foundation,300,600,300,1,00239,India
718786,2023-08-25,1008,Makeup Remover,80,160,80,1,00239,India
187565,2023-08-25,1001,Lipstick,150,300,150,1,00133,India
187565,2023-08-25,1003,Foundation,300,600,300,1,00133,India
187565,2023-08-25,1007,Eyeshadow,200,400,200,1,00133,India
490337,2023-08-25,1004,Eyeliner,100,200,100,1,00434,India
490337,2023-08-25,1006,Blush,150,300,150,1,00434,India
490337,2023-08-25,1007,Eyeshadow,200,400,200,1,00434,India
490337,2023-08-25,1005,Nail Polish,50,100,50,1,00434,India
168173,2023-08-25,1002,Mascara,200,400,200,1,00059,India
772889,2023-08-25,1012,Body Lotion,200,400,200,1,00387,India
772889,2023-08-25,1008,Makeup Remover,80,160,80,1,00387,India
772889,2023-08-25,1007,Eyeshadow,200,400,200,1,00387,India
135976,2023-08-25,1002,Mascara,200,400,200,1,00356,India
135976,2023-08-25,1007,Eyeshadow,200,400,200,1,00356,India
150620,2023-08-25,1006,Blush,150,300,150,1,00182,India
150620,2023-08-25,1002,Mascara,200,400,200,1,00182,India
150620,2023-08-25,1004,Eyeliner,100,200,100,1,00182,India
353284,2023-08-25,1004,Eyeliner,100,200,100,1,00419,India
353284,2023-08-25,1001,Lipstick,150,300,150,1,00419,India
353284,2023-08-25,1008,Makeup Remover,80,160,80,1,00419,India
817742,2023-08-25,1002,Mascara,200,400,200,1,00335,India
817742,2023-08-25,1003,Foundation,300,600,300,1,00335,India
831112,2023-08-25,1004,Eyeliner,100,200,100,1,00143,India
831112,2023-08-25,1012,Body Lotion,200,400,200,1,00143,India
804294,2023-08-25,1004,Eyeliner,100,200,100,1,00254,India
804294,2023-08-25,1007,Eyeshadow,200,400,200,1,00254,India
897883,2023-08-25,1005,Nail Polish,50,100,50,1,00104,India
897883,2023-08-25,1001,Lipstick,150,300,150,1,00104,India
897883,2023-08-25,1003,Foundation,300,600,300,1,00104,India
897883,2023-08-25,1008,Makeup Remover,80,160,80,1,00104,India
345922,2023-08-25,1005,Nail Polish,50,100,50,1,00070,India
382045,2023-08-25,1006,Blush,150,300,150,1,00243,India
133984,2023-08-25,1002,Mascara,200,400,200,1,00011,India
760787,2023-08-25,1002,Mascara,200,400,200,1,00240,India
760787,2023-08-25,1005,Nail Polish,50,100,50,1,00240,India
175235,2023-08-25,1005,Nail Polish,50,100,50,1,00052,India
175235,2023-08-25,1006,Blush,150,300,150,1,00052,India
175235,2023-08-25,1002,Mascara,200,400,200,1,00052,India
491892,2023-08-25,1002,Mascara,200,400,200,1,00059,India
491892,2023-08-25,1009,Moisturizer,250,500,250,1,00059,India
491892,2023-08-25,1007,Eyeshadow,200,400,200,1,00059,India
159360,2023-08-25,1009,Moisturizer,250,500,250,1,00011,India
159360,2023-08-25,1012,Body Lotion,200,400,200,1,00011,India
159360,2023-08-25,1004,Eyeliner,100,200,100,1,00011,India
838023,2023-08-25,1007,Eyeshadow,200,400,200,1,00176,India
838023,2023-08-25,1009,Moisturizer,250,500,250,1,00176,India
838023,2023-08-25,1003,Foundation,300,600,300,1,00176,India
838023,2023-08-25,1012,Body Lotion,200,400,200,1,00176,India
505771,2023-08-25,1004,Eyeliner,100,200,100,1,00143,India
505771,2023-08-25,1001,Lipstick,150,300,150,1,00143,India
989474,2023-08-25,1012,Body Lotion,200,400,200,1,00041,India
989474,2023-08-25,1002,Mascara,200,400,200,1,00041,India
288171,2023-08-25,1007,Eyeshadow,200,400,200,1,00492,India
288171,2023-08-25,1006,Blush,150,300,150,1,00492,India
288171,2023-08-25,1008,Makeup Remover,80,160,80,1,00492,India
960977,2023-08-25,1001,Lipstick,150,300,150,1,00093,India
960977,2023-08-25,1008,Makeup Remover,80,160,80,1,00093,India
960977,2023-08-25,1012,Body Lotion,200,400,200,1,00093,India
960977,2023-08-25,1005,Nail Polish,50,100,50,1,00093,India
960977,2023-08-25,1004,Eyeliner,100,200,100,1,00093,India
490006,2023-08-25,1009,Moisturizer,250,500,250,1,00294,India
490006,2023-08-25,1008,Makeup Remover,80,160,80,1,00294,India
490006,2023-08-25,1007,Eyeshadow,200,400,200,1,00294,India
253818,2023-08-25,1001,Lipstick,150,300,150,1,00112,India
226236,2023-08-26,1004,Eyeliner,100,200,100,1,00111,India
226236,2023-08-26,1012,Body Lotion,200,400,200,1,00111,India
226236,2023-08-26,1009,Moisturizer,250,500,250,1,00111,India
548491,2023-08-26,1009,Moisturizer,250,500,250,1,00156,India
548491,2023-08-26,1003,Foundation,300,600,300,1,00156,India
548491,2023-08-26,1008,Makeup Remover,80,160,80,1,00156,India
548491,2023-08-26,1001,Lipstick,150,300,150,1,00156,India
714328,2023-08-26,1007,Eyeshadow,200,400,200,1,00170,India
714328,2023-08-26,1012,Body Lotion,200,400,200,1,00170,India
731121,2023-08-26,1006,Blush,150,300,150,1,00480,India
731121,2023-08-26,1009,Moisturizer,250,500,250,1,00480,India
173081,2023-08-26,1008,Makeup Remover,80,160,80,1,00140,India
173081,2023-08-26,1006,Blush,150,300,150,1,00140,India
173081,2023-08-26,1009,Moisturizer,250,500,250,1,00140,India
173081,2023-08-26,1002,Mascara,200,400,200,1,00140,India
709170,2023-08-26,1004,Eyeliner,100,200,100,1,00343,India
709170,2023-08-26,1009,Moisturizer,250,500,250,1,00343,India
709170,2023-08-26,1005,Nail Polish,50,100,50,1,00343,India
698233,2023-08-26,1005,Nail Polish,50,100,50,1,00047,India
698233,2023-08-26,1001,Lipstick,150,300,150,1,00047,India
476091,2023-08-26,1003,Foundation,300,600,300,1,00122,India
476091,2023-08-26,1006,Blush,150,300,150,1,00122,India
841646,2023-08-26,1006,Blush,150,300,150,1,00098,India
841646,2023-08-26,1005,Nail Polish,50,100,50,1,00098,India
841646,2023-08-26,1003,Foundation,300,600,300,1,00098,India
685787,2023-08-26,1009,Moisturizer,250,500,250,1,00076,India
685787,2023-08-26,1001,Lipstick,150,300,150,1,00076,India
685787,2023-08-26,1008,Makeup Remover,80,160,80,1,00076,India
685787,2023-08-26,1002,Mascara,200,400,200,1,00076,India
465758,2023-08-26,1012,Body Lotion,200,400,200,1,00123,India
465758,2023-08-26,1009,Moisturizer,250,500,250,1,00123,India
465758,2023-08-26,1004,Eyeliner,100,200,100,1,00123,India
465758,2023-08-26,1003,Foundation,300,600,300,1,00123,India
319410,2023-08-26,1005,Nail Polish,50,100,50,1,00106,India
319410,2023-08-26,1002,Mascara,200,400,200,1,00106,India
712378,2023-08-26,1007,Eyeshadow,200,400,200,1,00413,India
712378,2023-08-26,1006,Blush,150,300,150,1,00413,India
325200,2023-08-26,1002,Mascara,200,400,200,1,00451,India
325200,2023-08-26,1005,Nail Polish,50,100,50,1,00451,India
325200,2023-08-26,1012,Body Lotion,200,400,200,1,00451,India
198518,2023-08-26,1012,Body Lotion,200,400,200,1,00341,India
198518,2023-08-26,1002,Mascara,200,400,200,1,00341,India
198518,2023-08-26,1009,Moisturizer,250,500,250,1,00341,India
198518,2023-08-26,1006,Blush,150,300,150,1,00341,India
198518,2023-08-26,1005,Nail Polish,50,100,50,1,00341,India
366973,2023-08-26,1009,Moisturizer,250,500,250,1,00418,India
366973,2023-08-26,1002,Mascara,200,400,200,1,00418,India
366973,2023-08-26,1004,Eyeliner,100,200,100,1,00418,India
366973,2023-08-26,1007,Eyeshadow,200,400,200,1,00418,India
407732,2023-08-26,1005,Nail Polish,50,100,50,1,00376,India
407732,2023-08-26,1003,Foundation,300,600,300,1,00376,India
381538,2023-08-26,1008,Makeup Remover,80,160,80,1,00021,India
381538,2023-08-26,1004,Eyeliner,100,200,100,1,00021,India
381538,2023-08-26,1012,Body Lotion,200,400,200,1,00021,India
107748,2023-08-26,1002,Mascara,200,400,200,1,00036,India
107748,2023-08-26,1005,Nail Polish,50,100,50,1,00036,India
368779,2023-08-26,1006,Blush,150,300,150,1,00446,India
368779,2023-08-26,1001,Lipstick,150,300,150,1,00446,India
368779,2023-08-26,1002,Mascara,200,400,200,1,00446,India
368779,2023-08-26,1004,Eyeliner,100,200,100,1,00446,India
881872,2023-08-26,1004,Eyeliner,100,200,100,1,00440,India
881872,2023-08-26,1003,Foundation,300,600,300,1,00440,India
881872,2023-08-26,1001,Lipstick,150,300,150,1,00440,India
814008,2023-08-26,1007,Eyeshadow,200,400,200,1,00220,India
814008,2023-08-26,1006,Blush,150,300,150,1,00220,India
814008,2023-08-26,1008,Makeup Remover,80,160,80,1,00220,India
814008,2023-08-26,1005,Nail Polish,50,100,50,1,00220,India
237612,2023-08-26,1001,Lipstick,150,300,150,1,00214,India
237612,2023-08-26,1012,Body Lotion,200,400,200,1,00214,India
237612,2023-08-26,1002,Mascara,200,400,200,1,00214,India
237612,2023-08-26,1009,Moisturizer,250,500,250,1,00214,India
712574,2023-08-26,1009,Moisturizer,250,500,250,1,00355,India
712574,2023-08-26,1001,Lipstick,150,300,150,1,00355,India
192843,2023-08-26,1012,Body Lotion,200,400,200,1,00139,India
192843,2023-08-26,1004,Eyeliner,100,200,100,1,00139,India
192843,2023-08-26,1001,Lipstick,150,300,150,1,00139,India
192843,2023-08-26,1002,Mascara,200,400,200,1,00139,India
464229,2023-08-26,1001,Lipstick,150,300,150,1,00015,India
464229,2023-08-26,1008,Makeup Remover,80,160,80,1,00015,India
464229,2023-08-26,1007,Eyeshadow,200,400,200,1,00015,India
464229,2023-08-26,1003,Foundation,300,600,300,1,00015,India
798019,2023-08-26,1008,Makeup Remover,80,160,80,1,00267,India
798019,2023-08-26,1003,Foundation,300,600,300,1,00267,India
973834,2023-08-26,1004,Eyeliner,100,200,100,1,00279,India
973834,2023-08-26,1001,Lipstick,150,300,150,1,00279,India
292548,2023-08-26,1002,Mascara,200,400,200,1,00118,India
292548,2023-08-26,1008,Makeup Remover,80,160,80,1,00118,India
100185,2023-08-26,1009,Moisturizer,250,500,250,1,00357,India
100185,2023-08-26,1002,Mascara,200,400,200,1,00357,India
100185,2023-08-26,1008,Makeup Remover,80,160,80,1,00357,India
137585,2023-08-27,1004,Eyeliner,100,200,100,1,00236,India
137585,2023-08-27,1012,Body Lotion,200,400,200,1,00236,India
968362,2023-08-27,1009,Moisturizer,250,500,250,1,00471,India
968362,2023-08-27,1008,Makeup Remover,80,160,80,1,00471,India
968362,2023-08-27,1004,Eyeliner,100,200,100,1,00471,India
968362,2023-08-27,1006,Blush,150,300,150,1,00471,India
968362,2023-08-27,1005,Nail Polish,50,100,50,1,00471,India
327074,2023-08-27,1012,Body Lotion,200,400,200,1,00170,India
327074,2023-08-27,1009,Moisturizer,250,500,250,1,00170,India
887176,2023-08-27,1009,Moisturizer,250,500,250,1,00336,India
918830,2023-08-27,1008,Makeup Remover,80,160,80,1,00134,India
918830,2023-08-27,1004,Eyeliner,100,200,100,1,00134,India
918830,2023-08-27,1006,Blush,150,300,150,1,00134,India
270048,2023-08-27,1007,Eyeshadow,200,400,200,1,00017,India
872395,2023-08-27,1003,Foundation,300,600,300,1,00053,India
872395,2023-08-27,1002,Mascara,200,400,200,1,00053,India
494864,2023-08-27,1006,Blush,150,300,150,1,00221,India
494864,2023-08-27,1001,Lipstick,150,300,150,1,00221,India
494864,2023-08-27,1012,Body Lotion,200,400,200,1,00221,India
676346,2023-08-27,1012,Body Lotion,200,400,200,1,00451,India
676346,2023-08-27,1006,Blush,150,300,150,1,00451,India
372601,2023-08-27,1002,Mascara,200,400,200,1,00046,India
372601,2023-08-27,1004,Eyeliner,100,200,100,1,00046,India
372601,2023-08-27,1009,Moisturizer,250,500,250,1,00046,India
372601,2023-08-27,1007,Eyeshadow,200,400,200,1,00046,India
656375,2023-08-27,1004,Eyeliner,100,200,100,1,00409,India
314338,2023-08-27,1006,Blush,150,300,150,1,00026,India
314338,2023-08-27,1002,Mascara,200,400,200,1,00026,India
989344,2023-08-27,1002,Mascara,200,400,200,1,00344,India
183665,2023-08-27,1002,Mascara,200,400,200,1,00218,India
183665,2023-08-27,1009,Moisturizer,250,500,250,1,00218,India
183665,2023-08-27,1001,Lipstick,150,300,150,1,00218,India
183665,2023-08-27,1003,Foundation,300,600,300,1,00218,India
731009,2023-08-27,1005,Nail Polish,50,100,50,1,00317,India
339503,2023-08-27,1006,Blush,150,300,150,1,00005,India
339503,2023-08-27,1002,Mascara,200,400,200,1,00005,India
339503,2023-08-27,1004,Eyeliner,100,200,100,1,00005,India
339503,2023-08-27,1012,Body Lotion,200,400,200,1,00005,India
339503,2023-08-27,1005,Nail Polish,50,100,50,1,00005,India
298663,2023-08-27,1003,Foundation,300,600,300,1,00244,India
298663,2023-08-27,1001,Lipstick,150,300,150,1,00244,India
298663,2023-08-27,1008,Makeup Remover,80,160,80,1,00244,India
298663,2023-08-27,1009,Moisturizer,250,500,250,1,00244,India
755051,2023-08-27,1001,Lipstick,150,300,150,1,00268,India
755051,2023-08-27,1005,Nail Polish,50,100,50,1,00268,India
755051,2023-08-27,1012,Body Lotion,200,400,200,1,00268,India
755051,2023-08-27,1008,Makeup Remover,80,160,80,1,00268,India
166913,2023-08-27,1004,Eyeliner,100,200,100,1,00492,India
166913,2023-08-27,1008,Makeup Remover,80,160,80,1,00492,India
166913,2023-08-27,1002,Mascara,200,400,200,1,00492,India
166913,2023-08-27,1012,Body Lotion,200,400,200,1,00492,India
942469,2023-08-27,1009,Moisturizer,250,500,250,1,00387,India
942469,2023-08-27,1005,Nail Polish,50,100,50,1,00387,India
942469,2023-08-27,1002,Mascara,200,400,200,1,00387,India
226826,2023-08-27,1009,Moisturizer,250,500,250,1,00194,India
226826,2023-08-27,1004,Eyeliner,100,200,100,1,00194,India
226826,2023-08-27,1001,Lipstick,150,300,150,1,00194,India
920668,2023-08-27,1007,Eyeshadow,200,400,200,1,00116,India
347247,2023-08-27,1004,Eyeliner,100,200,100,1,00476,India
347247,2023-08-27,1006,Blush,150,300,150,1,00476,India
180821,2023-08-27,1012,Body Lotion,200,400,200,1,00196,India
180821,2023-08-27,1005,Nail Polish,50,100,50,1,00196,India
180821,2023-08-27,1001,Lipstick,150,300,150,1,00196,India
180821,2023-08-27,1002,Mascara,200,400,200,1,00196,India
639742,2023-08-27,1001,Lipstick,150,300,150,1,00001,India
639742,2023-08-27,1006,Blush,150,300,150,1,00001,India
639742,2023-08-27,1009,Moisturizer,250,500,250,1,00001,India
820070,2023-08-27,1002,Mascara,200,400,200,1,00412,India
820070,2023-08-27,1007,Eyeshadow,200,400,200,1,00412,India
820070,2023-08-27,1012,Body Lotion,200,400,200,1,00412,India
820070,2023-08-27,1003,Foundation,300,600,300,1,00412,India
547963,2023-08-27,1008,Makeup Remover,80,160,80,1,00294,India
547963,2023-08-27,1009,Moisturizer,250,500,250,1,00294,India
873544,2023-08-27,1012,Body Lotion,200,400,200,1,00382,India
873544,2023-08-27,1006,Blush,150,300,150,1,00382,India
873544,2023-08-27,1007,Eyeshadow,200,400,200,1,00382,India
873544,2023-08-27,1008,Makeup Remover,80,160,80,1,00382,India
635990,2023-08-27,1008,Makeup Remover,80,160,80,1,00102,India
635990,2023-08-27,1012,Body Lotion,200,400,200,1,00102,India
635990,2023-08-27,1007,Eyeshadow,200,400,200,1,00102,India
635990,2023-08-27,1002,Mascara,200,400,200,1,00102,India
289592,2023-08-27,1001,Lipstick,150,300,150,1,00049,India
289592,2023-08-27,1006,Blush,150,300,150,1,00049,India
289592,2023-08-27,1005,Nail Polish,50,100,50,1,00049,India
744155,2023-08-27,1006,Blush,150,300,150,1,00488,India
744155,2023-08-27,1005,Nail Polish,50,100,50,1,00488,India
744155,2023-08-27,1001,Lipstick,150,300,150,1,00488,India
744155,2023-08-27,1009,Moisturizer,250,500,250,1,00488,India
156393,2023-08-27,1012,Body Lotion,200,400,200,1,00126,India
156393,2023-08-27,1001,Lipstick,150,300,150,1,00126,India
156393,2023-08-27,1007,Eyeshadow,200,400,200,1,00126,India
342640,2023-08-27,1008,Makeup Remover,80,160,80,1,00370,India
342640,2023-08-27,1007,Eyeshadow,200,400,200,1,00370,India
431722,2023-08-27,1003,Foundation,300,600,300,1,00394,India
683449,2023-08-27,1004,Eyeliner,100,200,100,1,00095,India
422620,2023-08-27,1008,Makeup Remover,80,160,80,1,00279,India
422620,2023-08-27,1004,Eyeliner,100,200,100,1,00279,India
422620,2023-08-27,1003,Foundation,300,600,300,1,00279,India
187468,2023-08-27,1012,Body Lotion,200,400,200,1,00338,India
187468,2023-08-27,1006,Blush,150,300,150,1,00338,India
794917,2023-08-27,1005,Nail Polish,50,100,50,1,00459,India
794917,2023-08-27,1004,Eyeliner,100,200,100,1,00459,India
794917,2023-08-27,1009,Moisturizer,250,500,250,1,00459,India
466393,2023-08-27,1008,Makeup Remover,80,160,80,1,00212,India
466393,2023-08-27,1012,Body Lotion,200,400,200,1,00212,India
466393,2023-08-27,1004,Eyeliner,100,200,100,1,00212,India
466393,2023-08-27,1007,Eyeshadow,200,400,200,1,00212,India
311954,2023-08-27,1002,Mascara,200,400,200,1,00041,India
311954,2023-08-27,1008,Makeup Remover,80,160,80,1,00041,India
454484,2023-08-27,1002,Mascara,200,400,200,1,00115,India
454484,2023-08-27,1006,Blush,150,300,150,1,00115,India
454484,2023-08-27,1009,Moisturizer,250,500,250,1,00115,India
454484,2023-08-27,1003,Foundation,300,600,300,1,00115,India
232246,2023-08-27,1004,Eyeliner,100,200,100,1,00355,India
232246,2023-08-27,1007,Eyeshadow,200,400,200,1,00355,India
232246,2023-08-27,1012,Body Lotion,200,400,200,1,00355,India
189343,2023-08-27,1008,Makeup Remover,80,160,80,1,00013,India
189343,2023-08-27,1007,Eyeshadow,200,400,200,1,00013,India
973367,2023-08-27,1012,Body Lotion,200,400,200,1,00087,India
327509,2023-08-27,1004,Eyeliner,100,200,100,1,00466,India
327509,2023-08-27,1012,Body Lotion,200,400,200,1,00466,India
365232,2023-08-27,1001,Lipstick,150,300,150,1,00286,India
365232,2023-08-27,1007,Eyeshadow,200,400,200,1,00286,India
273432,2023-08-27,1008,Makeup Remover,80,160,80,1,00386,India
273432,2023-08-27,1002,Mascara,200,400,200,1,00386,India
273432,2023-08-27,1004,Eyeliner,100,200,100,1,00386,India
998660,2023-08-27,1002,Mascara,200,400,200,1,00321,India
998660,2023-08-27,1004,Eyeliner,100,200,100,1,00321,India
998660,2023-08-27,1001,Lipstick,150,300,150,1,00321,India
998660,2023-08-27,1009,Moisturizer,250,500,250,1,00321,India
998660,2023-08-27,1012,Body Lotion,200,400,200,1,00321,India
697071,2023-08-27,1004,Eyeliner,100,200,100,1,00079,India
697071,2023-08-27,1012,Body Lotion,200,400,200,1,00079,India
697071,2023-08-27,1008,Makeup Remover,80,160,80,1,00079,India
955920,2023-08-28,1008,Makeup Remover,80,160,80,1,00059,India
955920,2023-08-28,1005,Nail Polish,50,100,50,1,00059,India
955920,2023-08-28,1001,Lipstick,150,300,150,1,00059,India
955920,2023-08-28,1007,Eyeshadow,200,400,200,1,00059,India
953139,2023-08-28,1003,Foundation,300,600,300,1,00202,India
239387,2023-08-28,1004,Eyeliner,100,200,100,1,00360,India
239387,2023-08-28,1003,Foundation,300,600,300,1,00360,India
239387,2023-08-28,1001,Lipstick,150,300,150,1,00360,India
239387,2023-08-28,1005,Nail Polish,50,100,50,1,00360,India
353813,2023-08-28,1004,Eyeliner,100,200,100,1,00223,India
353813,2023-08-28,1001,Lipstick,150,300,150,1,00223,India
427937,2023-08-28,1004,Eyeliner,100,200,100,1,00302,India
427937,2023-08-28,1001,Lipstick,150,300,150,1,00302,India
427937,2023-08-28,1008,Makeup Remover,80,160,80,1,00302,India
427937,2023-08-28,1007,Eyeshadow,200,400,200,1,00302,India
871370,2023-08-28,1007,Eyeshadow,200,400,200,1,00232,India
871370,2023-08-28,1012,Body Lotion,200,400,200,1,00232,India
871370,2023-08-28,1001,Lipstick,150,300,150,1,00232,India
871370,2023-08-28,1009,Moisturizer,250,500,250,1,00232,India
156838,2023-08-28,1003,Foundation,300,600,300,1,00448,India
156838,2023-08-28,1006,Blush,150,300,150,1,00448,India
156838,2023-08-28,1002,Mascara,200,400,200,1,00448,India
156838,2023-08-28,1005,Nail Polish,50,100,50,1,00448,India
106480,2023-08-28,1005,Nail Polish,50,100,50,1,00010,India
106480,2023-08-28,1009,Moisturizer,250,500,250,1,00010,India
106480,2023-08-28,1004,Eyeliner,100,200,100,1,00010,India
926476,2023-08-28,1012,Body Lotion,200,400,200,1,00243,India
926476,2023-08-28,1007,Eyeshadow,200,400,200,1,00243,India
926476,2023-08-28,1009,Moisturizer,250,500,250,1,00243,India
926476,2023-08-28,1005,Nail Polish,50,100,50,1,00243,India
547082,2023-08-28,1005,Nail Polish,50,100,50,1,00017,India
515802,2023-08-28,1006,Blush,150,300,150,1,00366,India
515802,2023-08-28,1007,Eyeshadow,200,400,200,1,00366,India
515802,2023-08-28,1009,Moisturizer,250,500,250,1,00366,India
451768,2023-08-28,1006,Blush,150,300,150,1,00033,India
451768,2023-08-28,1002,Mascara,200,400,200,1,00033,India
451768,2023-08-28,1001,Lipstick,150,300,150,1,00033,India
451768,2023-08-28,1004,Eyeliner,100,200,100,1,00033,India
508430,2023-08-28,1005,Nail Polish,50,100,50,1,00388,India
463817,2023-08-28,1005,Nail Polish,50,100,50,1,00320,India
463817,2023-08-28,1008,Makeup Remover,80,160,80,1,00320,India
463817,2023-08-28,1003,Foundation,300,600,300,1,00320,India
863888,2023-08-28,1003,Foundation,300,600,300,1,00146,India
863888,2023-08-28,1005,Nail Polish,50,100,50,1,00146,India
863888,2023-08-28,1009,Moisturizer,250,500,250,1,00146,India
863888,2023-08-28,1002,Mascara,200,400,200,1,00146,India
863888,2023-08-28,1006,Blush,150,300,150,1,00146,India
275593,2023-08-28,1002,Mascara,200,400,200,1,00356,India
275593,2023-08-28,1006,Blush,150,300,150,1,00356,India
275593,2023-08-28,1004,Eyeliner,100,200,100,1,00356,India
291882,2023-08-28,1012,Body Lotion,200,400,200,1,00095,India
291882,2023-08-28,1007,Eyeshadow,200,400,200,1,00095,India
191418,2023-08-28,1006,Blush,150,300,150,1,00010,India
322532,2023-08-28,1002,Mascara,200,400,200,1,00131,India
322532,2023-08-28,1003,Foundation,300,600,300,1,00131,India
322532,2023-08-28,1008,Makeup Remover,80,160,80,1,00131,India
322532,2023-08-28,1009,Moisturizer,250,500,250,1,00131,India
423509,2023-08-28,1006,Blush,150,300,150,1,00402,India
423509,2023-08-28,1012,Body Lotion,200,400,200,1,00402,India
423509,2023-08-28,1004,Eyeliner,100,200,100,1,00402,India
367023,2023-08-28,1005,Nail Polish,50,100,50,1,00025,India
367023,2023-08-28,1008,Makeup Remover,80,160,80,1,00025,India
525514,2023-08-28,1003,Foundation,300,600,300,1,00239,India
525514,2023-08-28,1007,Eyeshadow,200,400,200,1,00239,India
525514,2023-08-28,1005,Nail Polish,50,100,50,1,00239,India
685384,2023-08-28,1006,Blush,150,300,150,1,00170,India
304276,2023-08-28,1004,Eyeliner,100,200,100,1,00028,India
421665,2023-08-28,1005,Nail Polish,50,100,50,1,00383,India
421665,2023-08-28,1009,Moisturizer,250,500,250,1,00383,India
421665,2023-08-28,1007,Eyeshadow,200,400,200,1,00383,India
529463,2023-08-28,1006,Blush,150,300,150,1,00110,India
529463,2023-08-28,1012,Body Lotion,200,400,200,1,00110,India
529463,2023-08-28,1005,Nail Polish,50,100,50,1,00110,India
529463,2023-08-28,1002,Mascara,200,400,200,1,00110,India
291070,2023-08-28,1004,Eyeliner,100,200,100,1,00331,India
291070,2023-08-28,1006,Blush,150,300,150,1,00331,India
291070,2023-08-28,1002,Mascara,200,400,200,1,00331,India
884307,2023-08-28,1006,Blush,150,300,150,1,00299,India
884307,2023-08-28,1009,Moisturizer,250,500,250,1,00299,India
884307,2023-08-28,1003,Foundation,300,600,300,1,00299,India
267044,2023-08-28,1009,Moisturizer,250,500,250,1,00307,India
267044,2023-08-28,1002,Mascara,200,400,200,1,00307,India
267044,2023-08-28,1008,Makeup Remover,80,160,80,1,00307,India
930692,2023-08-28,1004,Eyeliner,100,200,100,1,00477,India
930692,2023-08-28,1001,Lipstick,150,300,150,1,00477,India
930692,2023-08-28,1012,Body Lotion,200,400,200,1,00477,India
826732,2023-08-28,1007,Eyeshadow,200,400,200,1,00030,India
826732,2023-08-28,1012,Body Lotion,200,400,200,1,00030,India
667392,2023-08-29,1007,Eyeshadow,200,400,200,1,00229,India
166495,2023-08-29,1006,Blush,150,300,150,1,00252,India
166495,2023-08-29,1003,Foundation,300,600,300,1,00252,India
166495,2023-08-29,1001,Lipstick,150,300,150,1,00252,India
713240,2023-08-29,1006,Blush,150,300,150,1,00413,India
713240,2023-08-29,1001,Lipstick,150,300,150,1,00413,India
662381,2023-08-29,1009,Moisturizer,250,500,250,1,00429,India
662381,2023-08-29,1006,Blush,150,300,150,1,00429,India
662381,2023-08-29,1002,Mascara,200,400,200,1,00429,India
907217,2023-08-29,1007,Eyeshadow,200,400,200,1,00025,India
907217,2023-08-29,1006,Blush,150,300,150,1,00025,India
907217,2023-08-29,1002,Mascara,200,400,200,1,00025,India
907217,2023-08-29,1001,Lipstick,150,300,150,1,00025,India
311832,2023-08-29,1012,Body Lotion,200,400,200,1,00075,India
311832,2023-08-29,1002,Mascara,200,400,200,1,00075,India
311832,2023-08-29,1001,Lipstick,150,300,150,1,00075,India
248773,2023-08-29,1006,Blush,150,300,150,1,00098,India
248773,2023-08-29,1007,Eyeshadow,200,400,200,1,00098,India
248773,2023-08-29,1008,Makeup Remover,80,160,80,1,00098,India
365025,2023-08-29,1005,Nail Polish,50,100,50,1,00286,India
365025,2023-08-29,1008,Makeup Remover,80,160,80,1,00286,India
365025,2023-08-29,1002,Mascara,200,400,200,1,00286,India
365025,2023-08-29,1001,Lipstick,150,300,150,1,00286,India
365025,2023-08-29,1006,Blush,150,300,150,1,00286,India
913343,2023-08-29,1001,Lipstick,150,300,150,1,00214,India
177373,2023-08-29,1005,Nail Polish,50,100,50,1,00170,India
177373,2023-08-29,1007,Eyeshadow,200,400,200,1,00170,India
177373,2023-08-29,1004,Eyeliner,100,200,100,1,00170,India
232840,2023-08-29,1012,Body Lotion,200,400,200,1,00324,India
232840,2023-08-29,1005,Nail Polish,50,100,50,1,00324,India
232840,2023-08-29,1001,Lipstick,150,300,150,1,00324,India
232840,2023-08-29,1007,Eyeshadow,200,400,200,1,00324,India
232840,2023-08-29,1009,Moisturizer,250,500,250,1,00324,India
659700,2023-08-29,1012,Body Lotion,200,400,200,1,00217,India
659700,2023-08-29,1003,Foundation,300,600,300,1,00217,India
659700,2023-08-29,1008,Makeup Remover,80,160,80,1,00217,India
492927,2023-08-29,1009,Moisturizer,250,500,250,1,00047,India
492927,2023-08-29,1004,Eyeliner,100,200,100,1,00047,India
626905,2023-08-29,1012,Body Lotion,200,400,200,1,00376,India
626905,2023-08-29,1007,Eyeshadow,200,400,200,1,00376,India
348861,2023-08-29,1002,Mascara,200,400,200,1,00133,India
348861,2023-08-29,1009,Moisturizer,250,500,250,1,00133,India
348861,2023-08-29,1005,Nail Polish,50,100,50,1,00133,India
197781,2023-08-29,1005,Nail Polish,50,100,50,1,00337,India
197781,2023-08-29,1012,Body Lotion,200,400,200,1,00337,India
197781,2023-08-29,1008,Makeup Remover,80,160,80,1,00337,India
197781,2023-08-29,1007,Eyeshadow,200,400,200,1,00337,India
105297,2023-08-29,1002,Mascara,200,400,200,1,00127,India
105297,2023-08-29,1008,Makeup Remover,80,160,80,1,00127,India
105297,2023-08-29,1006,Blush,150,300,150,1,00127,India
105297,2023-08-29,1003,Foundation,300,600,300,1,00127,India
317907,2023-08-29,1005,Nail Polish,50,100,50,1,00391,India
317907,2023-08-29,1009,Moisturizer,250,500,250,1,00391,India
317907,2023-08-29,1007,Eyeshadow,200,400,200,1,00391,India
317907,2023-08-29,1002,Mascara,200,400,200,1,00391,India
392368,2023-08-29,1008,Makeup Remover,80,160,80,1,00170,India
392368,2023-08-29,1003,Foundation,300,600,300,1,00170,India
392368,2023-08-29,1005,Nail Polish,50,100,50,1,00170,India
404244,2023-08-29,1001,Lipstick,150,300,150,1,00231,India
925382,2023-08-29,1008,Makeup Remover,80,160,80,1,00134,India
665125,2023-08-29,1008,Makeup Remover,80,160,80,1,00091,India
665125,2023-08-29,1004,Eyeliner,100,200,100,1,00091,India
665125,2023-08-29,1006,Blush,150,300,150,1,00091,India
276557,2023-08-29,1008,Makeup Remover,80,160,80,1,00393,India
276557,2023-08-29,1012,Body Lotion,200,400,200,1,00393,India
276557,2023-08-29,1002,Mascara,200,400,200,1,00393,India
276557,2023-08-29,1009,Moisturizer,250,500,250,1,00393,India
390494,2023-08-29,1007,Eyeshadow,200,400,200,1,00332,India
952942,2023-08-29,1008,Makeup Remover,80,160,80,1,00033,India
952942,2023-08-29,1004,Eyeliner,100,200,100,1,00033,India
245379,2023-08-29,1012,Body Lotion,200,400,200,1,00390,India
245379,2023-08-29,1008,Makeup Remover,80,160,80,1,00390,India
245379,2023-08-29,1002,Mascara,200,400,200,1,00390,India
245379,2023-08-29,1001,Lipstick,150,300,150,1,00390,India
977326,2023-08-29,1004,Eyeliner,100,200,100,1,00362,India
167816,2023-08-29,1008,Makeup Remover,80,160,80,1,00248,India
167816,2023-08-29,1007,Eyeshadow,200,400,200,1,00248,India
167816,2023-08-29,1001,Lipstick,150,300,150,1,00248,India
167816,2023-08-29,1003,Foundation,300,600,300,1,00248,India
319993,2023-08-29,1012,Body Lotion,200,400,200,1,00374,India
319993,2023-08-29,1005,Nail Polish,50,100,50,1,00374,India
164719,2023-08-29,1003,Foundation,300,600,300,1,00414,India
164719,2023-08-29,1004,Eyeliner,100,200,100,1,00414,India
913508,2023-08-29,1012,Body Lotion,200,400,200,1,00275,India
752088,2023-08-29,1007,Eyeshadow,200,400,200,1,00139,India
752088,2023-08-29,1006,Blush,150,300,150,1,00139,India
752088,2023-08-29,1012,Body Lotion,200,400,200,1,00139,India
752088,2023-08-29,1005,Nail Polish,50,100,50,1,00139,India
171672,2023-08-29,1008,Makeup Remover,80,160,80,1,00324,India
171672,2023-08-29,1002,Mascara,200,400,200,1,00324,India
783122,2023-08-29,1009,Moisturizer,250,500,250,1,00104,India
783122,2023-08-29,1005,Nail Polish,50,100,50,1,00104,India
783122,2023-08-29,1002,Mascara,200,400,200,1,00104,India
994840,2023-08-29,1002,Mascara,200,400,200,1,00072,India
994840,2023-08-29,1006,Blush,150,300,150,1,00072,India
994840,2023-08-29,1004,Eyeliner,100,200,100,1,00072,India
994840,2023-08-29,1012,Body Lotion,200,400,200,1,00072,India
340406,2023-08-29,1001,Lipstick,150,300,150,1,00261,India
431592,2023-08-29,1001,Lipstick,150,300,150,1,00377,India
431592,2023-08-29,1004,Eyeliner,100,200,100,1,00377,India
431592,2023-08-29,1008,Makeup Remover,80,160,80,1,00377,India
703710,2023-08-29,1008,Makeup Remover,80,160,80,1,00390,India
703710,2023-08-29,1001,Lipstick,150,300,150,1,00390,India
703710,2023-08-29,1002,Mascara,200,400,200,1,00390,India
703710,2023-08-29,1005,Nail Polish,50,100,50,1,00390,India
122304,2023-08-29,1004,Eyeliner,100,200,100,1,00395,India
122304,2023-08-29,1002,Mascara,200,400,200,1,00395,India
719961,2023-08-29,1001,Lipstick,150,300,150,1,00319,India
589755,2023-08-29,1007,Eyeshadow,200,400,200,1,00387,India
681076,2023-08-29,1009,Moisturizer,250,500,250,1,00491,India
681076,2023-08-29,1003,Foundation,300,600,300,1,00491,India
681076,2023-08-29,1002,Mascara,200,400,200,1,00491,India
681076,2023-08-29,1012,Body Lotion,200,400,200,1,00491,India
357608,2023-08-29,1004,Eyeliner,100,200,100,1,00182,India
357608,2023-08-29,1009,Moisturizer,250,500,250,1,00182,India
429330,2023-08-29,1001,Lipstick,150,300,150,1,00433,India
429330,2023-08-29,1008,Makeup Remover,80,160,80,1,00433,India
429330,2023-08-29,1005,Nail Polish,50,100,50,1,00433,India
467642,2023-08-29,1002,Mascara,200,400,200,1,00328,India
467642,2023-08-29,1004,Eyeliner,100,200,100,1,00328,India
467642,2023-08-29,1009,Moisturizer,250,500,250,1,00328,India
832318,2023-08-30,1006,Blush,150,300,150,1,00027,India
832318,2023-08-30,1004,Eyeliner,100,200,100,1,00027,India
832318,2023-08-30,1008,Makeup Remover,80,160,80,1,00027,India
286900,2023-08-30,1005,Nail Polish,50,100,50,1,00081,India
347450,2023-08-30,1012,Body Lotion,200,400,200,1,00166,India
347450,2023-08-30,1009,Moisturizer,250,500,250,1,00166,India
610602,2023-08-30,1008,Makeup Remover,80,160,80,1,00419,India
610602,2023-08-30,1012,Body Lotion,200,400,200,1,00419,India
610602,2023-08-30,1002,Mascara,200,400,200,1,00419,India
610602,2023-08-30,1009,Moisturizer,250,500,250,1,00419,India
402874,2023-08-30,1001,Lipstick,150,300,150,1,00005,India
402874,2023-08-30,1005,Nail Polish,50,100,50,1,00005,India
711561,2023-08-30,1012,Body Lotion,200,400,200,1,00416,India
711561,2023-08-30,1005,Nail Polish,50,100,50,1,00416,India
711561,2023-08-30,1007,Eyeshadow,200,400,200,1,00416,India
711561,2023-08-30,1009,Moisturizer,250,500,250,1,00416,India
576833,2023-08-30,1005,Nail Polish,50,100,50,1,00404,India
576833,2023-08-30,1006,Blush,150,300,150,1,00404,India
576833,2023-08-30,1002,Mascara,200,400,200,1,00404,India
379729,2023-08-30,1007,Eyeshadow,200,400,200,1,00416,India
379729,2023-08-30,1006,Blush,150,300,150,1,00416,India
379729,2023-08-30,1004,Eyeliner,100,200,100,1,00416,India
118024,2023-08-30,1001,Lipstick,150,300,150,1,00494,India
118024,2023-08-30,1003,Foundation,300,600,300,1,00494,India
118024,2023-08-30,1002,Mascara,200,400,200,1,00494,India
300552,2023-08-30,1005,Nail Polish,50,100,50,1,00244,India
300552,2023-08-30,1009,Moisturizer,250,500,250,1,00244,India
300552,2023-08-30,1002,Mascara,200,400,200,1,00244,India
300552,2023-08-30,1008,Makeup Remover,80,160,80,1,00244,India
357784,2023-08-30,1007,Eyeshadow,200,400,200,1,00362,India
357784,2023-08-30,1012,Body Lotion,200,400,200,1,00362,India
786439,2023-08-30,1008,Makeup Remover,80,160,80,1,00237,India
786439,2023-08-30,1006,Blush,150,300,150,1,00237,India
786439,2023-08-30,1009,Moisturizer,250,500,250,1,00237,India
584928,2023-08-30,1007,Eyeshadow,200,400,200,1,00462,India
584928,2023-08-30,1001,Lipstick,150,300,150,1,00462,India
720670,2023-08-30,1001,Lipstick,150,300,150,1,00314,India
720670,2023-08-30,1012,Body Lotion,200,400,200,1,00314,India
720670,2023-08-30,1003,Foundation,300,600,300,1,00314,India
720670,2023-08-30,1009,Moisturizer,250,500,250,1,00314,India
531700,2023-08-30,1002,Mascara,200,400,200,1,00497,India
683692,2023-08-30,1009,Moisturizer,250,500,250,1,00145,India
683692,2023-08-30,1006,Blush,150,300,150,1,00145,India
640659,2023-08-30,1003,Foundation,300,600,300,1,00445,India
640659,2023-08-30,1006,Blush,150,300,150,1,00445,India
374947,2023-08-30,1006,Blush,150,300,150,1,00226,India
675864,2023-08-30,1002,Mascara,200,400,200,1,00470,India
127919,2023-08-30,1012,Body Lotion,200,400,200,1,00306,India
127919,2023-08-30,1006,Blush,150,300,150,1,00306,India
127919,2023-08-30,1009,Moisturizer,250,500,250,1,00306,India
127919,2023-08-30,1008,Makeup Remover,80,160,80,1,00306,India
356811,2023-08-30,1008,Makeup Remover,80,160,80,1,00388,India
356811,2023-08-30,1003,Foundation,300,600,300,1,00388,India
356811,2023-08-30,1012,Body Lotion,200,400,200,1,00388,India
896108,2023-08-30,1009,Moisturizer,250,500,250,1,00023,India
896108,2023-08-30,1005,Nail Polish,50,100,50,1,00023,India
613440,2023-08-30,1008,Makeup Remover,80,160,80,1,00301,India
613440,2023-08-30,1003,Foundation,300,600,300,1,00301,India
613440,2023-08-30,1001,Lipstick,150,300,150,1,00301,India
613440,2023-08-30,1012,Body Lotion,200,400,200,1,00301,India
629871,2023-08-30,1009,Moisturizer,250,500,250,1,00189,India
629871,2023-08-30,1001,Lipstick,150,300,150,1,00189,India
629871,2023-08-30,1012,Body Lotion,200,400,200,1,00189,India
629871,2023-08-30,1003,Foundation,300,600,300,1,00189,India
774151,2023-08-30,1009,Moisturizer,250,500,250,1,00045,India
774151,2023-08-30,1012,Body Lotion,200,400,200,1,00045,India
774151,2023-08-30,1007,Eyeshadow,200,400,200,1,00045,India
194030,2023-08-30,1001,Lipstick,150,300,150,1,00413,India
194030,2023-08-30,1008,Makeup Remover,80,160,80,1,00413,India
896139,2023-08-30,1002,Mascara,200,400,200,1,00483,India
896139,2023-08-30,1005,Nail Polish,50,100,50,1,00483,India
896139,2023-08-30,1001,Lipstick,150,300,150,1,00483,India
896139,2023-08-30,1009,Moisturizer,250,500,250,1,00483,India
896139,2023-08-30,1006,Blush,150,300,150,1,00483,India
874135,2023-08-30,1005,Nail Polish,50,100,50,1,00272,India
874135,2023-08-30,1004,Eyeliner,100,200,100,1,00272,India
874135,2023-08-30,1009,Moisturizer,250,500,250,1,00272,India
874135,2023-08-30,1012,Body Lotion,200,400,200,1,00272,India
874135,2023-08-30,1006,Blush,150,300,150,1,00272,India
757089,2023-08-30,1004,Eyeliner,100,200,100,1,00206,India
757089,2023-08-30,1001,Lipstick,150,300,150,1,00206,India
885420,2023-08-30,1002,Mascara,200,400,200,1,00262,India
474602,2023-08-30,1002,Mascara,200,400,200,1,00264,India
474602,2023-08-30,1003,Foundation,300,600,300,1,00264,India
474602,2023-08-30,1012,Body Lotion,200,400,200,1,00264,India
264063,2023-08-30,1012,Body Lotion,200,400,200,1,00285,India
252746,2023-08-30,1007,Eyeshadow,200,400,200,1,00124,India
252746,2023-08-30,1003,Foundation,300,600,300,1,00124,India
540375,2023-08-30,1001,Lipstick,150,300,150,1,00491,India
180943,2023-08-31,1001,Lipstick,150,300,150,1,00158,India
180943,2023-08-31,1007,Eyeshadow,200,400,200,1,00158,India
105118,2023-08-31,1006,Blush,150,300,150,1,00216,India
105118,2023-08-31,1008,Makeup Remover,80,160,80,1,00216,India
105118,2023-08-31,1002,Mascara,200,400,200,1,00216,India
105118,2023-08-31,1003,Foundation,300,600,300,1,00216,India
862818,2023-08-31,1008,Makeup Remover,80,160,80,1,00184,India
862818,2023-08-31,1009,Moisturizer,250,500,250,1,00184,India
269236,2023-08-31,1003,Foundation,300,600,300,1,00344,India
269236,2023-08-31,1005,Nail Polish,50,100,50,1,00344,India
170846,2023-08-31,1007,Eyeshadow,200,400,200,1,00013,India
170846,2023-08-31,1006,Blush,150,300,150,1,00013,India
170846,2023-08-31,1004,Eyeliner,100,200,100,1,00013,India
880421,2023-08-31,1001,Lipstick,150,300,150,1,00385,India
880421,2023-08-31,1012,Body Lotion,200,400,200,1,00385,India
880421,2023-08-31,1007,Eyeshadow,200,400,200,1,00385,India
633544,2023-08-31,1006,Blush,150,300,150,1,00380,India
633544,2023-08-31,1001,Lipstick,150,300,150,1,00380,India
134890,2023-08-31,1012,Body Lotion,200,400,200,1,00266,India
977803,2023-08-31,1007,Eyeshadow,200,400,200,1,00053,India
977803,2023-08-31,1006,Blush,150,300,150,1,00053,India
677914,2023-08-31,1009,Moisturizer,250,500,250,1,00248,India
879449,2023-08-31,1008,Makeup Remover,80,160,80,1,00031,India
879449,2023-08-31,1003,Foundation,300,600,300,1,00031,India
719694,2023-08-31,1005,Nail Polish,50,100,50,1,00353,India
238242,2023-08-31,1012,Body Lotion,200,400,200,1,00068,India
238242,2023-08-31,1003,Foundation,300,600,300,1,00068,India
238242,2023-08-31,1002,Mascara,200,400,200,1,00068,India
536915,2023-08-31,1001,Lipstick,150,300,150,1,00303,India
536915,2023-08-31,1007,Eyeshadow,200,400,200,1,00303,India
536915,2023-08-31,1012,Body Lotion,200,400,200,1,00303,India
206884,2023-08-31,1007,Eyeshadow,200,400,200,1,00236,India
206884,2023-08-31,1008,Makeup Remover,80,160,80,1,00236,India
963531,2023-08-31,1007,Eyeshadow,200,400,200,1,00303,India
963531,2023-08-31,1004,Eyeliner,100,200,100,1,00303,India
963531,2023-08-31,1005,Nail Polish,50,100,50,1,00303,India
963531,2023-08-31,1003,Foundation,300,600,300,1,00303,India
963531,2023-08-31,1002,Mascara,200,400,200,1,00303,India
936727,2023-08-31,1008,Makeup Remover,80,160,80,1,00125,India
936727,2023-08-31,1006,Blush,150,300,150,1,00125,India
925023,2023-08-31,1006,Blush,150,300,150,1,00266,India
925023,2023-08-31,1008,Makeup Remover,80,160,80,1,00266,India
925023,2023-08-31,1001,Lipstick,150,300,150,1,00266,India
915005,2023-08-31,1012,Body Lotion,200,400,200,1,00017,India
915005,2023-08-31,1004,Eyeliner,100,200,100,1,00017,India
915005,2023-08-31,1007,Eyeshadow,200,400,200,1,00017,India
689213,2023-08-31,1002,Mascara,200,400,200,1,00297,India
857749,2023-08-31,1002,Mascara,200,400,200,1,00469,India
857749,2023-08-31,1005,Nail Polish,50,100,50,1,00469,India
857749,2023-08-31,1008,Makeup Remover,80,160,80,1,00469,India
766308,2023-08-31,1008,Makeup Remover,80,160,80,1,00313,India
766308,2023-08-31,1003,Foundation,300,600,300,1,00313,India
244244,2023-08-31,1009,Moisturizer,250,500,250,1,00459,India
244244,2023-08-31,1006,Blush,150,300,150,1,00459,India
244244,2023-08-31,1003,Foundation,300,600,300,1,00459,India
730591,2023-08-31,1002,Mascara,200,400,200,1,00061,India
730591,2023-08-31,1005,Nail Polish,50,100,50,1,00061,India
730591,2023-08-31,1006,Blush,150,300,150,1,00061,India
400261,2023-08-31,1009,Moisturizer,250,500,250,1,00081,India
707351,2023-08-31,1009,Moisturizer,250,500,250,1,00241,India
707351,2023-08-31,1012,Body Lotion,200,400,200,1,00241,India
779280,2023-08-31,1009,Moisturizer,250,500,250,1,00112,India
779280,2023-08-31,1008,Makeup Remover,80,160,80,1,00112,India
779280,2023-08-31,1006,Blush,150,300,150,1,00112,India
526640,2023-08-31,1006,Blush,150,300,150,1,00428,India
526640,2023-08-31,1004,Eyeliner,100,200,100,1,00428,India
526640,2023-08-31,1007,Eyeshadow,200,400,200,1,00428,India
592737,2023-08-31,1008,Makeup Remover,80,160,80,1,00252,India
938216,2023-08-31,1007,Eyeshadow,200,400,200,1,00234,India
938216,2023-08-31,1008,Makeup Remover,80,160,80,1,00234,India
938216,2023-08-31,1009,Moisturizer,250,500,250,1,00234,India
347171,2023-08-31,1008,Makeup Remover,80,160,80,1,00366,India
347171,2023-08-31,1009,Moisturizer,250,500,250,1,00366,India
347171,2023-08-31,1007,Eyeshadow,200,400,200,1,00366,India
347171,2023-08-31,1005,Nail Polish,50,100,50,1,00366,India
347171,2023-08-31,1012,Body Lotion,200,400,200,1,00366,India
475266,2023-08-31,1004,Eyeliner,100,200,100,1,00411,India
475266,2023-08-31,1009,Moisturizer,250,500,250,1,00411,India
145797,2023-08-31,1005,Nail Polish,50,100,50,1,00227,India
145797,2023-08-31,1001,Lipstick,150,300,150,1,00227,India
145797,2023-08-31,1007,Eyeshadow,200,400,200,1,00227,India
674294,2023-08-31,1005,Nail Polish,50,100,50,1,00150,India
164077,2023-08-31,1009,Moisturizer,250,500,250,1,00053,India
164077,2023-08-31,1001,Lipstick,150,300,150,1,00053,India
164077,2023-08-31,1007,Eyeshadow,200,400,200,1,00053,India
102864,2023-08-31,1009,Moisturizer,250,500,250,1,00439,India
102864,2023-08-31,1008,Makeup Remover,80,160,80,1,00439,India
102864,2023-08-31,1012,Body Lotion,200,400,200,1,00439,India
102864,2023-08-31,1001,Lipstick,150,300,150,1,00439,India
102864,2023-08-31,1003,Foundation,300,600,300,1,00439,India
477814,2023-08-31,1005,Nail Polish,50,100,50,1,00200,India
477814,2023-08-31,1008,Makeup Remover,80,160,80,1,00200,India
477814,2023-08-31,1012,Body Lotion,200,400,200,1,00200,India
477814,2023-08-31,1001,Lipstick,150,300,150,1,00200,India
345029,2023-08-31,1003,Foundation,300,600,300,1,00037,India
648959,2023-08-31,1006,Blush,150,300,150,1,00076,India
648959,2023-08-31,1002,Mascara,200,400,200,1,00076,India
648959,2023-08-31,1012,Body Lotion,200,400,200,1,00076,India
648959,2023-08-31,1008,Makeup Remover,80,160,80,1,00076,India
601352,2023-08-31,1012,Body Lotion,200,400,200,1,00306,India
601352,2023-08-31,1009,Moisturizer,250,500,250,1,00306,India
601352,2023-08-31,1003,Foundation,300,600,300,1,00306,India
601352,2023-08-31,1008,Makeup Remover,80,160,80,1,00306,India
126902,2023-08-31,1004,Eyeliner,100,200,100,1,00004,India
126902,2023-08-31,1012,Body Lotion,200,400,200,1,00004,India
126902,2023-08-31,1001,Lipstick,150,300,150,1,00004,India
126902,2023-08-31,1007,Eyeshadow,200,400,200,1,00004,India
408689,2023-08-31,1008,Makeup Remover,80,160,80,1,00025,India
947553,2023-08-31,1008,Makeup Remover,80,160,80,1,00127,India
947553,2023-08-31,1005,Nail Polish,50,100,50,1,00127,India
947553,2023-08-31,1003,Foundation,300,600,300,1,00127,India
139607,2023-09-01,1012,Body Lotion,200,400,200,1,00136,India
139607,2023-09-01,1004,Eyeliner,100,200,100,1,00136,India
961199,2023-09-01,1009,Moisturizer,250,500,250,1,00323,India
961199,2023-09-01,1007,Eyeshadow,200,400,200,1,00323,India
961199,2023-09-01,1003,Foundation,300,600,300,1,00323,India
961199,2023-09-01,1001,Lipstick,150,300,150,1,00323,India
374906,2023-09-01,1003,Foundation,300,600,300,1,00272,India
374906,2023-09-01,1006,Blush,150,300,150,1,00272,India
374906,2023-09-01,1007,Eyeshadow,200,400,200,1,00272,India
149069,2023-09-01,1008,Makeup Remover,80,160,80,1,00231,India
149069,2023-09-01,1004,Eyeliner,100,200,100,1,00231,India
440911,2023-09-01,1009,Moisturizer,250,500,250,1,00099,India
440911,2023-09-01,1004,Eyeliner,100,200,100,1,00099,India
440911,2023-09-01,1003,Foundation,300,600,300,1,00099,India
440911,2023-09-01,1012,Body Lotion,200,400,200,1,00099,India
669590,2023-09-01,1005,Nail Polish,50,100,50,1,00142,India
669590,2023-09-01,1004,Eyeliner,100,200,100,1,00142,India
669590,2023-09-01,1002,Mascara,200,400,200,1,00142,India
669590,2023-09-01,1003,Foundation,300,600,300,1,00142,India
663423,2023-09-01,1004,Eyeliner,100,200,100,1,00271,India
210414,2023-09-01,1005,Nail Polish,50,100,50,1,00122,India
210414,2023-09-01,1012,Body Lotion,200,400,200,1,00122,India
210414,2023-09-01,1008,Makeup Remover,80,160,80,1,00122,India
210414,2023-09-01,1002,Mascara,200,400,200,1,00122,India
791883,2023-09-01,1009,Moisturizer,250,500,250,1,00485,India
791883,2023-09-01,1007,Eyeshadow,200,400,200,1,00485,India
791883,2023-09-01,1001,Lipstick,150,300,150,1,00485,India
292262,2023-09-01,1003,Foundation,300,600,300,1,00383,India
292262,2023-09-01,1009,Moisturizer,250,500,250,1,00383,India
292262,2023-09-01,1004,Eyeliner,100,200,100,1,00383,India
292262,2023-09-01,1005,Nail Polish,50,100,50,1,00383,India
575800,2023-09-01,1003,Foundation,300,600,300,1,00175,India
575800,2023-09-01,1012,Body Lotion,200,400,200,1,00175,India
575800,2023-09-01,1002,Mascara,200,400,200,1,00175,India
575800,2023-09-01,1001,Lipstick,150,300,150,1,00175,India
727294,2023-09-01,1007,Eyeshadow,200,400,200,1,00370,India
727294,2023-09-01,1005,Nail Polish,50,100,50,1,00370,India
127030,2023-09-01,1006,Blush,150,300,150,1,00300,India
127030,2023-09-01,1005,Nail Polish,50,100,50,1,00300,India
127030,2023-09-01,1002,Mascara,200,400,200,1,00300,India
951527,2023-09-01,1004,Eyeliner,100,200,100,1,00194,India
990470,2023-09-01,1008,Makeup Remover,80,160,80,1,00488,India
990470,2023-09-01,1001,Lipstick,150,300,150,1,00488,India
990470,2023-09-01,1009,Moisturizer,250,500,250,1,00488,India
990470,2023-09-01,1004,Eyeliner,100,200,100,1,00488,India
421753,2023-09-01,1001,Lipstick,150,300,150,1,00375,India
421753,2023-09-01,1005,Nail Polish,50,100,50,1,00375,India
727677,2023-09-01,1007,Eyeshadow,200,400,200,1,00233,India
727677,2023-09-01,1005,Nail Polish,50,100,50,1,00233,India
477319,2023-09-01,1007,Eyeshadow,200,400,200,1,00377,India
843324,2023-09-01,1001,Lipstick,150,300,150,1,00366,India
843324,2023-09-01,1012,Body Lotion,200,400,200,1,00366,India
440905,2023-09-01,1004,Eyeliner,100,200,100,1,00240,India
440905,2023-09-01,1007,Eyeshadow,200,400,200,1,00240,India
440905,2023-09-01,1006,Blush,150,300,150,1,00240,India
420385,2023-09-01,1004,Eyeliner,100,200,100,1,00151,India
420385,2023-09-01,1009,Moisturizer,250,500,250,1,00151,India
420385,2023-09-01,1008,Makeup Remover,80,160,80,1,00151,India
434379,2023-09-01,1009,Moisturizer,250,500,250,1,00078,India
434379,2023-09-01,1005,Nail Polish,50,100,50,1,00078,India
434379,2023-09-01,1003,Foundation,300,600,300,1,00078,India
133542,2023-09-01,1002,Mascara,200,400,200,1,00398,India
133542,2023-09-01,1003,Foundation,300,600,300,1,00398,India
324471,2023-09-01,1002,Mascara,200,400,200,1,00191,India
507007,2023-09-01,1012,Body Lotion,200,400,200,1,00383,India
507007,2023-09-01,1008,Makeup Remover,80,160,80,1,00383,India
507007,2023-09-01,1001,Lipstick,150,300,150,1,00383,India
507007,2023-09-01,1007,Eyeshadow,200,400,200,1,00383,India
397300,2023-09-01,1004,Eyeliner,100,200,100,1,00038,India
397300,2023-09-01,1007,Eyeshadow,200,400,200,1,00038,India
351711,2023-09-01,1001,Lipstick,150,300,150,1,00359,India
453329,2023-09-01,1001,Lipstick,150,300,150,1,00481,India
453329,2023-09-01,1007,Eyeshadow,200,400,200,1,00481,India
453329,2023-09-01,1012,Body Lotion,200,400,200,1,00481,India
453329,2023-09-01,1004,Eyeliner,100,200,100,1,00481,India
775799,2023-09-01,1002,Mascara,200,400,200,1,00295,India
775799,2023-09-01,1009,Moisturizer,250,500,250,1,00295,India
774286,2023-09-01,1003,Foundation,300,600,300,1,00250,India
774286,2023-09-01,1007,Eyeshadow,200,400,200,1,00250,India
774286,2023-09-01,1004,Eyeliner,100,200,100,1,00250,India
774286,2023-09-01,1008,Makeup Remover,80,160,80,1,00250,India
774286,2023-09-01,1005,Nail Polish,50,100,50,1,00250,India
898321,2023-09-01,1012,Body Lotion,200,400,200,1,00122,India
970805,2023-09-01,1007,Eyeshadow,200,400,200,1,00220,India
431326,2023-09-01,1003,Foundation,300,600,300,1,00086,India
431326,2023-09-01,1005,Nail Polish,50,100,50,1,00086,India
759587,2023-09-01,1012,Body Lotion,200,400,200,1,00426,India
759587,2023-09-01,1002,Mascara,200,400,200,1,00426,India
759587,2023-09-01,1001,Lipstick,150,300,150,1,00426,India
293883,2023-09-01,1004,Eyeliner,100,200,100,1,00018,India
293883,2023-09-01,1012,Body Lotion,200,400,200,1,00018,India
293883,2023-09-01,1008,Makeup Remover,80,160,80,1,00018,India
293883,2023-09-01,1006,Blush,150,300,150,1,00018,India
293883,2023-09-01,1007,Eyeshadow,200,400,200,1,00018,India
229590,2023-09-01,1003,Foundation,300,600,300,1,00296,India
723578,2023-09-02,1001,Lipstick,150,300,150,1,00451,India
723578,2023-09-02,1008,Makeup Remover,80,160,80,1,00451,India
785363,2023-09-02,1001,Lipstick,150,300,150,1,00132,India
785363,2023-09-02,1006,Blush,150,300,150,1,00132,India
785363,2023-09-02,1008,Makeup Remover,80,160,80,1,00132,India
785363,2023-09-02,1007,Eyeshadow,200,400,200,1,00132,India
540580,2023-09-02,1002,Mascara,200,400,200,1,00069,India
540580,2023-09-02,1005,Nail Polish,50,100,50,1,00069,India
540580,2023-09-02,1007,Eyeshadow,200,400,200,1,00069,India
710762,2023-09-02,1007,Eyeshadow,200,400,200,1,00007,India
710762,2023-09-02,1001,Lipstick,150,300,150,1,00007,India
710762,2023-09-02,1002,Mascara,200,400,200,1,00007,India
572052,2023-09-02,1002,Mascara,200,400,200,1,00441,India
718775,2023-09-02,1012,Body Lotion,200,400,200,1,00129,India
718775,2023-09-02,1002,Mascara,200,400,200,1,00129,India
718775,2023-09-02,1007,Eyeshadow,200,400,200,1,00129,India
757496,2023-09-02,1003,Foundation,300,600,300,1,00316,India
757496,2023-09-02,1005,Nail Polish,50,100,50,1,00316,India
757496,2023-09-02,1002,Mascara,200,400,200,1,00316,India
757496,2023-09-02,1004,Eyeliner,100,200,100,1,00316,India
903799,2023-09-02,1003,Foundation,300,600,300,1,00068,India
903799,2023-09-02,1006,Blush,150,300,150,1,00068,India
903799,2023-09-02,1009,Moisturizer,250,500,250,1,00068,India
903799,2023-09-02,1005,Nail Polish,50,100,50,1,00068,India
742643,2023-09-02,1007,Eyeshadow,200,400,200,1,00171,India
661170,2023-09-02,1002,Mascara,200,400,200,1,00418,India
661170,2023-09-02,1005,Nail Polish,50,100,50,1,00418,India
661170,2023-09-02,1009,Moisturizer,250,500,250,1,00418,India
661170,2023-09-02,1004,Eyeliner,100,200,100,1,00418,India
661170,2023-09-02,1012,Body Lotion,200,400,200,1,00418,India
357705,2023-09-02,1009,Moisturizer,250,500,250,1,00060,India
357705,2023-09-02,1008,Makeup Remover,80,160,80,1,00060,India
357705,2023-09-02,1007,Eyeshadow,200,400,200,1,00060,India
985338,2023-09-02,1005,Nail Polish,50,100,50,1,00095,India
684725,2023-09-02,1008,Makeup Remover,80,160,80,1,00166,India
684725,2023-09-02,1006,Blush,150,300,150,1,00166,India
684725,2023-09-02,1009,Moisturizer,250,500,250,1,00166,India
684725,2023-09-02,1005,Nail Polish,50,100,50,1,00166,India
903342,2023-09-02,1004,Eyeliner,100,200,100,1,00464,India
903342,2023-09-02,1007,Eyeshadow,200,400,200,1,00464,India
898851,2023-09-02,1005,Nail Polish,50,100,50,1,00224,India
671488,2023-09-02,1005,Nail Polish,50,100,50,1,00273,India
671488,2023-09-02,1004,Eyeliner,100,200,100,1,00273,India
671488,2023-09-02,1006,Blush,150,300,150,1,00273,India
671488,2023-09-02,1002,Mascara,200,400,200,1,00273,India
532031,2023-09-02,1012,Body Lotion,200,400,200,1,00332,India
533260,2023-09-02,1009,Moisturizer,250,500,250,1,00491,India
533260,2023-09-02,1002,Mascara,200,400,200,1,00491,India
943851,2023-09-02,1012,Body Lotion,200,400,200,1,00300,India
943851,2023-09-02,1004,Eyeliner,100,200,100,1,00300,India
943851,2023-09-02,1005,Nail Polish,50,100,50,1,00300,India
923473,2023-09-02,1002,Mascara,200,400,200,1,00105,India
372964,2023-09-02,1003,Foundation,300,600,300,1,00193,India
372964,2023-09-02,1005,Nail Polish,50,100,50,1,00193,India
372964,2023-09-02,1009,Moisturizer,250,500,250,1,00193,India
874252,2023-09-02,1001,Lipstick,150,300,150,1,00022,India
874252,2023-09-02,1003,Foundation,300,600,300,1,00022,India
874252,2023-09-02,1006,Blush,150,300,150,1,00022,India
944165,2023-09-02,1009,Moisturizer,250,500,250,1,00293,India
944165,2023-09-02,1002,Mascara,200,400,200,1,00293,India
944165,2023-09-02,1007,Eyeshadow,200,400,200,1,00293,India
243873,2023-09-02,1005,Nail Polish,50,100,50,1,00182,India
243873,2023-09-02,1009,Moisturizer,250,500,250,1,00182,India
896418,2023-09-02,1001,Lipstick,150,300,150,1,00495,India
896418,2023-09-02,1006,Blush,150,300,150,1,00495,India
896418,2023-09-02,1009,Moisturizer,250,500,250,1,00495,India
488769,2023-09-02,1004,Eyeliner,100,200,100,1,00008,India
844187,2023-09-02,1006,Blush,150,300,150,1,00202,India
844187,2023-09-02,1003,Foundation,300,600,300,1,00202,India
303026,2023-09-02,1002,Mascara,200,400,200,1,00065,India
303026,2023-09-02,1003,Foundation,300,600,300,1,00065,India
261183,2023-09-02,1008,Makeup Remover,80,160,80,1,00104,India
261183,2023-09-02,1002,Mascara,200,400,200,1,00104,India
261183,2023-09-02,1009,Moisturizer,250,500,250,1,00104,India
261183,2023-09-02,1004,Eyeliner,100,200,100,1,00104,India
261183,2023-09-02,1005,Nail Polish,50,100,50,1,00104,India
385746,2023-09-02,1002,Mascara,200,400,200,1,00319,India
385746,2023-09-02,1007,Eyeshadow,200,400,200,1,00319,India
917133,2023-09-02,1003,Foundation,300,600,300,1,00133,India
917133,2023-09-02,1004,Eyeliner,100,200,100,1,00133,India
917133,2023-09-02,1009,Moisturizer,250,500,250,1,00133,India
917133,2023-09-02,1002,Mascara,200,400,200,1,00133,India
917133,2023-09-02,1012,Body Lotion,200,400,200,1,00133,India
960858,2023-09-02,1004,Eyeliner,100,200,100,1,00131,India
215738,2023-09-02,1002,Mascara,200,400,200,1,00078,India
215738,2023-09-02,1003,Foundation,300,600,300,1,00078,India
982483,2023-09-02,1006,Blush,150,300,150,1,00104,India
423626,2023-09-02,1002,Mascara,200,400,200,1,00417,India
423626,2023-09-02,1007,Eyeshadow,200,400,200,1,00417,India
423626,2023-09-02,1003,Foundation,300,600,300,1,00417,India
423626,2023-09-02,1001,Lipstick,150,300,150,1,00417,India
558468,2023-09-02,1007,Eyeshadow,200,400,200,1,00445,India
558468,2023-09-02,1001,Lipstick,150,300,150,1,00445,India
532155,2023-09-03,1002,Mascara,200,400,200,1,00095,India
532155,2023-09-03,1003,Foundation,300,600,300,1,00095,India
532155,2023-09-03,1006,Blush,150,300,150,1,00095,India
532155,2023-09-03,1004,Eyeliner,100,200,100,1,00095,India
532155,2023-09-03,1009,Moisturizer,250,500,250,1,00095,India
525591,2023-09-03,1001,Lipstick,150,300,150,1,00095,India
525591,2023-09-03,1007,Eyeshadow,200,400,200,1,00095,India
525591,2023-09-03,1006,Blush,150,300,150,1,00095,India
525591,2023-09-03,1012,Body Lotion,200,400,200,1,00095,India
265591,2023-09-03,1008,Makeup Remover,80,160,80,1,00282,India
265591,2023-09-03,1012,Body Lotion,200,400,200,1,00282,India
265591,2023-09-03,1005,Nail Polish,50,100,50,1,00282,India
996412,2023-09-03,1003,Foundation,300,600,300,1,00281,India
996412,2023-09-03,1009,Moisturizer,250,500,250,1,00281,India
996412,2023-09-03,1004,Eyeliner,100,200,100,1,00281,India
996412,2023-09-03,1012,Body Lotion,200,400,200,1,00281,India
635626,2023-09-03,1005,Nail Polish,50,100,50,1,00145,India
635626,2023-09-03,1007,Eyeshadow,200,400,200,1,00145,India
635626,2023-09-03,1006,Blush,150,300,150,1,00145,India
430703,2023-09-03,1004,Eyeliner,100,200,100,1,00270,India
430703,2023-09-03,1012,Body Lotion,200,400,200,1,00270,India
430703,2023-09-03,1009,Moisturizer,250,500,250,1,00270,India
517805,2023-09-03,1005,Nail Polish,50,100,50,1,00361,India
103545,2023-09-03,1002,Mascara,200,400,200,1,00196,India
103545,2023-09-03,1004,Eyeliner,100,200,100,1,00196,India
485915,2023-09-03,1008,Makeup Remover,80,160,80,1,00086,India
485915,2023-09-03,1007,Eyeshadow,200,400,200,1,00086,India
485915,2023-09-03,1005,Nail Polish,50,100,50,1,00086,India
126106,2023-09-03,1004,Eyeliner,100,200,100,1,00075,India
547444,2023-09-03,1001,Lipstick,150,300,150,1,00455,India
547444,2023-09-03,1012,Body Lotion,200,400,200,1,00455,India
863986,2023-09-03,1006,Blush,150,300,150,1,00103,India
863986,2023-09-03,1007,Eyeshadow,200,400,200,1,00103,India
325087,2023-09-03,1005,Nail Polish,50,100,50,1,00355,India
969020,2023-09-03,1008,Makeup Remover,80,160,80,1,00395,India
969020,2023-09-03,1006,Blush,150,300,150,1,00395,India
688997,2023-09-03,1008,Makeup Remover,80,160,80,1,00020,India
688997,2023-09-03,1007,Eyeshadow,200,400,200,1,00020,India
688997,2023-09-03,1001,Lipstick,150,300,150,1,00020,India
618884,2023-09-03,1006,Blush,150,300,150,1,00018,India
618884,2023-09-03,1003,Foundation,300,600,300,1,00018,India
326825,2023-09-03,1004,Eyeliner,100,200,100,1,00014,India
650714,2023-09-03,1012,Body Lotion,200,400,200,1,00121,India
988799,2023-09-03,1007,Eyeshadow,200,400,200,1,00441,India
988799,2023-09-03,1009,Moisturizer,250,500,250,1,00441,India
988799,2023-09-03,1012,Body Lotion,200,400,200,1,00441,India
754404,2023-09-03,1004,Eyeliner,100,200,100,1,00474,India
754404,2023-09-03,1001,Lipstick,150,300,150,1,00474,India
754404,2023-09-03,1003,Foundation,300,600,300,1,00474,India
545879,2023-09-03,1001,Lipstick,150,300,150,1,00316,India
545879,2023-09-03,1009,Moisturizer,250,500,250,1,00316,India
971348,2023-09-03,1003,Foundation,300,600,300,1,00071,India
191993,2023-09-03,1003,Foundation,300,600,300,1,00394,India
150093,2023-09-03,1012,Body Lotion,200,400,200,1,00374,India
150093,2023-09-03,1004,Eyeliner,100,200,100,1,00374,India
150093,2023-09-03,1002,Mascara,200,400,200,1,00374,India
150093,2023-09-03,1001,Lipstick,150,300,150,1,00374,India
150093,2023-09-03,1008,Makeup Remover,80,160,80,1,00374,India
819066,2023-09-03,1005,Nail Polish,50,100,50,1,00319,India
819066,2023-09-03,1007,Eyeshadow,200,400,200,1,00319,India
819066,2023-09-03,1002,Mascara,200,400,200,1,00319,India
366780,2023-09-03,1009,Moisturizer,250,500,250,1,00384,India
366780,2023-09-03,1005,Nail Polish,50,100,50,1,00384,India
366780,2023-09-03,1007,Eyeshadow,200,400,200,1,00384,India
823461,2023-09-03,1009,Moisturizer,250,500,250,1,00367,India
823461,2023-09-03,1004,Eyeliner,100,200,100,1,00367,India
823461,2023-09-03,1003,Foundation,300,600,300,1,00367,India
409452,2023-09-03,1003,Foundation,300,600,300,1,00444,India
658911,2023-09-03,1003,Foundation,300,600,300,1,00381,India
658911,2023-09-03,1002,Mascara,200,400,200,1,00381,India
658911,2023-09-03,1005,Nail Polish,50,100,50,1,00381,India
658911,2023-09-03,1004,Eyeliner,100,200,100,1,00381,India
855644,2023-09-03,1009,Moisturizer,250,500,250,1,00253,India
855644,2023-09-03,1012,Body Lotion,200,400,200,1,00253,India
855644,2023-09-03,1007,Eyeshadow,200,400,200,1,00253,India
501722,2023-09-03,1007,Eyeshadow,200,400,200,1,00005,India
501722,2023-09-03,1002,Mascara,200,400,200,1,00005,India
501722,2023-09-03,1001,Lipstick,150,300,150,1,00005,India
501722,2023-09-03,1005,Nail Polish,50,100,50,1,00005,India
367618,2023-09-03,1009,Moisturizer,250,500,250,1,00384,India
367618,2023-09-03,1005,Nail Polish,50,100,50,1,00384,India
233893,2023-09-03,1009,Moisturizer,250,500,250,1,00348,India
233893,2023-09-03,1008,Makeup Remover,80,160,80,1,00348,India
755666,2023-09-03,1006,Blush,150,300,150,1,00198,India
148849,2023-09-03,1004,Eyeliner,100,200,100,1,00114,India
665575,2023-09-03,1006,Blush,150,300,150,1,00022,India
665575,2023-09-03,1002,Mascara,200,400,200,1,00022,India
285924,2023-09-03,1004,Eyeliner,100,200,100,1,00007,India
285924,2023-09-03,1012,Body Lotion,200,400,200,1,00007,India
285924,2023-09-03,1005,Nail Polish,50,100,50,1,00007,India
285924,2023-09-03,1009,Moisturizer,250,500,250,1,00007,India
285924,2023-09-03,1001,Lipstick,150,300,150,1,00007,India
235111,2023-09-03,1002,Mascara,200,400,200,1,00190,India
235111,2023-09-03,1001,Lipstick,150,300,150,1,00190,India
368441,2023-09-03,1003,Foundation,300,600,300,1,00363,India
368441,2023-09-03,1008,Makeup Remover,80,160,80,1,00363,India
368441,2023-09-03,1004,Eyeliner,100,200,100,1,00363,India
368441,2023-09-03,1005,Nail Polish,50,100,50,1,00363,India
242548,2023-09-03,1004,Eyeliner,100,200,100,1,00075,India
846486,2023-09-04,1005,Nail Polish,50,100,50,1,00296,India
846486,2023-09-04,1007,Eyeshadow,200,400,200,1,00296,India
846486,2023-09-04,1009,Moisturizer,250,500,250,1,00296,India
653710,2023-09-04,1007,Eyeshadow,200,400,200,1,00049,India
455745,2023-09-04,1004,Eyeliner,100,200,100,1,00040,India
416520,2023-09-04,1009,Moisturizer,250,500,250,1,00098,India
416520,2023-09-04,1007,Eyeshadow,200,400,200,1,00098,India
416520,2023-09-04,1006,Blush,150,300,150,1,00098,India
416520,2023-09-04,1004,Eyeliner,100,200,100,1,00098,India
496825,2023-09-04,1005,Nail Polish,50,100,50,1,00331,India
496825,2023-09-04,1006,Blush,150,300,150,1,00331,India
496825,2023-09-04,1009,Moisturizer,250,500,250,1,00331,India
496825,2023-09-04,1008,Makeup Remover,80,160,80,1,00331,India
926972,2023-09-04,1012,Body Lotion,200,400,200,1,00053,India
926972,2023-09-04,1004,Eyeliner,100,200,100,1,00053,India
926972,2023-09-04,1006,Blush,150,300,150,1,00053,India
246111,2023-09-04,1007,Eyeshadow,200,400,200,1,00177,India
246111,2023-09-04,1006,Blush,150,300,150,1,00177,India
246111,2023-09-04,1001,Lipstick,150,300,150,1,00177,India
246111,2023-09-04,1012,Body Lotion,200,400,200,1,00177,India
345735,2023-09-04,1007,Eyeshadow,200,400,200,1,00326,India
345735,2023-09-04,1004,Eyeliner,100,200,100,1,00326,India
345735,2023-09-04,1009,Moisturizer,250,500,250,1,00326,India
345735,2023-09-04,1008,Makeup Remover,80,160,80,1,00326,India
233095,2023-09-04,1009,Moisturizer,250,500,250,1,00455,India
233095,2023-09-04,1004,Eyeliner,100,200,100,1,00455,India
766233,2023-09-04,1009,Moisturizer,250,500,250,1,00270,India
847664,2023-09-04,1008,Makeup Remover,80,160,80,1,00290,India
847664,2023-09-04,1006,Blush,150,300,150,1,00290,India
847664,2023-09-04,1002,Mascara,200,400,200,1,00290,India
847664,2023-09-04,1005,Nail Polish,50,100,50,1,00290,India
511683,2023-09-04,1012,Body Lotion,200,400,200,1,00006,India
453274,2023-09-04,1009,Moisturizer,250,500,250,1,00184,India
800501,2023-09-04,1003,Foundation,300,600,300,1,00027,India
800501,2023-09-04,1006,Blush,150,300,150,1,00027,India
483827,2023-09-04,1002,Mascara,200,400,200,1,00067,India
161793,2023-09-04,1002,Mascara,200,400,200,1,00093,India
832217,2023-09-04,1006,Blush,150,300,150,1,00201,India
832217,2023-09-04,1009,Moisturizer,250,500,250,1,00201,India
832217,2023-09-04,1007,Eyeshadow,200,400,200,1,00201,India
832217,2023-09-04,1005,Nail Polish,50,100,50,1,00201,India
767708,2023-09-04,1007,Eyeshadow,200,400,200,1,00071,India
767708,2023-09-04,1008,Makeup Remover,80,160,80,1,00071,India
964122,2023-09-04,1008,Makeup Remover,80,160,80,1,00196,India
500510,2023-09-04,1004,Eyeliner,100,200,100,1,00386,India
500510,2023-09-04,1007,Eyeshadow,200,400,200,1,00386,India
682370,2023-09-04,1002,Mascara,200,400,200,1,00344,India
682370,2023-09-04,1008,Makeup Remover,80,160,80,1,00344,India
682370,2023-09-04,1009,Moisturizer,250,500,250,1,00344,India
682370,2023-09-04,1005,Nail Polish,50,100,50,1,00344,India
682370,2023-09-04,1004,Eyeliner,100,200,100,1,00344,India
156155,2023-09-04,1012,Body Lotion,200,400,200,1,00106,India
156155,2023-09-04,1002,Mascara,200,400,200,1,00106,India
156155,2023-09-04,1008,Makeup Remover,80,160,80,1,00106,India
894466,2023-09-04,1007,Eyeshadow,200,400,200,1,00399,India
894466,2023-09-04,1012,Body Lotion,200,400,200,1,00399,India
894466,2023-09-04,1005,Nail Polish,50,100,50,1,00399,India
894466,2023-09-04,1002,Mascara,200,400,200,1,00399,India
653250,2023-09-04,1003,Foundation,300,600,300,1,00074,India
221556,2023-09-04,1003,Foundation,300,600,300,1,00406,India
221556,2023-09-04,1001,Lipstick,150,300,150,1,00406,India
221556,2023-09-04,1012,Body Lotion,200,400,200,1,00406,India
573630,2023-09-04,1006,Blush,150,300,150,1,00182,India
573630,2023-09-04,1009,Moisturizer,250,500,250,1,00182,India
992743,2023-09-04,1012,Body Lotion,200,400,200,1,00182,India
293587,2023-09-04,1012,Body Lotion,200,400,200,1,00428,India
293587,2023-09-04,1002,Mascara,200,400,200,1,00428,India
293587,2023-09-04,1007,Eyeshadow,200,400,200,1,00428,India
917442,2023-09-04,1004,Eyeliner,100,200,100,1,00066,India
917442,2023-09-04,1007,Eyeshadow,200,400,200,1,00066,India
917442,2023-09-04,1001,Lipstick,150,300,150,1,00066,India
722006,2023-09-04,1007,Eyeshadow,200,400,200,1,00185,India
364187,2023-09-04,1005,Nail Polish,50,100,50,1,00361,India
782102,2023-09-04,1003,Foundation,300,600,300,1,00441,India
557315,2023-09-04,1003,Foundation,300,600,300,1,00119,India
283863,2023-09-04,1004,Eyeliner,100,200,100,1,00346,India
283863,2023-09-04,1006,Blush,150,300,150,1,00346,India
283863,2023-09-04,1007,Eyeshadow,200,400,200,1,00346,India
494554,2023-09-04,1004,Eyeliner,100,200,100,1,00465,India
494554,2023-09-04,1003,Foundation,300,600,300,1,00465,India
400424,2023-09-04,1008,Makeup Remover,80,160,80,1,00141,India
400424,2023-09-04,1003,Foundation,300,600,300,1,00141,India
400424,2023-09-04,1007,Eyeshadow,200,400,200,1,00141,India
400424,2023-09-04,1005,Nail Polish,50,100,50,1,00141,India
400424,2023-09-04,1012,Body Lotion,200,400,200,1,00141,India
276713,2023-09-04,1002,Mascara,200,400,200,1,00480,India
276713,2023-09-04,1009,Moisturizer,250,500,250,1,00480,India
276713,2023-09-04,1001,Lipstick,150,300,150,1,00480,India
866651,2023-09-04,1003,Foundation,300,600,300,1,00275,India
668645,2023-09-04,1002,Mascara,200,400,200,1,00316,India
668645,2023-09-04,1008,Makeup Remover,80,160,80,1,00316,India
668645,2023-09-04,1003,Foundation,300,600,300,1,00316,India
711639,2023-09-04,1008,Makeup Remover,80,160,80,1,00044,India
711639,2023-09-04,1004,Eyeliner,100,200,100,1,00044,India
923926,2023-09-05,1008,Makeup Remover,80,160,80,1,00397,India
923926,2023-09-05,1006,Blush,150,300,150,1,00397,India
923926,2023-09-05,1003,Foundation,300,600,300,1,00397,India
923926,2023-09-05,1012,Body Lotion,200,400,200,1,00397,India
827794,2023-09-05,1007,Eyeshadow,200,400,200,1,00258,India
840815,2023-09-05,1003,Foundation,300,600,300,1,00089,India
840815,2023-09-05,1001,Lipstick,150,300,150,1,00089,India
840815,2023-09-05,1004,Eyeliner,100,200,100,1,00089,India
495530,2023-09-05,1003,Foundation,300,600,300,1,00159,India
572337,2023-09-05,1006,Blush,150,300,150,1,00482,India
572337,2023-09-05,1005,Nail Polish,50,100,50,1,00482,India
725362,2023-09-05,1002,Mascara,200,400,200,1,00033,India
725362,2023-09-05,1004,Eyeliner,100,200,100,1,00033,India
222668,2023-09-05,1009,Moisturizer,250,500,250,1,00268,India
222668,2023-09-05,1004,Eyeliner,100,200,100,1,00268,India
222668,2023-09-05,1003,Foundation,300,600,300,1,00268,India
222668,2023-09-05,1001,Lipstick,150,300,150,1,00268,India
106481,2023-09-05,1004,Eyeliner,100,200,100,1,00249,India
106481,2023-09-05,1008,Makeup Remover,80,160,80,1,00249,India
355150,2023-09-05,1001,Lipstick,150,300,150,1,00275,India
355150,2023-09-05,1005,Nail Polish,50,100,50,1,00275,India
355150,2023-09-05,1007,Eyeshadow,200,400,200,1,00275,India
940434,2023-09-05,1002,Mascara,200,400,200,1,00009,India
609431,2023-09-05,1003,Foundation,300,600,300,1,00350,India
833933,2023-09-05,1012,Body Lotion,200,400,200,1,00040,India
833933,2023-09-05,1002,Mascara,200,400,200,1,00040,India
469542,2023-09-05,1003,Foundation,300,600,300,1,00496,India
802107,2023-09-05,1009,Moisturizer,250,500,250,1,00055,India
802107,2023-09-05,1005,Nail Polish,50,100,50,1,00055,India
802107,2023-09-05,1008,Makeup Remover,80,160,80,1,00055,India
218318,2023-09-05,1002,Mascara,200,400,200,1,00056,India
155527,2023-09-05,1002,Mascara,200,400,200,1,00117,India
155527,2023-09-05,1012,Body Lotion,200,400,200,1,00117,India
870864,2023-09-05,1008,Makeup Remover,80,160,80,1,00446,India
870864,2023-09-05,1001,Lipstick,150,300,150,1,00446,India
870864,2023-09-05,1007,Eyeshadow,200,400,200,1,00446,India
203514,2023-09-05,1001,Lipstick,150,300,150,1,00089,India
203514,2023-09-05,1008,Makeup Remover,80,160,80,1,00089,India
203514,2023-09-05,1012,Body Lotion,200,400,200,1,00089,India
875451,2023-09-05,1001,Lipstick,150,300,150,1,00412,India
875451,2023-09-05,1004,Eyeliner,100,200,100,1,00412,India
875451,2023-09-05,1005,Nail Polish,50,100,50,1,00412,India
630876,2023-09-05,1009,Moisturizer,250,500,250,1,00040,India
160617,2023-09-05,1012,Body Lotion,200,400,200,1,00123,India
160617,2023-09-05,1006,Blush,150,300,150,1,00123,India
160617,2023-09-05,1002,Mascara,200,400,200,1,00123,India
160617,2023-09-05,1004,Eyeliner,100,200,100,1,00123,India
933167,2023-09-05,1002,Mascara,200,400,200,1,00073,India
933167,2023-09-05,1007,Eyeshadow,200,400,200,1,00073,India
281327,2023-09-05,1002,Mascara,200,400,200,1,00006,India
315935,2023-09-05,1005,Nail Polish,50,100,50,1,00067,India
777390,2023-09-05,1001,Lipstick,150,300,150,1,00035,India
777390,2023-09-05,1009,Moisturizer,250,500,250,1,00035,India
777390,2023-09-05,1004,Eyeliner,100,200,100,1,00035,India
338986,2023-09-05,1007,Eyeshadow,200,400,200,1,00397,India
338986,2023-09-05,1003,Foundation,300,600,300,1,00397,India
431185,2023-09-05,1003,Foundation,300,600,300,1,00261,India
431185,2023-09-05,1005,Nail Polish,50,100,50,1,00261,India
431185,2023-09-05,1009,Moisturizer,250,500,250,1,00261,India
431185,2023-09-05,1008,Makeup Remover,80,160,80,1,00261,India
431185,2023-09-05,1012,Body Lotion,200,400,200,1,00261,India
973618,2023-09-05,1005,Nail Polish,50,100,50,1,00441,India
973618,2023-09-05,1004,Eyeliner,100,200,100,1,00441,India
973618,2023-09-05,1006,Blush,150,300,150,1,00441,India
973618,2023-09-05,1009,Moisturizer,250,500,250,1,00441,India
916519,2023-09-05,1002,Mascara,200,400,200,1,00028,India
916519,2023-09-05,1001,Lipstick,150,300,150,1,00028,India
916519,2023-09-05,1005,Nail Polish,50,100,50,1,00028,India
916519,2023-09-05,1008,Makeup Remover,80,160,80,1,00028,India
888154,2023-09-05,1009,Moisturizer,250,500,250,1,00281,India
888154,2023-09-05,1006,Blush,150,300,150,1,00281,India
888154,2023-09-05,1003,Foundation,300,600,300,1,00281,India
888154,2023-09-05,1007,Eyeshadow,200,400,200,1,00281,India
824556,2023-09-05,1003,Foundation,300,600,300,1,00200,India
476011,2023-09-05,1002,Mascara,200,400,200,1,00471,India
476011,2023-09-05,1006,Blush,150,300,150,1,00471,India
285853,2023-09-05,1005,Nail Polish,50,100,50,1,00127,India
285853,2023-09-05,1002,Mascara,200,400,200,1,00127,India
285853,2023-09-05,1007,Eyeshadow,200,400,200,1,00127,India
285853,2023-09-05,1006,Blush,150,300,150,1,00127,India
285853,2023-09-05,1003,Foundation,300,600,300,1,00127,India
551230,2023-09-05,1005,Nail Polish,50,100,50,1,00168,India
551230,2023-09-05,1001,Lipstick,150,300,150,1,00168,India
821800,2023-09-05,1004,Eyeliner,100,200,100,1,00334,India
821800,2023-09-05,1006,Blush,150,300,150,1,00334,India
821800,2023-09-05,1001,Lipstick,150,300,150,1,00334,India
496001,2023-09-05,1002,Mascara,200,400,200,1,00336,India
307387,2023-09-05,1005,Nail Polish,50,100,50,1,00078,India
367510,2023-09-05,1008,Makeup Remover,80,160,80,1,00374,India
694456,2023-09-05,1001,Lipstick,150,300,150,1,00492,India
811939,2023-09-05,1003,Foundation,300,600,300,1,00092,India
811939,2023-09-05,1006,Blush,150,300,150,1,00092,India
811939,2023-09-05,1004,Eyeliner,100,200,100,1,00092,India
811939,2023-09-05,1008,Makeup Remover,80,160,80,1,00092,India
521695,2023-09-05,1012,Body Lotion,200,400,200,1,00180,India
521695,2023-09-05,1009,Moisturizer,250,500,250,1,00180,India
521695,2023-09-05,1005,Nail Polish,50,100,50,1,00180,India
404443,2023-09-05,1005,Nail Polish,50,100,50,1,00111,India
404443,2023-09-05,1004,Eyeliner,100,200,100,1,00111,India
404443,2023-09-05,1009,Moisturizer,250,500,250,1,00111,India
404443,2023-09-05,1001,Lipstick,150,300,150,1,00111,India
404443,2023-09-05,1012,Body Lotion,200,400,200,1,00111,India
427533,2023-09-05,1004,Eyeliner,100,200,100,1,00291,India
449331,2023-09-05,1002,Mascara,200,400,200,1,00136,India
449331,2023-09-05,1001,Lipstick,150,300,150,1,00136,India
282765,2023-09-05,1005,Nail Polish,50,100,50,1,00230,India
282765,2023-09-05,1001,Lipstick,150,300,150,1,00230,India
282765,2023-09-05,1009,Moisturizer,250,500,250,1,00230,India
481212,2023-09-05,1002,Mascara,200,400,200,1,00394,India
481212,2023-09-05,1006,Blush,150,300,150,1,00394,India
481212,2023-09-05,1008,Makeup Remover,80,160,80,1,00394,India
481212,2023-09-05,1007,Eyeshadow,200,400,200,1,00394,India
499679,2023-09-05,1008,Makeup Remover,80,160,80,1,00419,India
129075,2023-09-06,1005,Nail Polish,50,100,50,1,00279,India
129075,2023-09-06,1008,Makeup Remover,80,160,80,1,00279,India
129075,2023-09-06,1002,Mascara,200,400,200,1,00279,India
519730,2023-09-06,1009,Moisturizer,250,500,250,1,00188,India
519730,2023-09-06,1003,Foundation,300,600,300,1,00188,India
755149,2023-09-06,1001,Lipstick,150,300,150,1,00251,India
755149,2023-09-06,1003,Foundation,300,600,300,1,00251,India
755149,2023-09-06,1005,Nail Polish,50,100,50,1,00251,India
755149,2023-09-06,1012,Body Lotion,200,400,200,1,00251,India
650498,2023-09-06,1008,Makeup Remover,80,160,80,1,00209,India
688525,2023-09-06,1009,Moisturizer,250,500,250,1,00041,India
688525,2023-09-06,1003,Foundation,300,600,300,1,00041,India
688525,2023-09-06,1008,Makeup Remover,80,160,80,1,00041,India
589799,2023-09-06,1012,Body Lotion,200,400,200,1,00042,India
589799,2023-09-06,1005,Nail Polish,50,100,50,1,00042,India
589799,2023-09-06,1003,Foundation,300,600,300,1,00042,India
589799,2023-09-06,1007,Eyeshadow,200,400,200,1,00042,India
772755,2023-09-06,1012,Body Lotion,200,400,200,1,00493,India
121311,2023-09-06,1007,Eyeshadow,200,400,200,1,00443,India
634718,2023-09-06,1002,Mascara,200,400,200,1,00450,India
597001,2023-09-06,1012,Body Lotion,200,400,200,1,00048,India
597001,2023-09-06,1002,Mascara,200,400,200,1,00048,India
707999,2023-09-06,1002,Mascara,200,400,200,1,00393,India
510831,2023-09-06,1008,Makeup Remover,80,160,80,1,00144,India
510831,2023-09-06,1004,Eyeliner,100,200,100,1,00144,India
817787,2023-09-06,1008,Makeup Remover,80,160,80,1,00413,India
577011,2023-09-06,1004,Eyeliner,100,200,100,1,00163,India
136790,2023-09-06,1008,Makeup Remover,80,160,80,1,00084,India
136790,2023-09-06,1007,Eyeshadow,200,400,200,1,00084,India
136790,2023-09-06,1002,Mascara,200,400,200,1,00084,India
733066,2023-09-06,1001,Lipstick,150,300,150,1,00273,India
733066,2023-09-06,1008,Makeup Remover,80,160,80,1,00273,India
833704,2023-09-06,1012,Body Lotion,200,400,200,1,00323,India
833704,2023-09-06,1007,Eyeshadow,200,400,200,1,00323,India
160882,2023-09-06,1012,Body Lotion,200,400,200,1,00270,India
160882,2023-09-06,1009,Moisturizer,250,500,250,1,00270,India
160882,2023-09-06,1001,Lipstick,150,300,150,1,00270,India
796632,2023-09-06,1004,Eyeliner,100,200,100,1,00018,India
143883,2023-09-06,1005,Nail Polish,50,100,50,1,00279,India
143883,2023-09-06,1003,Foundation,300,600,300,1,00279,India
339114,2023-09-06,1003,Foundation,300,600,300,1,00195,India
339114,2023-09-06,1006,Blush,150,300,150,1,00195,India
909352,2023-09-06,1001,Lipstick,150,300,150,1,00033,India
909352,2023-09-06,1003,Foundation,300,600,300,1,00033,India
909352,2023-09-06,1009,Moisturizer,250,500,250,1,00033,India
589275,2023-09-06,1008,Makeup Remover,80,160,80,1,00196,India
589275,2023-09-06,1012,Body Lotion,200,400,200,1,00196,India
567564,2023-09-06,1005,Nail Polish,50,100,50,1,00484,India
567564,2023-09-06,1002,Mascara,200,400,200,1,00484,India
808617,2023-09-06,1008,Makeup Remover,80,160,80,1,00206,India
845780,2023-09-06,1012,Body Lotion,200,400,200,1,00283,India
845780,2023-09-06,1006,Blush,150,300,150,1,00283,India
655584,2023-09-06,1007,Eyeshadow,200,400,200,1,00222,India
655584,2023-09-06,1002,Mascara,200,400,200,1,00222,India
655584,2023-09-06,1001,Lipstick,150,300,150,1,00222,India
566162,2023-09-06,1006,Blush,150,300,150,1,00108,India
566162,2023-09-06,1005,Nail Polish,50,100,50,1,00108,India
566162,2023-09-06,1008,Makeup Remover,80,160,80,1,00108,India
789850,2023-09-06,1012,Body Lotion,200,400,200,1,00127,India
789850,2023-09-06,1003,Foundation,300,600,300,1,00127,India
425214,2023-09-06,1004,Eyeliner,100,200,100,1,00035,India
425214,2023-09-06,1012,Body Lotion,200,400,200,1,00035,India
458722,2023-09-06,1006,Blush,150,300,150,1,00367,India
506395,2023-09-06,1004,Eyeliner,100,200,100,1,00388,India
337388,2023-09-06,1001,Lipstick,150,300,150,1,00384,India
337388,2023-09-06,1012,Body Lotion,200,400,200,1,00384,India
763359,2023-09-06,1009,Moisturizer,250,500,250,1,00468,India
763359,2023-09-06,1012,Body Lotion,200,400,200,1,00468,India
763359,2023-09-06,1003,Foundation,300,600,300,1,00468,India
879911,2023-09-06,1012,Body Lotion,200,400,200,1,00381,India
879911,2023-09-06,1008,Makeup Remover,80,160,80,1,00381,India
650048,2023-09-06,1006,Blush,150,300,150,1,00243,India
457067,2023-09-07,1002,Mascara,200,400,200,1,00100,India
457067,2023-09-07,1001,Lipstick,150,300,150,1,00100,India
457067,2023-09-07,1006,Blush,150,300,150,1,00100,India
854258,2023-09-07,1003,Foundation,300,600,300,1,00290,India
398202,2023-09-07,1001,Lipstick,150,300,150,1,00191,India
398202,2023-09-07,1002,Mascara,200,400,200,1,00191,India
398202,2023-09-07,1004,Eyeliner,100,200,100,1,00191,India
398202,2023-09-07,1012,Body Lotion,200,400,200,1,00191,India
572076,2023-09-07,1012,Body Lotion,200,400,200,1,00215,India
572076,2023-09-07,1008,Makeup Remover,80,160,80,1,00215,India
572076,2023-09-07,1001,Lipstick,150,300,150,1,00215,India
572076,2023-09-07,1009,Moisturizer,250,500,250,1,00215,India
307303,2023-09-07,1002,Mascara,200,400,200,1,00494,India
307303,2023-09-07,1006,Blush,150,300,150,1,00494,India
307303,2023-09-07,1008,Makeup Remover,80,160,80,1,00494,India
561805,2023-09-07,1001,Lipstick,150,300,150,1,00258,India
561805,2023-09-07,1012,Body Lotion,200,400,200,1,00258,India
574632,2023-09-07,1003,Foundation,300,600,300,1,00090,India
574632,2023-09-07,1007,Eyeshadow,200,400,200,1,00090,India
724838,2023-09-07,1006,Blush,150,300,150,1,00243,India
724838,2023-09-07,1001,Lipstick,150,300,150,1,00243,India
616543,2023-09-07,1005,Nail Polish,50,100,50,1,00053,India
183154,2023-09-07,1006,Blush,150,300,150,1,00483,India
183154,2023-09-07,1009,Moisturizer,250,500,250,1,00483,India
183154,2023-09-07,1002,Mascara,200,400,200,1,00483,India
183154,2023-09-07,1003,Foundation,300,600,300,1,00483,India
877000,2023-09-07,1008,Makeup Remover,80,160,80,1,00282,India
877000,2023-09-07,1005,Nail Polish,50,100,50,1,00282,India
877000,2023-09-07,1006,Blush,150,300,150,1,00282,India
877000,2023-09-07,1004,Eyeliner,100,200,100,1,00282,India
427057,2023-09-07,1007,Eyeshadow,200,400,200,1,00409,India
427057,2023-09-07,1008,Makeup Remover,80,160,80,1,00409,India
427057,2023-09-07,1002,Mascara,200,400,200,1,00409,India
253251,2023-09-07,1008,Makeup Remover,80,160,80,1,00111,India
842963,2023-09-07,1007,Eyeshadow,200,400,200,1,00405,India
149990,2023-09-07,1001,Lipstick,150,300,150,1,00210,India
149990,2023-09-07,1005,Nail Polish,50,100,50,1,00210,India
149990,2023-09-07,1006,Blush,150,300,150,1,00210,India
793535,2023-09-07,1001,Lipstick,150,300,150,1,00045,India
793535,2023-09-07,1002,Mascara,200,400,200,1,00045,India
800397,2023-09-07,1003,Foundation,300,600,300,1,00020,India
800397,2023-09-07,1001,Lipstick,150,300,150,1,00020,India
440769,2023-09-07,1001,Lipstick,150,300,150,1,00453,India
440769,2023-09-07,1009,Moisturizer,250,500,250,1,00453,India
999579,2023-09-07,1005,Nail Polish,50,100,50,1,00235,India
298990,2023-09-07,1005,Nail Polish,50,100,50,1,00166,India
298990,2023-09-07,1008,Makeup Remover,80,160,80,1,00166,India
489063,2023-09-07,1007,Eyeshadow,200,400,200,1,00049,India
683193,2023-09-07,1004,Eyeliner,100,200,100,1,00369,India
683193,2023-09-07,1002,Mascara,200,400,200,1,00369,India
683193,2023-09-07,1012,Body Lotion,200,400,200,1,00369,India
365166,2023-09-07,1009,Moisturizer,250,500,250,1,00403,India
365166,2023-09-07,1012,Body Lotion,200,400,200,1,00403,India
710078,2023-09-07,1012,Body Lotion,200,400,200,1,00254,India
762098,2023-09-07,1004,Eyeliner,100,200,100,1,00429,India
708365,2023-09-07,1003,Foundation,300,600,300,1,00086,India
708365,2023-09-07,1005,Nail Polish,50,100,50,1,00086,India
708365,2023-09-07,1009,Moisturizer,250,500,250,1,00086,India
708365,2023-09-07,1012,Body Lotion,200,400,200,1,00086,India
837380,2023-09-07,1006,Blush,150,300,150,1,00217,India
837380,2023-09-07,1008,Makeup Remover,80,160,80,1,00217,India
837380,2023-09-07,1003,Foundation,300,600,300,1,00217,India
837380,2023-09-07,1012,Body Lotion,200,400,200,1,00217,India
177324,2023-09-07,1004,Eyeliner,100,200,100,1,00042,India
177324,2023-09-07,1007,Eyeshadow,200,400,200,1,00042,India
177324,2023-09-07,1008,Makeup Remover,80,160,80,1,00042,India
426324,2023-09-07,1004,Eyeliner,100,200,100,1,00489,India
701259,2023-09-07,1003,Foundation,300,600,300,1,00452,India
701259,2023-09-07,1006,Blush,150,300,150,1,00452,India
236560,2023-09-07,1002,Mascara,200,400,200,1,00290,India
236560,2023-09-07,1012,Body Lotion,200,400,200,1,00290,India
236560,2023-09-07,1003,Foundation,300,600,300,1,00290,India
524863,2023-09-07,1009,Moisturizer,250,500,250,1,00498,India
524863,2023-09-07,1007,Eyeshadow,200,400,200,1,00498,India
397292,2023-09-07,1006,Blush,150,300,150,1,00001,India
397292,2023-09-07,1008,Makeup Remover,80,160,80,1,00001,India
397292,2023-09-07,1009,Moisturizer,250,500,250,1,00001,India
397292,2023-09-07,1002,Mascara,200,400,200,1,00001,India
331104,2023-09-07,1005,Nail Polish,50,100,50,1,00377,India
331104,2023-09-07,1002,Mascara,200,400,200,1,00377,India
331104,2023-09-07,1003,Foundation,300,600,300,1,00377,India
331104,2023-09-07,1004,Eyeliner,100,200,100,1,00377,India
331104,2023-09-07,1012,Body Lotion,200,400,200,1,00377,India
394322,2023-09-07,1003,Foundation,300,600,300,1,00385,India
394322,2023-09-07,1008,Makeup Remover,80,160,80,1,00385,India
851493,2023-09-07,1007,Eyeshadow,200,400,200,1,00378,India
851493,2023-09-07,1003,Foundation,300,600,300,1,00378,India
851493,2023-09-07,1005,Nail Polish,50,100,50,1,00378,India
949044,2023-09-07,1007,Eyeshadow,200,400,200,1,00016,India
949044,2023-09-07,1012,Body Lotion,200,400,200,1,00016,India
949044,2023-09-07,1006,Blush,150,300,150,1,00016,India
949044,2023-09-07,1004,Eyeliner,100,200,100,1,00016,India
917516,2023-09-07,1005,Nail Polish,50,100,50,1,00323,India
169045,2023-09-07,1007,Eyeshadow,200,400,200,1,00425,India
169045,2023-09-07,1012,Body Lotion,200,400,200,1,00425,India
394740,2023-09-07,1006,Blush,150,300,150,1,00390,India
394740,2023-09-07,1001,Lipstick,150,300,150,1,00390,India
394740,2023-09-07,1003,Foundation,300,600,300,1,00390,India
394740,2023-09-07,1008,Makeup Remover,80,160,80,1,00390,India
186041,2023-09-07,1007,Eyeshadow,200,400,200,1,00318,India
186041,2023-09-07,1002,Mascara,200,400,200,1,00318,India
899662,2023-09-07,1006,Blush,150,300,150,1,00412,India
899662,2023-09-07,1002,Mascara,200,400,200,1,00412,India
899662,2023-09-07,1008,Makeup Remover,80,160,80,1,00412,India
809970,2023-09-07,1001,Lipstick,150,300,150,1,00208,India
809970,2023-09-07,1008,Makeup Remover,80,160,80,1,00208,India
809970,2023-09-07,1002,Mascara,200,400,200,1,00208,India
275379,2023-09-07,1012,Body Lotion,200,400,200,1,00214,India
275379,2023-09-07,1004,Eyeliner,100,200,100,1,00214,India
351066,2023-09-07,1005,Nail Polish,50,100,50,1,00208,India
351066,2023-09-07,1002,Mascara,200,400,200,1,00208,India
351066,2023-09-07,1006,Blush,150,300,150,1,00208,India
420092,2023-09-07,1012,Body Lotion,200,400,200,1,00062,India
279974,2023-09-07,1006,Blush,150,300,150,1,00161,India
279974,2023-09-07,1007,Eyeshadow,200,400,200,1,00161,India
279974,2023-09-07,1003,Foundation,300,600,300,1,00161,India
279974,2023-09-07,1012,Body Lotion,200,400,200,1,00161,India
194678,2023-09-08,1012,Body Lotion,200,400,200,1,00468,India
194678,2023-09-08,1007,Eyeshadow,200,400,200,1,00468,India
194678,2023-09-08,1002,Mascara,200,400,200,1,00468,India
987211,2023-09-08,1005,Nail Polish,50,100,50,1,00332,India
987211,2023-09-08,1003,Foundation,300,600,300,1,00332,India
987211,2023-09-08,1001,Lipstick,150,300,150,1,00332,India
867257,2023-09-08,1004,Eyeliner,100,200,100,1,00320,India
867257,2023-09-08,1002,Mascara,200,400,200,1,00320,India
971989,2023-09-08,1008,Makeup Remover,80,160,80,1,00400,India
971989,2023-09-08,1004,Eyeliner,100,200,100,1,00400,India
672930,2023-09-08,1004,Eyeliner,100,200,100,1,00186,India
672930,2023-09-08,1006,Blush,150,300,150,1,00186,India
472136,2023-09-08,1003,Foundation,300,600,300,1,00401,India
472136,2023-09-08,1008,Makeup Remover,80,160,80,1,00401,India
472136,2023-09-08,1002,Mascara,200,400,200,1,00401,India
472136,2023-09-08,1005,Nail Polish,50,100,50,1,00401,India
810579,2023-09-08,1005,Nail Polish,50,100,50,1,00061,India
810579,2023-09-08,1001,Lipstick,150,300,150,1,00061,India
194293,2023-09-08,1004,Eyeliner,100,200,100,1,00367,India
846572,2023-09-08,1001,Lipstick,150,300,150,1,00440,India
341915,2023-09-08,1004,Eyeliner,100,200,100,1,00368,India
341915,2023-09-08,1009,Moisturizer,250,500,250,1,00368,India
341915,2023-09-08,1001,Lipstick,150,300,150,1,00368,India
559130,2023-09-08,1004,Eyeliner,100,200,100,1,00259,India
559130,2023-09-08,1001,Lipstick,150,300,150,1,00259,India
559130,2023-09-08,1008,Makeup Remover,80,160,80,1,00259,India
559130,2023-09-08,1007,Eyeshadow,200,400,200,1,00259,India
595927,2023-09-08,1006,Blush,150,300,150,1,00367,India
595927,2023-09-08,1009,Moisturizer,250,500,250,1,00367,India
127650,2023-09-08,1007,Eyeshadow,200,400,200,1,00018,India
127650,2023-09-08,1012,Body Lotion,200,400,200,1,00018,India
261188,2023-09-08,1007,Eyeshadow,200,400,200,1,00265,India
261188,2023-09-08,1002,Mascara,200,400,200,1,00265,India
261188,2023-09-08,1009,Moisturizer,250,500,250,1,00265,India
494417,2023-09-08,1007,Eyeshadow,200,400,200,1,00264,India
494417,2023-09-08,1006,Blush,150,300,150,1,00264,India
494417,2023-09-08,1003,Foundation,300,600,300,1,00264,India
996357,2023-09-08,1001,Lipstick,150,300,150,1,00427,India
996357,2023-09-08,1008,Makeup Remover,80,160,80,1,00427,India
996357,2023-09-08,1012,Body Lotion,200,400,200,1,00427,India
996357,2023-09-08,1005,Nail Polish,50,100,50,1,00427,India
690899,2023-09-08,1006,Blush,150,300,150,1,00009,India
519128,2023-09-08,1002,Mascara,200,400,200,1,00231,India
128026,2023-09-08,1004,Eyeliner,100,200,100,1,00390,India
280931,2023-09-08,1002,Mascara,200,400,200,1,00235,India
280931,2023-09-08,1006,Blush,150,300,150,1,00235,India
280931,2023-09-08,1012,Body Lotion,200,400,200,1,00235,India
280931,2023-09-08,1009,Moisturizer,250,500,250,1,00235,India
505484,2023-09-08,1006,Blush,150,300,150,1,00014,India
221380,2023-09-08,1008,Makeup Remover,80,160,80,1,00420,India
221380,2023-09-08,1006,Blush,150,300,150,1,00420,India
506245,2023-09-08,1005,Nail Polish,50,100,50,1,00463,India
336546,2023-09-08,1003,Foundation,300,600,300,1,00211,India
336546,2023-09-08,1004,Eyeliner,100,200,100,1,00211,India
336546,2023-09-08,1008,Makeup Remover,80,160,80,1,00211,India
336546,2023-09-08,1012,Body Lotion,200,400,200,1,00211,India
234708,2023-09-08,1002,Mascara,200,400,200,1,00086,India
234708,2023-09-08,1006,Blush,150,300,150,1,00086,India
853374,2023-09-08,1012,Body Lotion,200,400,200,1,00433,India
370501,2023-09-08,1012,Body Lotion,200,400,200,1,00215,India
370501,2023-09-08,1003,Foundation,300,600,300,1,00215,India
131718,2023-09-08,1008,Makeup Remover,80,160,80,1,00204,India
804300,2023-09-08,1004,Eyeliner,100,200,100,1,00494,India
804300,2023-09-08,1012,Body Lotion,200,400,200,1,00494,India
804300,2023-09-08,1003,Foundation,300,600,300,1,00494,India
478977,2023-09-08,1008,Makeup Remover,80,160,80,1,00145,India
478977,2023-09-08,1005,Nail Polish,50,100,50,1,00145,India
157307,2023-09-08,1009,Moisturizer,250,500,250,1,00092,India
157307,2023-09-08,1001,Lipstick,150,300,150,1,00092,India
157307,2023-09-08,1012,Body Lotion,200,400,200,1,00092,India
157307,2023-09-08,1006,Blush,150,300,150,1,00092,India
157307,2023-09-08,1005,Nail Polish,50,100,50,1,00092,India
852893,2023-09-08,1003,Foundation,300,600,300,1,00210,India
852893,2023-09-08,1008,Makeup Remover,80,160,80,1,00210,India
852893,2023-09-08,1002,Mascara,200,400,200,1,00210,India
223498,2023-09-08,1004,Eyeliner,100,200,100,1,00216,India
223498,2023-09-08,1007,Eyeshadow,200,400,200,1,00216,India
223498,2023-09-08,1006,Blush,150,300,150,1,00216,India
208817,2023-09-09,1008,Makeup Remover,80,160,80,1,00357,India
208817,2023-09-09,1006,Blush,150,300,150,1,00357,India
604410,2023-09-09,1003,Foundation,300,600,300,1,00315,India
604410,2023-09-09,1009,Moisturizer,250,500,250,1,00315,India
604410,2023-09-09,1004,Eyeliner,100,200,100,1,00315,India
658007,2023-09-09,1001,Lipstick,150,300,150,1,00234,India
658007,2023-09-09,1002,Mascara,200,400,200,1,00234,India
658007,2023-09-09,1007,Eyeshadow,200,400,200,1,00234,India
165444,2023-09-09,1007,Eyeshadow,200,400,200,1,00142,India
165444,2023-09-09,1002,Mascara,200,400,200,1,00142,India
465115,2023-09-09,1008,Makeup Remover,80,160,80,1,00253,India
465115,2023-09-09,1004,Eyeliner,100,200,100,1,00253,India
465115,2023-09-09,1012,Body Lotion,200,400,200,1,00253,India
542518,2023-09-09,1008,Makeup Remover,80,160,80,1,00282,India
542518,2023-09-09,1003,Foundation,300,600,300,1,00282,India
542518,2023-09-09,1005,Nail Polish,50,100,50,1,00282,India
937217,2023-09-09,1008,Makeup Remover,80,160,80,1,00118,India
985298,2023-09-09,1004,Eyeliner,100,200,100,1,00040,India
581493,2023-09-09,1005,Nail Polish,50,100,50,1,00177,India
581493,2023-09-09,1007,Eyeshadow,200,400,200,1,00177,India
581493,2023-09-09,1004,Eyeliner,100,200,100,1,00177,India
581493,2023-09-09,1003,Foundation,300,600,300,1,00177,India
764012,2023-09-09,1007,Eyeshadow,200,400,200,1,00303,India
764012,2023-09-09,1008,Makeup Remover,80,160,80,1,00303,India
764012,2023-09-09,1003,Foundation,300,600,300,1,00303,India
764012,2023-09-09,1001,Lipstick,150,300,150,1,00303,India
838204,2023-09-09,1004,Eyeliner,100,200,100,1,00244,India
838204,2023-09-09,1009,Moisturizer,250,500,250,1,00244,India
838204,2023-09-09,1008,Makeup Remover,80,160,80,1,00244,India
838204,2023-09-09,1012,Body Lotion,200,400,200,1,00244,India
283330,2023-09-09,1007,Eyeshadow,200,400,200,1,00488,India
283330,2023-09-09,1005,Nail Polish,50,100,50,1,00488,India
283330,2023-09-09,1001,Lipstick,150,300,150,1,00488,India
443873,2023-09-09,1001,Lipstick,150,300,150,1,00082,India
443873,2023-09-09,1012,Body Lotion,200,400,200,1,00082,India
443873,2023-09-09,1007,Eyeshadow,200,400,200,1,00082,India
722289,2023-09-09,1012,Body Lotion,200,400,200,1,00409,India
722289,2023-09-09,1001,Lipstick,150,300,150,1,00409,India
722289,2023-09-09,1007,Eyeshadow,200,400,200,1,00409,India
722289,2023-09-09,1002,Mascara,200,400,200,1,00409,India
418071,2023-09-09,1009,Moisturizer,250,500,250,1,00440,India
418071,2023-09-09,1004,Eyeliner,100,200,100,1,00440,India
418071,2023-09-09,1003,Foundation,300,600,300,1,00440,India
418071,2023-09-09,1008,Makeup Remover,80,160,80,1,00440,India
700145,2023-09-09,1007,Eyeshadow,200,400,200,1,00337,India
700145,2023-09-09,1005,Nail Polish,50,100,50,1,00337,India
700145,2023-09-09,1008,Makeup Remover,80,160,80,1,00337,India
370293,2023-09-09,1012,Body Lotion,200,400,200,1,00144,India
370293,2023-09-09,1008,Makeup Remover,80,160,80,1,00144,India
370293,2023-09-09,1007,Eyeshadow,200,400,200,1,00144,India
252252,2023-09-09,1008,Makeup Remover,80,160,80,1,00416,India
252252,2023-09-09,1006,Blush,150,300,150,1,00416,India
252252,2023-09-09,1003,Foundation,300,600,300,1,00416,India
787918,2023-09-09,1005,Nail Polish,50,100,50,1,00014,India
787918,2023-09-09,1012,Body Lotion,200,400,200,1,00014,India
349168,2023-09-09,1003,Foundation,300,600,300,1,00107,India
349168,2023-09-09,1009,Moisturizer,250,500,250,1,00107,India
541614,2023-09-09,1004,Eyeliner,100,200,100,1,00132,India
541614,2023-09-09,1001,Lipstick,150,300,150,1,00132,India
541614,2023-09-09,1012,Body Lotion,200,400,200,1,00132,India
594116,2023-09-09,1003,Foundation,300,600,300,1,00015,India
594116,2023-09-09,1006,Blush,150,300,150,1,00015,India
594116,2023-09-09,1005,Nail Polish,50,100,50,1,00015,India
594116,2023-09-09,1002,Mascara,200,400,200,1,00015,India
136695,2023-09-09,1007,Eyeshadow,200,400,200,1,00069,India
136695,2023-09-09,1006,Blush,150,300,150,1,00069,India
136695,2023-09-09,1012,Body Lotion,200,400,200,1,00069,India
617919,2023-09-09,1012,Body Lotion,200,400,200,1,00490,India
656583,2023-09-09,1008,Makeup Remover,80,160,80,1,00415,India
656583,2023-09-09,1005,Nail Polish,50,100,50,1,00415,India
656583,2023-09-09,1001,Lipstick,150,300,150,1,00415,India
298152,2023-09-09,1001,Lipstick,150,300,150,1,00416,India
298152,2023-09-09,1008,Makeup Remover,80,160,80,1,00416,India
298152,2023-09-09,1007,Eyeshadow,200,400,200,1,00416,India
298152,2023-09-09,1003,Foundation,300,600,300,1,00416,India
273749,2023-09-09,1001,Lipstick,150,300,150,1,00140,India
273749,2023-09-09,1002,Mascara,200,400,200,1,00140,India
273749,2023-09-09,1007,Eyeshadow,200,400,200,1,00140,India
273749,2023-09-09,1009,Moisturizer,250,500,250,1,00140,India
273749,2023-09-09,1012,Body Lotion,200,400,200,1,00140,India
211613,2023-09-09,1004,Eyeliner,100,200,100,1,00318,India
211613,2023-09-09,1005,Nail Polish,50,100,50,1,00318,India
211613,2023-09-09,1006,Blush,150,300,150,1,00318,India
244217,2023-09-09,1001,Lipstick,150,300,150,1,00277,India
244217,2023-09-09,1003,Foundation,300,600,300,1,00277,India
370799,2023-09-09,1009,Moisturizer,250,500,250,1,00091,India
370799,2023-09-09,1006,Blush,150,300,150,1,00091,India
370799,2023-09-09,1008,Makeup Remover,80,160,80,1,00091,India
853022,2023-09-09,1009,Moisturizer,250,500,250,1,00052,India
853022,2023-09-09,1004,Eyeliner,100,200,100,1,00052,India
853022,2023-09-09,1012,Body Lotion,200,400,200,1,00052,India
665729,2023-09-09,1003,Foundation,300,600,300,1,00303,India
951389,2023-09-09,1003,Foundation,300,600,300,1,00332,India
951389,2023-09-09,1006,Blush,150,300,150,1,00332,India
951389,2023-09-09,1005,Nail Polish,50,100,50,1,00332,India
449047,2023-09-09,1002,Mascara,200,400,200,1,00393,India
449047,2023-09-09,1003,Foundation,300,600,300,1,00393,India
449047,2023-09-09,1012,Body Lotion,200,400,200,1,00393,India
449047,2023-09-09,1009,Moisturizer,250,500,250,1,00393,India
449047,2023-09-09,1008,Makeup Remover,80,160,80,1,00393,India
269842,2023-09-09,1004,Eyeliner,100,200,100,1,00453,India
269842,2023-09-09,1008,Makeup Remover,80,160,80,1,00453,India
269842,2023-09-09,1005,Nail Polish,50,100,50,1,00453,India
974497,2023-09-09,1006,Blush,150,300,150,1,00126,India
974497,2023-09-09,1001,Lipstick,150,300,150,1,00126,India
715629,2023-09-09,1003,Foundation,300,600,300,1,00093,India
715629,2023-09-09,1001,Lipstick,150,300,150,1,00093,India
933823,2023-09-09,1008,Makeup Remover,80,160,80,1,00083,India
933823,2023-09-09,1007,Eyeshadow,200,400,200,1,00083,India
889897,2023-09-09,1012,Body Lotion,200,400,200,1,00359,India
301590,2023-09-09,1005,Nail Polish,50,100,50,1,00418,India
215993,2023-09-09,1003,Foundation,300,600,300,1,00089,India
215993,2023-09-09,1004,Eyeliner,100,200,100,1,00089,India
215993,2023-09-09,1008,Makeup Remover,80,160,80,1,00089,India
215993,2023-09-09,1012,Body Lotion,200,400,200,1,00089,India
763022,2023-09-09,1006,Blush,150,300,150,1,00144,India
763022,2023-09-09,1005,Nail Polish,50,100,50,1,00144,India
763022,2023-09-09,1001,Lipstick,150,300,150,1,00144,India
875308,2023-09-09,1006,Blush,150,300,150,1,00060,India
875308,2023-09-09,1001,Lipstick,150,300,150,1,00060,India
909304,2023-09-09,1001,Lipstick,150,300,150,1,00441,India
909304,2023-09-09,1006,Blush,150,300,150,1,00441,India
476451,2023-09-09,1005,Nail Polish,50,100,50,1,00145,India
739285,2023-09-09,1008,Makeup Remover,80,160,80,1,00302,India
739285,2023-09-09,1012,Body Lotion,200,400,200,1,00302,India
739285,2023-09-09,1001,Lipstick,150,300,150,1,00302,India
739285,2023-09-09,1005,Nail Polish,50,100,50,1,00302,India
739285,2023-09-09,1002,Mascara,200,400,200,1,00302,India
917227,2023-09-09,1004,Eyeliner,100,200,100,1,00225,India
917227,2023-09-09,1006,Blush,150,300,150,1,00225,India
917227,2023-09-09,1003,Foundation,300,600,300,1,00225,India
595776,2023-09-09,1008,Makeup Remover,80,160,80,1,00036,India
595776,2023-09-09,1004,Eyeliner,100,200,100,1,00036,India
595776,2023-09-09,1009,Moisturizer,250,500,250,1,00036,India
203282,2023-09-10,1003,Foundation,300,600,300,1,00411,India
203282,2023-09-10,1012,Body Lotion,200,400,200,1,00411,India
194240,2023-09-10,1002,Mascara,200,400,200,1,00094,India
194240,2023-09-10,1004,Eyeliner,100,200,100,1,00094,India
696427,2023-09-10,1012,Body Lotion,200,400,200,1,00128,India
529714,2023-09-10,1002,Mascara,200,400,200,1,00292,India
919397,2023-09-10,1003,Foundation,300,600,300,1,00323,India
995059,2023-09-10,1004,Eyeliner,100,200,100,1,00116,India
995059,2023-09-10,1002,Mascara,200,400,200,1,00116,India
130989,2023-09-10,1008,Makeup Remover,80,160,80,1,00156,India
130989,2023-09-10,1009,Moisturizer,250,500,250,1,00156,India
130989,2023-09-10,1005,Nail Polish,50,100,50,1,00156,India
793363,2023-09-10,1006,Blush,150,300,150,1,00318,India
793363,2023-09-10,1001,Lipstick,150,300,150,1,00318,India
793363,2023-09-10,1012,Body Lotion,200,400,200,1,00318,India
422974,2023-09-10,1008,Makeup Remover,80,160,80,1,00385,India
940251,2023-09-10,1006,Blush,150,300,150,1,00169,India
940251,2023-09-10,1004,Eyeliner,100,200,100,1,00169,India
940251,2023-09-10,1003,Foundation,300,600,300,1,00169,India
940251,2023-09-10,1008,Makeup Remover,80,160,80,1,00169,India
269353,2023-09-10,1006,Blush,150,300,150,1,00030,India
269353,2023-09-10,1007,Eyeshadow,200,400,200,1,00030,India
918219,2023-09-10,1001,Lipstick,150,300,150,1,00377,India
349750,2023-09-10,1009,Moisturizer,250,500,250,1,00483,India
349750,2023-09-10,1002,Mascara,200,400,200,1,00483,India
349750,2023-09-10,1005,Nail Polish,50,100,50,1,00483,India
349750,2023-09-10,1012,Body Lotion,200,400,200,1,00483,India
114141,2023-09-10,1001,Lipstick,150,300,150,1,00349,India
390125,2023-09-10,1003,Foundation,300,600,300,1,00371,India
390125,2023-09-10,1004,Eyeliner,100,200,100,1,00371,India
390125,2023-09-10,1002,Mascara,200,400,200,1,00371,India
390125,2023-09-10,1006,Blush,150,300,150,1,00371,India
390125,2023-09-10,1009,Moisturizer,250,500,250,1,00371,India
948523,2023-09-10,1005,Nail Polish,50,100,50,1,00043,India
948523,2023-09-10,1004,Eyeliner,100,200,100,1,00043,India
948523,2023-09-10,1009,Moisturizer,250,500,250,1,00043,India
347353,2023-09-10,1001,Lipstick,150,300,150,1,00022,India
347353,2023-09-10,1012,Body Lotion,200,400,200,1,00022,India
347353,2023-09-10,1004,Eyeliner,100,200,100,1,00022,India
790093,2023-09-10,1008,Makeup Remover,80,160,80,1,00481,India
790093,2023-09-10,1002,Mascara,200,400,200,1,00481,India
790093,2023-09-10,1001,Lipstick,150,300,150,1,00481,India
790093,2023-09-10,1004,Eyeliner,100,200,100,1,00481,India
568866,2023-09-10,1012,Body Lotion,200,400,200,1,00475,India
568866,2023-09-10,1005,Nail Polish,50,100,50,1,00475,India
568866,2023-09-10,1006,Blush,150,300,150,1,00475,India
725885,2023-09-10,1004,Eyeliner,100,200,100,1,00060,India
725885,2023-09-10,1005,Nail Polish,50,100,50,1,00060,India
725885,2023-09-10,1006,Blush,150,300,150,1,00060,India
108629,2023-09-10,1003,Foundation,300,600,300,1,00329,India
108629,2023-09-10,1006,Blush,150,300,150,1,00329,India
108629,2023-09-10,1005,Nail Polish,50,100,50,1,00329,India
516782,2023-09-10,1005,Nail Polish,50,100,50,1,00160,India
516782,2023-09-10,1009,Moisturizer,250,500,250,1,00160,India
516782,2023-09-10,1001,Lipstick,150,300,150,1,00160,India
516782,2023-09-10,1007,Eyeshadow,200,400,200,1,00160,India
700309,2023-09-10,1001,Lipstick,150,300,150,1,00445,India
878301,2023-09-10,1002,Mascara,200,400,200,1,00263,India
523279,2023-09-10,1007,Eyeshadow,200,400,200,1,00363,India
523279,2023-09-10,1006,Blush,150,300,150,1,00363,India
523279,2023-09-10,1008,Makeup Remover,80,160,80,1,00363,India
254232,2023-09-10,1006,Blush,150,300,150,1,00331,India
254232,2023-09-10,1002,Mascara,200,400,200,1,00331,India
254232,2023-09-10,1007,Eyeshadow,200,400,200,1,00331,India
995325,2023-09-10,1008,Makeup Remover,80,160,80,1,00451,India
995325,2023-09-10,1009,Moisturizer,250,500,250,1,00451,India
628437,2023-09-10,1004,Eyeliner,100,200,100,1,00349,India
628437,2023-09-10,1008,Makeup Remover,80,160,80,1,00349,India
723034,2023-09-10,1005,Nail Polish,50,100,50,1,00142,India
723034,2023-09-10,1006,Blush,150,300,150,1,00142,India
942324,2023-09-10,1012,Body Lotion,200,400,200,1,00356,India
942324,2023-09-10,1006,Blush,150,300,150,1,00356,India
942324,2023-09-10,1003,Foundation,300,600,300,1,00356,India
704945,2023-09-10,1002,Mascara,200,400,200,1,00214,India
704945,2023-09-10,1009,Moisturizer,250,500,250,1,00214,India
704945,2023-09-10,1004,Eyeliner,100,200,100,1,00214,India
495730,2023-09-10,1001,Lipstick,150,300,150,1,00474,India
495730,2023-09-10,1003,Foundation,300,600,300,1,00474,India
495730,2023-09-10,1006,Blush,150,300,150,1,00474,India
495730,2023-09-10,1009,Moisturizer,250,500,250,1,00474,India
495730,2023-09-10,1002,Mascara,200,400,200,1,00474,India
131180,2023-09-10,1004,Eyeliner,100,200,100,1,00351,India
131180,2023-09-10,1012,Body Lotion,200,400,200,1,00351,India
131180,2023-09-10,1008,Makeup Remover,80,160,80,1,00351,India
463964,2023-09-10,1002,Mascara,200,400,200,1,00082,India
914439,2023-09-10,1003,Foundation,300,600,300,1,00291,India
914439,2023-09-10,1009,Moisturizer,250,500,250,1,00291,India
914439,2023-09-10,1007,Eyeshadow,200,400,200,1,00291,India
379543,2023-09-10,1008,Makeup Remover,80,160,80,1,00364,India
379543,2023-09-10,1005,Nail Polish,50,100,50,1,00364,India
109830,2023-09-10,1003,Foundation,300,600,300,1,00071,India
967765,2023-09-10,1003,Foundation,300,600,300,1,00340,India
967765,2023-09-10,1006,Blush,150,300,150,1,00340,India
967765,2023-09-10,1012,Body Lotion,200,400,200,1,00340,India
967765,2023-09-10,1008,Makeup Remover,80,160,80,1,00340,India
752566,2023-09-10,1003,Foundation,300,600,300,1,00261,India
752566,2023-09-10,1006,Blush,150,300,150,1,00261,India
752566,2023-09-10,1002,Mascara,200,400,200,1,00261,India
752566,2023-09-10,1008,Makeup Remover,80,160,80,1,00261,India
689393,2023-09-11,1005,Nail Polish,50,100,50,1,00002,India
689393,2023-09-11,1008,Makeup Remover,80,160,80,1,00002,India
689393,2023-09-11,1007,Eyeshadow,200,400,200,1,00002,India
952502,2023-09-11,1006,Blush,150,300,150,1,00091,India
952502,2023-09-11,1007,Eyeshadow,200,400,200,1,00091,India
922806,2023-09-11,1006,Blush,150,300,150,1,00292,India
922806,2023-09-11,1008,Makeup Remover,80,160,80,1,00292,India
922806,2023-09-11,1007,Eyeshadow,200,400,200,1,00292,India
922806,2023-09-11,1003,Foundation,300,600,300,1,00292,India
922806,2023-09-11,1009,Moisturizer,250,500,250,1,00292,India
449899,2023-09-11,1005,Nail Polish,50,100,50,1,00416,India
745300,2023-09-11,1006,Blush,150,300,150,1,00323,India
745300,2023-09-11,1001,Lipstick,150,300,150,1,00323,India
745300,2023-09-11,1004,Eyeliner,100,200,100,1,00323,India
447288,2023-09-11,1004,Eyeliner,100,200,100,1,00367,India
447288,2023-09-11,1001,Lipstick,150,300,150,1,00367,India
447288,2023-09-11,1007,Eyeshadow,200,400,200,1,00367,India
174406,2023-09-11,1006,Blush,150,300,150,1,00155,India
174406,2023-09-11,1005,Nail Polish,50,100,50,1,00155,India
174406,2023-09-11,1002,Mascara,200,400,200,1,00155,India
474515,2023-09-11,1008,Makeup Remover,80,160,80,1,00223,India
474515,2023-09-11,1005,Nail Polish,50,100,50,1,00223,India
474515,2023-09-11,1007,Eyeshadow,200,400,200,1,00223,India
652682,2023-09-11,1002,Mascara,200,400,200,1,00093,India
652682,2023-09-11,1003,Foundation,300,600,300,1,00093,India
652682,2023-09-11,1006,Blush,150,300,150,1,00093,India
652682,2023-09-11,1001,Lipstick,150,300,150,1,00093,India
282120,2023-09-11,1007,Eyeshadow,200,400,200,1,00460,India
282120,2023-09-11,1008,Makeup Remover,80,160,80,1,00460,India
635744,2023-09-11,1004,Eyeliner,100,200,100,1,00380,India
635744,2023-09-11,1008,Makeup Remover,80,160,80,1,00380,India
635744,2023-09-11,1001,Lipstick,150,300,150,1,00380,India
568395,2023-09-11,1009,Moisturizer,250,500,250,1,00232,India
568395,2023-09-11,1001,Lipstick,150,300,150,1,00232,India
568395,2023-09-11,1007,Eyeshadow,200,400,200,1,00232,India
568395,2023-09-11,1012,Body Lotion,200,400,200,1,00232,India
568395,2023-09-11,1008,Makeup Remover,80,160,80,1,00232,India
662034,2023-09-11,1009,Moisturizer,250,500,250,1,00083,India
415222,2023-09-11,1008,Makeup Remover,80,160,80,1,00471,India
415222,2023-09-11,1012,Body Lotion,200,400,200,1,00471,India
415222,2023-09-11,1009,Moisturizer,250,500,250,1,00471,India
591708,2023-09-11,1012,Body Lotion,200,400,200,1,00451,India
591708,2023-09-11,1008,Makeup Remover,80,160,80,1,00451,India
817762,2023-09-11,1006,Blush,150,300,150,1,00227,India
817762,2023-09-11,1008,Makeup Remover,80,160,80,1,00227,India
975214,2023-09-11,1009,Moisturizer,250,500,250,1,00229,India
975214,2023-09-11,1006,Blush,150,300,150,1,00229,India
975214,2023-09-11,1001,Lipstick,150,300,150,1,00229,India
975214,2023-09-11,1007,Eyeshadow,200,400,200,1,00229,India
918213,2023-09-11,1005,Nail Polish,50,100,50,1,00346,India
581672,2023-09-11,1004,Eyeliner,100,200,100,1,00347,India
581672,2023-09-11,1005,Nail Polish,50,100,50,1,00347,India
855966,2023-09-11,1005,Nail Polish,50,100,50,1,00332,India
855966,2023-09-11,1001,Lipstick,150,300,150,1,00332,India
855966,2023-09-11,1004,Eyeliner,100,200,100,1,00332,India
796759,2023-09-11,1005,Nail Polish,50,100,50,1,00214,India
796759,2023-09-11,1003,Foundation,300,600,300,1,00214,India
354264,2023-09-11,1002,Mascara,200,400,200,1,00070,India
418424,2023-09-11,1005,Nail Polish,50,100,50,1,00241,India
418424,2023-09-11,1012,Body Lotion,200,400,200,1,00241,India
137309,2023-09-11,1004,Eyeliner,100,200,100,1,00266,India
137309,2023-09-11,1001,Lipstick,150,300,150,1,00266,India
626041,2023-09-11,1012,Body Lotion,200,400,200,1,00042,India
555646,2023-09-11,1012,Body Lotion,200,400,200,1,00271,India
534976,2023-09-11,1005,Nail Polish,50,100,50,1,00407,India
534976,2023-09-11,1012,Body Lotion,200,400,200,1,00407,India
738232,2023-09-11,1005,Nail Polish,50,100,50,1,00371,India
738232,2023-09-11,1012,Body Lotion,200,400,200,1,00371,India
860800,2023-09-11,1005,Nail Polish,50,100,50,1,00114,India
860800,2023-09-11,1004,Eyeliner,100,200,100,1,00114,India
860800,2023-09-11,1007,Eyeshadow,200,400,200,1,00114,India
424583,2023-09-11,1002,Mascara,200,400,200,1,00106,India
424583,2023-09-11,1005,Nail Polish,50,100,50,1,00106,India
424583,2023-09-11,1009,Moisturizer,250,500,250,1,00106,India
424583,2023-09-11,1008,Makeup Remover,80,160,80,1,00106,India
419726,2023-09-11,1007,Eyeshadow,200,400,200,1,00222,India
419726,2023-09-11,1005,Nail Polish,50,100,50,1,00222,India
419726,2023-09-11,1002,Mascara,200,400,200,1,00222,India
653880,2023-09-11,1001,Lipstick,150,300,150,1,00486,India
653880,2023-09-11,1003,Foundation,300,600,300,1,00486,India
653880,2023-09-11,1009,Moisturizer,250,500,250,1,00486,India
159959,2023-09-11,1012,Body Lotion,200,400,200,1,00466,India
378209,2023-09-11,1005,Nail Polish,50,100,50,1,00170,India
378209,2023-09-11,1009,Moisturizer,250,500,250,1,00170,India
378209,2023-09-11,1012,Body Lotion,200,400,200,1,00170,India
378209,2023-09-11,1003,Foundation,300,600,300,1,00170,India
181958,2023-09-11,1006,Blush,150,300,150,1,00476,India
181958,2023-09-11,1005,Nail Polish,50,100,50,1,00476,India
181958,2023-09-11,1001,Lipstick,150,300,150,1,00476,India
107727,2023-09-11,1007,Eyeshadow,200,400,200,1,00071,India
107727,2023-09-11,1012,Body Lotion,200,400,200,1,00071,India
107727,2023-09-11,1006,Blush,150,300,150,1,00071,India
107727,2023-09-11,1005,Nail Polish,50,100,50,1,00071,India
417801,2023-09-11,1006,Blush,150,300,150,1,00208,India
417801,2023-09-11,1004,Eyeliner,100,200,100,1,00208,India
417801,2023-09-11,1002,Mascara,200,400,200,1,00208,India
939274,2023-09-11,1009,Moisturizer,250,500,250,1,00096,India
939274,2023-09-11,1002,Mascara,200,400,200,1,00096,India
939274,2023-09-11,1006,Blush,150,300,150,1,00096,India
939274,2023-09-11,1003,Foundation,300,600,300,1,00096,India
968542,2023-09-11,1012,Body Lotion,200,400,200,1,00239,India
968542,2023-09-11,1007,Eyeshadow,200,400,200,1,00239,India
968542,2023-09-11,1004,Eyeliner,100,200,100,1,00239,India
429135,2023-09-11,1008,Makeup Remover,80,160,80,1,00186,India
429135,2023-09-11,1007,Eyeshadow,200,400,200,1,00186,India
922871,2023-09-11,1004,Eyeliner,100,200,100,1,00058,India
922871,2023-09-11,1005,Nail Polish,50,100,50,1,00058,India
922871,2023-09-11,1003,Foundation,300,600,300,1,00058,India
922871,2023-09-11,1002,Mascara,200,400,200,1,00058,India
343150,2023-09-11,1012,Body Lotion,200,400,200,1,00282,India
343150,2023-09-11,1006,Blush,150,300,150,1,00282,India
608745,2023-09-11,1001,Lipstick,150,300,150,1,00048,India
608745,2023-09-11,1008,Makeup Remover,80,160,80,1,00048,India
608745,2023-09-11,1005,Nail Polish,50,100,50,1,00048,India
608745,2023-09-11,1002,Mascara,200,400,200,1,00048,India
208644,2023-09-11,1004,Eyeliner,100,200,100,1,00212,India
208644,2023-09-11,1009,Moisturizer,250,500,250,1,00212,India
208644,2023-09-11,1001,Lipstick,150,300,150,1,00212,India
208644,2023-09-11,1006,Blush,150,300,150,1,00212,India
173353,2023-09-12,1009,Moisturizer,250,500,250,1,00103,India
173353,2023-09-12,1008,Makeup Remover,80,160,80,1,00103,India
333104,2023-09-12,1007,Eyeshadow,200,400,200,1,00303,India
559293,2023-09-12,1009,Moisturizer,250,500,250,1,00112,India
415053,2023-09-12,1003,Foundation,300,600,300,1,00215,India
415053,2023-09-12,1009,Moisturizer,250,500,250,1,00215,India
415053,2023-09-12,1002,Mascara,200,400,200,1,00215,India
462849,2023-09-12,1008,Makeup Remover,80,160,80,1,00218,India
462849,2023-09-12,1012,Body Lotion,200,400,200,1,00218,India
182256,2023-09-12,1009,Moisturizer,250,500,250,1,00096,India
829291,2023-09-12,1006,Blush,150,300,150,1,00239,India
829291,2023-09-12,1005,Nail Polish,50,100,50,1,00239,India
959028,2023-09-12,1004,Eyeliner,100,200,100,1,00275,India
959028,2023-09-12,1005,Nail Polish,50,100,50,1,00275,India
313767,2023-09-12,1008,Makeup Remover,80,160,80,1,00059,India
194777,2023-09-12,1001,Lipstick,150,300,150,1,00044,India
588262,2023-09-12,1001,Lipstick,150,300,150,1,00137,India
588262,2023-09-12,1003,Foundation,300,600,300,1,00137,India
906052,2023-09-12,1005,Nail Polish,50,100,50,1,00095,India
906052,2023-09-12,1008,Makeup Remover,80,160,80,1,00095,India
906052,2023-09-12,1003,Foundation,300,600,300,1,00095,India
765041,2023-09-12,1004,Eyeliner,100,200,100,1,00408,India
765041,2023-09-12,1007,Eyeshadow,200,400,200,1,00408,India
765041,2023-09-12,1009,Moisturizer,250,500,250,1,00408,India
773808,2023-09-12,1003,Foundation,300,600,300,1,00217,India
773808,2023-09-12,1001,Lipstick,150,300,150,1,00217,India
773808,2023-09-12,1007,Eyeshadow,200,400,200,1,00217,India
773808,2023-09-12,1006,Blush,150,300,150,1,00217,India
773808,2023-09-12,1012,Body Lotion,200,400,200,1,00217,India
586567,2023-09-12,1002,Mascara,200,400,200,1,00483,India
586567,2023-09-12,1003,Foundation,300,600,300,1,00483,India
998959,2023-09-12,1003,Foundation,300,600,300,1,00211,India
432228,2023-09-12,1007,Eyeshadow,200,400,200,1,00179,India
432228,2023-09-12,1005,Nail Polish,50,100,50,1,00179,India
432228,2023-09-12,1003,Foundation,300,600,300,1,00179,India
432228,2023-09-12,1001,Lipstick,150,300,150,1,00179,India
516715,2023-09-12,1012,Body Lotion,200,400,200,1,00468,India
516715,2023-09-12,1001,Lipstick,150,300,150,1,00468,India
337561,2023-09-12,1005,Nail Polish,50,100,50,1,00493,India
888922,2023-09-12,1012,Body Lotion,200,400,200,1,00297,India
888922,2023-09-12,1009,Moisturizer,250,500,250,1,00297,India
888922,2023-09-12,1005,Nail Polish,50,100,50,1,00297,India
681022,2023-09-12,1008,Makeup Remover,80,160,80,1,00281,India
681022,2023-09-12,1007,Eyeshadow,200,400,200,1,00281,India
681022,2023-09-12,1003,Foundation,300,600,300,1,00281,India
547161,2023-09-12,1003,Foundation,300,600,300,1,00138,India
547161,2023-09-12,1012,Body Lotion,200,400,200,1,00138,India
547161,2023-09-12,1005,Nail Polish,50,100,50,1,00138,India
839549,2023-09-12,1003,Foundation,300,600,300,1,00163,India
839549,2023-09-12,1004,Eyeliner,100,200,100,1,00163,India
839549,2023-09-12,1008,Makeup Remover,80,160,80,1,00163,India
578636,2023-09-12,1012,Body Lotion,200,400,200,1,00080,India
578636,2023-09-12,1003,Foundation,300,600,300,1,00080,India
578636,2023-09-12,1005,Nail Polish,50,100,50,1,00080,India
546820,2023-09-12,1012,Body Lotion,200,400,200,1,00213,India
546820,2023-09-12,1006,Blush,150,300,150,1,00213,India
172157,2023-09-12,1012,Body Lotion,200,400,200,1,00244,India
172157,2023-09-12,1007,Eyeshadow,200,400,200,1,00244,India
601537,2023-09-12,1009,Moisturizer,250,500,250,1,00271,India
601537,2023-09-12,1012,Body Lotion,200,400,200,1,00271,India
601537,2023-09-12,1007,Eyeshadow,200,400,200,1,00271,India
979560,2023-09-12,1003,Foundation,300,600,300,1,00138,India
979560,2023-09-12,1004,Eyeliner,100,200,100,1,00138,India
979560,2023-09-12,1006,Blush,150,300,150,1,00138,India
979560,2023-09-12,1012,Body Lotion,200,400,200,1,00138,India
283196,2023-09-12,1012,Body Lotion,200,400,200,1,00369,India
881182,2023-09-12,1008,Makeup Remover,80,160,80,1,00230,India
881182,2023-09-12,1012,Body Lotion,200,400,200,1,00230,India
881182,2023-09-12,1003,Foundation,300,600,300,1,00230,India
534099,2023-09-12,1006,Blush,150,300,150,1,00488,India
534099,2023-09-12,1009,Moisturizer,250,500,250,1,00488,India
534099,2023-09-12,1002,Mascara,200,400,200,1,00488,India
911292,2023-09-12,1006,Blush,150,300,150,1,00040,India
911292,2023-09-12,1009,Moisturizer,250,500,250,1,00040,India
911292,2023-09-12,1007,Eyeshadow,200,400,200,1,00040,India
911292,2023-09-12,1003,Foundation,300,600,300,1,00040,India
490428,2023-09-12,1003,Foundation,300,600,300,1,00479,India
490428,2023-09-12,1012,Body Lotion,200,400,200,1,00479,India
312705,2023-09-12,1008,Makeup Remover,80,160,80,1,00272,India
312705,2023-09-12,1009,Moisturizer,250,500,250,1,00272,India
312705,2023-09-12,1004,Eyeliner,100,200,100,1,00272,India
353963,2023-09-13,1012,Body Lotion,200,400,200,1,00196,India
353963,2023-09-13,1004,Eyeliner,100,200,100,1,00196,India
405552,2023-09-13,1008,Makeup Remover,80,160,80,1,00028,India
405552,2023-09-13,1007,Eyeshadow,200,400,200,1,00028,India
405552,2023-09-13,1009,Moisturizer,250,500,250,1,00028,India
783520,2023-09-13,1004,Eyeliner,100,200,100,1,00421,India
783520,2023-09-13,1003,Foundation,300,600,300,1,00421,India
783520,2023-09-13,1008,Makeup Remover,80,160,80,1,00421,India
783520,2023-09-13,1012,Body Lotion,200,400,200,1,00421,India
232170,2023-09-13,1009,Moisturizer,250,500,250,1,00249,India
232170,2023-09-13,1008,Makeup Remover,80,160,80,1,00249,India
637708,2023-09-13,1004,Eyeliner,100,200,100,1,00052,India
637708,2023-09-13,1001,Lipstick,150,300,150,1,00052,India
362770,2023-09-13,1002,Mascara,200,400,200,1,00349,India
362770,2023-09-13,1003,Foundation,300,600,300,1,00349,India
362770,2023-09-13,1001,Lipstick,150,300,150,1,00349,India
362770,2023-09-13,1006,Blush,150,300,150,1,00349,India
362770,2023-09-13,1005,Nail Polish,50,100,50,1,00349,India
989654,2023-09-13,1012,Body Lotion,200,400,200,1,00384,India
989654,2023-09-13,1003,Foundation,300,600,300,1,00384,India
959783,2023-09-13,1006,Blush,150,300,150,1,00082,India
959783,2023-09-13,1009,Moisturizer,250,500,250,1,00082,India
526365,2023-09-13,1008,Makeup Remover,80,160,80,1,00465,India
526365,2023-09-13,1012,Body Lotion,200,400,200,1,00465,India
526365,2023-09-13,1005,Nail Polish,50,100,50,1,00465,India
330543,2023-09-13,1005,Nail Polish,50,100,50,1,00442,India
330543,2023-09-13,1009,Moisturizer,250,500,250,1,00442,India
432079,2023-09-13,1004,Eyeliner,100,200,100,1,00294,India
466917,2023-09-13,1001,Lipstick,150,300,150,1,00318,India
623765,2023-09-13,1009,Moisturizer,250,500,250,1,00422,India
623765,2023-09-13,1008,Makeup Remover,80,160,80,1,00422,India
623765,2023-09-13,1006,Blush,150,300,150,1,00422,India
369798,2023-09-13,1008,Makeup Remover,80,160,80,1,00101,India
516272,2023-09-13,1006,Blush,150,300,150,1,00344,India
516272,2023-09-13,1012,Body Lotion,200,400,200,1,00344,India
516272,2023-09-13,1004,Eyeliner,100,200,100,1,00344,India
312141,2023-09-13,1002,Mascara,200,400,200,1,00095,India
312141,2023-09-13,1005,Nail Polish,50,100,50,1,00095,India
229864,2023-09-13,1003,Foundation,300,600,300,1,00292,India
229864,2023-09-13,1012,Body Lotion,200,400,200,1,00292,India
879774,2023-09-13,1002,Mascara,200,400,200,1,00085,India
879774,2023-09-13,1007,Eyeshadow,200,400,200,1,00085,India
879774,2023-09-13,1001,Lipstick,150,300,150,1,00085,India
810244,2023-09-13,1002,Mascara,200,400,200,1,00315,India
810244,2023-09-13,1012,Body Lotion,200,400,200,1,00315,India
682009,2023-09-13,1008,Makeup Remover,80,160,80,1,00342,India
682009,2023-09-13,1004,Eyeliner,100,200,100,1,00342,India
682009,2023-09-13,1003,Foundation,300,600,300,1,00342,India
239081,2023-09-13,1004,Eyeliner,100,200,100,1,00489,India
526821,2023-09-13,1002,Mascara,200,400,200,1,00186,India
526821,2023-09-13,1001,Lipstick,150,300,150,1,00186,India
526821,2023-09-13,1007,Eyeshadow,200,400,200,1,00186,India
526821,2023-09-13,1005,Nail Polish,50,100,50,1,00186,India
822331,2023-09-13,1012,Body Lotion,200,400,200,1,00474,India
344487,2023-09-13,1009,Moisturizer,250,500,250,1,00261,India
344487,2023-09-13,1002,Mascara,200,400,200,1,00261,India
561287,2023-09-13,1008,Makeup Remover,80,160,80,1,00087,India
561287,2023-09-13,1005,Nail Polish,50,100,50,1,00087,India
561287,2023-09-13,1006,Blush,150,300,150,1,00087,India
561287,2023-09-13,1002,Mascara,200,400,200,1,00087,India
532598,2023-09-13,1003,Foundation,300,600,300,1,00452,India
532598,2023-09-13,1004,Eyeliner,100,200,100,1,00452,India
532598,2023-09-13,1002,Mascara,200,400,200,1,00452,India
532598,2023-09-13,1007,Eyeshadow,200,400,200,1,00452,India
532598,2023-09-13,1005,Nail Polish,50,100,50,1,00452,India
762935,2023-09-13,1004,Eyeliner,100,200,100,1,00418,India
762935,2023-09-13,1002,Mascara,200,400,200,1,00418,India
470104,2023-09-13,1006,Blush,150,300,150,1,00096,India
470104,2023-09-13,1005,Nail Polish,50,100,50,1,00096,India
470104,2023-09-13,1002,Mascara,200,400,200,1,00096,India
470104,2023-09-13,1001,Lipstick,150,300,150,1,00096,India
258144,2023-09-13,1002,Mascara,200,400,200,1,00337,India
258144,2023-09-13,1001,Lipstick,150,300,150,1,00337,India
855955,2023-09-13,1005,Nail Polish,50,100,50,1,00288,India
654722,2023-09-13,1007,Eyeshadow,200,400,200,1,00423,India
446010,2023-09-13,1001,Lipstick,150,300,150,1,00002,India
446010,2023-09-13,1005,Nail Polish,50,100,50,1,00002,India
446010,2023-09-13,1012,Body Lotion,200,400,200,1,00002,India
947559,2023-09-13,1003,Foundation,300,600,300,1,00467,India
947559,2023-09-13,1007,Eyeshadow,200,400,200,1,00467,India
947559,2023-09-13,1008,Makeup Remover,80,160,80,1,00467,India
947559,2023-09-13,1005,Nail Polish,50,100,50,1,00467,India
947559,2023-09-13,1006,Blush,150,300,150,1,00467,India
949482,2023-09-14,1012,Body Lotion,200,400,200,1,00473,India
949482,2023-09-14,1005,Nail Polish,50,100,50,1,00473,India
949482,2023-09-14,1006,Blush,150,300,150,1,00473,India
234823,2023-09-14,1004,Eyeliner,100,200,100,1,00418,India
838350,2023-09-14,1004,Eyeliner,100,200,100,1,00209,India
838350,2023-09-14,1001,Lipstick,150,300,150,1,00209,India
591368,2023-09-14,1001,Lipstick,150,300,150,1,00494,India
591368,2023-09-14,1009,Moisturizer,250,500,250,1,00494,India
591368,2023-09-14,1008,Makeup Remover,80,160,80,1,00494,India
591368,2023-09-14,1003,Foundation,300,600,300,1,00494,India
221378,2023-09-14,1006,Blush,150,300,150,1,00311,India
220764,2023-09-14,1007,Eyeshadow,200,400,200,1,00300,India
379638,2023-09-14,1006,Blush,150,300,150,1,00232,India
379638,2023-09-14,1001,Lipstick,150,300,150,1,00232,India
379638,2023-09-14,1007,Eyeshadow,200,400,200,1,00232,India
247494,2023-09-14,1009,Moisturizer,250,500,250,1,00349,India
247494,2023-09-14,1006,Blush,150,300,150,1,00349,India
247494,2023-09-14,1003,Foundation,300,600,300,1,00349,India
247494,2023-09-14,1002,Mascara,200,400,200,1,00349,India
247494,2023-09-14,1001,Lipstick,150,300,150,1,00349,India
154915,2023-09-14,1012,Body Lotion,200,400,200,1,00159,India
467530,2023-09-14,1005,Nail Polish,50,100,50,1,00361,India
467530,2023-09-14,1003,Foundation,300,600,300,1,00361,India
945753,2023-09-14,1003,Foundation,300,600,300,1,00144,India
945753,2023-09-14,1002,Mascara,200,400,200,1,00144,India
945753,2023-09-14,1009,Moisturizer,250,500,250,1,00144,India
462680,2023-09-14,1009,Moisturizer,250,500,250,1,00246,India
197723,2023-09-14,1001,Lipstick,150,300,150,1,00425,India
197723,2023-09-14,1003,Foundation,300,600,300,1,00425,India
197723,2023-09-14,1008,Makeup Remover,80,160,80,1,00425,India
688863,2023-09-14,1012,Body Lotion,200,400,200,1,00325,India
688863,2023-09-14,1006,Blush,150,300,150,1,00325,India
688863,2023-09-14,1001,Lipstick,150,300,150,1,00325,India
688863,2023-09-14,1002,Mascara,200,400,200,1,00325,India
861557,2023-09-14,1012,Body Lotion,200,400,200,1,00206,India
861557,2023-09-14,1006,Blush,150,300,150,1,00206,India
107738,2023-09-14,1001,Lipstick,150,300,150,1,00395,India
107738,2023-09-14,1009,Moisturizer,250,500,250,1,00395,India
107738,2023-09-14,1006,Blush,150,300,150,1,00395,India
359773,2023-09-14,1005,Nail Polish,50,100,50,1,00353,India
359773,2023-09-14,1007,Eyeshadow,200,400,200,1,00353,India
359773,2023-09-14,1002,Mascara,200,400,200,1,00353,India
359773,2023-09-14,1004,Eyeliner,100,200,100,1,00353,India
359773,2023-09-14,1003,Foundation,300,600,300,1,00353,India
191272,2023-09-14,1002,Mascara,200,400,200,1,00360,India
191272,2023-09-14,1004,Eyeliner,100,200,100,1,00360,India
191272,2023-09-14,1001,Lipstick,150,300,150,1,00360,India
191272,2023-09-14,1009,Moisturizer,250,500,250,1,00360,India
191272,2023-09-14,1003,Foundation,300,600,300,1,00360,India
797413,2023-09-14,1003,Foundation,300,600,300,1,00084,India
795544,2023-09-14,1008,Makeup Remover,80,160,80,1,00398,India
795544,2023-09-14,1003,Foundation,300,600,300,1,00398,India
236966,2023-09-14,1006,Blush,150,300,150,1,00411,India
977769,2023-09-14,1004,Eyeliner,100,200,100,1,00012,India
977769,2023-09-14,1008,Makeup Remover,80,160,80,1,00012,India
977769,2023-09-14,1006,Blush,150,300,150,1,00012,India
261669,2023-09-14,1009,Moisturizer,250,500,250,1,00198,India
261669,2023-09-14,1007,Eyeshadow,200,400,200,1,00198,India
261669,2023-09-14,1001,Lipstick,150,300,150,1,00198,India
252628,2023-09-14,1008,Makeup Remover,80,160,80,1,00182,India
252628,2023-09-14,1003,Foundation,300,600,300,1,00182,India
252628,2023-09-14,1001,Lipstick,150,300,150,1,00182,India
412105,2023-09-14,1006,Blush,150,300,150,1,00357,India
113594,2023-09-14,1012,Body Lotion,200,400,200,1,00089,India
113594,2023-09-14,1007,Eyeshadow,200,400,200,1,00089,India
113594,2023-09-14,1009,Moisturizer,250,500,250,1,00089,India
740020,2023-09-14,1003,Foundation,300,600,300,1,00497,India
740020,2023-09-14,1009,Moisturizer,250,500,250,1,00497,India
740020,2023-09-14,1002,Mascara,200,400,200,1,00497,India
188331,2023-09-14,1009,Moisturizer,250,500,250,1,00317,India
188331,2023-09-14,1001,Lipstick,150,300,150,1,00317,India
188331,2023-09-14,1003,Foundation,300,600,300,1,00317,India
188331,2023-09-14,1006,Blush,150,300,150,1,00317,India
833615,2023-09-14,1002,Mascara,200,400,200,1,00287,India
833615,2023-09-14,1012,Body Lotion,200,400,200,1,00287,India
833615,2023-09-14,1001,Lipstick,150,300,150,1,00287,India
833615,2023-09-14,1007,Eyeshadow,200,400,200,1,00287,India
661481,2023-09-14,1012,Body Lotion,200,400,200,1,00007,India
661481,2023-09-14,1005,Nail Polish,50,100,50,1,00007,India
566101,2023-09-14,1001,Lipstick,150,300,150,1,00478,India
566101,2023-09-14,1006,Blush,150,300,150,1,00478,India
566101,2023-09-14,1007,Eyeshadow,200,400,200,1,00478,India
496610,2023-09-14,1005,Nail Polish,50,100,50,1,00241,India
496610,2023-09-14,1012,Body Lotion,200,400,200,1,00241,India
496610,2023-09-14,1009,Moisturizer,250,500,250,1,00241,India
496610,2023-09-14,1003,Foundation,300,600,300,1,00241,India
446558,2023-09-14,1005,Nail Polish,50,100,50,1,00148,India
670053,2023-09-14,1001,Lipstick,150,300,150,1,00317,India
670053,2023-09-14,1003,Foundation,300,600,300,1,00317,India
670053,2023-09-14,1007,Eyeshadow,200,400,200,1,00317,India
927358,2023-09-14,1001,Lipstick,150,300,150,1,00119,India
927358,2023-09-14,1007,Eyeshadow,200,400,200,1,00119,India
927358,2023-09-14,1006,Blush,150,300,150,1,00119,India
927358,2023-09-14,1012,Body Lotion,200,400,200,1,00119,India
637271,2023-09-14,1007,Eyeshadow,200,400,200,1,00071,India
703189,2023-09-14,1007,Eyeshadow,200,400,200,1,00326,India
703189,2023-09-14,1002,Mascara,200,400,200,1,00326,India
703189,2023-09-14,1001,Lipstick,150,300,150,1,00326,India
703189,2023-09-14,1004,Eyeliner,100,200,100,1,00326,India
703189,2023-09-14,1005,Nail Polish,50,100,50,1,00326,India
691422,2023-09-14,1012,Body Lotion,200,400,200,1,00476,India
691422,2023-09-14,1001,Lipstick,150,300,150,1,00476,India
143712,2023-09-14,1009,Moisturizer,250,500,250,1,00064,India
330737,2023-09-14,1012,Body Lotion,200,400,200,1,00093,India
330737,2023-09-14,1008,Makeup Remover,80,160,80,1,00093,India
294777,2023-09-14,1008,Makeup Remover,80,160,80,1,00371,India
817693,2023-09-14,1006,Blush,150,300,150,1,00379,India
817693,2023-09-14,1004,Eyeliner,100,200,100,1,00379,India
817693,2023-09-14,1009,Moisturizer,250,500,250,1,00379,India
817693,2023-09-14,1008,Makeup Remover,80,160,80,1,00379,India
538852,2023-09-14,1005,Nail Polish,50,100,50,1,00285,India
538852,2023-09-14,1004,Eyeliner,100,200,100,1,00285,India
538852,2023-09-14,1003,Foundation,300,600,300,1,00285,India
423090,2023-09-14,1003,Foundation,300,600,300,1,00087,India
423090,2023-09-14,1007,Eyeshadow,200,400,200,1,00087,India
687179,2023-09-14,1004,Eyeliner,100,200,100,1,00344,India
687179,2023-09-14,1005,Nail Polish,50,100,50,1,00344,India
687179,2023-09-14,1008,Makeup Remover,80,160,80,1,00344,India
687179,2023-09-14,1012,Body Lotion,200,400,200,1,00344,India
687179,2023-09-14,1002,Mascara,200,400,200,1,00344,India
837860,2023-09-14,1009,Moisturizer,250,500,250,1,00050,India
837860,2023-09-14,1006,Blush,150,300,150,1,00050,India
140630,2023-09-14,1001,Lipstick,150,300,150,1,00369,India
140630,2023-09-14,1012,Body Lotion,200,400,200,1,00369,India
140630,2023-09-14,1006,Blush,150,300,150,1,00369,India
140630,2023-09-14,1004,Eyeliner,100,200,100,1,00369,India
928381,2023-09-14,1009,Moisturizer,250,500,250,1,00473,India
928381,2023-09-14,1001,Lipstick,150,300,150,1,00473,India
928381,2023-09-14,1006,Blush,150,300,150,1,00473,India
928381,2023-09-14,1008,Makeup Remover,80,160,80,1,00473,India
928381,2023-09-14,1004,Eyeliner,100,200,100,1,00473,India
497187,2023-09-14,1012,Body Lotion,200,400,200,1,00411,India
654191,2023-09-14,1006,Blush,150,300,150,1,00359,India
654191,2023-09-14,1007,Eyeshadow,200,400,200,1,00359,India
654191,2023-09-14,1005,Nail Polish,50,100,50,1,00359,India
808454,2023-09-15,1003,Foundation,300,600,300,1,00313,India
808454,2023-09-15,1008,Makeup Remover,80,160,80,1,00313,India
808454,2023-09-15,1009,Moisturizer,250,500,250,1,00313,India
297307,2023-09-15,1002,Mascara,200,400,200,1,00025,India
731698,2023-09-15,1009,Moisturizer,250,500,250,1,00190,India
148261,2023-09-15,1002,Mascara,200,400,200,1,00291,India
148261,2023-09-15,1001,Lipstick,150,300,150,1,00291,India
510512,2023-09-15,1004,Eyeliner,100,200,100,1,00387,India
510512,2023-09-15,1005,Nail Polish,50,100,50,1,00387,India
510512,2023-09-15,1002,Mascara,200,400,200,1,00387,India
936939,2023-09-15,1001,Lipstick,150,300,150,1,00493,India
739398,2023-09-15,1008,Makeup Remover,80,160,80,1,00413,India
126507,2023-09-15,1006,Blush,150,300,150,1,00280,India
126507,2023-09-15,1002,Mascara,200,400,200,1,00280,India
656295,2023-09-15,1012,Body Lotion,200,400,200,1,00434,India
876569,2023-09-15,1008,Makeup Remover,80,160,80,1,00131,India
876569,2023-09-15,1004,Eyeliner,100,200,100,1,00131,India
184877,2023-09-15,1005,Nail Polish,50,100,50,1,00343,India
184877,2023-09-15,1001,Lipstick,150,300,150,1,00343,India
184877,2023-09-15,1009,Moisturizer,250,500,250,1,00343,India
184877,2023-09-15,1006,Blush,150,300,150,1,00343,India
301344,2023-09-15,1012,Body Lotion,200,400,200,1,00127,India
715050,2023-09-15,1004,Eyeliner,100,200,100,1,00310,India
715050,2023-09-15,1007,Eyeshadow,200,400,200,1,00310,India
715050,2023-09-15,1009,Moisturizer,250,500,250,1,00310,India
715050,2023-09-15,1012,Body Lotion,200,400,200,1,00310,India
801415,2023-09-15,1004,Eyeliner,100,200,100,1,00084,India
801415,2023-09-15,1012,Body Lotion,200,400,200,1,00084,India
129662,2023-09-15,1008,Makeup Remover,80,160,80,1,00239,India
129662,2023-09-15,1002,Mascara,200,400,200,1,00239,India
129662,2023-09-15,1005,Nail Polish,50,100,50,1,00239,India
813755,2023-09-15,1005,Nail Polish,50,100,50,1,00208,India
813755,2023-09-15,1006,Blush,150,300,150,1,00208,India
813755,2023-09-15,1003,Foundation,300,600,300,1,00208,India
813755,2023-09-15,1004,Eyeliner,100,200,100,1,00208,India
813755,2023-09-15,1001,Lipstick,150,300,150,1,00208,India
263604,2023-09-15,1001,Lipstick,150,300,150,1,00475,India
263604,2023-09-15,1007,Eyeshadow,200,400,200,1,00475,India
263604,2023-09-15,1002,Mascara,200,400,200,1,00475,India
496920,2023-09-15,1003,Foundation,300,600,300,1,00443,India
496920,2023-09-15,1005,Nail Polish,50,100,50,1,00443,India
496920,2023-09-15,1012,Body Lotion,200,400,200,1,00443,India
338483,2023-09-15,1002,Mascara,200,400,200,1,00461,India
531779,2023-09-15,1008,Makeup Remover,80,160,80,1,00155,India
452660,2023-09-15,1009,Moisturizer,250,500,250,1,00288,India
452660,2023-09-15,1002,Mascara,200,400,200,1,00288,India
246267,2023-09-15,1007,Eyeshadow,200,400,200,1,00347,India
246267,2023-09-15,1001,Lipstick,150,300,150,1,00347,India
246267,2023-09-15,1003,Foundation,300,600,300,1,00347,India
246267,2023-09-15,1006,Blush,150,300,150,1,00347,India
823031,2023-09-15,1007,Eyeshadow,200,400,200,1,00060,India
141157,2023-09-15,1008,Makeup Remover,80,160,80,1,00023,India
339235,2023-09-15,1003,Foundation,300,600,300,1,00461,India
256593,2023-09-15,1002,Mascara,200,400,200,1,00068,India
256593,2023-09-15,1006,Blush,150,300,150,1,00068,India
256593,2023-09-15,1007,Eyeshadow,200,400,200,1,00068,India
256593,2023-09-15,1008,Makeup Remover,80,160,80,1,00068,India
804977,2023-09-15,1002,Mascara,200,400,200,1,00350,India
804977,2023-09-15,1012,Body Lotion,200,400,200,1,00350,India
804977,2023-09-15,1004,Eyeliner,100,200,100,1,00350,India
804977,2023-09-15,1003,Foundation,300,600,300,1,00350,India
359124,2023-09-15,1007,Eyeshadow,200,400,200,1,00410,India
359124,2023-09-15,1006,Blush,150,300,150,1,00410,India
899142,2023-09-15,1001,Lipstick,150,300,150,1,00447,India
899142,2023-09-15,1005,Nail Polish,50,100,50,1,00447,India
125440,2023-09-15,1007,Eyeshadow,200,400,200,1,00470,India
125440,2023-09-15,1005,Nail Polish,50,100,50,1,00470,India
162280,2023-09-15,1004,Eyeliner,100,200,100,1,00472,India
162280,2023-09-15,1007,Eyeshadow,200,400,200,1,00472,India
162280,2023-09-15,1003,Foundation,300,600,300,1,00472,India
162280,2023-09-15,1002,Mascara,200,400,200,1,00472,India
162280,2023-09-15,1008,Makeup Remover,80,160,80,1,00472,India
537983,2023-09-15,1006,Blush,150,300,150,1,00437,India
537983,2023-09-15,1001,Lipstick,150,300,150,1,00437,India
537983,2023-09-15,1007,Eyeshadow,200,400,200,1,00437,India
214434,2023-09-15,1012,Body Lotion,200,400,200,1,00365,India
820724,2023-09-15,1001,Lipstick,150,300,150,1,00467,India
820724,2023-09-15,1005,Nail Polish,50,100,50,1,00467,India
820724,2023-09-15,1003,Foundation,300,600,300,1,00467,India
392660,2023-09-15,1006,Blush,150,300,150,1,00296,India
392660,2023-09-15,1004,Eyeliner,100,200,100,1,00296,India
392660,2023-09-15,1002,Mascara,200,400,200,1,00296,India
694165,2023-09-15,1002,Mascara,200,400,200,1,00497,India
278375,2023-09-15,1002,Mascara,200,400,200,1,00440,India
278375,2023-09-15,1006,Blush,150,300,150,1,00440,India
700119,2023-09-15,1009,Moisturizer,250,500,250,1,00273,India
700119,2023-09-15,1004,Eyeliner,100,200,100,1,00273,India
700119,2023-09-15,1012,Body Lotion,200,400,200,1,00273,India
700119,2023-09-15,1001,Lipstick,150,300,150,1,00273,India
333578,2023-09-15,1001,Lipstick,150,300,150,1,00156,India
333578,2023-09-15,1008,Makeup Remover,80,160,80,1,00156,India
333578,2023-09-15,1007,Eyeshadow,200,400,200,1,00156,India
120489,2023-09-15,1003,Foundation,300,600,300,1,00144,India
120489,2023-09-15,1009,Moisturizer,250,500,250,1,00144,India
886066,2023-09-15,1005,Nail Polish,50,100,50,1,00292,India
886066,2023-09-15,1006,Blush,150,300,150,1,00292,India
643630,2023-09-15,1003,Foundation,300,600,300,1,00462,India
643630,2023-09-15,1008,Makeup Remover,80,160,80,1,00462,India
643630,2023-09-15,1002,Mascara,200,400,200,1,00462,India
643630,2023-09-15,1007,Eyeshadow,200,400,200,1,00462,India
303242,2023-09-15,1006,Blush,150,300,150,1,00410,India
303242,2023-09-15,1001,Lipstick,150,300,150,1,00410,India
627601,2023-09-15,1003,Foundation,300,600,300,1,00377,India
627601,2023-09-15,1006,Blush,150,300,150,1,00377,India
627601,2023-09-15,1005,Nail Polish,50,100,50,1,00377,India
627601,2023-09-15,1002,Mascara,200,400,200,1,00377,India
472648,2023-09-15,1002,Mascara,200,400,200,1,00293,India
472648,2023-09-15,1009,Moisturizer,250,500,250,1,00293,India
472648,2023-09-15,1006,Blush,150,300,150,1,00293,India
472648,2023-09-15,1012,Body Lotion,200,400,200,1,00293,India
815572,2023-09-15,1009,Moisturizer,250,500,250,1,00083,India
815572,2023-09-15,1002,Mascara,200,400,200,1,00083,India
815572,2023-09-15,1012,Body Lotion,200,400,200,1,00083,India
815572,2023-09-15,1004,Eyeliner,100,200,100,1,00083,India
815572,2023-09-15,1001,Lipstick,150,300,150,1,00083,India
481566,2023-09-15,1008,Makeup Remover,80,160,80,1,00498,India
481566,2023-09-15,1006,Blush,150,300,150,1,00498,India
584746,2023-09-15,1008,Makeup Remover,80,160,80,1,00240,India
584746,2023-09-15,1005,Nail Polish,50,100,50,1,00240,India
584746,2023-09-15,1012,Body Lotion,200,400,200,1,00240,India
584746,2023-09-15,1001,Lipstick,150,300,150,1,00240,India
834136,2023-09-15,1004,Eyeliner,100,200,100,1,00457,India
834136,2023-09-15,1003,Foundation,300,600,300,1,00457,India
834136,2023-09-15,1005,Nail Polish,50,100,50,1,00457,India
530230,2023-09-16,1001,Lipstick,150,300,150,1,00053,India
962925,2023-09-16,1009,Moisturizer,250,500,250,1,00008,India
962925,2023-09-16,1008,Makeup Remover,80,160,80,1,00008,India
189365,2023-09-16,1003,Foundation,300,600,300,1,00257,India
189365,2023-09-16,1007,Eyeshadow,200,400,200,1,00257,India
189365,2023-09-16,1001,Lipstick,150,300,150,1,00257,India
189365,2023-09-16,1004,Eyeliner,100,200,100,1,00257,India
180371,2023-09-16,1012,Body Lotion,200,400,200,1,00292,India
180371,2023-09-16,1002,Mascara,200,400,200,1,00292,India
490399,2023-09-16,1005,Nail Polish,50,100,50,1,00102,India
490399,2023-09-16,1009,Moisturizer,250,500,250,1,00102,India
490399,2023-09-16,1004,Eyeliner,100,200,100,1,00102,India
949426,2023-09-16,1003,Foundation,300,600,300,1,00127,India
243453,2023-09-16,1003,Foundation,300,600,300,1,00491,India
243453,2023-09-16,1009,Moisturizer,250,500,250,1,00491,India
243453,2023-09-16,1012,Body Lotion,200,400,200,1,00491,India
317445,2023-09-16,1002,Mascara,200,400,200,1,00048,India
849949,2023-09-16,1008,Makeup Remover,80,160,80,1,00430,India
849949,2023-09-16,1002,Mascara,200,400,200,1,00430,India
849949,2023-09-16,1001,Lipstick,150,300,150,1,00430,India
849949,2023-09-16,1006,Blush,150,300,150,1,00430,India
286000,2023-09-16,1003,Foundation,300,600,300,1,00106,India
234862,2023-09-16,1003,Foundation,300,600,300,1,00383,India
234862,2023-09-16,1001,Lipstick,150,300,150,1,00383,India
234862,2023-09-16,1007,Eyeshadow,200,400,200,1,00383,India
391427,2023-09-16,1001,Lipstick,150,300,150,1,00332,India
391427,2023-09-16,1008,Makeup Remover,80,160,80,1,00332,India
391427,2023-09-16,1004,Eyeliner,100,200,100,1,00332,India
391427,2023-09-16,1012,Body Lotion,200,400,200,1,00332,India
391427,2023-09-16,1007,Eyeshadow,200,400,200,1,00332,India
632836,2023-09-16,1003,Foundation,300,600,300,1,00143,India
632836,2023-09-16,1002,Mascara,200,400,200,1,00143,India
632836,2023-09-16,1006,Blush,150,300,150,1,00143,India
626917,2023-09-16,1002,Mascara,200,400,200,1,00375,India
626917,2023-09-16,1005,Nail Polish,50,100,50,1,00375,India
626917,2023-09-16,1012,Body Lotion,200,400,200,1,00375,India
407468,2023-09-16,1001,Lipstick,150,300,150,1,00182,India
407468,2023-09-16,1005,Nail Polish,50,100,50,1,00182,India
407468,2023-09-16,1012,Body Lotion,200,400,200,1,00182,India
410536,2023-09-16,1004,Eyeliner,100,200,100,1,00413,India
410536,2023-09-16,1001,Lipstick,150,300,150,1,00413,India
410536,2023-09-16,1002,Mascara,200,400,200,1,00413,India
492974,2023-09-16,1007,Eyeshadow,200,400,200,1,00177,India
492974,2023-09-16,1005,Nail Polish,50,100,50,1,00177,India
909302,2023-09-16,1005,Nail Polish,50,100,50,1,00418,India
909302,2023-09-16,1012,Body Lotion,200,400,200,1,00418,India
909302,2023-09-16,1008,Makeup Remover,80,160,80,1,00418,India
909302,2023-09-16,1007,Eyeshadow,200,400,200,1,00418,India
401552,2023-09-16,1008,Makeup Remover,80,160,80,1,00298,India
401552,2023-09-16,1004,Eyeliner,100,200,100,1,00298,India
401552,2023-09-16,1001,Lipstick,150,300,150,1,00298,India
401552,2023-09-16,1002,Mascara,200,400,200,1,00298,India
456190,2023-09-16,1006,Blush,150,300,150,1,00244,India
461838,2023-09-16,1012,Body Lotion,200,400,200,1,00396,India
461838,2023-09-16,1004,Eyeliner,100,200,100,1,00396,India
714780,2023-09-16,1003,Foundation,300,600,300,1,00177,India
714780,2023-09-16,1002,Mascara,200,400,200,1,00177,India
714780,2023-09-16,1007,Eyeshadow,200,400,200,1,00177,India
714780,2023-09-16,1008,Makeup Remover,80,160,80,1,00177,India
283186,2023-09-16,1009,Moisturizer,250,500,250,1,00001,India
283186,2023-09-16,1007,Eyeshadow,200,400,200,1,00001,India
283186,2023-09-16,1006,Blush,150,300,150,1,00001,India
283186,2023-09-16,1004,Eyeliner,100,200,100,1,00001,India
847771,2023-09-16,1007,Eyeshadow,200,400,200,1,00271,India
980183,2023-09-16,1012,Body Lotion,200,400,200,1,00363,India
980183,2023-09-16,1004,Eyeliner,100,200,100,1,00363,India
980183,2023-09-16,1008,Makeup Remover,80,160,80,1,00363,India
600091,2023-09-16,1009,Moisturizer,250,500,250,1,00140,India
600091,2023-09-16,1002,Mascara,200,400,200,1,00140,India
600091,2023-09-16,1012,Body Lotion,200,400,200,1,00140,India
600091,2023-09-16,1006,Blush,150,300,150,1,00140,India
736378,2023-09-16,1003,Foundation,300,600,300,1,00477,India
736378,2023-09-16,1012,Body Lotion,200,400,200,1,00477,India
736378,2023-09-16,1001,Lipstick,150,300,150,1,00477,India
736378,2023-09-16,1002,Mascara,200,400,200,1,00477,India
624584,2023-09-16,1002,Mascara,200,400,200,1,00497,India
624584,2023-09-16,1004,Eyeliner,100,200,100,1,00497,India
624584,2023-09-16,1001,Lipstick,150,300,150,1,00497,India
889854,2023-09-16,1009,Moisturizer,250,500,250,1,00274,India
889854,2023-09-16,1001,Lipstick,150,300,150,1,00274,India
889854,2023-09-16,1004,Eyeliner,100,200,100,1,00274,India
980249,2023-09-16,1001,Lipstick,150,300,150,1,00376,India
485112,2023-09-16,1008,Makeup Remover,80,160,80,1,00118,India
485112,2023-09-16,1005,Nail Polish,50,100,50,1,00118,India
485112,2023-09-16,1003,Foundation,300,600,300,1,00118,India
446157,2023-09-16,1005,Nail Polish,50,100,50,1,00205,India
446157,2023-09-16,1006,Blush,150,300,150,1,00205,India
446157,2023-09-16,1001,Lipstick,150,300,150,1,00205,India
520763,2023-09-16,1003,Foundation,300,600,300,1,00379,India
520763,2023-09-16,1007,Eyeshadow,200,400,200,1,00379,India
520763,2023-09-16,1012,Body Lotion,200,400,200,1,00379,India
520763,2023-09-16,1001,Lipstick,150,300,150,1,00379,India
684771,2023-09-16,1004,Eyeliner,100,200,100,1,00011,India
684771,2023-09-16,1006,Blush,150,300,150,1,00011,India
684771,2023-09-16,1003,Foundation,300,600,300,1,00011,India
691179,2023-09-16,1006,Blush,150,300,150,1,00253,India
900590,2023-09-16,1005,Nail Polish,50,100,50,1,00358,India
900590,2023-09-16,1009,Moisturizer,250,500,250,1,00358,India
900590,2023-09-16,1012,Body Lotion,200,400,200,1,00358,India
743950,2023-09-16,1009,Moisturizer,250,500,250,1,00246,India
743950,2023-09-16,1007,Eyeshadow,200,400,200,1,00246,India
674740,2023-09-16,1004,Eyeliner,100,200,100,1,00149,India
192074,2023-09-16,1002,Mascara,200,400,200,1,00125,India
192074,2023-09-16,1007,Eyeshadow,200,400,200,1,00125,India
192074,2023-09-16,1009,Moisturizer,250,500,250,1,00125,India
192074,2023-09-16,1012,Body Lotion,200,400,200,1,00125,India
192074,2023-09-16,1008,Makeup Remover,80,160,80,1,00125,India
468757,2023-09-16,1001,Lipstick,150,300,150,1,00302,India
468757,2023-09-16,1007,Eyeshadow,200,400,200,1,00302,India
468757,2023-09-16,1012,Body Lotion,200,400,200,1,00302,India
468757,2023-09-16,1005,Nail Polish,50,100,50,1,00302,India
468757,2023-09-16,1006,Blush,150,300,150,1,00302,India
683107,2023-09-16,1004,Eyeliner,100,200,100,1,00046,India
683107,2023-09-16,1008,Makeup Remover,80,160,80,1,00046,India
683107,2023-09-16,1006,Blush,150,300,150,1,00046,India
683107,2023-09-16,1002,Mascara,200,400,200,1,00046,India
152912,2023-09-16,1007,Eyeshadow,200,400,200,1,00486,India
396588,2023-09-16,1009,Moisturizer,250,500,250,1,00376,India
294790,2023-09-16,1009,Moisturizer,250,500,250,1,00208,India
294790,2023-09-16,1002,Mascara,200,400,200,1,00208,India
294790,2023-09-16,1005,Nail Polish,50,100,50,1,00208,India
833905,2023-09-17,1007,Eyeshadow,200,400,200,1,00026,India
833905,2023-09-17,1003,Foundation,300,600,300,1,00026,India
833905,2023-09-17,1002,Mascara,200,400,200,1,00026,India
525058,2023-09-17,1004,Eyeliner,100,200,100,1,00391,India
525058,2023-09-17,1009,Moisturizer,250,500,250,1,00391,India
525058,2023-09-17,1003,Foundation,300,600,300,1,00391,India
525058,2023-09-17,1007,Eyeshadow,200,400,200,1,00391,India
955777,2023-09-17,1003,Foundation,300,600,300,1,00289,India
955777,2023-09-17,1012,Body Lotion,200,400,200,1,00289,India
799121,2023-09-17,1009,Moisturizer,250,500,250,1,00256,India
799121,2023-09-17,1004,Eyeliner,100,200,100,1,00256,India
799121,2023-09-17,1007,Eyeshadow,200,400,200,1,00256,India
736638,2023-09-17,1003,Foundation,300,600,300,1,00331,India
773661,2023-09-17,1012,Body Lotion,200,400,200,1,00249,India
773661,2023-09-17,1003,Foundation,300,600,300,1,00249,India
773661,2023-09-17,1001,Lipstick,150,300,150,1,00249,India
773661,2023-09-17,1005,Nail Polish,50,100,50,1,00249,India
261826,2023-09-17,1006,Blush,150,300,150,1,00089,India
261826,2023-09-17,1008,Makeup Remover,80,160,80,1,00089,India
261826,2023-09-17,1004,Eyeliner,100,200,100,1,00089,India
769230,2023-09-17,1001,Lipstick,150,300,150,1,00064,India
769230,2023-09-17,1005,Nail Polish,50,100,50,1,00064,India
776359,2023-09-17,1001,Lipstick,150,300,150,1,00382,India
776359,2023-09-17,1002,Mascara,200,400,200,1,00382,India
410789,2023-09-17,1003,Foundation,300,600,300,1,00434,India
603981,2023-09-17,1004,Eyeliner,100,200,100,1,00126,India
603981,2023-09-17,1012,Body Lotion,200,400,200,1,00126,India
869644,2023-09-17,1007,Eyeshadow,200,400,200,1,00282,India
869644,2023-09-17,1012,Body Lotion,200,400,200,1,00282,India
869644,2023-09-17,1006,Blush,150,300,150,1,00282,India
869644,2023-09-17,1002,Mascara,200,400,200,1,00282,India
109613,2023-09-17,1005,Nail Polish,50,100,50,1,00065,India
109613,2023-09-17,1012,Body Lotion,200,400,200,1,00065,India
109613,2023-09-17,1004,Eyeliner,100,200,100,1,00065,India
109613,2023-09-17,1003,Foundation,300,600,300,1,00065,India
479331,2023-09-17,1007,Eyeshadow,200,400,200,1,00446,India
479331,2023-09-17,1001,Lipstick,150,300,150,1,00446,India
479331,2023-09-17,1012,Body Lotion,200,400,200,1,00446,India
427936,2023-09-17,1009,Moisturizer,250,500,250,1,00062,India
427936,2023-09-17,1004,Eyeliner,100,200,100,1,00062,India
754334,2023-09-17,1005,Nail Polish,50,100,50,1,00409,India
754334,2023-09-17,1001,Lipstick,150,300,150,1,00409,India
754334,2023-09-17,1009,Moisturizer,250,500,250,1,00409,India
754334,2023-09-17,1008,Makeup Remover,80,160,80,1,00409,India
211734,2023-09-17,1007,Eyeshadow,200,400,200,1,00038,India
211734,2023-09-17,1002,Mascara,200,400,200,1,00038,India
398459,2023-09-17,1002,Mascara,200,400,200,1,00348,India
398459,2023-09-17,1001,Lipstick,150,300,150,1,00348,India
398459,2023-09-17,1009,Moisturizer,250,500,250,1,00348,India
398459,2023-09-17,1007,Eyeshadow,200,400,200,1,00348,India
941481,2023-09-17,1007,Eyeshadow,200,400,200,1,00362,India
941481,2023-09-17,1005,Nail Polish,50,100,50,1,00362,India
949924,2023-09-17,1002,Mascara,200,400,200,1,00144,India
520332,2023-09-17,1001,Lipstick,150,300,150,1,00029,India
520332,2023-09-17,1002,Mascara,200,400,200,1,00029,India
836553,2023-09-17,1004,Eyeliner,100,200,100,1,00089,India
836553,2023-09-17,1006,Blush,150,300,150,1,00089,India
836553,2023-09-17,1007,Eyeshadow,200,400,200,1,00089,India
836553,2023-09-17,1001,Lipstick,150,300,150,1,00089,India
403634,2023-09-17,1004,Eyeliner,100,200,100,1,00252,India
403634,2023-09-17,1002,Mascara,200,400,200,1,00252,India
403634,2023-09-17,1003,Foundation,300,600,300,1,00252,India
404770,2023-09-17,1009,Moisturizer,250,500,250,1,00056,India
404770,2023-09-17,1007,Eyeshadow,200,400,200,1,00056,India
105520,2023-09-17,1008,Makeup Remover,80,160,80,1,00238,India
105520,2023-09-17,1007,Eyeshadow,200,400,200,1,00238,India
640348,2023-09-17,1012,Body Lotion,200,400,200,1,00417,India
636832,2023-09-17,1003,Foundation,300,600,300,1,00291,India
636832,2023-09-17,1009,Moisturizer,250,500,250,1,00291,India
636832,2023-09-17,1006,Blush,150,300,150,1,00291,India
636832,2023-09-17,1007,Eyeshadow,200,400,200,1,00291,India
636832,2023-09-17,1004,Eyeliner,100,200,100,1,00291,India
233604,2023-09-17,1002,Mascara,200,400,200,1,00200,India
233604,2023-09-17,1007,Eyeshadow,200,400,200,1,00200,India
686877,2023-09-17,1009,Moisturizer,250,500,250,1,00125,India
974635,2023-09-17,1005,Nail Polish,50,100,50,1,00144,India
974635,2023-09-17,1003,Foundation,300,600,300,1,00144,India
974635,2023-09-17,1002,Mascara,200,400,200,1,00144,India
581044,2023-09-17,1004,Eyeliner,100,200,100,1,00193,India
628199,2023-09-17,1004,Eyeliner,100,200,100,1,00251,India
628199,2023-09-17,1006,Blush,150,300,150,1,00251,India
628199,2023-09-17,1002,Mascara,200,400,200,1,00251,India
912244,2023-09-17,1005,Nail Polish,50,100,50,1,00032,India
912244,2023-09-17,1004,Eyeliner,100,200,100,1,00032,India
912244,2023-09-17,1001,Lipstick,150,300,150,1,00032,India
245349,2023-09-17,1003,Foundation,300,600,300,1,00459,India
245349,2023-09-17,1012,Body Lotion,200,400,200,1,00459,India
245349,2023-09-17,1007,Eyeshadow,200,400,200,1,00459,India
245349,2023-09-17,1006,Blush,150,300,150,1,00459,India
991493,2023-09-17,1007,Eyeshadow,200,400,200,1,00098,India
991493,2023-09-17,1003,Foundation,300,600,300,1,00098,India
991493,2023-09-17,1009,Moisturizer,250,500,250,1,00098,India
991493,2023-09-17,1012,Body Lotion,200,400,200,1,00098,India
202236,2023-09-17,1003,Foundation,300,600,300,1,00342,India
202236,2023-09-17,1009,Moisturizer,250,500,250,1,00342,India
202236,2023-09-17,1002,Mascara,200,400,200,1,00342,India
903933,2023-09-17,1012,Body Lotion,200,400,200,1,00366,India
903933,2023-09-17,1001,Lipstick,150,300,150,1,00366,India
481964,2023-09-17,1009,Moisturizer,250,500,250,1,00341,India
481964,2023-09-17,1008,Makeup Remover,80,160,80,1,00341,India
296694,2023-09-17,1001,Lipstick,150,300,150,1,00418,India
947692,2023-09-17,1007,Eyeshadow,200,400,200,1,00220,India
947692,2023-09-17,1002,Mascara,200,400,200,1,00220,India
115086,2023-09-17,1006,Blush,150,300,150,1,00180,India
115086,2023-09-17,1012,Body Lotion,200,400,200,1,00180,India
115086,2023-09-17,1003,Foundation,300,600,300,1,00180,India
253209,2023-09-18,1012,Body Lotion,200,400,200,1,00153,India
959685,2023-09-18,1008,Makeup Remover,80,160,80,1,00277,India
959685,2023-09-18,1012,Body Lotion,200,400,200,1,00277,India
959685,2023-09-18,1002,Mascara,200,400,200,1,00277,India
934258,2023-09-18,1005,Nail Polish,50,100,50,1,00216,India
934258,2023-09-18,1003,Foundation,300,600,300,1,00216,India
934258,2023-09-18,1012,Body Lotion,200,400,200,1,00216,India
934258,2023-09-18,1006,Blush,150,300,150,1,00216,India
379850,2023-09-18,1006,Blush,150,300,150,1,00495,India
379850,2023-09-18,1005,Nail Polish,50,100,50,1,00495,India
634033,2023-09-18,1005,Nail Polish,50,100,50,1,00004,India
634033,2023-09-18,1012,Body Lotion,200,400,200,1,00004,India
634033,2023-09-18,1001,Lipstick,150,300,150,1,00004,India
634033,2023-09-18,1002,Mascara,200,400,200,1,00004,India
994772,2023-09-18,1009,Moisturizer,250,500,250,1,00179,India
994772,2023-09-18,1001,Lipstick,150,300,150,1,00179,India
994772,2023-09-18,1006,Blush,150,300,150,1,00179,India
543226,2023-09-18,1001,Lipstick,150,300,150,1,00396,India
543226,2023-09-18,1005,Nail Polish,50,100,50,1,00396,India
543226,2023-09-18,1009,Moisturizer,250,500,250,1,00396,India
543226,2023-09-18,1008,Makeup Remover,80,160,80,1,00396,India
288626,2023-09-18,1001,Lipstick,150,300,150,1,00065,India
288626,2023-09-18,1003,Foundation,300,600,300,1,00065,India
288626,2023-09-18,1009,Moisturizer,250,500,250,1,00065,India
288626,2023-09-18,1005,Nail Polish,50,100,50,1,00065,India
516449,2023-09-18,1009,Moisturizer,250,500,250,1,00459,India
516449,2023-09-18,1006,Blush,150,300,150,1,00459,India
522436,2023-09-18,1006,Blush,150,300,150,1,00382,India
522436,2023-09-18,1007,Eyeshadow,200,400,200,1,00382,India
522436,2023-09-18,1009,Moisturizer,250,500,250,1,00382,India
332765,2023-09-18,1004,Eyeliner,100,200,100,1,00278,India
332765,2023-09-18,1008,Makeup Remover,80,160,80,1,00278,India
332765,2023-09-18,1003,Foundation,300,600,300,1,00278,India
332765,2023-09-18,1006,Blush,150,300,150,1,00278,India
332765,2023-09-18,1002,Mascara,200,400,200,1,00278,India
837815,2023-09-18,1012,Body Lotion,200,400,200,1,00447,India
527625,2023-09-18,1006,Blush,150,300,150,1,00472,India
860809,2023-09-18,1006,Blush,150,300,150,1,00017,India
178636,2023-09-18,1009,Moisturizer,250,500,250,1,00218,India
178636,2023-09-18,1005,Nail Polish,50,100,50,1,00218,India
830034,2023-09-18,1002,Mascara,200,400,200,1,00175,India
830034,2023-09-18,1012,Body Lotion,200,400,200,1,00175,India
830034,2023-09-18,1001,Lipstick,150,300,150,1,00175,India
912787,2023-09-18,1008,Makeup Remover,80,160,80,1,00392,India
912787,2023-09-18,1004,Eyeliner,100,200,100,1,00392,India
708737,2023-09-18,1012,Body Lotion,200,400,200,1,00303,India
708737,2023-09-18,1002,Mascara,200,400,200,1,00303,India
708737,2023-09-18,1003,Foundation,300,600,300,1,00303,India
708737,2023-09-18,1007,Eyeshadow,200,400,200,1,00303,India
301219,2023-09-18,1012,Body Lotion,200,400,200,1,00201,India
301219,2023-09-18,1004,Eyeliner,100,200,100,1,00201,India
301219,2023-09-18,1001,Lipstick,150,300,150,1,00201,India
301219,2023-09-18,1003,Foundation,300,600,300,1,00201,India
301219,2023-09-18,1009,Moisturizer,250,500,250,1,00201,India
706159,2023-09-18,1012,Body Lotion,200,400,200,1,00451,India
706159,2023-09-18,1002,Mascara,200,400,200,1,00451,India
706159,2023-09-18,1009,Moisturizer,250,500,250,1,00451,India
706159,2023-09-18,1008,Makeup Remover,80,160,80,1,00451,India
206580,2023-09-18,1008,Makeup Remover,80,160,80,1,00371,India
206580,2023-09-18,1006,Blush,150,300,150,1,00371,India
206580,2023-09-18,1001,Lipstick,150,300,150,1,00371,India
884537,2023-09-18,1012,Body Lotion,200,400,200,1,00322,India
884537,2023-09-18,1009,Moisturizer,250,500,250,1,00322,India
884537,2023-09-18,1001,Lipstick,150,300,150,1,00322,India
788583,2023-09-18,1002,Mascara,200,400,200,1,00163,India
788583,2023-09-18,1001,Lipstick,150,300,150,1,00163,India
788583,2023-09-18,1007,Eyeshadow,200,400,200,1,00163,India
788583,2023-09-18,1004,Eyeliner,100,200,100,1,00163,India
202417,2023-09-18,1007,Eyeshadow,200,400,200,1,00358,India
917690,2023-09-18,1004,Eyeliner,100,200,100,1,00042,India
917690,2023-09-18,1002,Mascara,200,400,200,1,00042,India
917690,2023-09-18,1003,Foundation,300,600,300,1,00042,India
764462,2023-09-18,1003,Foundation,300,600,300,1,00182,India
764462,2023-09-18,1005,Nail Polish,50,100,50,1,00182,India
310401,2023-09-18,1008,Makeup Remover,80,160,80,1,00253,India
310401,2023-09-18,1001,Lipstick,150,300,150,1,00253,India
889121,2023-09-18,1005,Nail Polish,50,100,50,1,00247,India
889121,2023-09-18,1003,Foundation,300,600,300,1,00247,India
753749,2023-09-18,1006,Blush,150,300,150,1,00372,India
753749,2023-09-18,1012,Body Lotion,200,400,200,1,00372,India
138601,2023-09-18,1003,Foundation,300,600,300,1,00192,India
138601,2023-09-18,1004,Eyeliner,100,200,100,1,00192,India
138601,2023-09-18,1009,Moisturizer,250,500,250,1,00192,India
138601,2023-09-18,1006,Blush,150,300,150,1,00192,India
545527,2023-09-18,1009,Moisturizer,250,500,250,1,00041,India
545527,2023-09-18,1003,Foundation,300,600,300,1,00041,India
545527,2023-09-18,1006,Blush,150,300,150,1,00041,India
978556,2023-09-18,1003,Foundation,300,600,300,1,00029,India
978556,2023-09-18,1004,Eyeliner,100,200,100,1,00029,India
978556,2023-09-18,1001,Lipstick,150,300,150,1,00029,India
978556,2023-09-18,1005,Nail Polish,50,100,50,1,00029,India
558503,2023-09-18,1008,Makeup Remover,80,160,80,1,00101,India
558503,2023-09-18,1012,Body Lotion,200,400,200,1,00101,India
446821,2023-09-18,1005,Nail Polish,50,100,50,1,00305,India
446821,2023-09-18,1008,Makeup Remover,80,160,80,1,00305,India
612690,2023-09-18,1012,Body Lotion,200,400,200,1,00184,India
996526,2023-09-18,1008,Makeup Remover,80,160,80,1,00261,India
996526,2023-09-18,1006,Blush,150,300,150,1,00261,India
996526,2023-09-18,1009,Moisturizer,250,500,250,1,00261,India
362473,2023-09-18,1007,Eyeshadow,200,400,200,1,00279,India
137568,2023-09-18,1002,Mascara,200,400,200,1,00091,India
554979,2023-09-18,1002,Mascara,200,400,200,1,00081,India
554979,2023-09-18,1001,Lipstick,150,300,150,1,00081,India
590339,2023-09-18,1002,Mascara,200,400,200,1,00323,India
590339,2023-09-18,1012,Body Lotion,200,400,200,1,00323,India
412595,2023-09-18,1008,Makeup Remover,80,160,80,1,00196,India
849616,2023-09-18,1002,Mascara,200,400,200,1,00355,India
849616,2023-09-18,1004,Eyeliner,100,200,100,1,00355,India
849616,2023-09-18,1006,Blush,150,300,150,1,00355,India
963198,2023-09-18,1003,Foundation,300,600,300,1,00468,India
963198,2023-09-18,1007,Eyeshadow,200,400,200,1,00468,India
865556,2023-09-19,1001,Lipstick,150,300,150,1,00073,India
865556,2023-09-19,1002,Mascara,200,400,200,1,00073,India
865556,2023-09-19,1003,Foundation,300,600,300,1,00073,India
865556,2023-09-19,1007,Eyeshadow,200,400,200,1,00073,India
893214,2023-09-19,1002,Mascara,200,400,200,1,00406,India
893214,2023-09-19,1012,Body Lotion,200,400,200,1,00406,India
543605,2023-09-19,1008,Makeup Remover,80,160,80,1,00446,India
147059,2023-09-19,1008,Makeup Remover,80,160,80,1,00371,India
147059,2023-09-19,1007,Eyeshadow,200,400,200,1,00371,India
147059,2023-09-19,1012,Body Lotion,200,400,200,1,00371,India
147059,2023-09-19,1006,Blush,150,300,150,1,00371,India
147059,2023-09-19,1002,Mascara,200,400,200,1,00371,India
804123,2023-09-19,1003,Foundation,300,600,300,1,00256,India
804123,2023-09-19,1007,Eyeshadow,200,400,200,1,00256,India
804123,2023-09-19,1004,Eyeliner,100,200,100,1,00256,India
804123,2023-09-19,1012,Body Lotion,200,400,200,1,00256,India
380315,2023-09-19,1004,Eyeliner,100,200,100,1,00305,India
380315,2023-09-19,1003,Foundation,300,600,300,1,00305,India
597687,2023-09-19,1005,Nail Polish,50,100,50,1,00192,India
597687,2023-09-19,1006,Blush,150,300,150,1,00192,India
597687,2023-09-19,1012,Body Lotion,200,400,200,1,00192,India
738162,2023-09-19,1001,Lipstick,150,300,150,1,00095,India
316222,2023-09-19,1012,Body Lotion,200,400,200,1,00184,India
316222,2023-09-19,1007,Eyeshadow,200,400,200,1,00184,India
316222,2023-09-19,1003,Foundation,300,600,300,1,00184,India
142683,2023-09-19,1001,Lipstick,150,300,150,1,00076,India
142683,2023-09-19,1003,Foundation,300,600,300,1,00076,India
142683,2023-09-19,1006,Blush,150,300,150,1,00076,India
142683,2023-09-19,1005,Nail Polish,50,100,50,1,00076,India
142683,2023-09-19,1002,Mascara,200,400,200,1,00076,India
100826,2023-09-19,1004,Eyeliner,100,200,100,1,00126,India
100826,2023-09-19,1008,Makeup Remover,80,160,80,1,00126,India
100826,2023-09-19,1009,Moisturizer,250,500,250,1,00126,India
460335,2023-09-19,1007,Eyeshadow,200,400,200,1,00405,India
460335,2023-09-19,1008,Makeup Remover,80,160,80,1,00405,India
296740,2023-09-19,1005,Nail Polish,50,100,50,1,00143,India
422587,2023-09-19,1007,Eyeshadow,200,400,200,1,00140,India
422587,2023-09-19,1006,Blush,150,300,150,1,00140,India
422587,2023-09-19,1009,Moisturizer,250,500,250,1,00140,India
799364,2023-09-19,1007,Eyeshadow,200,400,200,1,00389,India
799364,2023-09-19,1004,Eyeliner,100,200,100,1,00389,India
799364,2023-09-19,1001,Lipstick,150,300,150,1,00389,India
828398,2023-09-19,1008,Makeup Remover,80,160,80,1,00412,India
828398,2023-09-19,1001,Lipstick,150,300,150,1,00412,India
828398,2023-09-19,1012,Body Lotion,200,400,200,1,00412,India
256529,2023-09-19,1008,Makeup Remover,80,160,80,1,00075,India
256529,2023-09-19,1002,Mascara,200,400,200,1,00075,India
256529,2023-09-19,1012,Body Lotion,200,400,200,1,00075,India
357110,2023-09-19,1007,Eyeshadow,200,400,200,1,00163,India
357110,2023-09-19,1008,Makeup Remover,80,160,80,1,00163,India
357110,2023-09-19,1006,Blush,150,300,150,1,00163,India
357110,2023-09-19,1004,Eyeliner,100,200,100,1,00163,India
266585,2023-09-19,1012,Body Lotion,200,400,200,1,00117,India
266585,2023-09-19,1006,Blush,150,300,150,1,00117,India
323043,2023-09-19,1004,Eyeliner,100,200,100,1,00290,India
323043,2023-09-19,1012,Body Lotion,200,400,200,1,00290,India
323043,2023-09-19,1001,Lipstick,150,300,150,1,00290,India
342994,2023-09-19,1012,Body Lotion,200,400,200,1,00282,India
342994,2023-09-19,1004,Eyeliner,100,200,100,1,00282,India
342994,2023-09-19,1002,Mascara,200,400,200,1,00282,India
342994,2023-09-19,1006,Blush,150,300,150,1,00282,India
414013,2023-09-19,1007,Eyeshadow,200,400,200,1,00205,India
414013,2023-09-19,1003,Foundation,300,600,300,1,00205,India
525852,2023-09-19,1008,Makeup Remover,80,160,80,1,00190,India
525852,2023-09-19,1006,Blush,150,300,150,1,00190,India
525852,2023-09-19,1001,Lipstick,150,300,150,1,00190,India
525852,2023-09-19,1003,Foundation,300,600,300,1,00190,India
525852,2023-09-19,1012,Body Lotion,200,400,200,1,00190,India
323311,2023-09-19,1001,Lipstick,150,300,150,1,00358,India
343305,2023-09-19,1005,Nail Polish,50,100,50,1,00385,India
302972,2023-09-19,1006,Blush,150,300,150,1,00335,India
302972,2023-09-19,1008,Makeup Remover,80,160,80,1,00335,India
583697,2023-09-19,1004,Eyeliner,100,200,100,1,00258,India
497806,2023-09-19,1008,Makeup Remover,80,160,80,1,00328,India
497806,2023-09-19,1001,Lipstick,150,300,150,1,00328,India
497806,2023-09-19,1005,Nail Polish,50,100,50,1,00328,India
754338,2023-09-19,1009,Moisturizer,250,500,250,1,00173,India
754338,2023-09-19,1005,Nail Polish,50,100,50,1,00173,India
754338,2023-09-19,1012,Body Lotion,200,400,200,1,00173,India
491862,2023-09-19,1012,Body Lotion,200,400,200,1,00312,India
491862,2023-09-19,1007,Eyeshadow,200,400,200,1,00312,India
491862,2023-09-19,1006,Blush,150,300,150,1,00312,India
491862,2023-09-19,1003,Foundation,300,600,300,1,00312,India
409369,2023-09-19,1006,Blush,150,300,150,1,00302,India
409369,2023-09-19,1008,Makeup Remover,80,160,80,1,00302,India
409369,2023-09-19,1012,Body Lotion,200,400,200,1,00302,India
963104,2023-09-19,1004,Eyeliner,100,200,100,1,00011,India
202465,2023-09-19,1005,Nail Polish,50,100,50,1,00034,India
202465,2023-09-19,1004,Eyeliner,100,200,100,1,00034,India
815943,2023-09-19,1009,Moisturizer,250,500,250,1,00142,India
815943,2023-09-19,1002,Mascara,200,400,200,1,00142,India
815943,2023-09-19,1005,Nail Polish,50,100,50,1,00142,India
755693,2023-09-19,1009,Moisturizer,250,500,250,1,00199,India
755693,2023-09-19,1002,Mascara,200,400,200,1,00199,India
755693,2023-09-19,1005,Nail Polish,50,100,50,1,00199,India
755693,2023-09-19,1006,Blush,150,300,150,1,00199,India
413632,2023-09-19,1012,Body Lotion,200,400,200,1,00121,India
413632,2023-09-19,1002,Mascara,200,400,200,1,00121,India
413632,2023-09-19,1003,Foundation,300,600,300,1,00121,India
296973,2023-09-19,1007,Eyeshadow,200,400,200,1,00398,India
296973,2023-09-19,1002,Mascara,200,400,200,1,00398,India
296973,2023-09-19,1009,Moisturizer,250,500,250,1,00398,India
296973,2023-09-19,1008,Makeup Remover,80,160,80,1,00398,India
502320,2023-09-19,1002,Mascara,200,400,200,1,00251,India
502320,2023-09-19,1005,Nail Polish,50,100,50,1,00251,India
959117,2023-09-19,1012,Body Lotion,200,400,200,1,00402,India
959117,2023-09-19,1004,Eyeliner,100,200,100,1,00402,India
959117,2023-09-19,1002,Mascara,200,400,200,1,00402,India
944345,2023-09-19,1007,Eyeshadow,200,400,200,1,00223,India
290914,2023-09-20,1004,Eyeliner,100,200,100,1,00126,India
290914,2023-09-20,1001,Lipstick,150,300,150,1,00126,India
290914,2023-09-20,1005,Nail Polish,50,100,50,1,00126,India
360409,2023-09-20,1012,Body Lotion,200,400,200,1,00183,India
338447,2023-09-20,1004,Eyeliner,100,200,100,1,00429,India
338447,2023-09-20,1007,Eyeshadow,200,400,200,1,00429,India
942868,2023-09-20,1005,Nail Polish,50,100,50,1,00241,India
942868,2023-09-20,1001,Lipstick,150,300,150,1,00241,India
539141,2023-09-20,1009,Moisturizer,250,500,250,1,00343,India
539141,2023-09-20,1004,Eyeliner,100,200,100,1,00343,India
539141,2023-09-20,1003,Foundation,300,600,300,1,00343,India
297852,2023-09-20,1012,Body Lotion,200,400,200,1,00056,India
177273,2023-09-20,1006,Blush,150,300,150,1,00400,India
177273,2023-09-20,1005,Nail Polish,50,100,50,1,00400,India
177273,2023-09-20,1007,Eyeshadow,200,400,200,1,00400,India
177273,2023-09-20,1001,Lipstick,150,300,150,1,00400,India
818953,2023-09-20,1003,Foundation,300,600,300,1,00301,India
818953,2023-09-20,1012,Body Lotion,200,400,200,1,00301,India
818953,2023-09-20,1008,Makeup Remover,80,160,80,1,00301,India
818953,2023-09-20,1001,Lipstick,150,300,150,1,00301,India
996886,2023-09-20,1002,Mascara,200,400,200,1,00246,India
996886,2023-09-20,1005,Nail Polish,50,100,50,1,00246,India
996886,2023-09-20,1008,Makeup Remover,80,160,80,1,00246,India
996886,2023-09-20,1004,Eyeliner,100,200,100,1,00246,India
320863,2023-09-20,1003,Foundation,300,600,300,1,00471,India
320863,2023-09-20,1005,Nail Polish,50,100,50,1,00471,India
320863,2023-09-20,1001,Lipstick,150,300,150,1,00471,India
375801,2023-09-20,1012,Body Lotion,200,400,200,1,00034,India
867236,2023-09-20,1009,Moisturizer,250,500,250,1,00313,India
867236,2023-09-20,1004,Eyeliner,100,200,100,1,00313,India
867236,2023-09-20,1001,Lipstick,150,300,150,1,00313,India
261133,2023-09-20,1007,Eyeshadow,200,400,200,1,00065,India
261133,2023-09-20,1002,Mascara,200,400,200,1,00065,India
261133,2023-09-20,1004,Eyeliner,100,200,100,1,00065,India
566777,2023-09-20,1009,Moisturizer,250,500,250,1,00052,India
566777,2023-09-20,1006,Blush,150,300,150,1,00052,India
566777,2023-09-20,1012,Body Lotion,200,400,200,1,00052,India
372136,2023-09-20,1009,Moisturizer,250,500,250,1,00084,India
372136,2023-09-20,1002,Mascara,200,400,200,1,00084,India
372136,2023-09-20,1012,Body Lotion,200,400,200,1,00084,India
595797,2023-09-20,1004,Eyeliner,100,200,100,1,00289,India
742017,2023-09-20,1009,Moisturizer,250,500,250,1,00345,India
742017,2023-09-20,1008,Makeup Remover,80,160,80,1,00345,India
742017,2023-09-20,1002,Mascara,200,400,200,1,00345,India
742017,2023-09-20,1003,Foundation,300,600,300,1,00345,India
956407,2023-09-20,1012,Body Lotion,200,400,200,1,00325,India
956407,2023-09-20,1008,Makeup Remover,80,160,80,1,00325,India
956407,2023-09-20,1007,Eyeshadow,200,400,200,1,00325,India
956407,2023-09-20,1002,Mascara,200,400,200,1,00325,India
230798,2023-09-20,1005,Nail Polish,50,100,50,1,00151,India
230798,2023-09-20,1012,Body Lotion,200,400,200,1,00151,India
804668,2023-09-20,1012,Body Lotion,200,400,200,1,00028,India
804668,2023-09-20,1007,Eyeshadow,200,400,200,1,00028,India
804668,2023-09-20,1005,Nail Polish,50,100,50,1,00028,India
804668,2023-09-20,1003,Foundation,300,600,300,1,00028,India
231153,2023-09-20,1006,Blush,150,300,150,1,00267,India
255947,2023-09-20,1001,Lipstick,150,300,150,1,00365,India
255947,2023-09-20,1007,Eyeshadow,200,400,200,1,00365,India
676605,2023-09-20,1008,Makeup Remover,80,160,80,1,00188,India
676605,2023-09-20,1004,Eyeliner,100,200,100,1,00188,India
676605,2023-09-20,1005,Nail Polish,50,100,50,1,00188,India
676605,2023-09-20,1006,Blush,150,300,150,1,00188,India
778709,2023-09-20,1003,Foundation,300,600,300,1,00490,India
778709,2023-09-20,1007,Eyeshadow,200,400,200,1,00490,India
778709,2023-09-20,1004,Eyeliner,100,200,100,1,00490,India
141821,2023-09-20,1009,Moisturizer,250,500,250,1,00364,India
728852,2023-09-20,1007,Eyeshadow,200,400,200,1,00376,India
728852,2023-09-20,1008,Makeup Remover,80,160,80,1,00376,India
455016,2023-09-20,1006,Blush,150,300,150,1,00053,India
455016,2023-09-20,1012,Body Lotion,200,400,200,1,00053,India
455016,2023-09-20,1005,Nail Polish,50,100,50,1,00053,India
549033,2023-09-20,1008,Makeup Remover,80,160,80,1,00181,India
705390,2023-09-20,1003,Foundation,300,600,300,1,00437,India
705390,2023-09-20,1002,Mascara,200,400,200,1,00437,India
552967,2023-09-20,1007,Eyeshadow,200,400,200,1,00260,India
506997,2023-09-20,1008,Makeup Remover,80,160,80,1,00171,India
506997,2023-09-20,1009,Moisturizer,250,500,250,1,00171,India
506997,2023-09-20,1007,Eyeshadow,200,400,200,1,00171,India
318980,2023-09-20,1001,Lipstick,150,300,150,1,00478,India
318980,2023-09-20,1012,Body Lotion,200,400,200,1,00478,India
318980,2023-09-20,1009,Moisturizer,250,500,250,1,00478,India
360445,2023-09-21,1007,Eyeshadow,200,400,200,1,00233,India
360445,2023-09-21,1003,Foundation,300,600,300,1,00233,India
628161,2023-09-21,1005,Nail Polish,50,100,50,1,00146,India
628161,2023-09-21,1001,Lipstick,150,300,150,1,00146,India
628161,2023-09-21,1007,Eyeshadow,200,400,200,1,00146,India
747999,2023-09-21,1003,Foundation,300,600,300,1,00349,India
747999,2023-09-21,1004,Eyeliner,100,200,100,1,00349,India
747999,2023-09-21,1009,Moisturizer,250,500,250,1,00349,India
620301,2023-09-21,1001,Lipstick,150,300,150,1,00300,India
132323,2023-09-21,1008,Makeup Remover,80,160,80,1,00054,India
132323,2023-09-21,1002,Mascara,200,400,200,1,00054,India
132323,2023-09-21,1009,Moisturizer,250,500,250,1,00054,India
132323,2023-09-21,1004,Eyeliner,100,200,100,1,00054,India
511849,2023-09-21,1003,Foundation,300,600,300,1,00210,India
511849,2023-09-21,1008,Makeup Remover,80,160,80,1,00210,India
511849,2023-09-21,1005,Nail Polish,50,100,50,1,00210,India
511849,2023-09-21,1004,Eyeliner,100,200,100,1,00210,India
937470,2023-09-21,1005,Nail Polish,50,100,50,1,00099,India
937470,2023-09-21,1006,Blush,150,300,150,1,00099,India
937470,2023-09-21,1012,Body Lotion,200,400,200,1,00099,India
937470,2023-09-21,1009,Moisturizer,250,500,250,1,00099,India
937470,2023-09-21,1007,Eyeshadow,200,400,200,1,00099,India
256452,2023-09-21,1005,Nail Polish,50,100,50,1,00487,India
557998,2023-09-21,1009,Moisturizer,250,500,250,1,00188,India
567243,2023-09-21,1012,Body Lotion,200,400,200,1,00296,India
735125,2023-09-21,1002,Mascara,200,400,200,1,00271,India
735125,2023-09-21,1009,Moisturizer,250,500,250,1,00271,India
853281,2023-09-21,1006,Blush,150,300,150,1,00350,India
853281,2023-09-21,1008,Makeup Remover,80,160,80,1,00350,India
494204,2023-09-21,1004,Eyeliner,100,200,100,1,00050,India
667458,2023-09-21,1001,Lipstick,150,300,150,1,00368,India
667458,2023-09-21,1007,Eyeshadow,200,400,200,1,00368,India
667458,2023-09-21,1012,Body Lotion,200,400,200,1,00368,India
526060,2023-09-21,1001,Lipstick,150,300,150,1,00066,India
526060,2023-09-21,1007,Eyeshadow,200,400,200,1,00066,India
893563,2023-09-21,1007,Eyeshadow,200,400,200,1,00234,India
893563,2023-09-21,1006,Blush,150,300,150,1,00234,India
893563,2023-09-21,1003,Foundation,300,600,300,1,00234,India
893563,2023-09-21,1004,Eyeliner,100,200,100,1,00234,India
518115,2023-09-21,1009,Moisturizer,250,500,250,1,00392,India
518115,2023-09-21,1001,Lipstick,150,300,150,1,00392,India
518115,2023-09-21,1004,Eyeliner,100,200,100,1,00392,India
518115,2023-09-21,1002,Mascara,200,400,200,1,00392,India
999019,2023-09-21,1003,Foundation,300,600,300,1,00038,India
968983,2023-09-21,1012,Body Lotion,200,400,200,1,00436,India
968983,2023-09-21,1006,Blush,150,300,150,1,00436,India
968983,2023-09-21,1007,Eyeshadow,200,400,200,1,00436,India
571855,2023-09-21,1006,Blush,150,300,150,1,00039,India
619143,2023-09-21,1002,Mascara,200,400,200,1,00396,India
619143,2023-09-21,1006,Blush,150,300,150,1,00396,India
619143,2023-09-21,1003,Foundation,300,600,300,1,00396,India
110638,2023-09-21,1003,Foundation,300,600,300,1,00125,India
401184,2023-09-21,1008,Makeup Remover,80,160,80,1,00153,India
401184,2023-09-21,1006,Blush,150,300,150,1,00153,India
401184,2023-09-21,1009,Moisturizer,250,500,250,1,00153,India
233414,2023-09-21,1003,Foundation,300,600,300,1,00375,India
233414,2023-09-21,1005,Nail Polish,50,100,50,1,00375,India
233414,2023-09-21,1008,Makeup Remover,80,160,80,1,00375,India
233414,2023-09-21,1004,Eyeliner,100,200,100,1,00375,India
976198,2023-09-21,1006,Blush,150,300,150,1,00438,India
976198,2023-09-21,1009,Moisturizer,250,500,250,1,00438,India
976198,2023-09-21,1001,Lipstick,150,300,150,1,00438,India
503583,2023-09-21,1008,Makeup Remover,80,160,80,1,00344,India
503583,2023-09-21,1004,Eyeliner,100,200,100,1,00344,India
503583,2023-09-21,1012,Body Lotion,200,400,200,1,00344,India
864683,2023-09-21,1001,Lipstick,150,300,150,1,00459,India
864683,2023-09-21,1005,Nail Polish,50,100,50,1,00459,India
864683,2023-09-21,1012,Body Lotion,200,400,200,1,00459,India
639942,2023-09-21,1002,Mascara,200,400,200,1,00314,India
639942,2023-09-21,1008,Makeup Remover,80,160,80,1,00314,India
639942,2023-09-21,1012,Body Lotion,200,400,200,1,00314,India
692225,2023-09-21,1002,Mascara,200,400,200,1,00188,India
692225,2023-09-21,1005,Nail Polish,50,100,50,1,00188,India
165944,2023-09-21,1008,Makeup Remover,80,160,80,1,00050,India
165944,2023-09-21,1006,Blush,150,300,150,1,00050,India
837902,2023-09-21,1008,Makeup Remover,80,160,80,1,00387,India
837902,2023-09-21,1003,Foundation,300,600,300,1,00387,India
837902,2023-09-21,1004,Eyeliner,100,200,100,1,00387,India
714980,2023-09-21,1007,Eyeshadow,200,400,200,1,00254,India
714980,2023-09-21,1003,Foundation,300,600,300,1,00254,India
404522,2023-09-21,1001,Lipstick,150,300,150,1,00429,India
404522,2023-09-21,1005,Nail Polish,50,100,50,1,00429,India
435515,2023-09-21,1006,Blush,150,300,150,1,00438,India
435515,2023-09-21,1009,Moisturizer,250,500,250,1,00438,India
363352,2023-09-21,1012,Body Lotion,200,400,200,1,00360,India
363352,2023-09-21,1002,Mascara,200,400,200,1,00360,India
122754,2023-09-21,1003,Foundation,300,600,300,1,00493,India
122754,2023-09-21,1008,Makeup Remover,80,160,80,1,00493,India
122754,2023-09-21,1002,Mascara,200,400,200,1,00493,India
232655,2023-09-21,1005,Nail Polish,50,100,50,1,00445,India
232655,2023-09-21,1003,Foundation,300,600,300,1,00445,India
232655,2023-09-21,1006,Blush,150,300,150,1,00445,India
129712,2023-09-21,1002,Mascara,200,400,200,1,00230,India
129712,2023-09-21,1007,Eyeshadow,200,400,200,1,00230,India
129712,2023-09-21,1003,Foundation,300,600,300,1,00230,India
129712,2023-09-21,1008,Makeup Remover,80,160,80,1,00230,India
446393,2023-09-21,1008,Makeup Remover,80,160,80,1,00442,India
446393,2023-09-21,1004,Eyeliner,100,200,100,1,00442,India
446393,2023-09-21,1009,Moisturizer,250,500,250,1,00442,India
743369,2023-09-21,1009,Moisturizer,250,500,250,1,00023,India
743369,2023-09-21,1012,Body Lotion,200,400,200,1,00023,India
906086,2023-09-21,1001,Lipstick,150,300,150,1,00100,India
476056,2023-09-22,1005,Nail Polish,50,100,50,1,00284,India
476056,2023-09-22,1004,Eyeliner,100,200,100,1,00284,India
476056,2023-09-22,1006,Blush,150,300,150,1,00284,India
197502,2023-09-22,1007,Eyeshadow,200,400,200,1,00144,India
452683,2023-09-22,1001,Lipstick,150,300,150,1,00230,India
452683,2023-09-22,1007,Eyeshadow,200,400,200,1,00230,India
815391,2023-09-22,1006,Blush,150,300,150,1,00475,India
815391,2023-09-22,1008,Makeup Remover,80,160,80,1,00475,India
815391,2023-09-22,1005,Nail Polish,50,100,50,1,00475,India
815391,2023-09-22,1003,Foundation,300,600,300,1,00475,India
372824,2023-09-22,1001,Lipstick,150,300,150,1,00105,India
372824,2023-09-22,1008,Makeup Remover,80,160,80,1,00105,India
372824,2023-09-22,1002,Mascara,200,400,200,1,00105,India
372824,2023-09-22,1012,Body Lotion,200,400,200,1,00105,India
372824,2023-09-22,1005,Nail Polish,50,100,50,1,00105,India
912091,2023-09-22,1008,Makeup Remover,80,160,80,1,00048,India
912091,2023-09-22,1005,Nail Polish,50,100,50,1,00048,India
871605,2023-09-22,1001,Lipstick,150,300,150,1,00221,India
871605,2023-09-22,1007,Eyeshadow,200,400,200,1,00221,India
871605,2023-09-22,1004,Eyeliner,100,200,100,1,00221,India
173778,2023-09-22,1004,Eyeliner,100,200,100,1,00026,India
173778,2023-09-22,1003,Foundation,300,600,300,1,00026,India
173778,2023-09-22,1002,Mascara,200,400,200,1,00026,India
173778,2023-09-22,1006,Blush,150,300,150,1,00026,India
788416,2023-09-22,1001,Lipstick,150,300,150,1,00125,India
611431,2023-09-22,1003,Foundation,300,600,300,1,00482,India
611431,2023-09-22,1002,Mascara,200,400,200,1,00482,India
611431,2023-09-22,1001,Lipstick,150,300,150,1,00482,India
611431,2023-09-22,1009,Moisturizer,250,500,250,1,00482,India
611431,2023-09-22,1012,Body Lotion,200,400,200,1,00482,India
157542,2023-09-22,1009,Moisturizer,250,500,250,1,00364,India
713432,2023-09-22,1006,Blush,150,300,150,1,00257,India
587786,2023-09-22,1008,Makeup Remover,80,160,80,1,00414,India
587786,2023-09-22,1009,Moisturizer,250,500,250,1,00414,India
579814,2023-09-22,1003,Foundation,300,600,300,1,00425,India
579814,2023-09-22,1001,Lipstick,150,300,150,1,00425,India
945760,2023-09-22,1009,Moisturizer,250,500,250,1,00035,India
945760,2023-09-22,1008,Makeup Remover,80,160,80,1,00035,India
758091,2023-09-22,1009,Moisturizer,250,500,250,1,00102,India
544458,2023-09-22,1006,Blush,150,300,150,1,00174,India
544458,2023-09-22,1004,Eyeliner,100,200,100,1,00174,India
680367,2023-09-22,1002,Mascara,200,400,200,1,00201,India
680367,2023-09-22,1007,Eyeshadow,200,400,200,1,00201,India
680367,2023-09-22,1009,Moisturizer,250,500,250,1,00201,India
680367,2023-09-22,1004,Eyeliner,100,200,100,1,00201,India
680367,2023-09-22,1001,Lipstick,150,300,150,1,00201,India
215393,2023-09-22,1012,Body Lotion,200,400,200,1,00125,India
215393,2023-09-22,1002,Mascara,200,400,200,1,00125,India
215393,2023-09-22,1005,Nail Polish,50,100,50,1,00125,India
184683,2023-09-22,1004,Eyeliner,100,200,100,1,00432,India
184683,2023-09-22,1007,Eyeshadow,200,400,200,1,00432,India
184683,2023-09-22,1005,Nail Polish,50,100,50,1,00432,India
184683,2023-09-22,1002,Mascara,200,400,200,1,00432,India
254469,2023-09-22,1003,Foundation,300,600,300,1,00072,India
254469,2023-09-22,1006,Blush,150,300,150,1,00072,India
873111,2023-09-22,1012,Body Lotion,200,400,200,1,00097,India
873111,2023-09-22,1003,Foundation,300,600,300,1,00097,India
873111,2023-09-22,1004,Eyeliner,100,200,100,1,00097,India
643601,2023-09-22,1006,Blush,150,300,150,1,00153,India
961713,2023-09-22,1001,Lipstick,150,300,150,1,00420,India
961713,2023-09-22,1002,Mascara,200,400,200,1,00420,India
436053,2023-09-22,1003,Foundation,300,600,300,1,00153,India
436053,2023-09-22,1009,Moisturizer,250,500,250,1,00153,India
436053,2023-09-22,1007,Eyeshadow,200,400,200,1,00153,India
882313,2023-09-22,1007,Eyeshadow,200,400,200,1,00025,India
882313,2023-09-22,1012,Body Lotion,200,400,200,1,00025,India
882313,2023-09-22,1004,Eyeliner,100,200,100,1,00025,India
882313,2023-09-22,1003,Foundation,300,600,300,1,00025,India
730547,2023-09-22,1004,Eyeliner,100,200,100,1,00047,India
730547,2023-09-22,1009,Moisturizer,250,500,250,1,00047,India
730547,2023-09-22,1007,Eyeshadow,200,400,200,1,00047,India
288790,2023-09-22,1004,Eyeliner,100,200,100,1,00498,India
288790,2023-09-22,1007,Eyeshadow,200,400,200,1,00498,India
288790,2023-09-22,1003,Foundation,300,600,300,1,00498,India
965119,2023-09-22,1006,Blush,150,300,150,1,00056,India
352750,2023-09-22,1008,Makeup Remover,80,160,80,1,00002,India
352750,2023-09-22,1009,Moisturizer,250,500,250,1,00002,India
339230,2023-09-22,1012,Body Lotion,200,400,200,1,00352,India
278197,2023-09-22,1008,Makeup Remover,80,160,80,1,00487,India
278197,2023-09-22,1003,Foundation,300,600,300,1,00487,India
278197,2023-09-22,1004,Eyeliner,100,200,100,1,00487,India
278197,2023-09-22,1005,Nail Polish,50,100,50,1,00487,India
346061,2023-09-22,1009,Moisturizer,250,500,250,1,00442,India
643583,2023-09-22,1009,Moisturizer,250,500,250,1,00038,India
643583,2023-09-22,1003,Foundation,300,600,300,1,00038,India
643583,2023-09-22,1008,Makeup Remover,80,160,80,1,00038,India
714635,2023-09-22,1007,Eyeshadow,200,400,200,1,00014,India
567608,2023-09-23,1003,Foundation,300,600,300,1,00499,India
567608,2023-09-23,1005,Nail Polish,50,100,50,1,00499,India
567608,2023-09-23,1012,Body Lotion,200,400,200,1,00499,India
826087,2023-09-23,1007,Eyeshadow,200,400,200,1,00344,India
826087,2023-09-23,1006,Blush,150,300,150,1,00344,India
709741,2023-09-23,1008,Makeup Remover,80,160,80,1,00200,India
205346,2023-09-23,1005,Nail Polish,50,100,50,1,00254,India
205346,2023-09-23,1009,Moisturizer,250,500,250,1,00254,India
205346,2023-09-23,1008,Makeup Remover,80,160,80,1,00254,India
353698,2023-09-23,1009,Moisturizer,250,500,250,1,00315,India
121180,2023-09-23,1006,Blush,150,300,150,1,00048,India
661325,2023-09-23,1009,Moisturizer,250,500,250,1,00315,India
661325,2023-09-23,1012,Body Lotion,200,400,200,1,00315,India
874356,2023-09-23,1002,Mascara,200,400,200,1,00382,India
682442,2023-09-23,1009,Moisturizer,250,500,250,1,00443,India
682442,2023-09-23,1005,Nail Polish,50,100,50,1,00443,India
682442,2023-09-23,1001,Lipstick,150,300,150,1,00443,India
296981,2023-09-23,1007,Eyeshadow,200,400,200,1,00279,India
296981,2023-09-23,1001,Lipstick,150,300,150,1,00279,India
296981,2023-09-23,1003,Foundation,300,600,300,1,00279,India
296981,2023-09-23,1005,Nail Polish,50,100,50,1,00279,India
296981,2023-09-23,1002,Mascara,200,400,200,1,00279,India
955721,2023-09-23,1002,Mascara,200,400,200,1,00439,India
955721,2023-09-23,1007,Eyeshadow,200,400,200,1,00439,India
955721,2023-09-23,1006,Blush,150,300,150,1,00439,India
955721,2023-09-23,1012,Body Lotion,200,400,200,1,00439,India
350672,2023-09-23,1012,Body Lotion,200,400,200,1,00022,India
350672,2023-09-23,1001,Lipstick,150,300,150,1,00022,India
350672,2023-09-23,1009,Moisturizer,250,500,250,1,00022,India
350672,2023-09-23,1004,Eyeliner,100,200,100,1,00022,India
927081,2023-09-23,1004,Eyeliner,100,200,100,1,00287,India
297288,2023-09-23,1004,Eyeliner,100,200,100,1,00195,India
297288,2023-09-23,1005,Nail Polish,50,100,50,1,00195,India
763395,2023-09-23,1009,Moisturizer,250,500,250,1,00070,India
763395,2023-09-23,1012,Body Lotion,200,400,200,1,00070,India
120184,2023-09-23,1001,Lipstick,150,300,150,1,00259,India
120184,2023-09-23,1008,Makeup Remover,80,160,80,1,00259,India
120184,2023-09-23,1009,Moisturizer,250,500,250,1,00259,India
120184,2023-09-23,1002,Mascara,200,400,200,1,00259,India
734565,2023-09-23,1012,Body Lotion,200,400,200,1,00414,India
734565,2023-09-23,1004,Eyeliner,100,200,100,1,00414,India
734565,2023-09-23,1009,Moisturizer,250,500,250,1,00414,India
734565,2023-09-23,1008,Makeup Remover,80,160,80,1,00414,India
996604,2023-09-23,1005,Nail Polish,50,100,50,1,00349,India
996604,2023-09-23,1012,Body Lotion,200,400,200,1,00349,India
996604,2023-09-23,1003,Foundation,300,600,300,1,00349,India
897142,2023-09-23,1005,Nail Polish,50,100,50,1,00398,India
897142,2023-09-23,1004,Eyeliner,100,200,100,1,00398,India
897142,2023-09-23,1003,Foundation,300,600,300,1,00398,India
222875,2023-09-23,1005,Nail Polish,50,100,50,1,00347,India
222875,2023-09-23,1003,Foundation,300,600,300,1,00347,India
222875,2023-09-23,1006,Blush,150,300,150,1,00347,India
417190,2023-09-23,1001,Lipstick,150,300,150,1,00328,India
417190,2023-09-23,1012,Body Lotion,200,400,200,1,00328,India
417190,2023-09-23,1006,Blush,150,300,150,1,00328,India
718148,2023-09-23,1008,Makeup Remover,80,160,80,1,00349,India
718148,2023-09-23,1004,Eyeliner,100,200,100,1,00349,India
718148,2023-09-23,1012,Body Lotion,200,400,200,1,00349,India
764195,2023-09-23,1001,Lipstick,150,300,150,1,00323,India
764195,2023-09-23,1002,Mascara,200,400,200,1,00323,India
764195,2023-09-23,1004,Eyeliner,100,200,100,1,00323,India
598043,2023-09-23,1004,Eyeliner,100,200,100,1,00191,India
598043,2023-09-23,1002,Mascara,200,400,200,1,00191,India
598043,2023-09-23,1006,Blush,150,300,150,1,00191,India
598043,2023-09-23,1003,Foundation,300,600,300,1,00191,India
598043,2023-09-23,1009,Moisturizer,250,500,250,1,00191,India
360435,2023-09-23,1007,Eyeshadow,200,400,200,1,00222,India
360435,2023-09-23,1008,Makeup Remover,80,160,80,1,00222,India
360435,2023-09-23,1009,Moisturizer,250,500,250,1,00222,India
360435,2023-09-23,1001,Lipstick,150,300,150,1,00222,India
360435,2023-09-23,1012,Body Lotion,200,400,200,1,00222,India
479967,2023-09-23,1005,Nail Polish,50,100,50,1,00104,India
216882,2023-09-23,1005,Nail Polish,50,100,50,1,00442,India
216882,2023-09-23,1002,Mascara,200,400,200,1,00442,India
216882,2023-09-23,1009,Moisturizer,250,500,250,1,00442,India
420374,2023-09-23,1012,Body Lotion,200,400,200,1,00488,India
520057,2023-09-23,1001,Lipstick,150,300,150,1,00220,India
796755,2023-09-23,1007,Eyeshadow,200,400,200,1,00139,India
521377,2023-09-23,1004,Eyeliner,100,200,100,1,00289,India
521377,2023-09-23,1005,Nail Polish,50,100,50,1,00289,India
143355,2023-09-23,1001,Lipstick,150,300,150,1,00372,India
203263,2023-09-23,1006,Blush,150,300,150,1,00054,India
203263,2023-09-23,1003,Foundation,300,600,300,1,00054,India
203263,2023-09-23,1008,Makeup Remover,80,160,80,1,00054,India
311924,2023-09-23,1012,Body Lotion,200,400,200,1,00365,India
311924,2023-09-23,1007,Eyeshadow,200,400,200,1,00365,India
311924,2023-09-23,1002,Mascara,200,400,200,1,00365,India
106333,2023-09-23,1008,Makeup Remover,80,160,80,1,00333,India
106333,2023-09-23,1005,Nail Polish,50,100,50,1,00333,India
602364,2023-09-23,1001,Lipstick,150,300,150,1,00380,India
602364,2023-09-23,1012,Body Lotion,200,400,200,1,00380,India
602364,2023-09-23,1002,Mascara,200,400,200,1,00380,India
602364,2023-09-23,1007,Eyeshadow,200,400,200,1,00380,India
906544,2023-09-24,1002,Mascara,200,400,200,1,00041,India
474496,2023-09-24,1007,Eyeshadow,200,400,200,1,00423,India
474496,2023-09-24,1002,Mascara,200,400,200,1,00423,India
474496,2023-09-24,1008,Makeup Remover,80,160,80,1,00423,India
434206,2023-09-24,1009,Moisturizer,250,500,250,1,00077,India
434206,2023-09-24,1001,Lipstick,150,300,150,1,00077,India
434206,2023-09-24,1008,Makeup Remover,80,160,80,1,00077,India
434206,2023-09-24,1005,Nail Polish,50,100,50,1,00077,India
132273,2023-09-24,1004,Eyeliner,100,200,100,1,00074,India
520483,2023-09-24,1009,Moisturizer,250,500,250,1,00465,India
520483,2023-09-24,1001,Lipstick,150,300,150,1,00465,India
275202,2023-09-24,1007,Eyeshadow,200,400,200,1,00207,India
465001,2023-09-24,1007,Eyeshadow,200,400,200,1,00442,India
502738,2023-09-24,1002,Mascara,200,400,200,1,00258,India
502738,2023-09-24,1003,Foundation,300,600,300,1,00258,India
502738,2023-09-24,1004,Eyeliner,100,200,100,1,00258,India
502738,2023-09-24,1001,Lipstick,150,300,150,1,00258,India
381767,2023-09-24,1007,Eyeshadow,200,400,200,1,00464,India
381767,2023-09-24,1004,Eyeliner,100,200,100,1,00464,India
381767,2023-09-24,1003,Foundation,300,600,300,1,00464,India
180171,2023-09-24,1008,Makeup Remover,80,160,80,1,00429,India
180171,2023-09-24,1001,Lipstick,150,300,150,1,00429,India
180171,2023-09-24,1005,Nail Polish,50,100,50,1,00429,India
180171,2023-09-24,1006,Blush,150,300,150,1,00429,India
944128,2023-09-24,1012,Body Lotion,200,400,200,1,00459,India
944128,2023-09-24,1009,Moisturizer,250,500,250,1,00459,India
425359,2023-09-24,1005,Nail Polish,50,100,50,1,00416,India
425359,2023-09-24,1003,Foundation,300,600,300,1,00416,India
425359,2023-09-24,1002,Mascara,200,400,200,1,00416,India
425359,2023-09-24,1007,Eyeshadow,200,400,200,1,00416,India
210667,2023-09-24,1002,Mascara,200,400,200,1,00125,India
210667,2023-09-24,1006,Blush,150,300,150,1,00125,India
343958,2023-09-24,1004,Eyeliner,100,200,100,1,00383,India
343958,2023-09-24,1012,Body Lotion,200,400,200,1,00383,India
343958,2023-09-24,1006,Blush,150,300,150,1,00383,India
992253,2023-09-24,1004,Eyeliner,100,200,100,1,00107,India
992253,2023-09-24,1006,Blush,150,300,150,1,00107,India
992253,2023-09-24,1003,Foundation,300,600,300,1,00107,India
992253,2023-09-24,1001,Lipstick,150,300,150,1,00107,India
538297,2023-09-24,1005,Nail Polish,50,100,50,1,00083,India
538297,2023-09-24,1002,Mascara,200,400,200,1,00083,India
538297,2023-09-24,1008,Makeup Remover,80,160,80,1,00083,India
538297,2023-09-24,1007,Eyeshadow,200,400,200,1,00083,India
538297,2023-09-24,1009,Moisturizer,250,500,250,1,00083,India
185306,2023-09-24,1006,Blush,150,300,150,1,00049,India
185306,2023-09-24,1003,Foundation,300,600,300,1,00049,India
919323,2023-09-24,1005,Nail Polish,50,100,50,1,00430,India
957400,2023-09-24,1006,Blush,150,300,150,1,00350,India
957400,2023-09-24,1005,Nail Polish,50,100,50,1,00350,India
887198,2023-09-24,1012,Body Lotion,200,400,200,1,00226,India
846302,2023-09-24,1004,Eyeliner,100,200,100,1,00309,India
846302,2023-09-24,1008,Makeup Remover,80,160,80,1,00309,India
846302,2023-09-24,1001,Lipstick,150,300,150,1,00309,India
863174,2023-09-24,1003,Foundation,300,600,300,1,00432,India
863174,2023-09-24,1001,Lipstick,150,300,150,1,00432,India
863174,2023-09-24,1012,Body Lotion,200,400,200,1,00432,India
863174,2023-09-24,1005,Nail Polish,50,100,50,1,00432,India
863174,2023-09-24,1002,Mascara,200,400,200,1,00432,India
408232,2023-09-24,1005,Nail Polish,50,100,50,1,00242,India
408232,2023-09-24,1012,Body Lotion,200,400,200,1,00242,India
408232,2023-09-24,1008,Makeup Remover,80,160,80,1,00242,India
484762,2023-09-24,1009,Moisturizer,250,500,250,1,00473,India
484762,2023-09-24,1004,Eyeliner,100,200,100,1,00473,India
576720,2023-09-24,1001,Lipstick,150,300,150,1,00319,India
576720,2023-09-24,1007,Eyeshadow,200,400,200,1,00319,India
576720,2023-09-24,1003,Foundation,300,600,300,1,00319,India
576720,2023-09-24,1005,Nail Polish,50,100,50,1,00319,India
576720,2023-09-24,1006,Blush,150,300,150,1,00319,India
860898,2023-09-24,1009,Moisturizer,250,500,250,1,00484,India
860898,2023-09-24,1012,Body Lotion,200,400,200,1,00484,India
148178,2023-09-24,1001,Lipstick,150,300,150,1,00221,India
148178,2023-09-24,1003,Foundation,300,600,300,1,00221,India
610082,2023-09-24,1002,Mascara,200,400,200,1,00295,India
610082,2023-09-24,1005,Nail Polish,50,100,50,1,00295,India
225007,2023-09-24,1007,Eyeshadow,200,400,200,1,00458,India
225007,2023-09-24,1005,Nail Polish,50,100,50,1,00458,India
225007,2023-09-24,1002,Mascara,200,400,200,1,00458,India
608444,2023-09-24,1009,Moisturizer,250,500,250,1,00329,India
608444,2023-09-24,1008,Makeup Remover,80,160,80,1,00329,India
608444,2023-09-24,1004,Eyeliner,100,200,100,1,00329,India
755139,2023-09-25,1009,Moisturizer,250,500,250,1,00458,India
901595,2023-09-25,1003,Foundation,300,600,300,1,00021,India
901595,2023-09-25,1002,Mascara,200,400,200,1,00021,India
521571,2023-09-25,1008,Makeup Remover,80,160,80,1,00085,India
521571,2023-09-25,1002,Mascara,200,400,200,1,00085,India
521571,2023-09-25,1007,Eyeshadow,200,400,200,1,00085,India
521571,2023-09-25,1003,Foundation,300,600,300,1,00085,India
551402,2023-09-25,1001,Lipstick,150,300,150,1,00036,India
551402,2023-09-25,1006,Blush,150,300,150,1,00036,India
551402,2023-09-25,1004,Eyeliner,100,200,100,1,00036,India
734544,2023-09-25,1003,Foundation,300,600,300,1,00210,India
734544,2023-09-25,1009,Moisturizer,250,500,250,1,00210,India
396274,2023-09-25,1001,Lipstick,150,300,150,1,00084,India
396274,2023-09-25,1008,Makeup Remover,80,160,80,1,00084,India
396274,2023-09-25,1012,Body Lotion,200,400,200,1,00084,India
233878,2023-09-25,1001,Lipstick,150,300,150,1,00373,India
233878,2023-09-25,1012,Body Lotion,200,400,200,1,00373,India
233878,2023-09-25,1005,Nail Polish,50,100,50,1,00373,India
233878,2023-09-25,1009,Moisturizer,250,500,250,1,00373,India
965084,2023-09-25,1004,Eyeliner,100,200,100,1,00142,India
965084,2023-09-25,1012,Body Lotion,200,400,200,1,00142,India
588633,2023-09-25,1005,Nail Polish,50,100,50,1,00311,India
588633,2023-09-25,1007,Eyeshadow,200,400,200,1,00311,India
588633,2023-09-25,1008,Makeup Remover,80,160,80,1,00311,India
154255,2023-09-25,1007,Eyeshadow,200,400,200,1,00130,India
148296,2023-09-25,1002,Mascara,200,400,200,1,00090,India
148296,2023-09-25,1003,Foundation,300,600,300,1,00090,India
362536,2023-09-25,1002,Mascara,200,400,200,1,00204,India
362536,2023-09-25,1007,Eyeshadow,200,400,200,1,00204,India
546122,2023-09-25,1004,Eyeliner,100,200,100,1,00451,India
546122,2023-09-25,1006,Blush,150,300,150,1,00451,India
546122,2023-09-25,1005,Nail Polish,50,100,50,1,00451,India
172906,2023-09-25,1012,Body Lotion,200,400,200,1,00111,India
699788,2023-09-25,1009,Moisturizer,250,500,250,1,00330,India
699788,2023-09-25,1008,Makeup Remover,80,160,80,1,00330,India
699788,2023-09-25,1006,Blush,150,300,150,1,00330,India
199453,2023-09-25,1005,Nail Polish,50,100,50,1,00198,India
670485,2023-09-25,1005,Nail Polish,50,100,50,1,00242,India
670485,2023-09-25,1002,Mascara,200,400,200,1,00242,India
670485,2023-09-25,1006,Blush,150,300,150,1,00242,India
332158,2023-09-25,1001,Lipstick,150,300,150,1,00088,India
332158,2023-09-25,1003,Foundation,300,600,300,1,00088,India
332158,2023-09-25,1007,Eyeshadow,200,400,200,1,00088,India
332158,2023-09-25,1004,Eyeliner,100,200,100,1,00088,India
251262,2023-09-25,1007,Eyeshadow,200,400,200,1,00024,India
251262,2023-09-25,1001,Lipstick,150,300,150,1,00024,India
251262,2023-09-25,1012,Body Lotion,200,400,200,1,00024,India
568650,2023-09-25,1007,Eyeshadow,200,400,200,1,00445,India
580316,2023-09-25,1006,Blush,150,300,150,1,00153,India
580316,2023-09-25,1003,Foundation,300,600,300,1,00153,India
324474,2023-09-25,1003,Foundation,300,600,300,1,00147,India
890154,2023-09-25,1006,Blush,150,300,150,1,00496,India
890154,2023-09-25,1012,Body Lotion,200,400,200,1,00496,India
890154,2023-09-25,1007,Eyeshadow,200,400,200,1,00496,India
890154,2023-09-25,1009,Moisturizer,250,500,250,1,00496,India
211852,2023-09-25,1004,Eyeliner,100,200,100,1,00054,India
211852,2023-09-25,1006,Blush,150,300,150,1,00054,India
486604,2023-09-25,1003,Foundation,300,600,300,1,00199,India
741369,2023-09-25,1001,Lipstick,150,300,150,1,00395,India
741369,2023-09-25,1005,Nail Polish,50,100,50,1,00395,India
888446,2023-09-25,1005,Nail Polish,50,100,50,1,00153,India
365344,2023-09-25,1005,Nail Polish,50,100,50,1,00451,India
365344,2023-09-25,1009,Moisturizer,250,500,250,1,00451,India
804074,2023-09-25,1007,Eyeshadow,200,400,200,1,00299,India
804074,2023-09-25,1003,Foundation,300,600,300,1,00299,India
804074,2023-09-25,1002,Mascara,200,400,200,1,00299,India
248005,2023-09-25,1012,Body Lotion,200,400,200,1,00087,India
309663,2023-09-25,1004,Eyeliner,100,200,100,1,00213,India
309663,2023-09-25,1005,Nail Polish,50,100,50,1,00213,India
309663,2023-09-25,1007,Eyeshadow,200,400,200,1,00213,India
199630,2023-09-25,1008,Makeup Remover,80,160,80,1,00422,India
784749,2023-09-25,1007,Eyeshadow,200,400,200,1,00183,India
784749,2023-09-25,1009,Moisturizer,250,500,250,1,00183,India
784749,2023-09-25,1001,Lipstick,150,300,150,1,00183,India
208971,2023-09-25,1001,Lipstick,150,300,150,1,00076,India
208971,2023-09-25,1012,Body Lotion,200,400,200,1,00076,India
208971,2023-09-25,1006,Blush,150,300,150,1,00076,India
208971,2023-09-25,1005,Nail Polish,50,100,50,1,00076,India
639044,2023-09-25,1012,Body Lotion,200,400,200,1,00251,India
333418,2023-09-25,1008,Makeup Remover,80,160,80,1,00295,India
333418,2023-09-25,1012,Body Lotion,200,400,200,1,00295,India
333418,2023-09-25,1002,Mascara,200,400,200,1,00295,India
333418,2023-09-25,1001,Lipstick,150,300,150,1,00295,India
961618,2023-09-25,1008,Makeup Remover,80,160,80,1,00194,India
961618,2023-09-25,1007,Eyeshadow,200,400,200,1,00194,India
961618,2023-09-25,1002,Mascara,200,400,200,1,00194,India
524123,2023-09-25,1009,Moisturizer,250,500,250,1,00226,India
480472,2023-09-26,1007,Eyeshadow,200,400,200,1,00139,India
480472,2023-09-26,1003,Foundation,300,600,300,1,00139,India
647043,2023-09-26,1002,Mascara,200,400,200,1,00112,India
647043,2023-09-26,1006,Blush,150,300,150,1,00112,India
647043,2023-09-26,1003,Foundation,300,600,300,1,00112,India
601801,2023-09-26,1008,Makeup Remover,80,160,80,1,00019,India
601801,2023-09-26,1002,Mascara,200,400,200,1,00019,India
601801,2023-09-26,1012,Body Lotion,200,400,200,1,00019,India
601801,2023-09-26,1009,Moisturizer,250,500,250,1,00019,India
783746,2023-09-26,1006,Blush,150,300,150,1,00401,India
378898,2023-09-26,1008,Makeup Remover,80,160,80,1,00239,India
378898,2023-09-26,1005,Nail Polish,50,100,50,1,00239,India
378898,2023-09-26,1007,Eyeshadow,200,400,200,1,00239,India
378898,2023-09-26,1002,Mascara,200,400,200,1,00239,India
546503,2023-09-26,1002,Mascara,200,400,200,1,00278,India
546503,2023-09-26,1005,Nail Polish,50,100,50,1,00278,India
546503,2023-09-26,1007,Eyeshadow,200,400,200,1,00278,India
417292,2023-09-26,1006,Blush,150,300,150,1,00011,India
417292,2023-09-26,1007,Eyeshadow,200,400,200,1,00011,India
417292,2023-09-26,1008,Makeup Remover,80,160,80,1,00011,India
417292,2023-09-26,1004,Eyeliner,100,200,100,1,00011,India
344340,2023-09-26,1012,Body Lotion,200,400,200,1,00032,India
344340,2023-09-26,1003,Foundation,300,600,300,1,00032,India
344340,2023-09-26,1002,Mascara,200,400,200,1,00032,India
344340,2023-09-26,1004,Eyeliner,100,200,100,1,00032,India
344340,2023-09-26,1007,Eyeshadow,200,400,200,1,00032,India
260280,2023-09-26,1007,Eyeshadow,200,400,200,1,00096,India
260280,2023-09-26,1002,Mascara,200,400,200,1,00096,India
260280,2023-09-26,1001,Lipstick,150,300,150,1,00096,India
248405,2023-09-26,1008,Makeup Remover,80,160,80,1,00163,India
248405,2023-09-26,1012,Body Lotion,200,400,200,1,00163,India
253012,2023-09-26,1012,Body Lotion,200,400,200,1,00384,India
253012,2023-09-26,1002,Mascara,200,400,200,1,00384,India
253012,2023-09-26,1007,Eyeshadow,200,400,200,1,00384,India
253012,2023-09-26,1009,Moisturizer,250,500,250,1,00384,India
253012,2023-09-26,1001,Lipstick,150,300,150,1,00384,India
620916,2023-09-26,1001,Lipstick,150,300,150,1,00453,India
591650,2023-09-26,1003,Foundation,300,600,300,1,00250,India
617777,2023-09-26,1007,Eyeshadow,200,400,200,1,00422,India
655623,2023-09-26,1006,Blush,150,300,150,1,00184,India
655623,2023-09-26,1007,Eyeshadow,200,400,200,1,00184,India
655623,2023-09-26,1004,Eyeliner,100,200,100,1,00184,India
760564,2023-09-26,1007,Eyeshadow,200,400,200,1,00448,India
345778,2023-09-26,1007,Eyeshadow,200,400,200,1,00063,India
345778,2023-09-26,1009,Moisturizer,250,500,250,1,00063,India
345778,2023-09-26,1008,Makeup Remover,80,160,80,1,00063,India
534848,2023-09-26,1005,Nail Polish,50,100,50,1,00428,India
319809,2023-09-26,1003,Foundation,300,600,300,1,00144,India
319809,2023-09-26,1012,Body Lotion,200,400,200,1,00144,India
319809,2023-09-26,1004,Eyeliner,100,200,100,1,00144,India
319809,2023-09-26,1008,Makeup Remover,80,160,80,1,00144,India
592940,2023-09-26,1001,Lipstick,150,300,150,1,00377,India
115840,2023-09-26,1012,Body Lotion,200,400,200,1,00411,India
115840,2023-09-26,1006,Blush,150,300,150,1,00411,India
115840,2023-09-26,1003,Foundation,300,600,300,1,00411,India
115840,2023-09-26,1005,Nail Polish,50,100,50,1,00411,India
211350,2023-09-26,1003,Foundation,300,600,300,1,00033,India
211350,2023-09-26,1005,Nail Polish,50,100,50,1,00033,India
211350,2023-09-26,1002,Mascara,200,400,200,1,00033,India
785564,2023-09-26,1009,Moisturizer,250,500,250,1,00423,India
785564,2023-09-26,1007,Eyeshadow,200,400,200,1,00423,India
785564,2023-09-26,1001,Lipstick,150,300,150,1,00423,India
785564,2023-09-26,1006,Blush,150,300,150,1,00423,India
488436,2023-09-26,1007,Eyeshadow,200,400,200,1,00046,India
488436,2023-09-26,1008,Makeup Remover,80,160,80,1,00046,India
488436,2023-09-26,1002,Mascara,200,400,200,1,00046,India
488436,2023-09-26,1001,Lipstick,150,300,150,1,00046,India
488436,2023-09-26,1006,Blush,150,300,150,1,00046,India
673512,2023-09-26,1001,Lipstick,150,300,150,1,00189,India
646611,2023-09-26,1004,Eyeliner,100,200,100,1,00397,India
646611,2023-09-26,1003,Foundation,300,600,300,1,00397,India
646611,2023-09-26,1002,Mascara,200,400,200,1,00397,India
646611,2023-09-26,1006,Blush,150,300,150,1,00397,India
425422,2023-09-26,1006,Blush,150,300,150,1,00283,India
786785,2023-09-26,1003,Foundation,300,600,300,1,00232,India
786785,2023-09-26,1001,Lipstick,150,300,150,1,00232,India
786785,2023-09-26,1004,Eyeliner,100,200,100,1,00232,India
786785,2023-09-26,1012,Body Lotion,200,400,200,1,00232,India
872939,2023-09-26,1004,Eyeliner,100,200,100,1,00126,India
195989,2023-09-26,1006,Blush,150,300,150,1,00400,India
945497,2023-09-27,1009,Moisturizer,250,500,250,1,00448,India
945497,2023-09-27,1003,Foundation,300,600,300,1,00448,India
945497,2023-09-27,1012,Body Lotion,200,400,200,1,00448,India
945497,2023-09-27,1006,Blush,150,300,150,1,00448,India
769654,2023-09-27,1012,Body Lotion,200,400,200,1,00039,India
769654,2023-09-27,1005,Nail Polish,50,100,50,1,00039,India
769654,2023-09-27,1002,Mascara,200,400,200,1,00039,India
769654,2023-09-27,1001,Lipstick,150,300,150,1,00039,India
790773,2023-09-27,1006,Blush,150,300,150,1,00155,India
790773,2023-09-27,1003,Foundation,300,600,300,1,00155,India
736440,2023-09-27,1009,Moisturizer,250,500,250,1,00087,India
736440,2023-09-27,1012,Body Lotion,200,400,200,1,00087,India
736440,2023-09-27,1001,Lipstick,150,300,150,1,00087,India
509144,2023-09-27,1001,Lipstick,150,300,150,1,00313,India
509144,2023-09-27,1004,Eyeliner,100,200,100,1,00313,India
509144,2023-09-27,1012,Body Lotion,200,400,200,1,00313,India
509144,2023-09-27,1005,Nail Polish,50,100,50,1,00313,India
885006,2023-09-27,1001,Lipstick,150,300,150,1,00150,India
885006,2023-09-27,1012,Body Lotion,200,400,200,1,00150,India
186092,2023-09-27,1005,Nail Polish,50,100,50,1,00192,India
186092,2023-09-27,1003,Foundation,300,600,300,1,00192,India
186092,2023-09-27,1008,Makeup Remover,80,160,80,1,00192,India
186092,2023-09-27,1009,Moisturizer,250,500,250,1,00192,India
912656,2023-09-27,1008,Makeup Remover,80,160,80,1,00306,India
912656,2023-09-27,1003,Foundation,300,600,300,1,00306,India
912656,2023-09-27,1009,Moisturizer,250,500,250,1,00306,India
912656,2023-09-27,1002,Mascara,200,400,200,1,00306,India
958508,2023-09-27,1001,Lipstick,150,300,150,1,00400,India
285369,2023-09-27,1008,Makeup Remover,80,160,80,1,00258,India
597098,2023-09-27,1002,Mascara,200,400,200,1,00464,India
597098,2023-09-27,1003,Foundation,300,600,300,1,00464,India
597098,2023-09-27,1009,Moisturizer,250,500,250,1,00464,India
200194,2023-09-27,1008,Makeup Remover,80,160,80,1,00107,India
200513,2023-09-27,1004,Eyeliner,100,200,100,1,00478,India
200513,2023-09-27,1008,Makeup Remover,80,160,80,1,00478,India
200513,2023-09-27,1012,Body Lotion,200,400,200,1,00478,India
200513,2023-09-27,1009,Moisturizer,250,500,250,1,00478,India
200513,2023-09-27,1005,Nail Polish,50,100,50,1,00478,India
179270,2023-09-27,1007,Eyeshadow,200,400,200,1,00424,India
803566,2023-09-27,1003,Foundation,300,600,300,1,00433,India
803566,2023-09-27,1002,Mascara,200,400,200,1,00433,India
880016,2023-09-27,1009,Moisturizer,250,500,250,1,00349,India
880016,2023-09-27,1012,Body Lotion,200,400,200,1,00349,India
880016,2023-09-27,1001,Lipstick,150,300,150,1,00349,India
880016,2023-09-27,1002,Mascara,200,400,200,1,00349,India
934197,2023-09-27,1009,Moisturizer,250,500,250,1,00219,India
934197,2023-09-27,1003,Foundation,300,600,300,1,00219,India
934197,2023-09-27,1006,Blush,150,300,150,1,00219,India
934197,2023-09-27,1012,Body Lotion,200,400,200,1,00219,India
307615,2023-09-27,1002,Mascara,200,400,200,1,00447,India
307615,2023-09-27,1008,Makeup Remover,80,160,80,1,00447,India
150231,2023-09-27,1006,Blush,150,300,150,1,00028,India
150231,2023-09-27,1008,Makeup Remover,80,160,80,1,00028,India
150231,2023-09-27,1005,Nail Polish,50,100,50,1,00028,India
150231,2023-09-27,1003,Foundation,300,600,300,1,00028,India
150231,2023-09-27,1001,Lipstick,150,300,150,1,00028,India
822058,2023-09-27,1004,Eyeliner,100,200,100,1,00446,India
822058,2023-09-27,1001,Lipstick,150,300,150,1,00446,India
822058,2023-09-27,1009,Moisturizer,250,500,250,1,00446,India
822058,2023-09-27,1012,Body Lotion,200,400,200,1,00446,India
884369,2023-09-27,1007,Eyeshadow,200,400,200,1,00030,India
884369,2023-09-27,1004,Eyeliner,100,200,100,1,00030,India
884369,2023-09-27,1012,Body Lotion,200,400,200,1,00030,India
954918,2023-09-27,1005,Nail Polish,50,100,50,1,00385,India
954918,2023-09-27,1012,Body Lotion,200,400,200,1,00385,India
954918,2023-09-27,1003,Foundation,300,600,300,1,00385,India
441586,2023-09-27,1001,Lipstick,150,300,150,1,00447,India
441586,2023-09-27,1007,Eyeshadow,200,400,200,1,00447,India
441586,2023-09-27,1003,Foundation,300,600,300,1,00447,India
939128,2023-09-27,1003,Foundation,300,600,300,1,00374,India
939128,2023-09-27,1004,Eyeliner,100,200,100,1,00374,India
647656,2023-09-27,1008,Makeup Remover,80,160,80,1,00403,India
647656,2023-09-27,1002,Mascara,200,400,200,1,00403,India
216110,2023-09-27,1007,Eyeshadow,200,400,200,1,00459,India
581782,2023-09-27,1004,Eyeliner,100,200,100,1,00003,India
581782,2023-09-27,1005,Nail Polish,50,100,50,1,00003,India
581782,2023-09-27,1012,Body Lotion,200,400,200,1,00003,India
581782,2023-09-27,1002,Mascara,200,400,200,1,00003,India
581782,2023-09-27,1006,Blush,150,300,150,1,00003,India
855673,2023-09-27,1003,Foundation,300,600,300,1,00378,India
855673,2023-09-27,1005,Nail Polish,50,100,50,1,00378,India
855673,2023-09-27,1001,Lipstick,150,300,150,1,00378,India
311672,2023-09-27,1001,Lipstick,150,300,150,1,00048,India
311672,2023-09-27,1002,Mascara,200,400,200,1,00048,India
311672,2023-09-27,1003,Foundation,300,600,300,1,00048,India
777056,2023-09-27,1001,Lipstick,150,300,150,1,00176,India
777056,2023-09-27,1009,Moisturizer,250,500,250,1,00176,India
905551,2023-09-27,1008,Makeup Remover,80,160,80,1,00033,India
905551,2023-09-27,1005,Nail Polish,50,100,50,1,00033,India
905551,2023-09-27,1002,Mascara,200,400,200,1,00033,India
905551,2023-09-27,1009,Moisturizer,250,500,250,1,00033,India
802362,2023-09-27,1007,Eyeshadow,200,400,200,1,00454,India
253984,2023-09-27,1012,Body Lotion,200,400,200,1,00250,India
253984,2023-09-27,1003,Foundation,300,600,300,1,00250,India
253984,2023-09-27,1002,Mascara,200,400,200,1,00250,India
253984,2023-09-27,1001,Lipstick,150,300,150,1,00250,India
313707,2023-09-27,1009,Moisturizer,250,500,250,1,00149,India
313707,2023-09-27,1007,Eyeshadow,200,400,200,1,00149,India
313707,2023-09-27,1006,Blush,150,300,150,1,00149,India
313707,2023-09-27,1005,Nail Polish,50,100,50,1,00149,India
247829,2023-09-27,1007,Eyeshadow,200,400,200,1,00109,India
247829,2023-09-27,1005,Nail Polish,50,100,50,1,00109,India
877484,2023-09-27,1007,Eyeshadow,200,400,200,1,00350,India
877484,2023-09-27,1009,Moisturizer,250,500,250,1,00350,India
877484,2023-09-27,1004,Eyeliner,100,200,100,1,00350,India
175438,2023-09-27,1009,Moisturizer,250,500,250,1,00071,India
175438,2023-09-27,1004,Eyeliner,100,200,100,1,00071,India
185295,2023-09-27,1012,Body Lotion,200,400,200,1,00372,India
185295,2023-09-27,1009,Moisturizer,250,500,250,1,00372,India
185295,2023-09-27,1006,Blush,150,300,150,1,00372,India
185295,2023-09-27,1003,Foundation,300,600,300,1,00372,India
994156,2023-09-27,1007,Eyeshadow,200,400,200,1,00174,India
994156,2023-09-27,1004,Eyeliner,100,200,100,1,00174,India
904483,2023-09-27,1003,Foundation,300,600,300,1,00215,India
904483,2023-09-27,1001,Lipstick,150,300,150,1,00215,India
358460,2023-09-27,1007,Eyeshadow,200,400,200,1,00449,India
358460,2023-09-27,1006,Blush,150,300,150,1,00449,India
358460,2023-09-27,1008,Makeup Remover,80,160,80,1,00449,India
362553,2023-09-27,1006,Blush,150,300,150,1,00201,India
362553,2023-09-27,1007,Eyeshadow,200,400,200,1,00201,India
362553,2023-09-27,1002,Mascara,200,400,200,1,00201,India
362553,2023-09-27,1005,Nail Polish,50,100,50,1,00201,India
643456,2023-09-27,1008,Makeup Remover,80,160,80,1,00428,India
643456,2023-09-27,1001,Lipstick,150,300,150,1,00428,India
643456,2023-09-27,1012,Body Lotion,200,400,200,1,00428,India
242523,2023-09-27,1006,Blush,150,300,150,1,00366,India
242523,2023-09-27,1001,Lipstick,150,300,150,1,00366,India
242523,2023-09-27,1003,Foundation,300,600,300,1,00366,India
131703,2023-09-27,1001,Lipstick,150,300,150,1,00494,India
131703,2023-09-27,1009,Moisturizer,250,500,250,1,00494,India
215500,2023-09-27,1009,Moisturizer,250,500,250,1,00177,India
215500,2023-09-27,1004,Eyeliner,100,200,100,1,00177,India
332525,2023-09-27,1002,Mascara,200,400,200,1,00470,India
332525,2023-09-27,1005,Nail Polish,50,100,50,1,00470,India
332525,2023-09-27,1006,Blush,150,300,150,1,00470,India
598392,2023-09-27,1008,Makeup Remover,80,160,80,1,00066,India
473907,2023-09-27,1004,Eyeliner,100,200,100,1,00363,India
473907,2023-09-27,1007,Eyeshadow,200,400,200,1,00363,India
473907,2023-09-27,1002,Mascara,200,400,200,1,00363,India
473907,2023-09-27,1006,Blush,150,300,150,1,00363,India
414120,2023-09-27,1001,Lipstick,150,300,150,1,00425,India
414120,2023-09-27,1004,Eyeliner,100,200,100,1,00425,India
414120,2023-09-27,1008,Makeup Remover,80,160,80,1,00425,India
177101,2023-09-28,1006,Blush,150,300,150,1,00172,India
177101,2023-09-28,1008,Makeup Remover,80,160,80,1,00172,India
177101,2023-09-28,1002,Mascara,200,400,200,1,00172,India
541857,2023-09-28,1002,Mascara,200,400,200,1,00172,India
268818,2023-09-28,1001,Lipstick,150,300,150,1,00111,India
268818,2023-09-28,1007,Eyeshadow,200,400,200,1,00111,India
883755,2023-09-28,1005,Nail Polish,50,100,50,1,00013,India
883755,2023-09-28,1006,Blush,150,300,150,1,00013,India
883755,2023-09-28,1008,Makeup Remover,80,160,80,1,00013,India
883755,2023-09-28,1009,Moisturizer,250,500,250,1,00013,India
473717,2023-09-28,1012,Body Lotion,200,400,200,1,00441,India
473717,2023-09-28,1006,Blush,150,300,150,1,00441,India
473717,2023-09-28,1008,Makeup Remover,80,160,80,1,00441,India
473717,2023-09-28,1005,Nail Polish,50,100,50,1,00441,India
390772,2023-09-28,1009,Moisturizer,250,500,250,1,00150,India
390772,2023-09-28,1005,Nail Polish,50,100,50,1,00150,India
390772,2023-09-28,1004,Eyeliner,100,200,100,1,00150,India
390772,2023-09-28,1012,Body Lotion,200,400,200,1,00150,India
588602,2023-09-28,1001,Lipstick,150,300,150,1,00214,India
588602,2023-09-28,1012,Body Lotion,200,400,200,1,00214,India
588602,2023-09-28,1005,Nail Polish,50,100,50,1,00214,India
588602,2023-09-28,1008,Makeup Remover,80,160,80,1,00214,India
623932,2023-09-28,1009,Moisturizer,250,500,250,1,00164,India
623932,2023-09-28,1005,Nail Polish,50,100,50,1,00164,India
623932,2023-09-28,1001,Lipstick,150,300,150,1,00164,India
329425,2023-09-28,1001,Lipstick,150,300,150,1,00480,India
884219,2023-09-28,1001,Lipstick,150,300,150,1,00121,India
884219,2023-09-28,1002,Mascara,200,400,200,1,00121,India
884219,2023-09-28,1008,Makeup Remover,80,160,80,1,00121,India
884219,2023-09-28,1003,Foundation,300,600,300,1,00121,India
754313,2023-09-28,1007,Eyeshadow,200,400,200,1,00296,India
754313,2023-09-28,1008,Makeup Remover,80,160,80,1,00296,India
754313,2023-09-28,1005,Nail Polish,50,100,50,1,00296,India
754313,2023-09-28,1006,Blush,150,300,150,1,00296,India
217517,2023-09-28,1008,Makeup Remover,80,160,80,1,00340,India
217517,2023-09-28,1003,Foundation,300,600,300,1,00340,India
217517,2023-09-28,1004,Eyeliner,100,200,100,1,00340,India
428524,2023-09-28,1012,Body Lotion,200,400,200,1,00038,India
265856,2023-09-28,1008,Makeup Remover,80,160,80,1,00230,India
286180,2023-09-28,1004,Eyeliner,100,200,100,1,00468,India
286180,2023-09-28,1001,Lipstick,150,300,150,1,00468,India
286180,2023-09-28,1012,Body Lotion,200,400,200,1,00468,India
786608,2023-09-28,1004,Eyeliner,100,200,100,1,00346,India
786608,2023-09-28,1006,Blush,150,300,150,1,00346,India
786608,2023-09-28,1002,Mascara,200,400,200,1,00346,India
786608,2023-09-28,1007,Eyeshadow,200,400,200,1,00346,India
786608,2023-09-28,1008,Makeup Remover,80,160,80,1,00346,India
824225,2023-09-28,1008,Makeup Remover,80,160,80,1,00348,India
824225,2023-09-28,1006,Blush,150,300,150,1,00348,India
824225,2023-09-28,1005,Nail Polish,50,100,50,1,00348,India
305535,2023-09-28,1009,Moisturizer,250,500,250,1,00281,India
305535,2023-09-28,1001,Lipstick,150,300,150,1,00281,India
304724,2023-09-28,1002,Mascara,200,400,200,1,00435,India
304724,2023-09-28,1006,Blush,150,300,150,1,00435,India
304724,2023-09-28,1008,Makeup Remover,80,160,80,1,00435,India
226598,2023-09-28,1008,Makeup Remover,80,160,80,1,00402,India
643395,2023-09-28,1001,Lipstick,150,300,150,1,00238,India
643395,2023-09-28,1006,Blush,150,300,150,1,00238,India
903945,2023-09-28,1006,Blush,150,300,150,1,00488,India
606112,2023-09-28,1007,Eyeshadow,200,400,200,1,00228,India
606112,2023-09-28,1012,Body Lotion,200,400,200,1,00228,India
606112,2023-09-28,1001,Lipstick,150,300,150,1,00228,India
526457,2023-09-28,1008,Makeup Remover,80,160,80,1,00342,India
714890,2023-09-28,1009,Moisturizer,250,500,250,1,00004,India
714890,2023-09-28,1012,Body Lotion,200,400,200,1,00004,India
924821,2023-09-28,1009,Moisturizer,250,500,250,1,00013,India
924821,2023-09-28,1001,Lipstick,150,300,150,1,00013,India
200355,2023-09-28,1007,Eyeshadow,200,400,200,1,00384,India
990759,2023-09-28,1002,Mascara,200,400,200,1,00208,India
990759,2023-09-28,1009,Moisturizer,250,500,250,1,00208,India
990759,2023-09-28,1003,Foundation,300,600,300,1,00208,India
851268,2023-09-28,1005,Nail Polish,50,100,50,1,00486,India
851268,2023-09-28,1012,Body Lotion,200,400,200,1,00486,India
851268,2023-09-28,1008,Makeup Remover,80,160,80,1,00486,India
851268,2023-09-28,1002,Mascara,200,400,200,1,00486,India
988014,2023-09-28,1002,Mascara,200,400,200,1,00372,India
988014,2023-09-28,1005,Nail Polish,50,100,50,1,00372,India
600134,2023-09-28,1006,Blush,150,300,150,1,00314,India
600134,2023-09-28,1003,Foundation,300,600,300,1,00314,India
600134,2023-09-28,1001,Lipstick,150,300,150,1,00314,India
641953,2023-09-28,1004,Eyeliner,100,200,100,1,00302,India
641953,2023-09-28,1006,Blush,150,300,150,1,00302,India
563686,2023-09-28,1005,Nail Polish,50,100,50,1,00222,India
877060,2023-09-28,1006,Blush,150,300,150,1,00310,India
877060,2023-09-28,1002,Mascara,200,400,200,1,00310,India
877060,2023-09-28,1007,Eyeshadow,200,400,200,1,00310,India
699319,2023-09-28,1005,Nail Polish,50,100,50,1,00289,India
699319,2023-09-28,1009,Moisturizer,250,500,250,1,00289,India
699319,2023-09-28,1002,Mascara,200,400,200,1,00289,India
699319,2023-09-28,1006,Blush,150,300,150,1,00289,India
699319,2023-09-28,1003,Foundation,300,600,300,1,00289,India
578610,2023-09-28,1003,Foundation,300,600,300,1,00298,India
578610,2023-09-28,1004,Eyeliner,100,200,100,1,00298,India
578610,2023-09-28,1012,Body Lotion,200,400,200,1,00298,India
317314,2023-09-28,1009,Moisturizer,250,500,250,1,00469,India
317314,2023-09-28,1004,Eyeliner,100,200,100,1,00469,India
317314,2023-09-28,1007,Eyeshadow,200,400,200,1,00469,India
966371,2023-09-28,1009,Moisturizer,250,500,250,1,00138,India
966371,2023-09-28,1007,Eyeshadow,200,400,200,1,00138,India
966371,2023-09-28,1003,Foundation,300,600,300,1,00138,India
309632,2023-09-28,1002,Mascara,200,400,200,1,00271,India
309632,2023-09-28,1004,Eyeliner,100,200,100,1,00271,India
309632,2023-09-28,1007,Eyeshadow,200,400,200,1,00271,India
309632,2023-09-28,1005,Nail Polish,50,100,50,1,00271,India
309632,2023-09-28,1009,Moisturizer,250,500,250,1,00271,India
790925,2023-09-28,1002,Mascara,200,400,200,1,00326,India
790925,2023-09-28,1007,Eyeshadow,200,400,200,1,00326,India
790925,2023-09-28,1001,Lipstick,150,300,150,1,00326,India
790925,2023-09-28,1003,Foundation,300,600,300,1,00326,India
474321,2023-09-28,1004,Eyeliner,100,200,100,1,00137,India
474321,2023-09-28,1008,Makeup Remover,80,160,80,1,00137,India
325910,2023-09-28,1005,Nail Polish,50,100,50,1,00020,India
325910,2023-09-28,1003,Foundation,300,600,300,1,00020,India
325910,2023-09-28,1009,Moisturizer,250,500,250,1,00020,India
184222,2023-09-28,1002,Mascara,200,400,200,1,00006,India
184222,2023-09-28,1009,Moisturizer,250,500,250,1,00006,India
184222,2023-09-28,1004,Eyeliner,100,200,100,1,00006,India
184222,2023-09-28,1012,Body Lotion,200,400,200,1,00006,India
198349,2023-09-29,1012,Body Lotion,200,400,200,1,00004,India
198349,2023-09-29,1003,Foundation,300,600,300,1,00004,India
849276,2023-09-29,1007,Eyeshadow,200,400,200,1,00011,India
849276,2023-09-29,1005,Nail Polish,50,100,50,1,00011,India
849276,2023-09-29,1012,Body Lotion,200,400,200,1,00011,India
849276,2023-09-29,1009,Moisturizer,250,500,250,1,00011,India
602879,2023-09-29,1009,Moisturizer,250,500,250,1,00165,India
602879,2023-09-29,1004,Eyeliner,100,200,100,1,00165,India
602879,2023-09-29,1007,Eyeshadow,200,400,200,1,00165,India
950341,2023-09-29,1012,Body Lotion,200,400,200,1,00143,India
950341,2023-09-29,1009,Moisturizer,250,500,250,1,00143,India
950341,2023-09-29,1006,Blush,150,300,150,1,00143,India
950341,2023-09-29,1004,Eyeliner,100,200,100,1,00143,India
950341,2023-09-29,1001,Lipstick,150,300,150,1,00143,India
212450,2023-09-29,1002,Mascara,200,400,200,1,00484,India
212450,2023-09-29,1006,Blush,150,300,150,1,00484,India
212450,2023-09-29,1007,Eyeshadow,200,400,200,1,00484,India
971963,2023-09-29,1004,Eyeliner,100,200,100,1,00392,India
971963,2023-09-29,1008,Makeup Remover,80,160,80,1,00392,India
674548,2023-09-29,1005,Nail Polish,50,100,50,1,00172,India
674548,2023-09-29,1006,Blush,150,300,150,1,00172,India
674548,2023-09-29,1002,Mascara,200,400,200,1,00172,India
518369,2023-09-29,1001,Lipstick,150,300,150,1,00325,India
576363,2023-09-29,1012,Body Lotion,200,400,200,1,00193,India
576363,2023-09-29,1009,Moisturizer,250,500,250,1,00193,India
884044,2023-09-29,1005,Nail Polish,50,100,50,1,00167,India
884044,2023-09-29,1004,Eyeliner,100,200,100,1,00167,India
884044,2023-09-29,1001,Lipstick,150,300,150,1,00167,India
343126,2023-09-29,1006,Blush,150,300,150,1,00032,India
343126,2023-09-29,1007,Eyeshadow,200,400,200,1,00032,India
541825,2023-09-29,1004,Eyeliner,100,200,100,1,00082,India
541825,2023-09-29,1009,Moisturizer,250,500,250,1,00082,India
541825,2023-09-29,1008,Makeup Remover,80,160,80,1,00082,India
541825,2023-09-29,1005,Nail Polish,50,100,50,1,00082,India
817948,2023-09-29,1001,Lipstick,150,300,150,1,00352,India
808987,2023-09-29,1002,Mascara,200,400,200,1,00174,India
582071,2023-09-29,1002,Mascara,200,400,200,1,00416,India
582071,2023-09-29,1009,Moisturizer,250,500,250,1,00416,India
528215,2023-09-29,1009,Moisturizer,250,500,250,1,00322,India
528215,2023-09-29,1012,Body Lotion,200,400,200,1,00322,India
664992,2023-09-29,1004,Eyeliner,100,200,100,1,00310,India
664992,2023-09-29,1001,Lipstick,150,300,150,1,00310,India
664992,2023-09-29,1008,Makeup Remover,80,160,80,1,00310,India
290207,2023-09-29,1012,Body Lotion,200,400,200,1,00135,India
290207,2023-09-29,1001,Lipstick,150,300,150,1,00135,India
705134,2023-09-29,1007,Eyeshadow,200,400,200,1,00066,India
733407,2023-09-29,1005,Nail Polish,50,100,50,1,00448,India
733407,2023-09-29,1007,Eyeshadow,200,400,200,1,00448,India
200670,2023-09-29,1004,Eyeliner,100,200,100,1,00156,India
200670,2023-09-29,1003,Foundation,300,600,300,1,00156,India
675066,2023-09-29,1009,Moisturizer,250,500,250,1,00032,India
675066,2023-09-29,1005,Nail Polish,50,100,50,1,00032,India
675066,2023-09-29,1008,Makeup Remover,80,160,80,1,00032,India
675066,2023-09-29,1001,Lipstick,150,300,150,1,00032,India
344931,2023-09-29,1009,Moisturizer,250,500,250,1,00281,India
344931,2023-09-29,1004,Eyeliner,100,200,100,1,00281,India
344931,2023-09-29,1002,Mascara,200,400,200,1,00281,India
344931,2023-09-29,1001,Lipstick,150,300,150,1,00281,India
201715,2023-09-29,1002,Mascara,200,400,200,1,00446,India
201715,2023-09-29,1007,Eyeshadow,200,400,200,1,00446,India
201715,2023-09-29,1008,Makeup Remover,80,160,80,1,00446,India
755670,2023-09-29,1005,Nail Polish,50,100,50,1,00025,India
755670,2023-09-29,1009,Moisturizer,250,500,250,1,00025,India
755670,2023-09-29,1004,Eyeliner,100,200,100,1,00025,India
917268,2023-09-29,1001,Lipstick,150,300,150,1,00471,India
850517,2023-09-29,1009,Moisturizer,250,500,250,1,00251,India
850517,2023-09-29,1012,Body Lotion,200,400,200,1,00251,India
850517,2023-09-29,1001,Lipstick,150,300,150,1,00251,India
955116,2023-09-29,1003,Foundation,300,600,300,1,00487,India
629535,2023-09-29,1007,Eyeshadow,200,400,200,1,00128,India
492965,2023-09-29,1007,Eyeshadow,200,400,200,1,00034,India
492965,2023-09-29,1008,Makeup Remover,80,160,80,1,00034,India
492965,2023-09-29,1001,Lipstick,150,300,150,1,00034,India
492965,2023-09-29,1002,Mascara,200,400,200,1,00034,India
599716,2023-09-29,1008,Makeup Remover,80,160,80,1,00249,India
710874,2023-09-29,1012,Body Lotion,200,400,200,1,00021,India
710874,2023-09-29,1003,Foundation,300,600,300,1,00021,India
710874,2023-09-29,1005,Nail Polish,50,100,50,1,00021,India
710874,2023-09-29,1007,Eyeshadow,200,400,200,1,00021,India
990369,2023-09-29,1007,Eyeshadow,200,400,200,1,00372,India
990369,2023-09-29,1001,Lipstick,150,300,150,1,00372,India
990369,2023-09-29,1006,Blush,150,300,150,1,00372,India
990369,2023-09-29,1005,Nail Polish,50,100,50,1,00372,India
990369,2023-09-29,1002,Mascara,200,400,200,1,00372,India
291833,2023-09-29,1004,Eyeliner,100,200,100,1,00057,India
291833,2023-09-29,1003,Foundation,300,600,300,1,00057,India
832863,2023-09-29,1008,Makeup Remover,80,160,80,1,00487,India
795109,2023-09-29,1008,Makeup Remover,80,160,80,1,00499,India
795109,2023-09-29,1007,Eyeshadow,200,400,200,1,00499,India
795109,2023-09-29,1003,Foundation,300,600,300,1,00499,India
956466,2023-09-29,1008,Makeup Remover,80,160,80,1,00157,India
956466,2023-09-29,1012,Body Lotion,200,400,200,1,00157,India
507378,2023-09-30,1005,Nail Polish,50,100,50,1,00435,India
507378,2023-09-30,1004,Eyeliner,100,200,100,1,00435,India
507378,2023-09-30,1003,Foundation,300,600,300,1,00435,India
507378,2023-09-30,1006,Blush,150,300,150,1,00435,India
501517,2023-09-30,1006,Blush,150,300,150,1,00139,India
501517,2023-09-30,1003,Foundation,300,600,300,1,00139,India
501517,2023-09-30,1012,Body Lotion,200,400,200,1,00139,India
501517,2023-09-30,1004,Eyeliner,100,200,100,1,00139,India
675145,2023-09-30,1012,Body Lotion,200,400,200,1,00038,India
675145,2023-09-30,1009,Moisturizer,250,500,250,1,00038,India
675145,2023-09-30,1007,Eyeshadow,200,400,200,1,00038,India
675145,2023-09-30,1003,Foundation,300,600,300,1,00038,India
861773,2023-09-30,1002,Mascara,200,400,200,1,00337,India
861773,2023-09-30,1001,Lipstick,150,300,150,1,00337,India
861773,2023-09-30,1003,Foundation,300,600,300,1,00337,India
861773,2023-09-30,1005,Nail Polish,50,100,50,1,00337,India
758625,2023-09-30,1002,Mascara,200,400,200,1,00494,India
758625,2023-09-30,1003,Foundation,300,600,300,1,00494,India
758625,2023-09-30,1008,Makeup Remover,80,160,80,1,00494,India
758625,2023-09-30,1007,Eyeshadow,200,400,200,1,00494,India
759300,2023-09-30,1012,Body Lotion,200,400,200,1,00439,India
759300,2023-09-30,1003,Foundation,300,600,300,1,00439,India
773002,2023-09-30,1009,Moisturizer,250,500,250,1,00250,India
773002,2023-09-30,1006,Blush,150,300,150,1,00250,India
773002,2023-09-30,1001,Lipstick,150,300,150,1,00250,India
214633,2023-09-30,1008,Makeup Remover,80,160,80,1,00020,India
214633,2023-09-30,1012,Body Lotion,200,400,200,1,00020,India
779163,2023-09-30,1008,Makeup Remover,80,160,80,1,00086,India
142669,2023-09-30,1008,Makeup Remover,80,160,80,1,00250,India
142669,2023-09-30,1001,Lipstick,150,300,150,1,00250,India
142669,2023-09-30,1009,Moisturizer,250,500,250,1,00250,India
333595,2023-09-30,1012,Body Lotion,200,400,200,1,00400,India
958926,2023-09-30,1005,Nail Polish,50,100,50,1,00138,India
958926,2023-09-30,1012,Body Lotion,200,400,200,1,00138,India
958926,2023-09-30,1002,Mascara,200,400,200,1,00138,India
132441,2023-09-30,1001,Lipstick,150,300,150,1,00373,India
132441,2023-09-30,1003,Foundation,300,600,300,1,00373,India
386589,2023-09-30,1002,Mascara,200,400,200,1,00281,India
386589,2023-09-30,1004,Eyeliner,100,200,100,1,00281,India
547419,2023-09-30,1002,Mascara,200,400,200,1,00048,India
547419,2023-09-30,1009,Moisturizer,250,500,250,1,00048,India
547419,2023-09-30,1008,Makeup Remover,80,160,80,1,00048,India
547419,2023-09-30,1003,Foundation,300,600,300,1,00048,India
358059,2023-09-30,1007,Eyeshadow,200,400,200,1,00410,India
358059,2023-09-30,1006,Blush,150,300,150,1,00410,India
358059,2023-09-30,1012,Body Lotion,200,400,200,1,00410,India
862062,2023-09-30,1005,Nail Polish,50,100,50,1,00072,India
862062,2023-09-30,1008,Makeup Remover,80,160,80,1,00072,India
862062,2023-09-30,1001,Lipstick,150,300,150,1,00072,India
186849,2023-09-30,1007,Eyeshadow,200,400,200,1,00490,India
186849,2023-09-30,1012,Body Lotion,200,400,200,1,00490,India
433792,2023-09-30,1003,Foundation,300,600,300,1,00077,India
433792,2023-09-30,1004,Eyeliner,100,200,100,1,00077,India
433792,2023-09-30,1006,Blush,150,300,150,1,00077,India
780499,2023-09-30,1001,Lipstick,150,300,150,1,00418,India
580640,2023-09-30,1002,Mascara,200,400,200,1,00172,India
580640,2023-09-30,1006,Blush,150,300,150,1,00172,India
553262,2023-09-30,1012,Body Lotion,200,400,200,1,00044,India
553262,2023-09-30,1007,Eyeshadow,200,400,200,1,00044,India
915700,2023-09-30,1012,Body Lotion,200,400,200,1,00162,India
876962,2023-09-30,1005,Nail Polish,50,100,50,1,00079,India
876962,2023-09-30,1002,Mascara,200,400,200,1,00079,India
876962,2023-09-30,1012,Body Lotion,200,400,200,1,00079,India
209150,2023-09-30,1008,Makeup Remover,80,160,80,1,00052,India
209150,2023-09-30,1002,Mascara,200,400,200,1,00052,India
209150,2023-09-30,1001,Lipstick,150,300,150,1,00052,India
495199,2023-09-30,1003,Foundation,300,600,300,1,00139,India
182993,2023-09-30,1003,Foundation,300,600,300,1,00144,India
182993,2023-09-30,1012,Body Lotion,200,400,200,1,00144,India
182993,2023-09-30,1005,Nail Polish,50,100,50,1,00144,India
900267,2023-09-30,1006,Blush,150,300,150,1,00490,India
900267,2023-09-30,1004,Eyeliner,100,200,100,1,00490,India
733241,2023-09-30,1003,Foundation,300,600,300,1,00302,India
733241,2023-09-30,1005,Nail Polish,50,100,50,1,00302,India
733241,2023-09-30,1001,Lipstick,150,300,150,1,00302,India
133361,2023-09-30,1006,Blush,150,300,150,1,00338,India
133361,2023-09-30,1001,Lipstick,150,300,150,1,00338,India
577563,2023-09-30,1007,Eyeshadow,200,400,200,1,00447,India
577563,2023-09-30,1002,Mascara,200,400,200,1,00447,India
577563,2023-09-30,1006,Blush,150,300,150,1,00447,India
213417,2023-09-30,1007,Eyeshadow,200,400,200,1,00097,India
213417,2023-09-30,1002,Mascara,200,400,200,1,00097,India
213417,2023-09-30,1003,Foundation,300,600,300,1,00097,India
358569,2023-10-01,1002,Mascara,200,400,200,1,00234,India
358569,2023-10-01,1006,Blush,150,300,150,1,00234,India
358569,2023-10-01,1007,Eyeshadow,200,400,200,1,00234,India
398578,2023-10-01,1012,Body Lotion,200,400,200,2,00032,India
398578,2023-10-01,1003,Foundation,300,600,300,1,00032,India
261981,2023-10-01,1001,Lipstick,150,300,150,1,00483,India
261981,2023-10-01,1009,Moisturizer,250,500,250,2,00483,India
261981,2023-10-01,1012,Body Lotion,200,400,200,2,00483,India
261981,2023-10-01,1005,Nail Polish,50,100,50,1,00483,India
225470,2023-10-01,1006,Blush,150,300,150,1,00043,India
225470,2023-10-01,1007,Eyeshadow,200,400,200,1,00043,India
225470,2023-10-01,1002,Mascara,200,400,200,1,00043,India
664573,2023-10-01,1012,Body Lotion,200,400,200,2,00104,India
664573,2023-10-01,1006,Blush,150,300,150,1,00104,India
664573,2023-10-01,1004,Eyeliner,100,200,100,1,00104,India
664573,2023-10-01,1002,Mascara,200,400,200,1,00104,India
766630,2023-10-01,1001,Lipstick,150,300,150,1,00212,India
766630,2023-10-01,1007,Eyeshadow,200,400,200,1,00212,India
115860,2023-10-01,1006,Blush,150,300,150,1,00286,India
115860,2023-10-01,1007,Eyeshadow,200,400,200,1,00286,India
843872,2023-10-01,1001,Lipstick,150,300,150,1,00447,India
843872,2023-10-01,1009,Moisturizer,250,500,250,2,00447,India
843872,2023-10-01,1004,Eyeliner,100,200,100,1,00447,India
843872,2023-10-01,1003,Foundation,300,600,300,1,00447,India
843872,2023-10-01,1007,Eyeshadow,200,400,200,1,00447,India
556866,2023-10-01,1004,Eyeliner,100,200,100,1,00053,India
556866,2023-10-01,1001,Lipstick,150,300,150,1,00053,India
556866,2023-10-01,1009,Moisturizer,250,500,250,2,00053,India
556866,2023-10-01,1006,Blush,150,300,150,1,00053,India
616073,2023-10-01,1002,Mascara,200,400,200,1,00113,India
616073,2023-10-01,1008,Makeup Remover,80,160,80,1,00113,India
616073,2023-10-01,1005,Nail Polish,50,100,50,1,00113,India
616073,2023-10-01,1012,Body Lotion,200,400,200,2,00113,India
169910,2023-10-01,1007,Eyeshadow,200,400,200,1,00007,India
757148,2023-10-01,1012,Body Lotion,200,400,200,2,00145,India
757148,2023-10-01,1007,Eyeshadow,200,400,200,1,00145,India
757148,2023-10-01,1001,Lipstick,150,300,150,1,00145,India
604915,2023-10-01,1006,Blush,150,300,150,1,00266,India
604915,2023-10-01,1007,Eyeshadow,200,400,200,1,00266,India
604915,2023-10-01,1001,Lipstick,150,300,150,1,00266,India
604915,2023-10-01,1004,Eyeliner,100,200,100,1,00266,India
828585,2023-10-01,1001,Lipstick,150,300,150,1,00493,India
750409,2023-10-01,1005,Nail Polish,50,100,50,1,00109,India
997669,2023-10-01,1009,Moisturizer,250,500,250,2,00373,India
997669,2023-10-01,1007,Eyeshadow,200,400,200,1,00373,India
997669,2023-10-01,1003,Foundation,300,600,300,1,00373,India
300407,2023-10-01,1001,Lipstick,150,300,150,1,00140,India
300407,2023-10-01,1003,Foundation,300,600,300,1,00140,India
842553,2023-10-01,1009,Moisturizer,250,500,250,2,00381,India
842553,2023-10-01,1004,Eyeliner,100,200,100,1,00381,India
988881,2023-10-01,1001,Lipstick,150,300,150,1,00170,India
421116,2023-10-01,1002,Mascara,200,400,200,1,00177,India
421116,2023-10-01,1006,Blush,150,300,150,1,00177,India
394417,2023-10-01,1012,Body Lotion,200,400,200,2,00324,India
394417,2023-10-01,1004,Eyeliner,100,200,100,1,00324,India
394417,2023-10-01,1002,Mascara,200,400,200,1,00324,India
394417,2023-10-01,1006,Blush,150,300,150,1,00324,India
125508,2023-10-01,1009,Moisturizer,250,500,250,2,00450,India
125508,2023-10-01,1012,Body Lotion,200,400,200,2,00450,India
125508,2023-10-01,1001,Lipstick,150,300,150,1,00450,India
125508,2023-10-01,1003,Foundation,300,600,300,1,00450,India
125508,2023-10-01,1005,Nail Polish,50,100,50,1,00450,India
527909,2023-10-01,1008,Makeup Remover,80,160,80,1,00334,India
775208,2023-10-01,1005,Nail Polish,50,100,50,1,00162,India
775208,2023-10-01,1009,Moisturizer,250,500,250,2,00162,India
775208,2023-10-01,1008,Makeup Remover,80,160,80,1,00162,India
775208,2023-10-01,1007,Eyeshadow,200,400,200,1,00162,India
723245,2023-10-01,1004,Eyeliner,100,200,100,1,00055,India
723245,2023-10-01,1009,Moisturizer,250,500,250,2,00055,India
629236,2023-10-01,1003,Foundation,300,600,300,1,00405,India
629236,2023-10-01,1002,Mascara,200,400,200,1,00405,India
734795,2023-10-01,1003,Foundation,300,600,300,1,00105,India
734795,2023-10-01,1002,Mascara,200,400,200,1,00105,India
734795,2023-10-01,1009,Moisturizer,250,500,250,2,00105,India
603522,2023-10-01,1009,Moisturizer,250,500,250,2,00345,India
603522,2023-10-01,1007,Eyeshadow,200,400,200,1,00345,India
603522,2023-10-01,1004,Eyeliner,100,200,100,1,00345,India
603522,2023-10-01,1002,Mascara,200,400,200,1,00345,India
198208,2023-10-01,1008,Makeup Remover,80,160,80,1,00363,India
198208,2023-10-01,1003,Foundation,300,600,300,1,00363,India
198208,2023-10-01,1002,Mascara,200,400,200,1,00363,India
139274,2023-10-01,1007,Eyeshadow,200,400,200,1,00338,India
139274,2023-10-01,1003,Foundation,300,600,300,1,00338,India
139274,2023-10-01,1008,Makeup Remover,80,160,80,1,00338,India
139274,2023-10-01,1009,Moisturizer,250,500,250,2,00338,India
452792,2023-10-01,1008,Makeup Remover,80,160,80,1,00474,India
452792,2023-10-01,1003,Foundation,300,600,300,1,00474,India
452792,2023-10-01,1012,Body Lotion,200,400,200,2,00474,India
452792,2023-10-01,1004,Eyeliner,100,200,100,1,00474,India
452792,2023-10-01,1002,Mascara,200,400,200,1,00474,India
317686,2023-10-01,1007,Eyeshadow,200,400,200,1,00460,India
480151,2023-10-01,1008,Makeup Remover,80,160,80,1,00407,India
480151,2023-10-01,1007,Eyeshadow,200,400,200,1,00407,India
480151,2023-10-01,1009,Moisturizer,250,500,250,2,00407,India
480151,2023-10-01,1004,Eyeliner,100,200,100,1,00407,India
477023,2023-10-01,1002,Mascara,200,400,200,1,00307,India
477023,2023-10-01,1007,Eyeshadow,200,400,200,1,00307,India
798465,2023-10-01,1009,Moisturizer,250,500,250,2,00359,India
798465,2023-10-01,1004,Eyeliner,100,200,100,1,00359,India
798465,2023-10-01,1012,Body Lotion,200,400,200,2,00359,India
457946,2023-10-01,1005,Nail Polish,50,100,50,1,00367,India
457946,2023-10-01,1009,Moisturizer,250,500,250,2,00367,India
457946,2023-10-01,1002,Mascara,200,400,200,1,00367,India
699136,2023-10-01,1002,Mascara,200,400,200,1,00281,India
699136,2023-10-01,1007,Eyeshadow,200,400,200,1,00281,India
699136,2023-10-01,1008,Makeup Remover,80,160,80,1,00281,India
131826,2023-10-02,1009,Moisturizer,250,500,250,2,00493,India
131826,2023-10-02,1008,Makeup Remover,80,160,80,1,00493,India
131826,2023-10-02,1007,Eyeshadow,200,400,200,1,00493,India
131826,2023-10-02,1004,Eyeliner,100,200,100,1,00493,India
728797,2023-10-02,1005,Nail Polish,50,100,50,1,00217,India
728797,2023-10-02,1001,Lipstick,150,300,150,1,00217,India
728797,2023-10-02,1004,Eyeliner,100,200,100,1,00217,India
178945,2023-10-02,1001,Lipstick,150,300,150,1,00497,India
178945,2023-10-02,1007,Eyeshadow,200,400,200,1,00497,India
178945,2023-10-02,1004,Eyeliner,100,200,100,1,00497,India
178945,2023-10-02,1003,Foundation,300,600,300,1,00497,India
601031,2023-10-02,1006,Blush,150,300,150,1,00393,India
601031,2023-10-02,1003,Foundation,300,600,300,1,00393,India
568777,2023-10-02,1012,Body Lotion,200,400,200,2,00074,India
209238,2023-10-02,1006,Blush,150,300,150,1,00316,India
209238,2023-10-02,1012,Body Lotion,200,400,200,2,00316,India
209238,2023-10-02,1007,Eyeshadow,200,400,200,1,00316,India
209238,2023-10-02,1003,Foundation,300,600,300,1,00316,India
336059,2023-10-02,1001,Lipstick,150,300,150,1,00034,India
336059,2023-10-02,1008,Makeup Remover,80,160,80,1,00034,India
336059,2023-10-02,1005,Nail Polish,50,100,50,1,00034,India
336059,2023-10-02,1012,Body Lotion,200,400,200,2,00034,India
336059,2023-10-02,1007,Eyeshadow,200,400,200,1,00034,India
575737,2023-10-02,1008,Makeup Remover,80,160,80,1,00086,India
575737,2023-10-02,1002,Mascara,200,400,200,1,00086,India
575737,2023-10-02,1005,Nail Polish,50,100,50,1,00086,India
189568,2023-10-02,1001,Lipstick,150,300,150,1,00140,India
774055,2023-10-02,1002,Mascara,200,400,200,1,00313,India
315345,2023-10-02,1003,Foundation,300,600,300,1,00496,India
315345,2023-10-02,1002,Mascara,200,400,200,1,00496,India
315345,2023-10-02,1007,Eyeshadow,200,400,200,1,00496,India
315345,2023-10-02,1012,Body Lotion,200,400,200,2,00496,India
114925,2023-10-02,1004,Eyeliner,100,200,100,1,00486,India
114925,2023-10-02,1002,Mascara,200,400,200,1,00486,India
114925,2023-10-02,1003,Foundation,300,600,300,1,00486,India
752411,2023-10-02,1005,Nail Polish,50,100,50,1,00203,India
752411,2023-10-02,1001,Lipstick,150,300,150,1,00203,India
103413,2023-10-02,1006,Blush,150,300,150,1,00347,India
103413,2023-10-02,1003,Foundation,300,600,300,1,00347,India
103413,2023-10-02,1007,Eyeshadow,200,400,200,1,00347,India
644309,2023-10-02,1006,Blush,150,300,150,1,00360,India
644309,2023-10-02,1008,Makeup Remover,80,160,80,1,00360,India
389840,2023-10-02,1001,Lipstick,150,300,150,1,00273,India
987091,2023-10-02,1003,Foundation,300,600,300,1,00267,India
987091,2023-10-02,1012,Body Lotion,200,400,200,2,00267,India
687449,2023-10-02,1007,Eyeshadow,200,400,200,1,00056,India
687449,2023-10-02,1006,Blush,150,300,150,1,00056,India
687449,2023-10-02,1009,Moisturizer,250,500,250,2,00056,India
687449,2023-10-02,1003,Foundation,300,600,300,1,00056,India
343673,2023-10-02,1001,Lipstick,150,300,150,1,00086,India
921741,2023-10-02,1002,Mascara,200,400,200,1,00205,India
724214,2023-10-02,1005,Nail Polish,50,100,50,1,00169,India
724214,2023-10-02,1012,Body Lotion,200,400,200,2,00169,India
583581,2023-10-02,1003,Foundation,300,600,300,1,00120,India
583581,2023-10-02,1007,Eyeshadow,200,400,200,1,00120,India
821040,2023-10-02,1012,Body Lotion,200,400,200,2,00040,India
821040,2023-10-02,1009,Moisturizer,250,500,250,2,00040,India
821040,2023-10-02,1005,Nail Polish,50,100,50,1,00040,India
821040,2023-10-02,1006,Blush,150,300,150,1,00040,India
494161,2023-10-02,1006,Blush,150,300,150,1,00060,India
494161,2023-10-02,1001,Lipstick,150,300,150,1,00060,India
494161,2023-10-02,1009,Moisturizer,250,500,250,2,00060,India
641777,2023-10-02,1002,Mascara,200,400,200,1,00169,India
481890,2023-10-02,1004,Eyeliner,100,200,100,1,00404,India
481890,2023-10-02,1001,Lipstick,150,300,150,1,00404,India
481890,2023-10-02,1002,Mascara,200,400,200,1,00404,India
772653,2023-10-02,1003,Foundation,300,600,300,1,00107,India
772653,2023-10-02,1009,Moisturizer,250,500,250,2,00107,India
772653,2023-10-02,1002,Mascara,200,400,200,1,00107,India
230709,2023-10-02,1007,Eyeshadow,200,400,200,1,00087,India
862841,2023-10-02,1001,Lipstick,150,300,150,1,00199,India
862841,2023-10-02,1004,Eyeliner,100,200,100,1,00199,India
862841,2023-10-02,1007,Eyeshadow,200,400,200,1,00199,India
635923,2023-10-02,1004,Eyeliner,100,200,100,1,00412,India
635923,2023-10-02,1009,Moisturizer,250,500,250,2,00412,India
635923,2023-10-02,1006,Blush,150,300,150,1,00412,India
635923,2023-10-02,1007,Eyeshadow,200,400,200,1,00412,India
107850,2023-10-02,1008,Makeup Remover,80,160,80,1,00051,India
107850,2023-10-02,1001,Lipstick,150,300,150,1,00051,India
495590,2023-10-02,1004,Eyeliner,100,200,100,1,00182,India
495590,2023-10-02,1007,Eyeshadow,200,400,200,1,00182,India
495590,2023-10-02,1012,Body Lotion,200,400,200,2,00182,India
495590,2023-10-02,1009,Moisturizer,250,500,250,2,00182,India
495590,2023-10-02,1006,Blush,150,300,150,1,00182,India
117223,2023-10-03,1001,Lipstick,150,300,150,1,00261,India
806632,2023-10-03,1009,Moisturizer,250,500,250,2,00047,India
408225,2023-10-03,1005,Nail Polish,50,100,50,1,00157,India
408225,2023-10-03,1002,Mascara,200,400,200,1,00157,India
408225,2023-10-03,1012,Body Lotion,200,400,200,2,00157,India
555399,2023-10-03,1006,Blush,150,300,150,1,00088,India
555399,2023-10-03,1002,Mascara,200,400,200,1,00088,India
555399,2023-10-03,1012,Body Lotion,200,400,200,2,00088,India
932772,2023-10-03,1002,Mascara,200,400,200,1,00276,India
932772,2023-10-03,1004,Eyeliner,100,200,100,1,00276,India
462235,2023-10-03,1006,Blush,150,300,150,1,00343,India
462235,2023-10-03,1005,Nail Polish,50,100,50,1,00343,India
614154,2023-10-03,1007,Eyeshadow,200,400,200,1,00098,India
614154,2023-10-03,1005,Nail Polish,50,100,50,1,00098,India
697877,2023-10-03,1008,Makeup Remover,80,160,80,1,00175,India
697877,2023-10-03,1006,Blush,150,300,150,1,00175,India
697877,2023-10-03,1003,Foundation,300,600,300,1,00175,India
697877,2023-10-03,1005,Nail Polish,50,100,50,1,00175,India
697877,2023-10-03,1007,Eyeshadow,200,400,200,1,00175,India
384077,2023-10-03,1008,Makeup Remover,80,160,80,1,00317,India
384077,2023-10-03,1006,Blush,150,300,150,1,00317,India
384077,2023-10-03,1007,Eyeshadow,200,400,200,1,00317,India
664269,2023-10-03,1002,Mascara,200,400,200,1,00407,India
664269,2023-10-03,1012,Body Lotion,200,400,200,2,00407,India
122728,2023-10-03,1012,Body Lotion,200,400,200,2,00065,India
122728,2023-10-03,1005,Nail Polish,50,100,50,1,00065,India
139097,2023-10-03,1008,Makeup Remover,80,160,80,1,00163,India
139097,2023-10-03,1009,Moisturizer,250,500,250,2,00163,India
139097,2023-10-03,1012,Body Lotion,200,400,200,2,00163,India
139097,2023-10-03,1005,Nail Polish,50,100,50,1,00163,India
525167,2023-10-03,1001,Lipstick,150,300,150,1,00466,India
525167,2023-10-03,1009,Moisturizer,250,500,250,2,00466,India
350790,2023-10-03,1004,Eyeliner,100,200,100,1,00119,India
875442,2023-10-03,1008,Makeup Remover,80,160,80,1,00081,India
270738,2023-10-03,1012,Body Lotion,200,400,200,2,00277,India
669978,2023-10-03,1005,Nail Polish,50,100,50,1,00041,India
669978,2023-10-03,1006,Blush,150,300,150,1,00041,India
669978,2023-10-03,1009,Moisturizer,250,500,250,2,00041,India
725230,2023-10-03,1001,Lipstick,150,300,150,1,00323,India
725230,2023-10-03,1009,Moisturizer,250,500,250,2,00323,India
725230,2023-10-03,1002,Mascara,200,400,200,1,00323,India
571824,2023-10-03,1012,Body Lotion,200,400,200,2,00119,India
571824,2023-10-03,1006,Blush,150,300,150,1,00119,India
571824,2023-10-03,1002,Mascara,200,400,200,1,00119,India
571824,2023-10-03,1007,Eyeshadow,200,400,200,1,00119,India
197232,2023-10-03,1006,Blush,150,300,150,1,00400,India
197232,2023-10-03,1005,Nail Polish,50,100,50,1,00400,India
197232,2023-10-03,1009,Moisturizer,250,500,250,2,00400,India
355506,2023-10-03,1005,Nail Polish,50,100,50,1,00058,India
355506,2023-10-03,1008,Makeup Remover,80,160,80,1,00058,India
355506,2023-10-03,1003,Foundation,300,600,300,1,00058,India
355506,2023-10-03,1004,Eyeliner,100,200,100,1,00058,India
222154,2023-10-03,1005,Nail Polish,50,100,50,1,00126,India
222154,2023-10-03,1002,Mascara,200,400,200,1,00126,India
222154,2023-10-03,1008,Makeup Remover,80,160,80,1,00126,India
222154,2023-10-03,1006,Blush,150,300,150,1,00126,India
376595,2023-10-03,1009,Moisturizer,250,500,250,2,00054,India
376595,2023-10-03,1007,Eyeshadow,200,400,200,1,00054,India
609456,2023-10-03,1003,Foundation,300,600,300,1,00141,India
609456,2023-10-03,1012,Body Lotion,200,400,200,2,00141,India
609456,2023-10-03,1005,Nail Polish,50,100,50,1,00141,India
609456,2023-10-03,1004,Eyeliner,100,200,100,1,00141,India
686927,2023-10-03,1009,Moisturizer,250,500,250,2,00230,India
686927,2023-10-03,1008,Makeup Remover,80,160,80,1,00230,India
686927,2023-10-03,1004,Eyeliner,100,200,100,1,00230,India
686927,2023-10-03,1001,Lipstick,150,300,150,1,00230,India
748212,2023-10-03,1006,Blush,150,300,150,1,00292,India
748212,2023-10-03,1003,Foundation,300,600,300,1,00292,India
748212,2023-10-03,1008,Makeup Remover,80,160,80,1,00292,India
748212,2023-10-03,1004,Eyeliner,100,200,100,1,00292,India
414972,2023-10-03,1012,Body Lotion,200,400,200,2,00047,India
414972,2023-10-03,1008,Makeup Remover,80,160,80,1,00047,India
414972,2023-10-03,1003,Foundation,300,600,300,1,00047,India
382170,2023-10-03,1002,Mascara,200,400,200,1,00463,India
382170,2023-10-03,1001,Lipstick,150,300,150,1,00463,India
805445,2023-10-03,1003,Foundation,300,600,300,1,00487,India
805445,2023-10-03,1002,Mascara,200,400,200,1,00487,India
805445,2023-10-03,1005,Nail Polish,50,100,50,1,00487,India
375292,2023-10-03,1001,Lipstick,150,300,150,1,00046,India
375292,2023-10-03,1008,Makeup Remover,80,160,80,1,00046,India
375292,2023-10-03,1007,Eyeshadow,200,400,200,1,00046,India
375292,2023-10-03,1002,Mascara,200,400,200,1,00046,India
154844,2023-10-03,1008,Makeup Remover,80,160,80,1,00122,India
154844,2023-10-03,1001,Lipstick,150,300,150,1,00122,India
703720,2023-10-03,1005,Nail Polish,50,100,50,1,00011,India
227526,2023-10-03,1008,Makeup Remover,80,160,80,1,00394,India
227526,2023-10-03,1002,Mascara,200,400,200,1,00394,India
227526,2023-10-03,1007,Eyeshadow,200,400,200,1,00394,India
128712,2023-10-03,1006,Blush,150,300,150,1,00197,India
128712,2023-10-03,1008,Makeup Remover,80,160,80,1,00197,India
707138,2023-10-03,1008,Makeup Remover,80,160,80,1,00190,India
707138,2023-10-03,1009,Moisturizer,250,500,250,2,00190,India
707138,2023-10-03,1004,Eyeliner,100,200,100,1,00190,India
262418,2023-10-03,1003,Foundation,300,600,300,1,00031,India
262418,2023-10-03,1008,Makeup Remover,80,160,80,1,00031,India
262418,2023-10-03,1002,Mascara,200,400,200,1,00031,India
863851,2023-10-03,1004,Eyeliner,100,200,100,1,00253,India
863851,2023-10-03,1005,Nail Polish,50,100,50,1,00253,India
863851,2023-10-03,1001,Lipstick,150,300,150,1,00253,India
112152,2023-10-03,1007,Eyeshadow,200,400,200,1,00464,India
112152,2023-10-03,1001,Lipstick,150,300,150,1,00464,India
112152,2023-10-03,1002,Mascara,200,400,200,1,00464,India
245796,2023-10-03,1003,Foundation,300,600,300,1,00175,India
245796,2023-10-03,1007,Eyeshadow,200,400,200,1,00175,India
245796,2023-10-03,1008,Makeup Remover,80,160,80,1,00175,India
245796,2023-10-03,1012,Body Lotion,200,400,200,2,00175,India
146664,2023-10-03,1009,Moisturizer,250,500,250,2,00001,India
146664,2023-10-03,1012,Body Lotion,200,400,200,2,00001,India
229058,2023-10-03,1005,Nail Polish,50,100,50,1,00272,India
229058,2023-10-03,1006,Blush,150,300,150,1,00272,India
229058,2023-10-03,1001,Lipstick,150,300,150,1,00272,India
337435,2023-10-03,1005,Nail Polish,50,100,50,1,00278,India
346047,2023-10-03,1002,Mascara,200,400,200,1,00304,India
346047,2023-10-03,1007,Eyeshadow,200,400,200,1,00304,India
346047,2023-10-03,1009,Moisturizer,250,500,250,2,00304,India
346047,2023-10-03,1006,Blush,150,300,150,1,00304,India
895879,2023-10-03,1001,Lipstick,150,300,150,1,00134,India
895879,2023-10-03,1003,Foundation,300,600,300,1,00134,India
375576,2023-10-03,1003,Foundation,300,600,300,1,00223,India
375576,2023-10-03,1004,Eyeliner,100,200,100,1,00223,India
375576,2023-10-03,1012,Body Lotion,200,400,200,2,00223,India
375576,2023-10-03,1009,Moisturizer,250,500,250,2,00223,India
450322,2023-10-03,1002,Mascara,200,400,200,1,00211,India
450322,2023-10-03,1007,Eyeshadow,200,400,200,1,00211,India
450322,2023-10-03,1005,Nail Polish,50,100,50,1,00211,India
450322,2023-10-03,1009,Moisturizer,250,500,250,2,00211,India
623386,2023-10-03,1007,Eyeshadow,200,400,200,1,00138,India
623386,2023-10-03,1006,Blush,150,300,150,1,00138,India
325965,2023-10-03,1005,Nail Polish,50,100,50,1,00168,India
325965,2023-10-03,1009,Moisturizer,250,500,250,2,00168,India
629557,2023-10-04,1008,Makeup Remover,80,160,80,1,00461,India
629557,2023-10-04,1012,Body Lotion,200,400,200,2,00461,India
629557,2023-10-04,1001,Lipstick,150,300,150,1,00461,India
110314,2023-10-04,1003,Foundation,300,600,300,1,00342,India
628968,2023-10-04,1007,Eyeshadow,200,400,200,1,00056,India
186304,2023-10-04,1012,Body Lotion,200,400,200,2,00446,India
186304,2023-10-04,1004,Eyeliner,100,200,100,1,00446,India
730023,2023-10-04,1001,Lipstick,150,300,150,1,00106,India
259715,2023-10-04,1004,Eyeliner,100,200,100,1,00204,India
259715,2023-10-04,1002,Mascara,200,400,200,1,00204,India
259715,2023-10-04,1009,Moisturizer,250,500,250,2,00204,India
259715,2023-10-04,1006,Blush,150,300,150,1,00204,India
259715,2023-10-04,1012,Body Lotion,200,400,200,2,00204,India
814053,2023-10-04,1001,Lipstick,150,300,150,1,00257,India
814053,2023-10-04,1009,Moisturizer,250,500,250,2,00257,India
814053,2023-10-04,1005,Nail Polish,50,100,50,1,00257,India
814053,2023-10-04,1006,Blush,150,300,150,1,00257,India
814053,2023-10-04,1008,Makeup Remover,80,160,80,1,00257,India
458376,2023-10-04,1003,Foundation,300,600,300,1,00414,India
458376,2023-10-04,1005,Nail Polish,50,100,50,1,00414,India
458376,2023-10-04,1002,Mascara,200,400,200,1,00414,India
758242,2023-10-04,1009,Moisturizer,250,500,250,2,00023,India
758242,2023-10-04,1001,Lipstick,150,300,150,1,00023,India
758242,2023-10-04,1002,Mascara,200,400,200,1,00023,India
353995,2023-10-04,1012,Body Lotion,200,400,200,2,00491,India
442111,2023-10-04,1012,Body Lotion,200,400,200,2,00485,India
442111,2023-10-04,1009,Moisturizer,250,500,250,2,00485,India
442111,2023-10-04,1006,Blush,150,300,150,1,00485,India
214029,2023-10-04,1009,Moisturizer,250,500,250,2,00336,India
214029,2023-10-04,1003,Foundation,300,600,300,1,00336,India
214029,2023-10-04,1006,Blush,150,300,150,1,00336,India
882038,2023-10-04,1004,Eyeliner,100,200,100,1,00461,India
882038,2023-10-04,1007,Eyeshadow,200,400,200,1,00461,India
882038,2023-10-04,1003,Foundation,300,600,300,1,00461,India
722223,2023-10-04,1007,Eyeshadow,200,400,200,1,00356,India
747197,2023-10-04,1012,Body Lotion,200,400,200,2,00384,India
747197,2023-10-04,1004,Eyeliner,100,200,100,1,00384,India
747197,2023-10-04,1008,Makeup Remover,80,160,80,1,00384,India
562144,2023-10-04,1008,Makeup Remover,80,160,80,1,00149,India
562144,2023-10-04,1001,Lipstick,150,300,150,1,00149,India
562144,2023-10-04,1006,Blush,150,300,150,1,00149,India
809730,2023-10-04,1007,Eyeshadow,200,400,200,1,00338,India
743998,2023-10-04,1001,Lipstick,150,300,150,1,00436,India
743998,2023-10-04,1003,Foundation,300,600,300,1,00436,India
635442,2023-10-04,1002,Mascara,200,400,200,1,00305,India
635442,2023-10-04,1005,Nail Polish,50,100,50,1,00305,India
635442,2023-10-04,1006,Blush,150,300,150,1,00305,India
635442,2023-10-04,1007,Eyeshadow,200,400,200,1,00305,India
507848,2023-10-04,1008,Makeup Remover,80,160,80,1,00466,India
507848,2023-10-04,1006,Blush,150,300,150,1,00466,India
912473,2023-10-04,1012,Body Lotion,200,400,200,2,00042,India
912473,2023-10-04,1001,Lipstick,150,300,150,1,00042,India
912473,2023-10-04,1004,Eyeliner,100,200,100,1,00042,India
935557,2023-10-04,1005,Nail Polish,50,100,50,1,00337,India
935557,2023-10-04,1006,Blush,150,300,150,1,00337,India
935557,2023-10-04,1002,Mascara,200,400,200,1,00337,India
935557,2023-10-04,1008,Makeup Remover,80,160,80,1,00337,India
135519,2023-10-04,1004,Eyeliner,100,200,100,1,00187,India
135519,2023-10-04,1012,Body Lotion,200,400,200,2,00187,India
328658,2023-10-04,1007,Eyeshadow,200,400,200,1,00495,India
328658,2023-10-04,1004,Eyeliner,100,200,100,1,00495,India
328658,2023-10-04,1012,Body Lotion,200,400,200,2,00495,India
671403,2023-10-04,1003,Foundation,300,600,300,1,00244,India
671403,2023-10-04,1008,Makeup Remover,80,160,80,1,00244,India
854469,2023-10-04,1008,Makeup Remover,80,160,80,1,00477,India
854469,2023-10-04,1002,Mascara,200,400,200,1,00477,India
815023,2023-10-04,1002,Mascara,200,400,200,1,00172,India
815023,2023-10-04,1004,Eyeliner,100,200,100,1,00172,India
815023,2023-10-04,1009,Moisturizer,250,500,250,2,00172,India
815023,2023-10-04,1003,Foundation,300,600,300,1,00172,India
997840,2023-10-04,1004,Eyeliner,100,200,100,1,00248,India
997840,2023-10-04,1008,Makeup Remover,80,160,80,1,00248,India
997840,2023-10-04,1005,Nail Polish,50,100,50,1,00248,India
997840,2023-10-04,1001,Lipstick,150,300,150,1,00248,India
845270,2023-10-04,1005,Nail Polish,50,100,50,1,00372,India
845270,2023-10-04,1009,Moisturizer,250,500,250,2,00372,India
845270,2023-10-04,1006,Blush,150,300,150,1,00372,India
845270,2023-10-04,1007,Eyeshadow,200,400,200,1,00372,India
479701,2023-10-04,1002,Mascara,200,400,200,1,00045,India
479701,2023-10-04,1006,Blush,150,300,150,1,00045,India
479701,2023-10-04,1007,Eyeshadow,200,400,200,1,00045,India
647160,2023-10-04,1001,Lipstick,150,300,150,1,00012,India
647160,2023-10-04,1007,Eyeshadow,200,400,200,1,00012,India
952796,2023-10-04,1004,Eyeliner,100,200,100,1,00479,India
952796,2023-10-04,1005,Nail Polish,50,100,50,1,00479,India
972905,2023-10-04,1012,Body Lotion,200,400,200,2,00455,India
972905,2023-10-04,1008,Makeup Remover,80,160,80,1,00455,India
287382,2023-10-04,1007,Eyeshadow,200,400,200,1,00060,India
287382,2023-10-04,1003,Foundation,300,600,300,1,00060,India
925386,2023-10-04,1012,Body Lotion,200,400,200,2,00135,India
925386,2023-10-04,1009,Moisturizer,250,500,250,2,00135,India
925386,2023-10-04,1005,Nail Polish,50,100,50,1,00135,India
821106,2023-10-04,1008,Makeup Remover,80,160,80,1,00199,India
821106,2023-10-04,1006,Blush,150,300,150,1,00199,India
821106,2023-10-04,1012,Body Lotion,200,400,200,2,00199,India
939353,2023-10-04,1004,Eyeliner,100,200,100,1,00052,India
939353,2023-10-04,1007,Eyeshadow,200,400,200,1,00052,India
939353,2023-10-04,1009,Moisturizer,250,500,250,2,00052,India
939353,2023-10-04,1005,Nail Polish,50,100,50,1,00052,India
759522,2023-10-04,1003,Foundation,300,600,300,1,00432,India
759522,2023-10-04,1001,Lipstick,150,300,150,1,00432,India
759522,2023-10-04,1004,Eyeliner,100,200,100,1,00432,India
921318,2023-10-04,1003,Foundation,300,600,300,1,00344,India
921318,2023-10-04,1007,Eyeshadow,200,400,200,1,00344,India
674872,2023-10-04,1007,Eyeshadow,200,400,200,1,00224,India
210695,2023-10-04,1003,Foundation,300,600,300,1,00330,India
210695,2023-10-04,1005,Nail Polish,50,100,50,1,00330,India
210695,2023-10-04,1012,Body Lotion,200,400,200,2,00330,India
802479,2023-10-05,1006,Blush,150,300,150,1,00342,India
391116,2023-10-05,1004,Eyeliner,100,200,100,1,00048,India
391116,2023-10-05,1009,Moisturizer,250,500,250,2,00048,India
391116,2023-10-05,1007,Eyeshadow,200,400,200,1,00048,India
533586,2023-10-05,1002,Mascara,200,400,200,1,00274,India
533586,2023-10-05,1006,Blush,150,300,150,1,00274,India
507675,2023-10-05,1008,Makeup Remover,80,160,80,1,00068,India
507675,2023-10-05,1005,Nail Polish,50,100,50,1,00068,India
507675,2023-10-05,1006,Blush,150,300,150,1,00068,India
507675,2023-10-05,1001,Lipstick,150,300,150,1,00068,India
865493,2023-10-05,1009,Moisturizer,250,500,250,2,00035,India
865493,2023-10-05,1005,Nail Polish,50,100,50,1,00035,India
348223,2023-10-05,1004,Eyeliner,100,200,100,1,00257,India
348223,2023-10-05,1005,Nail Polish,50,100,50,1,00257,India
348223,2023-10-05,1003,Foundation,300,600,300,1,00257,India
313484,2023-10-05,1009,Moisturizer,250,500,250,2,00089,India
374574,2023-10-05,1002,Mascara,200,400,200,1,00468,India
374574,2023-10-05,1007,Eyeshadow,200,400,200,1,00468,India
374574,2023-10-05,1005,Nail Polish,50,100,50,1,00468,India
433911,2023-10-05,1006,Blush,150,300,150,1,00218,India
433911,2023-10-05,1003,Foundation,300,600,300,1,00218,India
433911,2023-10-05,1001,Lipstick,150,300,150,1,00218,India
433911,2023-10-05,1008,Makeup Remover,80,160,80,1,00218,India
924228,2023-10-05,1001,Lipstick,150,300,150,1,00304,India
924228,2023-10-05,1007,Eyeshadow,200,400,200,1,00304,India
924228,2023-10-05,1002,Mascara,200,400,200,1,00304,India
827163,2023-10-05,1001,Lipstick,150,300,150,1,00339,India
827163,2023-10-05,1007,Eyeshadow,200,400,200,1,00339,India
364865,2023-10-05,1001,Lipstick,150,300,150,1,00338,India
364865,2023-10-05,1002,Mascara,200,400,200,1,00338,India
364865,2023-10-05,1005,Nail Polish,50,100,50,1,00338,India
761802,2023-10-05,1007,Eyeshadow,200,400,200,1,00087,India
761802,2023-10-05,1003,Foundation,300,600,300,1,00087,India
761802,2023-10-05,1004,Eyeliner,100,200,100,1,00087,India
796722,2023-10-05,1007,Eyeshadow,200,400,200,1,00418,India
796722,2023-10-05,1004,Eyeliner,100,200,100,1,00418,India
796722,2023-10-05,1002,Mascara,200,400,200,1,00418,India
662275,2023-10-05,1003,Foundation,300,600,300,1,00394,India
399548,2023-10-05,1008,Makeup Remover,80,160,80,1,00305,India
399548,2023-10-05,1012,Body Lotion,200,400,200,2,00305,India
399548,2023-10-05,1005,Nail Polish,50,100,50,1,00305,India
341259,2023-10-05,1004,Eyeliner,100,200,100,1,00142,India
770278,2023-10-05,1001,Lipstick,150,300,150,1,00450,India
770278,2023-10-05,1002,Mascara,200,400,200,1,00450,India
452035,2023-10-05,1008,Makeup Remover,80,160,80,1,00391,India
690776,2023-10-05,1012,Body Lotion,200,400,200,2,00173,India
361108,2023-10-05,1006,Blush,150,300,150,1,00013,India
361108,2023-10-05,1005,Nail Polish,50,100,50,1,00013,India
549190,2023-10-05,1005,Nail Polish,50,100,50,1,00273,India
549190,2023-10-05,1006,Blush,150,300,150,1,00273,India
549190,2023-10-05,1007,Eyeshadow,200,400,200,1,00273,India
601291,2023-10-05,1008,Makeup Remover,80,160,80,1,00130,India
601291,2023-10-05,1002,Mascara,200,400,200,1,00130,India
601291,2023-10-05,1003,Foundation,300,600,300,1,00130,India
601291,2023-10-05,1012,Body Lotion,200,400,200,2,00130,India
489016,2023-10-05,1012,Body Lotion,200,400,200,2,00471,India
489016,2023-10-05,1003,Foundation,300,600,300,1,00471,India
489016,2023-10-05,1005,Nail Polish,50,100,50,1,00471,India
525930,2023-10-05,1009,Moisturizer,250,500,250,2,00213,India
570429,2023-10-05,1008,Makeup Remover,80,160,80,1,00002,India
570429,2023-10-05,1003,Foundation,300,600,300,1,00002,India
933465,2023-10-05,1007,Eyeshadow,200,400,200,1,00198,India
933465,2023-10-05,1008,Makeup Remover,80,160,80,1,00198,India
933465,2023-10-05,1006,Blush,150,300,150,1,00198,India
138069,2023-10-05,1005,Nail Polish,50,100,50,1,00346,India
138069,2023-10-05,1008,Makeup Remover,80,160,80,1,00346,India
138069,2023-10-05,1009,Moisturizer,250,500,250,2,00346,India
138069,2023-10-05,1002,Mascara,200,400,200,1,00346,India
513652,2023-10-05,1008,Makeup Remover,80,160,80,1,00137,India
513652,2023-10-05,1006,Blush,150,300,150,1,00137,India
764096,2023-10-05,1002,Mascara,200,400,200,1,00176,India
764096,2023-10-05,1001,Lipstick,150,300,150,1,00176,India
764096,2023-10-05,1006,Blush,150,300,150,1,00176,India
764096,2023-10-05,1009,Moisturizer,250,500,250,2,00176,India
256290,2023-10-05,1001,Lipstick,150,300,150,1,00013,India
256290,2023-10-05,1006,Blush,150,300,150,1,00013,India
256290,2023-10-05,1004,Eyeliner,100,200,100,1,00013,India
256290,2023-10-05,1002,Mascara,200,400,200,1,00013,India
557966,2023-10-05,1003,Foundation,300,600,300,1,00317,India
557966,2023-10-05,1006,Blush,150,300,150,1,00317,India
598881,2023-10-05,1006,Blush,150,300,150,1,00271,India
598881,2023-10-05,1004,Eyeliner,100,200,100,1,00271,India
437745,2023-10-05,1002,Mascara,200,400,200,1,00161,India
491725,2023-10-05,1005,Nail Polish,50,100,50,1,00234,India
563869,2023-10-05,1007,Eyeshadow,200,400,200,1,00095,India
563869,2023-10-05,1012,Body Lotion,200,400,200,2,00095,India
563869,2023-10-05,1005,Nail Polish,50,100,50,1,00095,India
563869,2023-10-05,1002,Mascara,200,400,200,1,00095,India
195390,2023-10-05,1008,Makeup Remover,80,160,80,1,00265,India
195390,2023-10-05,1001,Lipstick,150,300,150,1,00265,India
195390,2023-10-05,1006,Blush,150,300,150,1,00265,India
882377,2023-10-05,1012,Body Lotion,200,400,200,2,00346,India
882377,2023-10-05,1006,Blush,150,300,150,1,00346,India
642797,2023-10-05,1012,Body Lotion,200,400,200,2,00141,India
642797,2023-10-05,1001,Lipstick,150,300,150,1,00141,India
419043,2023-10-05,1002,Mascara,200,400,200,1,00361,India
457602,2023-10-06,1012,Body Lotion,200,400,200,2,00290,India
457602,2023-10-06,1001,Lipstick,150,300,150,1,00290,India
718378,2023-10-06,1001,Lipstick,150,300,150,1,00193,India
718378,2023-10-06,1003,Foundation,300,600,300,1,00193,India
392396,2023-10-06,1006,Blush,150,300,150,1,00401,India
392396,2023-10-06,1012,Body Lotion,200,400,200,2,00401,India
392396,2023-10-06,1008,Makeup Remover,80,160,80,1,00401,India
344829,2023-10-06,1007,Eyeshadow,200,400,200,1,00235,India
344829,2023-10-06,1009,Moisturizer,250,500,250,2,00235,India
344829,2023-10-06,1003,Foundation,300,600,300,1,00235,India
594670,2023-10-06,1005,Nail Polish,50,100,50,1,00320,India
594670,2023-10-06,1004,Eyeliner,100,200,100,1,00320,India
594670,2023-10-06,1009,Moisturizer,250,500,250,2,00320,India
816409,2023-10-06,1001,Lipstick,150,300,150,1,00123,India
816409,2023-10-06,1004,Eyeliner,100,200,100,1,00123,India
816409,2023-10-06,1005,Nail Polish,50,100,50,1,00123,India
816409,2023-10-06,1007,Eyeshadow,200,400,200,1,00123,India
816409,2023-10-06,1008,Makeup Remover,80,160,80,1,00123,India
125414,2023-10-06,1002,Mascara,200,400,200,1,00181,India
125414,2023-10-06,1012,Body Lotion,200,400,200,2,00181,India
125414,2023-10-06,1001,Lipstick,150,300,150,1,00181,India
125414,2023-10-06,1009,Moisturizer,250,500,250,2,00181,India
599057,2023-10-06,1006,Blush,150,300,150,1,00234,India
599057,2023-10-06,1002,Mascara,200,400,200,1,00234,India
599057,2023-10-06,1008,Makeup Remover,80,160,80,1,00234,India
297969,2023-10-06,1009,Moisturizer,250,500,250,2,00410,India
297969,2023-10-06,1005,Nail Polish,50,100,50,1,00410,India
613952,2023-10-06,1003,Foundation,300,600,300,1,00423,India
819136,2023-10-06,1004,Eyeliner,100,200,100,1,00073,India
819136,2023-10-06,1001,Lipstick,150,300,150,1,00073,India
433866,2023-10-06,1009,Moisturizer,250,500,250,2,00074,India
204785,2023-10-06,1008,Makeup Remover,80,160,80,1,00180,India
204785,2023-10-06,1003,Foundation,300,600,300,1,00180,India
204785,2023-10-06,1007,Eyeshadow,200,400,200,1,00180,India
857988,2023-10-06,1012,Body Lotion,200,400,200,2,00138,India
857988,2023-10-06,1008,Makeup Remover,80,160,80,1,00138,India
136868,2023-10-06,1008,Makeup Remover,80,160,80,1,00201,India
136868,2023-10-06,1005,Nail Polish,50,100,50,1,00201,India
136868,2023-10-06,1006,Blush,150,300,150,1,00201,India
136868,2023-10-06,1007,Eyeshadow,200,400,200,1,00201,India
659843,2023-10-06,1005,Nail Polish,50,100,50,1,00297,India
659843,2023-10-06,1001,Lipstick,150,300,150,1,00297,India
659843,2023-10-06,1009,Moisturizer,250,500,250,2,00297,India
659843,2023-10-06,1006,Blush,150,300,150,1,00297,India
659843,2023-10-06,1003,Foundation,300,600,300,1,00297,India
971062,2023-10-06,1008,Makeup Remover,80,160,80,1,00452,India
412123,2023-10-06,1004,Eyeliner,100,200,100,1,00270,India
412123,2023-10-06,1001,Lipstick,150,300,150,1,00270,India
412123,2023-10-06,1012,Body Lotion,200,400,200,2,00270,India
602578,2023-10-06,1007,Eyeshadow,200,400,200,1,00084,India
602578,2023-10-06,1006,Blush,150,300,150,1,00084,India
602578,2023-10-06,1001,Lipstick,150,300,150,1,00084,India
602578,2023-10-06,1009,Moisturizer,250,500,250,2,00084,India
999161,2023-10-06,1006,Blush,150,300,150,1,00289,India
999161,2023-10-06,1005,Nail Polish,50,100,50,1,00289,India
639575,2023-10-06,1009,Moisturizer,250,500,250,2,00139,India
514936,2023-10-06,1005,Nail Polish,50,100,50,1,00350,India
514936,2023-10-06,1008,Makeup Remover,80,160,80,1,00350,India
657201,2023-10-06,1008,Makeup Remover,80,160,80,1,00443,India
657201,2023-10-06,1003,Foundation,300,600,300,1,00443,India
657201,2023-10-06,1007,Eyeshadow,200,400,200,1,00443,India
657201,2023-10-06,1006,Blush,150,300,150,1,00443,India
657201,2023-10-06,1002,Mascara,200,400,200,1,00443,India
308251,2023-10-06,1008,Makeup Remover,80,160,80,1,00082,India
308251,2023-10-06,1002,Mascara,200,400,200,1,00082,India
308251,2023-10-06,1012,Body Lotion,200,400,200,2,00082,India
308251,2023-10-06,1007,Eyeshadow,200,400,200,1,00082,India
844245,2023-10-06,1002,Mascara,200,400,200,1,00202,India
473396,2023-10-06,1002,Mascara,200,400,200,1,00440,India
473396,2023-10-06,1005,Nail Polish,50,100,50,1,00440,India
473396,2023-10-06,1003,Foundation,300,600,300,1,00440,India
495289,2023-10-06,1002,Mascara,200,400,200,1,00193,India
495289,2023-10-06,1001,Lipstick,150,300,150,1,00193,India
495289,2023-10-06,1007,Eyeshadow,200,400,200,1,00193,India
432644,2023-10-06,1002,Mascara,200,400,200,1,00339,India
822674,2023-10-06,1009,Moisturizer,250,500,250,2,00118,India
822674,2023-10-06,1012,Body Lotion,200,400,200,2,00118,India
822674,2023-10-06,1005,Nail Polish,50,100,50,1,00118,India
734951,2023-10-06,1004,Eyeliner,100,200,100,1,00470,India
734951,2023-10-06,1005,Nail Polish,50,100,50,1,00470,India
734951,2023-10-06,1006,Blush,150,300,150,1,00470,India
385529,2023-10-06,1007,Eyeshadow,200,400,200,1,00250,India
475437,2023-10-06,1007,Eyeshadow,200,400,200,1,00057,India
475437,2023-10-06,1012,Body Lotion,200,400,200,2,00057,India
815858,2023-10-06,1009,Moisturizer,250,500,250,2,00296,India
815858,2023-10-06,1006,Blush,150,300,150,1,00296,India
696946,2023-10-06,1006,Blush,150,300,150,1,00349,India
696946,2023-10-06,1007,Eyeshadow,200,400,200,1,00349,India
696946,2023-10-06,1009,Moisturizer,250,500,250,2,00349,India
696946,2023-10-06,1012,Body Lotion,200,400,200,2,00349,India
347255,2023-10-06,1008,Makeup Remover,80,160,80,1,00042,India
347255,2023-10-06,1003,Foundation,300,600,300,1,00042,India
347255,2023-10-06,1012,Body Lotion,200,400,200,2,00042,India
524739,2023-10-06,1005,Nail Polish,50,100,50,1,00296,India
524739,2023-10-06,1009,Moisturizer,250,500,250,2,00296,India
290390,2023-10-06,1002,Mascara,200,400,200,1,00224,India
290390,2023-10-06,1012,Body Lotion,200,400,200,2,00224,India
290390,2023-10-06,1005,Nail Polish,50,100,50,1,00224,India
250534,2023-10-06,1001,Lipstick,150,300,150,1,00078,India
486365,2023-10-06,1007,Eyeshadow,200,400,200,1,00300,India
486365,2023-10-06,1009,Moisturizer,250,500,250,2,00300,India
486365,2023-10-06,1008,Makeup Remover,80,160,80,1,00300,India
486365,2023-10-06,1002,Mascara,200,400,200,1,00300,India
486365,2023-10-06,1005,Nail Polish,50,100,50,1,00300,India
959421,2023-10-06,1003,Foundation,300,600,300,1,00075,India
959421,2023-10-06,1006,Blush,150,300,150,1,00075,India
894715,2023-10-06,1007,Eyeshadow,200,400,200,1,00303,India
290268,2023-10-06,1008,Makeup Remover,80,160,80,1,00321,India
290268,2023-10-06,1009,Moisturizer,250,500,250,2,00321,India
290268,2023-10-06,1012,Body Lotion,200,400,200,2,00321,India
290268,2023-10-06,1005,Nail Polish,50,100,50,1,00321,India
290268,2023-10-06,1003,Foundation,300,600,300,1,00321,India
972932,2023-10-06,1009,Moisturizer,250,500,250,2,00444,India
271493,2023-10-07,1009,Moisturizer,250,500,250,2,00081,India
576520,2023-10-07,1006,Blush,150,300,150,1,00433,India
576520,2023-10-07,1005,Nail Polish,50,100,50,1,00433,India
576520,2023-10-07,1001,Lipstick,150,300,150,1,00433,India
525050,2023-10-07,1008,Makeup Remover,80,160,80,1,00351,India
863358,2023-10-07,1001,Lipstick,150,300,150,1,00264,India
863358,2023-10-07,1007,Eyeshadow,200,400,200,1,00264,India
863358,2023-10-07,1003,Foundation,300,600,300,1,00264,India
863358,2023-10-07,1006,Blush,150,300,150,1,00264,India
215201,2023-10-07,1001,Lipstick,150,300,150,1,00294,India
749751,2023-10-07,1008,Makeup Remover,80,160,80,1,00445,India
749751,2023-10-07,1006,Blush,150,300,150,1,00445,India
749751,2023-10-07,1001,Lipstick,150,300,150,1,00445,India
612522,2023-10-07,1008,Makeup Remover,80,160,80,1,00102,India
933048,2023-10-07,1002,Mascara,200,400,200,1,00094,India
933048,2023-10-07,1004,Eyeliner,100,200,100,1,00094,India
933048,2023-10-07,1012,Body Lotion,200,400,200,2,00094,India
920003,2023-10-07,1004,Eyeliner,100,200,100,1,00065,India
920003,2023-10-07,1003,Foundation,300,600,300,1,00065,India
920003,2023-10-07,1005,Nail Polish,50,100,50,1,00065,India
920003,2023-10-07,1001,Lipstick,150,300,150,1,00065,India
969081,2023-10-07,1006,Blush,150,300,150,1,00137,India
969081,2023-10-07,1007,Eyeshadow,200,400,200,1,00137,India
969081,2023-10-07,1002,Mascara,200,400,200,1,00137,India
304464,2023-10-07,1007,Eyeshadow,200,400,200,1,00418,India
304464,2023-10-07,1004,Eyeliner,100,200,100,1,00418,India
347112,2023-10-07,1008,Makeup Remover,80,160,80,1,00342,India
996280,2023-10-07,1003,Foundation,300,600,300,1,00451,India
996280,2023-10-07,1008,Makeup Remover,80,160,80,1,00451,India
996280,2023-10-07,1006,Blush,150,300,150,1,00451,India
996280,2023-10-07,1005,Nail Polish,50,100,50,1,00451,India
996280,2023-10-07,1009,Moisturizer,250,500,250,2,00451,India
389423,2023-10-07,1001,Lipstick,150,300,150,1,00122,India
767854,2023-10-07,1003,Foundation,300,600,300,1,00070,India
767854,2023-10-07,1007,Eyeshadow,200,400,200,1,00070,India
707887,2023-10-07,1007,Eyeshadow,200,400,200,1,00097,India
707887,2023-10-07,1009,Moisturizer,250,500,250,2,00097,India
710258,2023-10-07,1003,Foundation,300,600,300,1,00411,India
710258,2023-10-07,1005,Nail Polish,50,100,50,1,00411,India
710258,2023-10-07,1009,Moisturizer,250,500,250,2,00411,India
661761,2023-10-07,1008,Makeup Remover,80,160,80,1,00084,India
661761,2023-10-07,1009,Moisturizer,250,500,250,2,00084,India
936804,2023-10-07,1012,Body Lotion,200,400,200,2,00237,India
332106,2023-10-07,1002,Mascara,200,400,200,1,00313,India
332106,2023-10-07,1006,Blush,150,300,150,1,00313,India
332106,2023-10-07,1008,Makeup Remover,80,160,80,1,00313,India
332106,2023-10-07,1012,Body Lotion,200,400,200,2,00313,India
332106,2023-10-07,1003,Foundation,300,600,300,1,00313,India
950543,2023-10-07,1007,Eyeshadow,200,400,200,1,00124,India
950543,2023-10-07,1003,Foundation,300,600,300,1,00124,India
950543,2023-10-07,1004,Eyeliner,100,200,100,1,00124,India
941522,2023-10-07,1005,Nail Polish,50,100,50,1,00482,India
941522,2023-10-07,1006,Blush,150,300,150,1,00482,India
207340,2023-10-07,1005,Nail Polish,50,100,50,1,00222,India
207340,2023-10-07,1006,Blush,150,300,150,1,00222,India
392793,2023-10-07,1003,Foundation,300,600,300,1,00442,India
392793,2023-10-07,1005,Nail Polish,50,100,50,1,00442,India
392793,2023-10-07,1002,Mascara,200,400,200,1,00442,India
806231,2023-10-07,1002,Mascara,200,400,200,1,00215,India
563035,2023-10-07,1003,Foundation,300,600,300,1,00437,India
563035,2023-10-07,1009,Moisturizer,250,500,250,2,00437,India
563035,2023-10-07,1002,Mascara,200,400,200,1,00437,India
508909,2023-10-07,1008,Makeup Remover,80,160,80,1,00360,India
508909,2023-10-07,1006,Blush,150,300,150,1,00360,India
508909,2023-10-07,1012,Body Lotion,200,400,200,2,00360,India
552066,2023-10-07,1006,Blush,150,300,150,1,00074,India
552066,2023-10-07,1007,Eyeshadow,200,400,200,1,00074,India
524560,2023-10-07,1004,Eyeliner,100,200,100,1,00412,India
524560,2023-10-07,1008,Makeup Remover,80,160,80,1,00412,India
524560,2023-10-07,1007,Eyeshadow,200,400,200,1,00412,India
297380,2023-10-07,1001,Lipstick,150,300,150,1,00447,India
297380,2023-10-07,1007,Eyeshadow,200,400,200,1,00447,India
216047,2023-10-08,1008,Makeup Remover,80,160,80,1,00441,India
216047,2023-10-08,1004,Eyeliner,100,200,100,1,00441,India
216047,2023-10-08,1001,Lipstick,150,300,150,1,00441,India
385714,2023-10-08,1004,Eyeliner,100,200,100,1,00106,India
720361,2023-10-08,1006,Blush,150,300,150,1,00204,India
749625,2023-10-08,1006,Blush,150,300,150,1,00339,India
749625,2023-10-08,1002,Mascara,200,400,200,1,00339,India
749625,2023-10-08,1001,Lipstick,150,300,150,1,00339,India
749625,2023-10-08,1008,Makeup Remover,80,160,80,1,00339,India
314613,2023-10-08,1002,Mascara,200,400,200,1,00182,India
897231,2023-10-08,1007,Eyeshadow,200,400,200,1,00304,India
897231,2023-10-08,1009,Moisturizer,250,500,250,2,00304,India
897231,2023-10-08,1005,Nail Polish,50,100,50,1,00304,India
897231,2023-10-08,1003,Foundation,300,600,300,1,00304,India
897231,2023-10-08,1004,Eyeliner,100,200,100,1,00304,India
365500,2023-10-08,1001,Lipstick,150,300,150,1,00378,India
365500,2023-10-08,1006,Blush,150,300,150,1,00378,India
365500,2023-10-08,1012,Body Lotion,200,400,200,2,00378,India
840751,2023-10-08,1008,Makeup Remover,80,160,80,1,00208,India
840751,2023-10-08,1009,Moisturizer,250,500,250,2,00208,India
840751,2023-10-08,1012,Body Lotion,200,400,200,2,00208,India
840751,2023-10-08,1002,Mascara,200,400,200,1,00208,India
564597,2023-10-08,1009,Moisturizer,250,500,250,2,00015,India
402837,2023-10-08,1002,Mascara,200,400,200,1,00340,India
402837,2023-10-08,1001,Lipstick,150,300,150,1,00340,India
595242,2023-10-08,1009,Moisturizer,250,500,250,2,00040,India
391543,2023-10-08,1009,Moisturizer,250,500,250,2,00448,India
391543,2023-10-08,1001,Lipstick,150,300,150,1,00448,India
296563,2023-10-08,1004,Eyeliner,100,200,100,1,00426,India
251677,2023-10-08,1005,Nail Polish,50,100,50,1,00005,India
844982,2023-10-08,1007,Eyeshadow,200,400,200,1,00373,India
844982,2023-10-08,1009,Moisturizer,250,500,250,2,00373,India
844982,2023-10-08,1006,Blush,150,300,150,1,00373,India
844982,2023-10-08,1012,Body Lotion,200,400,200,2,00373,India
844982,2023-10-08,1003,Foundation,300,600,300,1,00373,India
682427,2023-10-08,1007,Eyeshadow,200,400,200,1,00294,India
682427,2023-10-08,1001,Lipstick,150,300,150,1,00294,India
682427,2023-10-08,1003,Foundation,300,600,300,1,00294,India
682427,2023-10-08,1006,Blush,150,300,150,1,00294,India
343401,2023-10-08,1008,Makeup Remover,80,160,80,1,00269,India
343401,2023-10-08,1006,Blush,150,300,150,1,00269,India
636874,2023-10-08,1009,Moisturizer,250,500,250,2,00421,India
636874,2023-10-08,1002,Mascara,200,400,200,1,00421,India
636874,2023-10-08,1006,Blush,150,300,150,1,00421,India
987360,2023-10-08,1002,Mascara,200,400,200,1,00278,India
987360,2023-10-08,1003,Foundation,300,600,300,1,00278,India
397029,2023-10-08,1007,Eyeshadow,200,400,200,1,00018,India
692635,2023-10-08,1004,Eyeliner,100,200,100,1,00090,India
692635,2023-10-08,1006,Blush,150,300,150,1,00090,India
692635,2023-10-08,1009,Moisturizer,250,500,250,2,00090,India
692635,2023-10-08,1003,Foundation,300,600,300,1,00090,India
143833,2023-10-08,1007,Eyeshadow,200,400,200,1,00407,India
143833,2023-10-08,1002,Mascara,200,400,200,1,00407,India
143833,2023-10-08,1008,Makeup Remover,80,160,80,1,00407,India
803529,2023-10-08,1007,Eyeshadow,200,400,200,1,00472,India
803529,2023-10-08,1001,Lipstick,150,300,150,1,00472,India
803529,2023-10-08,1005,Nail Polish,50,100,50,1,00472,India
493161,2023-10-08,1002,Mascara,200,400,200,1,00331,India
493161,2023-10-08,1007,Eyeshadow,200,400,200,1,00331,India
493161,2023-10-08,1001,Lipstick,150,300,150,1,00331,India
678853,2023-10-08,1001,Lipstick,150,300,150,1,00082,India
678853,2023-10-08,1005,Nail Polish,50,100,50,1,00082,India
573017,2023-10-08,1003,Foundation,300,600,300,1,00236,India
573017,2023-10-08,1001,Lipstick,150,300,150,1,00236,India
810975,2023-10-08,1002,Mascara,200,400,200,1,00237,India
810975,2023-10-08,1008,Makeup Remover,80,160,80,1,00237,India
810975,2023-10-08,1009,Moisturizer,250,500,250,2,00237,India
810975,2023-10-08,1005,Nail Polish,50,100,50,1,00237,India
231578,2023-10-08,1004,Eyeliner,100,200,100,1,00206,India
231578,2023-10-08,1001,Lipstick,150,300,150,1,00206,India
231578,2023-10-08,1005,Nail Polish,50,100,50,1,00206,India
231578,2023-10-08,1008,Makeup Remover,80,160,80,1,00206,India
231578,2023-10-08,1002,Mascara,200,400,200,1,00206,India
518022,2023-10-08,1009,Moisturizer,250,500,250,2,00425,India
518022,2023-10-08,1007,Eyeshadow,200,400,200,1,00425,India
931039,2023-10-08,1009,Moisturizer,250,500,250,2,00145,India
931039,2023-10-08,1002,Mascara,200,400,200,1,00145,India
931039,2023-10-08,1004,Eyeliner,100,200,100,1,00145,India
582416,2023-10-08,1005,Nail Polish,50,100,50,1,00423,India
763211,2023-10-08,1003,Foundation,300,600,300,1,00199,India
763211,2023-10-08,1009,Moisturizer,250,500,250,2,00199,India
166827,2023-10-08,1007,Eyeshadow,200,400,200,1,00452,India
166827,2023-10-08,1012,Body Lotion,200,400,200,2,00452,India
697920,2023-10-08,1001,Lipstick,150,300,150,1,00364,India
697920,2023-10-08,1006,Blush,150,300,150,1,00364,India
697920,2023-10-08,1012,Body Lotion,200,400,200,2,00364,India
583083,2023-10-08,1006,Blush,150,300,150,1,00005,India
583083,2023-10-08,1009,Moisturizer,250,500,250,2,00005,India
583083,2023-10-08,1005,Nail Polish,50,100,50,1,00005,India
583083,2023-10-08,1002,Mascara,200,400,200,1,00005,India
173432,2023-10-08,1005,Nail Polish,50,100,50,1,00350,India
173432,2023-10-08,1002,Mascara,200,400,200,1,00350,India
843328,2023-10-08,1006,Blush,150,300,150,1,00302,India
643479,2023-10-08,1003,Foundation,300,600,300,1,00294,India
643479,2023-10-08,1001,Lipstick,150,300,150,1,00294,India
486795,2023-10-09,1005,Nail Polish,50,100,50,1,00263,India
486795,2023-10-09,1003,Foundation,300,600,300,1,00263,India
869023,2023-10-09,1004,Eyeliner,100,200,100,1,00083,India
430493,2023-10-09,1008,Makeup Remover,80,160,80,1,00354,India
430493,2023-10-09,1012,Body Lotion,200,400,200,2,00354,India
978273,2023-10-09,1007,Eyeshadow,200,400,200,1,00383,India
978273,2023-10-09,1012,Body Lotion,200,400,200,2,00383,India
978273,2023-10-09,1001,Lipstick,150,300,150,1,00383,India
978273,2023-10-09,1005,Nail Polish,50,100,50,1,00383,India
986887,2023-10-09,1002,Mascara,200,400,200,1,00086,India
986887,2023-10-09,1003,Foundation,300,600,300,1,00086,India
986887,2023-10-09,1007,Eyeshadow,200,400,200,1,00086,India
986887,2023-10-09,1001,Lipstick,150,300,150,1,00086,India
862778,2023-10-09,1004,Eyeliner,100,200,100,1,00114,India
677068,2023-10-09,1003,Foundation,300,600,300,1,00302,India
484262,2023-10-09,1004,Eyeliner,100,200,100,1,00137,India
484262,2023-10-09,1012,Body Lotion,200,400,200,2,00137,India
641810,2023-10-09,1009,Moisturizer,250,500,250,2,00443,India
641810,2023-10-09,1005,Nail Polish,50,100,50,1,00443,India
641810,2023-10-09,1007,Eyeshadow,200,400,200,1,00443,India
761530,2023-10-09,1008,Makeup Remover,80,160,80,1,00374,India
761530,2023-10-09,1003,Foundation,300,600,300,1,00374,India
761530,2023-10-09,1006,Blush,150,300,150,1,00374,India
761530,2023-10-09,1007,Eyeshadow,200,400,200,1,00374,India
638944,2023-10-09,1005,Nail Polish,50,100,50,1,00357,India
638944,2023-10-09,1002,Mascara,200,400,200,1,00357,India
638944,2023-10-09,1003,Foundation,300,600,300,1,00357,India
943102,2023-10-09,1008,Makeup Remover,80,160,80,1,00308,India
943102,2023-10-09,1001,Lipstick,150,300,150,1,00308,India
272599,2023-10-09,1002,Mascara,200,400,200,1,00311,India
272599,2023-10-09,1004,Eyeliner,100,200,100,1,00311,India
980302,2023-10-09,1006,Blush,150,300,150,1,00139,India
465231,2023-10-09,1002,Mascara,200,400,200,1,00204,India
465231,2023-10-09,1005,Nail Polish,50,100,50,1,00204,India
465231,2023-10-09,1003,Foundation,300,600,300,1,00204,India
465231,2023-10-09,1012,Body Lotion,200,400,200,2,00204,India
320672,2023-10-09,1007,Eyeshadow,200,400,200,1,00432,India
320672,2023-10-09,1003,Foundation,300,600,300,1,00432,India
320672,2023-10-09,1004,Eyeliner,100,200,100,1,00432,India
141104,2023-10-09,1007,Eyeshadow,200,400,200,1,00010,India
141104,2023-10-09,1005,Nail Polish,50,100,50,1,00010,India
141104,2023-10-09,1004,Eyeliner,100,200,100,1,00010,India
141104,2023-10-09,1002,Mascara,200,400,200,1,00010,India
333111,2023-10-09,1002,Mascara,200,400,200,1,00172,India
333111,2023-10-09,1012,Body Lotion,200,400,200,2,00172,India
333111,2023-10-09,1005,Nail Polish,50,100,50,1,00172,India
716808,2023-10-09,1009,Moisturizer,250,500,250,2,00009,India
716808,2023-10-09,1008,Makeup Remover,80,160,80,1,00009,India
716808,2023-10-09,1006,Blush,150,300,150,1,00009,India
716808,2023-10-09,1001,Lipstick,150,300,150,1,00009,India
654754,2023-10-09,1002,Mascara,200,400,200,1,00488,India
654754,2023-10-09,1005,Nail Polish,50,100,50,1,00488,India
654754,2023-10-09,1001,Lipstick,150,300,150,1,00488,India
654754,2023-10-09,1006,Blush,150,300,150,1,00488,India
339259,2023-10-09,1001,Lipstick,150,300,150,1,00112,India
339259,2023-10-09,1004,Eyeliner,100,200,100,1,00112,India
339259,2023-10-09,1008,Makeup Remover,80,160,80,1,00112,India
339259,2023-10-09,1005,Nail Polish,50,100,50,1,00112,India
187098,2023-10-09,1009,Moisturizer,250,500,250,2,00004,India
187098,2023-10-09,1003,Foundation,300,600,300,1,00004,India
187098,2023-10-09,1006,Blush,150,300,150,1,00004,India
187098,2023-10-09,1008,Makeup Remover,80,160,80,1,00004,India
249037,2023-10-09,1002,Mascara,200,400,200,1,00457,India
249037,2023-10-09,1003,Foundation,300,600,300,1,00457,India
249037,2023-10-09,1009,Moisturizer,250,500,250,2,00457,India
249037,2023-10-09,1008,Makeup Remover,80,160,80,1,00457,India
822137,2023-10-09,1008,Makeup Remover,80,160,80,1,00284,India
361433,2023-10-09,1008,Makeup Remover,80,160,80,1,00201,India
361433,2023-10-09,1005,Nail Polish,50,100,50,1,00201,India
361433,2023-10-09,1006,Blush,150,300,150,1,00201,India
361433,2023-10-09,1002,Mascara,200,400,200,1,00201,India
666860,2023-10-09,1003,Foundation,300,600,300,1,00038,India
984015,2023-10-09,1005,Nail Polish,50,100,50,1,00237,India
984015,2023-10-09,1003,Foundation,300,600,300,1,00237,India
142374,2023-10-09,1001,Lipstick,150,300,150,1,00392,India
142374,2023-10-09,1003,Foundation,300,600,300,1,00392,India
142374,2023-10-09,1007,Eyeshadow,200,400,200,1,00392,India
142374,2023-10-09,1012,Body Lotion,200,400,200,2,00392,India
756854,2023-10-09,1003,Foundation,300,600,300,1,00459,India
756854,2023-10-09,1004,Eyeliner,100,200,100,1,00459,India
811391,2023-10-09,1001,Lipstick,150,300,150,1,00136,India
811391,2023-10-09,1004,Eyeliner,100,200,100,1,00136,India
811391,2023-10-09,1012,Body Lotion,200,400,200,2,00136,India
811391,2023-10-09,1002,Mascara,200,400,200,1,00136,India
785675,2023-10-09,1002,Mascara,200,400,200,1,00154,India
785675,2023-10-09,1003,Foundation,300,600,300,1,00154,India
785675,2023-10-09,1005,Nail Polish,50,100,50,1,00154,India
355842,2023-10-09,1005,Nail Polish,50,100,50,1,00011,India
355842,2023-10-09,1007,Eyeshadow,200,400,200,1,00011,India
407028,2023-10-09,1005,Nail Polish,50,100,50,1,00025,India
407028,2023-10-09,1003,Foundation,300,600,300,1,00025,India
407028,2023-10-09,1001,Lipstick,150,300,150,1,00025,India
708009,2023-10-09,1008,Makeup Remover,80,160,80,1,00371,India
708009,2023-10-09,1002,Mascara,200,400,200,1,00371,India
115732,2023-10-09,1004,Eyeliner,100,200,100,1,00191,India
115732,2023-10-09,1009,Moisturizer,250,500,250,2,00191,India
459638,2023-10-09,1009,Moisturizer,250,500,250,2,00006,India
459638,2023-10-09,1007,Eyeshadow,200,400,200,1,00006,India
459638,2023-10-09,1006,Blush,150,300,150,1,00006,India
459638,2023-10-09,1003,Foundation,300,600,300,1,00006,India
523376,2023-10-09,1001,Lipstick,150,300,150,1,00117,India
523376,2023-10-09,1008,Makeup Remover,80,160,80,1,00117,India
523376,2023-10-09,1009,Moisturizer,250,500,250,2,00117,India
523376,2023-10-09,1007,Eyeshadow,200,400,200,1,00117,India
587300,2023-10-10,1008,Makeup Remover,80,160,80,1,00242,India
587300,2023-10-10,1001,Lipstick,150,300,150,1,00242,India
587300,2023-10-10,1003,Foundation,300,600,300,1,00242,India
587300,2023-10-10,1007,Eyeshadow,200,400,200,1,00242,India
587300,2023-10-10,1002,Mascara,200,400,200,1,00242,India
109702,2023-10-10,1007,Eyeshadow,200,400,200,1,00054,India
109702,2023-10-10,1002,Mascara,200,400,200,1,00054,India
235196,2023-10-10,1009,Moisturizer,250,500,250,2,00011,India
235196,2023-10-10,1001,Lipstick,150,300,150,1,00011,India
235196,2023-10-10,1002,Mascara,200,400,200,1,00011,India
235196,2023-10-10,1007,Eyeshadow,200,400,200,1,00011,India
843200,2023-10-10,1009,Moisturizer,250,500,250,2,00197,India
445532,2023-10-10,1001,Lipstick,150,300,150,1,00423,India
445532,2023-10-10,1004,Eyeliner,100,200,100,1,00423,India
585665,2023-10-10,1002,Mascara,200,400,200,1,00418,India
607486,2023-10-10,1005,Nail Polish,50,100,50,1,00313,India
743005,2023-10-10,1001,Lipstick,150,300,150,1,00325,India
743005,2023-10-10,1003,Foundation,300,600,300,1,00325,India
743005,2023-10-10,1002,Mascara,200,400,200,1,00325,India
592423,2023-10-10,1003,Foundation,300,600,300,1,00327,India
592423,2023-10-10,1001,Lipstick,150,300,150,1,00327,India
592423,2023-10-10,1012,Body Lotion,200,400,200,2,00327,India
899584,2023-10-10,1009,Moisturizer,250,500,250,2,00423,India
226206,2023-10-10,1002,Mascara,200,400,200,1,00161,India
551020,2023-10-10,1007,Eyeshadow,200,400,200,1,00077,India
551020,2023-10-10,1005,Nail Polish,50,100,50,1,00077,India
551020,2023-10-10,1002,Mascara,200,400,200,1,00077,India
739191,2023-10-10,1007,Eyeshadow,200,400,200,1,00074,India
739191,2023-10-10,1005,Nail Polish,50,100,50,1,00074,India
739191,2023-10-10,1001,Lipstick,150,300,150,1,00074,India
739191,2023-10-10,1004,Eyeliner,100,200,100,1,00074,India
739191,2023-10-10,1008,Makeup Remover,80,160,80,1,00074,India
275901,2023-10-10,1007,Eyeshadow,200,400,200,1,00134,India
301689,2023-10-10,1002,Mascara,200,400,200,1,00025,India
301689,2023-10-10,1012,Body Lotion,200,400,200,2,00025,India
301689,2023-10-10,1006,Blush,150,300,150,1,00025,India
943334,2023-10-10,1008,Makeup Remover,80,160,80,1,00053,India
943334,2023-10-10,1007,Eyeshadow,200,400,200,1,00053,India
943334,2023-10-10,1003,Foundation,300,600,300,1,00053,India
327826,2023-10-10,1008,Makeup Remover,80,160,80,1,00274,India
327826,2023-10-10,1004,Eyeliner,100,200,100,1,00274,India
327826,2023-10-10,1003,Foundation,300,600,300,1,00274,India
376717,2023-10-10,1003,Foundation,300,600,300,1,00481,India
369369,2023-10-10,1005,Nail Polish,50,100,50,1,00321,India
369369,2023-10-10,1009,Moisturizer,250,500,250,2,00321,India
582799,2023-10-10,1008,Makeup Remover,80,160,80,1,00158,India
582799,2023-10-10,1004,Eyeliner,100,200,100,1,00158,India
186934,2023-10-10,1004,Eyeliner,100,200,100,1,00150,India
186934,2023-10-10,1008,Makeup Remover,80,160,80,1,00150,India
186934,2023-10-10,1012,Body Lotion,200,400,200,2,00150,India
186934,2023-10-10,1001,Lipstick,150,300,150,1,00150,India
774803,2023-10-10,1008,Makeup Remover,80,160,80,1,00097,India
774803,2023-10-10,1005,Nail Polish,50,100,50,1,00097,India
774803,2023-10-10,1012,Body Lotion,200,400,200,2,00097,India
889986,2023-10-10,1008,Makeup Remover,80,160,80,1,00295,India
889986,2023-10-10,1012,Body Lotion,200,400,200,2,00295,India
889986,2023-10-10,1007,Eyeshadow,200,400,200,1,00295,India
889986,2023-10-10,1009,Moisturizer,250,500,250,2,00295,India
889986,2023-10-10,1002,Mascara,200,400,200,1,00295,India
856093,2023-10-10,1006,Blush,150,300,150,1,00173,India
856093,2023-10-10,1005,Nail Polish,50,100,50,1,00173,India
856093,2023-10-10,1001,Lipstick,150,300,150,1,00173,India
856093,2023-10-10,1007,Eyeshadow,200,400,200,1,00173,India
519106,2023-10-10,1009,Moisturizer,250,500,250,2,00198,India
519106,2023-10-10,1008,Makeup Remover,80,160,80,1,00198,India
519106,2023-10-10,1006,Blush,150,300,150,1,00198,India
931474,2023-10-10,1002,Mascara,200,400,200,1,00345,India
931474,2023-10-10,1009,Moisturizer,250,500,250,2,00345,India
931474,2023-10-10,1012,Body Lotion,200,400,200,2,00345,India
590110,2023-10-10,1006,Blush,150,300,150,1,00076,India
590110,2023-10-10,1001,Lipstick,150,300,150,1,00076,India
590110,2023-10-10,1003,Foundation,300,600,300,1,00076,India
590110,2023-10-10,1007,Eyeshadow,200,400,200,1,00076,India
590110,2023-10-10,1012,Body Lotion,200,400,200,2,00076,India
747941,2023-10-10,1001,Lipstick,150,300,150,1,00346,India
747941,2023-10-10,1009,Moisturizer,250,500,250,2,00346,India
928680,2023-10-10,1007,Eyeshadow,200,400,200,1,00074,India
928680,2023-10-10,1012,Body Lotion,200,400,200,2,00074,India
928680,2023-10-10,1003,Foundation,300,600,300,1,00074,India
928680,2023-10-10,1005,Nail Polish,50,100,50,1,00074,India
659478,2023-10-10,1002,Mascara,200,400,200,1,00059,India
659478,2023-10-10,1009,Moisturizer,250,500,250,2,00059,India
659478,2023-10-10,1008,Makeup Remover,80,160,80,1,00059,India
659478,2023-10-10,1005,Nail Polish,50,100,50,1,00059,India
659478,2023-10-10,1006,Blush,150,300,150,1,00059,India
884221,2023-10-10,1004,Eyeliner,100,200,100,1,00143,India
884221,2023-10-10,1007,Eyeshadow,200,400,200,1,00143,India
884221,2023-10-10,1005,Nail Polish,50,100,50,1,00143,India
459298,2023-10-11,1003,Foundation,300,600,300,1,00248,India
459298,2023-10-11,1007,Eyeshadow,200,400,200,1,00248,India
459298,2023-10-11,1001,Lipstick,150,300,150,1,00248,India
459298,2023-10-11,1008,Makeup Remover,80,160,80,1,00248,India
817267,2023-10-11,1005,Nail Polish,50,100,50,1,00111,India
817267,2023-10-11,1001,Lipstick,150,300,150,1,00111,India
817267,2023-10-11,1002,Mascara,200,400,200,1,00111,India
817267,2023-10-11,1009,Moisturizer,250,500,250,2,00111,India
644750,2023-10-11,1009,Moisturizer,250,500,250,2,00094,India
644750,2023-10-11,1001,Lipstick,150,300,150,1,00094,India
644750,2023-10-11,1005,Nail Polish,50,100,50,1,00094,India
644750,2023-10-11,1006,Blush,150,300,150,1,00094,India
703828,2023-10-11,1007,Eyeshadow,200,400,200,1,00433,India
703828,2023-10-11,1009,Moisturizer,250,500,250,2,00433,India
646296,2023-10-11,1012,Body Lotion,200,400,200,2,00445,India
646296,2023-10-11,1003,Foundation,300,600,300,1,00445,India
646296,2023-10-11,1002,Mascara,200,400,200,1,00445,India
747362,2023-10-11,1002,Mascara,200,400,200,1,00186,India
747362,2023-10-11,1007,Eyeshadow,200,400,200,1,00186,India
747362,2023-10-11,1006,Blush,150,300,150,1,00186,India
527137,2023-10-11,1002,Mascara,200,400,200,1,00120,India
527137,2023-10-11,1008,Makeup Remover,80,160,80,1,00120,India
527137,2023-10-11,1001,Lipstick,150,300,150,1,00120,India
526957,2023-10-11,1012,Body Lotion,200,400,200,2,00383,India
526957,2023-10-11,1006,Blush,150,300,150,1,00383,India
526957,2023-10-11,1001,Lipstick,150,300,150,1,00383,India
783476,2023-10-11,1009,Moisturizer,250,500,250,2,00276,India
622951,2023-10-11,1012,Body Lotion,200,400,200,2,00037,India
622951,2023-10-11,1005,Nail Polish,50,100,50,1,00037,India
622951,2023-10-11,1001,Lipstick,150,300,150,1,00037,India
622951,2023-10-11,1002,Mascara,200,400,200,1,00037,India
510127,2023-10-11,1002,Mascara,200,400,200,1,00273,India
510127,2023-10-11,1007,Eyeshadow,200,400,200,1,00273,India
608967,2023-10-11,1008,Makeup Remover,80,160,80,1,00265,India
608967,2023-10-11,1009,Moisturizer,250,500,250,2,00265,India
608967,2023-10-11,1002,Mascara,200,400,200,1,00265,India
608967,2023-10-11,1006,Blush,150,300,150,1,00265,India
576811,2023-10-11,1004,Eyeliner,100,200,100,1,00294,India
576811,2023-10-11,1002,Mascara,200,400,200,1,00294,India
576811,2023-10-11,1007,Eyeshadow,200,400,200,1,00294,India
582509,2023-10-11,1006,Blush,150,300,150,1,00180,India
582509,2023-10-11,1012,Body Lotion,200,400,200,2,00180,India
582509,2023-10-11,1002,Mascara,200,400,200,1,00180,India
139815,2023-10-11,1004,Eyeliner,100,200,100,1,00115,India
139815,2023-10-11,1006,Blush,150,300,150,1,00115,India
139815,2023-10-11,1008,Makeup Remover,80,160,80,1,00115,India
139815,2023-10-11,1002,Mascara,200,400,200,1,00115,India
853749,2023-10-11,1005,Nail Polish,50,100,50,1,00092,India
853749,2023-10-11,1007,Eyeshadow,200,400,200,1,00092,India
879932,2023-10-11,1005,Nail Polish,50,100,50,1,00187,India
879932,2023-10-11,1008,Makeup Remover,80,160,80,1,00187,India
879932,2023-10-11,1012,Body Lotion,200,400,200,2,00187,India
196005,2023-10-11,1005,Nail Polish,50,100,50,1,00444,India
196005,2023-10-11,1002,Mascara,200,400,200,1,00444,India
196005,2023-10-11,1008,Makeup Remover,80,160,80,1,00444,India
257340,2023-10-11,1001,Lipstick,150,300,150,1,00200,India
504396,2023-10-11,1002,Mascara,200,400,200,1,00284,India
127637,2023-10-11,1002,Mascara,200,400,200,1,00361,India
127637,2023-10-11,1003,Foundation,300,600,300,1,00361,India
127637,2023-10-11,1006,Blush,150,300,150,1,00361,India
127637,2023-10-11,1009,Moisturizer,250,500,250,2,00361,India
301416,2023-10-11,1004,Eyeliner,100,200,100,1,00050,India
301416,2023-10-11,1009,Moisturizer,250,500,250,2,00050,India
668254,2023-10-11,1004,Eyeliner,100,200,100,1,00005,India
668254,2023-10-11,1009,Moisturizer,250,500,250,2,00005,India
668254,2023-10-11,1001,Lipstick,150,300,150,1,00005,India
853596,2023-10-11,1002,Mascara,200,400,200,1,00322,India
707564,2023-10-11,1012,Body Lotion,200,400,200,2,00084,India
707564,2023-10-11,1009,Moisturizer,250,500,250,2,00084,India
520591,2023-10-11,1005,Nail Polish,50,100,50,1,00414,India
520591,2023-10-11,1001,Lipstick,150,300,150,1,00414,India
411576,2023-10-11,1004,Eyeliner,100,200,100,1,00434,India
411576,2023-10-11,1009,Moisturizer,250,500,250,2,00434,India
238736,2023-10-11,1009,Moisturizer,250,500,250,2,00200,India
238736,2023-10-11,1012,Body Lotion,200,400,200,2,00200,India
292399,2023-10-11,1005,Nail Polish,50,100,50,1,00353,India
292399,2023-10-11,1004,Eyeliner,100,200,100,1,00353,India
292399,2023-10-11,1012,Body Lotion,200,400,200,2,00353,India
292399,2023-10-11,1001,Lipstick,150,300,150,1,00353,India
292399,2023-10-11,1007,Eyeshadow,200,400,200,1,00353,India
764905,2023-10-11,1006,Blush,150,300,150,1,00474,India
764905,2023-10-11,1003,Foundation,300,600,300,1,00474,India
764905,2023-10-11,1005,Nail Polish,50,100,50,1,00474,India
995883,2023-10-11,1003,Foundation,300,600,300,1,00312,India
995883,2023-10-11,1001,Lipstick,150,300,150,1,00312,India
995883,2023-10-11,1007,Eyeshadow,200,400,200,1,00312,India
995883,2023-10-11,1012,Body Lotion,200,400,200,2,00312,India
267463,2023-10-11,1005,Nail Polish,50,100,50,1,00135,India
389803,2023-10-11,1009,Moisturizer,250,500,250,2,00122,India
389803,2023-10-11,1005,Nail Polish,50,100,50,1,00122,India
389803,2023-10-11,1006,Blush,150,300,150,1,00122,India
489756,2023-10-11,1001,Lipstick,150,300,150,1,00008,India
103423,2023-10-11,1004,Eyeliner,100,200,100,1,00355,India
103423,2023-10-11,1005,Nail Polish,50,100,50,1,00355,India
103423,2023-10-11,1008,Makeup Remover,80,160,80,1,00355,India
103423,2023-10-11,1003,Foundation,300,600,300,1,00355,India
277734,2023-10-11,1006,Blush,150,300,150,1,00209,India
361436,2023-10-11,1003,Foundation,300,600,300,1,00353,India
361436,2023-10-11,1009,Moisturizer,250,500,250,2,00353,India
361436,2023-10-11,1004,Eyeliner,100,200,100,1,00353,India
173063,2023-10-11,1005,Nail Polish,50,100,50,1,00017,India
173063,2023-10-11,1003,Foundation,300,600,300,1,00017,India
430731,2023-10-11,1002,Mascara,200,400,200,1,00269,India
883794,2023-10-12,1008,Makeup Remover,80,160,80,1,00086,India
883794,2023-10-12,1001,Lipstick,150,300,150,1,00086,India
201385,2023-10-12,1012,Body Lotion,200,400,200,2,00184,India
427594,2023-10-12,1003,Foundation,300,600,300,1,00333,India
570772,2023-10-12,1008,Makeup Remover,80,160,80,1,00136,India
570772,2023-10-12,1005,Nail Polish,50,100,50,1,00136,India
570772,2023-10-12,1001,Lipstick,150,300,150,1,00136,India
570772,2023-10-12,1006,Blush,150,300,150,1,00136,India
761153,2023-10-12,1009,Moisturizer,250,500,250,2,00326,India
761153,2023-10-12,1006,Blush,150,300,150,1,00326,India
761153,2023-10-12,1004,Eyeliner,100,200,100,1,00326,India
761153,2023-10-12,1005,Nail Polish,50,100,50,1,00326,India
145360,2023-10-12,1002,Mascara,200,400,200,1,00154,India
145360,2023-10-12,1009,Moisturizer,250,500,250,2,00154,India
654439,2023-10-12,1002,Mascara,200,400,200,1,00223,India
269415,2023-10-12,1003,Foundation,300,600,300,1,00005,India
169263,2023-10-12,1012,Body Lotion,200,400,200,2,00146,India
169263,2023-10-12,1003,Foundation,300,600,300,1,00146,India
169263,2023-10-12,1005,Nail Polish,50,100,50,1,00146,India
169263,2023-10-12,1006,Blush,150,300,150,1,00146,India
884967,2023-10-12,1012,Body Lotion,200,400,200,2,00368,India
884967,2023-10-12,1005,Nail Polish,50,100,50,1,00368,India
884967,2023-10-12,1001,Lipstick,150,300,150,1,00368,India
884967,2023-10-12,1003,Foundation,300,600,300,1,00368,India
703637,2023-10-12,1007,Eyeshadow,200,400,200,1,00277,India
703637,2023-10-12,1002,Mascara,200,400,200,1,00277,India
703637,2023-10-12,1009,Moisturizer,250,500,250,2,00277,India
703637,2023-10-12,1012,Body Lotion,200,400,200,2,00277,India
139532,2023-10-12,1003,Foundation,300,600,300,1,00018,India
139532,2023-10-12,1007,Eyeshadow,200,400,200,1,00018,India
139532,2023-10-12,1012,Body Lotion,200,400,200,2,00018,India
139532,2023-10-12,1006,Blush,150,300,150,1,00018,India
873733,2023-10-12,1003,Foundation,300,600,300,1,00007,India
873733,2023-10-12,1004,Eyeliner,100,200,100,1,00007,India
873733,2023-10-12,1005,Nail Polish,50,100,50,1,00007,India
873733,2023-10-12,1009,Moisturizer,250,500,250,2,00007,India
973067,2023-10-12,1004,Eyeliner,100,200,100,1,00458,India
973067,2023-10-12,1005,Nail Polish,50,100,50,1,00458,India
973067,2023-10-12,1008,Makeup Remover,80,160,80,1,00458,India
973067,2023-10-12,1006,Blush,150,300,150,1,00458,India
988466,2023-10-12,1003,Foundation,300,600,300,1,00210,India
819326,2023-10-12,1003,Foundation,300,600,300,1,00270,India
507148,2023-10-12,1005,Nail Polish,50,100,50,1,00196,India
507148,2023-10-12,1006,Blush,150,300,150,1,00196,India
507148,2023-10-12,1008,Makeup Remover,80,160,80,1,00196,India
428945,2023-10-12,1004,Eyeliner,100,200,100,1,00478,India
428945,2023-10-12,1002,Mascara,200,400,200,1,00478,India
428945,2023-10-12,1007,Eyeshadow,200,400,200,1,00478,India
514422,2023-10-12,1006,Blush,150,300,150,1,00029,India
514422,2023-10-12,1007,Eyeshadow,200,400,200,1,00029,India
370649,2023-10-12,1006,Blush,150,300,150,1,00143,India
370649,2023-10-12,1003,Foundation,300,600,300,1,00143,India
981117,2023-10-12,1001,Lipstick,150,300,150,1,00288,India
981117,2023-10-12,1012,Body Lotion,200,400,200,2,00288,India
345155,2023-10-12,1009,Moisturizer,250,500,250,2,00480,India
279035,2023-10-12,1006,Blush,150,300,150,1,00010,India
249623,2023-10-12,1009,Moisturizer,250,500,250,2,00492,India
249623,2023-10-12,1007,Eyeshadow,200,400,200,1,00492,India
545376,2023-10-12,1007,Eyeshadow,200,400,200,1,00102,India
545376,2023-10-12,1001,Lipstick,150,300,150,1,00102,India
847494,2023-10-12,1001,Lipstick,150,300,150,1,00467,India
847494,2023-10-12,1006,Blush,150,300,150,1,00467,India
137131,2023-10-12,1001,Lipstick,150,300,150,1,00361,India
496178,2023-10-12,1012,Body Lotion,200,400,200,2,00319,India
496178,2023-10-12,1003,Foundation,300,600,300,1,00319,India
496178,2023-10-12,1001,Lipstick,150,300,150,1,00319,India
496178,2023-10-12,1008,Makeup Remover,80,160,80,1,00319,India
663039,2023-10-12,1002,Mascara,200,400,200,1,00417,India
663039,2023-10-12,1007,Eyeshadow,200,400,200,1,00417,India
663039,2023-10-12,1006,Blush,150,300,150,1,00417,India
176054,2023-10-12,1012,Body Lotion,200,400,200,2,00039,India
176054,2023-10-12,1009,Moisturizer,250,500,250,2,00039,India
176054,2023-10-12,1007,Eyeshadow,200,400,200,1,00039,India
186797,2023-10-12,1012,Body Lotion,200,400,200,2,00119,India
186797,2023-10-12,1003,Foundation,300,600,300,1,00119,India
549049,2023-10-12,1005,Nail Polish,50,100,50,1,00226,India
549049,2023-10-12,1003,Foundation,300,600,300,1,00226,India
549049,2023-10-12,1006,Blush,150,300,150,1,00226,India
241506,2023-10-12,1006,Blush,150,300,150,1,00005,India
241506,2023-10-12,1004,Eyeliner,100,200,100,1,00005,India
241506,2023-10-12,1008,Makeup Remover,80,160,80,1,00005,India
277503,2023-10-12,1001,Lipstick,150,300,150,1,00288,India
277503,2023-10-12,1006,Blush,150,300,150,1,00288,India
354417,2023-10-12,1008,Makeup Remover,80,160,80,1,00037,India
354417,2023-10-12,1002,Mascara,200,400,200,1,00037,India
564167,2023-10-12,1005,Nail Polish,50,100,50,1,00282,India
431327,2023-10-12,1006,Blush,150,300,150,1,00496,India
431327,2023-10-12,1001,Lipstick,150,300,150,1,00496,India
431327,2023-10-12,1008,Makeup Remover,80,160,80,1,00496,India
729116,2023-10-12,1004,Eyeliner,100,200,100,1,00403,India
729116,2023-10-12,1002,Mascara,200,400,200,1,00403,India
729116,2023-10-12,1012,Body Lotion,200,400,200,2,00403,India
185212,2023-10-12,1008,Makeup Remover,80,160,80,1,00267,India
185212,2023-10-12,1005,Nail Polish,50,100,50,1,00267,India
185212,2023-10-12,1003,Foundation,300,600,300,1,00267,India
185212,2023-10-12,1012,Body Lotion,200,400,200,2,00267,India
897110,2023-10-13,1012,Body Lotion,200,400,200,2,00253,India
361326,2023-10-13,1008,Makeup Remover,80,160,80,1,00468,India
361326,2023-10-13,1007,Eyeshadow,200,400,200,1,00468,India
780930,2023-10-13,1008,Makeup Remover,80,160,80,1,00347,India
780930,2023-10-13,1004,Eyeliner,100,200,100,1,00347,India
780930,2023-10-13,1006,Blush,150,300,150,1,00347,India
516519,2023-10-13,1006,Blush,150,300,150,1,00109,India
546437,2023-10-13,1008,Makeup Remover,80,160,80,1,00119,India
546437,2023-10-13,1007,Eyeshadow,200,400,200,1,00119,India
438009,2023-10-13,1012,Body Lotion,200,400,200,2,00328,India
438009,2023-10-13,1008,Makeup Remover,80,160,80,1,00328,India
833277,2023-10-13,1005,Nail Polish,50,100,50,1,00427,India
833277,2023-10-13,1007,Eyeshadow,200,400,200,1,00427,India
833277,2023-10-13,1008,Makeup Remover,80,160,80,1,00427,India
427730,2023-10-13,1003,Foundation,300,600,300,1,00238,India
427730,2023-10-13,1001,Lipstick,150,300,150,1,00238,India
427730,2023-10-13,1002,Mascara,200,400,200,1,00238,India
427730,2023-10-13,1012,Body Lotion,200,400,200,2,00238,India
616568,2023-10-13,1004,Eyeliner,100,200,100,1,00298,India
616568,2023-10-13,1003,Foundation,300,600,300,1,00298,India
616568,2023-10-13,1012,Body Lotion,200,400,200,2,00298,India
470636,2023-10-13,1001,Lipstick,150,300,150,1,00246,India
470636,2023-10-13,1002,Mascara,200,400,200,1,00246,India
470636,2023-10-13,1006,Blush,150,300,150,1,00246,India
470636,2023-10-13,1009,Moisturizer,250,500,250,2,00246,India
481085,2023-10-13,1006,Blush,150,300,150,1,00105,India
481085,2023-10-13,1003,Foundation,300,600,300,1,00105,India
481085,2023-10-13,1004,Eyeliner,100,200,100,1,00105,India
715938,2023-10-13,1003,Foundation,300,600,300,1,00128,India
715938,2023-10-13,1002,Mascara,200,400,200,1,00128,India
211061,2023-10-13,1008,Makeup Remover,80,160,80,1,00336,India
211061,2023-10-13,1005,Nail Polish,50,100,50,1,00336,India
211061,2023-10-13,1002,Mascara,200,400,200,1,00336,India
443985,2023-10-13,1005,Nail Polish,50,100,50,1,00411,India
443985,2023-10-13,1002,Mascara,200,400,200,1,00411,India
443985,2023-10-13,1004,Eyeliner,100,200,100,1,00411,India
443985,2023-10-13,1009,Moisturizer,250,500,250,2,00411,India
794632,2023-10-13,1009,Moisturizer,250,500,250,2,00040,India
794632,2023-10-13,1004,Eyeliner,100,200,100,1,00040,India
794632,2023-10-13,1002,Mascara,200,400,200,1,00040,India
794632,2023-10-13,1001,Lipstick,150,300,150,1,00040,India
516666,2023-10-13,1003,Foundation,300,600,300,1,00160,India
516666,2023-10-13,1005,Nail Polish,50,100,50,1,00160,India
516666,2023-10-13,1007,Eyeshadow,200,400,200,1,00160,India
566832,2023-10-13,1012,Body Lotion,200,400,200,2,00261,India
566832,2023-10-13,1007,Eyeshadow,200,400,200,1,00261,India
566832,2023-10-13,1005,Nail Polish,50,100,50,1,00261,India
425211,2023-10-13,1001,Lipstick,150,300,150,1,00317,India
142074,2023-10-13,1002,Mascara,200,400,200,1,00170,India
142074,2023-10-13,1008,Makeup Remover,80,160,80,1,00170,India
624506,2023-10-13,1009,Moisturizer,250,500,250,2,00417,India
624506,2023-10-13,1005,Nail Polish,50,100,50,1,00417,India
624506,2023-10-13,1002,Mascara,200,400,200,1,00417,India
380252,2023-10-13,1001,Lipstick,150,300,150,1,00409,India
380252,2023-10-13,1005,Nail Polish,50,100,50,1,00409,India
380252,2023-10-13,1008,Makeup Remover,80,160,80,1,00409,India
174623,2023-10-13,1007,Eyeshadow,200,400,200,1,00097,India
174623,2023-10-13,1008,Makeup Remover,80,160,80,1,00097,India
174623,2023-10-13,1002,Mascara,200,400,200,1,00097,India
357817,2023-10-13,1001,Lipstick,150,300,150,1,00333,India
357817,2023-10-13,1005,Nail Polish,50,100,50,1,00333,India
357817,2023-10-13,1009,Moisturizer,250,500,250,2,00333,India
510093,2023-10-13,1009,Moisturizer,250,500,250,2,00490,India
510093,2023-10-13,1003,Foundation,300,600,300,1,00490,India
510093,2023-10-13,1006,Blush,150,300,150,1,00490,India
510093,2023-10-13,1012,Body Lotion,200,400,200,2,00490,India
952149,2023-10-13,1003,Foundation,300,600,300,1,00381,India
952149,2023-10-13,1012,Body Lotion,200,400,200,2,00381,India
952149,2023-10-13,1007,Eyeshadow,200,400,200,1,00381,India
346934,2023-10-13,1012,Body Lotion,200,400,200,2,00385,India
312804,2023-10-13,1008,Makeup Remover,80,160,80,1,00020,India
312804,2023-10-13,1006,Blush,150,300,150,1,00020,India
931652,2023-10-13,1007,Eyeshadow,200,400,200,1,00060,India
931652,2023-10-13,1009,Moisturizer,250,500,250,2,00060,India
931652,2023-10-13,1004,Eyeliner,100,200,100,1,00060,India
931652,2023-10-13,1012,Body Lotion,200,400,200,2,00060,India
420804,2023-10-13,1012,Body Lotion,200,400,200,2,00483,India
654411,2023-10-13,1006,Blush,150,300,150,1,00032,India
654411,2023-10-13,1005,Nail Polish,50,100,50,1,00032,India
654411,2023-10-13,1008,Makeup Remover,80,160,80,1,00032,India
208261,2023-10-14,1001,Lipstick,150,300,150,1,00098,India
208261,2023-10-14,1004,Eyeliner,100,200,100,1,00098,India
208261,2023-10-14,1008,Makeup Remover,80,160,80,1,00098,India
481007,2023-10-14,1007,Eyeshadow,200,400,200,1,00192,India
481007,2023-10-14,1002,Mascara,200,400,200,1,00192,India
774404,2023-10-14,1009,Moisturizer,250,500,250,2,00395,India
774404,2023-10-14,1008,Makeup Remover,80,160,80,1,00395,India
897771,2023-10-14,1004,Eyeliner,100,200,100,1,00408,India
897771,2023-10-14,1005,Nail Polish,50,100,50,1,00408,India
897771,2023-10-14,1007,Eyeshadow,200,400,200,1,00408,India
464544,2023-10-14,1007,Eyeshadow,200,400,200,1,00103,India
464544,2023-10-14,1008,Makeup Remover,80,160,80,1,00103,India
434611,2023-10-14,1012,Body Lotion,200,400,200,2,00397,India
434611,2023-10-14,1003,Foundation,300,600,300,1,00397,India
434611,2023-10-14,1005,Nail Polish,50,100,50,1,00397,India
434611,2023-10-14,1006,Blush,150,300,150,1,00397,India
644203,2023-10-14,1008,Makeup Remover,80,160,80,1,00425,India
713825,2023-10-14,1005,Nail Polish,50,100,50,1,00447,India
667557,2023-10-14,1007,Eyeshadow,200,400,200,1,00005,India
667557,2023-10-14,1003,Foundation,300,600,300,1,00005,India
557385,2023-10-14,1001,Lipstick,150,300,150,1,00215,India
557385,2023-10-14,1008,Makeup Remover,80,160,80,1,00215,India
557385,2023-10-14,1003,Foundation,300,600,300,1,00215,India
557385,2023-10-14,1007,Eyeshadow,200,400,200,1,00215,India
769864,2023-10-14,1006,Blush,150,300,150,1,00486,India
769864,2023-10-14,1008,Makeup Remover,80,160,80,1,00486,India
769864,2023-10-14,1003,Foundation,300,600,300,1,00486,India
487863,2023-10-14,1008,Makeup Remover,80,160,80,1,00172,India
704631,2023-10-14,1001,Lipstick,150,300,150,1,00351,India
698055,2023-10-14,1001,Lipstick,150,300,150,1,00446,India
726266,2023-10-14,1003,Foundation,300,600,300,1,00271,India
726266,2023-10-14,1007,Eyeshadow,200,400,200,1,00271,India
726266,2023-10-14,1002,Mascara,200,400,200,1,00271,India
320963,2023-10-14,1001,Lipstick,150,300,150,1,00290,India
180550,2023-10-14,1008,Makeup Remover,80,160,80,1,00264,India
180550,2023-10-14,1007,Eyeshadow,200,400,200,1,00264,India
180550,2023-10-14,1005,Nail Polish,50,100,50,1,00264,India
794540,2023-10-14,1012,Body Lotion,200,400,200,2,00159,India
794540,2023-10-14,1008,Makeup Remover,80,160,80,1,00159,India
794540,2023-10-14,1002,Mascara,200,400,200,1,00159,India
332485,2023-10-14,1004,Eyeliner,100,200,100,1,00281,India
332485,2023-10-14,1009,Moisturizer,250,500,250,2,00281,India
332485,2023-10-14,1008,Makeup Remover,80,160,80,1,00281,India
200018,2023-10-14,1005,Nail Polish,50,100,50,1,00298,India
200018,2023-10-14,1008,Makeup Remover,80,160,80,1,00298,India
200018,2023-10-14,1001,Lipstick,150,300,150,1,00298,India
200018,2023-10-14,1003,Foundation,300,600,300,1,00298,India
885474,2023-10-14,1012,Body Lotion,200,400,200,2,00073,India
384955,2023-10-14,1007,Eyeshadow,200,400,200,1,00319,India
600473,2023-10-14,1006,Blush,150,300,150,1,00011,India
638631,2023-10-14,1005,Nail Polish,50,100,50,1,00388,India
638631,2023-10-14,1006,Blush,150,300,150,1,00388,India
638631,2023-10-14,1009,Moisturizer,250,500,250,2,00388,India
682556,2023-10-14,1002,Mascara,200,400,200,1,00467,India
682556,2023-10-14,1009,Moisturizer,250,500,250,2,00467,India
109944,2023-10-14,1006,Blush,150,300,150,1,00192,India
109944,2023-10-14,1003,Foundation,300,600,300,1,00192,India
316091,2023-10-14,1003,Foundation,300,600,300,1,00442,India
867735,2023-10-14,1003,Foundation,300,600,300,1,00123,India
867735,2023-10-14,1006,Blush,150,300,150,1,00123,India
867735,2023-10-14,1012,Body Lotion,200,400,200,2,00123,India
235885,2023-10-14,1012,Body Lotion,200,400,200,2,00172,India
235885,2023-10-14,1009,Moisturizer,250,500,250,2,00172,India
235885,2023-10-14,1004,Eyeliner,100,200,100,1,00172,India
235885,2023-10-14,1003,Foundation,300,600,300,1,00172,India
235885,2023-10-14,1005,Nail Polish,50,100,50,1,00172,India
114281,2023-10-14,1001,Lipstick,150,300,150,1,00061,India
114281,2023-10-14,1006,Blush,150,300,150,1,00061,India
114281,2023-10-14,1012,Body Lotion,200,400,200,2,00061,India
114281,2023-10-14,1004,Eyeliner,100,200,100,1,00061,India
888706,2023-10-14,1008,Makeup Remover,80,160,80,1,00015,India
888706,2023-10-14,1004,Eyeliner,100,200,100,1,00015,India
888706,2023-10-14,1002,Mascara,200,400,200,1,00015,India
757217,2023-10-14,1004,Eyeliner,100,200,100,1,00014,India
757217,2023-10-14,1005,Nail Polish,50,100,50,1,00014,India
757217,2023-10-14,1002,Mascara,200,400,200,1,00014,India
757217,2023-10-14,1007,Eyeshadow,200,400,200,1,00014,India
151176,2023-10-14,1007,Eyeshadow,200,400,200,1,00174,India
969031,2023-10-14,1008,Makeup Remover,80,160,80,1,00028,India
159522,2023-10-14,1001,Lipstick,150,300,150,1,00253,India
159522,2023-10-14,1005,Nail Polish,50,100,50,1,00253,India
747912,2023-10-14,1012,Body Lotion,200,400,200,2,00488,India
747912,2023-10-14,1005,Nail Polish,50,100,50,1,00488,India
273994,2023-10-14,1009,Moisturizer,250,500,250,2,00155,India
273994,2023-10-14,1007,Eyeshadow,200,400,200,1,00155,India
316649,2023-10-15,1008,Makeup Remover,80,160,80,1,00422,India
990845,2023-10-15,1006,Blush,150,300,150,1,00114,India
990845,2023-10-15,1009,Moisturizer,250,500,250,2,00114,India
990845,2023-10-15,1001,Lipstick,150,300,150,1,00114,India
382159,2023-10-15,1003,Foundation,300,600,300,1,00076,India
382159,2023-10-15,1002,Mascara,200,400,200,1,00076,India
601734,2023-10-15,1006,Blush,150,300,150,1,00479,India
601734,2023-10-15,1002,Mascara,200,400,200,1,00479,India
601734,2023-10-15,1001,Lipstick,150,300,150,1,00479,India
601734,2023-10-15,1005,Nail Polish,50,100,50,1,00479,India
601734,2023-10-15,1008,Makeup Remover,80,160,80,1,00479,India
215433,2023-10-15,1008,Makeup Remover,80,160,80,1,00117,India
215433,2023-10-15,1003,Foundation,300,600,300,1,00117,India
392406,2023-10-15,1009,Moisturizer,250,500,250,2,00090,India
392406,2023-10-15,1003,Foundation,300,600,300,1,00090,India
392406,2023-10-15,1004,Eyeliner,100,200,100,1,00090,India
392406,2023-10-15,1002,Mascara,200,400,200,1,00090,India
383749,2023-10-15,1006,Blush,150,300,150,1,00291,India
383749,2023-10-15,1012,Body Lotion,200,400,200,2,00291,India
383749,2023-10-15,1008,Makeup Remover,80,160,80,1,00291,India
362939,2023-10-15,1005,Nail Polish,50,100,50,1,00126,India
362939,2023-10-15,1002,Mascara,200,400,200,1,00126,India
362939,2023-10-15,1012,Body Lotion,200,400,200,2,00126,India
362939,2023-10-15,1004,Eyeliner,100,200,100,1,00126,India
195733,2023-10-15,1009,Moisturizer,250,500,250,2,00331,India
195733,2023-10-15,1007,Eyeshadow,200,400,200,1,00331,India
195733,2023-10-15,1002,Mascara,200,400,200,1,00331,India
889920,2023-10-15,1006,Blush,150,300,150,1,00424,India
889920,2023-10-15,1007,Eyeshadow,200,400,200,1,00424,India
889920,2023-10-15,1009,Moisturizer,250,500,250,2,00424,India
889920,2023-10-15,1003,Foundation,300,600,300,1,00424,India
219321,2023-10-15,1002,Mascara,200,400,200,1,00171,India
219321,2023-10-15,1007,Eyeshadow,200,400,200,1,00171,India
219321,2023-10-15,1012,Body Lotion,200,400,200,2,00171,India
633737,2023-10-15,1005,Nail Polish,50,100,50,1,00433,India
633737,2023-10-15,1003,Foundation,300,600,300,1,00433,India
407587,2023-10-15,1008,Makeup Remover,80,160,80,1,00127,India
791739,2023-10-15,1009,Moisturizer,250,500,250,2,00149,India
791739,2023-10-15,1007,Eyeshadow,200,400,200,1,00149,India
177302,2023-10-15,1003,Foundation,300,600,300,1,00099,India
182947,2023-10-15,1009,Moisturizer,250,500,250,2,00135,India
182947,2023-10-15,1006,Blush,150,300,150,1,00135,India
182947,2023-10-15,1007,Eyeshadow,200,400,200,1,00135,India
182947,2023-10-15,1005,Nail Polish,50,100,50,1,00135,India
211011,2023-10-15,1001,Lipstick,150,300,150,1,00157,India
239067,2023-10-15,1002,Mascara,200,400,200,1,00081,India
933832,2023-10-15,1009,Moisturizer,250,500,250,2,00377,India
933832,2023-10-15,1006,Blush,150,300,150,1,00377,India
933832,2023-10-15,1007,Eyeshadow,200,400,200,1,00377,India
933832,2023-10-15,1008,Makeup Remover,80,160,80,1,00377,India
933832,2023-10-15,1005,Nail Polish,50,100,50,1,00377,India
559505,2023-10-15,1009,Moisturizer,250,500,250,2,00030,India
993528,2023-10-15,1008,Makeup Remover,80,160,80,1,00495,India
527831,2023-10-15,1009,Moisturizer,250,500,250,2,00071,India
659430,2023-10-15,1012,Body Lotion,200,400,200,2,00357,India
659430,2023-10-15,1004,Eyeliner,100,200,100,1,00357,India
659430,2023-10-15,1007,Eyeshadow,200,400,200,1,00357,India
486150,2023-10-15,1001,Lipstick,150,300,150,1,00104,India
486150,2023-10-15,1006,Blush,150,300,150,1,00104,India
486150,2023-10-15,1008,Makeup Remover,80,160,80,1,00104,India
486150,2023-10-15,1002,Mascara,200,400,200,1,00104,India
887090,2023-10-15,1012,Body Lotion,200,400,200,2,00347,India
887090,2023-10-15,1008,Makeup Remover,80,160,80,1,00347,India
887090,2023-10-15,1004,Eyeliner,100,200,100,1,00347,India
349706,2023-10-15,1012,Body Lotion,200,400,200,2,00402,India
349706,2023-10-15,1002,Mascara,200,400,200,1,00402,India
349706,2023-10-15,1008,Makeup Remover,80,160,80,1,00402,India
921687,2023-10-15,1009,Moisturizer,250,500,250,2,00027,India
921687,2023-10-15,1006,Blush,150,300,150,1,00027,India
921687,2023-10-15,1008,Makeup Remover,80,160,80,1,00027,India
278635,2023-10-15,1003,Foundation,300,600,300,1,00111,India
278635,2023-10-15,1001,Lipstick,150,300,150,1,00111,India
650713,2023-10-15,1001,Lipstick,150,300,150,1,00267,India
650713,2023-10-15,1012,Body Lotion,200,400,200,2,00267,India
256308,2023-10-15,1009,Moisturizer,250,500,250,2,00342,India
777754,2023-10-15,1008,Makeup Remover,80,160,80,1,00340,India
777754,2023-10-15,1009,Moisturizer,250,500,250,2,00340,India
777754,2023-10-15,1003,Foundation,300,600,300,1,00340,India
777754,2023-10-15,1012,Body Lotion,200,400,200,2,00340,India
902003,2023-10-15,1009,Moisturizer,250,500,250,2,00347,India
902003,2023-10-15,1008,Makeup Remover,80,160,80,1,00347,India
304823,2023-10-16,1009,Moisturizer,250,500,250,2,00021,India
304823,2023-10-16,1007,Eyeshadow,200,400,200,1,00021,India
301086,2023-10-16,1006,Blush,150,300,150,1,00498,India
736168,2023-10-16,1012,Body Lotion,200,400,200,2,00316,India
736168,2023-10-16,1002,Mascara,200,400,200,1,00316,India
736168,2023-10-16,1003,Foundation,300,600,300,1,00316,India
899975,2023-10-16,1012,Body Lotion,200,400,200,2,00326,India
899975,2023-10-16,1004,Eyeliner,100,200,100,1,00326,India
899975,2023-10-16,1003,Foundation,300,600,300,1,00326,India
899975,2023-10-16,1001,Lipstick,150,300,150,1,00326,India
172923,2023-10-16,1003,Foundation,300,600,300,1,00037,India
172923,2023-10-16,1005,Nail Polish,50,100,50,1,00037,India
172923,2023-10-16,1006,Blush,150,300,150,1,00037,India
550632,2023-10-16,1002,Mascara,200,400,200,1,00296,India
550632,2023-10-16,1006,Blush,150,300,150,1,00296,India
550632,2023-10-16,1003,Foundation,300,600,300,1,00296,India
582460,2023-10-16,1004,Eyeliner,100,200,100,1,00068,India
582460,2023-10-16,1012,Body Lotion,200,400,200,2,00068,India
582460,2023-10-16,1003,Foundation,300,600,300,1,00068,India
291708,2023-10-16,1001,Lipstick,150,300,150,1,00314,India
842009,2023-10-16,1003,Foundation,300,600,300,1,00333,India
842009,2023-10-16,1001,Lipstick,150,300,150,1,00333,India
842009,2023-10-16,1007,Eyeshadow,200,400,200,1,00333,India
842009,2023-10-16,1004,Eyeliner,100,200,100,1,00333,India
410828,2023-10-16,1001,Lipstick,150,300,150,1,00215,India
410828,2023-10-16,1009,Moisturizer,250,500,250,2,00215,India
467884,2023-10-16,1001,Lipstick,150,300,150,1,00174,India
467884,2023-10-16,1009,Moisturizer,250,500,250,2,00174,India
467884,2023-10-16,1006,Blush,150,300,150,1,00174,India
467884,2023-10-16,1005,Nail Polish,50,100,50,1,00174,India
467884,2023-10-16,1012,Body Lotion,200,400,200,2,00174,India
554225,2023-10-16,1008,Makeup Remover,80,160,80,1,00500,India
554225,2023-10-16,1007,Eyeshadow,200,400,200,1,00500,India
554225,2023-10-16,1003,Foundation,300,600,300,1,00500,India
554225,2023-10-16,1006,Blush,150,300,150,1,00500,India
554225,2023-10-16,1001,Lipstick,150,300,150,1,00500,India
609209,2023-10-16,1012,Body Lotion,200,400,200,2,00283,India
609209,2023-10-16,1008,Makeup Remover,80,160,80,1,00283,India
609209,2023-10-16,1005,Nail Polish,50,100,50,1,00283,India
301499,2023-10-16,1002,Mascara,200,400,200,1,00038,India
301499,2023-10-16,1003,Foundation,300,600,300,1,00038,India
301499,2023-10-16,1006,Blush,150,300,150,1,00038,India
543374,2023-10-16,1007,Eyeshadow,200,400,200,1,00241,India
543374,2023-10-16,1004,Eyeliner,100,200,100,1,00241,India
906590,2023-10-16,1007,Eyeshadow,200,400,200,1,00096,India
906590,2023-10-16,1012,Body Lotion,200,400,200,2,00096,India
937801,2023-10-16,1004,Eyeliner,100,200,100,1,00256,India
937801,2023-10-16,1007,Eyeshadow,200,400,200,1,00256,India
937801,2023-10-16,1003,Foundation,300,600,300,1,00256,India
937801,2023-10-16,1009,Moisturizer,250,500,250,2,00256,India
937801,2023-10-16,1012,Body Lotion,200,400,200,2,00256,India
617154,2023-10-16,1005,Nail Polish,50,100,50,1,00302,India
617154,2023-10-16,1003,Foundation,300,600,300,1,00302,India
341370,2023-10-16,1005,Nail Polish,50,100,50,1,00108,India
341370,2023-10-16,1001,Lipstick,150,300,150,1,00108,India
341370,2023-10-16,1008,Makeup Remover,80,160,80,1,00108,India
520401,2023-10-16,1005,Nail Polish,50,100,50,1,00243,India
477290,2023-10-16,1009,Moisturizer,250,500,250,2,00110,India
477290,2023-10-16,1006,Blush,150,300,150,1,00110,India
477290,2023-10-16,1004,Eyeliner,100,200,100,1,00110,India
477290,2023-10-16,1012,Body Lotion,200,400,200,2,00110,India
496374,2023-10-16,1001,Lipstick,150,300,150,1,00477,India
267154,2023-10-16,1003,Foundation,300,600,300,1,00017,India
267154,2023-10-16,1012,Body Lotion,200,400,200,2,00017,India
784098,2023-10-16,1006,Blush,150,300,150,1,00284,India
784098,2023-10-16,1001,Lipstick,150,300,150,1,00284,India
638739,2023-10-16,1005,Nail Polish,50,100,50,1,00015,India
970391,2023-10-16,1001,Lipstick,150,300,150,1,00300,India
970391,2023-10-16,1004,Eyeliner,100,200,100,1,00300,India
970391,2023-10-16,1008,Makeup Remover,80,160,80,1,00300,India
970391,2023-10-16,1009,Moisturizer,250,500,250,2,00300,India
968656,2023-10-16,1006,Blush,150,300,150,1,00201,India
101207,2023-10-16,1005,Nail Polish,50,100,50,1,00210,India
743319,2023-10-16,1005,Nail Polish,50,100,50,1,00180,India
743319,2023-10-16,1007,Eyeshadow,200,400,200,1,00180,India
261115,2023-10-16,1006,Blush,150,300,150,1,00076,India
261115,2023-10-16,1007,Eyeshadow,200,400,200,1,00076,India
261115,2023-10-16,1008,Makeup Remover,80,160,80,1,00076,India
850610,2023-10-16,1012,Body Lotion,200,400,200,2,00222,India
850610,2023-10-16,1005,Nail Polish,50,100,50,1,00222,India
158510,2023-10-16,1009,Moisturizer,250,500,250,2,00280,India
158510,2023-10-16,1008,Makeup Remover,80,160,80,1,00280,India
649999,2023-10-16,1007,Eyeshadow,200,400,200,1,00222,India
200703,2023-10-16,1012,Body Lotion,200,400,200,2,00336,India
200703,2023-10-16,1006,Blush,150,300,150,1,00336,India
200703,2023-10-16,1009,Moisturizer,250,500,250,2,00336,India
398003,2023-10-16,1001,Lipstick,150,300,150,1,00354,India
420488,2023-10-16,1005,Nail Polish,50,100,50,1,00141,India
420488,2023-10-16,1006,Blush,150,300,150,1,00141,India
282015,2023-10-16,1005,Nail Polish,50,100,50,1,00070,India
282015,2023-10-16,1003,Foundation,300,600,300,1,00070,India
282015,2023-10-16,1004,Eyeliner,100,200,100,1,00070,India
282015,2023-10-16,1001,Lipstick,150,300,150,1,00070,India
282015,2023-10-16,1008,Makeup Remover,80,160,80,1,00070,India
480082,2023-10-16,1004,Eyeliner,100,200,100,1,00253,India
480082,2023-10-16,1001,Lipstick,150,300,150,1,00253,India
338797,2023-10-16,1004,Eyeliner,100,200,100,1,00300,India
338797,2023-10-16,1007,Eyeshadow,200,400,200,1,00300,India
214762,2023-10-16,1007,Eyeshadow,200,400,200,1,00109,India
214762,2023-10-16,1008,Makeup Remover,80,160,80,1,00109,India
214762,2023-10-16,1002,Mascara,200,400,200,1,00109,India
490507,2023-10-16,1004,Eyeliner,100,200,100,1,00277,India
490507,2023-10-16,1005,Nail Polish,50,100,50,1,00277,India
490507,2023-10-16,1006,Blush,150,300,150,1,00277,India
387875,2023-10-16,1004,Eyeliner,100,200,100,1,00439,India
855416,2023-10-16,1004,Eyeliner,100,200,100,1,00377,India
855416,2023-10-16,1005,Nail Polish,50,100,50,1,00377,India
855416,2023-10-16,1001,Lipstick,150,300,150,1,00377,India
855416,2023-10-16,1002,Mascara,200,400,200,1,00377,India
504499,2023-10-17,1012,Body Lotion,200,400,200,2,00001,India
233312,2023-10-17,1004,Eyeliner,100,200,100,1,00303,India
233312,2023-10-17,1007,Eyeshadow,200,400,200,1,00303,India
233312,2023-10-17,1003,Foundation,300,600,300,1,00303,India
547569,2023-10-17,1008,Makeup Remover,80,160,80,1,00483,India
547569,2023-10-17,1012,Body Lotion,200,400,200,2,00483,India
547569,2023-10-17,1007,Eyeshadow,200,400,200,1,00483,India
547569,2023-10-17,1003,Foundation,300,600,300,1,00483,India
547569,2023-10-17,1002,Mascara,200,400,200,1,00483,India
383695,2023-10-17,1012,Body Lotion,200,400,200,2,00106,India
383695,2023-10-17,1001,Lipstick,150,300,150,1,00106,India
383695,2023-10-17,1006,Blush,150,300,150,1,00106,India
383695,2023-10-17,1002,Mascara,200,400,200,1,00106,India
383695,2023-10-17,1009,Moisturizer,250,500,250,2,00106,India
121497,2023-10-17,1004,Eyeliner,100,200,100,1,00153,India
121497,2023-10-17,1006,Blush,150,300,150,1,00153,India
121497,2023-10-17,1001,Lipstick,150,300,150,1,00153,India
371598,2023-10-17,1008,Makeup Remover,80,160,80,1,00066,India
371598,2023-10-17,1004,Eyeliner,100,200,100,1,00066,India
338616,2023-10-17,1005,Nail Polish,50,100,50,1,00108,India
334216,2023-10-17,1005,Nail Polish,50,100,50,1,00489,India
334216,2023-10-17,1012,Body Lotion,200,400,200,2,00489,India
632867,2023-10-17,1008,Makeup Remover,80,160,80,1,00387,India
632867,2023-10-17,1007,Eyeshadow,200,400,200,1,00387,India
632867,2023-10-17,1004,Eyeliner,100,200,100,1,00387,India
632867,2023-10-17,1002,Mascara,200,400,200,1,00387,India
632867,2023-10-17,1005,Nail Polish,50,100,50,1,00387,India
713504,2023-10-17,1004,Eyeliner,100,200,100,1,00145,India
713504,2023-10-17,1006,Blush,150,300,150,1,00145,India
713504,2023-10-17,1002,Mascara,200,400,200,1,00145,India
713504,2023-10-17,1007,Eyeshadow,200,400,200,1,00145,India
713504,2023-10-17,1005,Nail Polish,50,100,50,1,00145,India
296144,2023-10-17,1004,Eyeliner,100,200,100,1,00297,India
296144,2023-10-17,1007,Eyeshadow,200,400,200,1,00297,India
296144,2023-10-17,1006,Blush,150,300,150,1,00297,India
296144,2023-10-17,1001,Lipstick,150,300,150,1,00297,India
296144,2023-10-17,1012,Body Lotion,200,400,200,2,00297,India
838083,2023-10-17,1009,Moisturizer,250,500,250,2,00065,India
838083,2023-10-17,1002,Mascara,200,400,200,1,00065,India
838083,2023-10-17,1003,Foundation,300,600,300,1,00065,India
597978,2023-10-17,1005,Nail Polish,50,100,50,1,00428,India
597978,2023-10-17,1002,Mascara,200,400,200,1,00428,India
597978,2023-10-17,1006,Blush,150,300,150,1,00428,India
436725,2023-10-17,1006,Blush,150,300,150,1,00126,India
436725,2023-10-17,1005,Nail Polish,50,100,50,1,00126,India
698357,2023-10-17,1007,Eyeshadow,200,400,200,1,00029,India
698357,2023-10-17,1003,Foundation,300,600,300,1,00029,India
698357,2023-10-17,1006,Blush,150,300,150,1,00029,India
466761,2023-10-17,1008,Makeup Remover,80,160,80,1,00260,India
466761,2023-10-17,1002,Mascara,200,400,200,1,00260,India
466761,2023-10-17,1012,Body Lotion,200,400,200,2,00260,India
331484,2023-10-17,1001,Lipstick,150,300,150,1,00362,India
331484,2023-10-17,1006,Blush,150,300,150,1,00362,India
285680,2023-10-17,1008,Makeup Remover,80,160,80,1,00305,India
285680,2023-10-17,1006,Blush,150,300,150,1,00305,India
867832,2023-10-17,1007,Eyeshadow,200,400,200,1,00329,India
569198,2023-10-17,1008,Makeup Remover,80,160,80,1,00012,India
762771,2023-10-17,1003,Foundation,300,600,300,1,00336,India
762771,2023-10-17,1006,Blush,150,300,150,1,00336,India
452036,2023-10-17,1006,Blush,150,300,150,1,00168,India
452036,2023-10-17,1002,Mascara,200,400,200,1,00168,India
549701,2023-10-17,1009,Moisturizer,250,500,250,2,00436,India
143595,2023-10-17,1008,Makeup Remover,80,160,80,1,00117,India
143595,2023-10-17,1005,Nail Polish,50,100,50,1,00117,India
143595,2023-10-17,1007,Eyeshadow,200,400,200,1,00117,India
143595,2023-10-17,1002,Mascara,200,400,200,1,00117,India
125908,2023-10-17,1006,Blush,150,300,150,1,00414,India
125908,2023-10-17,1007,Eyeshadow,200,400,200,1,00414,India
125908,2023-10-17,1005,Nail Polish,50,100,50,1,00414,India
185031,2023-10-17,1001,Lipstick,150,300,150,1,00227,India
185031,2023-10-17,1002,Mascara,200,400,200,1,00227,India
526960,2023-10-17,1002,Mascara,200,400,200,1,00364,India
766917,2023-10-17,1012,Body Lotion,200,400,200,2,00324,India
766917,2023-10-17,1004,Eyeliner,100,200,100,1,00324,India
889012,2023-10-17,1001,Lipstick,150,300,150,1,00223,India
889012,2023-10-17,1006,Blush,150,300,150,1,00223,India
889012,2023-10-17,1002,Mascara,200,400,200,1,00223,India
429844,2023-10-17,1008,Makeup Remover,80,160,80,1,00006,India
429844,2023-10-17,1006,Blush,150,300,150,1,00006,India
504569,2023-10-18,1008,Makeup Remover,80,160,80,1,00312,India
305667,2023-10-18,1002,Mascara,200,400,200,1,00083,India
641706,2023-10-18,1008,Makeup Remover,80,160,80,1,00125,India
641706,2023-10-18,1007,Eyeshadow,200,400,200,1,00125,India
573041,2023-10-18,1008,Makeup Remover,80,160,80,1,00397,India
573041,2023-10-18,1009,Moisturizer,250,500,250,2,00397,India
573041,2023-10-18,1001,Lipstick,150,300,150,1,00397,India
573041,2023-10-18,1004,Eyeliner,100,200,100,1,00397,India
706830,2023-10-18,1006,Blush,150,300,150,1,00422,India
706830,2023-10-18,1004,Eyeliner,100,200,100,1,00422,India
706830,2023-10-18,1009,Moisturizer,250,500,250,2,00422,India
339867,2023-10-18,1007,Eyeshadow,200,400,200,1,00267,India
813655,2023-10-18,1005,Nail Polish,50,100,50,1,00085,India
517539,2023-10-18,1006,Blush,150,300,150,1,00286,India
517539,2023-10-18,1012,Body Lotion,200,400,200,2,00286,India
517539,2023-10-18,1003,Foundation,300,600,300,1,00286,India
798204,2023-10-18,1007,Eyeshadow,200,400,200,1,00375,India
798204,2023-10-18,1005,Nail Polish,50,100,50,1,00375,India
195318,2023-10-18,1008,Makeup Remover,80,160,80,1,00004,India
195318,2023-10-18,1005,Nail Polish,50,100,50,1,00004,India
195318,2023-10-18,1007,Eyeshadow,200,400,200,1,00004,India
195318,2023-10-18,1009,Moisturizer,250,500,250,2,00004,India
219930,2023-10-18,1003,Foundation,300,600,300,1,00376,India
219930,2023-10-18,1001,Lipstick,150,300,150,1,00376,India
524576,2023-10-18,1002,Mascara,200,400,200,1,00437,India
524576,2023-10-18,1012,Body Lotion,200,400,200,2,00437,India
524576,2023-10-18,1009,Moisturizer,250,500,250,2,00437,India
588975,2023-10-18,1012,Body Lotion,200,400,200,2,00173,India
588975,2023-10-18,1001,Lipstick,150,300,150,1,00173,India
588975,2023-10-18,1003,Foundation,300,600,300,1,00173,India
588975,2023-10-18,1009,Moisturizer,250,500,250,2,00173,India
698059,2023-10-18,1003,Foundation,300,600,300,1,00277,India
698059,2023-10-18,1005,Nail Polish,50,100,50,1,00277,India
698059,2023-10-18,1004,Eyeliner,100,200,100,1,00277,India
967198,2023-10-18,1007,Eyeshadow,200,400,200,1,00336,India
967198,2023-10-18,1012,Body Lotion,200,400,200,2,00336,India
967198,2023-10-18,1008,Makeup Remover,80,160,80,1,00336,India
967198,2023-10-18,1001,Lipstick,150,300,150,1,00336,India
894725,2023-10-18,1002,Mascara,200,400,200,1,00154,India
894725,2023-10-18,1008,Makeup Remover,80,160,80,1,00154,India
666993,2023-10-18,1004,Eyeliner,100,200,100,1,00229,India
666993,2023-10-18,1008,Makeup Remover,80,160,80,1,00229,India
666993,2023-10-18,1009,Moisturizer,250,500,250,2,00229,India
666993,2023-10-18,1007,Eyeshadow,200,400,200,1,00229,India
447789,2023-10-18,1005,Nail Polish,50,100,50,1,00480,India
447789,2023-10-18,1006,Blush,150,300,150,1,00480,India
447789,2023-10-18,1007,Eyeshadow,200,400,200,1,00480,India
447789,2023-10-18,1004,Eyeliner,100,200,100,1,00480,India
839148,2023-10-18,1005,Nail Polish,50,100,50,1,00469,India
839148,2023-10-18,1004,Eyeliner,100,200,100,1,00469,India
839148,2023-10-18,1006,Blush,150,300,150,1,00469,India
839148,2023-10-18,1002,Mascara,200,400,200,1,00469,India
711636,2023-10-18,1004,Eyeliner,100,200,100,1,00398,India
711636,2023-10-18,1002,Mascara,200,400,200,1,00398,India
711636,2023-10-18,1012,Body Lotion,200,400,200,2,00398,India
821563,2023-10-18,1006,Blush,150,300,150,1,00416,India
821563,2023-10-18,1004,Eyeliner,100,200,100,1,00416,India
821563,2023-10-18,1003,Foundation,300,600,300,1,00416,India
764211,2023-10-18,1007,Eyeshadow,200,400,200,1,00303,India
764211,2023-10-18,1006,Blush,150,300,150,1,00303,India
764211,2023-10-18,1009,Moisturizer,250,500,250,2,00303,India
764211,2023-10-18,1001,Lipstick,150,300,150,1,00303,India
885569,2023-10-18,1005,Nail Polish,50,100,50,1,00291,India
885569,2023-10-18,1008,Makeup Remover,80,160,80,1,00291,India
885569,2023-10-18,1002,Mascara,200,400,200,1,00291,India
122543,2023-10-18,1008,Makeup Remover,80,160,80,1,00477,India
122543,2023-10-18,1007,Eyeshadow,200,400,200,1,00477,India
122543,2023-10-18,1002,Mascara,200,400,200,1,00477,India
122543,2023-10-18,1004,Eyeliner,100,200,100,1,00477,India
122543,2023-10-18,1001,Lipstick,150,300,150,1,00477,India
343206,2023-10-18,1005,Nail Polish,50,100,50,1,00464,India
343206,2023-10-18,1003,Foundation,300,600,300,1,00464,India
343206,2023-10-18,1006,Blush,150,300,150,1,00464,India
343206,2023-10-18,1012,Body Lotion,200,400,200,2,00464,India
945880,2023-10-18,1008,Makeup Remover,80,160,80,1,00257,India
945880,2023-10-18,1009,Moisturizer,250,500,250,2,00257,India
945880,2023-10-18,1001,Lipstick,150,300,150,1,00257,India
945880,2023-10-18,1007,Eyeshadow,200,400,200,1,00257,India
729408,2023-10-18,1002,Mascara,200,400,200,1,00440,India
729408,2023-10-18,1007,Eyeshadow,200,400,200,1,00440,India
251405,2023-10-18,1012,Body Lotion,200,400,200,2,00282,India
251405,2023-10-18,1009,Moisturizer,250,500,250,2,00282,India
519080,2023-10-18,1007,Eyeshadow,200,400,200,1,00002,India
376412,2023-10-18,1005,Nail Polish,50,100,50,1,00471,India
376412,2023-10-18,1002,Mascara,200,400,200,1,00471,India
376412,2023-10-18,1006,Blush,150,300,150,1,00471,India
628634,2023-10-18,1005,Nail Polish,50,100,50,1,00140,India
628634,2023-10-18,1002,Mascara,200,400,200,1,00140,India
628634,2023-10-18,1003,Foundation,300,600,300,1,00140,India
304223,2023-10-18,1001,Lipstick,150,300,150,1,00421,India
304223,2023-10-18,1002,Mascara,200,400,200,1,00421,India
304223,2023-10-18,1004,Eyeliner,100,200,100,1,00421,India
332403,2023-10-18,1001,Lipstick,150,300,150,1,00219,India
332403,2023-10-18,1003,Foundation,300,600,300,1,00219,India
332403,2023-10-18,1012,Body Lotion,200,400,200,2,00219,India
332403,2023-10-18,1002,Mascara,200,400,200,1,00219,India
348361,2023-10-18,1001,Lipstick,150,300,150,1,00247,India
515172,2023-10-18,1006,Blush,150,300,150,1,00026,India
515172,2023-10-18,1003,Foundation,300,600,300,1,00026,India
515172,2023-10-18,1005,Nail Polish,50,100,50,1,00026,India
105960,2023-10-18,1008,Makeup Remover,80,160,80,1,00098,India
105960,2023-10-18,1006,Blush,150,300,150,1,00098,India
105960,2023-10-18,1004,Eyeliner,100,200,100,1,00098,India
105960,2023-10-18,1001,Lipstick,150,300,150,1,00098,India
427248,2023-10-18,1001,Lipstick,150,300,150,1,00027,India
427248,2023-10-18,1004,Eyeliner,100,200,100,1,00027,India
283171,2023-10-18,1006,Blush,150,300,150,1,00157,India
762334,2023-10-18,1006,Blush,150,300,150,1,00358,India
762334,2023-10-18,1007,Eyeshadow,200,400,200,1,00358,India
762334,2023-10-18,1012,Body Lotion,200,400,200,2,00358,India
147323,2023-10-18,1001,Lipstick,150,300,150,1,00212,India
147323,2023-10-18,1004,Eyeliner,100,200,100,1,00212,India
147323,2023-10-18,1012,Body Lotion,200,400,200,2,00212,India
147323,2023-10-18,1002,Mascara,200,400,200,1,00212,India
975062,2023-10-18,1006,Blush,150,300,150,1,00109,India
975062,2023-10-18,1012,Body Lotion,200,400,200,2,00109,India
975062,2023-10-18,1002,Mascara,200,400,200,1,00109,India
747022,2023-10-18,1001,Lipstick,150,300,150,1,00202,India
747022,2023-10-18,1007,Eyeshadow,200,400,200,1,00202,India
747022,2023-10-18,1006,Blush,150,300,150,1,00202,India
747022,2023-10-18,1004,Eyeliner,100,200,100,1,00202,India
215267,2023-10-18,1002,Mascara,200,400,200,1,00257,India
745300,2023-10-18,1005,Nail Polish,50,100,50,1,00323,India
745300,2023-10-18,1008,Makeup Remover,80,160,80,1,00323,India
745300,2023-10-18,1004,Eyeliner,100,200,100,1,00323,India
745300,2023-10-18,1002,Mascara,200,400,200,1,00323,India
745300,2023-10-18,1012,Body Lotion,200,400,200,2,00323,India
856955,2023-10-18,1006,Blush,150,300,150,1,00463,India
856955,2023-10-18,1002,Mascara,200,400,200,1,00463,India
856955,2023-10-18,1007,Eyeshadow,200,400,200,1,00463,India
856955,2023-10-18,1012,Body Lotion,200,400,200,2,00463,India
616149,2023-10-18,1012,Body Lotion,200,400,200,2,00186,India
784131,2023-10-18,1007,Eyeshadow,200,400,200,1,00101,India
812793,2023-10-19,1007,Eyeshadow,200,400,200,1,00375,India
812793,2023-10-19,1001,Lipstick,150,300,150,1,00375,India
812793,2023-10-19,1004,Eyeliner,100,200,100,1,00375,India
962194,2023-10-19,1002,Mascara,200,400,200,1,00295,India
962194,2023-10-19,1001,Lipstick,150,300,150,1,00295,India
962194,2023-10-19,1006,Blush,150,300,150,1,00295,India
962194,2023-10-19,1003,Foundation,300,600,300,1,00295,India
855186,2023-10-19,1007,Eyeshadow,200,400,200,1,00372,India
855186,2023-10-19,1008,Makeup Remover,80,160,80,1,00372,India
855186,2023-10-19,1001,Lipstick,150,300,150,1,00372,India
785803,2023-10-19,1002,Mascara,200,400,200,1,00148,India
785803,2023-10-19,1012,Body Lotion,200,400,200,2,00148,India
785803,2023-10-19,1006,Blush,150,300,150,1,00148,India
923650,2023-10-19,1012,Body Lotion,200,400,200,2,00023,India
923650,2023-10-19,1002,Mascara,200,400,200,1,00023,India
308430,2023-10-19,1007,Eyeshadow,200,400,200,1,00064,India
284253,2023-10-19,1008,Makeup Remover,80,160,80,1,00018,India
284253,2023-10-19,1005,Nail Polish,50,100,50,1,00018,India
284253,2023-10-19,1012,Body Lotion,200,400,200,2,00018,India
185194,2023-10-19,1005,Nail Polish,50,100,50,1,00484,India
185194,2023-10-19,1012,Body Lotion,200,400,200,2,00484,India
185194,2023-10-19,1007,Eyeshadow,200,400,200,1,00484,India
679683,2023-10-19,1001,Lipstick,150,300,150,1,00332,India
679683,2023-10-19,1009,Moisturizer,250,500,250,2,00332,India
679683,2023-10-19,1006,Blush,150,300,150,1,00332,India
679683,2023-10-19,1008,Makeup Remover,80,160,80,1,00332,India
802228,2023-10-19,1006,Blush,150,300,150,1,00031,India
802228,2023-10-19,1009,Moisturizer,250,500,250,2,00031,India
802228,2023-10-19,1002,Mascara,200,400,200,1,00031,India
225889,2023-10-19,1004,Eyeliner,100,200,100,1,00219,India
225889,2023-10-19,1003,Foundation,300,600,300,1,00219,India
301703,2023-10-19,1012,Body Lotion,200,400,200,2,00140,India
301703,2023-10-19,1007,Eyeshadow,200,400,200,1,00140,India
301703,2023-10-19,1005,Nail Polish,50,100,50,1,00140,India
156522,2023-10-19,1005,Nail Polish,50,100,50,1,00007,India
402080,2023-10-19,1006,Blush,150,300,150,1,00005,India
402080,2023-10-19,1012,Body Lotion,200,400,200,2,00005,India
402080,2023-10-19,1003,Foundation,300,600,300,1,00005,India
402080,2023-10-19,1008,Makeup Remover,80,160,80,1,00005,India
402080,2023-10-19,1001,Lipstick,150,300,150,1,00005,India
511827,2023-10-19,1002,Mascara,200,400,200,1,00211,India
511827,2023-10-19,1005,Nail Polish,50,100,50,1,00211,India
881643,2023-10-19,1005,Nail Polish,50,100,50,1,00404,India
881643,2023-10-19,1002,Mascara,200,400,200,1,00404,India
881643,2023-10-19,1003,Foundation,300,600,300,1,00404,India
802706,2023-10-19,1012,Body Lotion,200,400,200,2,00288,India
802706,2023-10-19,1005,Nail Polish,50,100,50,1,00288,India
802706,2023-10-19,1004,Eyeliner,100,200,100,1,00288,India
802706,2023-10-19,1006,Blush,150,300,150,1,00288,India
607851,2023-10-19,1007,Eyeshadow,200,400,200,1,00499,India
607851,2023-10-19,1001,Lipstick,150,300,150,1,00499,India
607851,2023-10-19,1002,Mascara,200,400,200,1,00499,India
146004,2023-10-19,1005,Nail Polish,50,100,50,1,00134,India
146004,2023-10-19,1001,Lipstick,150,300,150,1,00134,India
146004,2023-10-19,1007,Eyeshadow,200,400,200,1,00134,India
146004,2023-10-19,1012,Body Lotion,200,400,200,2,00134,India
120487,2023-10-19,1002,Mascara,200,400,200,1,00357,India
120487,2023-10-19,1004,Eyeliner,100,200,100,1,00357,India
741213,2023-10-19,1002,Mascara,200,400,200,1,00243,India
741213,2023-10-19,1009,Moisturizer,250,500,250,2,00243,India
253989,2023-10-19,1004,Eyeliner,100,200,100,1,00154,India
253989,2023-10-19,1007,Eyeshadow,200,400,200,1,00154,India
253989,2023-10-19,1012,Body Lotion,200,400,200,2,00154,India
274597,2023-10-19,1004,Eyeliner,100,200,100,1,00372,India
274597,2023-10-19,1005,Nail Polish,50,100,50,1,00372,India
826376,2023-10-19,1001,Lipstick,150,300,150,1,00178,India
826376,2023-10-19,1003,Foundation,300,600,300,1,00178,India
826376,2023-10-19,1008,Makeup Remover,80,160,80,1,00178,India
402572,2023-10-19,1003,Foundation,300,600,300,1,00194,India
402572,2023-10-19,1006,Blush,150,300,150,1,00194,India
402572,2023-10-19,1002,Mascara,200,400,200,1,00194,India
804260,2023-10-19,1009,Moisturizer,250,500,250,2,00273,India
804260,2023-10-19,1006,Blush,150,300,150,1,00273,India
804260,2023-10-19,1003,Foundation,300,600,300,1,00273,India
804260,2023-10-19,1004,Eyeliner,100,200,100,1,00273,India
547596,2023-10-19,1007,Eyeshadow,200,400,200,1,00383,India
547596,2023-10-19,1012,Body Lotion,200,400,200,2,00383,India
547596,2023-10-19,1004,Eyeliner,100,200,100,1,00383,India
547596,2023-10-19,1006,Blush,150,300,150,1,00383,India
547596,2023-10-19,1001,Lipstick,150,300,150,1,00383,India
316339,2023-10-19,1003,Foundation,300,600,300,1,00078,India
869402,2023-10-19,1002,Mascara,200,400,200,1,00260,India
511936,2023-10-19,1009,Moisturizer,250,500,250,2,00289,India
101410,2023-10-19,1007,Eyeshadow,200,400,200,1,00162,India
101410,2023-10-19,1001,Lipstick,150,300,150,1,00162,India
101410,2023-10-19,1003,Foundation,300,600,300,1,00162,India
772665,2023-10-19,1008,Makeup Remover,80,160,80,1,00206,India
772665,2023-10-19,1001,Lipstick,150,300,150,1,00206,India
524426,2023-10-19,1004,Eyeliner,100,200,100,1,00026,India
524426,2023-10-19,1009,Moisturizer,250,500,250,2,00026,India
127841,2023-10-19,1007,Eyeshadow,200,400,200,1,00139,India
127841,2023-10-19,1003,Foundation,300,600,300,1,00139,India
127841,2023-10-19,1012,Body Lotion,200,400,200,2,00139,India
127841,2023-10-19,1004,Eyeliner,100,200,100,1,00139,India
803139,2023-10-19,1001,Lipstick,150,300,150,1,00370,India
803139,2023-10-19,1005,Nail Polish,50,100,50,1,00370,India
357981,2023-10-19,1007,Eyeshadow,200,400,200,1,00025,India
357981,2023-10-19,1002,Mascara,200,400,200,1,00025,India
357981,2023-10-19,1004,Eyeliner,100,200,100,1,00025,India
357981,2023-10-19,1012,Body Lotion,200,400,200,2,00025,India
475917,2023-10-19,1008,Makeup Remover,80,160,80,1,00090,India
475639,2023-10-20,1004,Eyeliner,100,200,100,1,00180,India
475639,2023-10-20,1008,Makeup Remover,80,160,80,1,00180,India
824499,2023-10-20,1001,Lipstick,150,300,150,1,00278,India
872792,2023-10-20,1005,Nail Polish,50,100,50,1,00172,India
613706,2023-10-20,1012,Body Lotion,200,400,200,2,00307,India
613706,2023-10-20,1007,Eyeshadow,200,400,200,1,00307,India
613706,2023-10-20,1004,Eyeliner,100,200,100,1,00307,India
372758,2023-10-20,1012,Body Lotion,200,400,200,2,00407,India
372758,2023-10-20,1002,Mascara,200,400,200,1,00407,India
372758,2023-10-20,1001,Lipstick,150,300,150,1,00407,India
372758,2023-10-20,1006,Blush,150,300,150,1,00407,India
372758,2023-10-20,1005,Nail Polish,50,100,50,1,00407,India
694985,2023-10-20,1004,Eyeliner,100,200,100,1,00167,India
694985,2023-10-20,1001,Lipstick,150,300,150,1,00167,India
694985,2023-10-20,1005,Nail Polish,50,100,50,1,00167,India
755897,2023-10-20,1004,Eyeliner,100,200,100,1,00103,India
755897,2023-10-20,1012,Body Lotion,200,400,200,2,00103,India
755897,2023-10-20,1007,Eyeshadow,200,400,200,1,00103,India
755897,2023-10-20,1006,Blush,150,300,150,1,00103,India
825788,2023-10-20,1009,Moisturizer,250,500,250,2,00321,India
783980,2023-10-20,1012,Body Lotion,200,400,200,2,00146,India
783980,2023-10-20,1005,Nail Polish,50,100,50,1,00146,India
783980,2023-10-20,1003,Foundation,300,600,300,1,00146,India
685023,2023-10-20,1008,Makeup Remover,80,160,80,1,00451,India
685023,2023-10-20,1006,Blush,150,300,150,1,00451,India
594729,2023-10-20,1005,Nail Polish,50,100,50,1,00487,India
594729,2023-10-20,1007,Eyeshadow,200,400,200,1,00487,India
594729,2023-10-20,1004,Eyeliner,100,200,100,1,00487,India
332697,2023-10-20,1006,Blush,150,300,150,1,00222,India
332697,2023-10-20,1009,Moisturizer,250,500,250,2,00222,India
332697,2023-10-20,1008,Makeup Remover,80,160,80,1,00222,India
332697,2023-10-20,1003,Foundation,300,600,300,1,00222,India
332697,2023-10-20,1002,Mascara,200,400,200,1,00222,India
463901,2023-10-20,1004,Eyeliner,100,200,100,1,00073,India
463901,2023-10-20,1006,Blush,150,300,150,1,00073,India
490643,2023-10-20,1002,Mascara,200,400,200,1,00085,India
490643,2023-10-20,1008,Makeup Remover,80,160,80,1,00085,India
490643,2023-10-20,1001,Lipstick,150,300,150,1,00085,India
618189,2023-10-20,1009,Moisturizer,250,500,250,2,00226,India
234792,2023-10-20,1002,Mascara,200,400,200,1,00134,India
234792,2023-10-20,1006,Blush,150,300,150,1,00134,India
234792,2023-10-20,1009,Moisturizer,250,500,250,2,00134,India
234792,2023-10-20,1004,Eyeliner,100,200,100,1,00134,India
906832,2023-10-20,1009,Moisturizer,250,500,250,2,00255,India
906832,2023-10-20,1001,Lipstick,150,300,150,1,00255,India
906832,2023-10-20,1007,Eyeshadow,200,400,200,1,00255,India
297911,2023-10-20,1008,Makeup Remover,80,160,80,1,00336,India
297911,2023-10-20,1006,Blush,150,300,150,1,00336,India
297911,2023-10-20,1002,Mascara,200,400,200,1,00336,India
297911,2023-10-20,1001,Lipstick,150,300,150,1,00336,India
830205,2023-10-20,1006,Blush,150,300,150,1,00257,India
830205,2023-10-20,1007,Eyeshadow,200,400,200,1,00257,India
830205,2023-10-20,1002,Mascara,200,400,200,1,00257,India
605577,2023-10-20,1012,Body Lotion,200,400,200,2,00319,India
605577,2023-10-20,1001,Lipstick,150,300,150,1,00319,India
605577,2023-10-20,1007,Eyeshadow,200,400,200,1,00319,India
814474,2023-10-20,1005,Nail Polish,50,100,50,1,00137,India
814474,2023-10-20,1009,Moisturizer,250,500,250,2,00137,India
814474,2023-10-20,1008,Makeup Remover,80,160,80,1,00137,India
814474,2023-10-20,1004,Eyeliner,100,200,100,1,00137,India
814474,2023-10-20,1007,Eyeshadow,200,400,200,1,00137,India
286169,2023-10-20,1003,Foundation,300,600,300,1,00037,India
286169,2023-10-20,1002,Mascara,200,400,200,1,00037,India
888261,2023-10-20,1003,Foundation,300,600,300,1,00268,India
618972,2023-10-20,1001,Lipstick,150,300,150,1,00380,India
618972,2023-10-20,1002,Mascara,200,400,200,1,00380,India
618972,2023-10-20,1008,Makeup Remover,80,160,80,1,00380,India
618972,2023-10-20,1009,Moisturizer,250,500,250,2,00380,India
376604,2023-10-20,1006,Blush,150,300,150,1,00017,India
376604,2023-10-20,1003,Foundation,300,600,300,1,00017,India
376604,2023-10-20,1002,Mascara,200,400,200,1,00017,India
376604,2023-10-20,1009,Moisturizer,250,500,250,2,00017,India
376604,2023-10-20,1008,Makeup Remover,80,160,80,1,00017,India
633526,2023-10-20,1003,Foundation,300,600,300,1,00144,India
185973,2023-10-20,1009,Moisturizer,250,500,250,2,00071,India
140943,2023-10-20,1009,Moisturizer,250,500,250,2,00382,India
140943,2023-10-20,1008,Makeup Remover,80,160,80,1,00382,India
140943,2023-10-20,1005,Nail Polish,50,100,50,1,00382,India
140943,2023-10-20,1007,Eyeshadow,200,400,200,1,00382,India
328290,2023-10-20,1012,Body Lotion,200,400,200,2,00437,India
328290,2023-10-20,1008,Makeup Remover,80,160,80,1,00437,India
371251,2023-10-20,1007,Eyeshadow,200,400,200,1,00378,India
371251,2023-10-20,1008,Makeup Remover,80,160,80,1,00378,India
783007,2023-10-21,1012,Body Lotion,200,400,200,2,00430,India
783007,2023-10-21,1009,Moisturizer,250,500,250,2,00430,India
783007,2023-10-21,1003,Foundation,300,600,300,1,00430,India
783007,2023-10-21,1004,Eyeliner,100,200,100,1,00430,India
371876,2023-10-21,1008,Makeup Remover,80,160,80,1,00230,India
371876,2023-10-21,1005,Nail Polish,50,100,50,1,00230,India
371876,2023-10-21,1012,Body Lotion,200,400,200,2,00230,India
371876,2023-10-21,1002,Mascara,200,400,200,1,00230,India
490483,2023-10-21,1003,Foundation,300,600,300,1,00499,India
490483,2023-10-21,1009,Moisturizer,250,500,250,2,00499,India
490483,2023-10-21,1004,Eyeliner,100,200,100,1,00499,India
737432,2023-10-21,1003,Foundation,300,600,300,1,00442,India
737432,2023-10-21,1001,Lipstick,150,300,150,1,00442,India
737432,2023-10-21,1008,Makeup Remover,80,160,80,1,00442,India
737432,2023-10-21,1009,Moisturizer,250,500,250,2,00442,India
386197,2023-10-21,1004,Eyeliner,100,200,100,1,00135,India
766247,2023-10-21,1002,Mascara,200,400,200,1,00266,India
766247,2023-10-21,1006,Blush,150,300,150,1,00266,India
766247,2023-10-21,1004,Eyeliner,100,200,100,1,00266,India
766247,2023-10-21,1009,Moisturizer,250,500,250,2,00266,India
761448,2023-10-21,1005,Nail Polish,50,100,50,1,00442,India
761448,2023-10-21,1002,Mascara,200,400,200,1,00442,India
761448,2023-10-21,1007,Eyeshadow,200,400,200,1,00442,India
761448,2023-10-21,1004,Eyeliner,100,200,100,1,00442,India
996108,2023-10-21,1009,Moisturizer,250,500,250,2,00244,India
996108,2023-10-21,1007,Eyeshadow,200,400,200,1,00244,India
996108,2023-10-21,1008,Makeup Remover,80,160,80,1,00244,India
168023,2023-10-21,1004,Eyeliner,100,200,100,1,00230,India
168023,2023-10-21,1008,Makeup Remover,80,160,80,1,00230,India
527990,2023-10-21,1009,Moisturizer,250,500,250,2,00194,India
527990,2023-10-21,1012,Body Lotion,200,400,200,2,00194,India
527990,2023-10-21,1008,Makeup Remover,80,160,80,1,00194,India
527990,2023-10-21,1006,Blush,150,300,150,1,00194,India
857873,2023-10-21,1012,Body Lotion,200,400,200,2,00081,India
438998,2023-10-21,1001,Lipstick,150,300,150,1,00429,India
438998,2023-10-21,1008,Makeup Remover,80,160,80,1,00429,India
924506,2023-10-21,1007,Eyeshadow,200,400,200,1,00407,India
924506,2023-10-21,1005,Nail Polish,50,100,50,1,00407,India
924506,2023-10-21,1006,Blush,150,300,150,1,00407,India
355211,2023-10-21,1008,Makeup Remover,80,160,80,1,00443,India
355211,2023-10-21,1004,Eyeliner,100,200,100,1,00443,India
355211,2023-10-21,1005,Nail Polish,50,100,50,1,00443,India
275922,2023-10-21,1012,Body Lotion,200,400,200,2,00206,India
275922,2023-10-21,1003,Foundation,300,600,300,1,00206,India
275922,2023-10-21,1002,Mascara,200,400,200,1,00206,India
366421,2023-10-21,1012,Body Lotion,200,400,200,2,00295,India
370141,2023-10-21,1009,Moisturizer,250,500,250,2,00475,India
524988,2023-10-21,1005,Nail Polish,50,100,50,1,00208,India
524988,2023-10-21,1009,Moisturizer,250,500,250,2,00208,India
524988,2023-10-21,1002,Mascara,200,400,200,1,00208,India
524988,2023-10-21,1007,Eyeshadow,200,400,200,1,00208,India
398120,2023-10-21,1005,Nail Polish,50,100,50,1,00201,India
398120,2023-10-21,1012,Body Lotion,200,400,200,2,00201,India
398120,2023-10-21,1002,Mascara,200,400,200,1,00201,India
672241,2023-10-21,1002,Mascara,200,400,200,1,00070,India
672241,2023-10-21,1007,Eyeshadow,200,400,200,1,00070,India
672241,2023-10-21,1001,Lipstick,150,300,150,1,00070,India
672241,2023-10-21,1008,Makeup Remover,80,160,80,1,00070,India
184131,2023-10-21,1002,Mascara,200,400,200,1,00030,India
184131,2023-10-21,1005,Nail Polish,50,100,50,1,00030,India
184131,2023-10-21,1007,Eyeshadow,200,400,200,1,00030,India
931680,2023-10-21,1007,Eyeshadow,200,400,200,1,00034,India
931680,2023-10-21,1001,Lipstick,150,300,150,1,00034,India
931680,2023-10-21,1009,Moisturizer,250,500,250,2,00034,India
308023,2023-10-21,1005,Nail Polish,50,100,50,1,00316,India
308023,2023-10-21,1004,Eyeliner,100,200,100,1,00316,India
308023,2023-10-21,1009,Moisturizer,250,500,250,2,00316,India
308023,2023-10-21,1006,Blush,150,300,150,1,00316,India
798354,2023-10-21,1004,Eyeliner,100,200,100,1,00235,India
798354,2023-10-21,1007,Eyeshadow,200,400,200,1,00235,India
798354,2023-10-21,1008,Makeup Remover,80,160,80,1,00235,India
940949,2023-10-21,1005,Nail Polish,50,100,50,1,00077,India
940949,2023-10-21,1002,Mascara,200,400,200,1,00077,India
940949,2023-10-21,1007,Eyeshadow,200,400,200,1,00077,India
940949,2023-10-21,1003,Foundation,300,600,300,1,00077,India
385446,2023-10-21,1007,Eyeshadow,200,400,200,1,00406,India
385446,2023-10-21,1012,Body Lotion,200,400,200,2,00406,India
856933,2023-10-21,1009,Moisturizer,250,500,250,2,00475,India
856933,2023-10-21,1005,Nail Polish,50,100,50,1,00475,India
856933,2023-10-21,1012,Body Lotion,200,400,200,2,00475,India
743637,2023-10-21,1004,Eyeliner,100,200,100,1,00439,India
743637,2023-10-21,1006,Blush,150,300,150,1,00439,India
743637,2023-10-21,1012,Body Lotion,200,400,200,2,00439,India
955278,2023-10-21,1006,Blush,150,300,150,1,00091,India
955278,2023-10-21,1007,Eyeshadow,200,400,200,1,00091,India
955278,2023-10-21,1008,Makeup Remover,80,160,80,1,00091,India
955278,2023-10-21,1012,Body Lotion,200,400,200,2,00091,India
642158,2023-10-21,1001,Lipstick,150,300,150,1,00471,India
642158,2023-10-21,1005,Nail Polish,50,100,50,1,00471,India
642158,2023-10-21,1002,Mascara,200,400,200,1,00471,India
642158,2023-10-21,1007,Eyeshadow,200,400,200,1,00471,India
543677,2023-10-21,1009,Moisturizer,250,500,250,2,00201,India
543677,2023-10-21,1007,Eyeshadow,200,400,200,1,00201,India
343067,2023-10-21,1003,Foundation,300,600,300,1,00418,India
343067,2023-10-21,1002,Mascara,200,400,200,1,00418,India
968835,2023-10-21,1009,Moisturizer,250,500,250,2,00057,India
968835,2023-10-21,1001,Lipstick,150,300,150,1,00057,India
788251,2023-10-21,1001,Lipstick,150,300,150,1,00230,India
788251,2023-10-21,1005,Nail Polish,50,100,50,1,00230,India
788251,2023-10-21,1009,Moisturizer,250,500,250,2,00230,India
398782,2023-10-21,1003,Foundation,300,600,300,1,00172,India
398782,2023-10-21,1005,Nail Polish,50,100,50,1,00172,India
740370,2023-10-21,1006,Blush,150,300,150,1,00259,India
740370,2023-10-21,1007,Eyeshadow,200,400,200,1,00259,India
740370,2023-10-21,1008,Makeup Remover,80,160,80,1,00259,India
832681,2023-10-21,1003,Foundation,300,600,300,1,00193,India
832681,2023-10-21,1007,Eyeshadow,200,400,200,1,00193,India
158735,2023-10-21,1001,Lipstick,150,300,150,1,00416,India
158735,2023-10-21,1003,Foundation,300,600,300,1,00416,India
136431,2023-10-21,1009,Moisturizer,250,500,250,2,00002,India
136431,2023-10-21,1003,Foundation,300,600,300,1,00002,India
136431,2023-10-21,1006,Blush,150,300,150,1,00002,India
136431,2023-10-21,1004,Eyeliner,100,200,100,1,00002,India
671462,2023-10-21,1005,Nail Polish,50,100,50,1,00076,India
149498,2023-10-21,1001,Lipstick,150,300,150,1,00180,India
149498,2023-10-21,1012,Body Lotion,200,400,200,2,00180,India
149498,2023-10-21,1009,Moisturizer,250,500,250,2,00180,India
401119,2023-10-21,1006,Blush,150,300,150,1,00432,India
401119,2023-10-21,1009,Moisturizer,250,500,250,2,00432,India
401119,2023-10-21,1007,Eyeshadow,200,400,200,1,00432,India
401119,2023-10-21,1012,Body Lotion,200,400,200,2,00432,India
731716,2023-10-21,1001,Lipstick,150,300,150,1,00096,India
772636,2023-10-22,1002,Mascara,200,400,200,1,00144,India
772636,2023-10-22,1007,Eyeshadow,200,400,200,1,00144,India
772636,2023-10-22,1009,Moisturizer,250,500,250,2,00144,India
751928,2023-10-22,1012,Body Lotion,200,400,200,2,00493,India
751928,2023-10-22,1008,Makeup Remover,80,160,80,1,00493,India
751928,2023-10-22,1004,Eyeliner,100,200,100,1,00493,India
751928,2023-10-22,1003,Foundation,300,600,300,1,00493,India
751928,2023-10-22,1009,Moisturizer,250,500,250,2,00493,India
830322,2023-10-22,1002,Mascara,200,400,200,1,00052,India
830322,2023-10-22,1001,Lipstick,150,300,150,1,00052,India
186902,2023-10-22,1001,Lipstick,150,300,150,1,00413,India
186902,2023-10-22,1003,Foundation,300,600,300,1,00413,India
186902,2023-10-22,1002,Mascara,200,400,200,1,00413,India
684443,2023-10-22,1003,Foundation,300,600,300,1,00039,India
684443,2023-10-22,1001,Lipstick,150,300,150,1,00039,India
684443,2023-10-22,1004,Eyeliner,100,200,100,1,00039,India
801532,2023-10-22,1007,Eyeshadow,200,400,200,1,00308,India
801532,2023-10-22,1006,Blush,150,300,150,1,00308,India
801532,2023-10-22,1004,Eyeliner,100,200,100,1,00308,India
426251,2023-10-22,1001,Lipstick,150,300,150,1,00211,India
426251,2023-10-22,1008,Makeup Remover,80,160,80,1,00211,India
426251,2023-10-22,1009,Moisturizer,250,500,250,2,00211,India
426251,2023-10-22,1005,Nail Polish,50,100,50,1,00211,India
651066,2023-10-22,1007,Eyeshadow,200,400,200,1,00195,India
641857,2023-10-22,1006,Blush,150,300,150,1,00228,India
641857,2023-10-22,1012,Body Lotion,200,400,200,2,00228,India
388797,2023-10-22,1009,Moisturizer,250,500,250,2,00145,India
388797,2023-10-22,1005,Nail Polish,50,100,50,1,00145,India
388797,2023-10-22,1002,Mascara,200,400,200,1,00145,India
388797,2023-10-22,1006,Blush,150,300,150,1,00145,India
388797,2023-10-22,1007,Eyeshadow,200,400,200,1,00145,India
491214,2023-10-22,1005,Nail Polish,50,100,50,1,00463,India
830726,2023-10-22,1004,Eyeliner,100,200,100,1,00184,India
830726,2023-10-22,1007,Eyeshadow,200,400,200,1,00184,India
830726,2023-10-22,1002,Mascara,200,400,200,1,00184,India
750016,2023-10-22,1007,Eyeshadow,200,400,200,1,00452,India
750016,2023-10-22,1003,Foundation,300,600,300,1,00452,India
750016,2023-10-22,1012,Body Lotion,200,400,200,2,00452,India
750016,2023-10-22,1004,Eyeliner,100,200,100,1,00452,India
653873,2023-10-22,1009,Moisturizer,250,500,250,2,00428,India
653873,2023-10-22,1006,Blush,150,300,150,1,00428,India
653873,2023-10-22,1008,Makeup Remover,80,160,80,1,00428,India
796439,2023-10-22,1004,Eyeliner,100,200,100,1,00262,India
976605,2023-10-22,1009,Moisturizer,250,500,250,2,00238,India
976605,2023-10-22,1004,Eyeliner,100,200,100,1,00238,India
207010,2023-10-22,1005,Nail Polish,50,100,50,1,00414,India
936387,2023-10-22,1005,Nail Polish,50,100,50,1,00363,India
936387,2023-10-22,1001,Lipstick,150,300,150,1,00363,India
988969,2023-10-22,1003,Foundation,300,600,300,1,00364,India
988969,2023-10-22,1012,Body Lotion,200,400,200,2,00364,India
988969,2023-10-22,1005,Nail Polish,50,100,50,1,00364,India
988969,2023-10-22,1008,Makeup Remover,80,160,80,1,00364,India
656538,2023-10-22,1001,Lipstick,150,300,150,1,00476,India
127417,2023-10-22,1012,Body Lotion,200,400,200,2,00387,India
127417,2023-10-22,1004,Eyeliner,100,200,100,1,00387,India
350840,2023-10-22,1006,Blush,150,300,150,1,00421,India
350840,2023-10-22,1004,Eyeliner,100,200,100,1,00421,India
350840,2023-10-22,1001,Lipstick,150,300,150,1,00421,India
350840,2023-10-22,1003,Foundation,300,600,300,1,00421,India
910265,2023-10-22,1003,Foundation,300,600,300,1,00286,India
910265,2023-10-22,1004,Eyeliner,100,200,100,1,00286,India
910265,2023-10-22,1002,Mascara,200,400,200,1,00286,India
320313,2023-10-22,1008,Makeup Remover,80,160,80,1,00206,India
320313,2023-10-22,1012,Body Lotion,200,400,200,2,00206,India
320313,2023-10-22,1003,Foundation,300,600,300,1,00206,India
633569,2023-10-22,1009,Moisturizer,250,500,250,2,00089,India
633569,2023-10-22,1003,Foundation,300,600,300,1,00089,India
591124,2023-10-22,1008,Makeup Remover,80,160,80,1,00276,India
591124,2023-10-22,1002,Mascara,200,400,200,1,00276,India
591124,2023-10-22,1012,Body Lotion,200,400,200,2,00276,India
337747,2023-10-22,1003,Foundation,300,600,300,1,00194,India
337747,2023-10-22,1007,Eyeshadow,200,400,200,1,00194,India
337747,2023-10-22,1012,Body Lotion,200,400,200,2,00194,India
337747,2023-10-22,1004,Eyeliner,100,200,100,1,00194,India
313309,2023-10-22,1008,Makeup Remover,80,160,80,1,00237,India
313309,2023-10-22,1009,Moisturizer,250,500,250,2,00237,India
313309,2023-10-22,1001,Lipstick,150,300,150,1,00237,India
313309,2023-10-22,1002,Mascara,200,400,200,1,00237,India
288105,2023-10-22,1007,Eyeshadow,200,400,200,1,00455,India
671158,2023-10-22,1009,Moisturizer,250,500,250,2,00056,India
671158,2023-10-22,1006,Blush,150,300,150,1,00056,India
607063,2023-10-22,1002,Mascara,200,400,200,1,00272,India
607063,2023-10-22,1004,Eyeliner,100,200,100,1,00272,India
548389,2023-10-22,1012,Body Lotion,200,400,200,2,00415,India
548389,2023-10-22,1003,Foundation,300,600,300,1,00415,India
862712,2023-10-22,1002,Mascara,200,400,200,1,00027,India
862712,2023-10-22,1012,Body Lotion,200,400,200,2,00027,India
862712,2023-10-22,1008,Makeup Remover,80,160,80,1,00027,India
862712,2023-10-22,1005,Nail Polish,50,100,50,1,00027,India
455911,2023-10-22,1003,Foundation,300,600,300,1,00026,India
455911,2023-10-22,1006,Blush,150,300,150,1,00026,India
203947,2023-10-22,1002,Mascara,200,400,200,1,00034,India
203947,2023-10-22,1004,Eyeliner,100,200,100,1,00034,India
552959,2023-10-22,1007,Eyeshadow,200,400,200,1,00395,India
552959,2023-10-22,1008,Makeup Remover,80,160,80,1,00395,India
572537,2023-10-22,1002,Mascara,200,400,200,1,00485,India
572537,2023-10-22,1005,Nail Polish,50,100,50,1,00485,India
572537,2023-10-22,1009,Moisturizer,250,500,250,2,00485,India
572537,2023-10-22,1001,Lipstick,150,300,150,1,00485,India
572537,2023-10-22,1008,Makeup Remover,80,160,80,1,00485,India
900287,2023-10-22,1009,Moisturizer,250,500,250,2,00103,India
900287,2023-10-22,1003,Foundation,300,600,300,1,00103,India
597927,2023-10-22,1005,Nail Polish,50,100,50,1,00491,India
597927,2023-10-22,1003,Foundation,300,600,300,1,00491,India
888529,2023-10-22,1009,Moisturizer,250,500,250,2,00447,India
888529,2023-10-22,1001,Lipstick,150,300,150,1,00447,India
888529,2023-10-22,1004,Eyeliner,100,200,100,1,00447,India
678669,2023-10-22,1003,Foundation,300,600,300,1,00431,India
678669,2023-10-22,1002,Mascara,200,400,200,1,00431,India
678669,2023-10-22,1008,Makeup Remover,80,160,80,1,00431,India
139106,2023-10-22,1005,Nail Polish,50,100,50,1,00067,India
139106,2023-10-22,1004,Eyeliner,100,200,100,1,00067,India
139106,2023-10-22,1012,Body Lotion,200,400,200,2,00067,India
755529,2023-10-22,1003,Foundation,300,600,300,1,00027,India
218867,2023-10-22,1006,Blush,150,300,150,1,00051,India
850150,2023-10-22,1001,Lipstick,150,300,150,1,00212,India
850150,2023-10-22,1002,Mascara,200,400,200,1,00212,India
850150,2023-10-22,1012,Body Lotion,200,400,200,2,00212,India
850150,2023-10-22,1006,Blush,150,300,150,1,00212,India
850150,2023-10-22,1009,Moisturizer,250,500,250,2,00212,India
492818,2023-10-23,1005,Nail Polish,50,100,50,1,00414,India
492818,2023-10-23,1009,Moisturizer,250,500,250,2,00414,India
492818,2023-10-23,1003,Foundation,300,600,300,1,00414,India
492818,2023-10-23,1004,Eyeliner,100,200,100,1,00414,India
919176,2023-10-23,1006,Blush,150,300,150,1,00353,India
919176,2023-10-23,1012,Body Lotion,200,400,200,2,00353,India
915559,2023-10-23,1012,Body Lotion,200,400,200,2,00260,India
915559,2023-10-23,1001,Lipstick,150,300,150,1,00260,India
134906,2023-10-23,1008,Makeup Remover,80,160,80,1,00362,India
267451,2023-10-23,1007,Eyeshadow,200,400,200,1,00376,India
267451,2023-10-23,1008,Makeup Remover,80,160,80,1,00376,India
641089,2023-10-23,1001,Lipstick,150,300,150,1,00176,India
641089,2023-10-23,1003,Foundation,300,600,300,1,00176,India
641089,2023-10-23,1004,Eyeliner,100,200,100,1,00176,India
556526,2023-10-23,1007,Eyeshadow,200,400,200,1,00043,India
556526,2023-10-23,1004,Eyeliner,100,200,100,1,00043,India
394844,2023-10-23,1002,Mascara,200,400,200,1,00353,India
394844,2023-10-23,1012,Body Lotion,200,400,200,2,00353,India
602980,2023-10-23,1004,Eyeliner,100,200,100,1,00465,India
602980,2023-10-23,1005,Nail Polish,50,100,50,1,00465,India
602980,2023-10-23,1006,Blush,150,300,150,1,00465,India
622428,2023-10-23,1002,Mascara,200,400,200,1,00423,India
622428,2023-10-23,1001,Lipstick,150,300,150,1,00423,India
622428,2023-10-23,1007,Eyeshadow,200,400,200,1,00423,India
255645,2023-10-23,1009,Moisturizer,250,500,250,2,00133,India
181984,2023-10-23,1004,Eyeliner,100,200,100,1,00049,India
181984,2023-10-23,1008,Makeup Remover,80,160,80,1,00049,India
307918,2023-10-23,1006,Blush,150,300,150,1,00085,India
307918,2023-10-23,1007,Eyeshadow,200,400,200,1,00085,India
307918,2023-10-23,1008,Makeup Remover,80,160,80,1,00085,India
307918,2023-10-23,1004,Eyeliner,100,200,100,1,00085,India
307918,2023-10-23,1001,Lipstick,150,300,150,1,00085,India
960081,2023-10-23,1012,Body Lotion,200,400,200,2,00332,India
960081,2023-10-23,1007,Eyeshadow,200,400,200,1,00332,India
312221,2023-10-23,1006,Blush,150,300,150,1,00152,India
312221,2023-10-23,1009,Moisturizer,250,500,250,2,00152,India
944942,2023-10-23,1001,Lipstick,150,300,150,1,00310,India
467589,2023-10-23,1002,Mascara,200,400,200,1,00472,India
467589,2023-10-23,1006,Blush,150,300,150,1,00472,India
467589,2023-10-23,1012,Body Lotion,200,400,200,2,00472,India
778275,2023-10-23,1002,Mascara,200,400,200,1,00029,India
778275,2023-10-23,1012,Body Lotion,200,400,200,2,00029,India
420802,2023-10-23,1012,Body Lotion,200,400,200,2,00364,India
420802,2023-10-23,1004,Eyeliner,100,200,100,1,00364,India
420802,2023-10-23,1003,Foundation,300,600,300,1,00364,India
560952,2023-10-23,1004,Eyeliner,100,200,100,1,00291,India
419505,2023-10-23,1003,Foundation,300,600,300,1,00245,India
796127,2023-10-23,1004,Eyeliner,100,200,100,1,00332,India
796127,2023-10-23,1003,Foundation,300,600,300,1,00332,India
796127,2023-10-23,1001,Lipstick,150,300,150,1,00332,India
916558,2023-10-23,1004,Eyeliner,100,200,100,1,00209,India
916558,2023-10-23,1005,Nail Polish,50,100,50,1,00209,India
916558,2023-10-23,1001,Lipstick,150,300,150,1,00209,India
648081,2023-10-23,1007,Eyeshadow,200,400,200,1,00198,India
648081,2023-10-23,1005,Nail Polish,50,100,50,1,00198,India
167955,2023-10-23,1002,Mascara,200,400,200,1,00349,India
167955,2023-10-23,1003,Foundation,300,600,300,1,00349,India
167955,2023-10-23,1007,Eyeshadow,200,400,200,1,00349,India
821749,2023-10-23,1008,Makeup Remover,80,160,80,1,00319,India
724882,2023-10-23,1009,Moisturizer,250,500,250,2,00016,India
784027,2023-10-23,1006,Blush,150,300,150,1,00294,India
784027,2023-10-23,1001,Lipstick,150,300,150,1,00294,India
784027,2023-10-23,1002,Mascara,200,400,200,1,00294,India
784027,2023-10-23,1005,Nail Polish,50,100,50,1,00294,India
761072,2023-10-23,1009,Moisturizer,250,500,250,2,00285,India
761072,2023-10-23,1001,Lipstick,150,300,150,1,00285,India
823746,2023-10-23,1002,Mascara,200,400,200,1,00167,India
823746,2023-10-23,1001,Lipstick,150,300,150,1,00167,India
204499,2023-10-23,1008,Makeup Remover,80,160,80,1,00040,India
204499,2023-10-23,1001,Lipstick,150,300,150,1,00040,India
756025,2023-10-23,1004,Eyeliner,100,200,100,1,00133,India
756025,2023-10-23,1002,Mascara,200,400,200,1,00133,India
756025,2023-10-23,1009,Moisturizer,250,500,250,2,00133,India
144886,2023-10-23,1009,Moisturizer,250,500,250,2,00223,India
144886,2023-10-23,1002,Mascara,200,400,200,1,00223,India
144886,2023-10-23,1006,Blush,150,300,150,1,00223,India
426759,2023-10-23,1003,Foundation,300,600,300,1,00399,India
426759,2023-10-23,1002,Mascara,200,400,200,1,00399,India
426759,2023-10-23,1009,Moisturizer,250,500,250,2,00399,India
991302,2023-10-23,1012,Body Lotion,200,400,200,2,00243,India
991302,2023-10-23,1004,Eyeliner,100,200,100,1,00243,India
991302,2023-10-23,1001,Lipstick,150,300,150,1,00243,India
991302,2023-10-23,1008,Makeup Remover,80,160,80,1,00243,India
502083,2023-10-23,1003,Foundation,300,600,300,1,00259,India
502083,2023-10-23,1008,Makeup Remover,80,160,80,1,00259,India
502083,2023-10-23,1006,Blush,150,300,150,1,00259,India
761074,2023-10-23,1007,Eyeshadow,200,400,200,1,00185,India
761074,2023-10-23,1008,Makeup Remover,80,160,80,1,00185,India
761074,2023-10-23,1002,Mascara,200,400,200,1,00185,India
136145,2023-10-23,1009,Moisturizer,250,500,250,2,00459,India
136145,2023-10-23,1005,Nail Polish,50,100,50,1,00459,India
136145,2023-10-23,1004,Eyeliner,100,200,100,1,00459,India
318423,2023-10-23,1008,Makeup Remover,80,160,80,1,00434,India
708128,2023-10-23,1004,Eyeliner,100,200,100,1,00041,India
708128,2023-10-23,1006,Blush,150,300,150,1,00041,India
726204,2023-10-23,1005,Nail Polish,50,100,50,1,00428,India
726204,2023-10-23,1008,Makeup Remover,80,160,80,1,00428,India
726204,2023-10-23,1001,Lipstick,150,300,150,1,00428,India
726204,2023-10-23,1012,Body Lotion,200,400,200,2,00428,India
726204,2023-10-23,1006,Blush,150,300,150,1,00428,India
769058,2023-10-23,1006,Blush,150,300,150,1,00058,India
769058,2023-10-23,1007,Eyeshadow,200,400,200,1,00058,India
771971,2023-10-23,1003,Foundation,300,600,300,1,00351,India
771971,2023-10-23,1002,Mascara,200,400,200,1,00351,India
508657,2023-10-23,1009,Moisturizer,250,500,250,2,00321,India
277840,2023-10-23,1001,Lipstick,150,300,150,1,00157,India
277840,2023-10-23,1012,Body Lotion,200,400,200,2,00157,India
277840,2023-10-23,1007,Eyeshadow,200,400,200,1,00157,India
277840,2023-10-23,1004,Eyeliner,100,200,100,1,00157,India
490576,2023-10-23,1006,Blush,150,300,150,1,00386,India
490576,2023-10-23,1001,Lipstick,150,300,150,1,00386,India
490576,2023-10-23,1009,Moisturizer,250,500,250,2,00386,India
490576,2023-10-23,1005,Nail Polish,50,100,50,1,00386,India
446743,2023-10-23,1008,Makeup Remover,80,160,80,1,00275,India
763860,2023-10-24,1007,Eyeshadow,200,400,200,1,00384,India
763860,2023-10-24,1003,Foundation,300,600,300,1,00384,India
150151,2023-10-24,1001,Lipstick,150,300,150,1,00180,India
150151,2023-10-24,1004,Eyeliner,100,200,100,1,00180,India
716130,2023-10-24,1012,Body Lotion,200,400,200,2,00491,India
716130,2023-10-24,1008,Makeup Remover,80,160,80,1,00491,India
716130,2023-10-24,1009,Moisturizer,250,500,250,2,00491,India
640338,2023-10-24,1007,Eyeshadow,200,400,200,1,00077,India
398896,2023-10-24,1008,Makeup Remover,80,160,80,1,00322,India
635110,2023-10-24,1004,Eyeliner,100,200,100,1,00379,India
635110,2023-10-24,1002,Mascara,200,400,200,1,00379,India
809162,2023-10-24,1007,Eyeshadow,200,400,200,1,00082,India
809162,2023-10-24,1008,Makeup Remover,80,160,80,1,00082,India
483744,2023-10-24,1006,Blush,150,300,150,1,00500,India
483744,2023-10-24,1001,Lipstick,150,300,150,1,00500,India
190279,2023-10-24,1005,Nail Polish,50,100,50,1,00384,India
190279,2023-10-24,1001,Lipstick,150,300,150,1,00384,India
190279,2023-10-24,1006,Blush,150,300,150,1,00384,India
349702,2023-10-24,1003,Foundation,300,600,300,1,00326,India
349702,2023-10-24,1012,Body Lotion,200,400,200,2,00326,India
349702,2023-10-24,1004,Eyeliner,100,200,100,1,00326,India
349702,2023-10-24,1007,Eyeshadow,200,400,200,1,00326,India
781651,2023-10-24,1005,Nail Polish,50,100,50,1,00438,India
781651,2023-10-24,1002,Mascara,200,400,200,1,00438,India
552259,2023-10-24,1006,Blush,150,300,150,1,00272,India
552259,2023-10-24,1012,Body Lotion,200,400,200,2,00272,India
552259,2023-10-24,1008,Makeup Remover,80,160,80,1,00272,India
623176,2023-10-24,1012,Body Lotion,200,400,200,2,00082,India
454164,2023-10-24,1012,Body Lotion,200,400,200,2,00453,India
454164,2023-10-24,1005,Nail Polish,50,100,50,1,00453,India
245946,2023-10-24,1004,Eyeliner,100,200,100,1,00067,India
752306,2023-10-24,1006,Blush,150,300,150,1,00345,India
752306,2023-10-24,1012,Body Lotion,200,400,200,2,00345,India
752306,2023-10-24,1001,Lipstick,150,300,150,1,00345,India
320304,2023-10-24,1007,Eyeshadow,200,400,200,1,00236,India
320304,2023-10-24,1006,Blush,150,300,150,1,00236,India
320304,2023-10-24,1005,Nail Polish,50,100,50,1,00236,India
953560,2023-10-24,1001,Lipstick,150,300,150,1,00037,India
766216,2023-10-24,1002,Mascara,200,400,200,1,00340,India
766216,2023-10-24,1007,Eyeshadow,200,400,200,1,00340,India
766216,2023-10-24,1005,Nail Polish,50,100,50,1,00340,India
250575,2023-10-24,1008,Makeup Remover,80,160,80,1,00442,India
250575,2023-10-24,1003,Foundation,300,600,300,1,00442,India
250575,2023-10-24,1012,Body Lotion,200,400,200,2,00442,India
250575,2023-10-24,1007,Eyeshadow,200,400,200,1,00442,India
250575,2023-10-24,1004,Eyeliner,100,200,100,1,00442,India
666286,2023-10-24,1008,Makeup Remover,80,160,80,1,00096,India
666286,2023-10-24,1002,Mascara,200,400,200,1,00096,India
313685,2023-10-24,1007,Eyeshadow,200,400,200,1,00238,India
313685,2023-10-24,1008,Makeup Remover,80,160,80,1,00238,India
313685,2023-10-24,1006,Blush,150,300,150,1,00238,India
332643,2023-10-24,1004,Eyeliner,100,200,100,1,00461,India
675052,2023-10-24,1002,Mascara,200,400,200,1,00133,India
675052,2023-10-24,1006,Blush,150,300,150,1,00133,India
675052,2023-10-24,1005,Nail Polish,50,100,50,1,00133,India
974908,2023-10-24,1005,Nail Polish,50,100,50,1,00481,India
974908,2023-10-24,1008,Makeup Remover,80,160,80,1,00481,India
974908,2023-10-24,1009,Moisturizer,250,500,250,2,00481,India
592689,2023-10-24,1012,Body Lotion,200,400,200,2,00286,India
592689,2023-10-24,1004,Eyeliner,100,200,100,1,00286,India
453686,2023-10-24,1002,Mascara,200,400,200,1,00458,India
453686,2023-10-24,1012,Body Lotion,200,400,200,2,00458,India
453686,2023-10-24,1009,Moisturizer,250,500,250,2,00458,India
453686,2023-10-24,1005,Nail Polish,50,100,50,1,00458,India
651696,2023-10-24,1001,Lipstick,150,300,150,1,00067,India
651696,2023-10-24,1003,Foundation,300,600,300,1,00067,India
651696,2023-10-24,1012,Body Lotion,200,400,200,2,00067,India
651696,2023-10-24,1007,Eyeshadow,200,400,200,1,00067,India
651696,2023-10-24,1006,Blush,150,300,150,1,00067,India
275032,2023-10-24,1003,Foundation,300,600,300,1,00096,India
275032,2023-10-24,1006,Blush,150,300,150,1,00096,India
275032,2023-10-24,1008,Makeup Remover,80,160,80,1,00096,India
275032,2023-10-24,1004,Eyeliner,100,200,100,1,00096,India
188348,2023-10-24,1006,Blush,150,300,150,1,00450,India
359103,2023-10-24,1006,Blush,150,300,150,1,00397,India
359103,2023-10-24,1007,Eyeshadow,200,400,200,1,00397,India
359103,2023-10-24,1012,Body Lotion,200,400,200,2,00397,India
385891,2023-10-24,1003,Foundation,300,600,300,1,00428,India
385891,2023-10-24,1001,Lipstick,150,300,150,1,00428,India
385891,2023-10-24,1012,Body Lotion,200,400,200,2,00428,India
498287,2023-10-24,1012,Body Lotion,200,400,200,2,00043,India
498287,2023-10-24,1003,Foundation,300,600,300,1,00043,India
498287,2023-10-24,1005,Nail Polish,50,100,50,1,00043,India
498287,2023-10-24,1006,Blush,150,300,150,1,00043,India
686152,2023-10-24,1005,Nail Polish,50,100,50,1,00217,India
686152,2023-10-24,1004,Eyeliner,100,200,100,1,00217,India
686152,2023-10-24,1003,Foundation,300,600,300,1,00217,India
466417,2023-10-24,1004,Eyeliner,100,200,100,1,00098,India
466417,2023-10-24,1002,Mascara,200,400,200,1,00098,India
466417,2023-10-24,1009,Moisturizer,250,500,250,2,00098,India
711033,2023-10-24,1009,Moisturizer,250,500,250,2,00401,India
711033,2023-10-24,1005,Nail Polish,50,100,50,1,00401,India
711033,2023-10-24,1007,Eyeshadow,200,400,200,1,00401,India
711033,2023-10-24,1008,Makeup Remover,80,160,80,1,00401,India
518902,2023-10-25,1006,Blush,150,300,150,1,00085,India
518902,2023-10-25,1001,Lipstick,150,300,150,1,00085,India
331487,2023-10-25,1008,Makeup Remover,80,160,80,1,00136,India
842037,2023-10-25,1006,Blush,150,300,150,1,00065,India
842037,2023-10-25,1001,Lipstick,150,300,150,1,00065,India
877722,2023-10-25,1001,Lipstick,150,300,150,1,00167,India
877722,2023-10-25,1009,Moisturizer,250,500,250,2,00167,India
160235,2023-10-25,1003,Foundation,300,600,300,1,00008,India
160235,2023-10-25,1006,Blush,150,300,150,1,00008,India
866332,2023-10-25,1004,Eyeliner,100,200,100,1,00117,India
866332,2023-10-25,1002,Mascara,200,400,200,1,00117,India
567220,2023-10-25,1002,Mascara,200,400,200,1,00286,India
567220,2023-10-25,1009,Moisturizer,250,500,250,2,00286,India
741705,2023-10-25,1008,Makeup Remover,80,160,80,1,00176,India
741705,2023-10-25,1003,Foundation,300,600,300,1,00176,India
741705,2023-10-25,1007,Eyeshadow,200,400,200,1,00176,India
130343,2023-10-25,1006,Blush,150,300,150,1,00308,India
120114,2023-10-25,1005,Nail Polish,50,100,50,1,00265,India
120114,2023-10-25,1012,Body Lotion,200,400,200,2,00265,India
120114,2023-10-25,1007,Eyeshadow,200,400,200,1,00265,India
859256,2023-10-25,1003,Foundation,300,600,300,1,00401,India
859256,2023-10-25,1001,Lipstick,150,300,150,1,00401,India
786507,2023-10-25,1003,Foundation,300,600,300,1,00009,India
786507,2023-10-25,1002,Mascara,200,400,200,1,00009,India
610346,2023-10-25,1012,Body Lotion,200,400,200,2,00320,India
329434,2023-10-25,1009,Moisturizer,250,500,250,2,00021,India
329434,2023-10-25,1012,Body Lotion,200,400,200,2,00021,India
242433,2023-10-25,1009,Moisturizer,250,500,250,2,00215,India
242433,2023-10-25,1012,Body Lotion,200,400,200,2,00215,India
242433,2023-10-25,1004,Eyeliner,100,200,100,1,00215,India
382426,2023-10-25,1007,Eyeshadow,200,400,200,1,00035,India
382426,2023-10-25,1001,Lipstick,150,300,150,1,00035,India
382426,2023-10-25,1006,Blush,150,300,150,1,00035,India
382426,2023-10-25,1004,Eyeliner,100,200,100,1,00035,India
106947,2023-10-25,1002,Mascara,200,400,200,1,00233,India
106947,2023-10-25,1003,Foundation,300,600,300,1,00233,India
106947,2023-10-25,1005,Nail Polish,50,100,50,1,00233,India
109954,2023-10-25,1005,Nail Polish,50,100,50,1,00486,India
109954,2023-10-25,1003,Foundation,300,600,300,1,00486,India
156086,2023-10-25,1008,Makeup Remover,80,160,80,1,00260,India
470355,2023-10-25,1005,Nail Polish,50,100,50,1,00421,India
470355,2023-10-25,1004,Eyeliner,100,200,100,1,00421,India
470355,2023-10-25,1003,Foundation,300,600,300,1,00421,India
206223,2023-10-25,1009,Moisturizer,250,500,250,2,00163,India
206223,2023-10-25,1008,Makeup Remover,80,160,80,1,00163,India
206223,2023-10-25,1012,Body Lotion,200,400,200,2,00163,India
206223,2023-10-25,1003,Foundation,300,600,300,1,00163,India
560467,2023-10-25,1004,Eyeliner,100,200,100,1,00386,India
560467,2023-10-25,1005,Nail Polish,50,100,50,1,00386,India
560467,2023-10-25,1002,Mascara,200,400,200,1,00386,India
941147,2023-10-25,1003,Foundation,300,600,300,1,00232,India
137166,2023-10-25,1012,Body Lotion,200,400,200,2,00386,India
137166,2023-10-25,1001,Lipstick,150,300,150,1,00386,India
160236,2023-10-25,1007,Eyeshadow,200,400,200,1,00214,India
160236,2023-10-25,1008,Makeup Remover,80,160,80,1,00214,India
160236,2023-10-25,1009,Moisturizer,250,500,250,2,00214,India
160236,2023-10-25,1004,Eyeliner,100,200,100,1,00214,India
799991,2023-10-25,1009,Moisturizer,250,500,250,2,00183,India
799991,2023-10-25,1003,Foundation,300,600,300,1,00183,India
557227,2023-10-25,1001,Lipstick,150,300,150,1,00309,India
962170,2023-10-25,1007,Eyeshadow,200,400,200,1,00346,India
962170,2023-10-25,1005,Nail Polish,50,100,50,1,00346,India
962170,2023-10-25,1012,Body Lotion,200,400,200,2,00346,India
843051,2023-10-25,1006,Blush,150,300,150,1,00343,India
843051,2023-10-25,1008,Makeup Remover,80,160,80,1,00343,India
843051,2023-10-25,1007,Eyeshadow,200,400,200,1,00343,India
843051,2023-10-25,1004,Eyeliner,100,200,100,1,00343,India
323701,2023-10-25,1003,Foundation,300,600,300,1,00394,India
323701,2023-10-25,1004,Eyeliner,100,200,100,1,00394,India
568068,2023-10-25,1004,Eyeliner,100,200,100,1,00045,India
568068,2023-10-25,1003,Foundation,300,600,300,1,00045,India
568068,2023-10-25,1005,Nail Polish,50,100,50,1,00045,India
721499,2023-10-25,1009,Moisturizer,250,500,250,2,00472,India
721499,2023-10-25,1005,Nail Polish,50,100,50,1,00472,India
721499,2023-10-25,1003,Foundation,300,600,300,1,00472,India
775183,2023-10-25,1002,Mascara,200,400,200,1,00483,India
775183,2023-10-25,1003,Foundation,300,600,300,1,00483,India
775183,2023-10-25,1004,Eyeliner,100,200,100,1,00483,India
904888,2023-10-25,1001,Lipstick,150,300,150,1,00175,India
904888,2023-10-25,1002,Mascara,200,400,200,1,00175,India
904888,2023-10-25,1007,Eyeshadow,200,400,200,1,00175,India
904888,2023-10-25,1003,Foundation,300,600,300,1,00175,India
103481,2023-10-25,1003,Foundation,300,600,300,1,00068,India
103481,2023-10-25,1012,Body Lotion,200,400,200,2,00068,India
186120,2023-10-25,1004,Eyeliner,100,200,100,1,00098,India
713727,2023-10-26,1008,Makeup Remover,80,160,80,1,00215,India
319635,2023-10-26,1006,Blush,150,300,150,1,00164,India
319635,2023-10-26,1004,Eyeliner,100,200,100,1,00164,India
319635,2023-10-26,1003,Foundation,300,600,300,1,00164,India
319635,2023-10-26,1008,Makeup Remover,80,160,80,1,00164,India
319635,2023-10-26,1012,Body Lotion,200,400,200,2,00164,India
152576,2023-10-26,1009,Moisturizer,250,500,250,2,00369,India
152576,2023-10-26,1007,Eyeshadow,200,400,200,1,00369,India
152576,2023-10-26,1006,Blush,150,300,150,1,00369,India
551406,2023-10-26,1006,Blush,150,300,150,1,00098,India
551406,2023-10-26,1009,Moisturizer,250,500,250,2,00098,India
365418,2023-10-26,1005,Nail Polish,50,100,50,1,00447,India
365418,2023-10-26,1003,Foundation,300,600,300,1,00447,India
365418,2023-10-26,1001,Lipstick,150,300,150,1,00447,India
365418,2023-10-26,1012,Body Lotion,200,400,200,2,00447,India
888215,2023-10-26,1003,Foundation,300,600,300,1,00305,India
888215,2023-10-26,1012,Body Lotion,200,400,200,2,00305,India
785759,2023-10-26,1008,Makeup Remover,80,160,80,1,00125,India
284079,2023-10-26,1007,Eyeshadow,200,400,200,1,00246,India
284079,2023-10-26,1009,Moisturizer,250,500,250,2,00246,India
284079,2023-10-26,1003,Foundation,300,600,300,1,00246,India
300326,2023-10-26,1012,Body Lotion,200,400,200,2,00196,India
300326,2023-10-26,1006,Blush,150,300,150,1,00196,India
300326,2023-10-26,1004,Eyeliner,100,200,100,1,00196,India
388077,2023-10-26,1009,Moisturizer,250,500,250,2,00234,India
388077,2023-10-26,1005,Nail Polish,50,100,50,1,00234,India
388077,2023-10-26,1012,Body Lotion,200,400,200,2,00234,India
388077,2023-10-26,1002,Mascara,200,400,200,1,00234,India
388077,2023-10-26,1007,Eyeshadow,200,400,200,1,00234,India
342283,2023-10-26,1006,Blush,150,300,150,1,00466,India
706691,2023-10-26,1012,Body Lotion,200,400,200,2,00305,India
336628,2023-10-26,1001,Lipstick,150,300,150,1,00285,India
336628,2023-10-26,1006,Blush,150,300,150,1,00285,India
336628,2023-10-26,1008,Makeup Remover,80,160,80,1,00285,India
336628,2023-10-26,1012,Body Lotion,200,400,200,2,00285,India
731363,2023-10-26,1006,Blush,150,300,150,1,00354,India
731363,2023-10-26,1012,Body Lotion,200,400,200,2,00354,India
731363,2023-10-26,1007,Eyeshadow,200,400,200,1,00354,India
731363,2023-10-26,1001,Lipstick,150,300,150,1,00354,India
323406,2023-10-26,1002,Mascara,200,400,200,1,00073,India
323406,2023-10-26,1009,Moisturizer,250,500,250,2,00073,India
701551,2023-10-26,1002,Mascara,200,400,200,1,00027,India
580104,2023-10-26,1003,Foundation,300,600,300,1,00375,India
278914,2023-10-26,1002,Mascara,200,400,200,1,00218,India
192925,2023-10-26,1005,Nail Polish,50,100,50,1,00118,India
192925,2023-10-26,1003,Foundation,300,600,300,1,00118,India
203184,2023-10-26,1002,Mascara,200,400,200,1,00272,India
368795,2023-10-26,1012,Body Lotion,200,400,200,2,00460,India
368795,2023-10-26,1005,Nail Polish,50,100,50,1,00460,India
368795,2023-10-26,1007,Eyeshadow,200,400,200,1,00460,India
368795,2023-10-26,1004,Eyeliner,100,200,100,1,00460,India
368795,2023-10-26,1008,Makeup Remover,80,160,80,1,00460,India
784876,2023-10-26,1001,Lipstick,150,300,150,1,00408,India
784876,2023-10-26,1005,Nail Polish,50,100,50,1,00408,India
376260,2023-10-26,1012,Body Lotion,200,400,200,2,00226,India
376260,2023-10-26,1003,Foundation,300,600,300,1,00226,India
376260,2023-10-26,1002,Mascara,200,400,200,1,00226,India
435599,2023-10-26,1009,Moisturizer,250,500,250,2,00472,India
435599,2023-10-26,1012,Body Lotion,200,400,200,2,00472,India
902771,2023-10-26,1003,Foundation,300,600,300,1,00347,India
902771,2023-10-26,1008,Makeup Remover,80,160,80,1,00347,India
912894,2023-10-26,1006,Blush,150,300,150,1,00280,India
435882,2023-10-26,1012,Body Lotion,200,400,200,2,00086,India
435882,2023-10-26,1007,Eyeshadow,200,400,200,1,00086,India
435882,2023-10-26,1002,Mascara,200,400,200,1,00086,India
341541,2023-10-26,1002,Mascara,200,400,200,1,00048,India
341541,2023-10-26,1012,Body Lotion,200,400,200,2,00048,India
341541,2023-10-26,1008,Makeup Remover,80,160,80,1,00048,India
875988,2023-10-26,1012,Body Lotion,200,400,200,2,00195,India
538033,2023-10-26,1006,Blush,150,300,150,1,00186,India
191151,2023-10-27,1007,Eyeshadow,200,400,200,1,00429,India
191151,2023-10-27,1001,Lipstick,150,300,150,1,00429,India
191151,2023-10-27,1004,Eyeliner,100,200,100,1,00429,India
865561,2023-10-27,1001,Lipstick,150,300,150,1,00143,India
865561,2023-10-27,1008,Makeup Remover,80,160,80,1,00143,India
865561,2023-10-27,1006,Blush,150,300,150,1,00143,India
865561,2023-10-27,1007,Eyeshadow,200,400,200,1,00143,India
987276,2023-10-27,1002,Mascara,200,400,200,1,00194,India
987276,2023-10-27,1007,Eyeshadow,200,400,200,1,00194,India
987276,2023-10-27,1012,Body Lotion,200,400,200,2,00194,India
918441,2023-10-27,1005,Nail Polish,50,100,50,1,00405,India
918441,2023-10-27,1001,Lipstick,150,300,150,1,00405,India
125934,2023-10-27,1001,Lipstick,150,300,150,1,00299,India
365050,2023-10-27,1007,Eyeshadow,200,400,200,1,00228,India
365050,2023-10-27,1003,Foundation,300,600,300,1,00228,India
365050,2023-10-27,1006,Blush,150,300,150,1,00228,India
419965,2023-10-27,1001,Lipstick,150,300,150,1,00045,India
419965,2023-10-27,1005,Nail Polish,50,100,50,1,00045,India
419965,2023-10-27,1009,Moisturizer,250,500,250,2,00045,India
392217,2023-10-27,1005,Nail Polish,50,100,50,1,00452,India
392217,2023-10-27,1009,Moisturizer,250,500,250,2,00452,India
392217,2023-10-27,1008,Makeup Remover,80,160,80,1,00452,India
100616,2023-10-27,1002,Mascara,200,400,200,1,00081,India
298977,2023-10-27,1006,Blush,150,300,150,1,00340,India
298977,2023-10-27,1005,Nail Polish,50,100,50,1,00340,India
298977,2023-10-27,1003,Foundation,300,600,300,1,00340,India
522487,2023-10-27,1008,Makeup Remover,80,160,80,1,00102,India
522487,2023-10-27,1001,Lipstick,150,300,150,1,00102,India
801744,2023-10-27,1004,Eyeliner,100,200,100,1,00326,India
801744,2023-10-27,1012,Body Lotion,200,400,200,2,00326,India
801744,2023-10-27,1002,Mascara,200,400,200,1,00326,India
801744,2023-10-27,1007,Eyeshadow,200,400,200,1,00326,India
123143,2023-10-27,1012,Body Lotion,200,400,200,2,00478,India
480188,2023-10-27,1003,Foundation,300,600,300,1,00216,India
480188,2023-10-27,1005,Nail Polish,50,100,50,1,00216,India
773116,2023-10-27,1002,Mascara,200,400,200,1,00252,India
900521,2023-10-27,1006,Blush,150,300,150,1,00242,India
366679,2023-10-27,1004,Eyeliner,100,200,100,1,00317,India
366679,2023-10-27,1005,Nail Polish,50,100,50,1,00317,India
366679,2023-10-27,1008,Makeup Remover,80,160,80,1,00317,India
366679,2023-10-27,1012,Body Lotion,200,400,200,2,00317,India
649670,2023-10-27,1009,Moisturizer,250,500,250,2,00382,India
717600,2023-10-27,1006,Blush,150,300,150,1,00154,India
717600,2023-10-27,1007,Eyeshadow,200,400,200,1,00154,India
717600,2023-10-27,1003,Foundation,300,600,300,1,00154,India
717600,2023-10-27,1001,Lipstick,150,300,150,1,00154,India
717600,2023-10-27,1002,Mascara,200,400,200,1,00154,India
219550,2023-10-27,1006,Blush,150,300,150,1,00357,India
219550,2023-10-27,1004,Eyeliner,100,200,100,1,00357,India
300666,2023-10-27,1004,Eyeliner,100,200,100,1,00194,India
300666,2023-10-27,1007,Eyeshadow,200,400,200,1,00194,India
300666,2023-10-27,1002,Mascara,200,400,200,1,00194,India
300666,2023-10-27,1009,Moisturizer,250,500,250,2,00194,India
181291,2023-10-27,1002,Mascara,200,400,200,1,00495,India
420190,2023-10-27,1012,Body Lotion,200,400,200,2,00444,India
487029,2023-10-27,1007,Eyeshadow,200,400,200,1,00262,India
487029,2023-10-27,1001,Lipstick,150,300,150,1,00262,India
487029,2023-10-27,1006,Blush,150,300,150,1,00262,India
487029,2023-10-27,1005,Nail Polish,50,100,50,1,00262,India
598766,2023-10-27,1005,Nail Polish,50,100,50,1,00278,India
701764,2023-10-27,1001,Lipstick,150,300,150,1,00481,India
701764,2023-10-27,1008,Makeup Remover,80,160,80,1,00481,India
701764,2023-10-27,1006,Blush,150,300,150,1,00481,India
181248,2023-10-27,1008,Makeup Remover,80,160,80,1,00351,India
181248,2023-10-27,1005,Nail Polish,50,100,50,1,00351,India
473746,2023-10-27,1012,Body Lotion,200,400,200,2,00492,India
473746,2023-10-27,1008,Makeup Remover,80,160,80,1,00492,India
633172,2023-10-27,1006,Blush,150,300,150,1,00495,India
633172,2023-10-27,1004,Eyeliner,100,200,100,1,00495,India
633172,2023-10-27,1007,Eyeshadow,200,400,200,1,00495,India
633172,2023-10-27,1001,Lipstick,150,300,150,1,00495,India
716307,2023-10-27,1008,Makeup Remover,80,160,80,1,00488,India
716307,2023-10-27,1003,Foundation,300,600,300,1,00488,India
716307,2023-10-27,1004,Eyeliner,100,200,100,1,00488,India
843831,2023-10-27,1003,Foundation,300,600,300,1,00409,India
843831,2023-10-27,1009,Moisturizer,250,500,250,2,00409,India
843831,2023-10-27,1001,Lipstick,150,300,150,1,00409,India
176529,2023-10-27,1006,Blush,150,300,150,1,00346,India
536079,2023-10-27,1012,Body Lotion,200,400,200,2,00425,India
536079,2023-10-27,1007,Eyeshadow,200,400,200,1,00425,India
536079,2023-10-27,1008,Makeup Remover,80,160,80,1,00425,India
965989,2023-10-27,1001,Lipstick,150,300,150,1,00264,India
965989,2023-10-27,1008,Makeup Remover,80,160,80,1,00264,India
965989,2023-10-27,1004,Eyeliner,100,200,100,1,00264,India
799848,2023-10-27,1002,Mascara,200,400,200,1,00017,India
845965,2023-10-27,1005,Nail Polish,50,100,50,1,00225,India
845965,2023-10-27,1012,Body Lotion,200,400,200,2,00225,India
845965,2023-10-27,1009,Moisturizer,250,500,250,2,00225,India
845965,2023-10-27,1008,Makeup Remover,80,160,80,1,00225,India
845965,2023-10-27,1001,Lipstick,150,300,150,1,00225,India
968058,2023-10-27,1003,Foundation,300,600,300,1,00496,India
968058,2023-10-27,1002,Mascara,200,400,200,1,00496,India
580073,2023-10-27,1003,Foundation,300,600,300,1,00085,India
408132,2023-10-27,1004,Eyeliner,100,200,100,1,00401,India
408132,2023-10-27,1005,Nail Polish,50,100,50,1,00401,India
408132,2023-10-27,1002,Mascara,200,400,200,1,00401,India
548365,2023-10-27,1002,Mascara,200,400,200,1,00061,India
548365,2023-10-27,1012,Body Lotion,200,400,200,2,00061,India
548365,2023-10-27,1004,Eyeliner,100,200,100,1,00061,India
806924,2023-10-27,1008,Makeup Remover,80,160,80,1,00480,India
834073,2023-10-27,1004,Eyeliner,100,200,100,1,00204,India
834073,2023-10-27,1007,Eyeshadow,200,400,200,1,00204,India
834073,2023-10-27,1009,Moisturizer,250,500,250,2,00204,India
834073,2023-10-27,1008,Makeup Remover,80,160,80,1,00204,India
347830,2023-10-27,1006,Blush,150,300,150,1,00028,India
347830,2023-10-27,1009,Moisturizer,250,500,250,2,00028,India
504822,2023-10-27,1007,Eyeshadow,200,400,200,1,00237,India
318663,2023-10-27,1006,Blush,150,300,150,1,00448,India
548749,2023-10-27,1007,Eyeshadow,200,400,200,1,00303,India
548749,2023-10-27,1006,Blush,150,300,150,1,00303,India
448782,2023-10-27,1004,Eyeliner,100,200,100,1,00046,India
448782,2023-10-27,1007,Eyeshadow,200,400,200,1,00046,India
566216,2023-10-27,1012,Body Lotion,200,400,200,2,00234,India
416929,2023-10-28,1004,Eyeliner,100,200,100,1,00233,India
416929,2023-10-28,1002,Mascara,200,400,200,1,00233,India
299408,2023-10-28,1004,Eyeliner,100,200,100,1,00214,India
299408,2023-10-28,1007,Eyeshadow,200,400,200,1,00214,India
299408,2023-10-28,1006,Blush,150,300,150,1,00214,India
299408,2023-10-28,1012,Body Lotion,200,400,200,2,00214,India
250443,2023-10-28,1005,Nail Polish,50,100,50,1,00317,India
250443,2023-10-28,1006,Blush,150,300,150,1,00317,India
344599,2023-10-28,1008,Makeup Remover,80,160,80,1,00326,India
344599,2023-10-28,1001,Lipstick,150,300,150,1,00326,India
344599,2023-10-28,1012,Body Lotion,200,400,200,2,00326,India
583275,2023-10-28,1009,Moisturizer,250,500,250,2,00421,India
583275,2023-10-28,1001,Lipstick,150,300,150,1,00421,India
583275,2023-10-28,1012,Body Lotion,200,400,200,2,00421,India
583275,2023-10-28,1006,Blush,150,300,150,1,00421,India
583275,2023-10-28,1008,Makeup Remover,80,160,80,1,00421,India
790861,2023-10-28,1003,Foundation,300,600,300,1,00216,India
790861,2023-10-28,1005,Nail Polish,50,100,50,1,00216,India
750713,2023-10-28,1004,Eyeliner,100,200,100,1,00443,India
750713,2023-10-28,1002,Mascara,200,400,200,1,00443,India
750713,2023-10-28,1009,Moisturizer,250,500,250,2,00443,India
628728,2023-10-28,1009,Moisturizer,250,500,250,2,00266,India
628728,2023-10-28,1007,Eyeshadow,200,400,200,1,00266,India
628728,2023-10-28,1004,Eyeliner,100,200,100,1,00266,India
725495,2023-10-28,1005,Nail Polish,50,100,50,1,00445,India
725495,2023-10-28,1009,Moisturizer,250,500,250,2,00445,India
725495,2023-10-28,1012,Body Lotion,200,400,200,2,00445,India
166464,2023-10-28,1009,Moisturizer,250,500,250,2,00203,India
759144,2023-10-28,1006,Blush,150,300,150,1,00410,India
761187,2023-10-28,1003,Foundation,300,600,300,1,00119,India
761187,2023-10-28,1006,Blush,150,300,150,1,00119,India
761187,2023-10-28,1005,Nail Polish,50,100,50,1,00119,India
761187,2023-10-28,1002,Mascara,200,400,200,1,00119,India
898452,2023-10-28,1003,Foundation,300,600,300,1,00082,India
898452,2023-10-28,1005,Nail Polish,50,100,50,1,00082,India
929129,2023-10-28,1009,Moisturizer,250,500,250,2,00312,India
929129,2023-10-28,1007,Eyeshadow,200,400,200,1,00312,India
929129,2023-10-28,1003,Foundation,300,600,300,1,00312,India
929129,2023-10-28,1001,Lipstick,150,300,150,1,00312,India
570965,2023-10-28,1008,Makeup Remover,80,160,80,1,00201,India
570965,2023-10-28,1004,Eyeliner,100,200,100,1,00201,India
570965,2023-10-28,1003,Foundation,300,600,300,1,00201,India
986519,2023-10-28,1002,Mascara,200,400,200,1,00243,India
756872,2023-10-28,1001,Lipstick,150,300,150,1,00038,India
756872,2023-10-28,1003,Foundation,300,600,300,1,00038,India
975278,2023-10-28,1007,Eyeshadow,200,400,200,1,00017,India
975278,2023-10-28,1004,Eyeliner,100,200,100,1,00017,India
577172,2023-10-28,1003,Foundation,300,600,300,1,00118,India
577172,2023-10-28,1009,Moisturizer,250,500,250,2,00118,India
577172,2023-10-28,1004,Eyeliner,100,200,100,1,00118,India
238496,2023-10-28,1009,Moisturizer,250,500,250,2,00382,India
238496,2023-10-28,1005,Nail Polish,50,100,50,1,00382,India
454683,2023-10-28,1007,Eyeshadow,200,400,200,1,00185,India
454683,2023-10-28,1005,Nail Polish,50,100,50,1,00185,India
454683,2023-10-28,1004,Eyeliner,100,200,100,1,00185,India
691969,2023-10-28,1008,Makeup Remover,80,160,80,1,00231,India
691969,2023-10-28,1002,Mascara,200,400,200,1,00231,India
691969,2023-10-28,1009,Moisturizer,250,500,250,2,00231,India
691969,2023-10-28,1005,Nail Polish,50,100,50,1,00231,India
965923,2023-10-28,1006,Blush,150,300,150,1,00020,India
965923,2023-10-28,1009,Moisturizer,250,500,250,2,00020,India
512763,2023-10-28,1008,Makeup Remover,80,160,80,1,00108,India
512763,2023-10-28,1007,Eyeshadow,200,400,200,1,00108,India
419275,2023-10-28,1006,Blush,150,300,150,1,00072,India
419275,2023-10-28,1004,Eyeliner,100,200,100,1,00072,India
258026,2023-10-28,1004,Eyeliner,100,200,100,1,00301,India
258026,2023-10-28,1008,Makeup Remover,80,160,80,1,00301,India
258026,2023-10-28,1001,Lipstick,150,300,150,1,00301,India
155935,2023-10-28,1006,Blush,150,300,150,1,00433,India
155935,2023-10-28,1001,Lipstick,150,300,150,1,00433,India
367996,2023-10-28,1001,Lipstick,150,300,150,1,00254,India
367996,2023-10-28,1002,Mascara,200,400,200,1,00254,India
367996,2023-10-28,1007,Eyeshadow,200,400,200,1,00254,India
367996,2023-10-28,1009,Moisturizer,250,500,250,2,00254,India
397205,2023-10-28,1012,Body Lotion,200,400,200,2,00009,India
954520,2023-10-28,1008,Makeup Remover,80,160,80,1,00038,India
954520,2023-10-28,1002,Mascara,200,400,200,1,00038,India
677787,2023-10-28,1005,Nail Polish,50,100,50,1,00260,India
677787,2023-10-28,1008,Makeup Remover,80,160,80,1,00260,India
677787,2023-10-28,1006,Blush,150,300,150,1,00260,India
677787,2023-10-28,1009,Moisturizer,250,500,250,2,00260,India
134374,2023-10-29,1006,Blush,150,300,150,1,00040,India
134374,2023-10-29,1003,Foundation,300,600,300,1,00040,India
194469,2023-10-29,1003,Foundation,300,600,300,1,00406,India
682897,2023-10-29,1007,Eyeshadow,200,400,200,1,00210,India
682897,2023-10-29,1003,Foundation,300,600,300,1,00210,India
334699,2023-10-29,1001,Lipstick,150,300,150,1,00121,India
334699,2023-10-29,1002,Mascara,200,400,200,1,00121,India
334699,2023-10-29,1012,Body Lotion,200,400,200,2,00121,India
418109,2023-10-29,1002,Mascara,200,400,200,1,00117,India
418109,2023-10-29,1006,Blush,150,300,150,1,00117,India
418109,2023-10-29,1007,Eyeshadow,200,400,200,1,00117,India
418109,2023-10-29,1009,Moisturizer,250,500,250,2,00117,India
408275,2023-10-29,1005,Nail Polish,50,100,50,1,00462,India
408275,2023-10-29,1003,Foundation,300,600,300,1,00462,India
408275,2023-10-29,1009,Moisturizer,250,500,250,2,00462,India
408275,2023-10-29,1008,Makeup Remover,80,160,80,1,00462,India
981959,2023-10-29,1003,Foundation,300,600,300,1,00077,India
981959,2023-10-29,1012,Body Lotion,200,400,200,2,00077,India
981959,2023-10-29,1008,Makeup Remover,80,160,80,1,00077,India
738550,2023-10-29,1007,Eyeshadow,200,400,200,1,00016,India
738550,2023-10-29,1002,Mascara,200,400,200,1,00016,India
738550,2023-10-29,1003,Foundation,300,600,300,1,00016,India
403375,2023-10-29,1008,Makeup Remover,80,160,80,1,00265,India
403375,2023-10-29,1001,Lipstick,150,300,150,1,00265,India
403375,2023-10-29,1007,Eyeshadow,200,400,200,1,00265,India
736487,2023-10-29,1005,Nail Polish,50,100,50,1,00203,India
736487,2023-10-29,1007,Eyeshadow,200,400,200,1,00203,India
697204,2023-10-29,1001,Lipstick,150,300,150,1,00244,India
697204,2023-10-29,1005,Nail Polish,50,100,50,1,00244,India
697204,2023-10-29,1006,Blush,150,300,150,1,00244,India
697204,2023-10-29,1003,Foundation,300,600,300,1,00244,India
551919,2023-10-29,1005,Nail Polish,50,100,50,1,00299,India
551919,2023-10-29,1012,Body Lotion,200,400,200,2,00299,India
622237,2023-10-29,1009,Moisturizer,250,500,250,2,00150,India
622237,2023-10-29,1002,Mascara,200,400,200,1,00150,India
622237,2023-10-29,1001,Lipstick,150,300,150,1,00150,India
622237,2023-10-29,1008,Makeup Remover,80,160,80,1,00150,India
398274,2023-10-29,1009,Moisturizer,250,500,250,2,00301,India
419535,2023-10-29,1012,Body Lotion,200,400,200,2,00158,India
419535,2023-10-29,1001,Lipstick,150,300,150,1,00158,India
419535,2023-10-29,1005,Nail Polish,50,100,50,1,00158,India
621604,2023-10-29,1008,Makeup Remover,80,160,80,1,00354,India
621604,2023-10-29,1001,Lipstick,150,300,150,1,00354,India
621604,2023-10-29,1005,Nail Polish,50,100,50,1,00354,India
346952,2023-10-29,1001,Lipstick,150,300,150,1,00079,India
346952,2023-10-29,1005,Nail Polish,50,100,50,1,00079,India
346952,2023-10-29,1004,Eyeliner,100,200,100,1,00079,India
346952,2023-10-29,1008,Makeup Remover,80,160,80,1,00079,India
837481,2023-10-29,1007,Eyeshadow,200,400,200,1,00053,India
837481,2023-10-29,1008,Makeup Remover,80,160,80,1,00053,India
837481,2023-10-29,1003,Foundation,300,600,300,1,00053,India
226674,2023-10-29,1006,Blush,150,300,150,1,00095,India
177496,2023-10-29,1003,Foundation,300,600,300,1,00270,India
437598,2023-10-29,1001,Lipstick,150,300,150,1,00062,India
437598,2023-10-29,1005,Nail Polish,50,100,50,1,00062,India
437598,2023-10-29,1007,Eyeshadow,200,400,200,1,00062,India
437598,2023-10-29,1002,Mascara,200,400,200,1,00062,India
437598,2023-10-29,1012,Body Lotion,200,400,200,2,00062,India
340389,2023-10-29,1006,Blush,150,300,150,1,00118,India
340389,2023-10-29,1009,Moisturizer,250,500,250,2,00118,India
340389,2023-10-29,1012,Body Lotion,200,400,200,2,00118,India
340389,2023-10-29,1007,Eyeshadow,200,400,200,1,00118,India
340389,2023-10-29,1008,Makeup Remover,80,160,80,1,00118,India
476728,2023-10-29,1003,Foundation,300,600,300,1,00087,India
717673,2023-10-29,1012,Body Lotion,200,400,200,2,00050,India
717673,2023-10-29,1001,Lipstick,150,300,150,1,00050,India
717673,2023-10-29,1004,Eyeliner,100,200,100,1,00050,India
717673,2023-10-29,1008,Makeup Remover,80,160,80,1,00050,India
546137,2023-10-29,1009,Moisturizer,250,500,250,2,00207,India
546137,2023-10-29,1005,Nail Polish,50,100,50,1,00207,India
756753,2023-10-29,1009,Moisturizer,250,500,250,2,00224,India
793058,2023-10-29,1002,Mascara,200,400,200,1,00367,India
793058,2023-10-29,1005,Nail Polish,50,100,50,1,00367,India
809212,2023-10-29,1003,Foundation,300,600,300,1,00496,India
809212,2023-10-29,1005,Nail Polish,50,100,50,1,00496,India
809212,2023-10-29,1008,Makeup Remover,80,160,80,1,00496,India
631597,2023-10-29,1002,Mascara,200,400,200,1,00009,India
631597,2023-10-29,1003,Foundation,300,600,300,1,00009,India
383562,2023-10-29,1006,Blush,150,300,150,1,00286,India
383562,2023-10-29,1008,Makeup Remover,80,160,80,1,00286,India
383562,2023-10-29,1004,Eyeliner,100,200,100,1,00286,India
759023,2023-10-29,1009,Moisturizer,250,500,250,2,00420,India
759023,2023-10-29,1006,Blush,150,300,150,1,00420,India
759023,2023-10-29,1007,Eyeshadow,200,400,200,1,00420,India
610911,2023-10-29,1003,Foundation,300,600,300,1,00358,India
610911,2023-10-29,1009,Moisturizer,250,500,250,2,00358,India
610911,2023-10-29,1007,Eyeshadow,200,400,200,1,00358,India
610911,2023-10-29,1006,Blush,150,300,150,1,00358,India
973791,2023-10-29,1008,Makeup Remover,80,160,80,1,00445,India
973791,2023-10-29,1009,Moisturizer,250,500,250,2,00445,India
973791,2023-10-29,1002,Mascara,200,400,200,1,00445,India
322258,2023-10-29,1005,Nail Polish,50,100,50,1,00023,India
322258,2023-10-29,1007,Eyeshadow,200,400,200,1,00023,India
322258,2023-10-29,1001,Lipstick,150,300,150,1,00023,India
996747,2023-10-29,1005,Nail Polish,50,100,50,1,00357,India
996747,2023-10-29,1001,Lipstick,150,300,150,1,00357,India
996747,2023-10-29,1008,Makeup Remover,80,160,80,1,00357,India
996747,2023-10-29,1002,Mascara,200,400,200,1,00357,India
240134,2023-10-29,1004,Eyeliner,100,200,100,1,00164,India
222450,2023-10-29,1005,Nail Polish,50,100,50,1,00201,India
222450,2023-10-29,1012,Body Lotion,200,400,200,2,00201,India
222450,2023-10-29,1003,Foundation,300,600,300,1,00201,India
438970,2023-10-29,1008,Makeup Remover,80,160,80,1,00142,India
438970,2023-10-29,1012,Body Lotion,200,400,200,2,00142,India
373429,2023-10-29,1006,Blush,150,300,150,1,00295,India
373429,2023-10-29,1005,Nail Polish,50,100,50,1,00295,India
373429,2023-10-29,1008,Makeup Remover,80,160,80,1,00295,India
373429,2023-10-29,1003,Foundation,300,600,300,1,00295,India
364551,2023-10-29,1002,Mascara,200,400,200,1,00391,India
364551,2023-10-29,1005,Nail Polish,50,100,50,1,00391,India
422666,2023-10-29,1001,Lipstick,150,300,150,1,00445,India
422666,2023-10-29,1002,Mascara,200,400,200,1,00445,India
279972,2023-10-29,1008,Makeup Remover,80,160,80,1,00394,India
279972,2023-10-29,1003,Foundation,300,600,300,1,00394,India
279972,2023-10-29,1007,Eyeshadow,200,400,200,1,00394,India
279972,2023-10-29,1005,Nail Polish,50,100,50,1,00394,India
842186,2023-10-29,1008,Makeup Remover,80,160,80,1,00153,India
842186,2023-10-29,1001,Lipstick,150,300,150,1,00153,India
842186,2023-10-29,1003,Foundation,300,600,300,1,00153,India
890485,2023-10-29,1009,Moisturizer,250,500,250,2,00269,India
890485,2023-10-29,1005,Nail Polish,50,100,50,1,00269,India
890485,2023-10-29,1003,Foundation,300,600,300,1,00269,India
633497,2023-10-29,1006,Blush,150,300,150,1,00345,India
792488,2023-10-29,1008,Makeup Remover,80,160,80,1,00011,India
792488,2023-10-29,1004,Eyeliner,100,200,100,1,00011,India
148339,2023-10-30,1004,Eyeliner,100,200,100,1,00470,India
148339,2023-10-30,1003,Foundation,300,600,300,1,00470,India
148339,2023-10-30,1007,Eyeshadow,200,400,200,1,00470,India
148339,2023-10-30,1012,Body Lotion,200,400,200,2,00470,India
104415,2023-10-30,1005,Nail Polish,50,100,50,1,00245,India
104415,2023-10-30,1003,Foundation,300,600,300,1,00245,India
104415,2023-10-30,1008,Makeup Remover,80,160,80,1,00245,India
701823,2023-10-30,1012,Body Lotion,200,400,200,2,00339,India
701823,2023-10-30,1002,Mascara,200,400,200,1,00339,India
701823,2023-10-30,1007,Eyeshadow,200,400,200,1,00339,India
722986,2023-10-30,1012,Body Lotion,200,400,200,2,00372,India
722986,2023-10-30,1003,Foundation,300,600,300,1,00372,India
722986,2023-10-30,1009,Moisturizer,250,500,250,2,00372,India
722986,2023-10-30,1006,Blush,150,300,150,1,00372,India
418649,2023-10-30,1001,Lipstick,150,300,150,1,00234,India
418649,2023-10-30,1006,Blush,150,300,150,1,00234,India
418649,2023-10-30,1003,Foundation,300,600,300,1,00234,India
162214,2023-10-30,1008,Makeup Remover,80,160,80,1,00258,India
162214,2023-10-30,1005,Nail Polish,50,100,50,1,00258,India
814041,2023-10-30,1001,Lipstick,150,300,150,1,00409,India
999084,2023-10-30,1012,Body Lotion,200,400,200,2,00269,India
999084,2023-10-30,1003,Foundation,300,600,300,1,00269,India
888685,2023-10-30,1012,Body Lotion,200,400,200,2,00173,India
888685,2023-10-30,1003,Foundation,300,600,300,1,00173,India
389888,2023-10-30,1006,Blush,150,300,150,1,00103,India
389888,2023-10-30,1004,Eyeliner,100,200,100,1,00103,India
389888,2023-10-30,1009,Moisturizer,250,500,250,2,00103,India
389888,2023-10-30,1007,Eyeshadow,200,400,200,1,00103,India
389888,2023-10-30,1012,Body Lotion,200,400,200,2,00103,India
478707,2023-10-30,1003,Foundation,300,600,300,1,00298,India
478707,2023-10-30,1009,Moisturizer,250,500,250,2,00298,India
478707,2023-10-30,1012,Body Lotion,200,400,200,2,00298,India
478707,2023-10-30,1005,Nail Polish,50,100,50,1,00298,India
478707,2023-10-30,1007,Eyeshadow,200,400,200,1,00298,India
972935,2023-10-30,1004,Eyeliner,100,200,100,1,00238,India
972935,2023-10-30,1008,Makeup Remover,80,160,80,1,00238,India
141328,2023-10-30,1009,Moisturizer,250,500,250,2,00420,India
141328,2023-10-30,1004,Eyeliner,100,200,100,1,00420,India
141328,2023-10-30,1001,Lipstick,150,300,150,1,00420,India
985448,2023-10-30,1009,Moisturizer,250,500,250,2,00122,India
985448,2023-10-30,1002,Mascara,200,400,200,1,00122,India
985448,2023-10-30,1003,Foundation,300,600,300,1,00122,India
544854,2023-10-30,1003,Foundation,300,600,300,1,00406,India
253795,2023-10-30,1002,Mascara,200,400,200,1,00153,India
253795,2023-10-30,1003,Foundation,300,600,300,1,00153,India
930099,2023-10-30,1008,Makeup Remover,80,160,80,1,00386,India
930099,2023-10-30,1009,Moisturizer,250,500,250,2,00386,India
343039,2023-10-30,1002,Mascara,200,400,200,1,00139,India
640677,2023-10-30,1008,Makeup Remover,80,160,80,1,00201,India
447130,2023-10-30,1003,Foundation,300,600,300,1,00260,India
447130,2023-10-30,1009,Moisturizer,250,500,250,2,00260,India
447130,2023-10-30,1002,Mascara,200,400,200,1,00260,India
338593,2023-10-30,1004,Eyeliner,100,200,100,1,00423,India
928712,2023-10-30,1012,Body Lotion,200,400,200,2,00056,India
928712,2023-10-30,1003,Foundation,300,600,300,1,00056,India
928712,2023-10-30,1005,Nail Polish,50,100,50,1,00056,India
928712,2023-10-30,1007,Eyeshadow,200,400,200,1,00056,India
928712,2023-10-30,1002,Mascara,200,400,200,1,00056,India
971141,2023-10-30,1004,Eyeliner,100,200,100,1,00212,India
518754,2023-10-30,1012,Body Lotion,200,400,200,2,00258,India
518754,2023-10-30,1002,Mascara,200,400,200,1,00258,India
518754,2023-10-30,1007,Eyeshadow,200,400,200,1,00258,India
280494,2023-10-30,1004,Eyeliner,100,200,100,1,00144,India
904812,2023-10-30,1006,Blush,150,300,150,1,00063,India
904812,2023-10-30,1002,Mascara,200,400,200,1,00063,India
904812,2023-10-30,1009,Moisturizer,250,500,250,2,00063,India
719110,2023-10-30,1007,Eyeshadow,200,400,200,1,00023,India
719110,2023-10-30,1003,Foundation,300,600,300,1,00023,India
719110,2023-10-30,1009,Moisturizer,250,500,250,2,00023,India
837163,2023-10-30,1006,Blush,150,300,150,1,00350,India
837163,2023-10-30,1009,Moisturizer,250,500,250,2,00350,India
773212,2023-10-30,1005,Nail Polish,50,100,50,1,00043,India
902958,2023-10-30,1012,Body Lotion,200,400,200,2,00349,India
902958,2023-10-30,1001,Lipstick,150,300,150,1,00349,India
127851,2023-10-30,1001,Lipstick,150,300,150,1,00142,India
127851,2023-10-30,1006,Blush,150,300,150,1,00142,India
127851,2023-10-30,1004,Eyeliner,100,200,100,1,00142,India
798935,2023-10-30,1002,Mascara,200,400,200,1,00034,India
798935,2023-10-30,1003,Foundation,300,600,300,1,00034,India
798935,2023-10-30,1005,Nail Polish,50,100,50,1,00034,India
574459,2023-10-30,1006,Blush,150,300,150,1,00095,India
574459,2023-10-30,1003,Foundation,300,600,300,1,00095,India
574459,2023-10-30,1001,Lipstick,150,300,150,1,00095,India
574459,2023-10-30,1007,Eyeshadow,200,400,200,1,00095,India
392200,2023-10-30,1002,Mascara,200,400,200,1,00296,India
988607,2023-10-30,1004,Eyeliner,100,200,100,1,00296,India
988607,2023-10-30,1007,Eyeshadow,200,400,200,1,00296,India
988607,2023-10-30,1009,Moisturizer,250,500,250,2,00296,India
988607,2023-10-30,1008,Makeup Remover,80,160,80,1,00296,India
762222,2023-10-30,1004,Eyeliner,100,200,100,1,00456,India
762222,2023-10-30,1001,Lipstick,150,300,150,1,00456,India
762222,2023-10-30,1008,Makeup Remover,80,160,80,1,00456,India
301191,2023-10-30,1004,Eyeliner,100,200,100,1,00301,India
301191,2023-10-30,1003,Foundation,300,600,300,1,00301,India
301191,2023-10-30,1007,Eyeshadow,200,400,200,1,00301,India
316096,2023-10-30,1009,Moisturizer,250,500,250,2,00134,India
316096,2023-10-30,1012,Body Lotion,200,400,200,2,00134,India
316096,2023-10-30,1003,Foundation,300,600,300,1,00134,India
500388,2023-10-30,1012,Body Lotion,200,400,200,2,00234,India
500388,2023-10-30,1007,Eyeshadow,200,400,200,1,00234,India
500388,2023-10-30,1005,Nail Polish,50,100,50,1,00234,India
500388,2023-10-30,1003,Foundation,300,600,300,1,00234,India
500388,2023-10-30,1008,Makeup Remover,80,160,80,1,00234,India
470605,2023-10-30,1009,Moisturizer,250,500,250,2,00273,India
470605,2023-10-30,1004,Eyeliner,100,200,100,1,00273,India
470605,2023-10-30,1003,Foundation,300,600,300,1,00273,India
470605,2023-10-30,1006,Blush,150,300,150,1,00273,India
470605,2023-10-30,1008,Makeup Remover,80,160,80,1,00273,India
945359,2023-10-30,1003,Foundation,300,600,300,1,00003,India
552249,2023-10-30,1001,Lipstick,150,300,150,1,00004,India
552249,2023-10-30,1006,Blush,150,300,150,1,00004,India
552249,2023-10-30,1008,Makeup Remover,80,160,80,1,00004,India
483076,2023-10-30,1003,Foundation,300,600,300,1,00468,India
483076,2023-10-30,1009,Moisturizer,250,500,250,2,00468,India
271754,2023-10-30,1004,Eyeliner,100,200,100,1,00054,India
271754,2023-10-30,1005,Nail Polish,50,100,50,1,00054,India
271754,2023-10-30,1012,Body Lotion,200,400,200,2,00054,India
271754,2023-10-30,1007,Eyeshadow,200,400,200,1,00054,India
271754,2023-10-30,1008,Makeup Remover,80,160,80,1,00054,India
973393,2023-10-31,1012,Body Lotion,200,400,200,2,00069,India
973393,2023-10-31,1001,Lipstick,150,300,150,1,00069,India
776332,2023-10-31,1007,Eyeshadow,200,400,200,1,00445,India
933168,2023-10-31,1001,Lipstick,150,300,150,1,00118,India
933168,2023-10-31,1008,Makeup Remover,80,160,80,1,00118,India
933168,2023-10-31,1002,Mascara,200,400,200,1,00118,India
933168,2023-10-31,1003,Foundation,300,600,300,1,00118,India
933168,2023-10-31,1012,Body Lotion,200,400,200,2,00118,India
686217,2023-10-31,1008,Makeup Remover,80,160,80,1,00287,India
352208,2023-10-31,1002,Mascara,200,400,200,1,00205,India
352208,2023-10-31,1012,Body Lotion,200,400,200,2,00205,India
352208,2023-10-31,1003,Foundation,300,600,300,1,00205,India
178456,2023-10-31,1012,Body Lotion,200,400,200,2,00346,India
178456,2023-10-31,1008,Makeup Remover,80,160,80,1,00346,India
178456,2023-10-31,1007,Eyeshadow,200,400,200,1,00346,India
178456,2023-10-31,1002,Mascara,200,400,200,1,00346,India
207191,2023-10-31,1009,Moisturizer,250,500,250,2,00015,India
207191,2023-10-31,1003,Foundation,300,600,300,1,00015,India
207191,2023-10-31,1006,Blush,150,300,150,1,00015,India
121425,2023-10-31,1005,Nail Polish,50,100,50,1,00481,India
121425,2023-10-31,1001,Lipstick,150,300,150,1,00481,India
121425,2023-10-31,1004,Eyeliner,100,200,100,1,00481,India
121425,2023-10-31,1012,Body Lotion,200,400,200,2,00481,India
829897,2023-10-31,1003,Foundation,300,600,300,1,00225,India
653726,2023-10-31,1007,Eyeshadow,200,400,200,1,00253,India
653726,2023-10-31,1006,Blush,150,300,150,1,00253,India
653726,2023-10-31,1009,Moisturizer,250,500,250,2,00253,India
529157,2023-10-31,1007,Eyeshadow,200,400,200,1,00191,India
529157,2023-10-31,1008,Makeup Remover,80,160,80,1,00191,India
432900,2023-10-31,1007,Eyeshadow,200,400,200,1,00184,India
157216,2023-10-31,1008,Makeup Remover,80,160,80,1,00374,India
157216,2023-10-31,1006,Blush,150,300,150,1,00374,India
387544,2023-10-31,1002,Mascara,200,400,200,1,00376,India
387544,2023-10-31,1007,Eyeshadow,200,400,200,1,00376,India
996047,2023-10-31,1004,Eyeliner,100,200,100,1,00124,India
996047,2023-10-31,1009,Moisturizer,250,500,250,2,00124,India
996047,2023-10-31,1012,Body Lotion,200,400,200,2,00124,India
996047,2023-10-31,1002,Mascara,200,400,200,1,00124,India
380583,2023-10-31,1005,Nail Polish,50,100,50,1,00222,India
380583,2023-10-31,1006,Blush,150,300,150,1,00222,India
380583,2023-10-31,1007,Eyeshadow,200,400,200,1,00222,India
229880,2023-10-31,1002,Mascara,200,400,200,1,00428,India
229880,2023-10-31,1007,Eyeshadow,200,400,200,1,00428,India
297683,2023-10-31,1008,Makeup Remover,80,160,80,1,00058,India
297683,2023-10-31,1006,Blush,150,300,150,1,00058,India
297683,2023-10-31,1007,Eyeshadow,200,400,200,1,00058,India
847923,2023-10-31,1004,Eyeliner,100,200,100,1,00052,India
847923,2023-10-31,1002,Mascara,200,400,200,1,00052,India
520403,2023-10-31,1001,Lipstick,150,300,150,1,00494,India
520403,2023-10-31,1012,Body Lotion,200,400,200,2,00494,India
520403,2023-10-31,1007,Eyeshadow,200,400,200,1,00494,India
984053,2023-10-31,1006,Blush,150,300,150,1,00435,India
984053,2023-10-31,1012,Body Lotion,200,400,200,2,00435,India
217726,2023-10-31,1008,Makeup Remover,80,160,80,1,00349,India
217726,2023-10-31,1002,Mascara,200,400,200,1,00349,India
217726,2023-10-31,1005,Nail Polish,50,100,50,1,00349,India
217726,2023-10-31,1012,Body Lotion,200,400,200,2,00349,India
511510,2023-10-31,1009,Moisturizer,250,500,250,2,00376,India
511510,2023-10-31,1006,Blush,150,300,150,1,00376,India
511510,2023-10-31,1004,Eyeliner,100,200,100,1,00376,India
511510,2023-10-31,1007,Eyeshadow,200,400,200,1,00376,India
255391,2023-10-31,1002,Mascara,200,400,200,1,00378,India
255391,2023-10-31,1007,Eyeshadow,200,400,200,1,00378,India
255391,2023-10-31,1006,Blush,150,300,150,1,00378,India
255391,2023-10-31,1003,Foundation,300,600,300,1,00378,India
534352,2023-10-31,1009,Moisturizer,250,500,250,2,00412,India
534352,2023-10-31,1008,Makeup Remover,80,160,80,1,00412,India
297006,2023-10-31,1009,Moisturizer,250,500,250,2,00150,India
297006,2023-10-31,1002,Mascara,200,400,200,1,00150,India
276757,2023-10-31,1006,Blush,150,300,150,1,00220,India
395182,2023-10-31,1002,Mascara,200,400,200,1,00164,India
887889,2023-10-31,1004,Eyeliner,100,200,100,1,00496,India
887889,2023-10-31,1002,Mascara,200,400,200,1,00496,India
887889,2023-10-31,1003,Foundation,300,600,300,1,00496,India
887889,2023-10-31,1005,Nail Polish,50,100,50,1,00496,India
887889,2023-10-31,1001,Lipstick,150,300,150,1,00496,India
295784,2023-10-31,1009,Moisturizer,250,500,250,2,00291,India
245059,2023-10-31,1001,Lipstick,150,300,150,1,00316,India
245059,2023-10-31,1008,Makeup Remover,80,160,80,1,00316,India
245059,2023-10-31,1004,Eyeliner,100,200,100,1,00316,India
245059,2023-10-31,1006,Blush,150,300,150,1,00316,India
588921,2023-10-31,1007,Eyeshadow,200,400,200,1,00457,India
588921,2023-10-31,1009,Moisturizer,250,500,250,2,00457,India
588921,2023-10-31,1012,Body Lotion,200,400,200,2,00457,India
588921,2023-10-31,1003,Foundation,300,600,300,1,00457,India
198079,2023-10-31,1006,Blush,150,300,150,1,00428,India
198079,2023-10-31,1009,Moisturizer,250,500,250,2,00428,India
198079,2023-10-31,1007,Eyeshadow,200,400,200,1,00428,India
198079,2023-10-31,1003,Foundation,300,600,300,1,00428,India
321344,2023-10-31,1004,Eyeliner,100,200,100,1,00099,India
321344,2023-10-31,1003,Foundation,300,600,300,1,00099,India
321344,2023-10-31,1006,Blush,150,300,150,1,00099,India
321344,2023-10-31,1008,Makeup Remover,80,160,80,1,00099,India
293433,2023-10-31,1008,Makeup Remover,80,160,80,1,00003,India
293433,2023-10-31,1006,Blush,150,300,150,1,00003,India
293433,2023-10-31,1001,Lipstick,150,300,150,1,00003,India
719098,2023-10-31,1012,Body Lotion,200,400,200,2,00477,India
719098,2023-10-31,1007,Eyeshadow,200,400,200,1,00477,India
719098,2023-10-31,1006,Blush,150,300,150,1,00477,India
438026,2023-10-31,1001,Lipstick,150,300,150,1,00114,India
438026,2023-10-31,1002,Mascara,200,400,200,1,00114,India
438026,2023-10-31,1012,Body Lotion,200,400,200,2,00114,India
591033,2023-11-01,1012,Body Lotion,200,400,200,2,00486,India
591033,2023-11-01,1003,Foundation,300,600,300,2,00486,India
591033,2023-11-01,1006,Blush,150,300,150,2,00486,India
282162,2023-11-01,1008,Makeup Remover,80,160,80,2,00103,India
282162,2023-11-01,1012,Body Lotion,200,400,200,2,00103,India
282162,2023-11-01,1002,Mascara,200,400,200,2,00103,India
196497,2023-11-01,1006,Blush,150,300,150,2,00470,India
196497,2023-11-01,1002,Mascara,200,400,200,2,00470,India
196497,2023-11-01,1012,Body Lotion,200,400,200,2,00470,India
196497,2023-11-01,1005,Nail Polish,50,100,50,2,00470,India
954797,2023-11-01,1003,Foundation,300,600,300,2,00348,India
954797,2023-11-01,1012,Body Lotion,200,400,200,2,00348,India
268658,2023-11-01,1006,Blush,150,300,150,2,00495,India
268658,2023-11-01,1002,Mascara,200,400,200,2,00495,India
981343,2023-11-01,1004,Eyeliner,100,200,100,2,00496,India
981343,2023-11-01,1009,Moisturizer,250,500,250,2,00496,India
981343,2023-11-01,1005,Nail Polish,50,100,50,2,00496,India
981343,2023-11-01,1001,Lipstick,150,300,150,2,00496,India
637512,2023-11-01,1005,Nail Polish,50,100,50,2,00371,India
637512,2023-11-01,1002,Mascara,200,400,200,2,00371,India
637512,2023-11-01,1006,Blush,150,300,150,2,00371,India
878875,2023-11-01,1001,Lipstick,150,300,150,2,00204,India
878875,2023-11-01,1012,Body Lotion,200,400,200,2,00204,India
878875,2023-11-01,1005,Nail Polish,50,100,50,2,00204,India
768611,2023-11-01,1004,Eyeliner,100,200,100,2,00051,India
768611,2023-11-01,1008,Makeup Remover,80,160,80,2,00051,India
314105,2023-11-01,1001,Lipstick,150,300,150,2,00443,India
314105,2023-11-01,1002,Mascara,200,400,200,2,00443,India
314105,2023-11-01,1009,Moisturizer,250,500,250,2,00443,India
746677,2023-11-01,1005,Nail Polish,50,100,50,2,00132,India
157925,2023-11-01,1002,Mascara,200,400,200,2,00097,India
157925,2023-11-01,1009,Moisturizer,250,500,250,2,00097,India
157925,2023-11-01,1012,Body Lotion,200,400,200,2,00097,India
157925,2023-11-01,1008,Makeup Remover,80,160,80,2,00097,India
376331,2023-11-01,1007,Eyeshadow,200,400,200,2,00269,India
376331,2023-11-01,1012,Body Lotion,200,400,200,2,00269,India
376331,2023-11-01,1008,Makeup Remover,80,160,80,2,00269,India
376331,2023-11-01,1009,Moisturizer,250,500,250,2,00269,India
653331,2023-11-01,1008,Makeup Remover,80,160,80,2,00221,India
653331,2023-11-01,1002,Mascara,200,400,200,2,00221,India
653331,2023-11-01,1007,Eyeshadow,200,400,200,2,00221,India
653331,2023-11-01,1009,Moisturizer,250,500,250,2,00221,India
653331,2023-11-01,1012,Body Lotion,200,400,200,2,00221,India
518228,2023-11-01,1006,Blush,150,300,150,2,00186,India
518228,2023-11-01,1008,Makeup Remover,80,160,80,2,00186,India
518228,2023-11-01,1007,Eyeshadow,200,400,200,2,00186,India
281960,2023-11-01,1003,Foundation,300,600,300,2,00096,India
281960,2023-11-01,1008,Makeup Remover,80,160,80,2,00096,India
281960,2023-11-01,1009,Moisturizer,250,500,250,2,00096,India
523282,2023-11-01,1002,Mascara,200,400,200,2,00115,India
523282,2023-11-01,1003,Foundation,300,600,300,2,00115,India
523282,2023-11-01,1012,Body Lotion,200,400,200,2,00115,India
523282,2023-11-01,1009,Moisturizer,250,500,250,2,00115,India
622287,2023-11-01,1005,Nail Polish,50,100,50,2,00435,India
914239,2023-11-01,1009,Moisturizer,250,500,250,2,00423,India
914239,2023-11-01,1006,Blush,150,300,150,2,00423,India
569650,2023-11-01,1008,Makeup Remover,80,160,80,2,00267,India
799446,2023-11-01,1012,Body Lotion,200,400,200,2,00306,India
799446,2023-11-01,1009,Moisturizer,250,500,250,2,00306,India
799446,2023-11-01,1007,Eyeshadow,200,400,200,2,00306,India
799446,2023-11-01,1006,Blush,150,300,150,2,00306,India
288656,2023-11-01,1004,Eyeliner,100,200,100,2,00314,India
288656,2023-11-01,1003,Foundation,300,600,300,2,00314,India
288656,2023-11-01,1002,Mascara,200,400,200,2,00314,India
543347,2023-11-01,1006,Blush,150,300,150,2,00033,India
543347,2023-11-01,1003,Foundation,300,600,300,2,00033,India
543347,2023-11-01,1001,Lipstick,150,300,150,2,00033,India
782984,2023-11-01,1001,Lipstick,150,300,150,2,00500,India
782984,2023-11-01,1004,Eyeliner,100,200,100,2,00500,India
342687,2023-11-01,1001,Lipstick,150,300,150,2,00003,India
477546,2023-11-01,1005,Nail Polish,50,100,50,2,00345,India
477546,2023-11-01,1012,Body Lotion,200,400,200,2,00345,India
644175,2023-11-01,1006,Blush,150,300,150,2,00434,India
644175,2023-11-01,1003,Foundation,300,600,300,2,00434,India
482306,2023-11-01,1003,Foundation,300,600,300,2,00109,India
372285,2023-11-01,1004,Eyeliner,100,200,100,2,00263,India
372285,2023-11-01,1012,Body Lotion,200,400,200,2,00263,India
360785,2023-11-01,1008,Makeup Remover,80,160,80,2,00002,India
360785,2023-11-01,1002,Mascara,200,400,200,2,00002,India
360785,2023-11-01,1012,Body Lotion,200,400,200,2,00002,India
360785,2023-11-01,1009,Moisturizer,250,500,250,2,00002,India
641662,2023-11-01,1008,Makeup Remover,80,160,80,2,00220,India
641662,2023-11-01,1005,Nail Polish,50,100,50,2,00220,India
641662,2023-11-01,1002,Mascara,200,400,200,2,00220,India
641662,2023-11-01,1001,Lipstick,150,300,150,2,00220,India
125002,2023-11-01,1008,Makeup Remover,80,160,80,2,00489,India
125002,2023-11-01,1009,Moisturizer,250,500,250,2,00489,India
125002,2023-11-01,1002,Mascara,200,400,200,2,00489,India
634752,2023-11-01,1005,Nail Polish,50,100,50,2,00292,India
245830,2023-11-01,1008,Makeup Remover,80,160,80,2,00255,India
245830,2023-11-01,1006,Blush,150,300,150,2,00255,India
266124,2023-11-01,1007,Eyeshadow,200,400,200,2,00006,India
266124,2023-11-01,1012,Body Lotion,200,400,200,2,00006,India
266124,2023-11-01,1004,Eyeliner,100,200,100,2,00006,India
788949,2023-11-01,1004,Eyeliner,100,200,100,2,00168,India
788949,2023-11-01,1003,Foundation,300,600,300,2,00168,India
788949,2023-11-01,1012,Body Lotion,200,400,200,2,00168,India
913226,2023-11-01,1005,Nail Polish,50,100,50,2,00182,India
769021,2023-11-01,1003,Foundation,300,600,300,2,00382,India
769021,2023-11-01,1008,Makeup Remover,80,160,80,2,00382,India
769021,2023-11-01,1007,Eyeshadow,200,400,200,2,00382,India
230595,2023-11-01,1006,Blush,150,300,150,2,00049,India
230595,2023-11-01,1003,Foundation,300,600,300,2,00049,India
230595,2023-11-01,1007,Eyeshadow,200,400,200,2,00049,India
230595,2023-11-01,1001,Lipstick,150,300,150,2,00049,India
456694,2023-11-01,1009,Moisturizer,250,500,250,2,00112,India
456694,2023-11-01,1004,Eyeliner,100,200,100,2,00112,India
456694,2023-11-01,1003,Foundation,300,600,300,2,00112,India
713552,2023-11-01,1003,Foundation,300,600,300,2,00460,India
713552,2023-11-01,1012,Body Lotion,200,400,200,2,00460,India
713552,2023-11-01,1009,Moisturizer,250,500,250,2,00460,India
713552,2023-11-01,1007,Eyeshadow,200,400,200,2,00460,India
895901,2023-11-01,1005,Nail Polish,50,100,50,2,00348,India
895901,2023-11-01,1012,Body Lotion,200,400,200,2,00348,India
895901,2023-11-01,1002,Mascara,200,400,200,2,00348,India
895901,2023-11-01,1006,Blush,150,300,150,2,00348,India
979807,2023-11-01,1001,Lipstick,150,300,150,2,00390,India
979807,2023-11-01,1003,Foundation,300,600,300,2,00390,India
979807,2023-11-01,1004,Eyeliner,100,200,100,2,00390,India
474477,2023-11-01,1008,Makeup Remover,80,160,80,2,00301,India
474477,2023-11-01,1002,Mascara,200,400,200,2,00301,India
823133,2023-11-01,1004,Eyeliner,100,200,100,2,00333,India
823133,2023-11-01,1005,Nail Polish,50,100,50,2,00333,India
802671,2023-11-01,1004,Eyeliner,100,200,100,2,00169,India
802671,2023-11-01,1012,Body Lotion,200,400,200,2,00169,India
802671,2023-11-01,1003,Foundation,300,600,300,2,00169,India
802671,2023-11-01,1006,Blush,150,300,150,2,00169,India
393583,2023-11-01,1007,Eyeshadow,200,400,200,2,00132,India
393583,2023-11-01,1012,Body Lotion,200,400,200,2,00132,India
913329,2023-11-01,1008,Makeup Remover,80,160,80,2,00007,India
913329,2023-11-01,1009,Moisturizer,250,500,250,2,00007,India
913329,2023-11-01,1006,Blush,150,300,150,2,00007,India
913329,2023-11-01,1004,Eyeliner,100,200,100,2,00007,India
364245,2023-11-01,1008,Makeup Remover,80,160,80,2,00310,India
364245,2023-11-01,1009,Moisturizer,250,500,250,2,00310,India
364245,2023-11-01,1003,Foundation,300,600,300,2,00310,India
175225,2023-11-02,1009,Moisturizer,250,500,250,2,00030,India
175225,2023-11-02,1012,Body Lotion,200,400,200,2,00030,India
175225,2023-11-02,1004,Eyeliner,100,200,100,2,00030,India
175225,2023-11-02,1002,Mascara,200,400,200,2,00030,India
488362,2023-11-02,1007,Eyeshadow,200,400,200,2,00090,India
488362,2023-11-02,1001,Lipstick,150,300,150,2,00090,India
535063,2023-11-02,1003,Foundation,300,600,300,2,00261,India
535063,2023-11-02,1001,Lipstick,150,300,150,2,00261,India
798670,2023-11-02,1009,Moisturizer,250,500,250,2,00331,India
798670,2023-11-02,1004,Eyeliner,100,200,100,2,00331,India
798670,2023-11-02,1005,Nail Polish,50,100,50,2,00331,India
798670,2023-11-02,1003,Foundation,300,600,300,2,00331,India
232504,2023-11-02,1003,Foundation,300,600,300,2,00119,India
630834,2023-11-02,1004,Eyeliner,100,200,100,2,00417,India
773440,2023-11-02,1001,Lipstick,150,300,150,2,00251,India
773440,2023-11-02,1006,Blush,150,300,150,2,00251,India
773440,2023-11-02,1002,Mascara,200,400,200,2,00251,India
773440,2023-11-02,1005,Nail Polish,50,100,50,2,00251,India
206137,2023-11-02,1004,Eyeliner,100,200,100,2,00476,India
206137,2023-11-02,1006,Blush,150,300,150,2,00476,India
993015,2023-11-02,1012,Body Lotion,200,400,200,2,00478,India
993015,2023-11-02,1002,Mascara,200,400,200,2,00478,India
993015,2023-11-02,1009,Moisturizer,250,500,250,2,00478,India
198170,2023-11-02,1001,Lipstick,150,300,150,2,00098,India
198170,2023-11-02,1002,Mascara,200,400,200,2,00098,India
198170,2023-11-02,1004,Eyeliner,100,200,100,2,00098,India
198170,2023-11-02,1003,Foundation,300,600,300,2,00098,India
343187,2023-11-02,1012,Body Lotion,200,400,200,2,00411,India
343187,2023-11-02,1005,Nail Polish,50,100,50,2,00411,India
343187,2023-11-02,1009,Moisturizer,250,500,250,2,00411,India
574338,2023-11-02,1001,Lipstick,150,300,150,2,00392,India
574338,2023-11-02,1008,Makeup Remover,80,160,80,2,00392,India
574338,2023-11-02,1006,Blush,150,300,150,2,00392,India
574338,2023-11-02,1002,Mascara,200,400,200,2,00392,India
731490,2023-11-02,1003,Foundation,300,600,300,2,00160,India
731490,2023-11-02,1008,Makeup Remover,80,160,80,2,00160,India
731490,2023-11-02,1005,Nail Polish,50,100,50,2,00160,India
731490,2023-11-02,1002,Mascara,200,400,200,2,00160,India
731490,2023-11-02,1012,Body Lotion,200,400,200,2,00160,India
769182,2023-11-02,1006,Blush,150,300,150,2,00378,India
769182,2023-11-02,1005,Nail Polish,50,100,50,2,00378,India
769182,2023-11-02,1012,Body Lotion,200,400,200,2,00378,India
272695,2023-11-02,1005,Nail Polish,50,100,50,2,00070,India
272695,2023-11-02,1008,Makeup Remover,80,160,80,2,00070,India
143810,2023-11-02,1008,Makeup Remover,80,160,80,2,00164,India
143810,2023-11-02,1002,Mascara,200,400,200,2,00164,India
143810,2023-11-02,1009,Moisturizer,250,500,250,2,00164,India
824782,2023-11-02,1012,Body Lotion,200,400,200,2,00245,India
677032,2023-11-02,1007,Eyeshadow,200,400,200,2,00357,India
677032,2023-11-02,1006,Blush,150,300,150,2,00357,India
677032,2023-11-02,1002,Mascara,200,400,200,2,00357,India
337934,2023-11-02,1003,Foundation,300,600,300,2,00116,India
337934,2023-11-02,1009,Moisturizer,250,500,250,2,00116,India
444383,2023-11-02,1002,Mascara,200,400,200,2,00426,India
444383,2023-11-02,1008,Makeup Remover,80,160,80,2,00426,India
444383,2023-11-02,1006,Blush,150,300,150,2,00426,India
521220,2023-11-02,1008,Makeup Remover,80,160,80,2,00292,India
521220,2023-11-02,1009,Moisturizer,250,500,250,2,00292,India
227250,2023-11-02,1007,Eyeshadow,200,400,200,2,00132,India
542120,2023-11-02,1002,Mascara,200,400,200,2,00302,India
542120,2023-11-02,1001,Lipstick,150,300,150,2,00302,India
232626,2023-11-02,1005,Nail Polish,50,100,50,2,00247,India
269643,2023-11-02,1001,Lipstick,150,300,150,2,00117,India
930067,2023-11-02,1007,Eyeshadow,200,400,200,2,00410,India
563395,2023-11-02,1012,Body Lotion,200,400,200,2,00335,India
563395,2023-11-02,1002,Mascara,200,400,200,2,00335,India
430578,2023-11-02,1004,Eyeliner,100,200,100,2,00448,India
430578,2023-11-02,1012,Body Lotion,200,400,200,2,00448,India
430578,2023-11-02,1006,Blush,150,300,150,2,00448,India
430578,2023-11-02,1002,Mascara,200,400,200,2,00448,India
430578,2023-11-02,1008,Makeup Remover,80,160,80,2,00448,India
663974,2023-11-02,1001,Lipstick,150,300,150,2,00368,India
663974,2023-11-02,1005,Nail Polish,50,100,50,2,00368,India
766378,2023-11-02,1004,Eyeliner,100,200,100,2,00045,India
766378,2023-11-02,1002,Mascara,200,400,200,2,00045,India
766378,2023-11-02,1006,Blush,150,300,150,2,00045,India
766378,2023-11-02,1005,Nail Polish,50,100,50,2,00045,India
215652,2023-11-02,1007,Eyeshadow,200,400,200,2,00414,India
215652,2023-11-02,1002,Mascara,200,400,200,2,00414,India
924479,2023-11-02,1012,Body Lotion,200,400,200,2,00179,India
924479,2023-11-02,1007,Eyeshadow,200,400,200,2,00179,India
924479,2023-11-02,1008,Makeup Remover,80,160,80,2,00179,India
924479,2023-11-02,1005,Nail Polish,50,100,50,2,00179,India
328896,2023-11-02,1007,Eyeshadow,200,400,200,2,00248,India
328896,2023-11-02,1008,Makeup Remover,80,160,80,2,00248,India
530131,2023-11-02,1001,Lipstick,150,300,150,2,00002,India
530131,2023-11-02,1003,Foundation,300,600,300,2,00002,India
530131,2023-11-02,1009,Moisturizer,250,500,250,2,00002,India
530131,2023-11-02,1004,Eyeliner,100,200,100,2,00002,India
213961,2023-11-02,1001,Lipstick,150,300,150,2,00317,India
213961,2023-11-02,1012,Body Lotion,200,400,200,2,00317,India
213961,2023-11-02,1006,Blush,150,300,150,2,00317,India
213961,2023-11-02,1008,Makeup Remover,80,160,80,2,00317,India
307425,2023-11-02,1004,Eyeliner,100,200,100,2,00022,India
307425,2023-11-02,1005,Nail Polish,50,100,50,2,00022,India
720032,2023-11-02,1006,Blush,150,300,150,2,00307,India
720032,2023-11-02,1012,Body Lotion,200,400,200,2,00307,India
300482,2023-11-02,1003,Foundation,300,600,300,2,00023,India
300482,2023-11-02,1004,Eyeliner,100,200,100,2,00023,India
970079,2023-11-02,1006,Blush,150,300,150,2,00384,India
970079,2023-11-02,1002,Mascara,200,400,200,2,00384,India
970079,2023-11-02,1009,Moisturizer,250,500,250,2,00384,India
405956,2023-11-02,1009,Moisturizer,250,500,250,2,00177,India
968234,2023-11-02,1001,Lipstick,150,300,150,2,00130,India
968234,2023-11-02,1007,Eyeshadow,200,400,200,2,00130,India
936204,2023-11-02,1006,Blush,150,300,150,2,00311,India
936204,2023-11-02,1004,Eyeliner,100,200,100,2,00311,India
936204,2023-11-02,1012,Body Lotion,200,400,200,2,00311,India
991165,2023-11-02,1005,Nail Polish,50,100,50,2,00261,India
565904,2023-11-02,1004,Eyeliner,100,200,100,2,00026,India
387262,2023-11-02,1012,Body Lotion,200,400,200,2,00056,India
387262,2023-11-02,1002,Mascara,200,400,200,2,00056,India
641765,2023-11-02,1005,Nail Polish,50,100,50,2,00328,India
641765,2023-11-02,1007,Eyeshadow,200,400,200,2,00328,India
641765,2023-11-02,1001,Lipstick,150,300,150,2,00328,India
641765,2023-11-02,1008,Makeup Remover,80,160,80,2,00328,India
797492,2023-11-02,1012,Body Lotion,200,400,200,2,00499,India
797492,2023-11-02,1009,Moisturizer,250,500,250,2,00499,India
797492,2023-11-02,1008,Makeup Remover,80,160,80,2,00499,India
855904,2023-11-03,1012,Body Lotion,200,400,200,2,00218,India
855904,2023-11-03,1001,Lipstick,150,300,150,2,00218,India
698635,2023-11-03,1002,Mascara,200,400,200,2,00140,India
698635,2023-11-03,1001,Lipstick,150,300,150,2,00140,India
698635,2023-11-03,1012,Body Lotion,200,400,200,2,00140,India
165819,2023-11-03,1007,Eyeshadow,200,400,200,2,00431,India
165819,2023-11-03,1012,Body Lotion,200,400,200,2,00431,India
165819,2023-11-03,1004,Eyeliner,100,200,100,2,00431,India
165819,2023-11-03,1003,Foundation,300,600,300,2,00431,India
506646,2023-11-03,1012,Body Lotion,200,400,200,2,00420,India
506646,2023-11-03,1009,Moisturizer,250,500,250,2,00420,India
676311,2023-11-03,1002,Mascara,200,400,200,2,00037,India
676311,2023-11-03,1003,Foundation,300,600,300,2,00037,India
735393,2023-11-03,1008,Makeup Remover,80,160,80,2,00484,India
735393,2023-11-03,1002,Mascara,200,400,200,2,00484,India
735393,2023-11-03,1004,Eyeliner,100,200,100,2,00484,India
735393,2023-11-03,1006,Blush,150,300,150,2,00484,India
735393,2023-11-03,1012,Body Lotion,200,400,200,2,00484,India
707683,2023-11-03,1005,Nail Polish,50,100,50,2,00175,India
707683,2023-11-03,1006,Blush,150,300,150,2,00175,India
707683,2023-11-03,1004,Eyeliner,100,200,100,2,00175,India
707683,2023-11-03,1001,Lipstick,150,300,150,2,00175,India
707683,2023-11-03,1007,Eyeshadow,200,400,200,2,00175,India
579809,2023-11-03,1002,Mascara,200,400,200,2,00036,India
579809,2023-11-03,1006,Blush,150,300,150,2,00036,India
579809,2023-11-03,1003,Foundation,300,600,300,2,00036,India
579809,2023-11-03,1007,Eyeshadow,200,400,200,2,00036,India
579809,2023-11-03,1012,Body Lotion,200,400,200,2,00036,India
578114,2023-11-03,1004,Eyeliner,100,200,100,2,00006,India
580291,2023-11-03,1006,Blush,150,300,150,2,00082,India
580291,2023-11-03,1012,Body Lotion,200,400,200,2,00082,India
580291,2023-11-03,1009,Moisturizer,250,500,250,2,00082,India
612141,2023-11-03,1004,Eyeliner,100,200,100,2,00131,India
612141,2023-11-03,1001,Lipstick,150,300,150,2,00131,India
728461,2023-11-03,1006,Blush,150,300,150,2,00226,India
728461,2023-11-03,1009,Moisturizer,250,500,250,2,00226,India
728461,2023-11-03,1008,Makeup Remover,80,160,80,2,00226,India
151539,2023-11-03,1001,Lipstick,150,300,150,2,00049,India
151539,2023-11-03,1002,Mascara,200,400,200,2,00049,India
151539,2023-11-03,1012,Body Lotion,200,400,200,2,00049,India
151539,2023-11-03,1003,Foundation,300,600,300,2,00049,India
932121,2023-11-03,1003,Foundation,300,600,300,2,00063,India
314269,2023-11-03,1001,Lipstick,150,300,150,2,00238,India
314269,2023-11-03,1007,Eyeshadow,200,400,200,2,00238,India
314269,2023-11-03,1009,Moisturizer,250,500,250,2,00238,India
702560,2023-11-03,1003,Foundation,300,600,300,2,00117,India
966228,2023-11-03,1007,Eyeshadow,200,400,200,2,00069,India
966228,2023-11-03,1004,Eyeliner,100,200,100,2,00069,India
966228,2023-11-03,1001,Lipstick,150,300,150,2,00069,India
966228,2023-11-03,1009,Moisturizer,250,500,250,2,00069,India
106217,2023-11-03,1004,Eyeliner,100,200,100,2,00153,India
106217,2023-11-03,1002,Mascara,200,400,200,2,00153,India
147030,2023-11-03,1008,Makeup Remover,80,160,80,2,00223,India
147030,2023-11-03,1004,Eyeliner,100,200,100,2,00223,India
147030,2023-11-03,1002,Mascara,200,400,200,2,00223,India
147030,2023-11-03,1005,Nail Polish,50,100,50,2,00223,India
147030,2023-11-03,1012,Body Lotion,200,400,200,2,00223,India
611174,2023-11-03,1012,Body Lotion,200,400,200,2,00197,India
611174,2023-11-03,1001,Lipstick,150,300,150,2,00197,India
611174,2023-11-03,1002,Mascara,200,400,200,2,00197,India
326364,2023-11-03,1007,Eyeshadow,200,400,200,2,00320,India
629701,2023-11-03,1012,Body Lotion,200,400,200,2,00325,India
629701,2023-11-03,1003,Foundation,300,600,300,2,00325,India
629701,2023-11-03,1008,Makeup Remover,80,160,80,2,00325,India
581429,2023-11-03,1001,Lipstick,150,300,150,2,00282,India
581429,2023-11-03,1006,Blush,150,300,150,2,00282,India
581429,2023-11-03,1003,Foundation,300,600,300,2,00282,India
381154,2023-11-03,1008,Makeup Remover,80,160,80,2,00168,India
381154,2023-11-03,1002,Mascara,200,400,200,2,00168,India
381154,2023-11-03,1006,Blush,150,300,150,2,00168,India
859928,2023-11-03,1009,Moisturizer,250,500,250,2,00011,India
475833,2023-11-03,1002,Mascara,200,400,200,2,00144,India
475833,2023-11-03,1006,Blush,150,300,150,2,00144,India
870855,2023-11-03,1003,Foundation,300,600,300,2,00180,India
870855,2023-11-03,1007,Eyeshadow,200,400,200,2,00180,India
859744,2023-11-03,1006,Blush,150,300,150,2,00367,India
859744,2023-11-03,1004,Eyeliner,100,200,100,2,00367,India
316668,2023-11-03,1003,Foundation,300,600,300,2,00092,India
316668,2023-11-03,1012,Body Lotion,200,400,200,2,00092,India
316668,2023-11-03,1007,Eyeshadow,200,400,200,2,00092,India
316668,2023-11-03,1001,Lipstick,150,300,150,2,00092,India
217483,2023-11-03,1009,Moisturizer,250,500,250,2,00310,India
217483,2023-11-03,1012,Body Lotion,200,400,200,2,00310,India
217483,2023-11-03,1007,Eyeshadow,200,400,200,2,00310,India
217483,2023-11-03,1004,Eyeliner,100,200,100,2,00310,India
450708,2023-11-03,1009,Moisturizer,250,500,250,2,00027,India
450708,2023-11-03,1007,Eyeshadow,200,400,200,2,00027,India
450708,2023-11-03,1001,Lipstick,150,300,150,2,00027,India
783985,2023-11-03,1009,Moisturizer,250,500,250,2,00118,India
783985,2023-11-03,1002,Mascara,200,400,200,2,00118,India
171219,2023-11-03,1004,Eyeliner,100,200,100,2,00267,India
171219,2023-11-03,1006,Blush,150,300,150,2,00267,India
171219,2023-11-03,1008,Makeup Remover,80,160,80,2,00267,India
171219,2023-11-03,1003,Foundation,300,600,300,2,00267,India
235924,2023-11-04,1004,Eyeliner,100,200,100,2,00498,India
235924,2023-11-04,1005,Nail Polish,50,100,50,2,00498,India
544842,2023-11-04,1012,Body Lotion,200,400,200,2,00388,India
544842,2023-11-04,1009,Moisturizer,250,500,250,2,00388,India
544842,2023-11-04,1007,Eyeshadow,200,400,200,2,00388,India
355249,2023-11-04,1012,Body Lotion,200,400,200,2,00035,India
355249,2023-11-04,1006,Blush,150,300,150,2,00035,India
766702,2023-11-04,1005,Nail Polish,50,100,50,2,00388,India
412632,2023-11-04,1012,Body Lotion,200,400,200,2,00172,India
338555,2023-11-04,1001,Lipstick,150,300,150,2,00108,India
338555,2023-11-04,1004,Eyeliner,100,200,100,2,00108,India
338555,2023-11-04,1005,Nail Polish,50,100,50,2,00108,India
338555,2023-11-04,1006,Blush,150,300,150,2,00108,India
776902,2023-11-04,1003,Foundation,300,600,300,2,00205,India
776902,2023-11-04,1009,Moisturizer,250,500,250,2,00205,India
776902,2023-11-04,1004,Eyeliner,100,200,100,2,00205,India
776902,2023-11-04,1012,Body Lotion,200,400,200,2,00205,India
192312,2023-11-04,1005,Nail Polish,50,100,50,2,00083,India
192312,2023-11-04,1012,Body Lotion,200,400,200,2,00083,India
192312,2023-11-04,1002,Mascara,200,400,200,2,00083,India
258669,2023-11-04,1008,Makeup Remover,80,160,80,2,00342,India
258669,2023-11-04,1002,Mascara,200,400,200,2,00342,India
258669,2023-11-04,1004,Eyeliner,100,200,100,2,00342,India
258669,2023-11-04,1003,Foundation,300,600,300,2,00342,India
813511,2023-11-04,1004,Eyeliner,100,200,100,2,00399,India
813511,2023-11-04,1005,Nail Polish,50,100,50,2,00399,India
813511,2023-11-04,1003,Foundation,300,600,300,2,00399,India
577741,2023-11-04,1008,Makeup Remover,80,160,80,2,00142,India
577741,2023-11-04,1002,Mascara,200,400,200,2,00142,India
577741,2023-11-04,1012,Body Lotion,200,400,200,2,00142,India
577741,2023-11-04,1009,Moisturizer,250,500,250,2,00142,India
577741,2023-11-04,1005,Nail Polish,50,100,50,2,00142,India
199761,2023-11-04,1003,Foundation,300,600,300,2,00145,India
859385,2023-11-04,1002,Mascara,200,400,200,2,00346,India
859385,2023-11-04,1009,Moisturizer,250,500,250,2,00346,India
859385,2023-11-04,1008,Makeup Remover,80,160,80,2,00346,India
859385,2023-11-04,1003,Foundation,300,600,300,2,00346,India
817215,2023-11-04,1005,Nail Polish,50,100,50,2,00290,India
817215,2023-11-04,1008,Makeup Remover,80,160,80,2,00290,India
817215,2023-11-04,1003,Foundation,300,600,300,2,00290,India
817215,2023-11-04,1001,Lipstick,150,300,150,2,00290,India
895207,2023-11-04,1009,Moisturizer,250,500,250,2,00083,India
895207,2023-11-04,1005,Nail Polish,50,100,50,2,00083,India
117739,2023-11-04,1004,Eyeliner,100,200,100,2,00385,India
673330,2023-11-04,1005,Nail Polish,50,100,50,2,00470,India
317808,2023-11-04,1012,Body Lotion,200,400,200,2,00411,India
317808,2023-11-04,1004,Eyeliner,100,200,100,2,00411,India
317808,2023-11-04,1008,Makeup Remover,80,160,80,2,00411,India
838001,2023-11-04,1005,Nail Polish,50,100,50,2,00155,India
749978,2023-11-04,1003,Foundation,300,600,300,2,00279,India
749978,2023-11-04,1005,Nail Polish,50,100,50,2,00279,India
749978,2023-11-04,1009,Moisturizer,250,500,250,2,00279,India
749978,2023-11-04,1004,Eyeliner,100,200,100,2,00279,India
860264,2023-11-04,1002,Mascara,200,400,200,2,00485,India
860264,2023-11-04,1004,Eyeliner,100,200,100,2,00485,India
813834,2023-11-04,1004,Eyeliner,100,200,100,2,00317,India
813834,2023-11-04,1012,Body Lotion,200,400,200,2,00317,India
813834,2023-11-04,1009,Moisturizer,250,500,250,2,00317,India
813834,2023-11-04,1002,Mascara,200,400,200,2,00317,India
645777,2023-11-04,1012,Body Lotion,200,400,200,2,00117,India
645777,2023-11-04,1002,Mascara,200,400,200,2,00117,India
645777,2023-11-04,1009,Moisturizer,250,500,250,2,00117,India
645777,2023-11-04,1001,Lipstick,150,300,150,2,00117,India
519887,2023-11-04,1008,Makeup Remover,80,160,80,2,00210,India
519887,2023-11-04,1006,Blush,150,300,150,2,00210,India
519887,2023-11-04,1001,Lipstick,150,300,150,2,00210,India
444227,2023-11-04,1001,Lipstick,150,300,150,2,00449,India
444227,2023-11-04,1004,Eyeliner,100,200,100,2,00449,India
444227,2023-11-04,1002,Mascara,200,400,200,2,00449,India
105651,2023-11-04,1001,Lipstick,150,300,150,2,00360,India
105651,2023-11-04,1002,Mascara,200,400,200,2,00360,India
105651,2023-11-04,1006,Blush,150,300,150,2,00360,India
277506,2023-11-04,1007,Eyeshadow,200,400,200,2,00080,India
277506,2023-11-04,1001,Lipstick,150,300,150,2,00080,India
394825,2023-11-04,1008,Makeup Remover,80,160,80,2,00071,India
394825,2023-11-04,1005,Nail Polish,50,100,50,2,00071,India
854358,2023-11-04,1008,Makeup Remover,80,160,80,2,00469,India
854358,2023-11-04,1003,Foundation,300,600,300,2,00469,India
821775,2023-11-04,1002,Mascara,200,400,200,2,00166,India
821775,2023-11-04,1003,Foundation,300,600,300,2,00166,India
821775,2023-11-04,1007,Eyeshadow,200,400,200,2,00166,India
821775,2023-11-04,1001,Lipstick,150,300,150,2,00166,India
471051,2023-11-04,1002,Mascara,200,400,200,2,00183,India
769460,2023-11-04,1002,Mascara,200,400,200,2,00314,India
769460,2023-11-04,1007,Eyeshadow,200,400,200,2,00314,India
769460,2023-11-04,1004,Eyeliner,100,200,100,2,00314,India
741887,2023-11-04,1004,Eyeliner,100,200,100,2,00355,India
804232,2023-11-04,1005,Nail Polish,50,100,50,2,00388,India
306837,2023-11-04,1001,Lipstick,150,300,150,2,00481,India
306837,2023-11-04,1007,Eyeshadow,200,400,200,2,00481,India
904560,2023-11-04,1002,Mascara,200,400,200,2,00102,India
904560,2023-11-04,1001,Lipstick,150,300,150,2,00102,India
904560,2023-11-04,1006,Blush,150,300,150,2,00102,India
904560,2023-11-04,1003,Foundation,300,600,300,2,00102,India
356355,2023-11-04,1002,Mascara,200,400,200,2,00352,India
356355,2023-11-04,1003,Foundation,300,600,300,2,00352,India
356355,2023-11-04,1005,Nail Polish,50,100,50,2,00352,India
356355,2023-11-04,1012,Body Lotion,200,400,200,2,00352,India
121195,2023-11-04,1004,Eyeliner,100,200,100,2,00313,India
121195,2023-11-04,1001,Lipstick,150,300,150,2,00313,India
121195,2023-11-04,1002,Mascara,200,400,200,2,00313,India
602295,2023-11-04,1002,Mascara,200,400,200,2,00226,India
602295,2023-11-04,1004,Eyeliner,100,200,100,2,00226,India
602295,2023-11-04,1012,Body Lotion,200,400,200,2,00226,India
157116,2023-11-04,1007,Eyeshadow,200,400,200,2,00082,India
157116,2023-11-04,1004,Eyeliner,100,200,100,2,00082,India
157116,2023-11-04,1012,Body Lotion,200,400,200,2,00082,India
791397,2023-11-04,1009,Moisturizer,250,500,250,2,00119,India
791397,2023-11-04,1012,Body Lotion,200,400,200,2,00119,India
791397,2023-11-04,1005,Nail Polish,50,100,50,2,00119,India
212673,2023-11-05,1008,Makeup Remover,80,160,80,2,00422,India
212673,2023-11-05,1004,Eyeliner,100,200,100,2,00422,India
228263,2023-11-05,1012,Body Lotion,200,400,200,2,00364,India
228263,2023-11-05,1006,Blush,150,300,150,2,00364,India
228263,2023-11-05,1008,Makeup Remover,80,160,80,2,00364,India
228263,2023-11-05,1005,Nail Polish,50,100,50,2,00364,India
789666,2023-11-05,1002,Mascara,200,400,200,2,00325,India
789666,2023-11-05,1008,Makeup Remover,80,160,80,2,00325,India
789666,2023-11-05,1005,Nail Polish,50,100,50,2,00325,India
789666,2023-11-05,1007,Eyeshadow,200,400,200,2,00325,India
789666,2023-11-05,1012,Body Lotion,200,400,200,2,00325,India
423984,2023-11-05,1012,Body Lotion,200,400,200,2,00284,India
423984,2023-11-05,1001,Lipstick,150,300,150,2,00284,India
221421,2023-11-05,1005,Nail Polish,50,100,50,2,00369,India
221421,2023-11-05,1001,Lipstick,150,300,150,2,00369,India
221421,2023-11-05,1012,Body Lotion,200,400,200,2,00369,India
221421,2023-11-05,1009,Moisturizer,250,500,250,2,00369,India
221421,2023-11-05,1004,Eyeliner,100,200,100,2,00369,India
564238,2023-11-05,1003,Foundation,300,600,300,2,00485,India
564238,2023-11-05,1006,Blush,150,300,150,2,00485,India
564238,2023-11-05,1005,Nail Polish,50,100,50,2,00485,India
564238,2023-11-05,1008,Makeup Remover,80,160,80,2,00485,India
564238,2023-11-05,1001,Lipstick,150,300,150,2,00485,India
913449,2023-11-05,1006,Blush,150,300,150,2,00350,India
913449,2023-11-05,1002,Mascara,200,400,200,2,00350,India
853128,2023-11-05,1004,Eyeliner,100,200,100,2,00453,India
853128,2023-11-05,1012,Body Lotion,200,400,200,2,00453,India
853128,2023-11-05,1002,Mascara,200,400,200,2,00453,India
997501,2023-11-05,1007,Eyeshadow,200,400,200,2,00167,India
997501,2023-11-05,1012,Body Lotion,200,400,200,2,00167,India
997501,2023-11-05,1001,Lipstick,150,300,150,2,00167,India
832442,2023-11-05,1009,Moisturizer,250,500,250,2,00429,India
832442,2023-11-05,1006,Blush,150,300,150,2,00429,India
832442,2023-11-05,1003,Foundation,300,600,300,2,00429,India
832442,2023-11-05,1004,Eyeliner,100,200,100,2,00429,India
734777,2023-11-05,1003,Foundation,300,600,300,2,00067,India
694431,2023-11-05,1008,Makeup Remover,80,160,80,2,00100,India
694431,2023-11-05,1004,Eyeliner,100,200,100,2,00100,India
694431,2023-11-05,1005,Nail Polish,50,100,50,2,00100,India
694431,2023-11-05,1009,Moisturizer,250,500,250,2,00100,India
694431,2023-11-05,1007,Eyeshadow,200,400,200,2,00100,India
512710,2023-11-05,1012,Body Lotion,200,400,200,2,00442,India
512710,2023-11-05,1006,Blush,150,300,150,2,00442,India
512710,2023-11-05,1008,Makeup Remover,80,160,80,2,00442,India
512710,2023-11-05,1009,Moisturizer,250,500,250,2,00442,India
512710,2023-11-05,1003,Foundation,300,600,300,2,00442,India
251667,2023-11-05,1008,Makeup Remover,80,160,80,2,00029,India
251667,2023-11-05,1012,Body Lotion,200,400,200,2,00029,India
251667,2023-11-05,1004,Eyeliner,100,200,100,2,00029,India
706547,2023-11-05,1008,Makeup Remover,80,160,80,2,00479,India
706547,2023-11-05,1001,Lipstick,150,300,150,2,00479,India
263582,2023-11-05,1008,Makeup Remover,80,160,80,2,00422,India
376114,2023-11-05,1004,Eyeliner,100,200,100,2,00366,India
376114,2023-11-05,1012,Body Lotion,200,400,200,2,00366,India
376114,2023-11-05,1003,Foundation,300,600,300,2,00366,India
253283,2023-11-05,1005,Nail Polish,50,100,50,2,00387,India
324637,2023-11-05,1005,Nail Polish,50,100,50,2,00307,India
324637,2023-11-05,1003,Foundation,300,600,300,2,00307,India
295056,2023-11-05,1012,Body Lotion,200,400,200,2,00438,India
801063,2023-11-05,1006,Blush,150,300,150,2,00035,India
801063,2023-11-05,1007,Eyeshadow,200,400,200,2,00035,India
801063,2023-11-05,1002,Mascara,200,400,200,2,00035,India
288873,2023-11-05,1005,Nail Polish,50,100,50,2,00214,India
288873,2023-11-05,1006,Blush,150,300,150,2,00214,India
177074,2023-11-05,1006,Blush,150,300,150,2,00149,India
993911,2023-11-05,1005,Nail Polish,50,100,50,2,00330,India
993911,2023-11-05,1009,Moisturizer,250,500,250,2,00330,India
424702,2023-11-05,1003,Foundation,300,600,300,2,00115,India
424702,2023-11-05,1004,Eyeliner,100,200,100,2,00115,India
424702,2023-11-05,1002,Mascara,200,400,200,2,00115,India
424702,2023-11-05,1009,Moisturizer,250,500,250,2,00115,India
424702,2023-11-05,1012,Body Lotion,200,400,200,2,00115,India
452526,2023-11-05,1003,Foundation,300,600,300,2,00234,India
452526,2023-11-05,1004,Eyeliner,100,200,100,2,00234,India
452526,2023-11-05,1001,Lipstick,150,300,150,2,00234,India
452526,2023-11-05,1008,Makeup Remover,80,160,80,2,00234,India
725776,2023-11-05,1006,Blush,150,300,150,2,00191,India
450206,2023-11-05,1007,Eyeshadow,200,400,200,2,00443,India
450206,2023-11-05,1002,Mascara,200,400,200,2,00443,India
450206,2023-11-05,1012,Body Lotion,200,400,200,2,00443,India
450206,2023-11-05,1004,Eyeliner,100,200,100,2,00443,India
643567,2023-11-05,1007,Eyeshadow,200,400,200,2,00283,India
643567,2023-11-05,1002,Mascara,200,400,200,2,00283,India
230269,2023-11-05,1006,Blush,150,300,150,2,00073,India
230269,2023-11-05,1009,Moisturizer,250,500,250,2,00073,India
230269,2023-11-05,1007,Eyeshadow,200,400,200,2,00073,India
903831,2023-11-05,1005,Nail Polish,50,100,50,2,00089,India
620162,2023-11-05,1004,Eyeliner,100,200,100,2,00094,India
620162,2023-11-05,1012,Body Lotion,200,400,200,2,00094,India
620162,2023-11-05,1001,Lipstick,150,300,150,2,00094,India
258285,2023-11-05,1007,Eyeshadow,200,400,200,2,00242,India
258285,2023-11-05,1002,Mascara,200,400,200,2,00242,India
258285,2023-11-05,1012,Body Lotion,200,400,200,2,00242,India
392039,2023-11-05,1002,Mascara,200,400,200,2,00056,India
392039,2023-11-05,1007,Eyeshadow,200,400,200,2,00056,India
392039,2023-11-05,1005,Nail Polish,50,100,50,2,00056,India
392039,2023-11-05,1001,Lipstick,150,300,150,2,00056,India
259201,2023-11-05,1002,Mascara,200,400,200,2,00122,India
259201,2023-11-05,1008,Makeup Remover,80,160,80,2,00122,India
441208,2023-11-05,1012,Body Lotion,200,400,200,2,00154,India
441208,2023-11-05,1003,Foundation,300,600,300,2,00154,India
240235,2023-11-05,1001,Lipstick,150,300,150,2,00385,India
240235,2023-11-05,1007,Eyeshadow,200,400,200,2,00385,India
240235,2023-11-05,1005,Nail Polish,50,100,50,2,00385,India
240235,2023-11-05,1004,Eyeliner,100,200,100,2,00385,India
486043,2023-11-05,1008,Makeup Remover,80,160,80,2,00041,India
486043,2023-11-05,1003,Foundation,300,600,300,2,00041,India
486043,2023-11-05,1006,Blush,150,300,150,2,00041,India
486043,2023-11-05,1004,Eyeliner,100,200,100,2,00041,India
409008,2023-11-05,1002,Mascara,200,400,200,2,00180,India
409008,2023-11-05,1009,Moisturizer,250,500,250,2,00180,India
409008,2023-11-05,1005,Nail Polish,50,100,50,2,00180,India
552803,2023-11-05,1007,Eyeshadow,200,400,200,2,00183,India
803216,2023-11-05,1007,Eyeshadow,200,400,200,2,00067,India
803216,2023-11-05,1008,Makeup Remover,80,160,80,2,00067,India
803216,2023-11-05,1005,Nail Polish,50,100,50,2,00067,India
110126,2023-11-05,1003,Foundation,300,600,300,2,00387,India
110126,2023-11-05,1006,Blush,150,300,150,2,00387,India
110126,2023-11-05,1001,Lipstick,150,300,150,2,00387,India
272241,2023-11-05,1003,Foundation,300,600,300,2,00419,India
272241,2023-11-05,1012,Body Lotion,200,400,200,2,00419,India
324006,2023-11-05,1003,Foundation,300,600,300,2,00336,India
324006,2023-11-05,1012,Body Lotion,200,400,200,2,00336,India
991963,2023-11-05,1004,Eyeliner,100,200,100,2,00129,India
991963,2023-11-05,1003,Foundation,300,600,300,2,00129,India
991963,2023-11-05,1007,Eyeshadow,200,400,200,2,00129,India
281136,2023-11-05,1008,Makeup Remover,80,160,80,2,00088,India
281136,2023-11-05,1006,Blush,150,300,150,2,00088,India
281136,2023-11-05,1003,Foundation,300,600,300,2,00088,India
904788,2023-11-05,1003,Foundation,300,600,300,2,00438,India
904788,2023-11-05,1006,Blush,150,300,150,2,00438,India
904788,2023-11-05,1001,Lipstick,150,300,150,2,00438,India
382456,2023-11-05,1003,Foundation,300,600,300,2,00091,India
896738,2023-11-05,1005,Nail Polish,50,100,50,2,00182,India
927472,2023-11-06,1007,Eyeshadow,200,400,200,2,00006,India
926624,2023-11-06,1009,Moisturizer,250,500,250,2,00185,India
926624,2023-11-06,1006,Blush,150,300,150,2,00185,India
926624,2023-11-06,1012,Body Lotion,200,400,200,2,00185,India
926624,2023-11-06,1007,Eyeshadow,200,400,200,2,00185,India
667828,2023-11-06,1008,Makeup Remover,80,160,80,2,00237,India
406362,2023-11-06,1001,Lipstick,150,300,150,2,00353,India
406362,2023-11-06,1002,Mascara,200,400,200,2,00353,India
406362,2023-11-06,1006,Blush,150,300,150,2,00353,India
621354,2023-11-06,1009,Moisturizer,250,500,250,2,00121,India
134364,2023-11-06,1006,Blush,150,300,150,2,00057,India
134364,2023-11-06,1004,Eyeliner,100,200,100,2,00057,India
134364,2023-11-06,1009,Moisturizer,250,500,250,2,00057,India
413027,2023-11-06,1001,Lipstick,150,300,150,2,00405,India
762430,2023-11-06,1008,Makeup Remover,80,160,80,2,00269,India
723760,2023-11-06,1008,Makeup Remover,80,160,80,2,00293,India
333588,2023-11-06,1003,Foundation,300,600,300,2,00205,India
333588,2023-11-06,1007,Eyeshadow,200,400,200,2,00205,India
595463,2023-11-06,1012,Body Lotion,200,400,200,2,00375,India
595463,2023-11-06,1002,Mascara,200,400,200,2,00375,India
595463,2023-11-06,1001,Lipstick,150,300,150,2,00375,India
595463,2023-11-06,1003,Foundation,300,600,300,2,00375,India
460085,2023-11-06,1008,Makeup Remover,80,160,80,2,00199,India
460085,2023-11-06,1005,Nail Polish,50,100,50,2,00199,India
554662,2023-11-06,1001,Lipstick,150,300,150,2,00006,India
554662,2023-11-06,1003,Foundation,300,600,300,2,00006,India
765965,2023-11-06,1009,Moisturizer,250,500,250,2,00334,India
765965,2023-11-06,1001,Lipstick,150,300,150,2,00334,India
765965,2023-11-06,1012,Body Lotion,200,400,200,2,00334,India
765965,2023-11-06,1003,Foundation,300,600,300,2,00334,India
690676,2023-11-06,1006,Blush,150,300,150,2,00173,India
703595,2023-11-06,1003,Foundation,300,600,300,2,00232,India
703595,2023-11-06,1002,Mascara,200,400,200,2,00232,India
909521,2023-11-06,1006,Blush,150,300,150,2,00245,India
909521,2023-11-06,1008,Makeup Remover,80,160,80,2,00245,India
909521,2023-11-06,1004,Eyeliner,100,200,100,2,00245,India
909521,2023-11-06,1012,Body Lotion,200,400,200,2,00245,India
685561,2023-11-06,1001,Lipstick,150,300,150,2,00051,India
685561,2023-11-06,1006,Blush,150,300,150,2,00051,India
243173,2023-11-06,1005,Nail Polish,50,100,50,2,00260,India
243173,2023-11-06,1007,Eyeshadow,200,400,200,2,00260,India
640807,2023-11-06,1002,Mascara,200,400,200,2,00026,India
640807,2023-11-06,1006,Blush,150,300,150,2,00026,India
876614,2023-11-06,1002,Mascara,200,400,200,2,00465,India
235597,2023-11-06,1007,Eyeshadow,200,400,200,2,00415,India
235597,2023-11-06,1012,Body Lotion,200,400,200,2,00415,India
946973,2023-11-06,1009,Moisturizer,250,500,250,2,00367,India
946973,2023-11-06,1005,Nail Polish,50,100,50,2,00367,India
946973,2023-11-06,1003,Foundation,300,600,300,2,00367,India
946973,2023-11-06,1008,Makeup Remover,80,160,80,2,00367,India
162571,2023-11-06,1004,Eyeliner,100,200,100,2,00429,India
162571,2023-11-06,1003,Foundation,300,600,300,2,00429,India
162571,2023-11-06,1012,Body Lotion,200,400,200,2,00429,India
850781,2023-11-06,1004,Eyeliner,100,200,100,2,00498,India
850781,2023-11-06,1006,Blush,150,300,150,2,00498,India
850781,2023-11-06,1007,Eyeshadow,200,400,200,2,00498,India
883662,2023-11-06,1004,Eyeliner,100,200,100,2,00019,India
883662,2023-11-06,1009,Moisturizer,250,500,250,2,00019,India
681882,2023-11-06,1002,Mascara,200,400,200,2,00097,India
681882,2023-11-06,1006,Blush,150,300,150,2,00097,India
681882,2023-11-06,1004,Eyeliner,100,200,100,2,00097,India
681882,2023-11-06,1012,Body Lotion,200,400,200,2,00097,India
835008,2023-11-06,1005,Nail Polish,50,100,50,2,00342,India
835008,2023-11-06,1002,Mascara,200,400,200,2,00342,India
580327,2023-11-06,1001,Lipstick,150,300,150,2,00307,India
580327,2023-11-06,1004,Eyeliner,100,200,100,2,00307,India
580327,2023-11-06,1002,Mascara,200,400,200,2,00307,India
834701,2023-11-06,1002,Mascara,200,400,200,2,00232,India
834701,2023-11-06,1003,Foundation,300,600,300,2,00232,India
864117,2023-11-06,1003,Foundation,300,600,300,2,00249,India
864117,2023-11-06,1008,Makeup Remover,80,160,80,2,00249,India
700139,2023-11-06,1012,Body Lotion,200,400,200,2,00080,India
700139,2023-11-06,1006,Blush,150,300,150,2,00080,India
456831,2023-11-06,1001,Lipstick,150,300,150,2,00032,India
690603,2023-11-06,1006,Blush,150,300,150,2,00147,India
690603,2023-11-06,1002,Mascara,200,400,200,2,00147,India
690603,2023-11-06,1005,Nail Polish,50,100,50,2,00147,India
690603,2023-11-06,1008,Makeup Remover,80,160,80,2,00147,India
690603,2023-11-06,1001,Lipstick,150,300,150,2,00147,India
887418,2023-11-06,1002,Mascara,200,400,200,2,00336,India
887418,2023-11-06,1005,Nail Polish,50,100,50,2,00336,India
887418,2023-11-06,1007,Eyeshadow,200,400,200,2,00336,India
443480,2023-11-06,1001,Lipstick,150,300,150,2,00008,India
443480,2023-11-06,1009,Moisturizer,250,500,250,2,00008,India
443480,2023-11-06,1006,Blush,150,300,150,2,00008,India
859826,2023-11-06,1005,Nail Polish,50,100,50,2,00092,India
859826,2023-11-06,1008,Makeup Remover,80,160,80,2,00092,India
859826,2023-11-06,1004,Eyeliner,100,200,100,2,00092,India
485516,2023-11-06,1009,Moisturizer,250,500,250,2,00329,India
593080,2023-11-06,1002,Mascara,200,400,200,2,00228,India
408238,2023-11-06,1007,Eyeshadow,200,400,200,2,00384,India
408238,2023-11-06,1008,Makeup Remover,80,160,80,2,00384,India
408238,2023-11-06,1002,Mascara,200,400,200,2,00384,India
568762,2023-11-06,1004,Eyeliner,100,200,100,2,00479,India
816542,2023-11-06,1006,Blush,150,300,150,2,00188,India
816542,2023-11-06,1002,Mascara,200,400,200,2,00188,India
816542,2023-11-06,1008,Makeup Remover,80,160,80,2,00188,India
816542,2023-11-06,1009,Moisturizer,250,500,250,2,00188,India
621783,2023-11-07,1001,Lipstick,150,300,150,2,00079,India
621783,2023-11-07,1004,Eyeliner,100,200,100,2,00079,India
621783,2023-11-07,1012,Body Lotion,200,400,200,2,00079,India
304873,2023-11-07,1009,Moisturizer,250,500,250,2,00173,India
304873,2023-11-07,1005,Nail Polish,50,100,50,2,00173,India
304873,2023-11-07,1006,Blush,150,300,150,2,00173,India
304873,2023-11-07,1001,Lipstick,150,300,150,2,00173,India
403838,2023-11-07,1009,Moisturizer,250,500,250,2,00008,India
403838,2023-11-07,1005,Nail Polish,50,100,50,2,00008,India
403838,2023-11-07,1003,Foundation,300,600,300,2,00008,India
403838,2023-11-07,1002,Mascara,200,400,200,2,00008,India
403838,2023-11-07,1006,Blush,150,300,150,2,00008,India
616076,2023-11-07,1001,Lipstick,150,300,150,2,00159,India
616076,2023-11-07,1002,Mascara,200,400,200,2,00159,India
991975,2023-11-07,1004,Eyeliner,100,200,100,2,00192,India
991975,2023-11-07,1006,Blush,150,300,150,2,00192,India
991975,2023-11-07,1008,Makeup Remover,80,160,80,2,00192,India
756121,2023-11-07,1001,Lipstick,150,300,150,2,00006,India
756121,2023-11-07,1002,Mascara,200,400,200,2,00006,India
756121,2023-11-07,1006,Blush,150,300,150,2,00006,India
313319,2023-11-07,1007,Eyeshadow,200,400,200,2,00122,India
313319,2023-11-07,1005,Nail Polish,50,100,50,2,00122,India
313319,2023-11-07,1003,Foundation,300,600,300,2,00122,India
874651,2023-11-07,1002,Mascara,200,400,200,2,00114,India
874651,2023-11-07,1006,Blush,150,300,150,2,00114,India
874651,2023-11-07,1009,Moisturizer,250,500,250,2,00114,India
160192,2023-11-07,1006,Blush,150,300,150,2,00238,India
930106,2023-11-07,1012,Body Lotion,200,400,200,2,00029,India
798308,2023-11-07,1004,Eyeliner,100,200,100,2,00290,India
798308,2023-11-07,1012,Body Lotion,200,400,200,2,00290,India
798308,2023-11-07,1001,Lipstick,150,300,150,2,00290,India
514975,2023-11-07,1001,Lipstick,150,300,150,2,00246,India
514975,2023-11-07,1004,Eyeliner,100,200,100,2,00246,India
514975,2023-11-07,1006,Blush,150,300,150,2,00246,India
507131,2023-11-07,1001,Lipstick,150,300,150,2,00148,India
507131,2023-11-07,1008,Makeup Remover,80,160,80,2,00148,India
741107,2023-11-07,1002,Mascara,200,400,200,2,00131,India
970186,2023-11-07,1003,Foundation,300,600,300,2,00200,India
706877,2023-11-07,1006,Blush,150,300,150,2,00345,India
982637,2023-11-07,1005,Nail Polish,50,100,50,2,00169,India
982637,2023-11-07,1002,Mascara,200,400,200,2,00169,India
982637,2023-11-07,1006,Blush,150,300,150,2,00169,India
807270,2023-11-07,1004,Eyeliner,100,200,100,2,00473,India
190787,2023-11-07,1008,Makeup Remover,80,160,80,2,00239,India
367775,2023-11-07,1003,Foundation,300,600,300,2,00321,India
367775,2023-11-07,1007,Eyeshadow,200,400,200,2,00321,India
734165,2023-11-07,1007,Eyeshadow,200,400,200,2,00165,India
734165,2023-11-07,1006,Blush,150,300,150,2,00165,India
734165,2023-11-07,1004,Eyeliner,100,200,100,2,00165,India
734165,2023-11-07,1005,Nail Polish,50,100,50,2,00165,India
734165,2023-11-07,1008,Makeup Remover,80,160,80,2,00165,India
885230,2023-11-07,1004,Eyeliner,100,200,100,2,00045,India
885230,2023-11-07,1008,Makeup Remover,80,160,80,2,00045,India
885230,2023-11-07,1003,Foundation,300,600,300,2,00045,India
885230,2023-11-07,1009,Moisturizer,250,500,250,2,00045,India
677336,2023-11-07,1003,Foundation,300,600,300,2,00425,India
223962,2023-11-07,1003,Foundation,300,600,300,2,00280,India
223962,2023-11-07,1001,Lipstick,150,300,150,2,00280,India
616007,2023-11-07,1002,Mascara,200,400,200,2,00201,India
616007,2023-11-07,1004,Eyeliner,100,200,100,2,00201,India
616007,2023-11-07,1008,Makeup Remover,80,160,80,2,00201,India
489204,2023-11-07,1001,Lipstick,150,300,150,2,00090,India
489204,2023-11-07,1004,Eyeliner,100,200,100,2,00090,India
489204,2023-11-07,1009,Moisturizer,250,500,250,2,00090,India
489204,2023-11-07,1002,Mascara,200,400,200,2,00090,India
125029,2023-11-07,1003,Foundation,300,600,300,2,00470,India
125029,2023-11-07,1007,Eyeshadow,200,400,200,2,00470,India
125029,2023-11-07,1001,Lipstick,150,300,150,2,00470,India
857785,2023-11-07,1009,Moisturizer,250,500,250,2,00045,India
857785,2023-11-07,1006,Blush,150,300,150,2,00045,India
857785,2023-11-07,1004,Eyeliner,100,200,100,2,00045,India
559365,2023-11-07,1008,Makeup Remover,80,160,80,2,00284,India
559365,2023-11-07,1001,Lipstick,150,300,150,2,00284,India
559365,2023-11-07,1005,Nail Polish,50,100,50,2,00284,India
696943,2023-11-07,1008,Makeup Remover,80,160,80,2,00413,India
696943,2023-11-07,1003,Foundation,300,600,300,2,00413,India
696943,2023-11-07,1009,Moisturizer,250,500,250,2,00413,India
853771,2023-11-07,1003,Foundation,300,600,300,2,00442,India
614125,2023-11-07,1001,Lipstick,150,300,150,2,00407,India
614125,2023-11-07,1003,Foundation,300,600,300,2,00407,India
614125,2023-11-07,1005,Nail Polish,50,100,50,2,00407,India
148580,2023-11-07,1005,Nail Polish,50,100,50,2,00395,India
148580,2023-11-07,1007,Eyeshadow,200,400,200,2,00395,India
473348,2023-11-07,1002,Mascara,200,400,200,2,00162,India
473348,2023-11-07,1003,Foundation,300,600,300,2,00162,India
473348,2023-11-07,1004,Eyeliner,100,200,100,2,00162,India
473348,2023-11-07,1006,Blush,150,300,150,2,00162,India
158618,2023-11-07,1003,Foundation,300,600,300,2,00451,India
158618,2023-11-07,1006,Blush,150,300,150,2,00451,India
158618,2023-11-07,1007,Eyeshadow,200,400,200,2,00451,India
158618,2023-11-07,1012,Body Lotion,200,400,200,2,00451,India
189333,2023-11-07,1009,Moisturizer,250,500,250,2,00019,India
189333,2023-11-07,1004,Eyeliner,100,200,100,2,00019,India
314869,2023-11-07,1003,Foundation,300,600,300,2,00367,India
314869,2023-11-07,1005,Nail Polish,50,100,50,2,00367,India
314869,2023-11-07,1006,Blush,150,300,150,2,00367,India
115759,2023-11-07,1002,Mascara,200,400,200,2,00436,India
115759,2023-11-07,1001,Lipstick,150,300,150,2,00436,India
675135,2023-11-07,1012,Body Lotion,200,400,200,2,00122,India
675135,2023-11-07,1004,Eyeliner,100,200,100,2,00122,India
793287,2023-11-08,1012,Body Lotion,200,400,200,2,00289,India
275962,2023-11-08,1002,Mascara,200,400,200,2,00036,India
275962,2023-11-08,1001,Lipstick,150,300,150,2,00036,India
405742,2023-11-08,1002,Mascara,200,400,200,2,00487,India
405742,2023-11-08,1008,Makeup Remover,80,160,80,2,00487,India
405742,2023-11-08,1005,Nail Polish,50,100,50,2,00487,India
597378,2023-11-08,1007,Eyeshadow,200,400,200,2,00150,India
597378,2023-11-08,1005,Nail Polish,50,100,50,2,00150,India
313221,2023-11-08,1004,Eyeliner,100,200,100,2,00460,India
267034,2023-11-08,1007,Eyeshadow,200,400,200,2,00303,India
865005,2023-11-08,1007,Eyeshadow,200,400,200,2,00481,India
865005,2023-11-08,1001,Lipstick,150,300,150,2,00481,India
865005,2023-11-08,1005,Nail Polish,50,100,50,2,00481,India
303917,2023-11-08,1005,Nail Polish,50,100,50,2,00489,India
303917,2023-11-08,1002,Mascara,200,400,200,2,00489,India
303917,2023-11-08,1008,Makeup Remover,80,160,80,2,00489,India
303917,2023-11-08,1006,Blush,150,300,150,2,00489,India
393880,2023-11-08,1012,Body Lotion,200,400,200,2,00417,India
393880,2023-11-08,1001,Lipstick,150,300,150,2,00417,India
393880,2023-11-08,1004,Eyeliner,100,200,100,2,00417,India
782728,2023-11-08,1005,Nail Polish,50,100,50,2,00198,India
782728,2023-11-08,1001,Lipstick,150,300,150,2,00198,India
782728,2023-11-08,1008,Makeup Remover,80,160,80,2,00198,India
146587,2023-11-08,1005,Nail Polish,50,100,50,2,00264,India
774076,2023-11-08,1006,Blush,150,300,150,2,00100,India
761020,2023-11-08,1002,Mascara,200,400,200,2,00047,India
761020,2023-11-08,1006,Blush,150,300,150,2,00047,India
761020,2023-11-08,1003,Foundation,300,600,300,2,00047,India
549825,2023-11-08,1008,Makeup Remover,80,160,80,2,00134,India
549825,2023-11-08,1003,Foundation,300,600,300,2,00134,India
549825,2023-11-08,1001,Lipstick,150,300,150,2,00134,India
549825,2023-11-08,1006,Blush,150,300,150,2,00134,India
579052,2023-11-08,1005,Nail Polish,50,100,50,2,00234,India
579052,2023-11-08,1008,Makeup Remover,80,160,80,2,00234,India
579052,2023-11-08,1007,Eyeshadow,200,400,200,2,00234,India
592446,2023-11-08,1001,Lipstick,150,300,150,2,00265,India
592446,2023-11-08,1004,Eyeliner,100,200,100,2,00265,India
592446,2023-11-08,1005,Nail Polish,50,100,50,2,00265,India
546669,2023-11-08,1006,Blush,150,300,150,2,00400,India
546669,2023-11-08,1005,Nail Polish,50,100,50,2,00400,India
546669,2023-11-08,1003,Foundation,300,600,300,2,00400,India
546669,2023-11-08,1002,Mascara,200,400,200,2,00400,India
624369,2023-11-08,1002,Mascara,200,400,200,2,00495,India
413083,2023-11-08,1005,Nail Polish,50,100,50,2,00118,India
413083,2023-11-08,1003,Foundation,300,600,300,2,00118,India
413083,2023-11-08,1002,Mascara,200,400,200,2,00118,India
413083,2023-11-08,1004,Eyeliner,100,200,100,2,00118,India
209926,2023-11-08,1003,Foundation,300,600,300,2,00430,India
209926,2023-11-08,1007,Eyeshadow,200,400,200,2,00430,India
372487,2023-11-08,1006,Blush,150,300,150,2,00190,India
372487,2023-11-08,1007,Eyeshadow,200,400,200,2,00190,India
658392,2023-11-08,1003,Foundation,300,600,300,2,00239,India
658392,2023-11-08,1007,Eyeshadow,200,400,200,2,00239,India
658392,2023-11-08,1008,Makeup Remover,80,160,80,2,00239,India
860352,2023-11-08,1007,Eyeshadow,200,400,200,2,00066,India
860352,2023-11-08,1004,Eyeliner,100,200,100,2,00066,India
860352,2023-11-08,1003,Foundation,300,600,300,2,00066,India
967270,2023-11-08,1002,Mascara,200,400,200,2,00029,India
967270,2023-11-08,1006,Blush,150,300,150,2,00029,India
967270,2023-11-08,1012,Body Lotion,200,400,200,2,00029,India
967270,2023-11-08,1009,Moisturizer,250,500,250,2,00029,India
146768,2023-11-08,1007,Eyeshadow,200,400,200,2,00312,India
146768,2023-11-08,1006,Blush,150,300,150,2,00312,India
146768,2023-11-08,1003,Foundation,300,600,300,2,00312,India
146768,2023-11-08,1009,Moisturizer,250,500,250,2,00312,India
514948,2023-11-08,1009,Moisturizer,250,500,250,2,00327,India
450390,2023-11-08,1012,Body Lotion,200,400,200,2,00239,India
450390,2023-11-08,1001,Lipstick,150,300,150,2,00239,India
450390,2023-11-08,1009,Moisturizer,250,500,250,2,00239,India
663433,2023-11-08,1007,Eyeshadow,200,400,200,2,00226,India
663433,2023-11-08,1002,Mascara,200,400,200,2,00226,India
663433,2023-11-08,1009,Moisturizer,250,500,250,2,00226,India
398668,2023-11-08,1004,Eyeliner,100,200,100,2,00445,India
717132,2023-11-08,1006,Blush,150,300,150,2,00349,India
748347,2023-11-09,1008,Makeup Remover,80,160,80,2,00472,India
393082,2023-11-09,1002,Mascara,200,400,200,2,00085,India
393082,2023-11-09,1012,Body Lotion,200,400,200,2,00085,India
393082,2023-11-09,1005,Nail Polish,50,100,50,2,00085,India
278538,2023-11-09,1003,Foundation,300,600,300,2,00466,India
278538,2023-11-09,1012,Body Lotion,200,400,200,2,00466,India
278538,2023-11-09,1001,Lipstick,150,300,150,2,00466,India
622777,2023-11-09,1003,Foundation,300,600,300,2,00383,India
622777,2023-11-09,1009,Moisturizer,250,500,250,2,00383,India
782295,2023-11-09,1004,Eyeliner,100,200,100,2,00158,India
720091,2023-11-09,1012,Body Lotion,200,400,200,2,00274,India
720091,2023-11-09,1007,Eyeshadow,200,400,200,2,00274,India
377841,2023-11-09,1003,Foundation,300,600,300,2,00494,India
641180,2023-11-09,1005,Nail Polish,50,100,50,2,00356,India
641180,2023-11-09,1009,Moisturizer,250,500,250,2,00356,India
641180,2023-11-09,1001,Lipstick,150,300,150,2,00356,India
618457,2023-11-09,1006,Blush,150,300,150,2,00356,India
618457,2023-11-09,1001,Lipstick,150,300,150,2,00356,India
425091,2023-11-09,1008,Makeup Remover,80,160,80,2,00099,India
425091,2023-11-09,1009,Moisturizer,250,500,250,2,00099,India
425091,2023-11-09,1001,Lipstick,150,300,150,2,00099,India
425091,2023-11-09,1006,Blush,150,300,150,2,00099,India
645801,2023-11-09,1004,Eyeliner,100,200,100,2,00500,India
645801,2023-11-09,1006,Blush,150,300,150,2,00500,India
847670,2023-11-09,1008,Makeup Remover,80,160,80,2,00159,India
941545,2023-11-09,1002,Mascara,200,400,200,2,00279,India
941545,2023-11-09,1007,Eyeshadow,200,400,200,2,00279,India
941545,2023-11-09,1004,Eyeliner,100,200,100,2,00279,India
983174,2023-11-09,1003,Foundation,300,600,300,2,00044,India
983174,2023-11-09,1012,Body Lotion,200,400,200,2,00044,India
983174,2023-11-09,1001,Lipstick,150,300,150,2,00044,India
983174,2023-11-09,1002,Mascara,200,400,200,2,00044,India
434396,2023-11-09,1012,Body Lotion,200,400,200,2,00100,India
434396,2023-11-09,1009,Moisturizer,250,500,250,2,00100,India
434396,2023-11-09,1007,Eyeshadow,200,400,200,2,00100,India
434396,2023-11-09,1001,Lipstick,150,300,150,2,00100,India
191416,2023-11-09,1007,Eyeshadow,200,400,200,2,00056,India
273373,2023-11-09,1003,Foundation,300,600,300,2,00162,India
273373,2023-11-09,1001,Lipstick,150,300,150,2,00162,India
273373,2023-11-09,1002,Mascara,200,400,200,2,00162,India
788889,2023-11-09,1012,Body Lotion,200,400,200,2,00415,India
788889,2023-11-09,1009,Moisturizer,250,500,250,2,00415,India
784315,2023-11-09,1003,Foundation,300,600,300,2,00345,India
784315,2023-11-09,1006,Blush,150,300,150,2,00345,India
784315,2023-11-09,1012,Body Lotion,200,400,200,2,00345,India
784315,2023-11-09,1007,Eyeshadow,200,400,200,2,00345,India
748864,2023-11-09,1012,Body Lotion,200,400,200,2,00023,India
748864,2023-11-09,1007,Eyeshadow,200,400,200,2,00023,India
833770,2023-11-09,1001,Lipstick,150,300,150,2,00380,India
348966,2023-11-09,1001,Lipstick,150,300,150,2,00341,India
988070,2023-11-09,1002,Mascara,200,400,200,2,00050,India
710661,2023-11-09,1005,Nail Polish,50,100,50,2,00362,India
710661,2023-11-09,1004,Eyeliner,100,200,100,2,00362,India
710661,2023-11-09,1007,Eyeshadow,200,400,200,2,00362,India
831599,2023-11-09,1008,Makeup Remover,80,160,80,2,00372,India
831599,2023-11-09,1001,Lipstick,150,300,150,2,00372,India
831599,2023-11-09,1002,Mascara,200,400,200,2,00372,India
831599,2023-11-09,1007,Eyeshadow,200,400,200,2,00372,India
831599,2023-11-09,1012,Body Lotion,200,400,200,2,00372,India
355128,2023-11-09,1004,Eyeliner,100,200,100,2,00219,India
355128,2023-11-09,1002,Mascara,200,400,200,2,00219,India
966234,2023-11-09,1009,Moisturizer,250,500,250,2,00492,India
966234,2023-11-09,1005,Nail Polish,50,100,50,2,00492,India
966234,2023-11-09,1007,Eyeshadow,200,400,200,2,00492,India
230198,2023-11-09,1002,Mascara,200,400,200,2,00476,India
230198,2023-11-09,1001,Lipstick,150,300,150,2,00476,India
439215,2023-11-09,1012,Body Lotion,200,400,200,2,00029,India
120674,2023-11-09,1007,Eyeshadow,200,400,200,2,00273,India
120674,2023-11-09,1003,Foundation,300,600,300,2,00273,India
120674,2023-11-09,1008,Makeup Remover,80,160,80,2,00273,India
120674,2023-11-09,1005,Nail Polish,50,100,50,2,00273,India
622237,2023-11-09,1001,Lipstick,150,300,150,2,00150,India
783642,2023-11-09,1001,Lipstick,150,300,150,2,00238,India
783642,2023-11-09,1007,Eyeshadow,200,400,200,2,00238,India
783642,2023-11-09,1009,Moisturizer,250,500,250,2,00238,India
783642,2023-11-09,1004,Eyeliner,100,200,100,2,00238,India
217965,2023-11-10,1006,Blush,150,300,150,2,00058,India
217965,2023-11-10,1005,Nail Polish,50,100,50,2,00058,India
217965,2023-11-10,1009,Moisturizer,250,500,250,2,00058,India
369710,2023-11-10,1008,Makeup Remover,80,160,80,2,00475,India
369710,2023-11-10,1006,Blush,150,300,150,2,00475,India
813466,2023-11-10,1006,Blush,150,300,150,2,00299,India
813466,2023-11-10,1004,Eyeliner,100,200,100,2,00299,India
825360,2023-11-10,1006,Blush,150,300,150,2,00374,India
825360,2023-11-10,1001,Lipstick,150,300,150,2,00374,India
825360,2023-11-10,1004,Eyeliner,100,200,100,2,00374,India
825360,2023-11-10,1007,Eyeshadow,200,400,200,2,00374,India
542560,2023-11-10,1009,Moisturizer,250,500,250,2,00059,India
542560,2023-11-10,1007,Eyeshadow,200,400,200,2,00059,India
542560,2023-11-10,1012,Body Lotion,200,400,200,2,00059,India
542560,2023-11-10,1006,Blush,150,300,150,2,00059,India
542560,2023-11-10,1004,Eyeliner,100,200,100,2,00059,India
877318,2023-11-10,1004,Eyeliner,100,200,100,2,00231,India
877318,2023-11-10,1009,Moisturizer,250,500,250,2,00231,India
877318,2023-11-10,1005,Nail Polish,50,100,50,2,00231,India
877318,2023-11-10,1008,Makeup Remover,80,160,80,2,00231,India
224566,2023-11-10,1007,Eyeshadow,200,400,200,2,00083,India
224566,2023-11-10,1012,Body Lotion,200,400,200,2,00083,India
504874,2023-11-10,1007,Eyeshadow,200,400,200,2,00469,India
956458,2023-11-10,1002,Mascara,200,400,200,2,00258,India
956458,2023-11-10,1003,Foundation,300,600,300,2,00258,India
956458,2023-11-10,1006,Blush,150,300,150,2,00258,India
956458,2023-11-10,1012,Body Lotion,200,400,200,2,00258,India
497251,2023-11-10,1006,Blush,150,300,150,2,00054,India
419555,2023-11-10,1005,Nail Polish,50,100,50,2,00261,India
392088,2023-11-10,1009,Moisturizer,250,500,250,2,00481,India
392088,2023-11-10,1004,Eyeliner,100,200,100,2,00481,India
392088,2023-11-10,1003,Foundation,300,600,300,2,00481,India
520509,2023-11-10,1005,Nail Polish,50,100,50,2,00223,India
520509,2023-11-10,1002,Mascara,200,400,200,2,00223,India
520509,2023-11-10,1012,Body Lotion,200,400,200,2,00223,India
520509,2023-11-10,1004,Eyeliner,100,200,100,2,00223,India
520509,2023-11-10,1008,Makeup Remover,80,160,80,2,00223,India
904429,2023-11-10,1001,Lipstick,150,300,150,2,00213,India
904429,2023-11-10,1004,Eyeliner,100,200,100,2,00213,India
643400,2023-11-10,1004,Eyeliner,100,200,100,2,00072,India
643400,2023-11-10,1001,Lipstick,150,300,150,2,00072,India
750225,2023-11-10,1012,Body Lotion,200,400,200,2,00288,India
750225,2023-11-10,1009,Moisturizer,250,500,250,2,00288,India
750225,2023-11-10,1002,Mascara,200,400,200,2,00288,India
750225,2023-11-10,1003,Foundation,300,600,300,2,00288,India
750225,2023-11-10,1008,Makeup Remover,80,160,80,2,00288,India
190743,2023-11-10,1006,Blush,150,300,150,2,00227,India
126393,2023-11-10,1003,Foundation,300,600,300,2,00270,India
995497,2023-11-10,1012,Body Lotion,200,400,200,2,00228,India
411376,2023-11-10,1009,Moisturizer,250,500,250,2,00412,India
411376,2023-11-10,1005,Nail Polish,50,100,50,2,00412,India
411376,2023-11-10,1001,Lipstick,150,300,150,2,00412,India
815726,2023-11-10,1002,Mascara,200,400,200,2,00041,India
815726,2023-11-10,1001,Lipstick,150,300,150,2,00041,India
961215,2023-11-10,1008,Makeup Remover,80,160,80,2,00478,India
961215,2023-11-10,1002,Mascara,200,400,200,2,00478,India
595963,2023-11-10,1004,Eyeliner,100,200,100,2,00001,India
595963,2023-11-10,1005,Nail Polish,50,100,50,2,00001,India
595963,2023-11-10,1006,Blush,150,300,150,2,00001,India
595963,2023-11-10,1009,Moisturizer,250,500,250,2,00001,India
137732,2023-11-10,1002,Mascara,200,400,200,2,00313,India
137732,2023-11-10,1006,Blush,150,300,150,2,00313,India
137732,2023-11-10,1012,Body Lotion,200,400,200,2,00313,India
137732,2023-11-10,1009,Moisturizer,250,500,250,2,00313,India
137732,2023-11-10,1008,Makeup Remover,80,160,80,2,00313,India
592969,2023-11-10,1008,Makeup Remover,80,160,80,2,00207,India
592969,2023-11-10,1003,Foundation,300,600,300,2,00207,India
344131,2023-11-10,1009,Moisturizer,250,500,250,2,00277,India
344131,2023-11-10,1007,Eyeshadow,200,400,200,2,00277,India
344131,2023-11-10,1004,Eyeliner,100,200,100,2,00277,India
923176,2023-11-10,1006,Blush,150,300,150,2,00348,India
923176,2023-11-10,1009,Moisturizer,250,500,250,2,00348,India
923176,2023-11-10,1002,Mascara,200,400,200,2,00348,India
923176,2023-11-10,1007,Eyeshadow,200,400,200,2,00348,India
480753,2023-11-10,1008,Makeup Remover,80,160,80,2,00227,India
480753,2023-11-10,1003,Foundation,300,600,300,2,00227,India
480753,2023-11-10,1007,Eyeshadow,200,400,200,2,00227,India
929446,2023-11-10,1007,Eyeshadow,200,400,200,2,00153,India
929446,2023-11-10,1008,Makeup Remover,80,160,80,2,00153,India
929446,2023-11-10,1006,Blush,150,300,150,2,00153,India
929446,2023-11-10,1005,Nail Polish,50,100,50,2,00153,India
929446,2023-11-10,1001,Lipstick,150,300,150,2,00153,India
299467,2023-11-10,1007,Eyeshadow,200,400,200,2,00471,India
299467,2023-11-10,1004,Eyeliner,100,200,100,2,00471,India
299467,2023-11-10,1008,Makeup Remover,80,160,80,2,00471,India
768731,2023-11-10,1012,Body Lotion,200,400,200,2,00412,India
768731,2023-11-10,1001,Lipstick,150,300,150,2,00412,India
113580,2023-11-10,1001,Lipstick,150,300,150,2,00455,India
113580,2023-11-10,1005,Nail Polish,50,100,50,2,00455,India
113580,2023-11-10,1004,Eyeliner,100,200,100,2,00455,India
765250,2023-11-11,1005,Nail Polish,50,100,50,2,00111,India
765250,2023-11-11,1003,Foundation,300,600,300,2,00111,India
933308,2023-11-11,1003,Foundation,300,600,300,2,00370,India
933308,2023-11-11,1008,Makeup Remover,80,160,80,2,00370,India
197186,2023-11-11,1012,Body Lotion,200,400,200,2,00019,India
197186,2023-11-11,1001,Lipstick,150,300,150,2,00019,India
197186,2023-11-11,1005,Nail Polish,50,100,50,2,00019,India
508106,2023-11-11,1004,Eyeliner,100,200,100,2,00252,India
508106,2023-11-11,1002,Mascara,200,400,200,2,00252,India
508106,2023-11-11,1003,Foundation,300,600,300,2,00252,India
508106,2023-11-11,1006,Blush,150,300,150,2,00252,India
508106,2023-11-11,1008,Makeup Remover,80,160,80,2,00252,India
897566,2023-11-11,1005,Nail Polish,50,100,50,2,00103,India
897566,2023-11-11,1006,Blush,150,300,150,2,00103,India
897566,2023-11-11,1008,Makeup Remover,80,160,80,2,00103,India
468212,2023-11-11,1012,Body Lotion,200,400,200,2,00341,India
468212,2023-11-11,1009,Moisturizer,250,500,250,2,00341,India
518758,2023-11-11,1002,Mascara,200,400,200,2,00227,India
899579,2023-11-11,1012,Body Lotion,200,400,200,2,00297,India
899579,2023-11-11,1003,Foundation,300,600,300,2,00297,India
899579,2023-11-11,1005,Nail Polish,50,100,50,2,00297,India
281698,2023-11-11,1012,Body Lotion,200,400,200,2,00105,India
281698,2023-11-11,1004,Eyeliner,100,200,100,2,00105,India
281698,2023-11-11,1006,Blush,150,300,150,2,00105,India
909370,2023-11-11,1002,Mascara,200,400,200,2,00085,India
909370,2023-11-11,1012,Body Lotion,200,400,200,2,00085,India
909370,2023-11-11,1008,Makeup Remover,80,160,80,2,00085,India
928571,2023-11-11,1004,Eyeliner,100,200,100,2,00226,India
575585,2023-11-11,1006,Blush,150,300,150,2,00377,India
575585,2023-11-11,1004,Eyeliner,100,200,100,2,00377,India
119737,2023-11-11,1006,Blush,150,300,150,2,00318,India
368788,2023-11-11,1005,Nail Polish,50,100,50,2,00371,India
368788,2023-11-11,1006,Blush,150,300,150,2,00371,India
979175,2023-11-11,1006,Blush,150,300,150,2,00010,India
979175,2023-11-11,1012,Body Lotion,200,400,200,2,00010,India
780965,2023-11-11,1003,Foundation,300,600,300,2,00450,India
780965,2023-11-11,1004,Eyeliner,100,200,100,2,00450,India
780965,2023-11-11,1002,Mascara,200,400,200,2,00450,India
268805,2023-11-11,1007,Eyeshadow,200,400,200,2,00212,India
239227,2023-11-11,1006,Blush,150,300,150,2,00482,India
239227,2023-11-11,1005,Nail Polish,50,100,50,2,00482,India
806419,2023-11-11,1012,Body Lotion,200,400,200,2,00380,India
581068,2023-11-11,1012,Body Lotion,200,400,200,2,00440,India
581068,2023-11-11,1002,Mascara,200,400,200,2,00440,India
581068,2023-11-11,1004,Eyeliner,100,200,100,2,00440,India
581068,2023-11-11,1003,Foundation,300,600,300,2,00440,India
394121,2023-11-11,1009,Moisturizer,250,500,250,2,00140,India
901091,2023-11-11,1006,Blush,150,300,150,2,00071,India
901091,2023-11-11,1009,Moisturizer,250,500,250,2,00071,India
901091,2023-11-11,1005,Nail Polish,50,100,50,2,00071,India
901091,2023-11-11,1003,Foundation,300,600,300,2,00071,India
314840,2023-11-11,1008,Makeup Remover,80,160,80,2,00400,India
314840,2023-11-11,1012,Body Lotion,200,400,200,2,00400,India
314840,2023-11-11,1004,Eyeliner,100,200,100,2,00400,India
314840,2023-11-11,1009,Moisturizer,250,500,250,2,00400,India
309586,2023-11-11,1004,Eyeliner,100,200,100,2,00014,India
309586,2023-11-11,1005,Nail Polish,50,100,50,2,00014,India
844735,2023-11-11,1003,Foundation,300,600,300,2,00206,India
844735,2023-11-11,1004,Eyeliner,100,200,100,2,00206,India
956580,2023-11-11,1009,Moisturizer,250,500,250,2,00081,India
956580,2023-11-11,1007,Eyeshadow,200,400,200,2,00081,India
956580,2023-11-11,1002,Mascara,200,400,200,2,00081,India
956580,2023-11-11,1008,Makeup Remover,80,160,80,2,00081,India
610346,2023-11-11,1002,Mascara,200,400,200,2,00320,India
993951,2023-11-11,1009,Moisturizer,250,500,250,2,00168,India
993951,2023-11-11,1002,Mascara,200,400,200,2,00168,India
122206,2023-11-11,1006,Blush,150,300,150,2,00184,India
694713,2023-11-11,1003,Foundation,300,600,300,2,00265,India
899846,2023-11-11,1003,Foundation,300,600,300,2,00011,India
709382,2023-11-11,1009,Moisturizer,250,500,250,2,00384,India
709382,2023-11-11,1003,Foundation,300,600,300,2,00384,India
709382,2023-11-11,1007,Eyeshadow,200,400,200,2,00384,India
132563,2023-11-11,1009,Moisturizer,250,500,250,2,00261,India
132563,2023-11-11,1004,Eyeliner,100,200,100,2,00261,India
132563,2023-11-11,1003,Foundation,300,600,300,2,00261,India
529018,2023-11-11,1004,Eyeliner,100,200,100,2,00272,India
529018,2023-11-11,1003,Foundation,300,600,300,2,00272,India
529018,2023-11-11,1007,Eyeshadow,200,400,200,2,00272,India
182871,2023-11-11,1009,Moisturizer,250,500,250,2,00109,India
182871,2023-11-11,1003,Foundation,300,600,300,2,00109,India
182871,2023-11-11,1012,Body Lotion,200,400,200,2,00109,India
182871,2023-11-11,1002,Mascara,200,400,200,2,00109,India
182871,2023-11-11,1006,Blush,150,300,150,2,00109,India
202113,2023-11-11,1004,Eyeliner,100,200,100,2,00482,India
202113,2023-11-11,1007,Eyeshadow,200,400,200,2,00482,India
202113,2023-11-11,1003,Foundation,300,600,300,2,00482,India
202113,2023-11-11,1001,Lipstick,150,300,150,2,00482,India
299577,2023-11-11,1001,Lipstick,150,300,150,2,00092,India
605588,2023-11-11,1007,Eyeshadow,200,400,200,2,00042,India
605588,2023-11-11,1012,Body Lotion,200,400,200,2,00042,India
451326,2023-11-11,1012,Body Lotion,200,400,200,2,00223,India
451326,2023-11-11,1009,Moisturizer,250,500,250,2,00223,India
217157,2023-11-11,1004,Eyeliner,100,200,100,2,00421,India
217157,2023-11-11,1005,Nail Polish,50,100,50,2,00421,India
217157,2023-11-11,1001,Lipstick,150,300,150,2,00421,India
217157,2023-11-11,1002,Mascara,200,400,200,2,00421,India
582530,2023-11-11,1006,Blush,150,300,150,2,00228,India
582530,2023-11-11,1007,Eyeshadow,200,400,200,2,00228,India
582530,2023-11-11,1001,Lipstick,150,300,150,2,00228,India
582530,2023-11-11,1009,Moisturizer,250,500,250,2,00228,India
982643,2023-11-11,1008,Makeup Remover,80,160,80,2,00002,India
982643,2023-11-11,1007,Eyeshadow,200,400,200,2,00002,India
982643,2023-11-11,1005,Nail Polish,50,100,50,2,00002,India
982643,2023-11-11,1003,Foundation,300,600,300,2,00002,India
982643,2023-11-11,1006,Blush,150,300,150,2,00002,India
989051,2023-11-11,1007,Eyeshadow,200,400,200,2,00348,India
989051,2023-11-11,1001,Lipstick,150,300,150,2,00348,India
989051,2023-11-11,1012,Body Lotion,200,400,200,2,00348,India
618696,2023-11-12,1001,Lipstick,150,300,150,2,00042,India
618696,2023-11-12,1007,Eyeshadow,200,400,200,2,00042,India
618696,2023-11-12,1004,Eyeliner,100,200,100,2,00042,India
618696,2023-11-12,1005,Nail Polish,50,100,50,2,00042,India
857448,2023-11-12,1003,Foundation,300,600,300,2,00175,India
857448,2023-11-12,1006,Blush,150,300,150,2,00175,India
857448,2023-11-12,1004,Eyeliner,100,200,100,2,00175,India
631930,2023-11-12,1008,Makeup Remover,80,160,80,2,00485,India
631930,2023-11-12,1007,Eyeshadow,200,400,200,2,00485,India
631930,2023-11-12,1002,Mascara,200,400,200,2,00485,India
231053,2023-11-12,1012,Body Lotion,200,400,200,2,00438,India
231053,2023-11-12,1001,Lipstick,150,300,150,2,00438,India
231053,2023-11-12,1009,Moisturizer,250,500,250,2,00438,India
231053,2023-11-12,1002,Mascara,200,400,200,2,00438,India
743424,2023-11-12,1005,Nail Polish,50,100,50,2,00020,India
743424,2023-11-12,1012,Body Lotion,200,400,200,2,00020,India
743424,2023-11-12,1004,Eyeliner,100,200,100,2,00020,India
743424,2023-11-12,1001,Lipstick,150,300,150,2,00020,India
433992,2023-11-12,1012,Body Lotion,200,400,200,2,00399,India
170741,2023-11-12,1009,Moisturizer,250,500,250,2,00136,India
974096,2023-11-12,1007,Eyeshadow,200,400,200,2,00176,India
974096,2023-11-12,1012,Body Lotion,200,400,200,2,00176,India
974096,2023-11-12,1009,Moisturizer,250,500,250,2,00176,India
974096,2023-11-12,1006,Blush,150,300,150,2,00176,India
849176,2023-11-12,1006,Blush,150,300,150,2,00365,India
849176,2023-11-12,1002,Mascara,200,400,200,2,00365,India
849176,2023-11-12,1001,Lipstick,150,300,150,2,00365,India
849176,2023-11-12,1012,Body Lotion,200,400,200,2,00365,India
849176,2023-11-12,1009,Moisturizer,250,500,250,2,00365,India
359382,2023-11-12,1012,Body Lotion,200,400,200,2,00382,India
359382,2023-11-12,1004,Eyeliner,100,200,100,2,00382,India
359382,2023-11-12,1006,Blush,150,300,150,2,00382,India
391341,2023-11-12,1005,Nail Polish,50,100,50,2,00346,India
391341,2023-11-12,1008,Makeup Remover,80,160,80,2,00346,India
359837,2023-11-12,1004,Eyeliner,100,200,100,2,00076,India
359837,2023-11-12,1009,Moisturizer,250,500,250,2,00076,India
359837,2023-11-12,1007,Eyeshadow,200,400,200,2,00076,India
767760,2023-11-12,1003,Foundation,300,600,300,2,00064,India
767760,2023-11-12,1008,Makeup Remover,80,160,80,2,00064,India
745807,2023-11-12,1006,Blush,150,300,150,2,00452,India
745807,2023-11-12,1008,Makeup Remover,80,160,80,2,00452,India
908112,2023-11-12,1005,Nail Polish,50,100,50,2,00471,India
908112,2023-11-12,1009,Moisturizer,250,500,250,2,00471,India
908112,2023-11-12,1007,Eyeshadow,200,400,200,2,00471,India
908112,2023-11-12,1003,Foundation,300,600,300,2,00471,India
551091,2023-11-12,1006,Blush,150,300,150,2,00082,India
962086,2023-11-12,1002,Mascara,200,400,200,2,00163,India
551525,2023-11-12,1012,Body Lotion,200,400,200,2,00057,India
551525,2023-11-12,1009,Moisturizer,250,500,250,2,00057,India
551525,2023-11-12,1004,Eyeliner,100,200,100,2,00057,India
893802,2023-11-12,1007,Eyeshadow,200,400,200,2,00030,India
186289,2023-11-12,1007,Eyeshadow,200,400,200,2,00434,India
186289,2023-11-12,1012,Body Lotion,200,400,200,2,00434,India
875232,2023-11-12,1012,Body Lotion,200,400,200,2,00486,India
875232,2023-11-12,1001,Lipstick,150,300,150,2,00486,India
875232,2023-11-12,1004,Eyeliner,100,200,100,2,00486,India
875232,2023-11-12,1002,Mascara,200,400,200,2,00486,India
875232,2023-11-12,1003,Foundation,300,600,300,2,00486,India
172778,2023-11-12,1008,Makeup Remover,80,160,80,2,00170,India
499351,2023-11-12,1005,Nail Polish,50,100,50,2,00348,India
499351,2023-11-12,1012,Body Lotion,200,400,200,2,00348,India
499351,2023-11-12,1002,Mascara,200,400,200,2,00348,India
499351,2023-11-12,1007,Eyeshadow,200,400,200,2,00348,India
947525,2023-11-12,1009,Moisturizer,250,500,250,2,00371,India
947525,2023-11-12,1003,Foundation,300,600,300,2,00371,India
947525,2023-11-12,1002,Mascara,200,400,200,2,00371,India
947525,2023-11-12,1004,Eyeliner,100,200,100,2,00371,India
635541,2023-11-12,1012,Body Lotion,200,400,200,2,00211,India
635541,2023-11-12,1007,Eyeshadow,200,400,200,2,00211,India
635541,2023-11-12,1008,Makeup Remover,80,160,80,2,00211,India
671685,2023-11-12,1001,Lipstick,150,300,150,2,00263,India
671685,2023-11-12,1012,Body Lotion,200,400,200,2,00263,India
671685,2023-11-12,1007,Eyeshadow,200,400,200,2,00263,India
671685,2023-11-12,1009,Moisturizer,250,500,250,2,00263,India
206850,2023-11-12,1008,Makeup Remover,80,160,80,2,00363,India
432234,2023-11-12,1006,Blush,150,300,150,2,00295,India
432234,2023-11-12,1003,Foundation,300,600,300,2,00295,India
432234,2023-11-12,1004,Eyeliner,100,200,100,2,00295,India
895040,2023-11-12,1001,Lipstick,150,300,150,2,00310,India
895040,2023-11-12,1005,Nail Polish,50,100,50,2,00310,India
895040,2023-11-12,1003,Foundation,300,600,300,2,00310,India
595419,2023-11-12,1004,Eyeliner,100,200,100,2,00309,India
595419,2023-11-12,1012,Body Lotion,200,400,200,2,00309,India
595419,2023-11-12,1005,Nail Polish,50,100,50,2,00309,India
369005,2023-11-13,1002,Mascara,200,400,200,2,00251,India
369005,2023-11-13,1007,Eyeshadow,200,400,200,2,00251,India
369005,2023-11-13,1006,Blush,150,300,150,2,00251,India
369005,2023-11-13,1008,Makeup Remover,80,160,80,2,00251,India
528490,2023-11-13,1006,Blush,150,300,150,2,00367,India
528490,2023-11-13,1009,Moisturizer,250,500,250,2,00367,India
528490,2023-11-13,1007,Eyeshadow,200,400,200,2,00367,India
223745,2023-11-13,1006,Blush,150,300,150,2,00446,India
223745,2023-11-13,1007,Eyeshadow,200,400,200,2,00446,India
223745,2023-11-13,1005,Nail Polish,50,100,50,2,00446,India
575356,2023-11-13,1003,Foundation,300,600,300,2,00403,India
575356,2023-11-13,1002,Mascara,200,400,200,2,00403,India
575356,2023-11-13,1009,Moisturizer,250,500,250,2,00403,India
114815,2023-11-13,1003,Foundation,300,600,300,2,00282,India
114815,2023-11-13,1004,Eyeliner,100,200,100,2,00282,India
114815,2023-11-13,1005,Nail Polish,50,100,50,2,00282,India
939009,2023-11-13,1005,Nail Polish,50,100,50,2,00009,India
115128,2023-11-13,1004,Eyeliner,100,200,100,2,00457,India
115128,2023-11-13,1005,Nail Polish,50,100,50,2,00457,India
115128,2023-11-13,1001,Lipstick,150,300,150,2,00457,India
115128,2023-11-13,1008,Makeup Remover,80,160,80,2,00457,India
147470,2023-11-13,1001,Lipstick,150,300,150,2,00230,India
147470,2023-11-13,1009,Moisturizer,250,500,250,2,00230,India
147470,2023-11-13,1004,Eyeliner,100,200,100,2,00230,India
147470,2023-11-13,1005,Nail Polish,50,100,50,2,00230,India
603024,2023-11-13,1005,Nail Polish,50,100,50,2,00385,India
603024,2023-11-13,1006,Blush,150,300,150,2,00385,India
857341,2023-11-13,1008,Makeup Remover,80,160,80,2,00282,India
797054,2023-11-13,1007,Eyeshadow,200,400,200,2,00192,India
797054,2023-11-13,1006,Blush,150,300,150,2,00192,India
797054,2023-11-13,1009,Moisturizer,250,500,250,2,00192,India
584852,2023-11-13,1003,Foundation,300,600,300,2,00202,India
584852,2023-11-13,1009,Moisturizer,250,500,250,2,00202,India
584852,2023-11-13,1006,Blush,150,300,150,2,00202,India
584852,2023-11-13,1004,Eyeliner,100,200,100,2,00202,India
584852,2023-11-13,1002,Mascara,200,400,200,2,00202,India
150022,2023-11-13,1007,Eyeshadow,200,400,200,2,00333,India
150022,2023-11-13,1004,Eyeliner,100,200,100,2,00333,India
443320,2023-11-13,1012,Body Lotion,200,400,200,2,00322,India
773876,2023-11-13,1007,Eyeshadow,200,400,200,2,00273,India
773876,2023-11-13,1001,Lipstick,150,300,150,2,00273,India
773876,2023-11-13,1008,Makeup Remover,80,160,80,2,00273,India
536282,2023-11-13,1004,Eyeliner,100,200,100,2,00159,India
120771,2023-11-13,1002,Mascara,200,400,200,2,00129,India
120771,2023-11-13,1008,Makeup Remover,80,160,80,2,00129,India
120771,2023-11-13,1007,Eyeshadow,200,400,200,2,00129,India
366612,2023-11-13,1002,Mascara,200,400,200,2,00148,India
366612,2023-11-13,1006,Blush,150,300,150,2,00148,India
336268,2023-11-13,1008,Makeup Remover,80,160,80,2,00261,India
336268,2023-11-13,1009,Moisturizer,250,500,250,2,00261,India
718553,2023-11-13,1005,Nail Polish,50,100,50,2,00118,India
718553,2023-11-13,1008,Makeup Remover,80,160,80,2,00118,India
718553,2023-11-13,1004,Eyeliner,100,200,100,2,00118,India
143763,2023-11-13,1009,Moisturizer,250,500,250,2,00445,India
143763,2023-11-13,1001,Lipstick,150,300,150,2,00445,India
143763,2023-11-13,1006,Blush,150,300,150,2,00445,India
143763,2023-11-13,1008,Makeup Remover,80,160,80,2,00445,India
238136,2023-11-13,1001,Lipstick,150,300,150,2,00154,India
238136,2023-11-13,1004,Eyeliner,100,200,100,2,00154,India
238136,2023-11-13,1007,Eyeshadow,200,400,200,2,00154,India
238136,2023-11-13,1002,Mascara,200,400,200,2,00154,India
238136,2023-11-13,1012,Body Lotion,200,400,200,2,00154,India
889062,2023-11-13,1004,Eyeliner,100,200,100,2,00340,India
121189,2023-11-13,1012,Body Lotion,200,400,200,2,00008,India
121189,2023-11-13,1007,Eyeshadow,200,400,200,2,00008,India
121189,2023-11-13,1002,Mascara,200,400,200,2,00008,India
328350,2023-11-13,1007,Eyeshadow,200,400,200,2,00405,India
896731,2023-11-13,1005,Nail Polish,50,100,50,2,00370,India
896731,2023-11-13,1001,Lipstick,150,300,150,2,00370,India
930052,2023-11-13,1005,Nail Polish,50,100,50,2,00027,India
767672,2023-11-13,1008,Makeup Remover,80,160,80,2,00493,India
767672,2023-11-13,1009,Moisturizer,250,500,250,2,00493,India
767672,2023-11-13,1003,Foundation,300,600,300,2,00493,India
549683,2023-11-13,1004,Eyeliner,100,200,100,2,00026,India
539188,2023-11-13,1008,Makeup Remover,80,160,80,2,00408,India
539188,2023-11-13,1004,Eyeliner,100,200,100,2,00408,India
901720,2023-11-13,1009,Moisturizer,250,500,250,2,00365,India
901720,2023-11-13,1004,Eyeliner,100,200,100,2,00365,India
901720,2023-11-13,1006,Blush,150,300,150,2,00365,India
936047,2023-11-13,1002,Mascara,200,400,200,2,00017,India
936047,2023-11-13,1006,Blush,150,300,150,2,00017,India
334277,2023-11-13,1001,Lipstick,150,300,150,2,00497,India
334277,2023-11-13,1006,Blush,150,300,150,2,00497,India
247212,2023-11-13,1008,Makeup Remover,80,160,80,2,00265,India
247212,2023-11-13,1003,Foundation,300,600,300,2,00265,India
247212,2023-11-13,1006,Blush,150,300,150,2,00265,India
247212,2023-11-13,1005,Nail Polish,50,100,50,2,00265,India
247212,2023-11-13,1004,Eyeliner,100,200,100,2,00265,India
866751,2023-11-13,1008,Makeup Remover,80,160,80,2,00133,India
866751,2023-11-13,1003,Foundation,300,600,300,2,00133,India
332285,2023-11-13,1002,Mascara,200,400,200,2,00383,India
332285,2023-11-13,1003,Foundation,300,600,300,2,00383,India
458576,2023-11-13,1004,Eyeliner,100,200,100,2,00448,India
831834,2023-11-13,1005,Nail Polish,50,100,50,2,00416,India
884107,2023-11-13,1001,Lipstick,150,300,150,2,00476,India
884107,2023-11-13,1005,Nail Polish,50,100,50,2,00476,India
884107,2023-11-13,1006,Blush,150,300,150,2,00476,India
504097,2023-11-13,1007,Eyeshadow,200,400,200,2,00349,India
504097,2023-11-13,1004,Eyeliner,100,200,100,2,00349,India
504097,2023-11-13,1001,Lipstick,150,300,150,2,00349,India
504097,2023-11-13,1006,Blush,150,300,150,2,00349,India
374664,2023-11-13,1007,Eyeshadow,200,400,200,2,00488,India
374664,2023-11-13,1006,Blush,150,300,150,2,00488,India
374664,2023-11-13,1004,Eyeliner,100,200,100,2,00488,India
270558,2023-11-13,1006,Blush,150,300,150,2,00343,India
311556,2023-11-13,1006,Blush,150,300,150,2,00301,India
902731,2023-11-13,1003,Foundation,300,600,300,2,00336,India
143434,2023-11-13,1005,Nail Polish,50,100,50,2,00275,India
143434,2023-11-13,1006,Blush,150,300,150,2,00275,India
215127,2023-11-13,1012,Body Lotion,200,400,200,2,00347,India
215127,2023-11-13,1008,Makeup Remover,80,160,80,2,00347,India
215127,2023-11-13,1009,Moisturizer,250,500,250,2,00347,India
315447,2023-11-13,1005,Nail Polish,50,100,50,2,00070,India
315447,2023-11-13,1008,Makeup Remover,80,160,80,2,00070,India
315447,2023-11-13,1012,Body Lotion,200,400,200,2,00070,India
565951,2023-11-14,1004,Eyeliner,100,200,100,2,00179,India
565951,2023-11-14,1006,Blush,150,300,150,2,00179,India
565951,2023-11-14,1012,Body Lotion,200,400,200,2,00179,India
565951,2023-11-14,1007,Eyeshadow,200,400,200,2,00179,India
472095,2023-11-14,1002,Mascara,200,400,200,2,00293,India
472095,2023-11-14,1001,Lipstick,150,300,150,2,00293,India
722474,2023-11-14,1004,Eyeliner,100,200,100,2,00005,India
722474,2023-11-14,1008,Makeup Remover,80,160,80,2,00005,India
710097,2023-11-14,1004,Eyeliner,100,200,100,2,00410,India
710097,2023-11-14,1008,Makeup Remover,80,160,80,2,00410,India
454771,2023-11-14,1004,Eyeliner,100,200,100,2,00004,India
454771,2023-11-14,1003,Foundation,300,600,300,2,00004,India
454771,2023-11-14,1008,Makeup Remover,80,160,80,2,00004,India
454771,2023-11-14,1001,Lipstick,150,300,150,2,00004,India
474552,2023-11-14,1003,Foundation,300,600,300,2,00096,India
474552,2023-11-14,1001,Lipstick,150,300,150,2,00096,India
474552,2023-11-14,1008,Makeup Remover,80,160,80,2,00096,India
135774,2023-11-14,1012,Body Lotion,200,400,200,2,00374,India
135774,2023-11-14,1005,Nail Polish,50,100,50,2,00374,India
135774,2023-11-14,1007,Eyeshadow,200,400,200,2,00374,India
700675,2023-11-14,1012,Body Lotion,200,400,200,2,00359,India
700675,2023-11-14,1003,Foundation,300,600,300,2,00359,India
700675,2023-11-14,1004,Eyeliner,100,200,100,2,00359,India
700675,2023-11-14,1002,Mascara,200,400,200,2,00359,India
700675,2023-11-14,1006,Blush,150,300,150,2,00359,India
809433,2023-11-14,1002,Mascara,200,400,200,2,00028,India
809433,2023-11-14,1012,Body Lotion,200,400,200,2,00028,India
205782,2023-11-14,1001,Lipstick,150,300,150,2,00386,India
205782,2023-11-14,1009,Moisturizer,250,500,250,2,00386,India
205782,2023-11-14,1002,Mascara,200,400,200,2,00386,India
205782,2023-11-14,1008,Makeup Remover,80,160,80,2,00386,India
205782,2023-11-14,1007,Eyeshadow,200,400,200,2,00386,India
465401,2023-11-14,1007,Eyeshadow,200,400,200,2,00016,India
354368,2023-11-14,1009,Moisturizer,250,500,250,2,00003,India
354368,2023-11-14,1003,Foundation,300,600,300,2,00003,India
523918,2023-11-14,1007,Eyeshadow,200,400,200,2,00134,India
523918,2023-11-14,1005,Nail Polish,50,100,50,2,00134,India
523918,2023-11-14,1008,Makeup Remover,80,160,80,2,00134,India
523918,2023-11-14,1009,Moisturizer,250,500,250,2,00134,India
523918,2023-11-14,1006,Blush,150,300,150,2,00134,India
524614,2023-11-14,1008,Makeup Remover,80,160,80,2,00252,India
524614,2023-11-14,1003,Foundation,300,600,300,2,00252,India
524614,2023-11-14,1005,Nail Polish,50,100,50,2,00252,India
907050,2023-11-14,1006,Blush,150,300,150,2,00187,India
649244,2023-11-14,1009,Moisturizer,250,500,250,2,00331,India
649244,2023-11-14,1006,Blush,150,300,150,2,00331,India
649244,2023-11-14,1012,Body Lotion,200,400,200,2,00331,India
233325,2023-11-14,1003,Foundation,300,600,300,2,00239,India
233325,2023-11-14,1005,Nail Polish,50,100,50,2,00239,India
233325,2023-11-14,1006,Blush,150,300,150,2,00239,India
233325,2023-11-14,1004,Eyeliner,100,200,100,2,00239,India
840431,2023-11-14,1002,Mascara,200,400,200,2,00190,India
480239,2023-11-14,1006,Blush,150,300,150,2,00126,India
480239,2023-11-14,1004,Eyeliner,100,200,100,2,00126,India
480239,2023-11-14,1012,Body Lotion,200,400,200,2,00126,India
480239,2023-11-14,1002,Mascara,200,400,200,2,00126,India
480239,2023-11-14,1001,Lipstick,150,300,150,2,00126,India
128138,2023-11-14,1012,Body Lotion,200,400,200,2,00062,India
128138,2023-11-14,1008,Makeup Remover,80,160,80,2,00062,India
128138,2023-11-14,1009,Moisturizer,250,500,250,2,00062,India
128138,2023-11-14,1006,Blush,150,300,150,2,00062,India
551593,2023-11-14,1004,Eyeliner,100,200,100,2,00054,India
551593,2023-11-14,1007,Eyeshadow,200,400,200,2,00054,India
439143,2023-11-14,1004,Eyeliner,100,200,100,2,00124,India
439143,2023-11-14,1001,Lipstick,150,300,150,2,00124,India
439143,2023-11-14,1009,Moisturizer,250,500,250,2,00124,India
439143,2023-11-14,1006,Blush,150,300,150,2,00124,India
624458,2023-11-14,1006,Blush,150,300,150,2,00247,India
624458,2023-11-14,1007,Eyeshadow,200,400,200,2,00247,India
624458,2023-11-14,1001,Lipstick,150,300,150,2,00247,India
714396,2023-11-14,1001,Lipstick,150,300,150,2,00053,India
714396,2023-11-14,1009,Moisturizer,250,500,250,2,00053,India
714396,2023-11-14,1008,Makeup Remover,80,160,80,2,00053,India
785834,2023-11-14,1006,Blush,150,300,150,2,00429,India
785834,2023-11-14,1007,Eyeshadow,200,400,200,2,00429,India
129293,2023-11-14,1001,Lipstick,150,300,150,2,00453,India
129293,2023-11-14,1008,Makeup Remover,80,160,80,2,00453,India
327380,2023-11-14,1005,Nail Polish,50,100,50,2,00006,India
327380,2023-11-14,1007,Eyeshadow,200,400,200,2,00006,India
327380,2023-11-14,1002,Mascara,200,400,200,2,00006,India
831658,2023-11-14,1009,Moisturizer,250,500,250,2,00208,India
831658,2023-11-14,1003,Foundation,300,600,300,2,00208,India
720112,2023-11-14,1003,Foundation,300,600,300,2,00011,India
720112,2023-11-14,1005,Nail Polish,50,100,50,2,00011,India
720112,2023-11-14,1006,Blush,150,300,150,2,00011,India
720112,2023-11-14,1002,Mascara,200,400,200,2,00011,India
675804,2023-11-14,1006,Blush,150,300,150,2,00457,India
675804,2023-11-14,1007,Eyeshadow,200,400,200,2,00457,India
675804,2023-11-14,1004,Eyeliner,100,200,100,2,00457,India
675804,2023-11-14,1003,Foundation,300,600,300,2,00457,India
890590,2023-11-14,1006,Blush,150,300,150,2,00322,India
890590,2023-11-14,1001,Lipstick,150,300,150,2,00322,India
890590,2023-11-14,1009,Moisturizer,250,500,250,2,00322,India
867814,2023-11-14,1004,Eyeliner,100,200,100,2,00461,India
867814,2023-11-14,1006,Blush,150,300,150,2,00461,India
867814,2023-11-14,1002,Mascara,200,400,200,2,00461,India
554234,2023-11-14,1004,Eyeliner,100,200,100,2,00103,India
554234,2023-11-14,1003,Foundation,300,600,300,2,00103,India
554234,2023-11-14,1006,Blush,150,300,150,2,00103,India
999048,2023-11-14,1007,Eyeshadow,200,400,200,2,00225,India
999048,2023-11-14,1001,Lipstick,150,300,150,2,00225,India
999048,2023-11-14,1006,Blush,150,300,150,2,00225,India
730562,2023-11-14,1005,Nail Polish,50,100,50,2,00278,India
730562,2023-11-14,1002,Mascara,200,400,200,2,00278,India
730562,2023-11-14,1006,Blush,150,300,150,2,00278,India
730562,2023-11-14,1009,Moisturizer,250,500,250,2,00278,India
320020,2023-11-14,1002,Mascara,200,400,200,2,00304,India
320020,2023-11-14,1006,Blush,150,300,150,2,00304,India
320020,2023-11-14,1003,Foundation,300,600,300,2,00304,India
689133,2023-11-14,1005,Nail Polish,50,100,50,2,00259,India
500214,2023-11-14,1008,Makeup Remover,80,160,80,2,00313,India
500214,2023-11-14,1004,Eyeliner,100,200,100,2,00313,India
500214,2023-11-14,1003,Foundation,300,600,300,2,00313,India
919448,2023-11-14,1006,Blush,150,300,150,2,00220,India
919448,2023-11-14,1012,Body Lotion,200,400,200,2,00220,India
919448,2023-11-14,1001,Lipstick,150,300,150,2,00220,India
634323,2023-11-14,1002,Mascara,200,400,200,2,00073,India
634323,2023-11-14,1004,Eyeliner,100,200,100,2,00073,India
634323,2023-11-14,1012,Body Lotion,200,400,200,2,00073,India
846480,2023-11-14,1007,Eyeshadow,200,400,200,2,00063,India
846480,2023-11-14,1003,Foundation,300,600,300,2,00063,India
846480,2023-11-14,1005,Nail Polish,50,100,50,2,00063,India
846480,2023-11-14,1008,Makeup Remover,80,160,80,2,00063,India
846480,2023-11-14,1012,Body Lotion,200,400,200,2,00063,India
286275,2023-11-14,1003,Foundation,300,600,300,2,00498,India
286275,2023-11-14,1006,Blush,150,300,150,2,00498,India
286275,2023-11-14,1009,Moisturizer,250,500,250,2,00498,India
286275,2023-11-14,1005,Nail Polish,50,100,50,2,00498,India
575367,2023-11-14,1003,Foundation,300,600,300,2,00176,India
575367,2023-11-14,1002,Mascara,200,400,200,2,00176,India
575367,2023-11-14,1008,Makeup Remover,80,160,80,2,00176,India
575367,2023-11-14,1009,Moisturizer,250,500,250,2,00176,India
575367,2023-11-14,1005,Nail Polish,50,100,50,2,00176,India
412414,2023-11-14,1012,Body Lotion,200,400,200,2,00104,India
412414,2023-11-14,1002,Mascara,200,400,200,2,00104,India
412414,2023-11-14,1001,Lipstick,150,300,150,2,00104,India
412414,2023-11-14,1003,Foundation,300,600,300,2,00104,India
254619,2023-11-14,1009,Moisturizer,250,500,250,2,00079,India
254619,2023-11-14,1005,Nail Polish,50,100,50,2,00079,India
254619,2023-11-14,1008,Makeup Remover,80,160,80,2,00079,India
254619,2023-11-14,1001,Lipstick,150,300,150,2,00079,India
600353,2023-11-14,1003,Foundation,300,600,300,2,00275,India
600353,2023-11-14,1009,Moisturizer,250,500,250,2,00275,India
600353,2023-11-14,1012,Body Lotion,200,400,200,2,00275,India
600353,2023-11-14,1008,Makeup Remover,80,160,80,2,00275,India
412237,2023-11-14,1002,Mascara,200,400,200,2,00133,India
412237,2023-11-14,1009,Moisturizer,250,500,250,2,00133,India
783160,2023-11-15,1007,Eyeshadow,200,400,200,2,00371,India
615667,2023-11-15,1001,Lipstick,150,300,150,2,00477,India
615667,2023-11-15,1008,Makeup Remover,80,160,80,2,00477,India
615667,2023-11-15,1006,Blush,150,300,150,2,00477,India
615667,2023-11-15,1002,Mascara,200,400,200,2,00477,India
241463,2023-11-15,1005,Nail Polish,50,100,50,2,00203,India
241463,2023-11-15,1008,Makeup Remover,80,160,80,2,00203,India
241463,2023-11-15,1003,Foundation,300,600,300,2,00203,India
241463,2023-11-15,1006,Blush,150,300,150,2,00203,India
268778,2023-11-15,1003,Foundation,300,600,300,2,00498,India
268778,2023-11-15,1001,Lipstick,150,300,150,2,00498,India
268778,2023-11-15,1009,Moisturizer,250,500,250,2,00498,India
758139,2023-11-15,1004,Eyeliner,100,200,100,2,00478,India
758139,2023-11-15,1003,Foundation,300,600,300,2,00478,India
758139,2023-11-15,1005,Nail Polish,50,100,50,2,00478,India
758139,2023-11-15,1009,Moisturizer,250,500,250,2,00478,India
560123,2023-11-15,1006,Blush,150,300,150,2,00400,India
560123,2023-11-15,1007,Eyeshadow,200,400,200,2,00400,India
143817,2023-11-15,1006,Blush,150,300,150,2,00445,India
143817,2023-11-15,1004,Eyeliner,100,200,100,2,00445,India
143817,2023-11-15,1008,Makeup Remover,80,160,80,2,00445,India
349806,2023-11-15,1008,Makeup Remover,80,160,80,2,00182,India
349806,2023-11-15,1003,Foundation,300,600,300,2,00182,India
349806,2023-11-15,1007,Eyeshadow,200,400,200,2,00182,India
840996,2023-11-15,1006,Blush,150,300,150,2,00430,India
840996,2023-11-15,1012,Body Lotion,200,400,200,2,00430,India
494233,2023-11-15,1006,Blush,150,300,150,2,00215,India
494233,2023-11-15,1004,Eyeliner,100,200,100,2,00215,India
494233,2023-11-15,1003,Foundation,300,600,300,2,00215,India
976458,2023-11-15,1007,Eyeshadow,200,400,200,2,00447,India
976458,2023-11-15,1004,Eyeliner,100,200,100,2,00447,India
976458,2023-11-15,1002,Mascara,200,400,200,2,00447,India
976458,2023-11-15,1006,Blush,150,300,150,2,00447,India
765429,2023-11-15,1001,Lipstick,150,300,150,2,00070,India
765429,2023-11-15,1009,Moisturizer,250,500,250,2,00070,India
765429,2023-11-15,1012,Body Lotion,200,400,200,2,00070,India
765429,2023-11-15,1007,Eyeshadow,200,400,200,2,00070,India
361264,2023-11-15,1001,Lipstick,150,300,150,2,00344,India
361264,2023-11-15,1003,Foundation,300,600,300,2,00344,India
361264,2023-11-15,1008,Makeup Remover,80,160,80,2,00344,India
350940,2023-11-15,1009,Moisturizer,250,500,250,2,00284,India
307093,2023-11-15,1005,Nail Polish,50,100,50,2,00241,India
307093,2023-11-15,1007,Eyeshadow,200,400,200,2,00241,India
989481,2023-11-15,1004,Eyeliner,100,200,100,2,00395,India
989481,2023-11-15,1012,Body Lotion,200,400,200,2,00395,India
909141,2023-11-15,1002,Mascara,200,400,200,2,00371,India
697735,2023-11-15,1006,Blush,150,300,150,2,00489,India
714613,2023-11-15,1002,Mascara,200,400,200,2,00116,India
714613,2023-11-15,1001,Lipstick,150,300,150,2,00116,India
714613,2023-11-15,1007,Eyeshadow,200,400,200,2,00116,India
714613,2023-11-15,1009,Moisturizer,250,500,250,2,00116,India
547717,2023-11-15,1004,Eyeliner,100,200,100,2,00378,India
663730,2023-11-15,1009,Moisturizer,250,500,250,2,00152,India
663730,2023-11-15,1002,Mascara,200,400,200,2,00152,India
663730,2023-11-15,1007,Eyeshadow,200,400,200,2,00152,India
523264,2023-11-15,1002,Mascara,200,400,200,2,00336,India
523264,2023-11-15,1003,Foundation,300,600,300,2,00336,India
523264,2023-11-15,1005,Nail Polish,50,100,50,2,00336,India
523264,2023-11-15,1007,Eyeshadow,200,400,200,2,00336,India
523264,2023-11-15,1008,Makeup Remover,80,160,80,2,00336,India
562388,2023-11-15,1003,Foundation,300,600,300,2,00468,India
562388,2023-11-15,1008,Makeup Remover,80,160,80,2,00468,India
562388,2023-11-15,1012,Body Lotion,200,400,200,2,00468,India
534377,2023-11-15,1006,Blush,150,300,150,2,00169,India
534377,2023-11-15,1001,Lipstick,150,300,150,2,00169,India
534377,2023-11-15,1004,Eyeliner,100,200,100,2,00169,India
323731,2023-11-15,1002,Mascara,200,400,200,2,00343,India
879334,2023-11-15,1009,Moisturizer,250,500,250,2,00013,India
879334,2023-11-15,1008,Makeup Remover,80,160,80,2,00013,India
879334,2023-11-15,1005,Nail Polish,50,100,50,2,00013,India
852859,2023-11-15,1005,Nail Polish,50,100,50,2,00120,India
852859,2023-11-15,1006,Blush,150,300,150,2,00120,India
852859,2023-11-15,1008,Makeup Remover,80,160,80,2,00120,India
339536,2023-11-15,1003,Foundation,300,600,300,2,00151,India
339536,2023-11-15,1006,Blush,150,300,150,2,00151,India
339536,2023-11-15,1005,Nail Polish,50,100,50,2,00151,India
674818,2023-11-15,1009,Moisturizer,250,500,250,2,00203,India
674818,2023-11-15,1006,Blush,150,300,150,2,00203,India
674818,2023-11-15,1012,Body Lotion,200,400,200,2,00203,India
100214,2023-11-15,1003,Foundation,300,600,300,2,00381,India
268484,2023-11-15,1005,Nail Polish,50,100,50,2,00368,India
268484,2023-11-15,1007,Eyeshadow,200,400,200,2,00368,India
268484,2023-11-15,1002,Mascara,200,400,200,2,00368,India
600892,2023-11-15,1008,Makeup Remover,80,160,80,2,00277,India
600892,2023-11-15,1001,Lipstick,150,300,150,2,00277,India
600892,2023-11-15,1009,Moisturizer,250,500,250,2,00277,India
600892,2023-11-15,1006,Blush,150,300,150,2,00277,India
600892,2023-11-15,1007,Eyeshadow,200,400,200,2,00277,India
423623,2023-11-15,1006,Blush,150,300,150,2,00322,India
447103,2023-11-15,1008,Makeup Remover,80,160,80,2,00179,India
181703,2023-11-15,1004,Eyeliner,100,200,100,2,00009,India
181703,2023-11-15,1007,Eyeshadow,200,400,200,2,00009,India
181703,2023-11-15,1006,Blush,150,300,150,2,00009,India
181703,2023-11-15,1009,Moisturizer,250,500,250,2,00009,India
436255,2023-11-15,1006,Blush,150,300,150,2,00198,India
436255,2023-11-15,1004,Eyeliner,100,200,100,2,00198,India
354905,2023-11-15,1001,Lipstick,150,300,150,2,00487,India
354905,2023-11-15,1007,Eyeshadow,200,400,200,2,00487,India
354905,2023-11-15,1006,Blush,150,300,150,2,00487,India
354905,2023-11-15,1004,Eyeliner,100,200,100,2,00487,India
758521,2023-11-15,1006,Blush,150,300,150,2,00400,India
714633,2023-11-15,1005,Nail Polish,50,100,50,2,00265,India
996557,2023-11-15,1005,Nail Polish,50,100,50,2,00363,India
746573,2023-11-15,1003,Foundation,300,600,300,2,00151,India
886583,2023-11-15,1002,Mascara,200,400,200,2,00359,India
314902,2023-11-15,1003,Foundation,300,600,300,2,00188,India
314902,2023-11-15,1005,Nail Polish,50,100,50,2,00188,India
314902,2023-11-15,1004,Eyeliner,100,200,100,2,00188,India
165733,2023-11-15,1003,Foundation,300,600,300,2,00401,India
388645,2023-11-15,1008,Makeup Remover,80,160,80,2,00070,India
388645,2023-11-15,1002,Mascara,200,400,200,2,00070,India
388645,2023-11-15,1012,Body Lotion,200,400,200,2,00070,India
388645,2023-11-15,1003,Foundation,300,600,300,2,00070,India
377684,2023-11-15,1001,Lipstick,150,300,150,2,00179,India
377684,2023-11-15,1009,Moisturizer,250,500,250,2,00179,India
377684,2023-11-15,1006,Blush,150,300,150,2,00179,India
125567,2023-11-15,1012,Body Lotion,200,400,200,2,00199,India
125567,2023-11-15,1002,Mascara,200,400,200,2,00199,India
125567,2023-11-15,1001,Lipstick,150,300,150,2,00199,India
125567,2023-11-15,1004,Eyeliner,100,200,100,2,00199,India
686752,2023-11-16,1005,Nail Polish,50,100,50,2,00241,India
686752,2023-11-16,1001,Lipstick,150,300,150,2,00241,India
686752,2023-11-16,1007,Eyeshadow,200,400,200,2,00241,India
686752,2023-11-16,1008,Makeup Remover,80,160,80,2,00241,India
554622,2023-11-16,1008,Makeup Remover,80,160,80,2,00480,India
166990,2023-11-16,1004,Eyeliner,100,200,100,2,00053,India
166990,2023-11-16,1007,Eyeshadow,200,400,200,2,00053,India
166990,2023-11-16,1002,Mascara,200,400,200,2,00053,India
166990,2023-11-16,1009,Moisturizer,250,500,250,2,00053,India
459502,2023-11-16,1003,Foundation,300,600,300,2,00263,India
459502,2023-11-16,1008,Makeup Remover,80,160,80,2,00263,India
239177,2023-11-16,1007,Eyeshadow,200,400,200,2,00287,India
239177,2023-11-16,1001,Lipstick,150,300,150,2,00287,India
597629,2023-11-16,1004,Eyeliner,100,200,100,2,00094,India
597629,2023-11-16,1001,Lipstick,150,300,150,2,00094,India
597629,2023-11-16,1005,Nail Polish,50,100,50,2,00094,India
597629,2023-11-16,1006,Blush,150,300,150,2,00094,India
581053,2023-11-16,1012,Body Lotion,200,400,200,2,00229,India
581053,2023-11-16,1003,Foundation,300,600,300,2,00229,India
581053,2023-11-16,1007,Eyeshadow,200,400,200,2,00229,India
122135,2023-11-16,1012,Body Lotion,200,400,200,2,00295,India
122135,2023-11-16,1005,Nail Polish,50,100,50,2,00295,India
126703,2023-11-16,1008,Makeup Remover,80,160,80,2,00074,India
110659,2023-11-16,1001,Lipstick,150,300,150,2,00050,India
840714,2023-11-16,1003,Foundation,300,600,300,2,00221,India
840714,2023-11-16,1007,Eyeshadow,200,400,200,2,00221,India
840714,2023-11-16,1009,Moisturizer,250,500,250,2,00221,India
840714,2023-11-16,1008,Makeup Remover,80,160,80,2,00221,India
100518,2023-11-16,1005,Nail Polish,50,100,50,2,00005,India
530429,2023-11-16,1008,Makeup Remover,80,160,80,2,00453,India
530429,2023-11-16,1005,Nail Polish,50,100,50,2,00453,India
530429,2023-11-16,1009,Moisturizer,250,500,250,2,00453,India
530429,2023-11-16,1001,Lipstick,150,300,150,2,00453,India
566545,2023-11-16,1006,Blush,150,300,150,2,00297,India
566545,2023-11-16,1001,Lipstick,150,300,150,2,00297,India
566545,2023-11-16,1004,Eyeliner,100,200,100,2,00297,India
566545,2023-11-16,1005,Nail Polish,50,100,50,2,00297,India
566545,2023-11-16,1007,Eyeshadow,200,400,200,2,00297,India
737747,2023-11-16,1003,Foundation,300,600,300,2,00362,India
737747,2023-11-16,1007,Eyeshadow,200,400,200,2,00362,India
737747,2023-11-16,1005,Nail Polish,50,100,50,2,00362,India
537009,2023-11-16,1004,Eyeliner,100,200,100,2,00454,India
537009,2023-11-16,1005,Nail Polish,50,100,50,2,00454,India
537009,2023-11-16,1012,Body Lotion,200,400,200,2,00454,India
915472,2023-11-16,1001,Lipstick,150,300,150,2,00424,India
915472,2023-11-16,1002,Mascara,200,400,200,2,00424,India
882308,2023-11-16,1012,Body Lotion,200,400,200,2,00272,India
882308,2023-11-16,1007,Eyeshadow,200,400,200,2,00272,India
882308,2023-11-16,1006,Blush,150,300,150,2,00272,India
288922,2023-11-16,1003,Foundation,300,600,300,2,00070,India
288922,2023-11-16,1005,Nail Polish,50,100,50,2,00070,India
288922,2023-11-16,1009,Moisturizer,250,500,250,2,00070,India
546466,2023-11-16,1001,Lipstick,150,300,150,2,00208,India
546466,2023-11-16,1005,Nail Polish,50,100,50,2,00208,India
581302,2023-11-16,1005,Nail Polish,50,100,50,2,00219,India
581302,2023-11-16,1004,Eyeliner,100,200,100,2,00219,India
939673,2023-11-16,1007,Eyeshadow,200,400,200,2,00367,India
939673,2023-11-16,1005,Nail Polish,50,100,50,2,00367,India
939673,2023-11-16,1008,Makeup Remover,80,160,80,2,00367,India
939673,2023-11-16,1012,Body Lotion,200,400,200,2,00367,India
965238,2023-11-16,1008,Makeup Remover,80,160,80,2,00066,India
965238,2023-11-16,1006,Blush,150,300,150,2,00066,India
965238,2023-11-16,1009,Moisturizer,250,500,250,2,00066,India
762146,2023-11-16,1003,Foundation,300,600,300,2,00224,India
762146,2023-11-16,1008,Makeup Remover,80,160,80,2,00224,India
563782,2023-11-16,1002,Mascara,200,400,200,2,00172,India
868472,2023-11-16,1003,Foundation,300,600,300,2,00229,India
868472,2023-11-16,1009,Moisturizer,250,500,250,2,00229,India
868472,2023-11-16,1002,Mascara,200,400,200,2,00229,India
868472,2023-11-16,1012,Body Lotion,200,400,200,2,00229,India
279432,2023-11-16,1008,Makeup Remover,80,160,80,2,00275,India
751963,2023-11-16,1004,Eyeliner,100,200,100,2,00313,India
751963,2023-11-16,1006,Blush,150,300,150,2,00313,India
751963,2023-11-16,1008,Makeup Remover,80,160,80,2,00313,India
273019,2023-11-16,1008,Makeup Remover,80,160,80,2,00145,India
273019,2023-11-16,1001,Lipstick,150,300,150,2,00145,India
273019,2023-11-16,1003,Foundation,300,600,300,2,00145,India
273019,2023-11-16,1009,Moisturizer,250,500,250,2,00145,India
750370,2023-11-16,1002,Mascara,200,400,200,2,00215,India
750370,2023-11-16,1008,Makeup Remover,80,160,80,2,00215,India
750370,2023-11-16,1009,Moisturizer,250,500,250,2,00215,India
641217,2023-11-16,1002,Mascara,200,400,200,2,00356,India
283390,2023-11-16,1009,Moisturizer,250,500,250,2,00208,India
283390,2023-11-16,1007,Eyeshadow,200,400,200,2,00208,India
283390,2023-11-16,1005,Nail Polish,50,100,50,2,00208,India
283390,2023-11-16,1008,Makeup Remover,80,160,80,2,00208,India
767852,2023-11-16,1012,Body Lotion,200,400,200,2,00388,India
767852,2023-11-16,1003,Foundation,300,600,300,2,00388,India
767852,2023-11-16,1002,Mascara,200,400,200,2,00388,India
440094,2023-11-16,1001,Lipstick,150,300,150,2,00203,India
440094,2023-11-16,1004,Eyeliner,100,200,100,2,00203,India
440094,2023-11-16,1006,Blush,150,300,150,2,00203,India
591268,2023-11-16,1003,Foundation,300,600,300,2,00084,India
621771,2023-11-16,1007,Eyeshadow,200,400,200,2,00379,India
744474,2023-11-16,1008,Makeup Remover,80,160,80,2,00169,India
744474,2023-11-16,1001,Lipstick,150,300,150,2,00169,India
744474,2023-11-16,1007,Eyeshadow,200,400,200,2,00169,India
744474,2023-11-16,1009,Moisturizer,250,500,250,2,00169,India
744474,2023-11-16,1002,Mascara,200,400,200,2,00169,India
984248,2023-11-16,1004,Eyeliner,100,200,100,2,00224,India
984248,2023-11-16,1006,Blush,150,300,150,2,00224,India
984248,2023-11-16,1002,Mascara,200,400,200,2,00224,India
260022,2023-11-16,1003,Foundation,300,600,300,2,00356,India
292318,2023-11-16,1006,Blush,150,300,150,2,00362,India
292318,2023-11-16,1007,Eyeshadow,200,400,200,2,00362,India
292318,2023-11-16,1008,Makeup Remover,80,160,80,2,00362,India
292318,2023-11-16,1012,Body Lotion,200,400,200,2,00362,India
220742,2023-11-16,1005,Nail Polish,50,100,50,2,00228,India
220742,2023-11-16,1008,Makeup Remover,80,160,80,2,00228,India
571577,2023-11-16,1009,Moisturizer,250,500,250,2,00254,India
571577,2023-11-16,1001,Lipstick,150,300,150,2,00254,India
990124,2023-11-16,1002,Mascara,200,400,200,2,00321,India
990124,2023-11-16,1003,Foundation,300,600,300,2,00321,India
486149,2023-11-16,1004,Eyeliner,100,200,100,2,00136,India
486149,2023-11-16,1003,Foundation,300,600,300,2,00136,India
486149,2023-11-16,1005,Nail Polish,50,100,50,2,00136,India
534664,2023-11-16,1005,Nail Polish,50,100,50,2,00499,India
534664,2023-11-16,1001,Lipstick,150,300,150,2,00499,India
534664,2023-11-16,1006,Blush,150,300,150,2,00499,India
186053,2023-11-16,1005,Nail Polish,50,100,50,2,00005,India
186053,2023-11-16,1003,Foundation,300,600,300,2,00005,India
186053,2023-11-16,1001,Lipstick,150,300,150,2,00005,India
186053,2023-11-16,1008,Makeup Remover,80,160,80,2,00005,India
367350,2023-11-16,1005,Nail Polish,50,100,50,2,00481,India
367350,2023-11-16,1012,Body Lotion,200,400,200,2,00481,India
367350,2023-11-16,1001,Lipstick,150,300,150,2,00481,India
367350,2023-11-16,1009,Moisturizer,250,500,250,2,00481,India
213868,2023-11-16,1005,Nail Polish,50,100,50,2,00066,India
213868,2023-11-16,1008,Makeup Remover,80,160,80,2,00066,India
213868,2023-11-16,1002,Mascara,200,400,200,2,00066,India
213868,2023-11-16,1004,Eyeliner,100,200,100,2,00066,India
984079,2023-11-16,1005,Nail Polish,50,100,50,2,00483,India
984079,2023-11-16,1004,Eyeliner,100,200,100,2,00483,India
984079,2023-11-16,1002,Mascara,200,400,200,2,00483,India
471830,2023-11-17,1012,Body Lotion,200,400,200,2,00441,India
946011,2023-11-17,1006,Blush,150,300,150,2,00123,India
946011,2023-11-17,1012,Body Lotion,200,400,200,2,00123,India
679154,2023-11-17,1012,Body Lotion,200,400,200,2,00008,India
679154,2023-11-17,1004,Eyeliner,100,200,100,2,00008,India
679154,2023-11-17,1002,Mascara,200,400,200,2,00008,India
679154,2023-11-17,1008,Makeup Remover,80,160,80,2,00008,India
695949,2023-11-17,1004,Eyeliner,100,200,100,2,00488,India
695949,2023-11-17,1002,Mascara,200,400,200,2,00488,India
789602,2023-11-17,1009,Moisturizer,250,500,250,2,00268,India
626063,2023-11-17,1009,Moisturizer,250,500,250,2,00045,India
626063,2023-11-17,1004,Eyeliner,100,200,100,2,00045,India
626063,2023-11-17,1002,Mascara,200,400,200,2,00045,India
663821,2023-11-17,1012,Body Lotion,200,400,200,2,00441,India
663821,2023-11-17,1001,Lipstick,150,300,150,2,00441,India
663821,2023-11-17,1006,Blush,150,300,150,2,00441,India
602952,2023-11-17,1006,Blush,150,300,150,2,00495,India
779203,2023-11-17,1002,Mascara,200,400,200,2,00240,India
760071,2023-11-17,1007,Eyeshadow,200,400,200,2,00439,India
197231,2023-11-17,1006,Blush,150,300,150,2,00131,India
197231,2023-11-17,1009,Moisturizer,250,500,250,2,00131,India
197231,2023-11-17,1008,Makeup Remover,80,160,80,2,00131,India
197231,2023-11-17,1003,Foundation,300,600,300,2,00131,India
197231,2023-11-17,1007,Eyeshadow,200,400,200,2,00131,India
555841,2023-11-17,1007,Eyeshadow,200,400,200,2,00331,India
555841,2023-11-17,1001,Lipstick,150,300,150,2,00331,India
555841,2023-11-17,1003,Foundation,300,600,300,2,00331,India
506569,2023-11-17,1005,Nail Polish,50,100,50,2,00398,India
506569,2023-11-17,1008,Makeup Remover,80,160,80,2,00398,India
506569,2023-11-17,1012,Body Lotion,200,400,200,2,00398,India
506569,2023-11-17,1006,Blush,150,300,150,2,00398,India
506569,2023-11-17,1003,Foundation,300,600,300,2,00398,India
414281,2023-11-17,1009,Moisturizer,250,500,250,2,00367,India
414281,2023-11-17,1012,Body Lotion,200,400,200,2,00367,India
414281,2023-11-17,1008,Makeup Remover,80,160,80,2,00367,India
414281,2023-11-17,1007,Eyeshadow,200,400,200,2,00367,India
414281,2023-11-17,1002,Mascara,200,400,200,2,00367,India
175464,2023-11-17,1006,Blush,150,300,150,2,00279,India
175464,2023-11-17,1007,Eyeshadow,200,400,200,2,00279,India
175464,2023-11-17,1004,Eyeliner,100,200,100,2,00279,India
175464,2023-11-17,1009,Moisturizer,250,500,250,2,00279,India
519510,2023-11-17,1006,Blush,150,300,150,2,00021,India
519510,2023-11-17,1004,Eyeliner,100,200,100,2,00021,India
539472,2023-11-17,1012,Body Lotion,200,400,200,2,00209,India
539472,2023-11-17,1007,Eyeshadow,200,400,200,2,00209,India
539280,2023-11-17,1006,Blush,150,300,150,2,00056,India
561285,2023-11-17,1001,Lipstick,150,300,150,2,00314,India
572514,2023-11-17,1006,Blush,150,300,150,2,00016,India
572514,2023-11-17,1004,Eyeliner,100,200,100,2,00016,India
572514,2023-11-17,1005,Nail Polish,50,100,50,2,00016,India
572514,2023-11-17,1003,Foundation,300,600,300,2,00016,India
572514,2023-11-17,1012,Body Lotion,200,400,200,2,00016,India
230140,2023-11-17,1007,Eyeshadow,200,400,200,2,00094,India
230140,2023-11-17,1005,Nail Polish,50,100,50,2,00094,India
230140,2023-11-17,1008,Makeup Remover,80,160,80,2,00094,India
473666,2023-11-17,1005,Nail Polish,50,100,50,2,00211,India
473666,2023-11-17,1007,Eyeshadow,200,400,200,2,00211,India
473666,2023-11-17,1002,Mascara,200,400,200,2,00211,India
473666,2023-11-17,1012,Body Lotion,200,400,200,2,00211,India
580016,2023-11-17,1001,Lipstick,150,300,150,2,00227,India
580016,2023-11-17,1002,Mascara,200,400,200,2,00227,India
580016,2023-11-17,1007,Eyeshadow,200,400,200,2,00227,India
580016,2023-11-17,1008,Makeup Remover,80,160,80,2,00227,India
969937,2023-11-17,1003,Foundation,300,600,300,2,00053,India
637030,2023-11-17,1004,Eyeliner,100,200,100,2,00093,India
637030,2023-11-17,1009,Moisturizer,250,500,250,2,00093,India
889098,2023-11-17,1003,Foundation,300,600,300,2,00096,India
889098,2023-11-17,1006,Blush,150,300,150,2,00096,India
889098,2023-11-17,1002,Mascara,200,400,200,2,00096,India
889098,2023-11-17,1004,Eyeliner,100,200,100,2,00096,India
127021,2023-11-17,1002,Mascara,200,400,200,2,00075,India
127021,2023-11-17,1009,Moisturizer,250,500,250,2,00075,India
229712,2023-11-17,1004,Eyeliner,100,200,100,2,00226,India
365796,2023-11-17,1003,Foundation,300,600,300,2,00155,India
908308,2023-11-17,1001,Lipstick,150,300,150,2,00355,India
908308,2023-11-17,1002,Mascara,200,400,200,2,00355,India
908308,2023-11-17,1006,Blush,150,300,150,2,00355,India
908308,2023-11-17,1009,Moisturizer,250,500,250,2,00355,India
965878,2023-11-17,1006,Blush,150,300,150,2,00323,India
965878,2023-11-17,1008,Makeup Remover,80,160,80,2,00323,India
965878,2023-11-17,1009,Moisturizer,250,500,250,2,00323,India
965878,2023-11-17,1002,Mascara,200,400,200,2,00323,India
965878,2023-11-17,1007,Eyeshadow,200,400,200,2,00323,India
306553,2023-11-17,1006,Blush,150,300,150,2,00160,India
306553,2023-11-17,1009,Moisturizer,250,500,250,2,00160,India
306553,2023-11-17,1002,Mascara,200,400,200,2,00160,India
892706,2023-11-17,1009,Moisturizer,250,500,250,2,00114,India
892706,2023-11-17,1003,Foundation,300,600,300,2,00114,India
892706,2023-11-17,1008,Makeup Remover,80,160,80,2,00114,India
892706,2023-11-17,1001,Lipstick,150,300,150,2,00114,India
334065,2023-11-17,1012,Body Lotion,200,400,200,2,00196,India
334065,2023-11-17,1008,Makeup Remover,80,160,80,2,00196,India
334065,2023-11-17,1003,Foundation,300,600,300,2,00196,India
245500,2023-11-17,1004,Eyeliner,100,200,100,2,00491,India
245500,2023-11-17,1007,Eyeshadow,200,400,200,2,00491,India
245500,2023-11-17,1001,Lipstick,150,300,150,2,00491,India
245500,2023-11-17,1012,Body Lotion,200,400,200,2,00491,India
443136,2023-11-17,1006,Blush,150,300,150,2,00444,India
443136,2023-11-17,1012,Body Lotion,200,400,200,2,00444,India
370288,2023-11-18,1003,Foundation,300,600,300,2,00470,India
370288,2023-11-18,1008,Makeup Remover,80,160,80,2,00470,India
370288,2023-11-18,1009,Moisturizer,250,500,250,2,00470,India
370288,2023-11-18,1002,Mascara,200,400,200,2,00470,India
345669,2023-11-18,1004,Eyeliner,100,200,100,2,00406,India
345669,2023-11-18,1003,Foundation,300,600,300,2,00406,India
345669,2023-11-18,1005,Nail Polish,50,100,50,2,00406,India
345669,2023-11-18,1007,Eyeshadow,200,400,200,2,00406,India
729244,2023-11-18,1004,Eyeliner,100,200,100,2,00180,India
729244,2023-11-18,1009,Moisturizer,250,500,250,2,00180,India
729244,2023-11-18,1001,Lipstick,150,300,150,2,00180,India
945820,2023-11-18,1009,Moisturizer,250,500,250,2,00036,India
945820,2023-11-18,1005,Nail Polish,50,100,50,2,00036,India
945820,2023-11-18,1007,Eyeshadow,200,400,200,2,00036,India
945820,2023-11-18,1004,Eyeliner,100,200,100,2,00036,India
945820,2023-11-18,1001,Lipstick,150,300,150,2,00036,India
695216,2023-11-18,1009,Moisturizer,250,500,250,2,00168,India
695216,2023-11-18,1008,Makeup Remover,80,160,80,2,00168,India
756689,2023-11-18,1007,Eyeshadow,200,400,200,2,00299,India
487157,2023-11-18,1008,Makeup Remover,80,160,80,2,00402,India
487157,2023-11-18,1007,Eyeshadow,200,400,200,2,00402,India
487157,2023-11-18,1001,Lipstick,150,300,150,2,00402,India
850988,2023-11-18,1009,Moisturizer,250,500,250,2,00219,India
850988,2023-11-18,1005,Nail Polish,50,100,50,2,00219,India
850988,2023-11-18,1008,Makeup Remover,80,160,80,2,00219,India
850988,2023-11-18,1004,Eyeliner,100,200,100,2,00219,India
850988,2023-11-18,1002,Mascara,200,400,200,2,00219,India
182623,2023-11-18,1005,Nail Polish,50,100,50,2,00459,India
182623,2023-11-18,1006,Blush,150,300,150,2,00459,India
182623,2023-11-18,1003,Foundation,300,600,300,2,00459,India
182623,2023-11-18,1004,Eyeliner,100,200,100,2,00459,India
918123,2023-11-18,1004,Eyeliner,100,200,100,2,00055,India
918123,2023-11-18,1002,Mascara,200,400,200,2,00055,India
981226,2023-11-18,1005,Nail Polish,50,100,50,2,00465,India
553290,2023-11-18,1003,Foundation,300,600,300,2,00141,India
553290,2023-11-18,1002,Mascara,200,400,200,2,00141,India
553290,2023-11-18,1009,Moisturizer,250,500,250,2,00141,India
150400,2023-11-18,1012,Body Lotion,200,400,200,2,00246,India
150400,2023-11-18,1005,Nail Polish,50,100,50,2,00246,India
150400,2023-11-18,1003,Foundation,300,600,300,2,00246,India
356558,2023-11-18,1007,Eyeshadow,200,400,200,2,00065,India
356558,2023-11-18,1003,Foundation,300,600,300,2,00065,India
356558,2023-11-18,1004,Eyeliner,100,200,100,2,00065,India
356558,2023-11-18,1006,Blush,150,300,150,2,00065,India
214676,2023-11-18,1003,Foundation,300,600,300,2,00128,India
214676,2023-11-18,1005,Nail Polish,50,100,50,2,00128,India
214676,2023-11-18,1006,Blush,150,300,150,2,00128,India
129420,2023-11-18,1008,Makeup Remover,80,160,80,2,00210,India
129420,2023-11-18,1003,Foundation,300,600,300,2,00210,India
232939,2023-11-18,1008,Makeup Remover,80,160,80,2,00085,India
232939,2023-11-18,1012,Body Lotion,200,400,200,2,00085,India
232939,2023-11-18,1004,Eyeliner,100,200,100,2,00085,India
482235,2023-11-18,1003,Foundation,300,600,300,2,00434,India
482235,2023-11-18,1004,Eyeliner,100,200,100,2,00434,India
208070,2023-11-18,1002,Mascara,200,400,200,2,00227,India
325155,2023-11-18,1005,Nail Polish,50,100,50,2,00109,India
325155,2023-11-18,1012,Body Lotion,200,400,200,2,00109,India
325155,2023-11-18,1004,Eyeliner,100,200,100,2,00109,India
849864,2023-11-18,1004,Eyeliner,100,200,100,2,00180,India
849864,2023-11-18,1007,Eyeshadow,200,400,200,2,00180,India
849864,2023-11-18,1005,Nail Polish,50,100,50,2,00180,India
849864,2023-11-18,1003,Foundation,300,600,300,2,00180,India
849864,2023-11-18,1008,Makeup Remover,80,160,80,2,00180,India
805848,2023-11-18,1008,Makeup Remover,80,160,80,2,00283,India
805848,2023-11-18,1001,Lipstick,150,300,150,2,00283,India
805848,2023-11-18,1007,Eyeshadow,200,400,200,2,00283,India
805848,2023-11-18,1012,Body Lotion,200,400,200,2,00283,India
218228,2023-11-18,1002,Mascara,200,400,200,2,00350,India
218228,2023-11-18,1009,Moisturizer,250,500,250,2,00350,India
218228,2023-11-18,1004,Eyeliner,100,200,100,2,00350,India
218228,2023-11-18,1001,Lipstick,150,300,150,2,00350,India
296900,2023-11-18,1003,Foundation,300,600,300,2,00317,India
163176,2023-11-18,1003,Foundation,300,600,300,2,00035,India
163176,2023-11-18,1005,Nail Polish,50,100,50,2,00035,India
432182,2023-11-18,1002,Mascara,200,400,200,2,00103,India
432182,2023-11-18,1004,Eyeliner,100,200,100,2,00103,India
822631,2023-11-18,1008,Makeup Remover,80,160,80,2,00314,India
822631,2023-11-18,1009,Moisturizer,250,500,250,2,00314,India
822631,2023-11-18,1001,Lipstick,150,300,150,2,00314,India
822631,2023-11-18,1006,Blush,150,300,150,2,00314,India
625079,2023-11-18,1008,Makeup Remover,80,160,80,2,00343,India
625079,2023-11-18,1004,Eyeliner,100,200,100,2,00343,India
625079,2023-11-18,1002,Mascara,200,400,200,2,00343,India
452825,2023-11-18,1009,Moisturizer,250,500,250,2,00020,India
452825,2023-11-18,1002,Mascara,200,400,200,2,00020,India
452825,2023-11-18,1012,Body Lotion,200,400,200,2,00020,India
943914,2023-11-18,1006,Blush,150,300,150,2,00462,India
943914,2023-11-18,1005,Nail Polish,50,100,50,2,00462,India
943914,2023-11-18,1008,Makeup Remover,80,160,80,2,00462,India
205004,2023-11-18,1008,Makeup Remover,80,160,80,2,00212,India
205004,2023-11-18,1006,Blush,150,300,150,2,00212,India
403980,2023-11-18,1003,Foundation,300,600,300,2,00463,India
403980,2023-11-18,1005,Nail Polish,50,100,50,2,00463,India
403980,2023-11-18,1012,Body Lotion,200,400,200,2,00463,India
744973,2023-11-18,1006,Blush,150,300,150,2,00233,India
744973,2023-11-18,1003,Foundation,300,600,300,2,00233,India
184746,2023-11-18,1005,Nail Polish,50,100,50,2,00108,India
184746,2023-11-18,1002,Mascara,200,400,200,2,00108,India
184746,2023-11-18,1007,Eyeshadow,200,400,200,2,00108,India
184746,2023-11-18,1012,Body Lotion,200,400,200,2,00108,India
184746,2023-11-18,1008,Makeup Remover,80,160,80,2,00108,India
635909,2023-11-18,1012,Body Lotion,200,400,200,2,00494,India
635909,2023-11-18,1009,Moisturizer,250,500,250,2,00494,India
838164,2023-11-18,1002,Mascara,200,400,200,2,00041,India
838164,2023-11-18,1005,Nail Polish,50,100,50,2,00041,India
838164,2023-11-18,1001,Lipstick,150,300,150,2,00041,India
838164,2023-11-18,1009,Moisturizer,250,500,250,2,00041,India
192630,2023-11-18,1003,Foundation,300,600,300,2,00349,India
348053,2023-11-18,1012,Body Lotion,200,400,200,2,00303,India
348053,2023-11-18,1007,Eyeshadow,200,400,200,2,00303,India
750307,2023-11-18,1012,Body Lotion,200,400,200,2,00003,India
243096,2023-11-18,1009,Moisturizer,250,500,250,2,00383,India
243096,2023-11-18,1004,Eyeliner,100,200,100,2,00383,India
243096,2023-11-18,1001,Lipstick,150,300,150,2,00383,India
999548,2023-11-18,1002,Mascara,200,400,200,2,00046,India
999548,2023-11-18,1003,Foundation,300,600,300,2,00046,India
999548,2023-11-18,1006,Blush,150,300,150,2,00046,India
999548,2023-11-18,1005,Nail Polish,50,100,50,2,00046,India
960947,2023-11-18,1008,Makeup Remover,80,160,80,2,00007,India
693033,2023-11-18,1012,Body Lotion,200,400,200,2,00382,India
693033,2023-11-18,1004,Eyeliner,100,200,100,2,00382,India
693033,2023-11-18,1009,Moisturizer,250,500,250,2,00382,India
693033,2023-11-18,1002,Mascara,200,400,200,2,00382,India
958547,2023-11-18,1003,Foundation,300,600,300,2,00125,India
958547,2023-11-18,1007,Eyeshadow,200,400,200,2,00125,India
958547,2023-11-18,1009,Moisturizer,250,500,250,2,00125,India
574361,2023-11-19,1006,Blush,150,300,150,2,00243,India
574361,2023-11-19,1003,Foundation,300,600,300,2,00243,India
516166,2023-11-19,1006,Blush,150,300,150,2,00210,India
516166,2023-11-19,1009,Moisturizer,250,500,250,2,00210,India
516166,2023-11-19,1012,Body Lotion,200,400,200,2,00210,India
516166,2023-11-19,1008,Makeup Remover,80,160,80,2,00210,India
517815,2023-11-19,1005,Nail Polish,50,100,50,2,00004,India
758616,2023-11-19,1007,Eyeshadow,200,400,200,2,00067,India
758616,2023-11-19,1009,Moisturizer,250,500,250,2,00067,India
758616,2023-11-19,1012,Body Lotion,200,400,200,2,00067,India
758616,2023-11-19,1001,Lipstick,150,300,150,2,00067,India
155632,2023-11-19,1004,Eyeliner,100,200,100,2,00135,India
155632,2023-11-19,1003,Foundation,300,600,300,2,00135,India
510760,2023-11-19,1001,Lipstick,150,300,150,2,00066,India
510760,2023-11-19,1008,Makeup Remover,80,160,80,2,00066,India
510760,2023-11-19,1009,Moisturizer,250,500,250,2,00066,India
510760,2023-11-19,1006,Blush,150,300,150,2,00066,India
571018,2023-11-19,1009,Moisturizer,250,500,250,2,00142,India
973224,2023-11-19,1004,Eyeliner,100,200,100,2,00195,India
973224,2023-11-19,1009,Moisturizer,250,500,250,2,00195,India
973224,2023-11-19,1002,Mascara,200,400,200,2,00195,India
779357,2023-11-19,1005,Nail Polish,50,100,50,2,00386,India
518547,2023-11-19,1002,Mascara,200,400,200,2,00402,India
518547,2023-11-19,1007,Eyeshadow,200,400,200,2,00402,India
518547,2023-11-19,1005,Nail Polish,50,100,50,2,00402,India
518547,2023-11-19,1003,Foundation,300,600,300,2,00402,India
548915,2023-11-19,1006,Blush,150,300,150,2,00322,India
877001,2023-11-19,1006,Blush,150,300,150,2,00218,India
113501,2023-11-19,1003,Foundation,300,600,300,2,00449,India
113501,2023-11-19,1002,Mascara,200,400,200,2,00449,India
113501,2023-11-19,1005,Nail Polish,50,100,50,2,00449,India
113501,2023-11-19,1012,Body Lotion,200,400,200,2,00449,India
113501,2023-11-19,1004,Eyeliner,100,200,100,2,00449,India
999237,2023-11-19,1003,Foundation,300,600,300,2,00298,India
999237,2023-11-19,1006,Blush,150,300,150,2,00298,India
999237,2023-11-19,1008,Makeup Remover,80,160,80,2,00298,India
480899,2023-11-19,1001,Lipstick,150,300,150,2,00196,India
480899,2023-11-19,1009,Moisturizer,250,500,250,2,00196,India
480899,2023-11-19,1003,Foundation,300,600,300,2,00196,India
825808,2023-11-19,1002,Mascara,200,400,200,2,00102,India
825808,2023-11-19,1012,Body Lotion,200,400,200,2,00102,India
825808,2023-11-19,1003,Foundation,300,600,300,2,00102,India
373700,2023-11-19,1007,Eyeshadow,200,400,200,2,00273,India
373700,2023-11-19,1005,Nail Polish,50,100,50,2,00273,India
373700,2023-11-19,1012,Body Lotion,200,400,200,2,00273,India
373700,2023-11-19,1001,Lipstick,150,300,150,2,00273,India
683461,2023-11-19,1009,Moisturizer,250,500,250,2,00197,India
683461,2023-11-19,1004,Eyeliner,100,200,100,2,00197,India
683461,2023-11-19,1007,Eyeshadow,200,400,200,2,00197,India
567890,2023-11-19,1002,Mascara,200,400,200,2,00029,India
567890,2023-11-19,1008,Makeup Remover,80,160,80,2,00029,India
501695,2023-11-19,1002,Mascara,200,400,200,2,00189,India
758551,2023-11-19,1002,Mascara,200,400,200,2,00489,India
758551,2023-11-19,1004,Eyeliner,100,200,100,2,00489,India
586022,2023-11-19,1009,Moisturizer,250,500,250,2,00158,India
586022,2023-11-19,1006,Blush,150,300,150,2,00158,India
283699,2023-11-19,1006,Blush,150,300,150,2,00355,India
283699,2023-11-19,1007,Eyeshadow,200,400,200,2,00355,India
495538,2023-11-19,1008,Makeup Remover,80,160,80,2,00437,India
444357,2023-11-19,1009,Moisturizer,250,500,250,2,00135,India
958350,2023-11-19,1003,Foundation,300,600,300,2,00443,India
958350,2023-11-19,1012,Body Lotion,200,400,200,2,00443,India
958350,2023-11-19,1009,Moisturizer,250,500,250,2,00443,India
453643,2023-11-19,1004,Eyeliner,100,200,100,2,00150,India
453643,2023-11-19,1006,Blush,150,300,150,2,00150,India
341673,2023-11-19,1004,Eyeliner,100,200,100,2,00335,India
341673,2023-11-19,1009,Moisturizer,250,500,250,2,00335,India
129200,2023-11-19,1003,Foundation,300,600,300,2,00439,India
129200,2023-11-19,1005,Nail Polish,50,100,50,2,00439,India
129200,2023-11-19,1004,Eyeliner,100,200,100,2,00439,India
317840,2023-11-19,1002,Mascara,200,400,200,2,00468,India
317840,2023-11-19,1001,Lipstick,150,300,150,2,00468,India
317840,2023-11-19,1004,Eyeliner,100,200,100,2,00468,India
317840,2023-11-19,1009,Moisturizer,250,500,250,2,00468,India
826728,2023-11-19,1008,Makeup Remover,80,160,80,2,00068,India
826728,2023-11-19,1002,Mascara,200,400,200,2,00068,India
826728,2023-11-19,1001,Lipstick,150,300,150,2,00068,India
135509,2023-11-19,1002,Mascara,200,400,200,2,00141,India
525158,2023-11-19,1003,Foundation,300,600,300,2,00126,India
525158,2023-11-19,1005,Nail Polish,50,100,50,2,00126,India
525158,2023-11-19,1009,Moisturizer,250,500,250,2,00126,India
525158,2023-11-19,1001,Lipstick,150,300,150,2,00126,India
188343,2023-11-19,1004,Eyeliner,100,200,100,2,00363,India
531780,2023-11-19,1002,Mascara,200,400,200,2,00094,India
531780,2023-11-19,1005,Nail Polish,50,100,50,2,00094,India
531780,2023-11-19,1003,Foundation,300,600,300,2,00094,India
579923,2023-11-19,1005,Nail Polish,50,100,50,2,00016,India
579923,2023-11-19,1006,Blush,150,300,150,2,00016,India
210643,2023-11-19,1007,Eyeshadow,200,400,200,2,00031,India
210643,2023-11-19,1003,Foundation,300,600,300,2,00031,India
430110,2023-11-19,1004,Eyeliner,100,200,100,2,00234,India
430110,2023-11-19,1003,Foundation,300,600,300,2,00234,India
430110,2023-11-19,1008,Makeup Remover,80,160,80,2,00234,India
899397,2023-11-19,1001,Lipstick,150,300,150,2,00239,India
899397,2023-11-19,1006,Blush,150,300,150,2,00239,India
899397,2023-11-19,1007,Eyeshadow,200,400,200,2,00239,India
899397,2023-11-19,1002,Mascara,200,400,200,2,00239,India
358125,2023-11-19,1007,Eyeshadow,200,400,200,2,00435,India
358125,2023-11-19,1008,Makeup Remover,80,160,80,2,00435,India
358125,2023-11-19,1005,Nail Polish,50,100,50,2,00435,India
224868,2023-11-20,1003,Foundation,300,600,300,2,00184,India
224868,2023-11-20,1006,Blush,150,300,150,2,00184,India
543856,2023-11-20,1002,Mascara,200,400,200,2,00303,India
543856,2023-11-20,1007,Eyeshadow,200,400,200,2,00303,India
543856,2023-11-20,1003,Foundation,300,600,300,2,00303,India
543856,2023-11-20,1008,Makeup Remover,80,160,80,2,00303,India
489929,2023-11-20,1012,Body Lotion,200,400,200,2,00033,India
489929,2023-11-20,1008,Makeup Remover,80,160,80,2,00033,India
268958,2023-11-20,1003,Foundation,300,600,300,2,00452,India
268958,2023-11-20,1002,Mascara,200,400,200,2,00452,India
268958,2023-11-20,1008,Makeup Remover,80,160,80,2,00452,India
268958,2023-11-20,1001,Lipstick,150,300,150,2,00452,India
268958,2023-11-20,1007,Eyeshadow,200,400,200,2,00452,India
725924,2023-11-20,1002,Mascara,200,400,200,2,00396,India
725924,2023-11-20,1001,Lipstick,150,300,150,2,00396,India
725924,2023-11-20,1003,Foundation,300,600,300,2,00396,India
725924,2023-11-20,1007,Eyeshadow,200,400,200,2,00396,India
427730,2023-11-20,1005,Nail Polish,50,100,50,2,00238,India
676808,2023-11-20,1012,Body Lotion,200,400,200,2,00307,India
676808,2023-11-20,1001,Lipstick,150,300,150,2,00307,India
575807,2023-11-20,1009,Moisturizer,250,500,250,2,00306,India
575807,2023-11-20,1004,Eyeliner,100,200,100,2,00306,India
261534,2023-11-20,1006,Blush,150,300,150,2,00343,India
261534,2023-11-20,1009,Moisturizer,250,500,250,2,00343,India
261534,2023-11-20,1012,Body Lotion,200,400,200,2,00343,India
335916,2023-11-20,1005,Nail Polish,50,100,50,2,00227,India
335916,2023-11-20,1012,Body Lotion,200,400,200,2,00227,India
611991,2023-11-20,1004,Eyeliner,100,200,100,2,00348,India
611991,2023-11-20,1005,Nail Polish,50,100,50,2,00348,India
611991,2023-11-20,1002,Mascara,200,400,200,2,00348,India
611991,2023-11-20,1012,Body Lotion,200,400,200,2,00348,India
736997,2023-11-20,1002,Mascara,200,400,200,2,00416,India
736997,2023-11-20,1012,Body Lotion,200,400,200,2,00416,India
736997,2023-11-20,1006,Blush,150,300,150,2,00416,India
736997,2023-11-20,1008,Makeup Remover,80,160,80,2,00416,India
802595,2023-11-20,1004,Eyeliner,100,200,100,2,00415,India
802595,2023-11-20,1012,Body Lotion,200,400,200,2,00415,India
802595,2023-11-20,1009,Moisturizer,250,500,250,2,00415,India
802595,2023-11-20,1006,Blush,150,300,150,2,00415,India
879616,2023-11-20,1001,Lipstick,150,300,150,2,00496,India
879616,2023-11-20,1004,Eyeliner,100,200,100,2,00496,India
879616,2023-11-20,1003,Foundation,300,600,300,2,00496,India
595900,2023-11-20,1001,Lipstick,150,300,150,2,00324,India
595900,2023-11-20,1003,Foundation,300,600,300,2,00324,India
595900,2023-11-20,1002,Mascara,200,400,200,2,00324,India
595900,2023-11-20,1012,Body Lotion,200,400,200,2,00324,India
595900,2023-11-20,1008,Makeup Remover,80,160,80,2,00324,India
655382,2023-11-20,1004,Eyeliner,100,200,100,2,00283,India
655382,2023-11-20,1012,Body Lotion,200,400,200,2,00283,India
655382,2023-11-20,1001,Lipstick,150,300,150,2,00283,India
651607,2023-11-20,1002,Mascara,200,400,200,2,00084,India
651607,2023-11-20,1006,Blush,150,300,150,2,00084,India
651607,2023-11-20,1005,Nail Polish,50,100,50,2,00084,India
651607,2023-11-20,1008,Makeup Remover,80,160,80,2,00084,India
651607,2023-11-20,1001,Lipstick,150,300,150,2,00084,India
433049,2023-11-20,1008,Makeup Remover,80,160,80,2,00196,India
433049,2023-11-20,1001,Lipstick,150,300,150,2,00196,India
433049,2023-11-20,1004,Eyeliner,100,200,100,2,00196,India
433049,2023-11-20,1005,Nail Polish,50,100,50,2,00196,India
772740,2023-11-20,1007,Eyeshadow,200,400,200,2,00058,India
772740,2023-11-20,1001,Lipstick,150,300,150,2,00058,India
772740,2023-11-20,1009,Moisturizer,250,500,250,2,00058,India
772740,2023-11-20,1008,Makeup Remover,80,160,80,2,00058,India
139741,2023-11-20,1007,Eyeshadow,200,400,200,2,00312,India
139741,2023-11-20,1009,Moisturizer,250,500,250,2,00312,India
139741,2023-11-20,1005,Nail Polish,50,100,50,2,00312,India
536992,2023-11-20,1012,Body Lotion,200,400,200,2,00313,India
985781,2023-11-20,1002,Mascara,200,400,200,2,00208,India
955497,2023-11-20,1005,Nail Polish,50,100,50,2,00245,India
955497,2023-11-20,1003,Foundation,300,600,300,2,00245,India
459612,2023-11-20,1002,Mascara,200,400,200,2,00061,India
156680,2023-11-20,1008,Makeup Remover,80,160,80,2,00432,India
156680,2023-11-20,1002,Mascara,200,400,200,2,00432,India
689263,2023-11-20,1001,Lipstick,150,300,150,2,00080,India
689263,2023-11-20,1009,Moisturizer,250,500,250,2,00080,India
689263,2023-11-20,1005,Nail Polish,50,100,50,2,00080,India
716560,2023-11-20,1006,Blush,150,300,150,2,00330,India
716560,2023-11-20,1001,Lipstick,150,300,150,2,00330,India
716560,2023-11-20,1003,Foundation,300,600,300,2,00330,India
594984,2023-11-20,1006,Blush,150,300,150,2,00449,India
594984,2023-11-20,1009,Moisturizer,250,500,250,2,00449,India
594984,2023-11-20,1003,Foundation,300,600,300,2,00449,India
112578,2023-11-20,1012,Body Lotion,200,400,200,2,00214,India
289929,2023-11-20,1001,Lipstick,150,300,150,2,00246,India
289929,2023-11-20,1007,Eyeshadow,200,400,200,2,00246,India
612016,2023-11-20,1003,Foundation,300,600,300,2,00018,India
612016,2023-11-20,1006,Blush,150,300,150,2,00018,India
612016,2023-11-20,1008,Makeup Remover,80,160,80,2,00018,India
612016,2023-11-20,1005,Nail Polish,50,100,50,2,00018,India
205866,2023-11-20,1004,Eyeliner,100,200,100,2,00107,India
205866,2023-11-20,1009,Moisturizer,250,500,250,2,00107,India
270193,2023-11-20,1001,Lipstick,150,300,150,2,00239,India
270193,2023-11-20,1003,Foundation,300,600,300,2,00239,India
354445,2023-11-20,1003,Foundation,300,600,300,2,00292,India
828419,2023-11-20,1002,Mascara,200,400,200,2,00350,India
828419,2023-11-20,1006,Blush,150,300,150,2,00350,India
828419,2023-11-20,1007,Eyeshadow,200,400,200,2,00350,India
828419,2023-11-20,1012,Body Lotion,200,400,200,2,00350,India
147952,2023-11-20,1008,Makeup Remover,80,160,80,2,00281,India
230516,2023-11-20,1001,Lipstick,150,300,150,2,00020,India
230516,2023-11-20,1003,Foundation,300,600,300,2,00020,India
230516,2023-11-20,1008,Makeup Remover,80,160,80,2,00020,India
230516,2023-11-20,1004,Eyeliner,100,200,100,2,00020,India
230516,2023-11-20,1005,Nail Polish,50,100,50,2,00020,India
802961,2023-11-20,1001,Lipstick,150,300,150,2,00429,India
881996,2023-11-20,1007,Eyeshadow,200,400,200,2,00487,India
117510,2023-11-20,1012,Body Lotion,200,400,200,2,00465,India
117510,2023-11-20,1004,Eyeliner,100,200,100,2,00465,India
117510,2023-11-20,1009,Moisturizer,250,500,250,2,00465,India
117510,2023-11-20,1007,Eyeshadow,200,400,200,2,00465,India
469153,2023-11-20,1009,Moisturizer,250,500,250,2,00360,India
469153,2023-11-20,1002,Mascara,200,400,200,2,00360,India
929260,2023-11-20,1004,Eyeliner,100,200,100,2,00389,India
513025,2023-11-20,1005,Nail Polish,50,100,50,2,00160,India
513025,2023-11-20,1001,Lipstick,150,300,150,2,00160,India
513025,2023-11-20,1007,Eyeshadow,200,400,200,2,00160,India
754440,2023-11-20,1007,Eyeshadow,200,400,200,2,00219,India
754440,2023-11-20,1008,Makeup Remover,80,160,80,2,00219,India
754440,2023-11-20,1005,Nail Polish,50,100,50,2,00219,India
754440,2023-11-20,1009,Moisturizer,250,500,250,2,00219,India
592551,2023-11-20,1005,Nail Polish,50,100,50,2,00003,India
232859,2023-11-20,1009,Moisturizer,250,500,250,2,00017,India
232859,2023-11-20,1012,Body Lotion,200,400,200,2,00017,India
232859,2023-11-20,1006,Blush,150,300,150,2,00017,India
232859,2023-11-20,1005,Nail Polish,50,100,50,2,00017,India
742615,2023-11-21,1007,Eyeshadow,200,400,200,2,00414,India
742615,2023-11-21,1005,Nail Polish,50,100,50,2,00414,India
742615,2023-11-21,1002,Mascara,200,400,200,2,00414,India
576592,2023-11-21,1004,Eyeliner,100,200,100,2,00040,India
576592,2023-11-21,1005,Nail Polish,50,100,50,2,00040,India
576592,2023-11-21,1006,Blush,150,300,150,2,00040,India
794239,2023-11-21,1004,Eyeliner,100,200,100,2,00319,India
794239,2023-11-21,1007,Eyeshadow,200,400,200,2,00319,India
752128,2023-11-21,1001,Lipstick,150,300,150,2,00261,India
752128,2023-11-21,1008,Makeup Remover,80,160,80,2,00261,India
752128,2023-11-21,1012,Body Lotion,200,400,200,2,00261,India
597436,2023-11-21,1001,Lipstick,150,300,150,2,00443,India
525382,2023-11-21,1012,Body Lotion,200,400,200,2,00413,India
525382,2023-11-21,1002,Mascara,200,400,200,2,00413,India
928871,2023-11-21,1004,Eyeliner,100,200,100,2,00200,India
928871,2023-11-21,1007,Eyeshadow,200,400,200,2,00200,India
928871,2023-11-21,1003,Foundation,300,600,300,2,00200,India
928871,2023-11-21,1005,Nail Polish,50,100,50,2,00200,India
928871,2023-11-21,1001,Lipstick,150,300,150,2,00200,India
871139,2023-11-21,1004,Eyeliner,100,200,100,2,00236,India
202194,2023-11-21,1007,Eyeshadow,200,400,200,2,00357,India
439813,2023-11-21,1005,Nail Polish,50,100,50,2,00331,India
439813,2023-11-21,1008,Makeup Remover,80,160,80,2,00331,India
439813,2023-11-21,1002,Mascara,200,400,200,2,00331,India
439813,2023-11-21,1001,Lipstick,150,300,150,2,00331,India
611383,2023-11-21,1008,Makeup Remover,80,160,80,2,00145,India
611383,2023-11-21,1004,Eyeliner,100,200,100,2,00145,India
611383,2023-11-21,1003,Foundation,300,600,300,2,00145,India
301650,2023-11-21,1001,Lipstick,150,300,150,2,00458,India
301650,2023-11-21,1008,Makeup Remover,80,160,80,2,00458,India
789448,2023-11-21,1005,Nail Polish,50,100,50,2,00378,India
123989,2023-11-21,1005,Nail Polish,50,100,50,2,00130,India
123989,2023-11-21,1008,Makeup Remover,80,160,80,2,00130,India
123989,2023-11-21,1007,Eyeshadow,200,400,200,2,00130,India
123989,2023-11-21,1004,Eyeliner,100,200,100,2,00130,India
123989,2023-11-21,1002,Mascara,200,400,200,2,00130,India
628978,2023-11-21,1006,Blush,150,300,150,2,00342,India
628978,2023-11-21,1003,Foundation,300,600,300,2,00342,India
628978,2023-11-21,1005,Nail Polish,50,100,50,2,00342,India
628978,2023-11-21,1012,Body Lotion,200,400,200,2,00342,India
573147,2023-11-21,1002,Mascara,200,400,200,2,00349,India
847270,2023-11-21,1008,Makeup Remover,80,160,80,2,00239,India
537242,2023-11-21,1002,Mascara,200,400,200,2,00418,India
108205,2023-11-21,1012,Body Lotion,200,400,200,2,00381,India
777065,2023-11-21,1002,Mascara,200,400,200,2,00444,India
777065,2023-11-21,1012,Body Lotion,200,400,200,2,00444,India
777065,2023-11-21,1008,Makeup Remover,80,160,80,2,00444,India
486606,2023-11-21,1002,Mascara,200,400,200,2,00391,India
486606,2023-11-21,1001,Lipstick,150,300,150,2,00391,India
486606,2023-11-21,1003,Foundation,300,600,300,2,00391,India
486606,2023-11-21,1005,Nail Polish,50,100,50,2,00391,India
486606,2023-11-21,1009,Moisturizer,250,500,250,2,00391,India
883761,2023-11-21,1009,Moisturizer,250,500,250,2,00319,India
883761,2023-11-21,1004,Eyeliner,100,200,100,2,00319,India
883761,2023-11-21,1012,Body Lotion,200,400,200,2,00319,India
883761,2023-11-21,1003,Foundation,300,600,300,2,00319,India
329717,2023-11-21,1004,Eyeliner,100,200,100,2,00402,India
329717,2023-11-21,1002,Mascara,200,400,200,2,00402,India
146016,2023-11-21,1007,Eyeshadow,200,400,200,2,00467,India
146016,2023-11-21,1012,Body Lotion,200,400,200,2,00467,India
146016,2023-11-21,1002,Mascara,200,400,200,2,00467,India
146016,2023-11-21,1005,Nail Polish,50,100,50,2,00467,India
898726,2023-11-21,1006,Blush,150,300,150,2,00404,India
898726,2023-11-21,1004,Eyeliner,100,200,100,2,00404,India
985489,2023-11-21,1003,Foundation,300,600,300,2,00391,India
985489,2023-11-21,1007,Eyeshadow,200,400,200,2,00391,India
924743,2023-11-21,1002,Mascara,200,400,200,2,00394,India
924743,2023-11-21,1003,Foundation,300,600,300,2,00394,India
475338,2023-11-21,1004,Eyeliner,100,200,100,2,00287,India
475338,2023-11-21,1005,Nail Polish,50,100,50,2,00287,India
607530,2023-11-21,1006,Blush,150,300,150,2,00026,India
945526,2023-11-21,1001,Lipstick,150,300,150,2,00092,India
945526,2023-11-21,1004,Eyeliner,100,200,100,2,00092,India
887576,2023-11-21,1006,Blush,150,300,150,2,00376,India
887576,2023-11-21,1009,Moisturizer,250,500,250,2,00376,India
887576,2023-11-21,1002,Mascara,200,400,200,2,00376,India
887576,2023-11-21,1005,Nail Polish,50,100,50,2,00376,India
808349,2023-11-21,1001,Lipstick,150,300,150,2,00496,India
808349,2023-11-21,1004,Eyeliner,100,200,100,2,00496,India
808349,2023-11-21,1006,Blush,150,300,150,2,00496,India
808349,2023-11-21,1008,Makeup Remover,80,160,80,2,00496,India
808349,2023-11-21,1012,Body Lotion,200,400,200,2,00496,India
964001,2023-11-22,1009,Moisturizer,250,500,250,2,00402,India
676063,2023-11-22,1006,Blush,150,300,150,2,00088,India
676063,2023-11-22,1003,Foundation,300,600,300,2,00088,India
676063,2023-11-22,1007,Eyeshadow,200,400,200,2,00088,India
676063,2023-11-22,1012,Body Lotion,200,400,200,2,00088,India
104045,2023-11-22,1002,Mascara,200,400,200,2,00462,India
104045,2023-11-22,1005,Nail Polish,50,100,50,2,00462,India
104045,2023-11-22,1009,Moisturizer,250,500,250,2,00462,India
686412,2023-11-22,1008,Makeup Remover,80,160,80,2,00301,India
259248,2023-11-22,1001,Lipstick,150,300,150,2,00266,India
914113,2023-11-22,1012,Body Lotion,200,400,200,2,00080,India
914113,2023-11-22,1004,Eyeliner,100,200,100,2,00080,India
914113,2023-11-22,1006,Blush,150,300,150,2,00080,India
914113,2023-11-22,1001,Lipstick,150,300,150,2,00080,India
230643,2023-11-22,1006,Blush,150,300,150,2,00375,India
230643,2023-11-22,1002,Mascara,200,400,200,2,00375,India
217984,2023-11-22,1012,Body Lotion,200,400,200,2,00165,India
217984,2023-11-22,1002,Mascara,200,400,200,2,00165,India
217984,2023-11-22,1003,Foundation,300,600,300,2,00165,India
217984,2023-11-22,1005,Nail Polish,50,100,50,2,00165,India
217984,2023-11-22,1001,Lipstick,150,300,150,2,00165,India
380174,2023-11-22,1008,Makeup Remover,80,160,80,2,00250,India
380174,2023-11-22,1012,Body Lotion,200,400,200,2,00250,India
380174,2023-11-22,1009,Moisturizer,250,500,250,2,00250,India
562791,2023-11-22,1002,Mascara,200,400,200,2,00041,India
562791,2023-11-22,1007,Eyeshadow,200,400,200,2,00041,India
562791,2023-11-22,1009,Moisturizer,250,500,250,2,00041,India
548985,2023-11-22,1003,Foundation,300,600,300,2,00419,India
611355,2023-11-22,1004,Eyeliner,100,200,100,2,00434,India
611355,2023-11-22,1008,Makeup Remover,80,160,80,2,00434,India
109566,2023-11-22,1003,Foundation,300,600,300,2,00375,India
300210,2023-11-22,1006,Blush,150,300,150,2,00269,India
300210,2023-11-22,1004,Eyeliner,100,200,100,2,00269,India
300210,2023-11-22,1012,Body Lotion,200,400,200,2,00269,India
300210,2023-11-22,1003,Foundation,300,600,300,2,00269,India
300210,2023-11-22,1008,Makeup Remover,80,160,80,2,00269,India
552367,2023-11-22,1001,Lipstick,150,300,150,2,00209,India
552367,2023-11-22,1007,Eyeshadow,200,400,200,2,00209,India
552367,2023-11-22,1005,Nail Polish,50,100,50,2,00209,India
552367,2023-11-22,1008,Makeup Remover,80,160,80,2,00209,India
103995,2023-11-22,1003,Foundation,300,600,300,2,00114,India
103995,2023-11-22,1008,Makeup Remover,80,160,80,2,00114,India
467071,2023-11-22,1008,Makeup Remover,80,160,80,2,00044,India
467071,2023-11-22,1002,Mascara,200,400,200,2,00044,India
467071,2023-11-22,1012,Body Lotion,200,400,200,2,00044,India
467071,2023-11-22,1001,Lipstick,150,300,150,2,00044,India
467071,2023-11-22,1007,Eyeshadow,200,400,200,2,00044,India
782341,2023-11-22,1005,Nail Polish,50,100,50,2,00116,India
782341,2023-11-22,1012,Body Lotion,200,400,200,2,00116,India
942826,2023-11-22,1004,Eyeliner,100,200,100,2,00230,India
942826,2023-11-22,1005,Nail Polish,50,100,50,2,00230,India
271546,2023-11-22,1004,Eyeliner,100,200,100,2,00375,India
716136,2023-11-22,1002,Mascara,200,400,200,2,00172,India
716136,2023-11-22,1008,Makeup Remover,80,160,80,2,00172,India
843488,2023-11-22,1004,Eyeliner,100,200,100,2,00282,India
843488,2023-11-22,1006,Blush,150,300,150,2,00282,India
843488,2023-11-22,1001,Lipstick,150,300,150,2,00282,India
116591,2023-11-22,1005,Nail Polish,50,100,50,2,00037,India
116591,2023-11-22,1008,Makeup Remover,80,160,80,2,00037,India
116591,2023-11-22,1012,Body Lotion,200,400,200,2,00037,India
540774,2023-11-22,1006,Blush,150,300,150,2,00433,India
540774,2023-11-22,1003,Foundation,300,600,300,2,00433,India
431834,2023-11-22,1003,Foundation,300,600,300,2,00267,India
431834,2023-11-22,1001,Lipstick,150,300,150,2,00267,India
378901,2023-11-22,1008,Makeup Remover,80,160,80,2,00004,India
378901,2023-11-22,1004,Eyeliner,100,200,100,2,00004,India
885012,2023-11-22,1007,Eyeshadow,200,400,200,2,00221,India
885012,2023-11-22,1005,Nail Polish,50,100,50,2,00221,India
492776,2023-11-22,1005,Nail Polish,50,100,50,2,00001,India
492776,2023-11-22,1004,Eyeliner,100,200,100,2,00001,India
492776,2023-11-22,1008,Makeup Remover,80,160,80,2,00001,India
492776,2023-11-22,1001,Lipstick,150,300,150,2,00001,India
292673,2023-11-22,1009,Moisturizer,250,500,250,2,00465,India
292673,2023-11-22,1002,Mascara,200,400,200,2,00465,India
292673,2023-11-22,1004,Eyeliner,100,200,100,2,00465,India
652811,2023-11-22,1003,Foundation,300,600,300,2,00035,India
652811,2023-11-22,1001,Lipstick,150,300,150,2,00035,India
652811,2023-11-22,1012,Body Lotion,200,400,200,2,00035,India
652811,2023-11-22,1006,Blush,150,300,150,2,00035,India
505915,2023-11-22,1002,Mascara,200,400,200,2,00105,India
505915,2023-11-22,1008,Makeup Remover,80,160,80,2,00105,India
505915,2023-11-22,1004,Eyeliner,100,200,100,2,00105,India
891199,2023-11-22,1001,Lipstick,150,300,150,2,00166,India
891199,2023-11-22,1009,Moisturizer,250,500,250,2,00166,India
891199,2023-11-22,1012,Body Lotion,200,400,200,2,00166,India
891199,2023-11-22,1006,Blush,150,300,150,2,00166,India
699530,2023-11-22,1005,Nail Polish,50,100,50,2,00437,India
699530,2023-11-22,1006,Blush,150,300,150,2,00437,India
699530,2023-11-22,1003,Foundation,300,600,300,2,00437,India
699530,2023-11-22,1004,Eyeliner,100,200,100,2,00437,India
699530,2023-11-22,1001,Lipstick,150,300,150,2,00437,India
909805,2023-11-22,1012,Body Lotion,200,400,200,2,00430,India
909805,2023-11-22,1005,Nail Polish,50,100,50,2,00430,India
909805,2023-11-22,1002,Mascara,200,400,200,2,00430,India
909805,2023-11-22,1003,Foundation,300,600,300,2,00430,India
544801,2023-11-22,1002,Mascara,200,400,200,2,00122,India
544801,2023-11-22,1008,Makeup Remover,80,160,80,2,00122,India
544801,2023-11-22,1006,Blush,150,300,150,2,00122,India
628361,2023-11-22,1003,Foundation,300,600,300,2,00147,India
628361,2023-11-22,1001,Lipstick,150,300,150,2,00147,India
604124,2023-11-23,1008,Makeup Remover,80,160,80,2,00098,India
604124,2023-11-23,1003,Foundation,300,600,300,2,00098,India
604124,2023-11-23,1002,Mascara,200,400,200,2,00098,India
604124,2023-11-23,1001,Lipstick,150,300,150,2,00098,India
249389,2023-11-23,1007,Eyeshadow,200,400,200,2,00176,India
249389,2023-11-23,1005,Nail Polish,50,100,50,2,00176,India
249389,2023-11-23,1006,Blush,150,300,150,2,00176,India
249389,2023-11-23,1004,Eyeliner,100,200,100,2,00176,India
669017,2023-11-23,1004,Eyeliner,100,200,100,2,00362,India
669017,2023-11-23,1012,Body Lotion,200,400,200,2,00362,India
669017,2023-11-23,1006,Blush,150,300,150,2,00362,India
669017,2023-11-23,1003,Foundation,300,600,300,2,00362,India
361828,2023-11-23,1008,Makeup Remover,80,160,80,2,00203,India
361828,2023-11-23,1004,Eyeliner,100,200,100,2,00203,India
361828,2023-11-23,1001,Lipstick,150,300,150,2,00203,India
361828,2023-11-23,1005,Nail Polish,50,100,50,2,00203,India
361828,2023-11-23,1007,Eyeshadow,200,400,200,2,00203,India
363695,2023-11-23,1007,Eyeshadow,200,400,200,2,00290,India
363695,2023-11-23,1001,Lipstick,150,300,150,2,00290,India
363695,2023-11-23,1003,Foundation,300,600,300,2,00290,India
876045,2023-11-23,1001,Lipstick,150,300,150,2,00303,India
876045,2023-11-23,1003,Foundation,300,600,300,2,00303,India
234410,2023-11-23,1007,Eyeshadow,200,400,200,2,00281,India
234410,2023-11-23,1003,Foundation,300,600,300,2,00281,India
234410,2023-11-23,1002,Mascara,200,400,200,2,00281,India
234410,2023-11-23,1001,Lipstick,150,300,150,2,00281,India
234410,2023-11-23,1005,Nail Polish,50,100,50,2,00281,India
590800,2023-11-23,1001,Lipstick,150,300,150,2,00215,India
590800,2023-11-23,1007,Eyeshadow,200,400,200,2,00215,India
541027,2023-11-23,1009,Moisturizer,250,500,250,2,00153,India
541027,2023-11-23,1012,Body Lotion,200,400,200,2,00153,India
541027,2023-11-23,1004,Eyeliner,100,200,100,2,00153,India
541027,2023-11-23,1006,Blush,150,300,150,2,00153,India
705693,2023-11-23,1008,Makeup Remover,80,160,80,2,00159,India
705693,2023-11-23,1001,Lipstick,150,300,150,2,00159,India
705693,2023-11-23,1009,Moisturizer,250,500,250,2,00159,India
705693,2023-11-23,1005,Nail Polish,50,100,50,2,00159,India
692696,2023-11-23,1003,Foundation,300,600,300,2,00377,India
692696,2023-11-23,1012,Body Lotion,200,400,200,2,00377,India
692696,2023-11-23,1006,Blush,150,300,150,2,00377,India
724954,2023-11-23,1007,Eyeshadow,200,400,200,2,00096,India
724954,2023-11-23,1005,Nail Polish,50,100,50,2,00096,India
724954,2023-11-23,1008,Makeup Remover,80,160,80,2,00096,India
369860,2023-11-23,1012,Body Lotion,200,400,200,2,00399,India
369860,2023-11-23,1002,Mascara,200,400,200,2,00399,India
369860,2023-11-23,1001,Lipstick,150,300,150,2,00399,India
863308,2023-11-23,1008,Makeup Remover,80,160,80,2,00432,India
863308,2023-11-23,1001,Lipstick,150,300,150,2,00432,India
880932,2023-11-23,1007,Eyeshadow,200,400,200,2,00435,India
880932,2023-11-23,1008,Makeup Remover,80,160,80,2,00435,India
547231,2023-11-23,1012,Body Lotion,200,400,200,2,00329,India
547231,2023-11-23,1006,Blush,150,300,150,2,00329,India
547231,2023-11-23,1005,Nail Polish,50,100,50,2,00329,India
547231,2023-11-23,1008,Makeup Remover,80,160,80,2,00329,India
699276,2023-11-23,1003,Foundation,300,600,300,2,00165,India
699276,2023-11-23,1009,Moisturizer,250,500,250,2,00165,India
699276,2023-11-23,1007,Eyeshadow,200,400,200,2,00165,India
470499,2023-11-23,1005,Nail Polish,50,100,50,2,00047,India
470499,2023-11-23,1012,Body Lotion,200,400,200,2,00047,India
527995,2023-11-23,1012,Body Lotion,200,400,200,2,00119,India
527995,2023-11-23,1001,Lipstick,150,300,150,2,00119,India
680329,2023-11-23,1003,Foundation,300,600,300,2,00325,India
680329,2023-11-23,1012,Body Lotion,200,400,200,2,00325,India
743506,2023-11-23,1007,Eyeshadow,200,400,200,2,00046,India
743506,2023-11-23,1003,Foundation,300,600,300,2,00046,India
622629,2023-11-23,1008,Makeup Remover,80,160,80,2,00411,India
622629,2023-11-23,1001,Lipstick,150,300,150,2,00411,India
622629,2023-11-23,1003,Foundation,300,600,300,2,00411,India
403712,2023-11-23,1001,Lipstick,150,300,150,2,00111,India
403712,2023-11-23,1009,Moisturizer,250,500,250,2,00111,India
403712,2023-11-23,1003,Foundation,300,600,300,2,00111,India
403712,2023-11-23,1002,Mascara,200,400,200,2,00111,India
551932,2023-11-23,1004,Eyeliner,100,200,100,2,00401,India
551932,2023-11-23,1009,Moisturizer,250,500,250,2,00401,India
551932,2023-11-23,1006,Blush,150,300,150,2,00401,India
551932,2023-11-23,1001,Lipstick,150,300,150,2,00401,India
351685,2023-11-23,1012,Body Lotion,200,400,200,2,00482,India
351685,2023-11-23,1007,Eyeshadow,200,400,200,2,00482,India
448435,2023-11-23,1004,Eyeliner,100,200,100,2,00317,India
448435,2023-11-23,1009,Moisturizer,250,500,250,2,00317,India
854770,2023-11-23,1005,Nail Polish,50,100,50,2,00446,India
854770,2023-11-23,1003,Foundation,300,600,300,2,00446,India
854770,2023-11-23,1009,Moisturizer,250,500,250,2,00446,India
854770,2023-11-23,1004,Eyeliner,100,200,100,2,00446,India
854770,2023-11-23,1007,Eyeshadow,200,400,200,2,00446,India
510889,2023-11-23,1005,Nail Polish,50,100,50,2,00150,India
842937,2023-11-23,1004,Eyeliner,100,200,100,2,00286,India
865723,2023-11-23,1007,Eyeshadow,200,400,200,2,00305,India
865723,2023-11-23,1003,Foundation,300,600,300,2,00305,India
330229,2023-11-23,1002,Mascara,200,400,200,2,00466,India
136875,2023-11-23,1003,Foundation,300,600,300,2,00212,India
629184,2023-11-23,1003,Foundation,300,600,300,2,00409,India
629184,2023-11-23,1001,Lipstick,150,300,150,2,00409,India
744255,2023-11-23,1004,Eyeliner,100,200,100,2,00359,India
744255,2023-11-23,1006,Blush,150,300,150,2,00359,India
744255,2023-11-23,1005,Nail Polish,50,100,50,2,00359,India
978927,2023-11-23,1009,Moisturizer,250,500,250,2,00440,India
978927,2023-11-23,1008,Makeup Remover,80,160,80,2,00440,India
978927,2023-11-23,1005,Nail Polish,50,100,50,2,00440,India
978927,2023-11-23,1002,Mascara,200,400,200,2,00440,India
922764,2023-11-23,1009,Moisturizer,250,500,250,2,00230,India
922764,2023-11-23,1006,Blush,150,300,150,2,00230,India
661927,2023-11-23,1012,Body Lotion,200,400,200,2,00149,India
661927,2023-11-23,1001,Lipstick,150,300,150,2,00149,India
467684,2023-11-23,1005,Nail Polish,50,100,50,2,00413,India
467684,2023-11-23,1001,Lipstick,150,300,150,2,00413,India
467684,2023-11-23,1002,Mascara,200,400,200,2,00413,India
467684,2023-11-23,1007,Eyeshadow,200,400,200,2,00413,India
467684,2023-11-23,1008,Makeup Remover,80,160,80,2,00413,India
881671,2023-11-23,1005,Nail Polish,50,100,50,2,00055,India
662417,2023-11-23,1007,Eyeshadow,200,400,200,2,00477,India
662417,2023-11-23,1008,Makeup Remover,80,160,80,2,00477,India
381100,2023-11-23,1005,Nail Polish,50,100,50,2,00224,India
891453,2023-11-23,1007,Eyeshadow,200,400,200,2,00016,India
891453,2023-11-23,1009,Moisturizer,250,500,250,2,00016,India
891453,2023-11-23,1003,Foundation,300,600,300,2,00016,India
891453,2023-11-23,1012,Body Lotion,200,400,200,2,00016,India
967753,2023-11-23,1009,Moisturizer,250,500,250,2,00425,India
967753,2023-11-23,1002,Mascara,200,400,200,2,00425,India
304243,2023-11-23,1012,Body Lotion,200,400,200,2,00435,India
304243,2023-11-23,1005,Nail Polish,50,100,50,2,00435,India
304243,2023-11-23,1008,Makeup Remover,80,160,80,2,00435,India
304243,2023-11-23,1003,Foundation,300,600,300,2,00435,India
191668,2023-11-23,1004,Eyeliner,100,200,100,2,00411,India
191668,2023-11-23,1003,Foundation,300,600,300,2,00411,India
191668,2023-11-23,1009,Moisturizer,250,500,250,2,00411,India
191668,2023-11-23,1002,Mascara,200,400,200,2,00411,India
123771,2023-11-23,1009,Moisturizer,250,500,250,2,00222,India
123771,2023-11-23,1007,Eyeshadow,200,400,200,2,00222,India
123771,2023-11-23,1005,Nail Polish,50,100,50,2,00222,India
474966,2023-11-23,1006,Blush,150,300,150,2,00206,India
886341,2023-11-24,1006,Blush,150,300,150,2,00462,India
886341,2023-11-24,1001,Lipstick,150,300,150,2,00462,India
886341,2023-11-24,1007,Eyeshadow,200,400,200,2,00462,India
886341,2023-11-24,1005,Nail Polish,50,100,50,2,00462,India
598914,2023-11-24,1008,Makeup Remover,80,160,80,2,00274,India
362789,2023-11-24,1004,Eyeliner,100,200,100,2,00148,India
765216,2023-11-24,1005,Nail Polish,50,100,50,2,00172,India
765216,2023-11-24,1008,Makeup Remover,80,160,80,2,00172,India
765216,2023-11-24,1009,Moisturizer,250,500,250,2,00172,India
168687,2023-11-24,1006,Blush,150,300,150,2,00464,India
168687,2023-11-24,1009,Moisturizer,250,500,250,2,00464,India
168687,2023-11-24,1005,Nail Polish,50,100,50,2,00464,India
168687,2023-11-24,1003,Foundation,300,600,300,2,00464,India
190767,2023-11-24,1009,Moisturizer,250,500,250,2,00472,India
190767,2023-11-24,1005,Nail Polish,50,100,50,2,00472,India
190767,2023-11-24,1006,Blush,150,300,150,2,00472,India
810238,2023-11-24,1007,Eyeshadow,200,400,200,2,00435,India
810238,2023-11-24,1003,Foundation,300,600,300,2,00435,India
810238,2023-11-24,1001,Lipstick,150,300,150,2,00435,India
810238,2023-11-24,1004,Eyeliner,100,200,100,2,00435,India
739629,2023-11-24,1002,Mascara,200,400,200,2,00042,India
946981,2023-11-24,1002,Mascara,200,400,200,2,00379,India
168186,2023-11-24,1001,Lipstick,150,300,150,2,00485,India
168186,2023-11-24,1004,Eyeliner,100,200,100,2,00485,India
168186,2023-11-24,1006,Blush,150,300,150,2,00485,India
733665,2023-11-24,1007,Eyeshadow,200,400,200,2,00136,India
733665,2023-11-24,1005,Nail Polish,50,100,50,2,00136,India
733665,2023-11-24,1001,Lipstick,150,300,150,2,00136,India
982668,2023-11-24,1001,Lipstick,150,300,150,2,00068,India
982668,2023-11-24,1002,Mascara,200,400,200,2,00068,India
982668,2023-11-24,1009,Moisturizer,250,500,250,2,00068,India
982668,2023-11-24,1005,Nail Polish,50,100,50,2,00068,India
136272,2023-11-24,1006,Blush,150,300,150,2,00296,India
131233,2023-11-24,1008,Makeup Remover,80,160,80,2,00263,India
131233,2023-11-24,1003,Foundation,300,600,300,2,00263,India
131233,2023-11-24,1002,Mascara,200,400,200,2,00263,India
131233,2023-11-24,1009,Moisturizer,250,500,250,2,00263,India
880561,2023-11-24,1001,Lipstick,150,300,150,2,00318,India
880561,2023-11-24,1003,Foundation,300,600,300,2,00318,India
880561,2023-11-24,1005,Nail Polish,50,100,50,2,00318,India
451735,2023-11-24,1006,Blush,150,300,150,2,00079,India
633561,2023-11-24,1003,Foundation,300,600,300,2,00295,India
302143,2023-11-24,1004,Eyeliner,100,200,100,2,00399,India
302143,2023-11-24,1012,Body Lotion,200,400,200,2,00399,India
302143,2023-11-24,1005,Nail Polish,50,100,50,2,00399,India
227957,2023-11-24,1012,Body Lotion,200,400,200,2,00311,India
227957,2023-11-24,1007,Eyeshadow,200,400,200,2,00311,India
187890,2023-11-24,1003,Foundation,300,600,300,2,00057,India
187890,2023-11-24,1012,Body Lotion,200,400,200,2,00057,India
187890,2023-11-24,1002,Mascara,200,400,200,2,00057,India
187890,2023-11-24,1008,Makeup Remover,80,160,80,2,00057,India
560445,2023-11-24,1006,Blush,150,300,150,2,00391,India
560445,2023-11-24,1008,Makeup Remover,80,160,80,2,00391,India
100226,2023-11-24,1012,Body Lotion,200,400,200,2,00500,India
100226,2023-11-24,1006,Blush,150,300,150,2,00500,India
714124,2023-11-24,1004,Eyeliner,100,200,100,2,00395,India
370637,2023-11-24,1005,Nail Polish,50,100,50,2,00133,India
370637,2023-11-24,1012,Body Lotion,200,400,200,2,00133,India
370637,2023-11-24,1009,Moisturizer,250,500,250,2,00133,India
370637,2023-11-24,1008,Makeup Remover,80,160,80,2,00133,India
546082,2023-11-24,1006,Blush,150,300,150,2,00263,India
546082,2023-11-24,1001,Lipstick,150,300,150,2,00263,India
546082,2023-11-24,1008,Makeup Remover,80,160,80,2,00263,India
546082,2023-11-24,1005,Nail Polish,50,100,50,2,00263,India
546082,2023-11-24,1004,Eyeliner,100,200,100,2,00263,India
813104,2023-11-24,1007,Eyeshadow,200,400,200,2,00078,India
813104,2023-11-24,1009,Moisturizer,250,500,250,2,00078,India
813104,2023-11-24,1006,Blush,150,300,150,2,00078,India
210269,2023-11-24,1001,Lipstick,150,300,150,2,00013,India
210269,2023-11-24,1003,Foundation,300,600,300,2,00013,India
468479,2023-11-24,1009,Moisturizer,250,500,250,2,00420,India
468479,2023-11-24,1002,Mascara,200,400,200,2,00420,India
468479,2023-11-24,1004,Eyeliner,100,200,100,2,00420,India
939125,2023-11-24,1003,Foundation,300,600,300,2,00362,India
386990,2023-11-24,1007,Eyeshadow,200,400,200,2,00256,India
386990,2023-11-24,1012,Body Lotion,200,400,200,2,00256,India
386990,2023-11-24,1008,Makeup Remover,80,160,80,2,00256,India
386990,2023-11-24,1006,Blush,150,300,150,2,00256,India
460996,2023-11-24,1012,Body Lotion,200,400,200,2,00314,India
361406,2023-11-24,1008,Makeup Remover,80,160,80,2,00126,India
361406,2023-11-24,1006,Blush,150,300,150,2,00126,India
181040,2023-11-24,1005,Nail Polish,50,100,50,2,00220,India
260744,2023-11-24,1005,Nail Polish,50,100,50,2,00258,India
260744,2023-11-24,1006,Blush,150,300,150,2,00258,India
260744,2023-11-24,1004,Eyeliner,100,200,100,2,00258,India
260744,2023-11-24,1001,Lipstick,150,300,150,2,00258,India
260744,2023-11-24,1008,Makeup Remover,80,160,80,2,00258,India
702480,2023-11-24,1008,Makeup Remover,80,160,80,2,00091,India
564614,2023-11-24,1008,Makeup Remover,80,160,80,2,00267,India
564614,2023-11-24,1009,Moisturizer,250,500,250,2,00267,India
845359,2023-11-24,1006,Blush,150,300,150,2,00038,India
845359,2023-11-24,1009,Moisturizer,250,500,250,2,00038,India
845359,2023-11-24,1012,Body Lotion,200,400,200,2,00038,India
793458,2023-11-24,1003,Foundation,300,600,300,2,00368,India
793458,2023-11-24,1006,Blush,150,300,150,2,00368,India
793458,2023-11-24,1004,Eyeliner,100,200,100,2,00368,India
793458,2023-11-24,1002,Mascara,200,400,200,2,00368,India
487108,2023-11-24,1012,Body Lotion,200,400,200,2,00124,India
487108,2023-11-24,1001,Lipstick,150,300,150,2,00124,India
487108,2023-11-24,1009,Moisturizer,250,500,250,2,00124,India
487108,2023-11-24,1004,Eyeliner,100,200,100,2,00124,India
301390,2023-11-24,1005,Nail Polish,50,100,50,2,00132,India
668751,2023-11-24,1005,Nail Polish,50,100,50,2,00288,India
668751,2023-11-24,1012,Body Lotion,200,400,200,2,00288,India
668751,2023-11-24,1003,Foundation,300,600,300,2,00288,India
668751,2023-11-24,1008,Makeup Remover,80,160,80,2,00288,India
541427,2023-11-24,1001,Lipstick,150,300,150,2,00043,India
541427,2023-11-24,1012,Body Lotion,200,400,200,2,00043,India
541427,2023-11-24,1008,Makeup Remover,80,160,80,2,00043,India
541427,2023-11-24,1007,Eyeshadow,200,400,200,2,00043,India
692299,2023-11-24,1009,Moisturizer,250,500,250,2,00316,India
993963,2023-11-24,1005,Nail Polish,50,100,50,2,00348,India
993963,2023-11-24,1006,Blush,150,300,150,2,00348,India
627694,2023-11-24,1002,Mascara,200,400,200,2,00482,India
574187,2023-11-24,1005,Nail Polish,50,100,50,2,00172,India
574187,2023-11-24,1002,Mascara,200,400,200,2,00172,India
219476,2023-11-24,1009,Moisturizer,250,500,250,2,00313,India
219476,2023-11-24,1012,Body Lotion,200,400,200,2,00313,India
219476,2023-11-24,1008,Makeup Remover,80,160,80,2,00313,India
774798,2023-11-24,1001,Lipstick,150,300,150,2,00187,India
481464,2023-11-24,1012,Body Lotion,200,400,200,2,00143,India
481464,2023-11-24,1009,Moisturizer,250,500,250,2,00143,India
481464,2023-11-24,1006,Blush,150,300,150,2,00143,India
640761,2023-11-24,1007,Eyeshadow,200,400,200,2,00176,India
640761,2023-11-24,1003,Foundation,300,600,300,2,00176,India
640761,2023-11-24,1005,Nail Polish,50,100,50,2,00176,India
360593,2023-11-25,1003,Foundation,300,600,300,2,00390,India
360593,2023-11-25,1001,Lipstick,150,300,150,2,00390,India
360593,2023-11-25,1006,Blush,150,300,150,2,00390,India
931982,2023-11-25,1003,Foundation,300,600,300,2,00190,India
518249,2023-11-25,1012,Body Lotion,200,400,200,2,00465,India
224247,2023-11-25,1004,Eyeliner,100,200,100,2,00339,India
224247,2023-11-25,1003,Foundation,300,600,300,2,00339,India
224247,2023-11-25,1007,Eyeshadow,200,400,200,2,00339,India
678922,2023-11-25,1006,Blush,150,300,150,2,00005,India
678922,2023-11-25,1005,Nail Polish,50,100,50,2,00005,India
678922,2023-11-25,1007,Eyeshadow,200,400,200,2,00005,India
648214,2023-11-25,1003,Foundation,300,600,300,2,00056,India
648214,2023-11-25,1004,Eyeliner,100,200,100,2,00056,India
648214,2023-11-25,1001,Lipstick,150,300,150,2,00056,India
880928,2023-11-25,1012,Body Lotion,200,400,200,2,00454,India
880928,2023-11-25,1002,Mascara,200,400,200,2,00454,India
936954,2023-11-25,1001,Lipstick,150,300,150,2,00206,India
936954,2023-11-25,1004,Eyeliner,100,200,100,2,00206,India
936954,2023-11-25,1002,Mascara,200,400,200,2,00206,India
936954,2023-11-25,1007,Eyeshadow,200,400,200,2,00206,India
936954,2023-11-25,1012,Body Lotion,200,400,200,2,00206,India
695218,2023-11-25,1007,Eyeshadow,200,400,200,2,00021,India
695218,2023-11-25,1008,Makeup Remover,80,160,80,2,00021,India
695218,2023-11-25,1004,Eyeliner,100,200,100,2,00021,India
695218,2023-11-25,1002,Mascara,200,400,200,2,00021,India
260054,2023-11-25,1006,Blush,150,300,150,2,00276,India
260054,2023-11-25,1001,Lipstick,150,300,150,2,00276,India
260054,2023-11-25,1002,Mascara,200,400,200,2,00276,India
757625,2023-11-25,1008,Makeup Remover,80,160,80,2,00334,India
324559,2023-11-25,1012,Body Lotion,200,400,200,2,00477,India
562979,2023-11-25,1002,Mascara,200,400,200,2,00283,India
562979,2023-11-25,1012,Body Lotion,200,400,200,2,00283,India
562979,2023-11-25,1004,Eyeliner,100,200,100,2,00283,India
562979,2023-11-25,1009,Moisturizer,250,500,250,2,00283,India
542538,2023-11-25,1001,Lipstick,150,300,150,2,00432,India
542538,2023-11-25,1009,Moisturizer,250,500,250,2,00432,India
682716,2023-11-25,1004,Eyeliner,100,200,100,2,00147,India
682716,2023-11-25,1006,Blush,150,300,150,2,00147,India
682716,2023-11-25,1005,Nail Polish,50,100,50,2,00147,India
682716,2023-11-25,1008,Makeup Remover,80,160,80,2,00147,India
453836,2023-11-25,1007,Eyeshadow,200,400,200,2,00268,India
453836,2023-11-25,1002,Mascara,200,400,200,2,00268,India
453836,2023-11-25,1006,Blush,150,300,150,2,00268,India
453836,2023-11-25,1005,Nail Polish,50,100,50,2,00268,India
453836,2023-11-25,1008,Makeup Remover,80,160,80,2,00268,India
397991,2023-11-25,1003,Foundation,300,600,300,2,00162,India
397991,2023-11-25,1001,Lipstick,150,300,150,2,00162,India
397991,2023-11-25,1005,Nail Polish,50,100,50,2,00162,India
944189,2023-11-25,1007,Eyeshadow,200,400,200,2,00236,India
315085,2023-11-25,1002,Mascara,200,400,200,2,00295,India
315085,2023-11-25,1007,Eyeshadow,200,400,200,2,00295,India
315085,2023-11-25,1005,Nail Polish,50,100,50,2,00295,India
619595,2023-11-25,1005,Nail Polish,50,100,50,2,00347,India
650640,2023-11-25,1012,Body Lotion,200,400,200,2,00254,India
650640,2023-11-25,1004,Eyeliner,100,200,100,2,00254,India
650640,2023-11-25,1008,Makeup Remover,80,160,80,2,00254,India
650640,2023-11-25,1002,Mascara,200,400,200,2,00254,India
498182,2023-11-25,1009,Moisturizer,250,500,250,2,00176,India
498182,2023-11-25,1004,Eyeliner,100,200,100,2,00176,India
498182,2023-11-25,1005,Nail Polish,50,100,50,2,00176,India
713237,2023-11-25,1001,Lipstick,150,300,150,2,00406,India
713237,2023-11-25,1002,Mascara,200,400,200,2,00406,India
713237,2023-11-25,1007,Eyeshadow,200,400,200,2,00406,India
713237,2023-11-25,1008,Makeup Remover,80,160,80,2,00406,India
636852,2023-11-25,1005,Nail Polish,50,100,50,2,00479,India
636852,2023-11-25,1002,Mascara,200,400,200,2,00479,India
636852,2023-11-25,1012,Body Lotion,200,400,200,2,00479,India
636852,2023-11-25,1004,Eyeliner,100,200,100,2,00479,India
636852,2023-11-25,1007,Eyeshadow,200,400,200,2,00479,India
771661,2023-11-25,1009,Moisturizer,250,500,250,2,00070,India
771661,2023-11-25,1005,Nail Polish,50,100,50,2,00070,India
771661,2023-11-25,1007,Eyeshadow,200,400,200,2,00070,India
948557,2023-11-25,1002,Mascara,200,400,200,2,00398,India
773128,2023-11-25,1012,Body Lotion,200,400,200,2,00282,India
773128,2023-11-25,1007,Eyeshadow,200,400,200,2,00282,India
773128,2023-11-25,1005,Nail Polish,50,100,50,2,00282,India
215630,2023-11-25,1003,Foundation,300,600,300,2,00175,India
215630,2023-11-25,1012,Body Lotion,200,400,200,2,00175,India
611451,2023-11-25,1005,Nail Polish,50,100,50,2,00457,India
611451,2023-11-25,1002,Mascara,200,400,200,2,00457,India
584357,2023-11-25,1006,Blush,150,300,150,2,00125,India
584357,2023-11-25,1007,Eyeshadow,200,400,200,2,00125,India
269566,2023-11-25,1007,Eyeshadow,200,400,200,2,00255,India
269566,2023-11-25,1006,Blush,150,300,150,2,00255,India
926630,2023-11-25,1012,Body Lotion,200,400,200,2,00097,India
926630,2023-11-25,1002,Mascara,200,400,200,2,00097,India
456765,2023-11-25,1001,Lipstick,150,300,150,2,00194,India
456765,2023-11-25,1002,Mascara,200,400,200,2,00194,India
456765,2023-11-25,1008,Makeup Remover,80,160,80,2,00194,India
456765,2023-11-25,1005,Nail Polish,50,100,50,2,00194,India
645830,2023-11-25,1004,Eyeliner,100,200,100,2,00349,India
172086,2023-11-25,1003,Foundation,300,600,300,2,00085,India
172086,2023-11-25,1006,Blush,150,300,150,2,00085,India
442052,2023-11-25,1006,Blush,150,300,150,2,00454,India
442052,2023-11-25,1008,Makeup Remover,80,160,80,2,00454,India
442052,2023-11-25,1012,Body Lotion,200,400,200,2,00454,India
525340,2023-11-25,1012,Body Lotion,200,400,200,2,00274,India
525340,2023-11-25,1006,Blush,150,300,150,2,00274,India
525340,2023-11-25,1004,Eyeliner,100,200,100,2,00274,India
832594,2023-11-25,1012,Body Lotion,200,400,200,2,00112,India
277830,2023-11-25,1012,Body Lotion,200,400,200,2,00194,India
277830,2023-11-25,1006,Blush,150,300,150,2,00194,India
277830,2023-11-25,1003,Foundation,300,600,300,2,00194,India
277830,2023-11-25,1009,Moisturizer,250,500,250,2,00194,India
281061,2023-11-25,1004,Eyeliner,100,200,100,2,00394,India
281061,2023-11-25,1008,Makeup Remover,80,160,80,2,00394,India
545470,2023-11-25,1002,Mascara,200,400,200,2,00051,India
545470,2023-11-25,1007,Eyeshadow,200,400,200,2,00051,India
545470,2023-11-25,1008,Makeup Remover,80,160,80,2,00051,India
660805,2023-11-25,1005,Nail Polish,50,100,50,2,00262,India
310131,2023-11-26,1006,Blush,150,300,150,2,00127,India
310131,2023-11-26,1001,Lipstick,150,300,150,2,00127,India
310131,2023-11-26,1005,Nail Polish,50,100,50,2,00127,India
310131,2023-11-26,1004,Eyeliner,100,200,100,2,00127,India
310131,2023-11-26,1003,Foundation,300,600,300,2,00127,India
366309,2023-11-26,1008,Makeup Remover,80,160,80,2,00244,India
366309,2023-11-26,1002,Mascara,200,400,200,2,00244,India
366309,2023-11-26,1001,Lipstick,150,300,150,2,00244,India
366309,2023-11-26,1009,Moisturizer,250,500,250,2,00244,India
887218,2023-11-26,1003,Foundation,300,600,300,2,00252,India
887218,2023-11-26,1001,Lipstick,150,300,150,2,00252,India
665782,2023-11-26,1002,Mascara,200,400,200,2,00420,India
665782,2023-11-26,1012,Body Lotion,200,400,200,2,00420,India
665782,2023-11-26,1004,Eyeliner,100,200,100,2,00420,India
665782,2023-11-26,1006,Blush,150,300,150,2,00420,India
186912,2023-11-26,1004,Eyeliner,100,200,100,2,00168,India
186912,2023-11-26,1002,Mascara,200,400,200,2,00168,India
186912,2023-11-26,1005,Nail Polish,50,100,50,2,00168,India
296673,2023-11-26,1008,Makeup Remover,80,160,80,2,00141,India
296673,2023-11-26,1007,Eyeshadow,200,400,200,2,00141,India
296673,2023-11-26,1001,Lipstick,150,300,150,2,00141,India
296673,2023-11-26,1004,Eyeliner,100,200,100,2,00141,India
199201,2023-11-26,1012,Body Lotion,200,400,200,2,00144,India
199201,2023-11-26,1008,Makeup Remover,80,160,80,2,00144,India
199201,2023-11-26,1004,Eyeliner,100,200,100,2,00144,India
681383,2023-11-26,1005,Nail Polish,50,100,50,2,00380,India
501848,2023-11-26,1005,Nail Polish,50,100,50,2,00396,India
501848,2023-11-26,1008,Makeup Remover,80,160,80,2,00396,India
501848,2023-11-26,1003,Foundation,300,600,300,2,00396,India
501848,2023-11-26,1002,Mascara,200,400,200,2,00396,India
501848,2023-11-26,1001,Lipstick,150,300,150,2,00396,India
329595,2023-11-26,1002,Mascara,200,400,200,2,00480,India
329595,2023-11-26,1008,Makeup Remover,80,160,80,2,00480,India
224064,2023-11-26,1005,Nail Polish,50,100,50,2,00367,India
224064,2023-11-26,1007,Eyeshadow,200,400,200,2,00367,India
384328,2023-11-26,1003,Foundation,300,600,300,2,00345,India
384328,2023-11-26,1005,Nail Polish,50,100,50,2,00345,India
384328,2023-11-26,1008,Makeup Remover,80,160,80,2,00345,India
588343,2023-11-26,1002,Mascara,200,400,200,2,00392,India
566148,2023-11-26,1009,Moisturizer,250,500,250,2,00251,India
566148,2023-11-26,1003,Foundation,300,600,300,2,00251,India
566148,2023-11-26,1007,Eyeshadow,200,400,200,2,00251,India
410987,2023-11-26,1012,Body Lotion,200,400,200,2,00207,India
342674,2023-11-26,1009,Moisturizer,250,500,250,2,00464,India
342674,2023-11-26,1008,Makeup Remover,80,160,80,2,00464,India
666761,2023-11-26,1012,Body Lotion,200,400,200,2,00188,India
666761,2023-11-26,1004,Eyeliner,100,200,100,2,00188,India
666761,2023-11-26,1001,Lipstick,150,300,150,2,00188,India
666761,2023-11-26,1006,Blush,150,300,150,2,00188,India
538352,2023-11-26,1005,Nail Polish,50,100,50,2,00113,India
284833,2023-11-26,1006,Blush,150,300,150,2,00004,India
284833,2023-11-26,1012,Body Lotion,200,400,200,2,00004,India
284833,2023-11-26,1004,Eyeliner,100,200,100,2,00004,India
284833,2023-11-26,1008,Makeup Remover,80,160,80,2,00004,India
340417,2023-11-26,1006,Blush,150,300,150,2,00075,India
340417,2023-11-26,1008,Makeup Remover,80,160,80,2,00075,India
839234,2023-11-26,1008,Makeup Remover,80,160,80,2,00374,India
839234,2023-11-26,1001,Lipstick,150,300,150,2,00374,India
543742,2023-11-26,1012,Body Lotion,200,400,200,2,00380,India
543742,2023-11-26,1008,Makeup Remover,80,160,80,2,00380,India
543742,2023-11-26,1002,Mascara,200,400,200,2,00380,India
543742,2023-11-26,1007,Eyeshadow,200,400,200,2,00380,India
543742,2023-11-26,1006,Blush,150,300,150,2,00380,India
975552,2023-11-26,1012,Body Lotion,200,400,200,2,00381,India
190463,2023-11-26,1004,Eyeliner,100,200,100,2,00348,India
190463,2023-11-26,1007,Eyeshadow,200,400,200,2,00348,India
190463,2023-11-26,1002,Mascara,200,400,200,2,00348,India
190463,2023-11-26,1009,Moisturizer,250,500,250,2,00348,India
190463,2023-11-26,1005,Nail Polish,50,100,50,2,00348,India
370590,2023-11-26,1005,Nail Polish,50,100,50,2,00325,India
370590,2023-11-26,1001,Lipstick,150,300,150,2,00325,India
370590,2023-11-26,1008,Makeup Remover,80,160,80,2,00325,India
370590,2023-11-26,1002,Mascara,200,400,200,2,00325,India
255912,2023-11-26,1012,Body Lotion,200,400,200,2,00346,India
945034,2023-11-26,1002,Mascara,200,400,200,2,00236,India
945034,2023-11-26,1004,Eyeliner,100,200,100,2,00236,India
729705,2023-11-26,1007,Eyeshadow,200,400,200,2,00290,India
729705,2023-11-26,1003,Foundation,300,600,300,2,00290,India
205443,2023-11-26,1004,Eyeliner,100,200,100,2,00428,India
551521,2023-11-26,1005,Nail Polish,50,100,50,2,00189,India
551521,2023-11-26,1003,Foundation,300,600,300,2,00189,India
551521,2023-11-26,1009,Moisturizer,250,500,250,2,00189,India
984719,2023-11-26,1007,Eyeshadow,200,400,200,2,00180,India
984719,2023-11-26,1009,Moisturizer,250,500,250,2,00180,India
217037,2023-11-26,1005,Nail Polish,50,100,50,2,00435,India
217037,2023-11-26,1008,Makeup Remover,80,160,80,2,00435,India
373031,2023-11-26,1003,Foundation,300,600,300,2,00151,India
373031,2023-11-26,1008,Makeup Remover,80,160,80,2,00151,India
373031,2023-11-26,1009,Moisturizer,250,500,250,2,00151,India
166856,2023-11-26,1006,Blush,150,300,150,2,00322,India
166856,2023-11-26,1003,Foundation,300,600,300,2,00322,India
166856,2023-11-26,1007,Eyeshadow,200,400,200,2,00322,India
166856,2023-11-26,1005,Nail Polish,50,100,50,2,00322,India
104576,2023-11-27,1007,Eyeshadow,200,400,200,2,00217,India
104576,2023-11-27,1008,Makeup Remover,80,160,80,2,00217,India
104576,2023-11-27,1001,Lipstick,150,300,150,2,00217,India
104576,2023-11-27,1004,Eyeliner,100,200,100,2,00217,India
194977,2023-11-27,1007,Eyeshadow,200,400,200,2,00284,India
837228,2023-11-27,1012,Body Lotion,200,400,200,2,00366,India
837228,2023-11-27,1009,Moisturizer,250,500,250,2,00366,India
837228,2023-11-27,1006,Blush,150,300,150,2,00366,India
837228,2023-11-27,1007,Eyeshadow,200,400,200,2,00366,India
541057,2023-11-27,1001,Lipstick,150,300,150,2,00287,India
541057,2023-11-27,1012,Body Lotion,200,400,200,2,00287,India
541057,2023-11-27,1009,Moisturizer,250,500,250,2,00287,India
696944,2023-11-27,1012,Body Lotion,200,400,200,2,00442,India
696944,2023-11-27,1009,Moisturizer,250,500,250,2,00442,India
696944,2023-11-27,1004,Eyeliner,100,200,100,2,00442,India
961590,2023-11-27,1004,Eyeliner,100,200,100,2,00194,India
961590,2023-11-27,1008,Makeup Remover,80,160,80,2,00194,India
941783,2023-11-27,1002,Mascara,200,400,200,2,00214,India
932519,2023-11-27,1003,Foundation,300,600,300,2,00165,India
932519,2023-11-27,1002,Mascara,200,400,200,2,00165,India
932519,2023-11-27,1012,Body Lotion,200,400,200,2,00165,India
121418,2023-11-27,1002,Mascara,200,400,200,2,00072,India
121418,2023-11-27,1007,Eyeshadow,200,400,200,2,00072,India
121418,2023-11-27,1009,Moisturizer,250,500,250,2,00072,India
406223,2023-11-27,1009,Moisturizer,250,500,250,2,00122,India
406223,2023-11-27,1004,Eyeliner,100,200,100,2,00122,India
406223,2023-11-27,1008,Makeup Remover,80,160,80,2,00122,India
406223,2023-11-27,1007,Eyeshadow,200,400,200,2,00122,India
733237,2023-11-27,1009,Moisturizer,250,500,250,2,00252,India
733237,2023-11-27,1001,Lipstick,150,300,150,2,00252,India
733237,2023-11-27,1008,Makeup Remover,80,160,80,2,00252,India
733237,2023-11-27,1002,Mascara,200,400,200,2,00252,India
517969,2023-11-27,1002,Mascara,200,400,200,2,00280,India
517969,2023-11-27,1009,Moisturizer,250,500,250,2,00280,India
517969,2023-11-27,1004,Eyeliner,100,200,100,2,00280,India
517969,2023-11-27,1007,Eyeshadow,200,400,200,2,00280,India
517969,2023-11-27,1006,Blush,150,300,150,2,00280,India
491437,2023-11-27,1008,Makeup Remover,80,160,80,2,00468,India
491437,2023-11-27,1007,Eyeshadow,200,400,200,2,00468,India
491437,2023-11-27,1004,Eyeliner,100,200,100,2,00468,India
491437,2023-11-27,1005,Nail Polish,50,100,50,2,00468,India
637611,2023-11-27,1008,Makeup Remover,80,160,80,2,00032,India
637611,2023-11-27,1002,Mascara,200,400,200,2,00032,India
637611,2023-11-27,1001,Lipstick,150,300,150,2,00032,India
637611,2023-11-27,1012,Body Lotion,200,400,200,2,00032,India
637611,2023-11-27,1006,Blush,150,300,150,2,00032,India
723673,2023-11-27,1001,Lipstick,150,300,150,2,00453,India
382577,2023-11-27,1009,Moisturizer,250,500,250,2,00035,India
382577,2023-11-27,1004,Eyeliner,100,200,100,2,00035,India
382577,2023-11-27,1002,Mascara,200,400,200,2,00035,India
333457,2023-11-27,1006,Blush,150,300,150,2,00151,India
333457,2023-11-27,1001,Lipstick,150,300,150,2,00151,India
284373,2023-11-27,1003,Foundation,300,600,300,2,00035,India
284373,2023-11-27,1008,Makeup Remover,80,160,80,2,00035,India
956609,2023-11-27,1004,Eyeliner,100,200,100,2,00334,India
956609,2023-11-27,1009,Moisturizer,250,500,250,2,00334,India
956609,2023-11-27,1012,Body Lotion,200,400,200,2,00334,India
905593,2023-11-27,1003,Foundation,300,600,300,2,00056,India
905593,2023-11-27,1008,Makeup Remover,80,160,80,2,00056,India
905593,2023-11-27,1009,Moisturizer,250,500,250,2,00056,India
663632,2023-11-27,1006,Blush,150,300,150,2,00098,India
663632,2023-11-27,1008,Makeup Remover,80,160,80,2,00098,India
663632,2023-11-27,1001,Lipstick,150,300,150,2,00098,India
663632,2023-11-27,1002,Mascara,200,400,200,2,00098,India
154195,2023-11-27,1012,Body Lotion,200,400,200,2,00056,India
154195,2023-11-27,1002,Mascara,200,400,200,2,00056,India
154195,2023-11-27,1006,Blush,150,300,150,2,00056,India
154195,2023-11-27,1008,Makeup Remover,80,160,80,2,00056,India
390193,2023-11-27,1008,Makeup Remover,80,160,80,2,00257,India
390193,2023-11-27,1001,Lipstick,150,300,150,2,00257,India
654722,2023-11-27,1002,Mascara,200,400,200,2,00423,India
614972,2023-11-27,1012,Body Lotion,200,400,200,2,00002,India
614972,2023-11-27,1003,Foundation,300,600,300,2,00002,India
614972,2023-11-27,1007,Eyeshadow,200,400,200,2,00002,India
789702,2023-11-27,1007,Eyeshadow,200,400,200,2,00024,India
789702,2023-11-27,1005,Nail Polish,50,100,50,2,00024,India
789702,2023-11-27,1009,Moisturizer,250,500,250,2,00024,India
789702,2023-11-27,1004,Eyeliner,100,200,100,2,00024,India
498172,2023-11-27,1003,Foundation,300,600,300,2,00290,India
498172,2023-11-27,1009,Moisturizer,250,500,250,2,00290,India
498172,2023-11-27,1002,Mascara,200,400,200,2,00290,India
498172,2023-11-27,1008,Makeup Remover,80,160,80,2,00290,India
814188,2023-11-27,1001,Lipstick,150,300,150,2,00273,India
814188,2023-11-27,1012,Body Lotion,200,400,200,2,00273,India
814188,2023-11-27,1003,Foundation,300,600,300,2,00273,India
814188,2023-11-27,1007,Eyeshadow,200,400,200,2,00273,India
959530,2023-11-27,1007,Eyeshadow,200,400,200,2,00349,India
959530,2023-11-27,1012,Body Lotion,200,400,200,2,00349,India
760453,2023-11-27,1006,Blush,150,300,150,2,00459,India
760453,2023-11-27,1003,Foundation,300,600,300,2,00459,India
760453,2023-11-27,1012,Body Lotion,200,400,200,2,00459,India
760453,2023-11-27,1008,Makeup Remover,80,160,80,2,00459,India
448431,2023-11-27,1001,Lipstick,150,300,150,2,00319,India
398034,2023-11-27,1003,Foundation,300,600,300,2,00040,India
398034,2023-11-27,1004,Eyeliner,100,200,100,2,00040,India
763542,2023-11-27,1012,Body Lotion,200,400,200,2,00271,India
765561,2023-11-27,1008,Makeup Remover,80,160,80,2,00408,India
878893,2023-11-27,1009,Moisturizer,250,500,250,2,00048,India
878893,2023-11-27,1001,Lipstick,150,300,150,2,00048,India
878893,2023-11-27,1005,Nail Polish,50,100,50,2,00048,India
878893,2023-11-27,1002,Mascara,200,400,200,2,00048,India
998965,2023-11-27,1004,Eyeliner,100,200,100,2,00315,India
998965,2023-11-27,1002,Mascara,200,400,200,2,00315,India
998965,2023-11-27,1005,Nail Polish,50,100,50,2,00315,India
980423,2023-11-27,1004,Eyeliner,100,200,100,2,00455,India
638876,2023-11-27,1004,Eyeliner,100,200,100,2,00384,India
638876,2023-11-27,1003,Foundation,300,600,300,2,00384,India
113918,2023-11-27,1009,Moisturizer,250,500,250,2,00083,India
113918,2023-11-27,1005,Nail Polish,50,100,50,2,00083,India
113918,2023-11-27,1003,Foundation,300,600,300,2,00083,India
113918,2023-11-27,1001,Lipstick,150,300,150,2,00083,India
993289,2023-11-27,1005,Nail Polish,50,100,50,2,00442,India
993289,2023-11-27,1003,Foundation,300,600,300,2,00442,India
737781,2023-11-27,1001,Lipstick,150,300,150,2,00071,India
737781,2023-11-27,1007,Eyeshadow,200,400,200,2,00071,India
876909,2023-11-27,1003,Foundation,300,600,300,2,00123,India
876909,2023-11-27,1007,Eyeshadow,200,400,200,2,00123,India
876909,2023-11-27,1006,Blush,150,300,150,2,00123,India
247968,2023-11-27,1006,Blush,150,300,150,2,00481,India
745933,2023-11-27,1007,Eyeshadow,200,400,200,2,00134,India
745933,2023-11-27,1012,Body Lotion,200,400,200,2,00134,India
333863,2023-11-27,1001,Lipstick,150,300,150,2,00489,India
333863,2023-11-27,1006,Blush,150,300,150,2,00489,India
333863,2023-11-27,1003,Foundation,300,600,300,2,00489,India
871800,2023-11-28,1012,Body Lotion,200,400,200,2,00126,India
871800,2023-11-28,1008,Makeup Remover,80,160,80,2,00126,India
871800,2023-11-28,1004,Eyeliner,100,200,100,2,00126,India
710144,2023-11-28,1002,Mascara,200,400,200,2,00031,India
710144,2023-11-28,1003,Foundation,300,600,300,2,00031,India
748579,2023-11-28,1003,Foundation,300,600,300,2,00038,India
748579,2023-11-28,1005,Nail Polish,50,100,50,2,00038,India
748579,2023-11-28,1007,Eyeshadow,200,400,200,2,00038,India
748579,2023-11-28,1006,Blush,150,300,150,2,00038,India
495519,2023-11-28,1007,Eyeshadow,200,400,200,2,00166,India
495519,2023-11-28,1005,Nail Polish,50,100,50,2,00166,India
495519,2023-11-28,1009,Moisturizer,250,500,250,2,00166,India
891255,2023-11-28,1002,Mascara,200,400,200,2,00355,India
891255,2023-11-28,1004,Eyeliner,100,200,100,2,00355,India
891255,2023-11-28,1012,Body Lotion,200,400,200,2,00355,India
891255,2023-11-28,1003,Foundation,300,600,300,2,00355,India
617940,2023-11-28,1007,Eyeshadow,200,400,200,2,00109,India
617940,2023-11-28,1001,Lipstick,150,300,150,2,00109,India
617940,2023-11-28,1005,Nail Polish,50,100,50,2,00109,India
617940,2023-11-28,1004,Eyeliner,100,200,100,2,00109,India
617940,2023-11-28,1012,Body Lotion,200,400,200,2,00109,India
111727,2023-11-28,1012,Body Lotion,200,400,200,2,00255,India
111727,2023-11-28,1001,Lipstick,150,300,150,2,00255,India
111727,2023-11-28,1003,Foundation,300,600,300,2,00255,India
921206,2023-11-28,1006,Blush,150,300,150,2,00312,India
921206,2023-11-28,1001,Lipstick,150,300,150,2,00312,India
848689,2023-11-28,1006,Blush,150,300,150,2,00486,India
422089,2023-11-28,1002,Mascara,200,400,200,2,00247,India
422089,2023-11-28,1009,Moisturizer,250,500,250,2,00247,India
422089,2023-11-28,1005,Nail Polish,50,100,50,2,00247,India
678823,2023-11-28,1006,Blush,150,300,150,2,00481,India
678823,2023-11-28,1012,Body Lotion,200,400,200,2,00481,India
678823,2023-11-28,1004,Eyeliner,100,200,100,2,00481,India
298303,2023-11-28,1009,Moisturizer,250,500,250,2,00296,India
298303,2023-11-28,1007,Eyeshadow,200,400,200,2,00296,India
298303,2023-11-28,1006,Blush,150,300,150,2,00296,India
298303,2023-11-28,1002,Mascara,200,400,200,2,00296,India
922274,2023-11-28,1009,Moisturizer,250,500,250,2,00156,India
384903,2023-11-28,1006,Blush,150,300,150,2,00013,India
384903,2023-11-28,1009,Moisturizer,250,500,250,2,00013,India
972996,2023-11-28,1007,Eyeshadow,200,400,200,2,00119,India
343626,2023-11-28,1006,Blush,150,300,150,2,00472,India
343626,2023-11-28,1001,Lipstick,150,300,150,2,00472,India
343626,2023-11-28,1009,Moisturizer,250,500,250,2,00472,India
397036,2023-11-28,1006,Blush,150,300,150,2,00482,India
397036,2023-11-28,1002,Mascara,200,400,200,2,00482,India
397036,2023-11-28,1012,Body Lotion,200,400,200,2,00482,India
397036,2023-11-28,1005,Nail Polish,50,100,50,2,00482,India
397036,2023-11-28,1007,Eyeshadow,200,400,200,2,00482,India
741116,2023-11-28,1008,Makeup Remover,80,160,80,2,00275,India
960032,2023-11-28,1007,Eyeshadow,200,400,200,2,00206,India
960032,2023-11-28,1005,Nail Polish,50,100,50,2,00206,India
371995,2023-11-28,1001,Lipstick,150,300,150,2,00446,India
371995,2023-11-28,1002,Mascara,200,400,200,2,00446,India
167590,2023-11-28,1008,Makeup Remover,80,160,80,2,00408,India
167590,2023-11-28,1007,Eyeshadow,200,400,200,2,00408,India
167590,2023-11-28,1002,Mascara,200,400,200,2,00408,India
504378,2023-11-28,1004,Eyeliner,100,200,100,2,00004,India
234577,2023-11-28,1005,Nail Polish,50,100,50,2,00256,India
234577,2023-11-28,1004,Eyeliner,100,200,100,2,00256,India
234577,2023-11-28,1012,Body Lotion,200,400,200,2,00256,India
234577,2023-11-28,1001,Lipstick,150,300,150,2,00256,India
150309,2023-11-28,1009,Moisturizer,250,500,250,2,00253,India
150309,2023-11-28,1002,Mascara,200,400,200,2,00253,India
718891,2023-11-28,1007,Eyeshadow,200,400,200,2,00243,India
204044,2023-11-28,1001,Lipstick,150,300,150,2,00385,India
204044,2023-11-28,1008,Makeup Remover,80,160,80,2,00385,India
204044,2023-11-28,1009,Moisturizer,250,500,250,2,00385,India
724666,2023-11-28,1012,Body Lotion,200,400,200,2,00175,India
724666,2023-11-28,1005,Nail Polish,50,100,50,2,00175,India
724666,2023-11-28,1001,Lipstick,150,300,150,2,00175,India
724666,2023-11-28,1004,Eyeliner,100,200,100,2,00175,India
453337,2023-11-28,1003,Foundation,300,600,300,2,00051,India
542604,2023-11-28,1012,Body Lotion,200,400,200,2,00321,India
542604,2023-11-28,1006,Blush,150,300,150,2,00321,India
542604,2023-11-28,1001,Lipstick,150,300,150,2,00321,India
542604,2023-11-28,1007,Eyeshadow,200,400,200,2,00321,India
244652,2023-11-28,1004,Eyeliner,100,200,100,2,00482,India
244652,2023-11-28,1009,Moisturizer,250,500,250,2,00482,India
244652,2023-11-28,1006,Blush,150,300,150,2,00482,India
974799,2023-11-28,1009,Moisturizer,250,500,250,2,00273,India
974799,2023-11-28,1008,Makeup Remover,80,160,80,2,00273,India
974799,2023-11-28,1006,Blush,150,300,150,2,00273,India
974799,2023-11-28,1005,Nail Polish,50,100,50,2,00273,India
974799,2023-11-28,1007,Eyeshadow,200,400,200,2,00273,India
109146,2023-11-28,1005,Nail Polish,50,100,50,2,00361,India
109146,2023-11-28,1007,Eyeshadow,200,400,200,2,00361,India
771392,2023-11-28,1004,Eyeliner,100,200,100,2,00335,India
771392,2023-11-28,1006,Blush,150,300,150,2,00335,India
256097,2023-11-28,1004,Eyeliner,100,200,100,2,00212,India
256097,2023-11-28,1008,Makeup Remover,80,160,80,2,00212,India
256097,2023-11-28,1012,Body Lotion,200,400,200,2,00212,India
246170,2023-11-28,1004,Eyeliner,100,200,100,2,00461,India
246170,2023-11-28,1001,Lipstick,150,300,150,2,00461,India
246170,2023-11-28,1012,Body Lotion,200,400,200,2,00461,India
246170,2023-11-28,1006,Blush,150,300,150,2,00461,India
591957,2023-11-28,1007,Eyeshadow,200,400,200,2,00436,India
591957,2023-11-28,1001,Lipstick,150,300,150,2,00436,India
288666,2023-11-28,1004,Eyeliner,100,200,100,2,00315,India
603546,2023-11-28,1007,Eyeshadow,200,400,200,2,00388,India
603546,2023-11-28,1008,Makeup Remover,80,160,80,2,00388,India
603546,2023-11-28,1001,Lipstick,150,300,150,2,00388,India
603546,2023-11-28,1006,Blush,150,300,150,2,00388,India
603546,2023-11-28,1009,Moisturizer,250,500,250,2,00388,India
885965,2023-11-28,1002,Mascara,200,400,200,2,00402,India
412401,2023-11-28,1009,Moisturizer,250,500,250,2,00198,India
964951,2023-11-28,1006,Blush,150,300,150,2,00382,India
964951,2023-11-28,1003,Foundation,300,600,300,2,00382,India
578869,2023-11-28,1003,Foundation,300,600,300,2,00054,India
241291,2023-11-28,1012,Body Lotion,200,400,200,2,00052,India
231618,2023-11-28,1012,Body Lotion,200,400,200,2,00167,India
231618,2023-11-28,1004,Eyeliner,100,200,100,2,00167,India
231618,2023-11-28,1002,Mascara,200,400,200,2,00167,India
231618,2023-11-28,1003,Foundation,300,600,300,2,00167,India
988699,2023-11-28,1004,Eyeliner,100,200,100,2,00479,India
988699,2023-11-28,1007,Eyeshadow,200,400,200,2,00479,India
988699,2023-11-28,1001,Lipstick,150,300,150,2,00479,India
988699,2023-11-28,1009,Moisturizer,250,500,250,2,00479,India
706634,2023-11-28,1001,Lipstick,150,300,150,2,00362,India
706634,2023-11-28,1005,Nail Polish,50,100,50,2,00362,India
706634,2023-11-28,1012,Body Lotion,200,400,200,2,00362,India
162431,2023-11-28,1003,Foundation,300,600,300,2,00190,India
162431,2023-11-28,1009,Moisturizer,250,500,250,2,00190,India
162431,2023-11-28,1008,Makeup Remover,80,160,80,2,00190,India
162431,2023-11-28,1007,Eyeshadow,200,400,200,2,00190,India
162431,2023-11-28,1001,Lipstick,150,300,150,2,00190,India
451362,2023-11-29,1012,Body Lotion,200,400,200,2,00117,India
451362,2023-11-29,1009,Moisturizer,250,500,250,2,00117,India
672172,2023-11-29,1004,Eyeliner,100,200,100,2,00182,India
672172,2023-11-29,1005,Nail Polish,50,100,50,2,00182,India
672172,2023-11-29,1007,Eyeshadow,200,400,200,2,00182,India
672172,2023-11-29,1006,Blush,150,300,150,2,00182,India
818188,2023-11-29,1002,Mascara,200,400,200,2,00430,India
818188,2023-11-29,1006,Blush,150,300,150,2,00430,India
508763,2023-11-29,1003,Foundation,300,600,300,2,00038,India
508763,2023-11-29,1001,Lipstick,150,300,150,2,00038,India
508763,2023-11-29,1012,Body Lotion,200,400,200,2,00038,India
508763,2023-11-29,1005,Nail Polish,50,100,50,2,00038,India
105448,2023-11-29,1003,Foundation,300,600,300,2,00305,India
105448,2023-11-29,1012,Body Lotion,200,400,200,2,00305,India
183779,2023-11-29,1002,Mascara,200,400,200,2,00197,India
183779,2023-11-29,1004,Eyeliner,100,200,100,2,00197,India
625850,2023-11-29,1009,Moisturizer,250,500,250,2,00487,India
625850,2023-11-29,1001,Lipstick,150,300,150,2,00487,India
625850,2023-11-29,1004,Eyeliner,100,200,100,2,00487,India
929942,2023-11-29,1001,Lipstick,150,300,150,2,00203,India
929942,2023-11-29,1005,Nail Polish,50,100,50,2,00203,India
132397,2023-11-29,1004,Eyeliner,100,200,100,2,00213,India
132397,2023-11-29,1012,Body Lotion,200,400,200,2,00213,India
132397,2023-11-29,1006,Blush,150,300,150,2,00213,India
132397,2023-11-29,1007,Eyeshadow,200,400,200,2,00213,India
132397,2023-11-29,1005,Nail Polish,50,100,50,2,00213,India
404754,2023-11-29,1007,Eyeshadow,200,400,200,2,00159,India
404754,2023-11-29,1002,Mascara,200,400,200,2,00159,India
527330,2023-11-29,1002,Mascara,200,400,200,2,00038,India
527330,2023-11-29,1008,Makeup Remover,80,160,80,2,00038,India
862247,2023-11-29,1003,Foundation,300,600,300,2,00159,India
862247,2023-11-29,1002,Mascara,200,400,200,2,00159,India
862247,2023-11-29,1004,Eyeliner,100,200,100,2,00159,India
862247,2023-11-29,1012,Body Lotion,200,400,200,2,00159,India
862247,2023-11-29,1009,Moisturizer,250,500,250,2,00159,India
587856,2023-11-29,1002,Mascara,200,400,200,2,00244,India
587856,2023-11-29,1009,Moisturizer,250,500,250,2,00244,India
587856,2023-11-29,1004,Eyeliner,100,200,100,2,00244,India
343168,2023-11-29,1002,Mascara,200,400,200,2,00348,India
343168,2023-11-29,1009,Moisturizer,250,500,250,2,00348,India
343168,2023-11-29,1003,Foundation,300,600,300,2,00348,India
459406,2023-11-29,1004,Eyeliner,100,200,100,2,00433,India
459406,2023-11-29,1012,Body Lotion,200,400,200,2,00433,India
459406,2023-11-29,1005,Nail Polish,50,100,50,2,00433,India
459406,2023-11-29,1009,Moisturizer,250,500,250,2,00433,India
350553,2023-11-29,1008,Makeup Remover,80,160,80,2,00008,India
350553,2023-11-29,1007,Eyeshadow,200,400,200,2,00008,India
854249,2023-11-29,1007,Eyeshadow,200,400,200,2,00072,India
854249,2023-11-29,1001,Lipstick,150,300,150,2,00072,India
854249,2023-11-29,1012,Body Lotion,200,400,200,2,00072,India
437837,2023-11-29,1008,Makeup Remover,80,160,80,2,00322,India
437837,2023-11-29,1004,Eyeliner,100,200,100,2,00322,India
437837,2023-11-29,1003,Foundation,300,600,300,2,00322,India
437837,2023-11-29,1002,Mascara,200,400,200,2,00322,India
322789,2023-11-29,1007,Eyeshadow,200,400,200,2,00150,India
322789,2023-11-29,1003,Foundation,300,600,300,2,00150,India
322789,2023-11-29,1001,Lipstick,150,300,150,2,00150,India
322789,2023-11-29,1005,Nail Polish,50,100,50,2,00150,India
947609,2023-11-29,1005,Nail Polish,50,100,50,2,00173,India
947609,2023-11-29,1001,Lipstick,150,300,150,2,00173,India
947609,2023-11-29,1007,Eyeshadow,200,400,200,2,00173,India
947609,2023-11-29,1008,Makeup Remover,80,160,80,2,00173,India
607608,2023-11-29,1002,Mascara,200,400,200,2,00235,India
607608,2023-11-29,1003,Foundation,300,600,300,2,00235,India
607608,2023-11-29,1007,Eyeshadow,200,400,200,2,00235,India
155709,2023-11-29,1005,Nail Polish,50,100,50,2,00079,India
155709,2023-11-29,1006,Blush,150,300,150,2,00079,India
155709,2023-11-29,1012,Body Lotion,200,400,200,2,00079,India
171337,2023-11-29,1007,Eyeshadow,200,400,200,2,00201,India
171337,2023-11-29,1004,Eyeliner,100,200,100,2,00201,India
171337,2023-11-29,1002,Mascara,200,400,200,2,00201,India
994370,2023-11-29,1007,Eyeshadow,200,400,200,2,00378,India
968063,2023-11-29,1007,Eyeshadow,200,400,200,2,00389,India
968063,2023-11-29,1009,Moisturizer,250,500,250,2,00389,India
968063,2023-11-29,1004,Eyeliner,100,200,100,2,00389,India
968063,2023-11-29,1008,Makeup Remover,80,160,80,2,00389,India
668259,2023-11-29,1005,Nail Polish,50,100,50,2,00306,India
668259,2023-11-29,1007,Eyeshadow,200,400,200,2,00306,India
668259,2023-11-29,1009,Moisturizer,250,500,250,2,00306,India
628765,2023-11-29,1012,Body Lotion,200,400,200,2,00069,India
628765,2023-11-29,1001,Lipstick,150,300,150,2,00069,India
628765,2023-11-29,1007,Eyeshadow,200,400,200,2,00069,India
263010,2023-11-29,1003,Foundation,300,600,300,2,00196,India
263010,2023-11-29,1005,Nail Polish,50,100,50,2,00196,India
263010,2023-11-29,1007,Eyeshadow,200,400,200,2,00196,India
263010,2023-11-29,1009,Moisturizer,250,500,250,2,00196,India
120471,2023-11-29,1004,Eyeliner,100,200,100,2,00133,India
120471,2023-11-29,1003,Foundation,300,600,300,2,00133,India
120471,2023-11-29,1007,Eyeshadow,200,400,200,2,00133,India
120471,2023-11-29,1009,Moisturizer,250,500,250,2,00133,India
943405,2023-11-29,1006,Blush,150,300,150,2,00236,India
943405,2023-11-29,1003,Foundation,300,600,300,2,00236,India
943405,2023-11-29,1008,Makeup Remover,80,160,80,2,00236,India
352947,2023-11-29,1002,Mascara,200,400,200,2,00144,India
352947,2023-11-29,1008,Makeup Remover,80,160,80,2,00144,India
978607,2023-11-29,1004,Eyeliner,100,200,100,2,00045,India
978607,2023-11-29,1008,Makeup Remover,80,160,80,2,00045,India
474017,2023-11-29,1002,Mascara,200,400,200,2,00184,India
474017,2023-11-29,1007,Eyeshadow,200,400,200,2,00184,India
474017,2023-11-29,1001,Lipstick,150,300,150,2,00184,India
474017,2023-11-29,1006,Blush,150,300,150,2,00184,India
509955,2023-11-29,1004,Eyeliner,100,200,100,2,00365,India
509955,2023-11-29,1007,Eyeshadow,200,400,200,2,00365,India
509955,2023-11-29,1012,Body Lotion,200,400,200,2,00365,India
509955,2023-11-29,1001,Lipstick,150,300,150,2,00365,India
362199,2023-11-29,1003,Foundation,300,600,300,2,00120,India
877652,2023-11-29,1001,Lipstick,150,300,150,2,00270,India
307123,2023-11-29,1004,Eyeliner,100,200,100,2,00211,India
932281,2023-11-29,1002,Mascara,200,400,200,2,00475,India
932281,2023-11-29,1005,Nail Polish,50,100,50,2,00475,India
932281,2023-11-29,1007,Eyeshadow,200,400,200,2,00475,India
104248,2023-11-29,1001,Lipstick,150,300,150,2,00072,India
104248,2023-11-29,1008,Makeup Remover,80,160,80,2,00072,India
104248,2023-11-29,1003,Foundation,300,600,300,2,00072,India
798917,2023-11-29,1009,Moisturizer,250,500,250,2,00049,India
873383,2023-11-29,1004,Eyeliner,100,200,100,2,00300,India
873383,2023-11-29,1009,Moisturizer,250,500,250,2,00300,India
707684,2023-11-29,1003,Foundation,300,600,300,2,00043,India
707684,2023-11-29,1005,Nail Polish,50,100,50,2,00043,India
707684,2023-11-29,1009,Moisturizer,250,500,250,2,00043,India
707684,2023-11-29,1001,Lipstick,150,300,150,2,00043,India
788620,2023-11-29,1008,Makeup Remover,80,160,80,2,00189,India
809665,2023-11-29,1005,Nail Polish,50,100,50,2,00180,India
809665,2023-11-29,1008,Makeup Remover,80,160,80,2,00180,India
809665,2023-11-29,1001,Lipstick,150,300,150,2,00180,India
783001,2023-11-29,1003,Foundation,300,600,300,2,00197,India
219135,2023-11-29,1006,Blush,150,300,150,2,00272,India
219135,2023-11-29,1005,Nail Polish,50,100,50,2,00272,India
219135,2023-11-29,1009,Moisturizer,250,500,250,2,00272,India
649014,2023-11-29,1004,Eyeliner,100,200,100,2,00318,India
991348,2023-11-29,1005,Nail Polish,50,100,50,2,00461,India
991348,2023-11-29,1007,Eyeshadow,200,400,200,2,00461,India
991348,2023-11-29,1009,Moisturizer,250,500,250,2,00461,India
815828,2023-11-29,1004,Eyeliner,100,200,100,2,00047,India
815828,2023-11-29,1012,Body Lotion,200,400,200,2,00047,India
434816,2023-11-29,1007,Eyeshadow,200,400,200,2,00033,India
434816,2023-11-29,1002,Mascara,200,400,200,2,00033,India
434816,2023-11-29,1012,Body Lotion,200,400,200,2,00033,India
350579,2023-11-30,1006,Blush,150,300,150,2,00208,India
350579,2023-11-30,1007,Eyeshadow,200,400,200,2,00208,India
841863,2023-11-30,1005,Nail Polish,50,100,50,2,00242,India
841863,2023-11-30,1009,Moisturizer,250,500,250,2,00242,India
884339,2023-11-30,1012,Body Lotion,200,400,200,2,00175,India
666633,2023-11-30,1005,Nail Polish,50,100,50,2,00349,India
666633,2023-11-30,1009,Moisturizer,250,500,250,2,00349,India
368070,2023-11-30,1012,Body Lotion,200,400,200,2,00362,India
368070,2023-11-30,1007,Eyeshadow,200,400,200,2,00362,India
368070,2023-11-30,1006,Blush,150,300,150,2,00362,India
756114,2023-11-30,1008,Makeup Remover,80,160,80,2,00366,India
756114,2023-11-30,1001,Lipstick,150,300,150,2,00366,India
756114,2023-11-30,1007,Eyeshadow,200,400,200,2,00366,India
211076,2023-11-30,1004,Eyeliner,100,200,100,2,00243,India
211076,2023-11-30,1009,Moisturizer,250,500,250,2,00243,India
221098,2023-11-30,1006,Blush,150,300,150,2,00370,India
615285,2023-11-30,1012,Body Lotion,200,400,200,2,00340,India
615285,2023-11-30,1007,Eyeshadow,200,400,200,2,00340,India
615285,2023-11-30,1006,Blush,150,300,150,2,00340,India
615285,2023-11-30,1002,Mascara,200,400,200,2,00340,India
913421,2023-11-30,1012,Body Lotion,200,400,200,2,00424,India
913421,2023-11-30,1006,Blush,150,300,150,2,00424,India
433630,2023-11-30,1007,Eyeshadow,200,400,200,2,00439,India
405383,2023-11-30,1002,Mascara,200,400,200,2,00288,India
228444,2023-11-30,1007,Eyeshadow,200,400,200,2,00336,India
228444,2023-11-30,1002,Mascara,200,400,200,2,00336,India
228444,2023-11-30,1008,Makeup Remover,80,160,80,2,00336,India
309410,2023-11-30,1005,Nail Polish,50,100,50,2,00271,India
309410,2023-11-30,1001,Lipstick,150,300,150,2,00271,India
309410,2023-11-30,1006,Blush,150,300,150,2,00271,India
309410,2023-11-30,1012,Body Lotion,200,400,200,2,00271,India
695589,2023-11-30,1001,Lipstick,150,300,150,2,00361,India
695589,2023-11-30,1003,Foundation,300,600,300,2,00361,India
695589,2023-11-30,1004,Eyeliner,100,200,100,2,00361,India
541671,2023-11-30,1008,Makeup Remover,80,160,80,2,00010,India
541671,2023-11-30,1005,Nail Polish,50,100,50,2,00010,India
541671,2023-11-30,1006,Blush,150,300,150,2,00010,India
541671,2023-11-30,1004,Eyeliner,100,200,100,2,00010,India
666848,2023-11-30,1006,Blush,150,300,150,2,00291,India
666848,2023-11-30,1007,Eyeshadow,200,400,200,2,00291,India
228192,2023-11-30,1009,Moisturizer,250,500,250,2,00059,India
228192,2023-11-30,1008,Makeup Remover,80,160,80,2,00059,India
195270,2023-11-30,1002,Mascara,200,400,200,2,00074,India
550139,2023-11-30,1004,Eyeliner,100,200,100,2,00076,India
550139,2023-11-30,1012,Body Lotion,200,400,200,2,00076,India
699897,2023-11-30,1005,Nail Polish,50,100,50,2,00275,India
699897,2023-11-30,1001,Lipstick,150,300,150,2,00275,India
699897,2023-11-30,1009,Moisturizer,250,500,250,2,00275,India
699897,2023-11-30,1006,Blush,150,300,150,2,00275,India
409460,2023-11-30,1004,Eyeliner,100,200,100,2,00290,India
409460,2023-11-30,1005,Nail Polish,50,100,50,2,00290,India
409460,2023-11-30,1009,Moisturizer,250,500,250,2,00290,India
205215,2023-11-30,1004,Eyeliner,100,200,100,2,00029,India
205215,2023-11-30,1012,Body Lotion,200,400,200,2,00029,India
205215,2023-11-30,1002,Mascara,200,400,200,2,00029,India
205215,2023-11-30,1001,Lipstick,150,300,150,2,00029,India
205215,2023-11-30,1005,Nail Polish,50,100,50,2,00029,India
274571,2023-11-30,1007,Eyeshadow,200,400,200,2,00086,India
274571,2023-11-30,1008,Makeup Remover,80,160,80,2,00086,India
274571,2023-11-30,1004,Eyeliner,100,200,100,2,00086,India
230957,2023-11-30,1005,Nail Polish,50,100,50,2,00038,India
230957,2023-11-30,1004,Eyeliner,100,200,100,2,00038,India
925495,2023-11-30,1002,Mascara,200,400,200,2,00273,India
925495,2023-11-30,1001,Lipstick,150,300,150,2,00273,India
925495,2023-11-30,1012,Body Lotion,200,400,200,2,00273,India
839376,2023-11-30,1005,Nail Polish,50,100,50,2,00461,India
671221,2023-11-30,1004,Eyeliner,100,200,100,2,00342,India
671221,2023-11-30,1003,Foundation,300,600,300,2,00342,India
671221,2023-11-30,1005,Nail Polish,50,100,50,2,00342,India
824856,2023-11-30,1002,Mascara,200,400,200,2,00392,India
144169,2023-11-30,1003,Foundation,300,600,300,2,00409,India
144169,2023-11-30,1012,Body Lotion,200,400,200,2,00409,India
879961,2023-11-30,1004,Eyeliner,100,200,100,2,00317,India
879961,2023-11-30,1012,Body Lotion,200,400,200,2,00317,India
879961,2023-11-30,1005,Nail Polish,50,100,50,2,00317,India
879961,2023-11-30,1009,Moisturizer,250,500,250,2,00317,India
460826,2023-12-01,1009,Moisturizer,250,500,250,2,00227,India
360419,2023-12-01,1003,Foundation,300,600,300,2,00234,India
360419,2023-12-01,1001,Lipstick,150,300,150,2,00234,India
360419,2023-12-01,1002,Mascara,200,400,200,2,00234,India
483785,2023-12-01,1009,Moisturizer,250,500,250,2,00409,India
483785,2023-12-01,1001,Lipstick,150,300,150,2,00409,India
483785,2023-12-01,1007,Eyeshadow,200,400,200,2,00409,India
483785,2023-12-01,1004,Eyeliner,100,200,100,2,00409,India
483785,2023-12-01,1006,Blush,150,300,150,2,00409,India
379653,2023-12-01,1005,Nail Polish,50,100,50,2,00487,India
379653,2023-12-01,1006,Blush,150,300,150,2,00487,India
840764,2023-12-01,1005,Nail Polish,50,100,50,2,00065,India
840764,2023-12-01,1004,Eyeliner,100,200,100,2,00065,India
840764,2023-12-01,1003,Foundation,300,600,300,2,00065,India
334975,2023-12-01,1004,Eyeliner,100,200,100,2,00296,India
334975,2023-12-01,1001,Lipstick,150,300,150,2,00296,India
115355,2023-12-01,1005,Nail Polish,50,100,50,2,00288,India
115355,2023-12-01,1012,Body Lotion,200,400,200,2,00288,India
115355,2023-12-01,1001,Lipstick,150,300,150,2,00288,India
987652,2023-12-01,1006,Blush,150,300,150,2,00013,India
987652,2023-12-01,1003,Foundation,300,600,300,2,00013,India
987652,2023-12-01,1005,Nail Polish,50,100,50,2,00013,India
179414,2023-12-01,1008,Makeup Remover,80,160,80,2,00349,India
179414,2023-12-01,1009,Moisturizer,250,500,250,2,00349,India
179414,2023-12-01,1003,Foundation,300,600,300,2,00349,India
887845,2023-12-01,1003,Foundation,300,600,300,2,00142,India
887845,2023-12-01,1005,Nail Polish,50,100,50,2,00142,India
887845,2023-12-01,1007,Eyeshadow,200,400,200,2,00142,India
659625,2023-12-01,1001,Lipstick,150,300,150,2,00001,India
659625,2023-12-01,1008,Makeup Remover,80,160,80,2,00001,India
659625,2023-12-01,1003,Foundation,300,600,300,2,00001,India
174217,2023-12-01,1001,Lipstick,150,300,150,2,00042,India
174217,2023-12-01,1005,Nail Polish,50,100,50,2,00042,India
174217,2023-12-01,1012,Body Lotion,200,400,200,2,00042,India
223903,2023-12-01,1012,Body Lotion,200,400,200,2,00313,India
223903,2023-12-01,1001,Lipstick,150,300,150,2,00313,India
223903,2023-12-01,1007,Eyeshadow,200,400,200,2,00313,India
223903,2023-12-01,1003,Foundation,300,600,300,2,00313,India
493687,2023-12-01,1001,Lipstick,150,300,150,2,00160,India
493687,2023-12-01,1003,Foundation,300,600,300,2,00160,India
861392,2023-12-01,1003,Foundation,300,600,300,2,00436,India
861392,2023-12-01,1009,Moisturizer,250,500,250,2,00436,India
604605,2023-12-01,1012,Body Lotion,200,400,200,2,00462,India
813678,2023-12-01,1006,Blush,150,300,150,2,00055,India
813678,2023-12-01,1003,Foundation,300,600,300,2,00055,India
813678,2023-12-01,1007,Eyeshadow,200,400,200,2,00055,India
632844,2023-12-01,1012,Body Lotion,200,400,200,2,00329,India
632844,2023-12-01,1006,Blush,150,300,150,2,00329,India
517335,2023-12-01,1004,Eyeliner,100,200,100,2,00348,India
517335,2023-12-01,1005,Nail Polish,50,100,50,2,00348,India
517335,2023-12-01,1012,Body Lotion,200,400,200,2,00348,India
892515,2023-12-01,1002,Mascara,200,400,200,2,00275,India
892515,2023-12-01,1001,Lipstick,150,300,150,2,00275,India
892515,2023-12-01,1006,Blush,150,300,150,2,00275,India
892515,2023-12-01,1012,Body Lotion,200,400,200,2,00275,India
283269,2023-12-01,1002,Mascara,200,400,200,2,00077,India
283269,2023-12-01,1012,Body Lotion,200,400,200,2,00077,India
699485,2023-12-01,1006,Blush,150,300,150,2,00090,India
699485,2023-12-01,1005,Nail Polish,50,100,50,2,00090,India
699485,2023-12-01,1002,Mascara,200,400,200,2,00090,India
699485,2023-12-01,1004,Eyeliner,100,200,100,2,00090,India
699485,2023-12-01,1003,Foundation,300,600,300,2,00090,India
322602,2023-12-01,1004,Eyeliner,100,200,100,2,00298,India
322602,2023-12-01,1006,Blush,150,300,150,2,00298,India
322602,2023-12-01,1005,Nail Polish,50,100,50,2,00298,India
602052,2023-12-01,1002,Mascara,200,400,200,2,00354,India
602052,2023-12-01,1004,Eyeliner,100,200,100,2,00354,India
977135,2023-12-01,1005,Nail Polish,50,100,50,2,00206,India
500556,2023-12-01,1002,Mascara,200,400,200,2,00454,India
133226,2023-12-01,1002,Mascara,200,400,200,2,00131,India
133226,2023-12-01,1012,Body Lotion,200,400,200,2,00131,India
483360,2023-12-01,1005,Nail Polish,50,100,50,2,00441,India
215352,2023-12-01,1007,Eyeshadow,200,400,200,2,00463,India
215352,2023-12-01,1004,Eyeliner,100,200,100,2,00463,India
215352,2023-12-01,1005,Nail Polish,50,100,50,2,00463,India
519594,2023-12-01,1012,Body Lotion,200,400,200,2,00150,India
519594,2023-12-01,1004,Eyeliner,100,200,100,2,00150,India
519594,2023-12-01,1007,Eyeshadow,200,400,200,2,00150,India
519594,2023-12-01,1001,Lipstick,150,300,150,2,00150,India
312534,2023-12-01,1001,Lipstick,150,300,150,2,00160,India
981283,2023-12-01,1009,Moisturizer,250,500,250,2,00047,India
981283,2023-12-01,1006,Blush,150,300,150,2,00047,India
981283,2023-12-01,1012,Body Lotion,200,400,200,2,00047,India
897610,2023-12-01,1001,Lipstick,150,300,150,2,00308,India
481295,2023-12-01,1008,Makeup Remover,80,160,80,2,00008,India
481295,2023-12-01,1003,Foundation,300,600,300,2,00008,India
481295,2023-12-01,1009,Moisturizer,250,500,250,2,00008,India
481295,2023-12-01,1012,Body Lotion,200,400,200,2,00008,India
356063,2023-12-02,1009,Moisturizer,250,500,250,2,00214,India
356063,2023-12-02,1004,Eyeliner,100,200,100,2,00214,India
356063,2023-12-02,1012,Body Lotion,200,400,200,2,00214,India
356063,2023-12-02,1003,Foundation,300,600,300,2,00214,India
575124,2023-12-02,1005,Nail Polish,50,100,50,2,00199,India
575124,2023-12-02,1007,Eyeshadow,200,400,200,2,00199,India
257632,2023-12-02,1001,Lipstick,150,300,150,2,00451,India
304734,2023-12-02,1001,Lipstick,150,300,150,2,00303,India
304734,2023-12-02,1004,Eyeliner,100,200,100,2,00303,India
304734,2023-12-02,1007,Eyeshadow,200,400,200,2,00303,India
304734,2023-12-02,1005,Nail Polish,50,100,50,2,00303,India
894990,2023-12-02,1008,Makeup Remover,80,160,80,2,00397,India
894990,2023-12-02,1012,Body Lotion,200,400,200,2,00397,India
894990,2023-12-02,1001,Lipstick,150,300,150,2,00397,India
675560,2023-12-02,1009,Moisturizer,250,500,250,2,00473,India
675560,2023-12-02,1006,Blush,150,300,150,2,00473,India
675560,2023-12-02,1012,Body Lotion,200,400,200,2,00473,India
530087,2023-12-02,1012,Body Lotion,200,400,200,2,00457,India
155304,2023-12-02,1002,Mascara,200,400,200,2,00454,India
155304,2023-12-02,1006,Blush,150,300,150,2,00454,India
155304,2023-12-02,1008,Makeup Remover,80,160,80,2,00454,India
155304,2023-12-02,1003,Foundation,300,600,300,2,00454,India
660413,2023-12-02,1008,Makeup Remover,80,160,80,2,00003,India
660413,2023-12-02,1005,Nail Polish,50,100,50,2,00003,India
660413,2023-12-02,1001,Lipstick,150,300,150,2,00003,India
660413,2023-12-02,1002,Mascara,200,400,200,2,00003,India
660413,2023-12-02,1003,Foundation,300,600,300,2,00003,India
990839,2023-12-02,1001,Lipstick,150,300,150,2,00090,India
990839,2023-12-02,1002,Mascara,200,400,200,2,00090,India
682939,2023-12-02,1001,Lipstick,150,300,150,2,00148,India
682939,2023-12-02,1012,Body Lotion,200,400,200,2,00148,India
682939,2023-12-02,1005,Nail Polish,50,100,50,2,00148,India
682939,2023-12-02,1008,Makeup Remover,80,160,80,2,00148,India
453757,2023-12-02,1005,Nail Polish,50,100,50,2,00230,India
453757,2023-12-02,1009,Moisturizer,250,500,250,2,00230,India
453757,2023-12-02,1001,Lipstick,150,300,150,2,00230,India
985566,2023-12-02,1008,Makeup Remover,80,160,80,2,00427,India
985566,2023-12-02,1012,Body Lotion,200,400,200,2,00427,India
985566,2023-12-02,1009,Moisturizer,250,500,250,2,00427,India
757586,2023-12-02,1006,Blush,150,300,150,2,00427,India
757586,2023-12-02,1007,Eyeshadow,200,400,200,2,00427,India
757586,2023-12-02,1005,Nail Polish,50,100,50,2,00427,India
757586,2023-12-02,1002,Mascara,200,400,200,2,00427,India
757586,2023-12-02,1001,Lipstick,150,300,150,2,00427,India
711559,2023-12-02,1008,Makeup Remover,80,160,80,2,00359,India
706556,2023-12-02,1006,Blush,150,300,150,2,00381,India
706556,2023-12-02,1004,Eyeliner,100,200,100,2,00381,India
706556,2023-12-02,1003,Foundation,300,600,300,2,00381,India
137986,2023-12-02,1003,Foundation,300,600,300,2,00311,India
137986,2023-12-02,1007,Eyeshadow,200,400,200,2,00311,India
137986,2023-12-02,1009,Moisturizer,250,500,250,2,00311,India
652946,2023-12-02,1012,Body Lotion,200,400,200,2,00241,India
652946,2023-12-02,1005,Nail Polish,50,100,50,2,00241,India
652946,2023-12-02,1007,Eyeshadow,200,400,200,2,00241,India
652946,2023-12-02,1003,Foundation,300,600,300,2,00241,India
820299,2023-12-02,1012,Body Lotion,200,400,200,2,00143,India
820299,2023-12-02,1009,Moisturizer,250,500,250,2,00143,India
820299,2023-12-02,1002,Mascara,200,400,200,2,00143,India
894663,2023-12-02,1002,Mascara,200,400,200,2,00330,India
894663,2023-12-02,1004,Eyeliner,100,200,100,2,00330,India
894663,2023-12-02,1007,Eyeshadow,200,400,200,2,00330,India
486238,2023-12-02,1007,Eyeshadow,200,400,200,2,00332,India
486238,2023-12-02,1008,Makeup Remover,80,160,80,2,00332,India
486238,2023-12-02,1003,Foundation,300,600,300,2,00332,India
844602,2023-12-02,1009,Moisturizer,250,500,250,2,00483,India
419084,2023-12-02,1006,Blush,150,300,150,2,00487,India
419084,2023-12-02,1012,Body Lotion,200,400,200,2,00487,India
419084,2023-12-02,1005,Nail Polish,50,100,50,2,00487,India
419084,2023-12-02,1007,Eyeshadow,200,400,200,2,00487,India
425545,2023-12-02,1008,Makeup Remover,80,160,80,2,00499,India
425545,2023-12-02,1003,Foundation,300,600,300,2,00499,India
425545,2023-12-02,1006,Blush,150,300,150,2,00499,India
966019,2023-12-02,1002,Mascara,200,400,200,2,00381,India
966019,2023-12-02,1007,Eyeshadow,200,400,200,2,00381,India
966019,2023-12-02,1008,Makeup Remover,80,160,80,2,00381,India
889681,2023-12-02,1007,Eyeshadow,200,400,200,2,00461,India
889681,2023-12-02,1003,Foundation,300,600,300,2,00461,India
889681,2023-12-02,1001,Lipstick,150,300,150,2,00461,India
889681,2023-12-02,1008,Makeup Remover,80,160,80,2,00461,India
889681,2023-12-02,1006,Blush,150,300,150,2,00461,India
837034,2023-12-02,1007,Eyeshadow,200,400,200,2,00240,India
257198,2023-12-02,1008,Makeup Remover,80,160,80,2,00009,India
257198,2023-12-02,1003,Foundation,300,600,300,2,00009,India
257198,2023-12-02,1006,Blush,150,300,150,2,00009,India
257198,2023-12-02,1007,Eyeshadow,200,400,200,2,00009,India
257198,2023-12-02,1001,Lipstick,150,300,150,2,00009,India
330947,2023-12-02,1001,Lipstick,150,300,150,2,00419,India
330947,2023-12-02,1002,Mascara,200,400,200,2,00419,India
330947,2023-12-02,1004,Eyeliner,100,200,100,2,00419,India
252468,2023-12-02,1001,Lipstick,150,300,150,2,00290,India
252468,2023-12-02,1009,Moisturizer,250,500,250,2,00290,India
252468,2023-12-02,1008,Makeup Remover,80,160,80,2,00290,India
252468,2023-12-02,1005,Nail Polish,50,100,50,2,00290,India
252468,2023-12-02,1003,Foundation,300,600,300,2,00290,India
989084,2023-12-02,1003,Foundation,300,600,300,2,00096,India
989084,2023-12-02,1002,Mascara,200,400,200,2,00096,India
676269,2023-12-02,1012,Body Lotion,200,400,200,2,00187,India
676269,2023-12-02,1003,Foundation,300,600,300,2,00187,India
678770,2023-12-02,1007,Eyeshadow,200,400,200,2,00418,India
678770,2023-12-02,1009,Moisturizer,250,500,250,2,00418,India
678770,2023-12-02,1012,Body Lotion,200,400,200,2,00418,India
678770,2023-12-02,1005,Nail Polish,50,100,50,2,00418,India
460432,2023-12-02,1005,Nail Polish,50,100,50,2,00125,India
905322,2023-12-02,1004,Eyeliner,100,200,100,2,00121,India
905322,2023-12-02,1003,Foundation,300,600,300,2,00121,India
905322,2023-12-02,1009,Moisturizer,250,500,250,2,00121,India
340568,2023-12-02,1005,Nail Polish,50,100,50,2,00114,India
340568,2023-12-02,1008,Makeup Remover,80,160,80,2,00114,India
236301,2023-12-02,1007,Eyeshadow,200,400,200,2,00202,India
808515,2023-12-02,1002,Mascara,200,400,200,2,00489,India
808515,2023-12-02,1008,Makeup Remover,80,160,80,2,00489,India
409893,2023-12-02,1003,Foundation,300,600,300,2,00321,India
409893,2023-12-02,1004,Eyeliner,100,200,100,2,00321,India
409893,2023-12-02,1008,Makeup Remover,80,160,80,2,00321,India
767716,2023-12-02,1006,Blush,150,300,150,2,00159,India
494109,2023-12-02,1001,Lipstick,150,300,150,2,00380,India
494109,2023-12-02,1002,Mascara,200,400,200,2,00380,India
494109,2023-12-02,1003,Foundation,300,600,300,2,00380,India
437968,2023-12-02,1012,Body Lotion,200,400,200,2,00028,India
437968,2023-12-02,1001,Lipstick,150,300,150,2,00028,India
437968,2023-12-02,1006,Blush,150,300,150,2,00028,India
898743,2023-12-02,1001,Lipstick,150,300,150,2,00089,India
898743,2023-12-02,1009,Moisturizer,250,500,250,2,00089,India
616158,2023-12-02,1003,Foundation,300,600,300,2,00413,India
616158,2023-12-02,1012,Body Lotion,200,400,200,2,00413,India
616158,2023-12-02,1009,Moisturizer,250,500,250,2,00413,India
122419,2023-12-02,1001,Lipstick,150,300,150,2,00172,India
122419,2023-12-02,1009,Moisturizer,250,500,250,2,00172,India
281307,2023-12-02,1012,Body Lotion,200,400,200,2,00027,India
281307,2023-12-02,1007,Eyeshadow,200,400,200,2,00027,India
281307,2023-12-02,1004,Eyeliner,100,200,100,2,00027,India
588992,2023-12-02,1004,Eyeliner,100,200,100,2,00460,India
550119,2023-12-02,1004,Eyeliner,100,200,100,2,00397,India
550119,2023-12-02,1002,Mascara,200,400,200,2,00397,India
550119,2023-12-02,1006,Blush,150,300,150,2,00397,India
173571,2023-12-03,1008,Makeup Remover,80,160,80,2,00339,India
188779,2023-12-03,1005,Nail Polish,50,100,50,2,00268,India
285275,2023-12-03,1006,Blush,150,300,150,2,00073,India
285275,2023-12-03,1008,Makeup Remover,80,160,80,2,00073,India
285275,2023-12-03,1001,Lipstick,150,300,150,2,00073,India
285275,2023-12-03,1002,Mascara,200,400,200,2,00073,India
285275,2023-12-03,1009,Moisturizer,250,500,250,2,00073,India
440205,2023-12-03,1012,Body Lotion,200,400,200,2,00399,India
440205,2023-12-03,1005,Nail Polish,50,100,50,2,00399,India
192137,2023-12-03,1005,Nail Polish,50,100,50,2,00070,India
298677,2023-12-03,1005,Nail Polish,50,100,50,2,00408,India
298677,2023-12-03,1008,Makeup Remover,80,160,80,2,00408,India
298677,2023-12-03,1004,Eyeliner,100,200,100,2,00408,India
298677,2023-12-03,1007,Eyeshadow,200,400,200,2,00408,India
298677,2023-12-03,1002,Mascara,200,400,200,2,00408,India
107754,2023-12-03,1008,Makeup Remover,80,160,80,2,00235,India
107754,2023-12-03,1001,Lipstick,150,300,150,2,00235,India
107754,2023-12-03,1007,Eyeshadow,200,400,200,2,00235,India
151311,2023-12-03,1007,Eyeshadow,200,400,200,2,00458,India
435660,2023-12-03,1004,Eyeliner,100,200,100,2,00316,India
435660,2023-12-03,1003,Foundation,300,600,300,2,00316,India
435660,2023-12-03,1007,Eyeshadow,200,400,200,2,00316,India
572028,2023-12-03,1002,Mascara,200,400,200,2,00108,India
572028,2023-12-03,1007,Eyeshadow,200,400,200,2,00108,India
572028,2023-12-03,1009,Moisturizer,250,500,250,2,00108,India
572028,2023-12-03,1006,Blush,150,300,150,2,00108,India
476034,2023-12-03,1004,Eyeliner,100,200,100,2,00338,India
476034,2023-12-03,1001,Lipstick,150,300,150,2,00338,India
476034,2023-12-03,1002,Mascara,200,400,200,2,00338,India
476034,2023-12-03,1012,Body Lotion,200,400,200,2,00338,India
957175,2023-12-03,1005,Nail Polish,50,100,50,2,00032,India
153778,2023-12-03,1003,Foundation,300,600,300,2,00316,India
153778,2023-12-03,1007,Eyeshadow,200,400,200,2,00316,India
153778,2023-12-03,1002,Mascara,200,400,200,2,00316,India
451616,2023-12-03,1002,Mascara,200,400,200,2,00438,India
451616,2023-12-03,1005,Nail Polish,50,100,50,2,00438,India
451616,2023-12-03,1012,Body Lotion,200,400,200,2,00438,India
239039,2023-12-03,1006,Blush,150,300,150,2,00006,India
367194,2023-12-03,1005,Nail Polish,50,100,50,2,00301,India
367194,2023-12-03,1009,Moisturizer,250,500,250,2,00301,India
367194,2023-12-03,1007,Eyeshadow,200,400,200,2,00301,India
367194,2023-12-03,1001,Lipstick,150,300,150,2,00301,India
768425,2023-12-03,1005,Nail Polish,50,100,50,2,00454,India
957214,2023-12-03,1001,Lipstick,150,300,150,2,00172,India
334181,2023-12-03,1006,Blush,150,300,150,2,00104,India
334181,2023-12-03,1008,Makeup Remover,80,160,80,2,00104,India
334181,2023-12-03,1007,Eyeshadow,200,400,200,2,00104,India
388044,2023-12-03,1003,Foundation,300,600,300,2,00440,India
388044,2023-12-03,1007,Eyeshadow,200,400,200,2,00440,India
788345,2023-12-03,1005,Nail Polish,50,100,50,2,00480,India
635879,2023-12-03,1012,Body Lotion,200,400,200,2,00340,India
635879,2023-12-03,1006,Blush,150,300,150,2,00340,India
496966,2023-12-03,1007,Eyeshadow,200,400,200,2,00138,India
496966,2023-12-03,1003,Foundation,300,600,300,2,00138,India
915464,2023-12-03,1005,Nail Polish,50,100,50,2,00108,India
915464,2023-12-03,1001,Lipstick,150,300,150,2,00108,India
915464,2023-12-03,1004,Eyeliner,100,200,100,2,00108,India
915464,2023-12-03,1003,Foundation,300,600,300,2,00108,India
915464,2023-12-03,1007,Eyeshadow,200,400,200,2,00108,India
877920,2023-12-03,1003,Foundation,300,600,300,2,00110,India
877920,2023-12-03,1007,Eyeshadow,200,400,200,2,00110,India
877920,2023-12-03,1008,Makeup Remover,80,160,80,2,00110,India
412007,2023-12-03,1012,Body Lotion,200,400,200,2,00359,India
412007,2023-12-03,1007,Eyeshadow,200,400,200,2,00359,India
824672,2023-12-03,1012,Body Lotion,200,400,200,2,00333,India
824672,2023-12-03,1004,Eyeliner,100,200,100,2,00333,India
824672,2023-12-03,1007,Eyeshadow,200,400,200,2,00333,India
233430,2023-12-03,1005,Nail Polish,50,100,50,2,00126,India
233430,2023-12-03,1006,Blush,150,300,150,2,00126,India
233430,2023-12-03,1009,Moisturizer,250,500,250,2,00126,India
233430,2023-12-03,1008,Makeup Remover,80,160,80,2,00126,India
441415,2023-12-03,1005,Nail Polish,50,100,50,2,00286,India
441415,2023-12-03,1008,Makeup Remover,80,160,80,2,00286,India
441415,2023-12-03,1006,Blush,150,300,150,2,00286,India
208516,2023-12-03,1009,Moisturizer,250,500,250,2,00127,India
208516,2023-12-03,1004,Eyeliner,100,200,100,2,00127,India
208516,2023-12-03,1012,Body Lotion,200,400,200,2,00127,India
208516,2023-12-03,1003,Foundation,300,600,300,2,00127,India
900956,2023-12-04,1012,Body Lotion,200,400,200,2,00029,India
900956,2023-12-04,1006,Blush,150,300,150,2,00029,India
414200,2023-12-04,1007,Eyeshadow,200,400,200,2,00169,India
414200,2023-12-04,1009,Moisturizer,250,500,250,2,00169,India
414200,2023-12-04,1002,Mascara,200,400,200,2,00169,India
286157,2023-12-04,1008,Makeup Remover,80,160,80,2,00384,India
885962,2023-12-04,1006,Blush,150,300,150,2,00395,India
885962,2023-12-04,1009,Moisturizer,250,500,250,2,00395,India
885962,2023-12-04,1001,Lipstick,150,300,150,2,00395,India
932228,2023-12-04,1007,Eyeshadow,200,400,200,2,00089,India
932228,2023-12-04,1003,Foundation,300,600,300,2,00089,India
932228,2023-12-04,1009,Moisturizer,250,500,250,2,00089,India
932228,2023-12-04,1012,Body Lotion,200,400,200,2,00089,India
939699,2023-12-04,1008,Makeup Remover,80,160,80,2,00007,India
939699,2023-12-04,1009,Moisturizer,250,500,250,2,00007,India
939699,2023-12-04,1004,Eyeliner,100,200,100,2,00007,India
939699,2023-12-04,1006,Blush,150,300,150,2,00007,India
939699,2023-12-04,1002,Mascara,200,400,200,2,00007,India
123358,2023-12-04,1012,Body Lotion,200,400,200,2,00223,India
123358,2023-12-04,1005,Nail Polish,50,100,50,2,00223,India
429084,2023-12-04,1007,Eyeshadow,200,400,200,2,00102,India
429084,2023-12-04,1008,Makeup Remover,80,160,80,2,00102,India
402775,2023-12-04,1008,Makeup Remover,80,160,80,2,00177,India
402775,2023-12-04,1006,Blush,150,300,150,2,00177,India
628886,2023-12-04,1003,Foundation,300,600,300,2,00160,India
628886,2023-12-04,1007,Eyeshadow,200,400,200,2,00160,India
628886,2023-12-04,1009,Moisturizer,250,500,250,2,00160,India
628886,2023-12-04,1001,Lipstick,150,300,150,2,00160,India
253797,2023-12-04,1001,Lipstick,150,300,150,2,00301,India
253797,2023-12-04,1008,Makeup Remover,80,160,80,2,00301,India
888229,2023-12-04,1001,Lipstick,150,300,150,2,00457,India
888229,2023-12-04,1012,Body Lotion,200,400,200,2,00457,India
888229,2023-12-04,1008,Makeup Remover,80,160,80,2,00457,India
888229,2023-12-04,1002,Mascara,200,400,200,2,00457,India
287883,2023-12-04,1008,Makeup Remover,80,160,80,2,00401,India
930130,2023-12-04,1006,Blush,150,300,150,2,00052,India
930130,2023-12-04,1005,Nail Polish,50,100,50,2,00052,India
319812,2023-12-04,1008,Makeup Remover,80,160,80,2,00271,India
492989,2023-12-04,1008,Makeup Remover,80,160,80,2,00138,India
320816,2023-12-04,1004,Eyeliner,100,200,100,2,00261,India
320816,2023-12-04,1005,Nail Polish,50,100,50,2,00261,India
320816,2023-12-04,1002,Mascara,200,400,200,2,00261,India
320816,2023-12-04,1007,Eyeshadow,200,400,200,2,00261,India
993844,2023-12-04,1001,Lipstick,150,300,150,2,00301,India
993844,2023-12-04,1012,Body Lotion,200,400,200,2,00301,India
993844,2023-12-04,1008,Makeup Remover,80,160,80,2,00301,India
251187,2023-12-04,1002,Mascara,200,400,200,2,00034,India
251187,2023-12-04,1007,Eyeshadow,200,400,200,2,00034,India
251187,2023-12-04,1008,Makeup Remover,80,160,80,2,00034,India
251187,2023-12-04,1005,Nail Polish,50,100,50,2,00034,India
278502,2023-12-04,1007,Eyeshadow,200,400,200,2,00192,India
847099,2023-12-04,1003,Foundation,300,600,300,2,00009,India
847099,2023-12-04,1002,Mascara,200,400,200,2,00009,India
488558,2023-12-04,1001,Lipstick,150,300,150,2,00400,India
488558,2023-12-04,1003,Foundation,300,600,300,2,00400,India
488558,2023-12-04,1005,Nail Polish,50,100,50,2,00400,India
488558,2023-12-04,1004,Eyeliner,100,200,100,2,00400,India
430329,2023-12-04,1012,Body Lotion,200,400,200,2,00193,India
430329,2023-12-04,1006,Blush,150,300,150,2,00193,India
430329,2023-12-04,1001,Lipstick,150,300,150,2,00193,India
828462,2023-12-04,1006,Blush,150,300,150,2,00201,India
798564,2023-12-04,1007,Eyeshadow,200,400,200,2,00290,India
798564,2023-12-04,1008,Makeup Remover,80,160,80,2,00290,India
798564,2023-12-04,1012,Body Lotion,200,400,200,2,00290,India
798564,2023-12-04,1006,Blush,150,300,150,2,00290,India
798564,2023-12-04,1005,Nail Polish,50,100,50,2,00290,India
170489,2023-12-04,1001,Lipstick,150,300,150,2,00313,India
170489,2023-12-04,1004,Eyeliner,100,200,100,2,00313,India
373964,2023-12-04,1001,Lipstick,150,300,150,2,00353,India
373964,2023-12-04,1002,Mascara,200,400,200,2,00353,India
373964,2023-12-04,1008,Makeup Remover,80,160,80,2,00353,India
373964,2023-12-04,1009,Moisturizer,250,500,250,2,00353,India
951922,2023-12-04,1007,Eyeshadow,200,400,200,2,00057,India
951922,2023-12-04,1009,Moisturizer,250,500,250,2,00057,India
951922,2023-12-04,1008,Makeup Remover,80,160,80,2,00057,India
290012,2023-12-04,1004,Eyeliner,100,200,100,2,00052,India
208662,2023-12-04,1006,Blush,150,300,150,2,00051,India
965904,2023-12-04,1008,Makeup Remover,80,160,80,2,00250,India
965904,2023-12-04,1003,Foundation,300,600,300,2,00250,India
965904,2023-12-04,1001,Lipstick,150,300,150,2,00250,India
717980,2023-12-04,1006,Blush,150,300,150,2,00058,India
717980,2023-12-04,1003,Foundation,300,600,300,2,00058,India
185937,2023-12-04,1004,Eyeliner,100,200,100,2,00098,India
185937,2023-12-04,1005,Nail Polish,50,100,50,2,00098,India
995718,2023-12-04,1001,Lipstick,150,300,150,2,00069,India
995718,2023-12-04,1009,Moisturizer,250,500,250,2,00069,India
995718,2023-12-04,1007,Eyeshadow,200,400,200,2,00069,India
995718,2023-12-04,1002,Mascara,200,400,200,2,00069,India
947524,2023-12-04,1008,Makeup Remover,80,160,80,2,00321,India
947524,2023-12-04,1006,Blush,150,300,150,2,00321,India
947524,2023-12-04,1012,Body Lotion,200,400,200,2,00321,India
947524,2023-12-04,1003,Foundation,300,600,300,2,00321,India
760146,2023-12-04,1001,Lipstick,150,300,150,2,00401,India
164501,2023-12-04,1009,Moisturizer,250,500,250,2,00305,India
824603,2023-12-04,1002,Mascara,200,400,200,2,00062,India
824603,2023-12-04,1005,Nail Polish,50,100,50,2,00062,India
824603,2023-12-04,1008,Makeup Remover,80,160,80,2,00062,India
824603,2023-12-04,1001,Lipstick,150,300,150,2,00062,India
824603,2023-12-04,1012,Body Lotion,200,400,200,2,00062,India
247336,2023-12-04,1012,Body Lotion,200,400,200,2,00305,India
247336,2023-12-04,1004,Eyeliner,100,200,100,2,00305,India
247336,2023-12-04,1007,Eyeshadow,200,400,200,2,00305,India
247336,2023-12-04,1005,Nail Polish,50,100,50,2,00305,India
586000,2023-12-04,1009,Moisturizer,250,500,250,2,00129,India
141034,2023-12-04,1009,Moisturizer,250,500,250,2,00494,India
141034,2023-12-04,1003,Foundation,300,600,300,2,00494,India
435782,2023-12-04,1008,Makeup Remover,80,160,80,2,00397,India
627221,2023-12-04,1007,Eyeshadow,200,400,200,2,00021,India
627221,2023-12-04,1008,Makeup Remover,80,160,80,2,00021,India
627221,2023-12-04,1003,Foundation,300,600,300,2,00021,India
627221,2023-12-04,1006,Blush,150,300,150,2,00021,India
516717,2023-12-04,1005,Nail Polish,50,100,50,2,00409,India
516717,2023-12-04,1008,Makeup Remover,80,160,80,2,00409,India
516717,2023-12-04,1001,Lipstick,150,300,150,2,00409,India
113471,2023-12-05,1007,Eyeshadow,200,400,200,2,00367,India
113471,2023-12-05,1004,Eyeliner,100,200,100,2,00367,India
217430,2023-12-05,1005,Nail Polish,50,100,50,2,00143,India
217430,2023-12-05,1001,Lipstick,150,300,150,2,00143,India
217430,2023-12-05,1006,Blush,150,300,150,2,00143,India
381850,2023-12-05,1008,Makeup Remover,80,160,80,2,00054,India
381850,2023-12-05,1004,Eyeliner,100,200,100,2,00054,India
293932,2023-12-05,1005,Nail Polish,50,100,50,2,00228,India
293932,2023-12-05,1006,Blush,150,300,150,2,00228,India
293932,2023-12-05,1009,Moisturizer,250,500,250,2,00228,India
293932,2023-12-05,1003,Foundation,300,600,300,2,00228,India
293932,2023-12-05,1002,Mascara,200,400,200,2,00228,India
653048,2023-12-05,1004,Eyeliner,100,200,100,2,00417,India
653048,2023-12-05,1005,Nail Polish,50,100,50,2,00417,India
653048,2023-12-05,1003,Foundation,300,600,300,2,00417,India
653048,2023-12-05,1002,Mascara,200,400,200,2,00417,India
285912,2023-12-05,1006,Blush,150,300,150,2,00256,India
285912,2023-12-05,1004,Eyeliner,100,200,100,2,00256,India
992065,2023-12-05,1002,Mascara,200,400,200,2,00270,India
992065,2023-12-05,1005,Nail Polish,50,100,50,2,00270,India
117757,2023-12-05,1004,Eyeliner,100,200,100,2,00151,India
117757,2023-12-05,1005,Nail Polish,50,100,50,2,00151,India
117757,2023-12-05,1007,Eyeshadow,200,400,200,2,00151,India
788157,2023-12-05,1002,Mascara,200,400,200,2,00148,India
788157,2023-12-05,1012,Body Lotion,200,400,200,2,00148,India
788157,2023-12-05,1009,Moisturizer,250,500,250,2,00148,India
788157,2023-12-05,1005,Nail Polish,50,100,50,2,00148,India
102831,2023-12-05,1006,Blush,150,300,150,2,00417,India
252321,2023-12-05,1007,Eyeshadow,200,400,200,2,00436,India
252321,2023-12-05,1009,Moisturizer,250,500,250,2,00436,India
252321,2023-12-05,1012,Body Lotion,200,400,200,2,00436,India
469883,2023-12-05,1003,Foundation,300,600,300,2,00175,India
469883,2023-12-05,1009,Moisturizer,250,500,250,2,00175,India
424722,2023-12-05,1002,Mascara,200,400,200,2,00294,India
424722,2023-12-05,1006,Blush,150,300,150,2,00294,India
424722,2023-12-05,1005,Nail Polish,50,100,50,2,00294,India
378847,2023-12-05,1002,Mascara,200,400,200,2,00159,India
378847,2023-12-05,1001,Lipstick,150,300,150,2,00159,India
146067,2023-12-05,1004,Eyeliner,100,200,100,2,00394,India
146067,2023-12-05,1005,Nail Polish,50,100,50,2,00394,India
146067,2023-12-05,1003,Foundation,300,600,300,2,00394,India
146067,2023-12-05,1012,Body Lotion,200,400,200,2,00394,India
579623,2023-12-05,1001,Lipstick,150,300,150,2,00254,India
579623,2023-12-05,1002,Mascara,200,400,200,2,00254,India
579623,2023-12-05,1006,Blush,150,300,150,2,00254,India
579623,2023-12-05,1003,Foundation,300,600,300,2,00254,India
135879,2023-12-05,1003,Foundation,300,600,300,2,00213,India
135879,2023-12-05,1001,Lipstick,150,300,150,2,00213,India
135879,2023-12-05,1006,Blush,150,300,150,2,00213,India
391060,2023-12-05,1005,Nail Polish,50,100,50,2,00171,India
391060,2023-12-05,1007,Eyeshadow,200,400,200,2,00171,India
391060,2023-12-05,1009,Moisturizer,250,500,250,2,00171,India
391060,2023-12-05,1003,Foundation,300,600,300,2,00171,India
391060,2023-12-05,1002,Mascara,200,400,200,2,00171,India
199999,2023-12-05,1012,Body Lotion,200,400,200,2,00308,India
199999,2023-12-05,1005,Nail Polish,50,100,50,2,00308,India
839147,2023-12-05,1007,Eyeshadow,200,400,200,2,00455,India
839147,2023-12-05,1002,Mascara,200,400,200,2,00455,India
839147,2023-12-05,1006,Blush,150,300,150,2,00455,India
839147,2023-12-05,1012,Body Lotion,200,400,200,2,00455,India
338801,2023-12-05,1002,Mascara,200,400,200,2,00434,India
338801,2023-12-05,1003,Foundation,300,600,300,2,00434,India
338801,2023-12-05,1005,Nail Polish,50,100,50,2,00434,India
338801,2023-12-05,1004,Eyeliner,100,200,100,2,00434,India
742206,2023-12-05,1012,Body Lotion,200,400,200,2,00103,India
742206,2023-12-05,1001,Lipstick,150,300,150,2,00103,India
742206,2023-12-05,1005,Nail Polish,50,100,50,2,00103,India
749700,2023-12-05,1004,Eyeliner,100,200,100,2,00286,India
749700,2023-12-05,1007,Eyeshadow,200,400,200,2,00286,India
749700,2023-12-05,1003,Foundation,300,600,300,2,00286,India
749700,2023-12-05,1001,Lipstick,150,300,150,2,00286,India
963821,2023-12-05,1006,Blush,150,300,150,2,00024,India
963821,2023-12-05,1004,Eyeliner,100,200,100,2,00024,India
351141,2023-12-05,1008,Makeup Remover,80,160,80,2,00485,India
351141,2023-12-05,1003,Foundation,300,600,300,2,00485,India
351141,2023-12-05,1012,Body Lotion,200,400,200,2,00485,India
351141,2023-12-05,1006,Blush,150,300,150,2,00485,India
351141,2023-12-05,1004,Eyeliner,100,200,100,2,00485,India
147665,2023-12-05,1001,Lipstick,150,300,150,2,00152,India
147665,2023-12-05,1007,Eyeshadow,200,400,200,2,00152,India
147665,2023-12-05,1005,Nail Polish,50,100,50,2,00152,India
127863,2023-12-05,1003,Foundation,300,600,300,2,00091,India
127863,2023-12-05,1009,Moisturizer,250,500,250,2,00091,India
127863,2023-12-05,1008,Makeup Remover,80,160,80,2,00091,India
861765,2023-12-05,1007,Eyeshadow,200,400,200,2,00095,India
861765,2023-12-05,1009,Moisturizer,250,500,250,2,00095,India
836008,2023-12-05,1009,Moisturizer,250,500,250,2,00117,India
836008,2023-12-05,1005,Nail Polish,50,100,50,2,00117,India
836008,2023-12-05,1008,Makeup Remover,80,160,80,2,00117,India
836008,2023-12-05,1004,Eyeliner,100,200,100,2,00117,India
854568,2023-12-05,1006,Blush,150,300,150,2,00248,India
854568,2023-12-05,1005,Nail Polish,50,100,50,2,00248,India
854568,2023-12-05,1001,Lipstick,150,300,150,2,00248,India
150453,2023-12-05,1012,Body Lotion,200,400,200,2,00415,India
150453,2023-12-05,1007,Eyeshadow,200,400,200,2,00415,India
150453,2023-12-05,1001,Lipstick,150,300,150,2,00415,India
319551,2023-12-05,1006,Blush,150,300,150,2,00430,India
319551,2023-12-05,1012,Body Lotion,200,400,200,2,00430,India
221211,2023-12-05,1001,Lipstick,150,300,150,2,00271,India
221211,2023-12-05,1005,Nail Polish,50,100,50,2,00271,India
221211,2023-12-05,1004,Eyeliner,100,200,100,2,00271,India
221211,2023-12-05,1007,Eyeshadow,200,400,200,2,00271,India
689597,2023-12-05,1005,Nail Polish,50,100,50,2,00272,India
689597,2023-12-05,1004,Eyeliner,100,200,100,2,00272,India
815935,2023-12-05,1006,Blush,150,300,150,2,00220,India
566359,2023-12-05,1001,Lipstick,150,300,150,2,00119,India
965143,2023-12-05,1006,Blush,150,300,150,2,00464,India
965143,2023-12-05,1009,Moisturizer,250,500,250,2,00464,India
965143,2023-12-05,1002,Mascara,200,400,200,2,00464,India
252855,2023-12-05,1006,Blush,150,300,150,2,00059,India
938008,2023-12-05,1001,Lipstick,150,300,150,2,00185,India
938008,2023-12-05,1008,Makeup Remover,80,160,80,2,00185,India
938008,2023-12-05,1006,Blush,150,300,150,2,00185,India
550282,2023-12-05,1003,Foundation,300,600,300,2,00411,India
550282,2023-12-05,1004,Eyeliner,100,200,100,2,00411,India
483092,2023-12-05,1009,Moisturizer,250,500,250,2,00185,India
483092,2023-12-05,1001,Lipstick,150,300,150,2,00185,India
483092,2023-12-05,1006,Blush,150,300,150,2,00185,India
483092,2023-12-05,1005,Nail Polish,50,100,50,2,00185,India
550264,2023-12-05,1007,Eyeshadow,200,400,200,2,00317,India
550264,2023-12-05,1001,Lipstick,150,300,150,2,00317,India
766075,2023-12-05,1006,Blush,150,300,150,2,00086,India
766075,2023-12-05,1008,Makeup Remover,80,160,80,2,00086,India
766075,2023-12-05,1003,Foundation,300,600,300,2,00086,India
665443,2023-12-05,1001,Lipstick,150,300,150,2,00278,India
665443,2023-12-05,1004,Eyeliner,100,200,100,2,00278,India
665443,2023-12-05,1002,Mascara,200,400,200,2,00278,India
529685,2023-12-05,1006,Blush,150,300,150,2,00195,India
529685,2023-12-05,1002,Mascara,200,400,200,2,00195,India
951016,2023-12-05,1001,Lipstick,150,300,150,2,00456,India
951016,2023-12-05,1004,Eyeliner,100,200,100,2,00456,India
951016,2023-12-05,1009,Moisturizer,250,500,250,2,00456,India
173289,2023-12-05,1001,Lipstick,150,300,150,2,00003,India
237193,2023-12-05,1009,Moisturizer,250,500,250,2,00074,India
237193,2023-12-05,1002,Mascara,200,400,200,2,00074,India
237193,2023-12-05,1012,Body Lotion,200,400,200,2,00074,India
605854,2023-12-05,1009,Moisturizer,250,500,250,2,00175,India
605854,2023-12-05,1008,Makeup Remover,80,160,80,2,00175,India
605854,2023-12-05,1004,Eyeliner,100,200,100,2,00175,India
605854,2023-12-05,1001,Lipstick,150,300,150,2,00175,India
935811,2023-12-05,1006,Blush,150,300,150,2,00248,India
935811,2023-12-05,1001,Lipstick,150,300,150,2,00248,India
935811,2023-12-05,1004,Eyeliner,100,200,100,2,00248,India
935811,2023-12-05,1002,Mascara,200,400,200,2,00248,India
626969,2023-12-06,1009,Moisturizer,250,500,250,2,00024,India
431794,2023-12-06,1007,Eyeshadow,200,400,200,2,00140,India
721773,2023-12-06,1006,Blush,150,300,150,2,00018,India
721773,2023-12-06,1007,Eyeshadow,200,400,200,2,00018,India
721773,2023-12-06,1008,Makeup Remover,80,160,80,2,00018,India
721773,2023-12-06,1001,Lipstick,150,300,150,2,00018,India
866564,2023-12-06,1004,Eyeliner,100,200,100,2,00317,India
432658,2023-12-06,1008,Makeup Remover,80,160,80,2,00311,India
895095,2023-12-06,1002,Mascara,200,400,200,2,00213,India
895095,2023-12-06,1006,Blush,150,300,150,2,00213,India
895095,2023-12-06,1012,Body Lotion,200,400,200,2,00213,India
226583,2023-12-06,1007,Eyeshadow,200,400,200,2,00237,India
226583,2023-12-06,1001,Lipstick,150,300,150,2,00237,India
226583,2023-12-06,1004,Eyeliner,100,200,100,2,00237,India
226583,2023-12-06,1006,Blush,150,300,150,2,00237,India
889162,2023-12-06,1004,Eyeliner,100,200,100,2,00291,India
899440,2023-12-06,1009,Moisturizer,250,500,250,2,00452,India
899440,2023-12-06,1007,Eyeshadow,200,400,200,2,00452,India
899440,2023-12-06,1012,Body Lotion,200,400,200,2,00452,India
981564,2023-12-06,1004,Eyeliner,100,200,100,2,00375,India
981564,2023-12-06,1001,Lipstick,150,300,150,2,00375,India
981564,2023-12-06,1006,Blush,150,300,150,2,00375,India
981564,2023-12-06,1007,Eyeshadow,200,400,200,2,00375,India
674675,2023-12-06,1008,Makeup Remover,80,160,80,2,00309,India
674675,2023-12-06,1006,Blush,150,300,150,2,00309,India
674675,2023-12-06,1002,Mascara,200,400,200,2,00309,India
674675,2023-12-06,1007,Eyeshadow,200,400,200,2,00309,India
177531,2023-12-06,1008,Makeup Remover,80,160,80,2,00217,India
877192,2023-12-06,1002,Mascara,200,400,200,2,00499,India
943302,2023-12-06,1007,Eyeshadow,200,400,200,2,00438,India
943302,2023-12-06,1003,Foundation,300,600,300,2,00438,India
988968,2023-12-06,1008,Makeup Remover,80,160,80,2,00244,India
988968,2023-12-06,1012,Body Lotion,200,400,200,2,00244,India
207883,2023-12-06,1002,Mascara,200,400,200,2,00414,India
207883,2023-12-06,1006,Blush,150,300,150,2,00414,India
207883,2023-12-06,1007,Eyeshadow,200,400,200,2,00414,India
654580,2023-12-06,1007,Eyeshadow,200,400,200,2,00476,India
654580,2023-12-06,1003,Foundation,300,600,300,2,00476,India
654580,2023-12-06,1005,Nail Polish,50,100,50,2,00476,India
907144,2023-12-06,1006,Blush,150,300,150,2,00326,India
907144,2023-12-06,1002,Mascara,200,400,200,2,00326,India
148973,2023-12-06,1004,Eyeliner,100,200,100,2,00095,India
148973,2023-12-06,1006,Blush,150,300,150,2,00095,India
148973,2023-12-06,1002,Mascara,200,400,200,2,00095,India
448076,2023-12-06,1006,Blush,150,300,150,2,00478,India
448076,2023-12-06,1012,Body Lotion,200,400,200,2,00478,India
930801,2023-12-06,1007,Eyeshadow,200,400,200,2,00033,India
930801,2023-12-06,1009,Moisturizer,250,500,250,2,00033,India
930801,2023-12-06,1005,Nail Polish,50,100,50,2,00033,India
687506,2023-12-06,1012,Body Lotion,200,400,200,2,00154,India
812291,2023-12-06,1007,Eyeshadow,200,400,200,2,00295,India
812291,2023-12-06,1006,Blush,150,300,150,2,00295,India
812291,2023-12-06,1002,Mascara,200,400,200,2,00295,India
604593,2023-12-06,1012,Body Lotion,200,400,200,2,00200,India
604593,2023-12-06,1003,Foundation,300,600,300,2,00200,India
604593,2023-12-06,1006,Blush,150,300,150,2,00200,India
604593,2023-12-06,1009,Moisturizer,250,500,250,2,00200,India
604593,2023-12-06,1008,Makeup Remover,80,160,80,2,00200,India
806160,2023-12-06,1008,Makeup Remover,80,160,80,2,00458,India
806160,2023-12-06,1005,Nail Polish,50,100,50,2,00458,India
806160,2023-12-06,1004,Eyeliner,100,200,100,2,00458,India
806160,2023-12-06,1009,Moisturizer,250,500,250,2,00458,India
806160,2023-12-06,1001,Lipstick,150,300,150,2,00458,India
547581,2023-12-06,1008,Makeup Remover,80,160,80,2,00051,India
547581,2023-12-06,1007,Eyeshadow,200,400,200,2,00051,India
547581,2023-12-06,1005,Nail Polish,50,100,50,2,00051,India
295992,2023-12-06,1008,Makeup Remover,80,160,80,2,00251,India
295992,2023-12-06,1001,Lipstick,150,300,150,2,00251,India
583332,2023-12-06,1009,Moisturizer,250,500,250,2,00214,India
583332,2023-12-06,1003,Foundation,300,600,300,2,00214,India
273595,2023-12-06,1004,Eyeliner,100,200,100,2,00493,India
273595,2023-12-06,1002,Mascara,200,400,200,2,00493,India
273595,2023-12-06,1012,Body Lotion,200,400,200,2,00493,India
564447,2023-12-06,1012,Body Lotion,200,400,200,2,00158,India
564447,2023-12-06,1003,Foundation,300,600,300,2,00158,India
958121,2023-12-06,1001,Lipstick,150,300,150,2,00181,India
958121,2023-12-06,1005,Nail Polish,50,100,50,2,00181,India
499681,2023-12-06,1007,Eyeshadow,200,400,200,2,00302,India
997608,2023-12-06,1004,Eyeliner,100,200,100,2,00337,India
997608,2023-12-06,1006,Blush,150,300,150,2,00337,India
268218,2023-12-06,1005,Nail Polish,50,100,50,2,00247,India
453945,2023-12-06,1003,Foundation,300,600,300,2,00335,India
453945,2023-12-06,1002,Mascara,200,400,200,2,00335,India
453945,2023-12-06,1006,Blush,150,300,150,2,00335,India
846640,2023-12-06,1012,Body Lotion,200,400,200,2,00268,India
692767,2023-12-06,1007,Eyeshadow,200,400,200,2,00022,India
308373,2023-12-06,1009,Moisturizer,250,500,250,2,00076,India
645104,2023-12-06,1008,Makeup Remover,80,160,80,2,00123,India
645104,2023-12-06,1001,Lipstick,150,300,150,2,00123,India
645104,2023-12-06,1009,Moisturizer,250,500,250,2,00123,India
645104,2023-12-06,1007,Eyeshadow,200,400,200,2,00123,India
928626,2023-12-06,1003,Foundation,300,600,300,2,00394,India
928626,2023-12-06,1009,Moisturizer,250,500,250,2,00394,India
928626,2023-12-06,1007,Eyeshadow,200,400,200,2,00394,India
928626,2023-12-06,1012,Body Lotion,200,400,200,2,00394,India
808876,2023-12-06,1004,Eyeliner,100,200,100,2,00434,India
808876,2023-12-06,1005,Nail Polish,50,100,50,2,00434,India
782076,2023-12-06,1001,Lipstick,150,300,150,2,00063,India
782076,2023-12-06,1007,Eyeshadow,200,400,200,2,00063,India
466016,2023-12-06,1003,Foundation,300,600,300,2,00416,India
466016,2023-12-06,1002,Mascara,200,400,200,2,00416,India
480720,2023-12-06,1008,Makeup Remover,80,160,80,2,00447,India
203517,2023-12-06,1006,Blush,150,300,150,2,00209,India
203517,2023-12-06,1002,Mascara,200,400,200,2,00209,India
203517,2023-12-06,1012,Body Lotion,200,400,200,2,00209,India
392560,2023-12-06,1012,Body Lotion,200,400,200,2,00197,India
432931,2023-12-06,1002,Mascara,200,400,200,2,00265,India
133666,2023-12-06,1004,Eyeliner,100,200,100,2,00407,India
755721,2023-12-06,1002,Mascara,200,400,200,2,00360,India
415211,2023-12-06,1006,Blush,150,300,150,2,00016,India
415211,2023-12-06,1008,Makeup Remover,80,160,80,2,00016,India
247660,2023-12-07,1004,Eyeliner,100,200,100,2,00139,India
583505,2023-12-07,1002,Mascara,200,400,200,2,00448,India
735334,2023-12-07,1002,Mascara,200,400,200,2,00162,India
735334,2023-12-07,1008,Makeup Remover,80,160,80,2,00162,India
735334,2023-12-07,1009,Moisturizer,250,500,250,2,00162,India
223751,2023-12-07,1003,Foundation,300,600,300,2,00458,India
223751,2023-12-07,1006,Blush,150,300,150,2,00458,India
944729,2023-12-07,1009,Moisturizer,250,500,250,2,00488,India
154668,2023-12-07,1005,Nail Polish,50,100,50,2,00101,India
154668,2023-12-07,1009,Moisturizer,250,500,250,2,00101,India
154668,2023-12-07,1006,Blush,150,300,150,2,00101,India
598611,2023-12-07,1007,Eyeshadow,200,400,200,2,00460,India
598611,2023-12-07,1004,Eyeliner,100,200,100,2,00460,India
627317,2023-12-07,1007,Eyeshadow,200,400,200,2,00416,India
627317,2023-12-07,1012,Body Lotion,200,400,200,2,00416,India
627317,2023-12-07,1004,Eyeliner,100,200,100,2,00416,India
627317,2023-12-07,1009,Moisturizer,250,500,250,2,00416,India
958010,2023-12-07,1012,Body Lotion,200,400,200,2,00385,India
482085,2023-12-07,1007,Eyeshadow,200,400,200,2,00092,India
482085,2023-12-07,1001,Lipstick,150,300,150,2,00092,India
482085,2023-12-07,1003,Foundation,300,600,300,2,00092,India
932500,2023-12-07,1012,Body Lotion,200,400,200,2,00261,India
932500,2023-12-07,1007,Eyeshadow,200,400,200,2,00261,India
932500,2023-12-07,1009,Moisturizer,250,500,250,2,00261,India
932500,2023-12-07,1002,Mascara,200,400,200,2,00261,India
219914,2023-12-07,1003,Foundation,300,600,300,2,00215,India
219914,2023-12-07,1001,Lipstick,150,300,150,2,00215,India
219914,2023-12-07,1004,Eyeliner,100,200,100,2,00215,India
171850,2023-12-07,1007,Eyeshadow,200,400,200,2,00176,India
171850,2023-12-07,1008,Makeup Remover,80,160,80,2,00176,India
670248,2023-12-07,1008,Makeup Remover,80,160,80,2,00199,India
670248,2023-12-07,1002,Mascara,200,400,200,2,00199,India
670248,2023-12-07,1003,Foundation,300,600,300,2,00199,India
670248,2023-12-07,1009,Moisturizer,250,500,250,2,00199,India
465137,2023-12-07,1012,Body Lotion,200,400,200,2,00057,India
465137,2023-12-07,1003,Foundation,300,600,300,2,00057,India
465137,2023-12-07,1009,Moisturizer,250,500,250,2,00057,India
465137,2023-12-07,1007,Eyeshadow,200,400,200,2,00057,India
467793,2023-12-07,1005,Nail Polish,50,100,50,2,00496,India
504183,2023-12-07,1007,Eyeshadow,200,400,200,2,00355,India
504183,2023-12-07,1005,Nail Polish,50,100,50,2,00355,India
301065,2023-12-07,1009,Moisturizer,250,500,250,2,00387,India
301065,2023-12-07,1008,Makeup Remover,80,160,80,2,00387,India
301065,2023-12-07,1004,Eyeliner,100,200,100,2,00387,India
301065,2023-12-07,1001,Lipstick,150,300,150,2,00387,India
301065,2023-12-07,1007,Eyeshadow,200,400,200,2,00387,India
928134,2023-12-07,1007,Eyeshadow,200,400,200,2,00008,India
980463,2023-12-07,1008,Makeup Remover,80,160,80,2,00009,India
735664,2023-12-07,1002,Mascara,200,400,200,2,00408,India
735664,2023-12-07,1003,Foundation,300,600,300,2,00408,India
735664,2023-12-07,1005,Nail Polish,50,100,50,2,00408,India
735664,2023-12-07,1004,Eyeliner,100,200,100,2,00408,India
783746,2023-12-07,1009,Moisturizer,250,500,250,2,00401,India
783746,2023-12-07,1004,Eyeliner,100,200,100,2,00401,India
314383,2023-12-07,1005,Nail Polish,50,100,50,2,00038,India
314383,2023-12-07,1006,Blush,150,300,150,2,00038,India
380506,2023-12-07,1002,Mascara,200,400,200,2,00109,India
380506,2023-12-07,1007,Eyeshadow,200,400,200,2,00109,India
380506,2023-12-07,1009,Moisturizer,250,500,250,2,00109,India
380506,2023-12-07,1008,Makeup Remover,80,160,80,2,00109,India
691274,2023-12-07,1002,Mascara,200,400,200,2,00413,India
691274,2023-12-07,1007,Eyeshadow,200,400,200,2,00413,India
691274,2023-12-07,1008,Makeup Remover,80,160,80,2,00413,India
703674,2023-12-07,1008,Makeup Remover,80,160,80,2,00243,India
703674,2023-12-07,1002,Mascara,200,400,200,2,00243,India
703674,2023-12-07,1012,Body Lotion,200,400,200,2,00243,India
479567,2023-12-07,1008,Makeup Remover,80,160,80,2,00033,India
479567,2023-12-07,1009,Moisturizer,250,500,250,2,00033,India
461464,2023-12-07,1009,Moisturizer,250,500,250,2,00434,India
461464,2023-12-07,1001,Lipstick,150,300,150,2,00434,India
498340,2023-12-07,1006,Blush,150,300,150,2,00180,India
127456,2023-12-07,1004,Eyeliner,100,200,100,2,00041,India
127456,2023-12-07,1003,Foundation,300,600,300,2,00041,India
127456,2023-12-07,1002,Mascara,200,400,200,2,00041,India
127456,2023-12-07,1006,Blush,150,300,150,2,00041,India
852939,2023-12-07,1002,Mascara,200,400,200,2,00131,India
852939,2023-12-07,1007,Eyeshadow,200,400,200,2,00131,India
852939,2023-12-07,1012,Body Lotion,200,400,200,2,00131,India
852939,2023-12-07,1006,Blush,150,300,150,2,00131,India
949833,2023-12-07,1004,Eyeliner,100,200,100,2,00481,India
949833,2023-12-07,1006,Blush,150,300,150,2,00481,India
949833,2023-12-07,1001,Lipstick,150,300,150,2,00481,India
959389,2023-12-07,1007,Eyeshadow,200,400,200,2,00048,India
959389,2023-12-07,1006,Blush,150,300,150,2,00048,India
313335,2023-12-07,1009,Moisturizer,250,500,250,2,00029,India
313335,2023-12-07,1002,Mascara,200,400,200,2,00029,India
313335,2023-12-07,1001,Lipstick,150,300,150,2,00029,India
922071,2023-12-07,1004,Eyeliner,100,200,100,2,00021,India
922071,2023-12-07,1006,Blush,150,300,150,2,00021,India
922071,2023-12-07,1003,Foundation,300,600,300,2,00021,India
117255,2023-12-07,1012,Body Lotion,200,400,200,2,00275,India
117255,2023-12-07,1005,Nail Polish,50,100,50,2,00275,India
654906,2023-12-07,1005,Nail Polish,50,100,50,2,00371,India
718379,2023-12-07,1007,Eyeshadow,200,400,200,2,00468,India
718379,2023-12-07,1004,Eyeliner,100,200,100,2,00468,India
718379,2023-12-07,1001,Lipstick,150,300,150,2,00468,India
718379,2023-12-07,1003,Foundation,300,600,300,2,00468,India
642499,2023-12-07,1004,Eyeliner,100,200,100,2,00161,India
642499,2023-12-07,1002,Mascara,200,400,200,2,00161,India
508983,2023-12-07,1005,Nail Polish,50,100,50,2,00085,India
508983,2023-12-07,1009,Moisturizer,250,500,250,2,00085,India
508983,2023-12-07,1002,Mascara,200,400,200,2,00085,India
508983,2023-12-07,1003,Foundation,300,600,300,2,00085,India
941532,2023-12-08,1002,Mascara,200,400,200,2,00190,India
941532,2023-12-08,1003,Foundation,300,600,300,2,00190,India
171277,2023-12-08,1009,Moisturizer,250,500,250,2,00076,India
171277,2023-12-08,1008,Makeup Remover,80,160,80,2,00076,India
422852,2023-12-08,1003,Foundation,300,600,300,2,00493,India
422852,2023-12-08,1008,Makeup Remover,80,160,80,2,00493,India
422852,2023-12-08,1005,Nail Polish,50,100,50,2,00493,India
273351,2023-12-08,1008,Makeup Remover,80,160,80,2,00198,India
273351,2023-12-08,1006,Blush,150,300,150,2,00198,India
273351,2023-12-08,1009,Moisturizer,250,500,250,2,00198,India
273351,2023-12-08,1001,Lipstick,150,300,150,2,00198,India
970190,2023-12-08,1005,Nail Polish,50,100,50,2,00453,India
970190,2023-12-08,1002,Mascara,200,400,200,2,00453,India
970190,2023-12-08,1006,Blush,150,300,150,2,00453,India
970190,2023-12-08,1004,Eyeliner,100,200,100,2,00453,India
978765,2023-12-08,1008,Makeup Remover,80,160,80,2,00007,India
701082,2023-12-08,1003,Foundation,300,600,300,2,00231,India
997094,2023-12-08,1004,Eyeliner,100,200,100,2,00263,India
997094,2023-12-08,1009,Moisturizer,250,500,250,2,00263,India
997094,2023-12-08,1002,Mascara,200,400,200,2,00263,India
997094,2023-12-08,1012,Body Lotion,200,400,200,2,00263,India
931021,2023-12-08,1007,Eyeshadow,200,400,200,2,00072,India
331136,2023-12-08,1007,Eyeshadow,200,400,200,2,00031,India
319329,2023-12-08,1002,Mascara,200,400,200,2,00399,India
439378,2023-12-08,1009,Moisturizer,250,500,250,2,00458,India
439378,2023-12-08,1003,Foundation,300,600,300,2,00458,India
439378,2023-12-08,1004,Eyeliner,100,200,100,2,00458,India
439378,2023-12-08,1008,Makeup Remover,80,160,80,2,00458,India
637953,2023-12-08,1007,Eyeshadow,200,400,200,2,00305,India
637953,2023-12-08,1004,Eyeliner,100,200,100,2,00305,India
454664,2023-12-08,1008,Makeup Remover,80,160,80,2,00403,India
454664,2023-12-08,1005,Nail Polish,50,100,50,2,00403,India
454664,2023-12-08,1006,Blush,150,300,150,2,00403,India
358244,2023-12-08,1003,Foundation,300,600,300,2,00107,India
358244,2023-12-08,1007,Eyeshadow,200,400,200,2,00107,India
358244,2023-12-08,1012,Body Lotion,200,400,200,2,00107,India
358244,2023-12-08,1005,Nail Polish,50,100,50,2,00107,India
358244,2023-12-08,1002,Mascara,200,400,200,2,00107,India
205192,2023-12-08,1007,Eyeshadow,200,400,200,2,00243,India
205192,2023-12-08,1003,Foundation,300,600,300,2,00243,India
205192,2023-12-08,1008,Makeup Remover,80,160,80,2,00243,India
978973,2023-12-08,1004,Eyeliner,100,200,100,2,00356,India
263572,2023-12-08,1005,Nail Polish,50,100,50,2,00059,India
408180,2023-12-08,1002,Mascara,200,400,200,2,00321,India
408180,2023-12-08,1001,Lipstick,150,300,150,2,00321,India
408180,2023-12-08,1009,Moisturizer,250,500,250,2,00321,India
408180,2023-12-08,1006,Blush,150,300,150,2,00321,India
257694,2023-12-08,1009,Moisturizer,250,500,250,2,00365,India
257694,2023-12-08,1007,Eyeshadow,200,400,200,2,00365,India
257694,2023-12-08,1006,Blush,150,300,150,2,00365,India
257694,2023-12-08,1008,Makeup Remover,80,160,80,2,00365,India
297954,2023-12-08,1006,Blush,150,300,150,2,00164,India
297954,2023-12-08,1001,Lipstick,150,300,150,2,00164,India
297954,2023-12-08,1004,Eyeliner,100,200,100,2,00164,India
297954,2023-12-08,1009,Moisturizer,250,500,250,2,00164,India
752485,2023-12-08,1009,Moisturizer,250,500,250,2,00380,India
752485,2023-12-08,1001,Lipstick,150,300,150,2,00380,India
752485,2023-12-08,1002,Mascara,200,400,200,2,00380,India
519409,2023-12-08,1009,Moisturizer,250,500,250,2,00097,India
519409,2023-12-08,1006,Blush,150,300,150,2,00097,India
519409,2023-12-08,1004,Eyeliner,100,200,100,2,00097,India
140289,2023-12-08,1005,Nail Polish,50,100,50,2,00354,India
781068,2023-12-08,1007,Eyeshadow,200,400,200,2,00234,India
214563,2023-12-08,1007,Eyeshadow,200,400,200,2,00135,India
214563,2023-12-08,1012,Body Lotion,200,400,200,2,00135,India
214563,2023-12-08,1003,Foundation,300,600,300,2,00135,India
824966,2023-12-08,1001,Lipstick,150,300,150,2,00376,India
833207,2023-12-08,1006,Blush,150,300,150,2,00296,India
833207,2023-12-08,1003,Foundation,300,600,300,2,00296,India
184987,2023-12-08,1003,Foundation,300,600,300,2,00493,India
184987,2023-12-08,1001,Lipstick,150,300,150,2,00493,India
491431,2023-12-08,1009,Moisturizer,250,500,250,2,00131,India
491431,2023-12-08,1003,Foundation,300,600,300,2,00131,India
982502,2023-12-08,1002,Mascara,200,400,200,2,00399,India
982502,2023-12-08,1004,Eyeliner,100,200,100,2,00399,India
503886,2023-12-09,1002,Mascara,200,400,200,2,00425,India
503886,2023-12-09,1004,Eyeliner,100,200,100,2,00425,India
503886,2023-12-09,1001,Lipstick,150,300,150,2,00425,India
620927,2023-12-09,1008,Makeup Remover,80,160,80,2,00012,India
620927,2023-12-09,1004,Eyeliner,100,200,100,2,00012,India
118766,2023-12-09,1009,Moisturizer,250,500,250,2,00091,India
118766,2023-12-09,1004,Eyeliner,100,200,100,2,00091,India
118766,2023-12-09,1002,Mascara,200,400,200,2,00091,India
463785,2023-12-09,1003,Foundation,300,600,300,2,00190,India
463785,2023-12-09,1008,Makeup Remover,80,160,80,2,00190,India
463785,2023-12-09,1009,Moisturizer,250,500,250,2,00190,India
876887,2023-12-09,1005,Nail Polish,50,100,50,2,00331,India
876887,2023-12-09,1004,Eyeliner,100,200,100,2,00331,India
876887,2023-12-09,1007,Eyeshadow,200,400,200,2,00331,India
876887,2023-12-09,1002,Mascara,200,400,200,2,00331,India
292672,2023-12-09,1003,Foundation,300,600,300,2,00454,India
292672,2023-12-09,1006,Blush,150,300,150,2,00454,India
292672,2023-12-09,1002,Mascara,200,400,200,2,00454,India
721862,2023-12-09,1003,Foundation,300,600,300,2,00475,India
721862,2023-12-09,1001,Lipstick,150,300,150,2,00475,India
141722,2023-12-09,1007,Eyeshadow,200,400,200,2,00129,India
141722,2023-12-09,1008,Makeup Remover,80,160,80,2,00129,India
975122,2023-12-09,1005,Nail Polish,50,100,50,2,00314,India
975122,2023-12-09,1002,Mascara,200,400,200,2,00314,India
975122,2023-12-09,1009,Moisturizer,250,500,250,2,00314,India
429408,2023-12-09,1008,Makeup Remover,80,160,80,2,00392,India
429408,2023-12-09,1007,Eyeshadow,200,400,200,2,00392,India
429408,2023-12-09,1012,Body Lotion,200,400,200,2,00392,India
429408,2023-12-09,1003,Foundation,300,600,300,2,00392,India
429408,2023-12-09,1002,Mascara,200,400,200,2,00392,India
608873,2023-12-09,1005,Nail Polish,50,100,50,2,00146,India
999070,2023-12-09,1008,Makeup Remover,80,160,80,2,00160,India
999070,2023-12-09,1006,Blush,150,300,150,2,00160,India
947698,2023-12-09,1003,Foundation,300,600,300,2,00482,India
148732,2023-12-09,1004,Eyeliner,100,200,100,2,00418,India
148732,2023-12-09,1006,Blush,150,300,150,2,00418,India
148732,2023-12-09,1012,Body Lotion,200,400,200,2,00418,India
506670,2023-12-09,1009,Moisturizer,250,500,250,2,00236,India
870827,2023-12-09,1009,Moisturizer,250,500,250,2,00128,India
870827,2023-12-09,1001,Lipstick,150,300,150,2,00128,India
339865,2023-12-09,1009,Moisturizer,250,500,250,2,00068,India
339865,2023-12-09,1001,Lipstick,150,300,150,2,00068,India
339865,2023-12-09,1006,Blush,150,300,150,2,00068,India
339865,2023-12-09,1012,Body Lotion,200,400,200,2,00068,India
218282,2023-12-09,1005,Nail Polish,50,100,50,2,00391,India
218282,2023-12-09,1002,Mascara,200,400,200,2,00391,India
208562,2023-12-09,1001,Lipstick,150,300,150,2,00365,India
208562,2023-12-09,1006,Blush,150,300,150,2,00365,India
208562,2023-12-09,1002,Mascara,200,400,200,2,00365,India
288360,2023-12-09,1007,Eyeshadow,200,400,200,2,00093,India
288360,2023-12-09,1009,Moisturizer,250,500,250,2,00093,India
400000,2023-12-09,1007,Eyeshadow,200,400,200,2,00172,India
400000,2023-12-09,1008,Makeup Remover,80,160,80,2,00172,India
400000,2023-12-09,1009,Moisturizer,250,500,250,2,00172,India
400000,2023-12-09,1004,Eyeliner,100,200,100,2,00172,India
977303,2023-12-09,1008,Makeup Remover,80,160,80,2,00013,India
977303,2023-12-09,1012,Body Lotion,200,400,200,2,00013,India
279888,2023-12-09,1003,Foundation,300,600,300,2,00161,India
725626,2023-12-09,1003,Foundation,300,600,300,2,00491,India
853145,2023-12-09,1003,Foundation,300,600,300,2,00047,India
853145,2023-12-09,1012,Body Lotion,200,400,200,2,00047,India
853145,2023-12-09,1001,Lipstick,150,300,150,2,00047,India
860440,2023-12-09,1003,Foundation,300,600,300,2,00277,India
860440,2023-12-09,1012,Body Lotion,200,400,200,2,00277,India
210420,2023-12-09,1007,Eyeshadow,200,400,200,2,00293,India
210420,2023-12-09,1009,Moisturizer,250,500,250,2,00293,India
210420,2023-12-09,1012,Body Lotion,200,400,200,2,00293,India
210420,2023-12-09,1002,Mascara,200,400,200,2,00293,India
210420,2023-12-09,1001,Lipstick,150,300,150,2,00293,India
519857,2023-12-09,1012,Body Lotion,200,400,200,2,00332,India
519857,2023-12-09,1001,Lipstick,150,300,150,2,00332,India
519857,2023-12-09,1005,Nail Polish,50,100,50,2,00332,India
667725,2023-12-09,1002,Mascara,200,400,200,2,00002,India
667725,2023-12-09,1009,Moisturizer,250,500,250,2,00002,India
667725,2023-12-09,1006,Blush,150,300,150,2,00002,India
667725,2023-12-09,1012,Body Lotion,200,400,200,2,00002,India
667725,2023-12-09,1005,Nail Polish,50,100,50,2,00002,India
842896,2023-12-09,1008,Makeup Remover,80,160,80,2,00116,India
842896,2023-12-09,1002,Mascara,200,400,200,2,00116,India
842896,2023-12-09,1007,Eyeshadow,200,400,200,2,00116,India
842896,2023-12-09,1012,Body Lotion,200,400,200,2,00116,India
842896,2023-12-09,1006,Blush,150,300,150,2,00116,India
666138,2023-12-09,1012,Body Lotion,200,400,200,2,00092,India
666138,2023-12-09,1003,Foundation,300,600,300,2,00092,India
666138,2023-12-09,1001,Lipstick,150,300,150,2,00092,India
666138,2023-12-09,1007,Eyeshadow,200,400,200,2,00092,India
666138,2023-12-09,1006,Blush,150,300,150,2,00092,India
451165,2023-12-09,1006,Blush,150,300,150,2,00248,India
451165,2023-12-09,1012,Body Lotion,200,400,200,2,00248,India
509797,2023-12-09,1002,Mascara,200,400,200,2,00225,India
749964,2023-12-09,1006,Blush,150,300,150,2,00426,India
749964,2023-12-09,1002,Mascara,200,400,200,2,00426,India
453094,2023-12-09,1001,Lipstick,150,300,150,2,00455,India
114625,2023-12-09,1004,Eyeliner,100,200,100,2,00112,India
114625,2023-12-09,1007,Eyeshadow,200,400,200,2,00112,India
114625,2023-12-09,1006,Blush,150,300,150,2,00112,India
315698,2023-12-09,1007,Eyeshadow,200,400,200,2,00092,India
315698,2023-12-09,1009,Moisturizer,250,500,250,2,00092,India
315698,2023-12-09,1002,Mascara,200,400,200,2,00092,India
315698,2023-12-09,1004,Eyeliner,100,200,100,2,00092,India
596297,2023-12-09,1009,Moisturizer,250,500,250,2,00417,India
596297,2023-12-09,1004,Eyeliner,100,200,100,2,00417,India
596297,2023-12-09,1005,Nail Polish,50,100,50,2,00417,India
596297,2023-12-09,1001,Lipstick,150,300,150,2,00417,India
442156,2023-12-09,1002,Mascara,200,400,200,2,00340,India
442156,2023-12-09,1005,Nail Polish,50,100,50,2,00340,India
442156,2023-12-09,1009,Moisturizer,250,500,250,2,00340,India
442156,2023-12-09,1007,Eyeshadow,200,400,200,2,00340,India
135407,2023-12-09,1006,Blush,150,300,150,2,00071,India
135407,2023-12-09,1007,Eyeshadow,200,400,200,2,00071,India
135407,2023-12-09,1002,Mascara,200,400,200,2,00071,India
135407,2023-12-09,1005,Nail Polish,50,100,50,2,00071,India
135407,2023-12-09,1004,Eyeliner,100,200,100,2,00071,India
181776,2023-12-09,1004,Eyeliner,100,200,100,2,00391,India
181776,2023-12-09,1007,Eyeshadow,200,400,200,2,00391,India
181776,2023-12-09,1002,Mascara,200,400,200,2,00391,India
181776,2023-12-09,1008,Makeup Remover,80,160,80,2,00391,India
173721,2023-12-09,1009,Moisturizer,250,500,250,2,00201,India
173721,2023-12-09,1003,Foundation,300,600,300,2,00201,India
173721,2023-12-09,1004,Eyeliner,100,200,100,2,00201,India
663172,2023-12-09,1007,Eyeshadow,200,400,200,2,00360,India
658127,2023-12-10,1006,Blush,150,300,150,2,00252,India
814210,2023-12-10,1007,Eyeshadow,200,400,200,2,00054,India
122685,2023-12-10,1003,Foundation,300,600,300,2,00314,India
122685,2023-12-10,1012,Body Lotion,200,400,200,2,00314,India
122685,2023-12-10,1007,Eyeshadow,200,400,200,2,00314,India
122685,2023-12-10,1002,Mascara,200,400,200,2,00314,India
700250,2023-12-10,1001,Lipstick,150,300,150,2,00259,India
949155,2023-12-10,1008,Makeup Remover,80,160,80,2,00244,India
949155,2023-12-10,1003,Foundation,300,600,300,2,00244,India
949155,2023-12-10,1006,Blush,150,300,150,2,00244,India
373068,2023-12-10,1009,Moisturizer,250,500,250,2,00113,India
373068,2023-12-10,1005,Nail Polish,50,100,50,2,00113,India
356975,2023-12-10,1008,Makeup Remover,80,160,80,2,00169,India
356975,2023-12-10,1002,Mascara,200,400,200,2,00169,India
483136,2023-12-10,1008,Makeup Remover,80,160,80,2,00131,India
512359,2023-12-10,1008,Makeup Remover,80,160,80,2,00476,India
525379,2023-12-10,1001,Lipstick,150,300,150,2,00373,India
525379,2023-12-10,1007,Eyeshadow,200,400,200,2,00373,India
525379,2023-12-10,1004,Eyeliner,100,200,100,2,00373,India
925754,2023-12-10,1005,Nail Polish,50,100,50,2,00310,India
925754,2023-12-10,1009,Moisturizer,250,500,250,2,00310,India
828348,2023-12-10,1008,Makeup Remover,80,160,80,2,00170,India
828348,2023-12-10,1012,Body Lotion,200,400,200,2,00170,India
828348,2023-12-10,1007,Eyeshadow,200,400,200,2,00170,India
161222,2023-12-10,1012,Body Lotion,200,400,200,2,00118,India
161222,2023-12-10,1004,Eyeliner,100,200,100,2,00118,India
161222,2023-12-10,1003,Foundation,300,600,300,2,00118,India
216608,2023-12-10,1005,Nail Polish,50,100,50,2,00140,India
216608,2023-12-10,1004,Eyeliner,100,200,100,2,00140,India
216608,2023-12-10,1009,Moisturizer,250,500,250,2,00140,India
216608,2023-12-10,1012,Body Lotion,200,400,200,2,00140,India
582059,2023-12-10,1007,Eyeshadow,200,400,200,2,00363,India
582059,2023-12-10,1008,Makeup Remover,80,160,80,2,00363,India
717870,2023-12-10,1001,Lipstick,150,300,150,2,00008,India
717870,2023-12-10,1006,Blush,150,300,150,2,00008,India
717870,2023-12-10,1012,Body Lotion,200,400,200,2,00008,India
717870,2023-12-10,1008,Makeup Remover,80,160,80,2,00008,India
715684,2023-12-10,1004,Eyeliner,100,200,100,2,00389,India
715684,2023-12-10,1006,Blush,150,300,150,2,00389,India
715684,2023-12-10,1009,Moisturizer,250,500,250,2,00389,India
270244,2023-12-10,1006,Blush,150,300,150,2,00202,India
270244,2023-12-10,1007,Eyeshadow,200,400,200,2,00202,India
270244,2023-12-10,1012,Body Lotion,200,400,200,2,00202,India
270244,2023-12-10,1002,Mascara,200,400,200,2,00202,India
193594,2023-12-10,1002,Mascara,200,400,200,2,00409,India
339794,2023-12-10,1009,Moisturizer,250,500,250,2,00079,India
883019,2023-12-10,1008,Makeup Remover,80,160,80,2,00060,India
270683,2023-12-10,1006,Blush,150,300,150,2,00400,India
270683,2023-12-10,1003,Foundation,300,600,300,2,00400,India
270683,2023-12-10,1005,Nail Polish,50,100,50,2,00400,India
270683,2023-12-10,1007,Eyeshadow,200,400,200,2,00400,India
798343,2023-12-10,1006,Blush,150,300,150,2,00373,India
827406,2023-12-10,1002,Mascara,200,400,200,2,00235,India
827406,2023-12-10,1006,Blush,150,300,150,2,00235,India
827406,2023-12-10,1004,Eyeliner,100,200,100,2,00235,India
827406,2023-12-10,1008,Makeup Remover,80,160,80,2,00235,India
827406,2023-12-10,1012,Body Lotion,200,400,200,2,00235,India
680234,2023-12-10,1007,Eyeshadow,200,400,200,2,00346,India
243075,2023-12-10,1004,Eyeliner,100,200,100,2,00176,India
243075,2023-12-10,1012,Body Lotion,200,400,200,2,00176,India
243075,2023-12-10,1006,Blush,150,300,150,2,00176,India
700254,2023-12-10,1009,Moisturizer,250,500,250,2,00418,India
700254,2023-12-10,1008,Makeup Remover,80,160,80,2,00418,India
212518,2023-12-10,1005,Nail Polish,50,100,50,2,00203,India
212518,2023-12-10,1007,Eyeshadow,200,400,200,2,00203,India
525493,2023-12-10,1006,Blush,150,300,150,2,00038,India
522318,2023-12-10,1012,Body Lotion,200,400,200,2,00108,India
522318,2023-12-10,1004,Eyeliner,100,200,100,2,00108,India
522318,2023-12-10,1003,Foundation,300,600,300,2,00108,India
999077,2023-12-10,1002,Mascara,200,400,200,2,00491,India
112151,2023-12-10,1012,Body Lotion,200,400,200,2,00021,India
112151,2023-12-10,1004,Eyeliner,100,200,100,2,00021,India
182578,2023-12-10,1008,Makeup Remover,80,160,80,2,00318,India
182578,2023-12-10,1003,Foundation,300,600,300,2,00318,India
191247,2023-12-10,1009,Moisturizer,250,500,250,2,00272,India
180893,2023-12-10,1007,Eyeshadow,200,400,200,2,00181,India
180893,2023-12-10,1008,Makeup Remover,80,160,80,2,00181,India
554601,2023-12-10,1004,Eyeliner,100,200,100,2,00129,India
554601,2023-12-10,1001,Lipstick,150,300,150,2,00129,India
302917,2023-12-10,1012,Body Lotion,200,400,200,2,00398,India
930324,2023-12-10,1006,Blush,150,300,150,2,00023,India
930324,2023-12-10,1001,Lipstick,150,300,150,2,00023,India
930324,2023-12-10,1007,Eyeshadow,200,400,200,2,00023,India
930324,2023-12-10,1004,Eyeliner,100,200,100,2,00023,India
192867,2023-12-10,1007,Eyeshadow,200,400,200,2,00494,India
781971,2023-12-10,1003,Foundation,300,600,300,2,00318,India
781971,2023-12-10,1008,Makeup Remover,80,160,80,2,00318,India
781971,2023-12-10,1004,Eyeliner,100,200,100,2,00318,India
772361,2023-12-10,1004,Eyeliner,100,200,100,2,00011,India
772361,2023-12-10,1007,Eyeshadow,200,400,200,2,00011,India
772361,2023-12-10,1003,Foundation,300,600,300,2,00011,India
897223,2023-12-10,1012,Body Lotion,200,400,200,2,00409,India
897223,2023-12-10,1005,Nail Polish,50,100,50,2,00409,India
897223,2023-12-10,1009,Moisturizer,250,500,250,2,00409,India
641121,2023-12-10,1006,Blush,150,300,150,2,00342,India
641121,2023-12-10,1001,Lipstick,150,300,150,2,00342,India
847686,2023-12-10,1008,Makeup Remover,80,160,80,2,00457,India
847686,2023-12-10,1005,Nail Polish,50,100,50,2,00457,India
847686,2023-12-10,1012,Body Lotion,200,400,200,2,00457,India
847686,2023-12-10,1001,Lipstick,150,300,150,2,00457,India
847686,2023-12-10,1009,Moisturizer,250,500,250,2,00457,India
526402,2023-12-10,1008,Makeup Remover,80,160,80,2,00253,India
164886,2023-12-11,1009,Moisturizer,250,500,250,2,00107,India
941656,2023-12-11,1006,Blush,150,300,150,2,00229,India
941656,2023-12-11,1005,Nail Polish,50,100,50,2,00229,India
225364,2023-12-11,1007,Eyeshadow,200,400,200,2,00119,India
225364,2023-12-11,1002,Mascara,200,400,200,2,00119,India
225364,2023-12-11,1006,Blush,150,300,150,2,00119,India
225364,2023-12-11,1003,Foundation,300,600,300,2,00119,India
640878,2023-12-11,1001,Lipstick,150,300,150,2,00213,India
384790,2023-12-11,1007,Eyeshadow,200,400,200,2,00499,India
384790,2023-12-11,1012,Body Lotion,200,400,200,2,00499,India
384790,2023-12-11,1001,Lipstick,150,300,150,2,00499,India
384790,2023-12-11,1005,Nail Polish,50,100,50,2,00499,India
141363,2023-12-11,1009,Moisturizer,250,500,250,2,00285,India
141363,2023-12-11,1002,Mascara,200,400,200,2,00285,India
141363,2023-12-11,1005,Nail Polish,50,100,50,2,00285,India
141363,2023-12-11,1001,Lipstick,150,300,150,2,00285,India
141363,2023-12-11,1003,Foundation,300,600,300,2,00285,India
426543,2023-12-11,1007,Eyeshadow,200,400,200,2,00002,India
426543,2023-12-11,1002,Mascara,200,400,200,2,00002,India
426543,2023-12-11,1001,Lipstick,150,300,150,2,00002,India
745937,2023-12-11,1009,Moisturizer,250,500,250,2,00077,India
745937,2023-12-11,1005,Nail Polish,50,100,50,2,00077,India
745937,2023-12-11,1003,Foundation,300,600,300,2,00077,India
696659,2023-12-11,1002,Mascara,200,400,200,2,00051,India
696659,2023-12-11,1009,Moisturizer,250,500,250,2,00051,India
696659,2023-12-11,1007,Eyeshadow,200,400,200,2,00051,India
666220,2023-12-11,1003,Foundation,300,600,300,2,00358,India
666220,2023-12-11,1002,Mascara,200,400,200,2,00358,India
666220,2023-12-11,1009,Moisturizer,250,500,250,2,00358,India
666220,2023-12-11,1005,Nail Polish,50,100,50,2,00358,India
728545,2023-12-11,1009,Moisturizer,250,500,250,2,00142,India
728545,2023-12-11,1012,Body Lotion,200,400,200,2,00142,India
728545,2023-12-11,1008,Makeup Remover,80,160,80,2,00142,India
468866,2023-12-11,1007,Eyeshadow,200,400,200,2,00418,India
468866,2023-12-11,1004,Eyeliner,100,200,100,2,00418,India
331035,2023-12-11,1006,Blush,150,300,150,2,00019,India
331035,2023-12-11,1012,Body Lotion,200,400,200,2,00019,India
331035,2023-12-11,1004,Eyeliner,100,200,100,2,00019,India
331035,2023-12-11,1003,Foundation,300,600,300,2,00019,India
588730,2023-12-11,1012,Body Lotion,200,400,200,2,00498,India
588730,2023-12-11,1004,Eyeliner,100,200,100,2,00498,India
588730,2023-12-11,1005,Nail Polish,50,100,50,2,00498,India
588730,2023-12-11,1002,Mascara,200,400,200,2,00498,India
237377,2023-12-11,1002,Mascara,200,400,200,2,00113,India
237377,2023-12-11,1009,Moisturizer,250,500,250,2,00113,India
237377,2023-12-11,1007,Eyeshadow,200,400,200,2,00113,India
237377,2023-12-11,1006,Blush,150,300,150,2,00113,India
237377,2023-12-11,1005,Nail Polish,50,100,50,2,00113,India
352914,2023-12-11,1005,Nail Polish,50,100,50,2,00390,India
112252,2023-12-11,1008,Makeup Remover,80,160,80,2,00372,India
112252,2023-12-11,1007,Eyeshadow,200,400,200,2,00372,India
112252,2023-12-11,1003,Foundation,300,600,300,2,00372,India
963782,2023-12-11,1007,Eyeshadow,200,400,200,2,00467,India
963782,2023-12-11,1001,Lipstick,150,300,150,2,00467,India
963782,2023-12-11,1009,Moisturizer,250,500,250,2,00467,India
963782,2023-12-11,1004,Eyeliner,100,200,100,2,00467,India
807694,2023-12-11,1009,Moisturizer,250,500,250,2,00499,India
807694,2023-12-11,1004,Eyeliner,100,200,100,2,00499,India
471818,2023-12-11,1001,Lipstick,150,300,150,2,00447,India
247864,2023-12-11,1009,Moisturizer,250,500,250,2,00046,India
689240,2023-12-11,1005,Nail Polish,50,100,50,2,00025,India
689240,2023-12-11,1003,Foundation,300,600,300,2,00025,India
689240,2023-12-11,1002,Mascara,200,400,200,2,00025,India
516837,2023-12-11,1009,Moisturizer,250,500,250,2,00350,India
516837,2023-12-11,1007,Eyeshadow,200,400,200,2,00350,India
516837,2023-12-11,1002,Mascara,200,400,200,2,00350,India
516837,2023-12-11,1012,Body Lotion,200,400,200,2,00350,India
940292,2023-12-11,1009,Moisturizer,250,500,250,2,00233,India
940292,2023-12-11,1007,Eyeshadow,200,400,200,2,00233,India
963709,2023-12-11,1002,Mascara,200,400,200,2,00203,India
963709,2023-12-11,1007,Eyeshadow,200,400,200,2,00203,India
963709,2023-12-11,1012,Body Lotion,200,400,200,2,00203,India
963709,2023-12-11,1009,Moisturizer,250,500,250,2,00203,India
430636,2023-12-11,1004,Eyeliner,100,200,100,2,00381,India
430636,2023-12-11,1007,Eyeshadow,200,400,200,2,00381,India
678795,2023-12-11,1004,Eyeliner,100,200,100,2,00066,India
275936,2023-12-11,1007,Eyeshadow,200,400,200,2,00241,India
275936,2023-12-11,1008,Makeup Remover,80,160,80,2,00241,India
275936,2023-12-11,1006,Blush,150,300,150,2,00241,India
275936,2023-12-11,1002,Mascara,200,400,200,2,00241,India
275936,2023-12-11,1009,Moisturizer,250,500,250,2,00241,India
837247,2023-12-11,1007,Eyeshadow,200,400,200,2,00330,India
837247,2023-12-11,1009,Moisturizer,250,500,250,2,00330,India
837247,2023-12-11,1006,Blush,150,300,150,2,00330,India
164642,2023-12-11,1004,Eyeliner,100,200,100,2,00372,India
164642,2023-12-11,1005,Nail Polish,50,100,50,2,00372,India
164642,2023-12-11,1006,Blush,150,300,150,2,00372,India
164642,2023-12-11,1002,Mascara,200,400,200,2,00372,India
663860,2023-12-12,1006,Blush,150,300,150,2,00079,India
593260,2023-12-12,1004,Eyeliner,100,200,100,2,00499,India
593260,2023-12-12,1003,Foundation,300,600,300,2,00499,India
593260,2023-12-12,1007,Eyeshadow,200,400,200,2,00499,India
122109,2023-12-12,1003,Foundation,300,600,300,2,00438,India
122109,2023-12-12,1005,Nail Polish,50,100,50,2,00438,India
122109,2023-12-12,1004,Eyeliner,100,200,100,2,00438,India
135616,2023-12-12,1012,Body Lotion,200,400,200,2,00480,India
408354,2023-12-12,1012,Body Lotion,200,400,200,2,00248,India
408354,2023-12-12,1003,Foundation,300,600,300,2,00248,India
408354,2023-12-12,1002,Mascara,200,400,200,2,00248,India
153651,2023-12-12,1006,Blush,150,300,150,2,00053,India
153651,2023-12-12,1004,Eyeliner,100,200,100,2,00053,India
153651,2023-12-12,1005,Nail Polish,50,100,50,2,00053,India
576812,2023-12-12,1009,Moisturizer,250,500,250,2,00015,India
576812,2023-12-12,1008,Makeup Remover,80,160,80,2,00015,India
596952,2023-12-12,1002,Mascara,200,400,200,2,00199,India
806213,2023-12-12,1004,Eyeliner,100,200,100,2,00106,India
806213,2023-12-12,1005,Nail Polish,50,100,50,2,00106,India
806213,2023-12-12,1012,Body Lotion,200,400,200,2,00106,India
328096,2023-12-12,1004,Eyeliner,100,200,100,2,00101,India
328096,2023-12-12,1003,Foundation,300,600,300,2,00101,India
328096,2023-12-12,1005,Nail Polish,50,100,50,2,00101,India
279835,2023-12-12,1006,Blush,150,300,150,2,00041,India
263273,2023-12-12,1002,Mascara,200,400,200,2,00178,India
263273,2023-12-12,1003,Foundation,300,600,300,2,00178,India
263273,2023-12-12,1008,Makeup Remover,80,160,80,2,00178,India
263273,2023-12-12,1005,Nail Polish,50,100,50,2,00178,India
166188,2023-12-12,1002,Mascara,200,400,200,2,00068,India
166188,2023-12-12,1005,Nail Polish,50,100,50,2,00068,India
166188,2023-12-12,1007,Eyeshadow,200,400,200,2,00068,India
557871,2023-12-12,1009,Moisturizer,250,500,250,2,00010,India
557871,2023-12-12,1012,Body Lotion,200,400,200,2,00010,India
557871,2023-12-12,1003,Foundation,300,600,300,2,00010,India
557871,2023-12-12,1002,Mascara,200,400,200,2,00010,India
932029,2023-12-12,1003,Foundation,300,600,300,2,00061,India
932029,2023-12-12,1001,Lipstick,150,300,150,2,00061,India
887602,2023-12-12,1005,Nail Polish,50,100,50,2,00420,India
731846,2023-12-12,1008,Makeup Remover,80,160,80,2,00250,India
823978,2023-12-12,1003,Foundation,300,600,300,2,00404,India
823978,2023-12-12,1012,Body Lotion,200,400,200,2,00404,India
823978,2023-12-12,1007,Eyeshadow,200,400,200,2,00404,India
823978,2023-12-12,1002,Mascara,200,400,200,2,00404,India
923926,2023-12-12,1008,Makeup Remover,80,160,80,2,00397,India
923926,2023-12-12,1009,Moisturizer,250,500,250,2,00397,India
923926,2023-12-12,1003,Foundation,300,600,300,2,00397,India
303209,2023-12-12,1009,Moisturizer,250,500,250,2,00452,India
303209,2023-12-12,1001,Lipstick,150,300,150,2,00452,India
303209,2023-12-12,1003,Foundation,300,600,300,2,00452,India
303209,2023-12-12,1007,Eyeshadow,200,400,200,2,00452,India
253136,2023-12-12,1001,Lipstick,150,300,150,2,00219,India
253136,2023-12-12,1004,Eyeliner,100,200,100,2,00219,India
253136,2023-12-12,1007,Eyeshadow,200,400,200,2,00219,India
253136,2023-12-12,1003,Foundation,300,600,300,2,00219,India
253136,2023-12-12,1005,Nail Polish,50,100,50,2,00219,India
380436,2023-12-12,1004,Eyeliner,100,200,100,2,00428,India
380436,2023-12-12,1009,Moisturizer,250,500,250,2,00428,India
380436,2023-12-12,1002,Mascara,200,400,200,2,00428,India
120853,2023-12-12,1009,Moisturizer,250,500,250,2,00101,India
120853,2023-12-12,1007,Eyeshadow,200,400,200,2,00101,India
675297,2023-12-12,1004,Eyeliner,100,200,100,2,00158,India
675297,2023-12-12,1002,Mascara,200,400,200,2,00158,India
308012,2023-12-12,1009,Moisturizer,250,500,250,2,00011,India
308012,2023-12-12,1005,Nail Polish,50,100,50,2,00011,India
629728,2023-12-12,1009,Moisturizer,250,500,250,2,00394,India
629728,2023-12-12,1005,Nail Polish,50,100,50,2,00394,India
629728,2023-12-12,1002,Mascara,200,400,200,2,00394,India
629728,2023-12-12,1012,Body Lotion,200,400,200,2,00394,India
292446,2023-12-12,1001,Lipstick,150,300,150,2,00018,India
824335,2023-12-12,1005,Nail Polish,50,100,50,2,00161,India
824335,2023-12-12,1006,Blush,150,300,150,2,00161,India
824335,2023-12-12,1002,Mascara,200,400,200,2,00161,India
556465,2023-12-12,1004,Eyeliner,100,200,100,2,00157,India
556465,2023-12-12,1001,Lipstick,150,300,150,2,00157,India
110930,2023-12-12,1004,Eyeliner,100,200,100,2,00037,India
110930,2023-12-12,1001,Lipstick,150,300,150,2,00037,India
110930,2023-12-12,1005,Nail Polish,50,100,50,2,00037,India
914213,2023-12-12,1009,Moisturizer,250,500,250,2,00132,India
914213,2023-12-12,1006,Blush,150,300,150,2,00132,India
431840,2023-12-12,1009,Moisturizer,250,500,250,2,00425,India
882298,2023-12-12,1012,Body Lotion,200,400,200,2,00166,India
483797,2023-12-12,1012,Body Lotion,200,400,200,2,00110,India
483797,2023-12-12,1006,Blush,150,300,150,2,00110,India
579089,2023-12-12,1004,Eyeliner,100,200,100,2,00054,India
579089,2023-12-12,1007,Eyeshadow,200,400,200,2,00054,India
579089,2023-12-12,1003,Foundation,300,600,300,2,00054,India
579089,2023-12-12,1006,Blush,150,300,150,2,00054,India
956239,2023-12-12,1003,Foundation,300,600,300,2,00029,India
956239,2023-12-12,1009,Moisturizer,250,500,250,2,00029,India
277402,2023-12-12,1003,Foundation,300,600,300,2,00390,India
277402,2023-12-12,1009,Moisturizer,250,500,250,2,00390,India
868522,2023-12-13,1007,Eyeshadow,200,400,200,2,00328,India
868522,2023-12-13,1012,Body Lotion,200,400,200,2,00328,India
868522,2023-12-13,1009,Moisturizer,250,500,250,2,00328,India
278818,2023-12-13,1003,Foundation,300,600,300,2,00062,India
306104,2023-12-13,1007,Eyeshadow,200,400,200,2,00357,India
868516,2023-12-13,1006,Blush,150,300,150,2,00366,India
868516,2023-12-13,1009,Moisturizer,250,500,250,2,00366,India
868516,2023-12-13,1002,Mascara,200,400,200,2,00366,India
868516,2023-12-13,1007,Eyeshadow,200,400,200,2,00366,India
501793,2023-12-13,1008,Makeup Remover,80,160,80,2,00309,India
221013,2023-12-13,1002,Mascara,200,400,200,2,00327,India
135675,2023-12-13,1005,Nail Polish,50,100,50,2,00126,India
135675,2023-12-13,1003,Foundation,300,600,300,2,00126,India
135675,2023-12-13,1009,Moisturizer,250,500,250,2,00126,India
135675,2023-12-13,1007,Eyeshadow,200,400,200,2,00126,India
238784,2023-12-13,1012,Body Lotion,200,400,200,2,00393,India
238784,2023-12-13,1003,Foundation,300,600,300,2,00393,India
238784,2023-12-13,1008,Makeup Remover,80,160,80,2,00393,India
238784,2023-12-13,1004,Eyeliner,100,200,100,2,00393,India
334970,2023-12-13,1006,Blush,150,300,150,2,00326,India
334970,2023-12-13,1001,Lipstick,150,300,150,2,00326,India
334970,2023-12-13,1007,Eyeshadow,200,400,200,2,00326,India
334970,2023-12-13,1004,Eyeliner,100,200,100,2,00326,India
963137,2023-12-13,1004,Eyeliner,100,200,100,2,00009,India
387046,2023-12-13,1006,Blush,150,300,150,2,00221,India
709505,2023-12-13,1012,Body Lotion,200,400,200,2,00436,India
709505,2023-12-13,1005,Nail Polish,50,100,50,2,00436,India
277253,2023-12-13,1003,Foundation,300,600,300,2,00357,India
583478,2023-12-13,1007,Eyeshadow,200,400,200,2,00097,India
676807,2023-12-13,1007,Eyeshadow,200,400,200,2,00366,India
676807,2023-12-13,1004,Eyeliner,100,200,100,2,00366,India
676807,2023-12-13,1005,Nail Polish,50,100,50,2,00366,India
676807,2023-12-13,1008,Makeup Remover,80,160,80,2,00366,India
639621,2023-12-13,1008,Makeup Remover,80,160,80,2,00052,India
639621,2023-12-13,1012,Body Lotion,200,400,200,2,00052,India
639621,2023-12-13,1003,Foundation,300,600,300,2,00052,India
639621,2023-12-13,1006,Blush,150,300,150,2,00052,India
191632,2023-12-13,1007,Eyeshadow,200,400,200,2,00141,India
856158,2023-12-13,1004,Eyeliner,100,200,100,2,00312,India
856158,2023-12-13,1007,Eyeshadow,200,400,200,2,00312,India
351798,2023-12-13,1001,Lipstick,150,300,150,2,00315,India
351798,2023-12-13,1009,Moisturizer,250,500,250,2,00315,India
537245,2023-12-13,1006,Blush,150,300,150,2,00095,India
537245,2023-12-13,1003,Foundation,300,600,300,2,00095,India
537245,2023-12-13,1002,Mascara,200,400,200,2,00095,India
529881,2023-12-13,1004,Eyeliner,100,200,100,2,00139,India
529881,2023-12-13,1012,Body Lotion,200,400,200,2,00139,India
896026,2023-12-13,1012,Body Lotion,200,400,200,2,00170,India
896026,2023-12-13,1009,Moisturizer,250,500,250,2,00170,India
334967,2023-12-13,1003,Foundation,300,600,300,2,00149,India
334967,2023-12-13,1006,Blush,150,300,150,2,00149,India
670933,2023-12-13,1002,Mascara,200,400,200,2,00397,India
487209,2023-12-13,1012,Body Lotion,200,400,200,2,00444,India
487209,2023-12-13,1005,Nail Polish,50,100,50,2,00444,India
487209,2023-12-13,1007,Eyeshadow,200,400,200,2,00444,India
506655,2023-12-13,1008,Makeup Remover,80,160,80,2,00432,India
506655,2023-12-13,1001,Lipstick,150,300,150,2,00432,India
891551,2023-12-13,1001,Lipstick,150,300,150,2,00118,India
891551,2023-12-13,1008,Makeup Remover,80,160,80,2,00118,India
891551,2023-12-13,1012,Body Lotion,200,400,200,2,00118,India
782931,2023-12-13,1001,Lipstick,150,300,150,2,00479,India
782931,2023-12-13,1003,Foundation,300,600,300,2,00479,India
782931,2023-12-13,1005,Nail Polish,50,100,50,2,00479,India
782931,2023-12-13,1012,Body Lotion,200,400,200,2,00479,India
782931,2023-12-13,1006,Blush,150,300,150,2,00479,India
224888,2023-12-13,1005,Nail Polish,50,100,50,2,00336,India
224888,2023-12-13,1004,Eyeliner,100,200,100,2,00336,India
315725,2023-12-13,1004,Eyeliner,100,200,100,2,00496,India
657068,2023-12-13,1008,Makeup Remover,80,160,80,2,00284,India
657068,2023-12-13,1009,Moisturizer,250,500,250,2,00284,India
657068,2023-12-13,1007,Eyeshadow,200,400,200,2,00284,India
538507,2023-12-13,1002,Mascara,200,400,200,2,00454,India
538507,2023-12-13,1012,Body Lotion,200,400,200,2,00454,India
538507,2023-12-13,1003,Foundation,300,600,300,2,00454,India
538507,2023-12-13,1001,Lipstick,150,300,150,2,00454,India
538507,2023-12-13,1005,Nail Polish,50,100,50,2,00454,India
681240,2023-12-13,1012,Body Lotion,200,400,200,2,00143,India
591723,2023-12-14,1003,Foundation,300,600,300,2,00123,India
591723,2023-12-14,1004,Eyeliner,100,200,100,2,00123,India
469526,2023-12-14,1004,Eyeliner,100,200,100,2,00493,India
469526,2023-12-14,1012,Body Lotion,200,400,200,2,00493,India
469526,2023-12-14,1005,Nail Polish,50,100,50,2,00493,India
950662,2023-12-14,1004,Eyeliner,100,200,100,2,00360,India
950662,2023-12-14,1007,Eyeshadow,200,400,200,2,00360,India
516131,2023-12-14,1002,Mascara,200,400,200,2,00253,India
516131,2023-12-14,1012,Body Lotion,200,400,200,2,00253,India
516131,2023-12-14,1008,Makeup Remover,80,160,80,2,00253,India
516131,2023-12-14,1007,Eyeshadow,200,400,200,2,00253,India
516131,2023-12-14,1004,Eyeliner,100,200,100,2,00253,India
223675,2023-12-14,1007,Eyeshadow,200,400,200,2,00259,India
223675,2023-12-14,1012,Body Lotion,200,400,200,2,00259,India
174908,2023-12-14,1004,Eyeliner,100,200,100,2,00319,India
174908,2023-12-14,1009,Moisturizer,250,500,250,2,00319,India
174908,2023-12-14,1007,Eyeshadow,200,400,200,2,00319,India
800305,2023-12-14,1004,Eyeliner,100,200,100,2,00102,India
800305,2023-12-14,1008,Makeup Remover,80,160,80,2,00102,India
800305,2023-12-14,1006,Blush,150,300,150,2,00102,India
600716,2023-12-14,1012,Body Lotion,200,400,200,2,00141,India
131710,2023-12-14,1003,Foundation,300,600,300,2,00150,India
131710,2023-12-14,1002,Mascara,200,400,200,2,00150,India
131710,2023-12-14,1007,Eyeshadow,200,400,200,2,00150,India
155897,2023-12-14,1006,Blush,150,300,150,2,00182,India
155897,2023-12-14,1003,Foundation,300,600,300,2,00182,India
794246,2023-12-14,1004,Eyeliner,100,200,100,2,00145,India
581148,2023-12-14,1012,Body Lotion,200,400,200,2,00240,India
581148,2023-12-14,1004,Eyeliner,100,200,100,2,00240,India
581148,2023-12-14,1007,Eyeshadow,200,400,200,2,00240,India
581148,2023-12-14,1008,Makeup Remover,80,160,80,2,00240,India
714422,2023-12-14,1008,Makeup Remover,80,160,80,2,00091,India
714422,2023-12-14,1005,Nail Polish,50,100,50,2,00091,India
658664,2023-12-14,1003,Foundation,300,600,300,2,00205,India
751414,2023-12-14,1006,Blush,150,300,150,2,00283,India
751414,2023-12-14,1001,Lipstick,150,300,150,2,00283,India
357862,2023-12-14,1008,Makeup Remover,80,160,80,2,00220,India
223107,2023-12-14,1003,Foundation,300,600,300,2,00128,India
223107,2023-12-14,1012,Body Lotion,200,400,200,2,00128,India
223107,2023-12-14,1005,Nail Polish,50,100,50,2,00128,India
223107,2023-12-14,1009,Moisturizer,250,500,250,2,00128,India
882927,2023-12-14,1002,Mascara,200,400,200,2,00048,India
882927,2023-12-14,1008,Makeup Remover,80,160,80,2,00048,India
882927,2023-12-14,1004,Eyeliner,100,200,100,2,00048,India
882927,2023-12-14,1006,Blush,150,300,150,2,00048,India
371233,2023-12-14,1004,Eyeliner,100,200,100,2,00037,India
538491,2023-12-14,1006,Blush,150,300,150,2,00210,India
652621,2023-12-14,1012,Body Lotion,200,400,200,2,00053,India
178100,2023-12-14,1012,Body Lotion,200,400,200,2,00281,India
178100,2023-12-14,1005,Nail Polish,50,100,50,2,00281,India
178100,2023-12-14,1007,Eyeshadow,200,400,200,2,00281,India
178100,2023-12-14,1006,Blush,150,300,150,2,00281,India
473840,2023-12-14,1002,Mascara,200,400,200,2,00167,India
695464,2023-12-14,1007,Eyeshadow,200,400,200,2,00370,India
695464,2023-12-14,1008,Makeup Remover,80,160,80,2,00370,India
428527,2023-12-14,1008,Makeup Remover,80,160,80,2,00466,India
428527,2023-12-14,1004,Eyeliner,100,200,100,2,00466,India
998612,2023-12-14,1003,Foundation,300,600,300,2,00160,India
101023,2023-12-14,1006,Blush,150,300,150,2,00107,India
101023,2023-12-14,1001,Lipstick,150,300,150,2,00107,India
101023,2023-12-14,1004,Eyeliner,100,200,100,2,00107,India
804486,2023-12-14,1001,Lipstick,150,300,150,2,00102,India
796165,2023-12-14,1008,Makeup Remover,80,160,80,2,00116,India
796165,2023-12-14,1004,Eyeliner,100,200,100,2,00116,India
796165,2023-12-14,1009,Moisturizer,250,500,250,2,00116,India
796165,2023-12-14,1006,Blush,150,300,150,2,00116,India
798961,2023-12-14,1005,Nail Polish,50,100,50,2,00418,India
798961,2023-12-14,1007,Eyeshadow,200,400,200,2,00418,India
357284,2023-12-14,1004,Eyeliner,100,200,100,2,00311,India
546962,2023-12-14,1005,Nail Polish,50,100,50,2,00264,India
546962,2023-12-14,1009,Moisturizer,250,500,250,2,00264,India
380953,2023-12-14,1006,Blush,150,300,150,2,00357,India
380953,2023-12-14,1009,Moisturizer,250,500,250,2,00357,India
117002,2023-12-14,1001,Lipstick,150,300,150,2,00366,India
117002,2023-12-14,1007,Eyeshadow,200,400,200,2,00366,India
117002,2023-12-14,1002,Mascara,200,400,200,2,00366,India
260200,2023-12-14,1004,Eyeliner,100,200,100,2,00377,India
260200,2023-12-14,1012,Body Lotion,200,400,200,2,00377,India
260200,2023-12-14,1009,Moisturizer,250,500,250,2,00377,India
260200,2023-12-14,1001,Lipstick,150,300,150,2,00377,India
116224,2023-12-14,1002,Mascara,200,400,200,2,00384,India
116224,2023-12-14,1007,Eyeshadow,200,400,200,2,00384,India
116224,2023-12-14,1006,Blush,150,300,150,2,00384,India
851830,2023-12-14,1006,Blush,150,300,150,2,00480,India
851830,2023-12-14,1003,Foundation,300,600,300,2,00480,India
415617,2023-12-14,1001,Lipstick,150,300,150,2,00278,India
415617,2023-12-14,1005,Nail Polish,50,100,50,2,00278,India
415617,2023-12-14,1012,Body Lotion,200,400,200,2,00278,India
415617,2023-12-14,1008,Makeup Remover,80,160,80,2,00278,India
512185,2023-12-14,1012,Body Lotion,200,400,200,2,00119,India
512185,2023-12-14,1003,Foundation,300,600,300,2,00119,India
512185,2023-12-14,1007,Eyeshadow,200,400,200,2,00119,India
512185,2023-12-14,1008,Makeup Remover,80,160,80,2,00119,India
949807,2023-12-14,1004,Eyeliner,100,200,100,2,00480,India
184422,2023-12-14,1002,Mascara,200,400,200,2,00049,India
184422,2023-12-14,1004,Eyeliner,100,200,100,2,00049,India
184422,2023-12-14,1003,Foundation,300,600,300,2,00049,India
184422,2023-12-14,1009,Moisturizer,250,500,250,2,00049,India
674546,2023-12-15,1005,Nail Polish,50,100,50,2,00162,India
316527,2023-12-15,1001,Lipstick,150,300,150,2,00049,India
316527,2023-12-15,1007,Eyeshadow,200,400,200,2,00049,India
316527,2023-12-15,1008,Makeup Remover,80,160,80,2,00049,India
528000,2023-12-15,1008,Makeup Remover,80,160,80,2,00471,India
953675,2023-12-15,1005,Nail Polish,50,100,50,2,00479,India
874053,2023-12-15,1002,Mascara,200,400,200,2,00065,India
874053,2023-12-15,1007,Eyeshadow,200,400,200,2,00065,India
874053,2023-12-15,1005,Nail Polish,50,100,50,2,00065,India
874053,2023-12-15,1006,Blush,150,300,150,2,00065,India
700991,2023-12-15,1009,Moisturizer,250,500,250,2,00169,India
700991,2023-12-15,1008,Makeup Remover,80,160,80,2,00169,India
700991,2023-12-15,1002,Mascara,200,400,200,2,00169,India
631584,2023-12-15,1001,Lipstick,150,300,150,2,00346,India
237789,2023-12-15,1002,Mascara,200,400,200,2,00433,India
237789,2023-12-15,1006,Blush,150,300,150,2,00433,India
237789,2023-12-15,1005,Nail Polish,50,100,50,2,00433,India
237789,2023-12-15,1009,Moisturizer,250,500,250,2,00433,India
412042,2023-12-15,1008,Makeup Remover,80,160,80,2,00029,India
412042,2023-12-15,1006,Blush,150,300,150,2,00029,India
412042,2023-12-15,1005,Nail Polish,50,100,50,2,00029,India
600253,2023-12-15,1009,Moisturizer,250,500,250,2,00147,India
600253,2023-12-15,1002,Mascara,200,400,200,2,00147,India
600253,2023-12-15,1004,Eyeliner,100,200,100,2,00147,India
600253,2023-12-15,1008,Makeup Remover,80,160,80,2,00147,India
600253,2023-12-15,1003,Foundation,300,600,300,2,00147,India
739361,2023-12-15,1012,Body Lotion,200,400,200,2,00434,India
739361,2023-12-15,1009,Moisturizer,250,500,250,2,00434,India
739361,2023-12-15,1005,Nail Polish,50,100,50,2,00434,India
584969,2023-12-15,1009,Moisturizer,250,500,250,2,00103,India
584969,2023-12-15,1008,Makeup Remover,80,160,80,2,00103,India
584969,2023-12-15,1002,Mascara,200,400,200,2,00103,India
584969,2023-12-15,1007,Eyeshadow,200,400,200,2,00103,India
584969,2023-12-15,1003,Foundation,300,600,300,2,00103,India
843352,2023-12-15,1005,Nail Polish,50,100,50,2,00307,India
843352,2023-12-15,1001,Lipstick,150,300,150,2,00307,India
843352,2023-12-15,1003,Foundation,300,600,300,2,00307,India
806181,2023-12-15,1012,Body Lotion,200,400,200,2,00500,India
806181,2023-12-15,1003,Foundation,300,600,300,2,00500,India
806181,2023-12-15,1001,Lipstick,150,300,150,2,00500,India
583625,2023-12-15,1006,Blush,150,300,150,2,00171,India
583625,2023-12-15,1007,Eyeshadow,200,400,200,2,00171,India
583625,2023-12-15,1009,Moisturizer,250,500,250,2,00171,India
583625,2023-12-15,1001,Lipstick,150,300,150,2,00171,India
583625,2023-12-15,1005,Nail Polish,50,100,50,2,00171,India
923360,2023-12-15,1003,Foundation,300,600,300,2,00419,India
923360,2023-12-15,1001,Lipstick,150,300,150,2,00419,India
923360,2023-12-15,1007,Eyeshadow,200,400,200,2,00419,India
470136,2023-12-15,1003,Foundation,300,600,300,2,00029,India
470136,2023-12-15,1009,Moisturizer,250,500,250,2,00029,India
470136,2023-12-15,1005,Nail Polish,50,100,50,2,00029,India
310586,2023-12-15,1009,Moisturizer,250,500,250,2,00174,India
310586,2023-12-15,1012,Body Lotion,200,400,200,2,00174,India
569141,2023-12-15,1005,Nail Polish,50,100,50,2,00374,India
816281,2023-12-15,1012,Body Lotion,200,400,200,2,00306,India
816281,2023-12-15,1003,Foundation,300,600,300,2,00306,India
816281,2023-12-15,1004,Eyeliner,100,200,100,2,00306,India
754958,2023-12-15,1008,Makeup Remover,80,160,80,2,00254,India
754958,2023-12-15,1012,Body Lotion,200,400,200,2,00254,India
666378,2023-12-15,1009,Moisturizer,250,500,250,2,00212,India
255234,2023-12-15,1004,Eyeliner,100,200,100,2,00184,India
255234,2023-12-15,1008,Makeup Remover,80,160,80,2,00184,India
468345,2023-12-15,1009,Moisturizer,250,500,250,2,00495,India
468345,2023-12-15,1012,Body Lotion,200,400,200,2,00495,India
468345,2023-12-15,1005,Nail Polish,50,100,50,2,00495,India
116374,2023-12-15,1004,Eyeliner,100,200,100,2,00487,India
714727,2023-12-15,1007,Eyeshadow,200,400,200,2,00038,India
265545,2023-12-15,1002,Mascara,200,400,200,2,00213,India
854703,2023-12-15,1009,Moisturizer,250,500,250,2,00299,India
854703,2023-12-15,1007,Eyeshadow,200,400,200,2,00299,India
854703,2023-12-15,1012,Body Lotion,200,400,200,2,00299,India
322988,2023-12-15,1001,Lipstick,150,300,150,2,00454,India
350977,2023-12-15,1005,Nail Polish,50,100,50,2,00471,India
350977,2023-12-15,1003,Foundation,300,600,300,2,00471,India
350977,2023-12-15,1012,Body Lotion,200,400,200,2,00471,India
248567,2023-12-15,1008,Makeup Remover,80,160,80,2,00415,India
821599,2023-12-15,1005,Nail Polish,50,100,50,2,00240,India
821599,2023-12-15,1008,Makeup Remover,80,160,80,2,00240,India
821599,2023-12-15,1001,Lipstick,150,300,150,2,00240,India
203965,2023-12-15,1001,Lipstick,150,300,150,2,00111,India
203965,2023-12-15,1012,Body Lotion,200,400,200,2,00111,India
203965,2023-12-15,1007,Eyeshadow,200,400,200,2,00111,India
980407,2023-12-15,1007,Eyeshadow,200,400,200,2,00277,India
980407,2023-12-15,1006,Blush,150,300,150,2,00277,India
980407,2023-12-15,1012,Body Lotion,200,400,200,2,00277,India
511929,2023-12-15,1008,Makeup Remover,80,160,80,2,00416,India
511929,2023-12-15,1002,Mascara,200,400,200,2,00416,India
511929,2023-12-15,1001,Lipstick,150,300,150,2,00416,India
511929,2023-12-15,1009,Moisturizer,250,500,250,2,00416,India
114391,2023-12-15,1005,Nail Polish,50,100,50,2,00266,India
272831,2023-12-15,1007,Eyeshadow,200,400,200,2,00331,India
272831,2023-12-15,1008,Makeup Remover,80,160,80,2,00331,India
859284,2023-12-15,1007,Eyeshadow,200,400,200,2,00447,India
859284,2023-12-15,1008,Makeup Remover,80,160,80,2,00447,India
777104,2023-12-15,1012,Body Lotion,200,400,200,2,00035,India
655321,2023-12-16,1006,Blush,150,300,150,2,00246,India
655321,2023-12-16,1009,Moisturizer,250,500,250,2,00246,India
655321,2023-12-16,1012,Body Lotion,200,400,200,2,00246,India
655321,2023-12-16,1003,Foundation,300,600,300,2,00246,India
983806,2023-12-16,1012,Body Lotion,200,400,200,2,00018,India
983806,2023-12-16,1004,Eyeliner,100,200,100,2,00018,India
435394,2023-12-16,1004,Eyeliner,100,200,100,2,00292,India
435394,2023-12-16,1003,Foundation,300,600,300,2,00292,India
215321,2023-12-16,1002,Mascara,200,400,200,2,00241,India
215321,2023-12-16,1001,Lipstick,150,300,150,2,00241,India
215321,2023-12-16,1009,Moisturizer,250,500,250,2,00241,India
551561,2023-12-16,1006,Blush,150,300,150,2,00406,India
803188,2023-12-16,1008,Makeup Remover,80,160,80,2,00127,India
803188,2023-12-16,1009,Moisturizer,250,500,250,2,00127,India
288715,2023-12-16,1009,Moisturizer,250,500,250,2,00133,India
288715,2023-12-16,1004,Eyeliner,100,200,100,2,00133,India
288715,2023-12-16,1012,Body Lotion,200,400,200,2,00133,India
288715,2023-12-16,1005,Nail Polish,50,100,50,2,00133,India
288715,2023-12-16,1007,Eyeshadow,200,400,200,2,00133,India
432857,2023-12-16,1006,Blush,150,300,150,2,00017,India
432857,2023-12-16,1012,Body Lotion,200,400,200,2,00017,India
432857,2023-12-16,1003,Foundation,300,600,300,2,00017,India
554784,2023-12-16,1007,Eyeshadow,200,400,200,2,00015,India
554784,2023-12-16,1012,Body Lotion,200,400,200,2,00015,India
554784,2023-12-16,1009,Moisturizer,250,500,250,2,00015,India
554784,2023-12-16,1004,Eyeliner,100,200,100,2,00015,India
575749,2023-12-16,1004,Eyeliner,100,200,100,2,00270,India
575749,2023-12-16,1002,Mascara,200,400,200,2,00270,India
575749,2023-12-16,1009,Moisturizer,250,500,250,2,00270,India
575749,2023-12-16,1005,Nail Polish,50,100,50,2,00270,India
119402,2023-12-16,1008,Makeup Remover,80,160,80,2,00486,India
204126,2023-12-16,1002,Mascara,200,400,200,2,00430,India
204126,2023-12-16,1001,Lipstick,150,300,150,2,00430,India
511537,2023-12-16,1005,Nail Polish,50,100,50,2,00414,India
511537,2023-12-16,1002,Mascara,200,400,200,2,00414,India
511537,2023-12-16,1004,Eyeliner,100,200,100,2,00414,India
511537,2023-12-16,1008,Makeup Remover,80,160,80,2,00414,India
225576,2023-12-16,1002,Mascara,200,400,200,2,00485,India
225576,2023-12-16,1006,Blush,150,300,150,2,00485,India
316434,2023-12-16,1007,Eyeshadow,200,400,200,2,00309,India
316434,2023-12-16,1005,Nail Polish,50,100,50,2,00309,India
316434,2023-12-16,1004,Eyeliner,100,200,100,2,00309,India
316434,2023-12-16,1008,Makeup Remover,80,160,80,2,00309,India
501765,2023-12-16,1007,Eyeshadow,200,400,200,2,00322,India
501765,2023-12-16,1003,Foundation,300,600,300,2,00322,India
557284,2023-12-16,1003,Foundation,300,600,300,2,00057,India
557284,2023-12-16,1001,Lipstick,150,300,150,2,00057,India
557284,2023-12-16,1004,Eyeliner,100,200,100,2,00057,India
888069,2023-12-16,1003,Foundation,300,600,300,2,00089,India
888069,2023-12-16,1007,Eyeshadow,200,400,200,2,00089,India
888069,2023-12-16,1005,Nail Polish,50,100,50,2,00089,India
888069,2023-12-16,1001,Lipstick,150,300,150,2,00089,India
112767,2023-12-16,1006,Blush,150,300,150,2,00308,India
112767,2023-12-16,1004,Eyeliner,100,200,100,2,00308,India
105738,2023-12-16,1001,Lipstick,150,300,150,2,00375,India
105738,2023-12-16,1005,Nail Polish,50,100,50,2,00375,India
105738,2023-12-16,1008,Makeup Remover,80,160,80,2,00375,India
780276,2023-12-16,1005,Nail Polish,50,100,50,2,00233,India
780276,2023-12-16,1007,Eyeshadow,200,400,200,2,00233,India
780276,2023-12-16,1003,Foundation,300,600,300,2,00233,India
780276,2023-12-16,1001,Lipstick,150,300,150,2,00233,India
820404,2023-12-16,1006,Blush,150,300,150,2,00206,India
820404,2023-12-16,1012,Body Lotion,200,400,200,2,00206,India
820404,2023-12-16,1002,Mascara,200,400,200,2,00206,India
820404,2023-12-16,1005,Nail Polish,50,100,50,2,00206,India
265275,2023-12-16,1008,Makeup Remover,80,160,80,2,00042,India
265275,2023-12-16,1002,Mascara,200,400,200,2,00042,India
265275,2023-12-16,1006,Blush,150,300,150,2,00042,India
585219,2023-12-16,1002,Mascara,200,400,200,2,00075,India
250090,2023-12-16,1003,Foundation,300,600,300,2,00258,India
250090,2023-12-16,1007,Eyeshadow,200,400,200,2,00258,India
250290,2023-12-16,1003,Foundation,300,600,300,2,00071,India
250290,2023-12-16,1005,Nail Polish,50,100,50,2,00071,India
250290,2023-12-16,1008,Makeup Remover,80,160,80,2,00071,India
250290,2023-12-16,1012,Body Lotion,200,400,200,2,00071,India
250290,2023-12-16,1007,Eyeshadow,200,400,200,2,00071,India
774975,2023-12-16,1008,Makeup Remover,80,160,80,2,00440,India
774975,2023-12-16,1006,Blush,150,300,150,2,00440,India
457689,2023-12-16,1002,Mascara,200,400,200,2,00170,India
457689,2023-12-16,1009,Moisturizer,250,500,250,2,00170,India
613197,2023-12-16,1003,Foundation,300,600,300,2,00434,India
613197,2023-12-16,1005,Nail Polish,50,100,50,2,00434,India
613197,2023-12-16,1008,Makeup Remover,80,160,80,2,00434,India
613197,2023-12-16,1004,Eyeliner,100,200,100,2,00434,India
664022,2023-12-16,1004,Eyeliner,100,200,100,2,00097,India
664022,2023-12-16,1012,Body Lotion,200,400,200,2,00097,India
664022,2023-12-16,1001,Lipstick,150,300,150,2,00097,India
101307,2023-12-16,1007,Eyeshadow,200,400,200,2,00135,India
101307,2023-12-16,1002,Mascara,200,400,200,2,00135,India
101307,2023-12-16,1003,Foundation,300,600,300,2,00135,India
628578,2023-12-16,1008,Makeup Remover,80,160,80,2,00129,India
177174,2023-12-16,1007,Eyeshadow,200,400,200,2,00244,India
933305,2023-12-16,1009,Moisturizer,250,500,250,2,00164,India
933305,2023-12-16,1008,Makeup Remover,80,160,80,2,00164,India
933305,2023-12-16,1012,Body Lotion,200,400,200,2,00164,India
968086,2023-12-16,1005,Nail Polish,50,100,50,2,00324,India
968086,2023-12-16,1007,Eyeshadow,200,400,200,2,00324,India
705333,2023-12-16,1006,Blush,150,300,150,2,00252,India
142689,2023-12-16,1009,Moisturizer,250,500,250,2,00185,India
142689,2023-12-16,1002,Mascara,200,400,200,2,00185,India
142689,2023-12-16,1012,Body Lotion,200,400,200,2,00185,India
709832,2023-12-16,1012,Body Lotion,200,400,200,2,00255,India
847795,2023-12-16,1003,Foundation,300,600,300,2,00414,India
847795,2023-12-16,1001,Lipstick,150,300,150,2,00414,India
528642,2023-12-16,1003,Foundation,300,600,300,2,00067,India
209851,2023-12-16,1007,Eyeshadow,200,400,200,2,00383,India
530417,2023-12-16,1006,Blush,150,300,150,2,00134,India
530417,2023-12-16,1003,Foundation,300,600,300,2,00134,India
249831,2023-12-17,1005,Nail Polish,50,100,50,2,00003,India
249831,2023-12-17,1009,Moisturizer,250,500,250,2,00003,India
525917,2023-12-17,1012,Body Lotion,200,400,200,2,00071,India
387567,2023-12-17,1012,Body Lotion,200,400,200,2,00232,India
198551,2023-12-17,1005,Nail Polish,50,100,50,2,00468,India
198551,2023-12-17,1008,Makeup Remover,80,160,80,2,00468,India
198551,2023-12-17,1003,Foundation,300,600,300,2,00468,India
198551,2023-12-17,1006,Blush,150,300,150,2,00468,India
554710,2023-12-17,1008,Makeup Remover,80,160,80,2,00374,India
554710,2023-12-17,1001,Lipstick,150,300,150,2,00374,India
554710,2023-12-17,1012,Body Lotion,200,400,200,2,00374,India
642299,2023-12-17,1012,Body Lotion,200,400,200,2,00134,India
458674,2023-12-17,1005,Nail Polish,50,100,50,2,00498,India
458674,2023-12-17,1002,Mascara,200,400,200,2,00498,India
866640,2023-12-17,1004,Eyeliner,100,200,100,2,00340,India
845754,2023-12-17,1001,Lipstick,150,300,150,2,00123,India
845754,2023-12-17,1006,Blush,150,300,150,2,00123,India
845754,2023-12-17,1003,Foundation,300,600,300,2,00123,India
845754,2023-12-17,1005,Nail Polish,50,100,50,2,00123,India
829921,2023-12-17,1003,Foundation,300,600,300,2,00202,India
829921,2023-12-17,1001,Lipstick,150,300,150,2,00202,India
706424,2023-12-17,1008,Makeup Remover,80,160,80,2,00083,India
706424,2023-12-17,1004,Eyeliner,100,200,100,2,00083,India
706424,2023-12-17,1005,Nail Polish,50,100,50,2,00083,India
456861,2023-12-17,1004,Eyeliner,100,200,100,2,00356,India
456861,2023-12-17,1009,Moisturizer,250,500,250,2,00356,India
962426,2023-12-17,1012,Body Lotion,200,400,200,2,00313,India
498069,2023-12-17,1004,Eyeliner,100,200,100,2,00477,India
498069,2023-12-17,1012,Body Lotion,200,400,200,2,00477,India
211577,2023-12-17,1012,Body Lotion,200,400,200,2,00492,India
211577,2023-12-17,1003,Foundation,300,600,300,2,00492,India
780245,2023-12-17,1005,Nail Polish,50,100,50,2,00177,India
672100,2023-12-17,1007,Eyeshadow,200,400,200,2,00217,India
877756,2023-12-17,1008,Makeup Remover,80,160,80,2,00468,India
877756,2023-12-17,1007,Eyeshadow,200,400,200,2,00468,India
877756,2023-12-17,1002,Mascara,200,400,200,2,00468,India
877756,2023-12-17,1005,Nail Polish,50,100,50,2,00468,India
801481,2023-12-17,1002,Mascara,200,400,200,2,00431,India
801481,2023-12-17,1004,Eyeliner,100,200,100,2,00431,India
801481,2023-12-17,1006,Blush,150,300,150,2,00431,India
632572,2023-12-17,1008,Makeup Remover,80,160,80,2,00051,India
573088,2023-12-17,1001,Lipstick,150,300,150,2,00263,India
573088,2023-12-17,1004,Eyeliner,100,200,100,2,00263,India
573088,2023-12-17,1002,Mascara,200,400,200,2,00263,India
573088,2023-12-17,1006,Blush,150,300,150,2,00263,India
918018,2023-12-17,1002,Mascara,200,400,200,2,00455,India
266286,2023-12-17,1001,Lipstick,150,300,150,2,00240,India
266286,2023-12-17,1007,Eyeshadow,200,400,200,2,00240,India
387704,2023-12-17,1003,Foundation,300,600,300,2,00215,India
387704,2023-12-17,1002,Mascara,200,400,200,2,00215,India
419323,2023-12-17,1003,Foundation,300,600,300,2,00483,India
419323,2023-12-17,1005,Nail Polish,50,100,50,2,00483,India
419323,2023-12-17,1001,Lipstick,150,300,150,2,00483,India
419323,2023-12-17,1002,Mascara,200,400,200,2,00483,India
798013,2023-12-17,1008,Makeup Remover,80,160,80,2,00184,India
798013,2023-12-17,1003,Foundation,300,600,300,2,00184,India
798013,2023-12-17,1001,Lipstick,150,300,150,2,00184,India
798013,2023-12-17,1006,Blush,150,300,150,2,00184,India
892329,2023-12-17,1006,Blush,150,300,150,2,00126,India
892329,2023-12-17,1004,Eyeliner,100,200,100,2,00126,India
892329,2023-12-17,1003,Foundation,300,600,300,2,00126,India
810424,2023-12-17,1009,Moisturizer,250,500,250,2,00179,India
810424,2023-12-17,1004,Eyeliner,100,200,100,2,00179,India
810424,2023-12-17,1002,Mascara,200,400,200,2,00179,India
925313,2023-12-17,1008,Makeup Remover,80,160,80,2,00392,India
949104,2023-12-17,1009,Moisturizer,250,500,250,2,00200,India
949104,2023-12-17,1005,Nail Polish,50,100,50,2,00200,India
587703,2023-12-17,1003,Foundation,300,600,300,2,00231,India
587703,2023-12-17,1006,Blush,150,300,150,2,00231,India
587703,2023-12-17,1004,Eyeliner,100,200,100,2,00231,India
190936,2023-12-17,1003,Foundation,300,600,300,2,00076,India
190936,2023-12-17,1005,Nail Polish,50,100,50,2,00076,India
190936,2023-12-17,1007,Eyeshadow,200,400,200,2,00076,India
190936,2023-12-17,1012,Body Lotion,200,400,200,2,00076,India
194025,2023-12-17,1005,Nail Polish,50,100,50,2,00392,India
194025,2023-12-17,1001,Lipstick,150,300,150,2,00392,India
927651,2023-12-17,1008,Makeup Remover,80,160,80,2,00245,India
927651,2023-12-17,1006,Blush,150,300,150,2,00245,India
823267,2023-12-17,1007,Eyeshadow,200,400,200,2,00055,India
823267,2023-12-17,1008,Makeup Remover,80,160,80,2,00055,India
823267,2023-12-17,1004,Eyeliner,100,200,100,2,00055,India
560971,2023-12-17,1002,Mascara,200,400,200,2,00419,India
560971,2023-12-17,1012,Body Lotion,200,400,200,2,00419,India
560971,2023-12-17,1009,Moisturizer,250,500,250,2,00419,India
560971,2023-12-17,1001,Lipstick,150,300,150,2,00419,India
836522,2023-12-17,1001,Lipstick,150,300,150,2,00002,India
836522,2023-12-17,1006,Blush,150,300,150,2,00002,India
892482,2023-12-17,1006,Blush,150,300,150,2,00065,India
892482,2023-12-17,1005,Nail Polish,50,100,50,2,00065,India
892482,2023-12-17,1003,Foundation,300,600,300,2,00065,India
892482,2023-12-17,1007,Eyeshadow,200,400,200,2,00065,India
892482,2023-12-17,1009,Moisturizer,250,500,250,2,00065,India
300061,2023-12-17,1005,Nail Polish,50,100,50,2,00367,India
300061,2023-12-17,1001,Lipstick,150,300,150,2,00367,India
300061,2023-12-17,1008,Makeup Remover,80,160,80,2,00367,India
300061,2023-12-17,1004,Eyeliner,100,200,100,2,00367,India
405994,2023-12-17,1001,Lipstick,150,300,150,2,00481,India
405994,2023-12-17,1004,Eyeliner,100,200,100,2,00481,India
405994,2023-12-17,1005,Nail Polish,50,100,50,2,00481,India
405994,2023-12-17,1007,Eyeshadow,200,400,200,2,00481,India
405994,2023-12-17,1009,Moisturizer,250,500,250,2,00481,India
772476,2023-12-17,1012,Body Lotion,200,400,200,2,00308,India
772476,2023-12-17,1004,Eyeliner,100,200,100,2,00308,India
772476,2023-12-17,1009,Moisturizer,250,500,250,2,00308,India
212868,2023-12-17,1008,Makeup Remover,80,160,80,2,00090,India
212868,2023-12-17,1001,Lipstick,150,300,150,2,00090,India
212868,2023-12-17,1009,Moisturizer,250,500,250,2,00090,India
785994,2023-12-17,1003,Foundation,300,600,300,2,00141,India
785994,2023-12-17,1007,Eyeshadow,200,400,200,2,00141,India
785994,2023-12-17,1009,Moisturizer,250,500,250,2,00141,India
549812,2023-12-17,1001,Lipstick,150,300,150,2,00022,India
549812,2023-12-17,1002,Mascara,200,400,200,2,00022,India
549812,2023-12-17,1004,Eyeliner,100,200,100,2,00022,India
669715,2023-12-17,1012,Body Lotion,200,400,200,2,00071,India
669715,2023-12-17,1005,Nail Polish,50,100,50,2,00071,India
669715,2023-12-17,1003,Foundation,300,600,300,2,00071,India
669715,2023-12-17,1001,Lipstick,150,300,150,2,00071,India
643469,2023-12-17,1009,Moisturizer,250,500,250,2,00330,India
643469,2023-12-17,1006,Blush,150,300,150,2,00330,India
643469,2023-12-17,1005,Nail Polish,50,100,50,2,00330,India
643469,2023-12-17,1008,Makeup Remover,80,160,80,2,00330,India
643469,2023-12-17,1002,Mascara,200,400,200,2,00330,India
468758,2023-12-18,1006,Blush,150,300,150,2,00124,India
468758,2023-12-18,1005,Nail Polish,50,100,50,2,00124,India
314517,2023-12-18,1009,Moisturizer,250,500,250,2,00163,India
314517,2023-12-18,1008,Makeup Remover,80,160,80,2,00163,India
498249,2023-12-18,1005,Nail Polish,50,100,50,2,00319,India
498249,2023-12-18,1006,Blush,150,300,150,2,00319,India
498249,2023-12-18,1003,Foundation,300,600,300,2,00319,India
781929,2023-12-18,1005,Nail Polish,50,100,50,2,00431,India
781929,2023-12-18,1006,Blush,150,300,150,2,00431,India
781929,2023-12-18,1007,Eyeshadow,200,400,200,2,00431,India
781929,2023-12-18,1008,Makeup Remover,80,160,80,2,00431,India
441079,2023-12-18,1004,Eyeliner,100,200,100,2,00120,India
441079,2023-12-18,1001,Lipstick,150,300,150,2,00120,India
714126,2023-12-18,1001,Lipstick,150,300,150,2,00143,India
714126,2023-12-18,1004,Eyeliner,100,200,100,2,00143,India
714126,2023-12-18,1003,Foundation,300,600,300,2,00143,India
963462,2023-12-18,1007,Eyeshadow,200,400,200,2,00425,India
963462,2023-12-18,1003,Foundation,300,600,300,2,00425,India
963462,2023-12-18,1002,Mascara,200,400,200,2,00425,India
963462,2023-12-18,1009,Moisturizer,250,500,250,2,00425,India
818125,2023-12-18,1012,Body Lotion,200,400,200,2,00407,India
818125,2023-12-18,1006,Blush,150,300,150,2,00407,India
674633,2023-12-18,1008,Makeup Remover,80,160,80,2,00294,India
674633,2023-12-18,1007,Eyeshadow,200,400,200,2,00294,India
909316,2023-12-18,1008,Makeup Remover,80,160,80,2,00403,India
509589,2023-12-18,1009,Moisturizer,250,500,250,2,00049,India
509589,2023-12-18,1008,Makeup Remover,80,160,80,2,00049,India
509589,2023-12-18,1001,Lipstick,150,300,150,2,00049,India
509589,2023-12-18,1002,Mascara,200,400,200,2,00049,India
509589,2023-12-18,1005,Nail Polish,50,100,50,2,00049,India
423742,2023-12-18,1008,Makeup Remover,80,160,80,2,00397,India
423742,2023-12-18,1001,Lipstick,150,300,150,2,00397,India
423742,2023-12-18,1003,Foundation,300,600,300,2,00397,India
728400,2023-12-18,1012,Body Lotion,200,400,200,2,00383,India
728400,2023-12-18,1003,Foundation,300,600,300,2,00383,India
886494,2023-12-18,1003,Foundation,300,600,300,2,00185,India
886494,2023-12-18,1005,Nail Polish,50,100,50,2,00185,India
122705,2023-12-18,1002,Mascara,200,400,200,2,00142,India
122705,2023-12-18,1006,Blush,150,300,150,2,00142,India
122705,2023-12-18,1008,Makeup Remover,80,160,80,2,00142,India
122705,2023-12-18,1007,Eyeshadow,200,400,200,2,00142,India
122705,2023-12-18,1003,Foundation,300,600,300,2,00142,India
707886,2023-12-18,1001,Lipstick,150,300,150,2,00309,India
707886,2023-12-18,1006,Blush,150,300,150,2,00309,India
707886,2023-12-18,1003,Foundation,300,600,300,2,00309,India
927596,2023-12-18,1002,Mascara,200,400,200,2,00051,India
927596,2023-12-18,1001,Lipstick,150,300,150,2,00051,India
927596,2023-12-18,1006,Blush,150,300,150,2,00051,India
927596,2023-12-18,1004,Eyeliner,100,200,100,2,00051,India
927596,2023-12-18,1003,Foundation,300,600,300,2,00051,India
474185,2023-12-18,1012,Body Lotion,200,400,200,2,00461,India
219135,2023-12-18,1002,Mascara,200,400,200,2,00272,India
219135,2023-12-18,1006,Blush,150,300,150,2,00272,India
219135,2023-12-18,1004,Eyeliner,100,200,100,2,00272,India
219135,2023-12-18,1009,Moisturizer,250,500,250,2,00272,India
896150,2023-12-18,1006,Blush,150,300,150,2,00142,India
765430,2023-12-18,1006,Blush,150,300,150,2,00077,India
129278,2023-12-18,1004,Eyeliner,100,200,100,2,00152,India
511624,2023-12-18,1003,Foundation,300,600,300,2,00491,India
448363,2023-12-18,1001,Lipstick,150,300,150,2,00343,India
219653,2023-12-18,1001,Lipstick,150,300,150,2,00009,India
899252,2023-12-18,1005,Nail Polish,50,100,50,2,00095,India
604892,2023-12-18,1008,Makeup Remover,80,160,80,2,00245,India
604892,2023-12-18,1002,Mascara,200,400,200,2,00245,India
604892,2023-12-18,1005,Nail Polish,50,100,50,2,00245,India
604892,2023-12-18,1007,Eyeshadow,200,400,200,2,00245,India
499968,2023-12-18,1008,Makeup Remover,80,160,80,2,00333,India
499968,2023-12-18,1004,Eyeliner,100,200,100,2,00333,India
518387,2023-12-18,1004,Eyeliner,100,200,100,2,00422,India
518387,2023-12-18,1002,Mascara,200,400,200,2,00422,India
856263,2023-12-18,1008,Makeup Remover,80,160,80,2,00026,India
656749,2023-12-18,1004,Eyeliner,100,200,100,2,00435,India
656749,2023-12-18,1012,Body Lotion,200,400,200,2,00435,India
656749,2023-12-18,1006,Blush,150,300,150,2,00435,India
581101,2023-12-18,1012,Body Lotion,200,400,200,2,00209,India
623373,2023-12-18,1004,Eyeliner,100,200,100,2,00344,India
623373,2023-12-18,1009,Moisturizer,250,500,250,2,00344,India
623373,2023-12-18,1002,Mascara,200,400,200,2,00344,India
623373,2023-12-18,1006,Blush,150,300,150,2,00344,India
419262,2023-12-18,1001,Lipstick,150,300,150,2,00201,India
419262,2023-12-18,1005,Nail Polish,50,100,50,2,00201,India
419262,2023-12-18,1009,Moisturizer,250,500,250,2,00201,India
194011,2023-12-18,1001,Lipstick,150,300,150,2,00125,India
909900,2023-12-18,1004,Eyeliner,100,200,100,2,00417,India
909900,2023-12-18,1006,Blush,150,300,150,2,00417,India
909900,2023-12-18,1008,Makeup Remover,80,160,80,2,00417,India
909900,2023-12-18,1001,Lipstick,150,300,150,2,00417,India
909900,2023-12-18,1003,Foundation,300,600,300,2,00417,India
431307,2023-12-18,1007,Eyeshadow,200,400,200,2,00256,India
444397,2023-12-18,1007,Eyeshadow,200,400,200,2,00075,India
444397,2023-12-18,1003,Foundation,300,600,300,2,00075,India
444397,2023-12-18,1008,Makeup Remover,80,160,80,2,00075,India
613613,2023-12-18,1002,Mascara,200,400,200,2,00283,India
613613,2023-12-18,1009,Moisturizer,250,500,250,2,00283,India
613613,2023-12-18,1003,Foundation,300,600,300,2,00283,India
337711,2023-12-18,1001,Lipstick,150,300,150,2,00381,India
337711,2023-12-18,1007,Eyeshadow,200,400,200,2,00381,India
675677,2023-12-18,1002,Mascara,200,400,200,2,00017,India
675677,2023-12-18,1012,Body Lotion,200,400,200,2,00017,India
675677,2023-12-18,1007,Eyeshadow,200,400,200,2,00017,India
675677,2023-12-18,1005,Nail Polish,50,100,50,2,00017,India
627209,2023-12-18,1007,Eyeshadow,200,400,200,2,00022,India
128942,2023-12-18,1008,Makeup Remover,80,160,80,2,00101,India
128942,2023-12-18,1002,Mascara,200,400,200,2,00101,India
128942,2023-12-18,1004,Eyeliner,100,200,100,2,00101,India
128942,2023-12-18,1006,Blush,150,300,150,2,00101,India
658745,2023-12-18,1012,Body Lotion,200,400,200,2,00380,India
948462,2023-12-18,1002,Mascara,200,400,200,2,00469,India
327376,2023-12-18,1004,Eyeliner,100,200,100,2,00354,India
327376,2023-12-18,1009,Moisturizer,250,500,250,2,00354,India
327376,2023-12-18,1006,Blush,150,300,150,2,00354,India
327376,2023-12-18,1005,Nail Polish,50,100,50,2,00354,India
401853,2023-12-19,1007,Eyeshadow,200,400,200,2,00302,India
401853,2023-12-19,1005,Nail Polish,50,100,50,2,00302,India
401853,2023-12-19,1003,Foundation,300,600,300,2,00302,India
790910,2023-12-19,1005,Nail Polish,50,100,50,2,00210,India
367885,2023-12-19,1012,Body Lotion,200,400,200,2,00199,India
367885,2023-12-19,1008,Makeup Remover,80,160,80,2,00199,India
367885,2023-12-19,1003,Foundation,300,600,300,2,00199,India
367885,2023-12-19,1002,Mascara,200,400,200,2,00199,India
400652,2023-12-19,1005,Nail Polish,50,100,50,2,00484,India
743802,2023-12-19,1002,Mascara,200,400,200,2,00436,India
743802,2023-12-19,1006,Blush,150,300,150,2,00436,India
743802,2023-12-19,1005,Nail Polish,50,100,50,2,00436,India
743802,2023-12-19,1007,Eyeshadow,200,400,200,2,00436,India
302067,2023-12-19,1003,Foundation,300,600,300,2,00362,India
302067,2023-12-19,1001,Lipstick,150,300,150,2,00362,India
302067,2023-12-19,1007,Eyeshadow,200,400,200,2,00362,India
189647,2023-12-19,1012,Body Lotion,200,400,200,2,00323,India
189647,2023-12-19,1002,Mascara,200,400,200,2,00323,India
418612,2023-12-19,1005,Nail Polish,50,100,50,2,00247,India
418612,2023-12-19,1004,Eyeliner,100,200,100,2,00247,India
418612,2023-12-19,1007,Eyeshadow,200,400,200,2,00247,India
418612,2023-12-19,1001,Lipstick,150,300,150,2,00247,India
326029,2023-12-19,1006,Blush,150,300,150,2,00314,India
326029,2023-12-19,1012,Body Lotion,200,400,200,2,00314,India
326029,2023-12-19,1004,Eyeliner,100,200,100,2,00314,India
663174,2023-12-19,1009,Moisturizer,250,500,250,2,00008,India
663174,2023-12-19,1004,Eyeliner,100,200,100,2,00008,India
663174,2023-12-19,1012,Body Lotion,200,400,200,2,00008,India
663174,2023-12-19,1005,Nail Polish,50,100,50,2,00008,India
880623,2023-12-19,1004,Eyeliner,100,200,100,2,00116,India
880623,2023-12-19,1012,Body Lotion,200,400,200,2,00116,India
880623,2023-12-19,1005,Nail Polish,50,100,50,2,00116,India
403413,2023-12-19,1005,Nail Polish,50,100,50,2,00239,India
403413,2023-12-19,1008,Makeup Remover,80,160,80,2,00239,India
403413,2023-12-19,1012,Body Lotion,200,400,200,2,00239,India
403413,2023-12-19,1002,Mascara,200,400,200,2,00239,India
403413,2023-12-19,1001,Lipstick,150,300,150,2,00239,India
577219,2023-12-19,1002,Mascara,200,400,200,2,00119,India
577219,2023-12-19,1006,Blush,150,300,150,2,00119,India
577219,2023-12-19,1004,Eyeliner,100,200,100,2,00119,India
577219,2023-12-19,1001,Lipstick,150,300,150,2,00119,India
377078,2023-12-19,1003,Foundation,300,600,300,2,00401,India
377078,2023-12-19,1005,Nail Polish,50,100,50,2,00401,India
377078,2023-12-19,1009,Moisturizer,250,500,250,2,00401,India
683442,2023-12-19,1003,Foundation,300,600,300,2,00447,India
683442,2023-12-19,1006,Blush,150,300,150,2,00447,India
683442,2023-12-19,1008,Makeup Remover,80,160,80,2,00447,India
683442,2023-12-19,1002,Mascara,200,400,200,2,00447,India
952224,2023-12-19,1005,Nail Polish,50,100,50,2,00424,India
584452,2023-12-19,1002,Mascara,200,400,200,2,00103,India
584452,2023-12-19,1009,Moisturizer,250,500,250,2,00103,India
746150,2023-12-19,1005,Nail Polish,50,100,50,2,00489,India
746150,2023-12-19,1001,Lipstick,150,300,150,2,00489,India
734616,2023-12-19,1008,Makeup Remover,80,160,80,2,00249,India
734616,2023-12-19,1003,Foundation,300,600,300,2,00249,India
734616,2023-12-19,1005,Nail Polish,50,100,50,2,00249,India
337711,2023-12-19,1006,Blush,150,300,150,2,00381,India
337711,2023-12-19,1001,Lipstick,150,300,150,2,00381,India
884081,2023-12-19,1009,Moisturizer,250,500,250,2,00182,India
884081,2023-12-19,1006,Blush,150,300,150,2,00182,India
884081,2023-12-19,1008,Makeup Remover,80,160,80,2,00182,India
224036,2023-12-19,1009,Moisturizer,250,500,250,2,00388,India
224036,2023-12-19,1001,Lipstick,150,300,150,2,00388,India
224036,2023-12-19,1004,Eyeliner,100,200,100,2,00388,India
392087,2023-12-19,1006,Blush,150,300,150,2,00224,India
108167,2023-12-19,1002,Mascara,200,400,200,2,00142,India
108167,2023-12-19,1008,Makeup Remover,80,160,80,2,00142,India
134109,2023-12-19,1009,Moisturizer,250,500,250,2,00092,India
756185,2023-12-19,1001,Lipstick,150,300,150,2,00237,India
756185,2023-12-19,1003,Foundation,300,600,300,2,00237,India
584069,2023-12-19,1004,Eyeliner,100,200,100,2,00346,India
584069,2023-12-19,1002,Mascara,200,400,200,2,00346,India
584069,2023-12-19,1005,Nail Polish,50,100,50,2,00346,India
584069,2023-12-19,1001,Lipstick,150,300,150,2,00346,India
111163,2023-12-19,1008,Makeup Remover,80,160,80,2,00269,India
111163,2023-12-19,1006,Blush,150,300,150,2,00269,India
111163,2023-12-19,1007,Eyeshadow,200,400,200,2,00269,India
451123,2023-12-19,1005,Nail Polish,50,100,50,2,00274,India
451123,2023-12-19,1009,Moisturizer,250,500,250,2,00274,India
451123,2023-12-19,1003,Foundation,300,600,300,2,00274,India
451123,2023-12-19,1006,Blush,150,300,150,2,00274,India
506648,2023-12-19,1008,Makeup Remover,80,160,80,2,00336,India
506648,2023-12-19,1006,Blush,150,300,150,2,00336,India
506648,2023-12-19,1007,Eyeshadow,200,400,200,2,00336,India
506648,2023-12-19,1012,Body Lotion,200,400,200,2,00336,India
506648,2023-12-19,1003,Foundation,300,600,300,2,00336,India
720789,2023-12-19,1005,Nail Polish,50,100,50,2,00487,India
720789,2023-12-19,1007,Eyeshadow,200,400,200,2,00487,India
720789,2023-12-19,1006,Blush,150,300,150,2,00487,India
720789,2023-12-19,1004,Eyeliner,100,200,100,2,00487,India
948875,2023-12-19,1002,Mascara,200,400,200,2,00119,India
948875,2023-12-19,1008,Makeup Remover,80,160,80,2,00119,India
948254,2023-12-19,1006,Blush,150,300,150,2,00027,India
948254,2023-12-19,1012,Body Lotion,200,400,200,2,00027,India
168232,2023-12-19,1008,Makeup Remover,80,160,80,2,00036,India
168232,2023-12-19,1004,Eyeliner,100,200,100,2,00036,India
168232,2023-12-19,1007,Eyeshadow,200,400,200,2,00036,India
942076,2023-12-19,1008,Makeup Remover,80,160,80,2,00415,India
918546,2023-12-19,1006,Blush,150,300,150,2,00369,India
918546,2023-12-19,1009,Moisturizer,250,500,250,2,00369,India
918546,2023-12-19,1008,Makeup Remover,80,160,80,2,00369,India
918546,2023-12-19,1004,Eyeliner,100,200,100,2,00369,India
642852,2023-12-19,1003,Foundation,300,600,300,2,00171,India
642852,2023-12-19,1007,Eyeshadow,200,400,200,2,00171,India
145289,2023-12-20,1008,Makeup Remover,80,160,80,2,00158,India
145289,2023-12-20,1012,Body Lotion,200,400,200,2,00158,India
145289,2023-12-20,1007,Eyeshadow,200,400,200,2,00158,India
145289,2023-12-20,1001,Lipstick,150,300,150,2,00158,India
145289,2023-12-20,1006,Blush,150,300,150,2,00158,India
640271,2023-12-20,1002,Mascara,200,400,200,2,00106,India
640271,2023-12-20,1009,Moisturizer,250,500,250,2,00106,India
640271,2023-12-20,1007,Eyeshadow,200,400,200,2,00106,India
640271,2023-12-20,1003,Foundation,300,600,300,2,00106,India
992811,2023-12-20,1003,Foundation,300,600,300,2,00313,India
992811,2023-12-20,1007,Eyeshadow,200,400,200,2,00313,India
974995,2023-12-20,1003,Foundation,300,600,300,2,00243,India
980022,2023-12-20,1006,Blush,150,300,150,2,00370,India
980022,2023-12-20,1001,Lipstick,150,300,150,2,00370,India
555029,2023-12-20,1009,Moisturizer,250,500,250,2,00316,India
555029,2023-12-20,1004,Eyeliner,100,200,100,2,00316,India
990158,2023-12-20,1001,Lipstick,150,300,150,2,00293,India
990158,2023-12-20,1005,Nail Polish,50,100,50,2,00293,India
990158,2023-12-20,1012,Body Lotion,200,400,200,2,00293,India
849894,2023-12-20,1012,Body Lotion,200,400,200,2,00178,India
849894,2023-12-20,1003,Foundation,300,600,300,2,00178,India
849894,2023-12-20,1009,Moisturizer,250,500,250,2,00178,India
628306,2023-12-20,1012,Body Lotion,200,400,200,2,00278,India
628306,2023-12-20,1003,Foundation,300,600,300,2,00278,India
897050,2023-12-20,1008,Makeup Remover,80,160,80,2,00360,India
894920,2023-12-20,1008,Makeup Remover,80,160,80,2,00233,India
894920,2023-12-20,1006,Blush,150,300,150,2,00233,India
894920,2023-12-20,1012,Body Lotion,200,400,200,2,00233,India
894920,2023-12-20,1001,Lipstick,150,300,150,2,00233,India
686747,2023-12-20,1012,Body Lotion,200,400,200,2,00378,India
814035,2023-12-20,1001,Lipstick,150,300,150,2,00301,India
814035,2023-12-20,1008,Makeup Remover,80,160,80,2,00301,India
650235,2023-12-20,1004,Eyeliner,100,200,100,2,00124,India
941827,2023-12-20,1005,Nail Polish,50,100,50,2,00360,India
941827,2023-12-20,1006,Blush,150,300,150,2,00360,India
941827,2023-12-20,1008,Makeup Remover,80,160,80,2,00360,India
222308,2023-12-20,1009,Moisturizer,250,500,250,2,00235,India
222308,2023-12-20,1002,Mascara,200,400,200,2,00235,India
222308,2023-12-20,1003,Foundation,300,600,300,2,00235,India
392747,2023-12-20,1006,Blush,150,300,150,2,00245,India
392747,2023-12-20,1004,Eyeliner,100,200,100,2,00245,India
392747,2023-12-20,1001,Lipstick,150,300,150,2,00245,India
392747,2023-12-20,1008,Makeup Remover,80,160,80,2,00245,India
350898,2023-12-20,1012,Body Lotion,200,400,200,2,00290,India
350898,2023-12-20,1005,Nail Polish,50,100,50,2,00290,India
919235,2023-12-20,1005,Nail Polish,50,100,50,2,00380,India
919235,2023-12-20,1004,Eyeliner,100,200,100,2,00380,India
919235,2023-12-20,1003,Foundation,300,600,300,2,00380,India
919235,2023-12-20,1001,Lipstick,150,300,150,2,00380,India
711631,2023-12-20,1005,Nail Polish,50,100,50,2,00223,India
711631,2023-12-20,1012,Body Lotion,200,400,200,2,00223,India
711631,2023-12-20,1006,Blush,150,300,150,2,00223,India
711631,2023-12-20,1004,Eyeliner,100,200,100,2,00223,India
711631,2023-12-20,1001,Lipstick,150,300,150,2,00223,India
156395,2023-12-20,1005,Nail Polish,50,100,50,2,00140,India
156395,2023-12-20,1002,Mascara,200,400,200,2,00140,India
156395,2023-12-20,1008,Makeup Remover,80,160,80,2,00140,India
156395,2023-12-20,1004,Eyeliner,100,200,100,2,00140,India
169014,2023-12-20,1007,Eyeshadow,200,400,200,2,00287,India
169014,2023-12-20,1004,Eyeliner,100,200,100,2,00287,India
169014,2023-12-20,1006,Blush,150,300,150,2,00287,India
169014,2023-12-20,1001,Lipstick,150,300,150,2,00287,India
611884,2023-12-20,1001,Lipstick,150,300,150,2,00440,India
643970,2023-12-20,1006,Blush,150,300,150,2,00384,India
643970,2023-12-20,1001,Lipstick,150,300,150,2,00384,India
643970,2023-12-20,1002,Mascara,200,400,200,2,00384,India
643970,2023-12-20,1005,Nail Polish,50,100,50,2,00384,India
643970,2023-12-20,1003,Foundation,300,600,300,2,00384,India
516534,2023-12-20,1007,Eyeshadow,200,400,200,2,00105,India
516534,2023-12-20,1012,Body Lotion,200,400,200,2,00105,India
516534,2023-12-20,1005,Nail Polish,50,100,50,2,00105,India
516534,2023-12-20,1006,Blush,150,300,150,2,00105,India
726123,2023-12-20,1008,Makeup Remover,80,160,80,2,00428,India
726123,2023-12-20,1002,Mascara,200,400,200,2,00428,India
726123,2023-12-20,1009,Moisturizer,250,500,250,2,00428,India
726123,2023-12-20,1001,Lipstick,150,300,150,2,00428,India
741735,2023-12-20,1004,Eyeliner,100,200,100,2,00479,India
741735,2023-12-20,1007,Eyeshadow,200,400,200,2,00479,India
741735,2023-12-20,1008,Makeup Remover,80,160,80,2,00479,India
119906,2023-12-20,1006,Blush,150,300,150,2,00192,India
119906,2023-12-20,1001,Lipstick,150,300,150,2,00192,India
119906,2023-12-20,1007,Eyeshadow,200,400,200,2,00192,India
119906,2023-12-20,1008,Makeup Remover,80,160,80,2,00192,India
451791,2023-12-20,1004,Eyeliner,100,200,100,2,00073,India
451791,2023-12-20,1005,Nail Polish,50,100,50,2,00073,India
451791,2023-12-20,1009,Moisturizer,250,500,250,2,00073,India
530034,2023-12-20,1005,Nail Polish,50,100,50,2,00325,India
744732,2023-12-20,1004,Eyeliner,100,200,100,2,00388,India
452262,2023-12-20,1003,Foundation,300,600,300,2,00416,India
452262,2023-12-20,1012,Body Lotion,200,400,200,2,00416,India
452262,2023-12-20,1009,Moisturizer,250,500,250,2,00416,India
555724,2023-12-20,1004,Eyeliner,100,200,100,2,00021,India
340073,2023-12-20,1009,Moisturizer,250,500,250,2,00315,India
340073,2023-12-20,1006,Blush,150,300,150,2,00315,India
340073,2023-12-20,1003,Foundation,300,600,300,2,00315,India
340073,2023-12-20,1005,Nail Polish,50,100,50,2,00315,India
307560,2023-12-20,1008,Makeup Remover,80,160,80,2,00252,India
307560,2023-12-20,1007,Eyeshadow,200,400,200,2,00252,India
307560,2023-12-20,1001,Lipstick,150,300,150,2,00252,India
551106,2023-12-20,1003,Foundation,300,600,300,2,00233,India
551106,2023-12-20,1007,Eyeshadow,200,400,200,2,00233,India
551106,2023-12-20,1005,Nail Polish,50,100,50,2,00233,India
551106,2023-12-20,1006,Blush,150,300,150,2,00233,India
519668,2023-12-20,1007,Eyeshadow,200,400,200,2,00004,India
519668,2023-12-20,1003,Foundation,300,600,300,2,00004,India
209985,2023-12-20,1002,Mascara,200,400,200,2,00283,India
209985,2023-12-20,1008,Makeup Remover,80,160,80,2,00283,India
209985,2023-12-20,1004,Eyeliner,100,200,100,2,00283,India
209985,2023-12-20,1012,Body Lotion,200,400,200,2,00283,India
209985,2023-12-20,1006,Blush,150,300,150,2,00283,India
488066,2023-12-20,1002,Mascara,200,400,200,2,00255,India
488066,2023-12-20,1001,Lipstick,150,300,150,2,00255,India
942544,2023-12-20,1002,Mascara,200,400,200,2,00066,India
942544,2023-12-20,1008,Makeup Remover,80,160,80,2,00066,India
625103,2023-12-20,1007,Eyeshadow,200,400,200,2,00481,India
625103,2023-12-20,1009,Moisturizer,250,500,250,2,00481,India
625103,2023-12-20,1012,Body Lotion,200,400,200,2,00481,India
625103,2023-12-20,1006,Blush,150,300,150,2,00481,India
532131,2023-12-20,1002,Mascara,200,400,200,2,00306,India
532131,2023-12-20,1006,Blush,150,300,150,2,00306,India
470104,2023-12-20,1006,Blush,150,300,150,2,00096,India
470104,2023-12-20,1002,Mascara,200,400,200,2,00096,India
470104,2023-12-20,1005,Nail Polish,50,100,50,2,00096,India
597203,2023-12-21,1012,Body Lotion,200,400,200,2,00425,India
597203,2023-12-21,1003,Foundation,300,600,300,2,00425,India
597203,2023-12-21,1001,Lipstick,150,300,150,2,00425,India
597203,2023-12-21,1002,Mascara,200,400,200,2,00425,India
412577,2023-12-21,1001,Lipstick,150,300,150,2,00164,India
320612,2023-12-21,1007,Eyeshadow,200,400,200,2,00300,India
320612,2023-12-21,1004,Eyeliner,100,200,100,2,00300,India
320612,2023-12-21,1006,Blush,150,300,150,2,00300,India
188984,2023-12-21,1003,Foundation,300,600,300,2,00212,India
188984,2023-12-21,1009,Moisturizer,250,500,250,2,00212,India
188984,2023-12-21,1004,Eyeliner,100,200,100,2,00212,India
188984,2023-12-21,1012,Body Lotion,200,400,200,2,00212,India
674333,2023-12-21,1001,Lipstick,150,300,150,2,00301,India
674333,2023-12-21,1005,Nail Polish,50,100,50,2,00301,India
674333,2023-12-21,1009,Moisturizer,250,500,250,2,00301,India
910602,2023-12-21,1003,Foundation,300,600,300,2,00088,India
910602,2023-12-21,1001,Lipstick,150,300,150,2,00088,India
910602,2023-12-21,1005,Nail Polish,50,100,50,2,00088,India
910602,2023-12-21,1002,Mascara,200,400,200,2,00088,India
169656,2023-12-21,1005,Nail Polish,50,100,50,2,00193,India
169656,2023-12-21,1004,Eyeliner,100,200,100,2,00193,India
859976,2023-12-21,1005,Nail Polish,50,100,50,2,00477,India
859976,2023-12-21,1007,Eyeshadow,200,400,200,2,00477,India
859976,2023-12-21,1001,Lipstick,150,300,150,2,00477,India
859976,2023-12-21,1002,Mascara,200,400,200,2,00477,India
223053,2023-12-21,1002,Mascara,200,400,200,2,00278,India
223053,2023-12-21,1003,Foundation,300,600,300,2,00278,India
223053,2023-12-21,1007,Eyeshadow,200,400,200,2,00278,India
106350,2023-12-21,1006,Blush,150,300,150,2,00265,India
106350,2023-12-21,1002,Mascara,200,400,200,2,00265,India
106350,2023-12-21,1012,Body Lotion,200,400,200,2,00265,India
897671,2023-12-21,1009,Moisturizer,250,500,250,2,00267,India
897671,2023-12-21,1007,Eyeshadow,200,400,200,2,00267,India
897671,2023-12-21,1002,Mascara,200,400,200,2,00267,India
890207,2023-12-21,1006,Blush,150,300,150,2,00165,India
890207,2023-12-21,1003,Foundation,300,600,300,2,00165,India
346131,2023-12-21,1004,Eyeliner,100,200,100,2,00256,India
346131,2023-12-21,1009,Moisturizer,250,500,250,2,00256,India
346131,2023-12-21,1005,Nail Polish,50,100,50,2,00256,India
848927,2023-12-21,1001,Lipstick,150,300,150,2,00105,India
848927,2023-12-21,1006,Blush,150,300,150,2,00105,India
848927,2023-12-21,1004,Eyeliner,100,200,100,2,00105,India
848927,2023-12-21,1002,Mascara,200,400,200,2,00105,India
347410,2023-12-21,1003,Foundation,300,600,300,2,00103,India
361658,2023-12-21,1009,Moisturizer,250,500,250,2,00234,India
361658,2023-12-21,1001,Lipstick,150,300,150,2,00234,India
361658,2023-12-21,1004,Eyeliner,100,200,100,2,00234,India
361658,2023-12-21,1002,Mascara,200,400,200,2,00234,India
132203,2023-12-21,1002,Mascara,200,400,200,2,00195,India
132203,2023-12-21,1001,Lipstick,150,300,150,2,00195,India
132203,2023-12-21,1008,Makeup Remover,80,160,80,2,00195,India
765884,2023-12-21,1004,Eyeliner,100,200,100,2,00412,India
765884,2023-12-21,1002,Mascara,200,400,200,2,00412,India
765884,2023-12-21,1009,Moisturizer,250,500,250,2,00412,India
941642,2023-12-21,1004,Eyeliner,100,200,100,2,00034,India
941642,2023-12-21,1006,Blush,150,300,150,2,00034,India
941642,2023-12-21,1001,Lipstick,150,300,150,2,00034,India
941642,2023-12-21,1008,Makeup Remover,80,160,80,2,00034,India
941642,2023-12-21,1007,Eyeshadow,200,400,200,2,00034,India
237921,2023-12-21,1005,Nail Polish,50,100,50,2,00327,India
237921,2023-12-21,1009,Moisturizer,250,500,250,2,00327,India
237921,2023-12-21,1002,Mascara,200,400,200,2,00327,India
923554,2023-12-21,1004,Eyeliner,100,200,100,2,00108,India
923554,2023-12-21,1007,Eyeshadow,200,400,200,2,00108,India
796202,2023-12-21,1006,Blush,150,300,150,2,00105,India
796202,2023-12-21,1003,Foundation,300,600,300,2,00105,India
796202,2023-12-21,1002,Mascara,200,400,200,2,00105,India
796202,2023-12-21,1012,Body Lotion,200,400,200,2,00105,India
113253,2023-12-21,1012,Body Lotion,200,400,200,2,00215,India
113253,2023-12-21,1006,Blush,150,300,150,2,00215,India
113253,2023-12-21,1008,Makeup Remover,80,160,80,2,00215,India
390673,2023-12-21,1005,Nail Polish,50,100,50,2,00146,India
390673,2023-12-21,1002,Mascara,200,400,200,2,00146,India
625202,2023-12-21,1003,Foundation,300,600,300,2,00243,India
625202,2023-12-21,1012,Body Lotion,200,400,200,2,00243,India
625202,2023-12-21,1007,Eyeshadow,200,400,200,2,00243,India
803948,2023-12-21,1008,Makeup Remover,80,160,80,2,00479,India
434449,2023-12-21,1001,Lipstick,150,300,150,2,00423,India
434449,2023-12-21,1002,Mascara,200,400,200,2,00423,India
174245,2023-12-21,1005,Nail Polish,50,100,50,2,00432,India
174245,2023-12-21,1002,Mascara,200,400,200,2,00432,India
174245,2023-12-21,1004,Eyeliner,100,200,100,2,00432,India
174245,2023-12-21,1001,Lipstick,150,300,150,2,00432,India
880501,2023-12-21,1005,Nail Polish,50,100,50,2,00347,India
880501,2023-12-21,1003,Foundation,300,600,300,2,00347,India
880501,2023-12-21,1002,Mascara,200,400,200,2,00347,India
880501,2023-12-21,1007,Eyeshadow,200,400,200,2,00347,India
743376,2023-12-21,1002,Mascara,200,400,200,2,00414,India
743376,2023-12-21,1012,Body Lotion,200,400,200,2,00414,India
743376,2023-12-21,1007,Eyeshadow,200,400,200,2,00414,India
123350,2023-12-21,1007,Eyeshadow,200,400,200,2,00445,India
123350,2023-12-21,1005,Nail Polish,50,100,50,2,00445,India
102783,2023-12-21,1008,Makeup Remover,80,160,80,2,00158,India
102783,2023-12-21,1005,Nail Polish,50,100,50,2,00158,India
809201,2023-12-21,1006,Blush,150,300,150,2,00330,India
809201,2023-12-21,1009,Moisturizer,250,500,250,2,00330,India
809201,2023-12-21,1007,Eyeshadow,200,400,200,2,00330,India
809201,2023-12-21,1008,Makeup Remover,80,160,80,2,00330,India
191484,2023-12-21,1008,Makeup Remover,80,160,80,2,00346,India
191484,2023-12-21,1009,Moisturizer,250,500,250,2,00346,India
191484,2023-12-21,1001,Lipstick,150,300,150,2,00346,India
510031,2023-12-21,1008,Makeup Remover,80,160,80,2,00210,India
510031,2023-12-21,1003,Foundation,300,600,300,2,00210,India
510031,2023-12-21,1005,Nail Polish,50,100,50,2,00210,India
510031,2023-12-21,1002,Mascara,200,400,200,2,00210,India
299531,2023-12-21,1006,Blush,150,300,150,2,00328,India
299531,2023-12-21,1007,Eyeshadow,200,400,200,2,00328,India
997926,2023-12-21,1012,Body Lotion,200,400,200,2,00142,India
997926,2023-12-21,1002,Mascara,200,400,200,2,00142,India
997926,2023-12-21,1001,Lipstick,150,300,150,2,00142,India
997926,2023-12-21,1003,Foundation,300,600,300,2,00142,India
997926,2023-12-21,1008,Makeup Remover,80,160,80,2,00142,India
890681,2023-12-22,1001,Lipstick,150,300,150,2,00198,India
890681,2023-12-22,1012,Body Lotion,200,400,200,2,00198,India
890681,2023-12-22,1009,Moisturizer,250,500,250,2,00198,India
862400,2023-12-22,1005,Nail Polish,50,100,50,2,00419,India
862400,2023-12-22,1006,Blush,150,300,150,2,00419,India
862400,2023-12-22,1012,Body Lotion,200,400,200,2,00419,India
744538,2023-12-22,1012,Body Lotion,200,400,200,2,00039,India
744538,2023-12-22,1004,Eyeliner,100,200,100,2,00039,India
115060,2023-12-22,1007,Eyeshadow,200,400,200,2,00246,India
115060,2023-12-22,1003,Foundation,300,600,300,2,00246,India
115060,2023-12-22,1006,Blush,150,300,150,2,00246,India
696842,2023-12-22,1009,Moisturizer,250,500,250,2,00140,India
696842,2023-12-22,1003,Foundation,300,600,300,2,00140,India
696842,2023-12-22,1001,Lipstick,150,300,150,2,00140,India
696842,2023-12-22,1007,Eyeshadow,200,400,200,2,00140,India
318066,2023-12-22,1008,Makeup Remover,80,160,80,2,00367,India
318066,2023-12-22,1005,Nail Polish,50,100,50,2,00367,India
207586,2023-12-22,1008,Makeup Remover,80,160,80,2,00012,India
891876,2023-12-22,1003,Foundation,300,600,300,2,00407,India
891876,2023-12-22,1005,Nail Polish,50,100,50,2,00407,India
850434,2023-12-22,1005,Nail Polish,50,100,50,2,00067,India
621557,2023-12-22,1008,Makeup Remover,80,160,80,2,00482,India
853924,2023-12-22,1007,Eyeshadow,200,400,200,2,00414,India
853924,2023-12-22,1003,Foundation,300,600,300,2,00414,India
203344,2023-12-22,1008,Makeup Remover,80,160,80,2,00369,India
203344,2023-12-22,1006,Blush,150,300,150,2,00369,India
203344,2023-12-22,1001,Lipstick,150,300,150,2,00369,India
769557,2023-12-22,1002,Mascara,200,400,200,2,00050,India
769557,2023-12-22,1004,Eyeliner,100,200,100,2,00050,India
653235,2023-12-22,1009,Moisturizer,250,500,250,2,00310,India
653235,2023-12-22,1002,Mascara,200,400,200,2,00310,India
653235,2023-12-22,1012,Body Lotion,200,400,200,2,00310,India
198731,2023-12-22,1012,Body Lotion,200,400,200,2,00307,India
198731,2023-12-22,1002,Mascara,200,400,200,2,00307,India
198731,2023-12-22,1004,Eyeliner,100,200,100,2,00307,India
198731,2023-12-22,1003,Foundation,300,600,300,2,00307,India
753370,2023-12-22,1007,Eyeshadow,200,400,200,2,00064,India
508099,2023-12-22,1008,Makeup Remover,80,160,80,2,00277,India
508099,2023-12-22,1003,Foundation,300,600,300,2,00277,India
508099,2023-12-22,1005,Nail Polish,50,100,50,2,00277,India
122891,2023-12-22,1008,Makeup Remover,80,160,80,2,00182,India
122891,2023-12-22,1009,Moisturizer,250,500,250,2,00182,India
122891,2023-12-22,1003,Foundation,300,600,300,2,00182,India
812400,2023-12-22,1007,Eyeshadow,200,400,200,2,00168,India
769105,2023-12-22,1012,Body Lotion,200,400,200,2,00165,India
769105,2023-12-22,1007,Eyeshadow,200,400,200,2,00165,India
769105,2023-12-22,1004,Eyeliner,100,200,100,2,00165,India
769105,2023-12-22,1005,Nail Polish,50,100,50,2,00165,India
341055,2023-12-22,1004,Eyeliner,100,200,100,2,00388,India
341055,2023-12-22,1009,Moisturizer,250,500,250,2,00388,India
341055,2023-12-22,1005,Nail Polish,50,100,50,2,00388,India
341055,2023-12-22,1002,Mascara,200,400,200,2,00388,India
238962,2023-12-22,1007,Eyeshadow,200,400,200,2,00165,India
238962,2023-12-22,1005,Nail Polish,50,100,50,2,00165,India
238962,2023-12-22,1009,Moisturizer,250,500,250,2,00165,India
113625,2023-12-22,1002,Mascara,200,400,200,2,00122,India
113625,2023-12-22,1003,Foundation,300,600,300,2,00122,India
113625,2023-12-22,1004,Eyeliner,100,200,100,2,00122,India
726283,2023-12-22,1003,Foundation,300,600,300,2,00288,India
726283,2023-12-22,1002,Mascara,200,400,200,2,00288,India
726283,2023-12-22,1004,Eyeliner,100,200,100,2,00288,India
726283,2023-12-22,1007,Eyeshadow,200,400,200,2,00288,India
433392,2023-12-22,1002,Mascara,200,400,200,2,00458,India
433392,2023-12-22,1003,Foundation,300,600,300,2,00458,India
433392,2023-12-22,1009,Moisturizer,250,500,250,2,00458,India
733779,2023-12-22,1005,Nail Polish,50,100,50,2,00104,India
733779,2023-12-22,1007,Eyeshadow,200,400,200,2,00104,India
733779,2023-12-22,1008,Makeup Remover,80,160,80,2,00104,India
594125,2023-12-22,1002,Mascara,200,400,200,2,00218,India
594125,2023-12-22,1009,Moisturizer,250,500,250,2,00218,India
720586,2023-12-22,1002,Mascara,200,400,200,2,00069,India
720586,2023-12-22,1009,Moisturizer,250,500,250,2,00069,India
720586,2023-12-22,1001,Lipstick,150,300,150,2,00069,India
720586,2023-12-22,1004,Eyeliner,100,200,100,2,00069,India
342410,2023-12-22,1009,Moisturizer,250,500,250,2,00434,India
420151,2023-12-22,1009,Moisturizer,250,500,250,2,00271,India
508373,2023-12-22,1002,Mascara,200,400,200,2,00418,India
508373,2023-12-22,1007,Eyeshadow,200,400,200,2,00418,India
508373,2023-12-22,1009,Moisturizer,250,500,250,2,00418,India
508373,2023-12-22,1012,Body Lotion,200,400,200,2,00418,India
283509,2023-12-22,1012,Body Lotion,200,400,200,2,00029,India
283509,2023-12-22,1008,Makeup Remover,80,160,80,2,00029,India
283509,2023-12-22,1006,Blush,150,300,150,2,00029,India
724571,2023-12-22,1001,Lipstick,150,300,150,2,00167,India
724571,2023-12-22,1004,Eyeliner,100,200,100,2,00167,India
724571,2023-12-22,1008,Makeup Remover,80,160,80,2,00167,India
950475,2023-12-22,1009,Moisturizer,250,500,250,2,00134,India
950475,2023-12-22,1001,Lipstick,150,300,150,2,00134,India
950475,2023-12-22,1005,Nail Polish,50,100,50,2,00134,India
950475,2023-12-22,1012,Body Lotion,200,400,200,2,00134,India
723943,2023-12-22,1009,Moisturizer,250,500,250,2,00388,India
797894,2023-12-22,1012,Body Lotion,200,400,200,2,00284,India
424307,2023-12-22,1001,Lipstick,150,300,150,2,00386,India
424307,2023-12-22,1012,Body Lotion,200,400,200,2,00386,India
424307,2023-12-22,1006,Blush,150,300,150,2,00386,India
424307,2023-12-22,1009,Moisturizer,250,500,250,2,00386,India
424307,2023-12-22,1004,Eyeliner,100,200,100,2,00386,India
590309,2023-12-22,1009,Moisturizer,250,500,250,2,00371,India
590309,2023-12-22,1004,Eyeliner,100,200,100,2,00371,India
590309,2023-12-22,1006,Blush,150,300,150,2,00371,India
302979,2023-12-22,1002,Mascara,200,400,200,2,00043,India
302979,2023-12-22,1004,Eyeliner,100,200,100,2,00043,India
476304,2023-12-22,1006,Blush,150,300,150,2,00276,India
355345,2023-12-22,1001,Lipstick,150,300,150,2,00364,India
355345,2023-12-22,1012,Body Lotion,200,400,200,2,00364,India
645364,2023-12-22,1004,Eyeliner,100,200,100,2,00335,India
645364,2023-12-22,1012,Body Lotion,200,400,200,2,00335,India
645364,2023-12-22,1001,Lipstick,150,300,150,2,00335,India
645364,2023-12-22,1002,Mascara,200,400,200,2,00335,India
810879,2023-12-22,1002,Mascara,200,400,200,2,00275,India
810879,2023-12-22,1003,Foundation,300,600,300,2,00275,India
810879,2023-12-22,1004,Eyeliner,100,200,100,2,00275,India
810879,2023-12-22,1006,Blush,150,300,150,2,00275,India
840626,2023-12-22,1003,Foundation,300,600,300,2,00058,India
840626,2023-12-22,1005,Nail Polish,50,100,50,2,00058,India
840626,2023-12-22,1012,Body Lotion,200,400,200,2,00058,India
840626,2023-12-22,1009,Moisturizer,250,500,250,2,00058,India
908916,2023-12-22,1004,Eyeliner,100,200,100,2,00167,India
908916,2023-12-22,1001,Lipstick,150,300,150,2,00167,India
908916,2023-12-22,1003,Foundation,300,600,300,2,00167,India
940671,2023-12-22,1004,Eyeliner,100,200,100,2,00354,India
940671,2023-12-22,1006,Blush,150,300,150,2,00354,India
291026,2023-12-22,1003,Foundation,300,600,300,2,00252,India
291026,2023-12-22,1001,Lipstick,150,300,150,2,00252,India
291026,2023-12-22,1009,Moisturizer,250,500,250,2,00252,India
145368,2023-12-22,1009,Moisturizer,250,500,250,2,00153,India
355374,2023-12-22,1002,Mascara,200,400,200,2,00296,India
355374,2023-12-22,1003,Foundation,300,600,300,2,00296,India
257996,2023-12-23,1012,Body Lotion,200,400,200,2,00062,India
257996,2023-12-23,1003,Foundation,300,600,300,2,00062,India
257996,2023-12-23,1008,Makeup Remover,80,160,80,2,00062,India
870878,2023-12-23,1012,Body Lotion,200,400,200,2,00301,India
599831,2023-12-23,1001,Lipstick,150,300,150,2,00362,India
599831,2023-12-23,1007,Eyeshadow,200,400,200,2,00362,India
599831,2023-12-23,1003,Foundation,300,600,300,2,00362,India
599831,2023-12-23,1006,Blush,150,300,150,2,00362,India
821317,2023-12-23,1012,Body Lotion,200,400,200,2,00293,India
821317,2023-12-23,1004,Eyeliner,100,200,100,2,00293,India
997320,2023-12-23,1002,Mascara,200,400,200,2,00316,India
921508,2023-12-23,1003,Foundation,300,600,300,2,00377,India
910371,2023-12-23,1002,Mascara,200,400,200,2,00108,India
910371,2023-12-23,1001,Lipstick,150,300,150,2,00108,India
910371,2023-12-23,1006,Blush,150,300,150,2,00108,India
910371,2023-12-23,1012,Body Lotion,200,400,200,2,00108,India
463669,2023-12-23,1004,Eyeliner,100,200,100,2,00229,India
463669,2023-12-23,1009,Moisturizer,250,500,250,2,00229,India
463669,2023-12-23,1002,Mascara,200,400,200,2,00229,India
311698,2023-12-23,1004,Eyeliner,100,200,100,2,00473,India
311698,2023-12-23,1007,Eyeshadow,200,400,200,2,00473,India
948096,2023-12-23,1005,Nail Polish,50,100,50,2,00442,India
948096,2023-12-23,1003,Foundation,300,600,300,2,00442,India
948096,2023-12-23,1002,Mascara,200,400,200,2,00442,India
948096,2023-12-23,1009,Moisturizer,250,500,250,2,00442,India
347552,2023-12-23,1009,Moisturizer,250,500,250,2,00221,India
347552,2023-12-23,1001,Lipstick,150,300,150,2,00221,India
347552,2023-12-23,1007,Eyeshadow,200,400,200,2,00221,India
347552,2023-12-23,1005,Nail Polish,50,100,50,2,00221,India
347552,2023-12-23,1003,Foundation,300,600,300,2,00221,India
183967,2023-12-23,1001,Lipstick,150,300,150,2,00148,India
931382,2023-12-23,1009,Moisturizer,250,500,250,2,00158,India
931382,2023-12-23,1006,Blush,150,300,150,2,00158,India
931382,2023-12-23,1007,Eyeshadow,200,400,200,2,00158,India
931382,2023-12-23,1008,Makeup Remover,80,160,80,2,00158,India
378812,2023-12-23,1012,Body Lotion,200,400,200,2,00324,India
378812,2023-12-23,1003,Foundation,300,600,300,2,00324,India
277520,2023-12-23,1009,Moisturizer,250,500,250,2,00256,India
277520,2023-12-23,1004,Eyeliner,100,200,100,2,00256,India
277520,2023-12-23,1007,Eyeshadow,200,400,200,2,00256,India
153278,2023-12-23,1009,Moisturizer,250,500,250,2,00279,India
153278,2023-12-23,1005,Nail Polish,50,100,50,2,00279,India
153278,2023-12-23,1007,Eyeshadow,200,400,200,2,00279,India
153278,2023-12-23,1003,Foundation,300,600,300,2,00279,India
536894,2023-12-23,1012,Body Lotion,200,400,200,2,00149,India
536894,2023-12-23,1009,Moisturizer,250,500,250,2,00149,India
536894,2023-12-23,1003,Foundation,300,600,300,2,00149,India
887120,2023-12-23,1009,Moisturizer,250,500,250,2,00389,India
887120,2023-12-23,1003,Foundation,300,600,300,2,00389,India
887120,2023-12-23,1007,Eyeshadow,200,400,200,2,00389,India
423761,2023-12-23,1006,Blush,150,300,150,2,00325,India
423761,2023-12-23,1005,Nail Polish,50,100,50,2,00325,India
407353,2023-12-23,1001,Lipstick,150,300,150,2,00214,India
407353,2023-12-23,1008,Makeup Remover,80,160,80,2,00214,India
407353,2023-12-23,1003,Foundation,300,600,300,2,00214,India
113422,2023-12-23,1005,Nail Polish,50,100,50,2,00217,India
155937,2023-12-23,1003,Foundation,300,600,300,2,00494,India
155937,2023-12-23,1009,Moisturizer,250,500,250,2,00494,India
155937,2023-12-23,1006,Blush,150,300,150,2,00494,India
604930,2023-12-23,1004,Eyeliner,100,200,100,2,00446,India
604930,2023-12-23,1012,Body Lotion,200,400,200,2,00446,India
604930,2023-12-23,1005,Nail Polish,50,100,50,2,00446,India
604930,2023-12-23,1008,Makeup Remover,80,160,80,2,00446,India
604930,2023-12-23,1002,Mascara,200,400,200,2,00446,India
867539,2023-12-23,1002,Mascara,200,400,200,2,00149,India
867539,2023-12-23,1009,Moisturizer,250,500,250,2,00149,India
867539,2023-12-23,1006,Blush,150,300,150,2,00149,India
881532,2023-12-23,1005,Nail Polish,50,100,50,2,00278,India
572283,2023-12-23,1002,Mascara,200,400,200,2,00309,India
532048,2023-12-23,1005,Nail Polish,50,100,50,2,00460,India
532048,2023-12-23,1006,Blush,150,300,150,2,00460,India
532048,2023-12-23,1009,Moisturizer,250,500,250,2,00460,India
532048,2023-12-23,1007,Eyeshadow,200,400,200,2,00460,India
215054,2023-12-23,1012,Body Lotion,200,400,200,2,00033,India
215054,2023-12-23,1004,Eyeliner,100,200,100,2,00033,India
215054,2023-12-23,1007,Eyeshadow,200,400,200,2,00033,India
823821,2023-12-23,1005,Nail Polish,50,100,50,2,00236,India
823821,2023-12-23,1006,Blush,150,300,150,2,00236,India
823821,2023-12-23,1007,Eyeshadow,200,400,200,2,00236,India
823821,2023-12-23,1012,Body Lotion,200,400,200,2,00236,India
399742,2023-12-23,1001,Lipstick,150,300,150,2,00475,India
399742,2023-12-23,1005,Nail Polish,50,100,50,2,00475,India
552191,2023-12-23,1004,Eyeliner,100,200,100,2,00458,India
552191,2023-12-23,1002,Mascara,200,400,200,2,00458,India
552191,2023-12-23,1009,Moisturizer,250,500,250,2,00458,India
552191,2023-12-23,1001,Lipstick,150,300,150,2,00458,India
861332,2023-12-23,1001,Lipstick,150,300,150,2,00228,India
504924,2023-12-23,1005,Nail Polish,50,100,50,2,00019,India
504924,2023-12-23,1003,Foundation,300,600,300,2,00019,India
757930,2023-12-23,1002,Mascara,200,400,200,2,00391,India
757930,2023-12-23,1006,Blush,150,300,150,2,00391,India
398142,2023-12-23,1012,Body Lotion,200,400,200,2,00235,India
398142,2023-12-23,1001,Lipstick,150,300,150,2,00235,India
398142,2023-12-23,1008,Makeup Remover,80,160,80,2,00235,India
398142,2023-12-23,1009,Moisturizer,250,500,250,2,00235,India
553074,2023-12-23,1008,Makeup Remover,80,160,80,2,00258,India
745792,2023-12-23,1003,Foundation,300,600,300,2,00077,India
745792,2023-12-23,1007,Eyeshadow,200,400,200,2,00077,India
210090,2023-12-23,1009,Moisturizer,250,500,250,2,00216,India
126740,2023-12-23,1004,Eyeliner,100,200,100,2,00484,India
126740,2023-12-23,1003,Foundation,300,600,300,2,00484,India
300118,2023-12-23,1001,Lipstick,150,300,150,2,00359,India
300118,2023-12-23,1002,Mascara,200,400,200,2,00359,India
781455,2023-12-23,1005,Nail Polish,50,100,50,2,00498,India
781455,2023-12-23,1007,Eyeshadow,200,400,200,2,00498,India
593543,2023-12-23,1002,Mascara,200,400,200,2,00099,India
593543,2023-12-23,1001,Lipstick,150,300,150,2,00099,India
475758,2023-12-23,1007,Eyeshadow,200,400,200,2,00432,India
475758,2023-12-23,1004,Eyeliner,100,200,100,2,00432,India
445199,2023-12-23,1002,Mascara,200,400,200,2,00318,India
642197,2023-12-23,1012,Body Lotion,200,400,200,2,00462,India
642197,2023-12-23,1006,Blush,150,300,150,2,00462,India
927098,2023-12-24,1009,Moisturizer,250,500,250,2,00054,India
586386,2023-12-24,1006,Blush,150,300,150,2,00332,India
586386,2023-12-24,1007,Eyeshadow,200,400,200,2,00332,India
586386,2023-12-24,1001,Lipstick,150,300,150,2,00332,India
887817,2023-12-24,1001,Lipstick,150,300,150,2,00421,India
887817,2023-12-24,1007,Eyeshadow,200,400,200,2,00421,India
887817,2023-12-24,1006,Blush,150,300,150,2,00421,India
887817,2023-12-24,1004,Eyeliner,100,200,100,2,00421,India
974374,2023-12-24,1005,Nail Polish,50,100,50,2,00362,India
974374,2023-12-24,1001,Lipstick,150,300,150,2,00362,India
974374,2023-12-24,1002,Mascara,200,400,200,2,00362,India
242116,2023-12-24,1002,Mascara,200,400,200,2,00318,India
242116,2023-12-24,1001,Lipstick,150,300,150,2,00318,India
777936,2023-12-24,1005,Nail Polish,50,100,50,2,00463,India
777936,2023-12-24,1001,Lipstick,150,300,150,2,00463,India
777936,2023-12-24,1003,Foundation,300,600,300,2,00463,India
777936,2023-12-24,1009,Moisturizer,250,500,250,2,00463,India
864847,2023-12-24,1008,Makeup Remover,80,160,80,2,00207,India
864847,2023-12-24,1004,Eyeliner,100,200,100,2,00207,India
565343,2023-12-24,1005,Nail Polish,50,100,50,2,00056,India
671872,2023-12-24,1003,Foundation,300,600,300,2,00334,India
671872,2023-12-24,1005,Nail Polish,50,100,50,2,00334,India
353877,2023-12-24,1003,Foundation,300,600,300,2,00309,India
353877,2023-12-24,1012,Body Lotion,200,400,200,2,00309,India
330767,2023-12-24,1004,Eyeliner,100,200,100,2,00490,India
330767,2023-12-24,1006,Blush,150,300,150,2,00490,India
330767,2023-12-24,1003,Foundation,300,600,300,2,00490,India
857564,2023-12-24,1012,Body Lotion,200,400,200,2,00154,India
294036,2023-12-24,1004,Eyeliner,100,200,100,2,00066,India
294036,2023-12-24,1007,Eyeshadow,200,400,200,2,00066,India
180186,2023-12-24,1005,Nail Polish,50,100,50,2,00231,India
284868,2023-12-24,1007,Eyeshadow,200,400,200,2,00332,India
803021,2023-12-24,1012,Body Lotion,200,400,200,2,00229,India
803021,2023-12-24,1001,Lipstick,150,300,150,2,00229,India
926293,2023-12-24,1005,Nail Polish,50,100,50,2,00095,India
926293,2023-12-24,1007,Eyeshadow,200,400,200,2,00095,India
926293,2023-12-24,1002,Mascara,200,400,200,2,00095,India
576735,2023-12-24,1008,Makeup Remover,80,160,80,2,00051,India
703617,2023-12-24,1001,Lipstick,150,300,150,2,00460,India
703617,2023-12-24,1007,Eyeshadow,200,400,200,2,00460,India
848795,2023-12-24,1008,Makeup Remover,80,160,80,2,00179,India
848795,2023-12-24,1005,Nail Polish,50,100,50,2,00179,India
848795,2023-12-24,1001,Lipstick,150,300,150,2,00179,India
848795,2023-12-24,1002,Mascara,200,400,200,2,00179,India
591129,2023-12-24,1007,Eyeshadow,200,400,200,2,00455,India
591129,2023-12-24,1006,Blush,150,300,150,2,00455,India
591129,2023-12-24,1008,Makeup Remover,80,160,80,2,00455,India
480672,2023-12-24,1003,Foundation,300,600,300,2,00154,India
566030,2023-12-24,1006,Blush,150,300,150,2,00251,India
799427,2023-12-24,1007,Eyeshadow,200,400,200,2,00468,India
799427,2023-12-24,1012,Body Lotion,200,400,200,2,00468,India
799427,2023-12-24,1006,Blush,150,300,150,2,00468,India
799427,2023-12-24,1001,Lipstick,150,300,150,2,00468,India
659405,2023-12-24,1002,Mascara,200,400,200,2,00194,India
659405,2023-12-24,1003,Foundation,300,600,300,2,00194,India
291800,2023-12-24,1007,Eyeshadow,200,400,200,2,00309,India
291800,2023-12-24,1001,Lipstick,150,300,150,2,00309,India
291800,2023-12-24,1005,Nail Polish,50,100,50,2,00309,India
403142,2023-12-24,1012,Body Lotion,200,400,200,2,00261,India
403142,2023-12-24,1007,Eyeshadow,200,400,200,2,00261,India
347667,2023-12-24,1002,Mascara,200,400,200,2,00202,India
347667,2023-12-24,1008,Makeup Remover,80,160,80,2,00202,India
250333,2023-12-24,1005,Nail Polish,50,100,50,2,00461,India
250333,2023-12-24,1006,Blush,150,300,150,2,00461,India
250333,2023-12-24,1008,Makeup Remover,80,160,80,2,00461,India
250333,2023-12-24,1001,Lipstick,150,300,150,2,00461,India
250333,2023-12-24,1009,Moisturizer,250,500,250,2,00461,India
117700,2023-12-24,1005,Nail Polish,50,100,50,2,00236,India
117700,2023-12-24,1007,Eyeshadow,200,400,200,2,00236,India
245771,2023-12-25,1001,Lipstick,150,300,150,2,00274,India
245771,2023-12-25,1006,Blush,150,300,150,2,00274,India
245771,2023-12-25,1005,Nail Polish,50,100,50,2,00274,India
245771,2023-12-25,1003,Foundation,300,600,300,2,00274,India
245771,2023-12-25,1004,Eyeliner,100,200,100,2,00274,India
586319,2023-12-25,1007,Eyeshadow,200,400,200,2,00038,India
586319,2023-12-25,1005,Nail Polish,50,100,50,2,00038,India
586319,2023-12-25,1006,Blush,150,300,150,2,00038,India
586319,2023-12-25,1009,Moisturizer,250,500,250,2,00038,India
193724,2023-12-25,1005,Nail Polish,50,100,50,2,00427,India
193724,2023-12-25,1002,Mascara,200,400,200,2,00427,India
379718,2023-12-25,1009,Moisturizer,250,500,250,2,00288,India
555165,2023-12-25,1008,Makeup Remover,80,160,80,2,00331,India
555165,2023-12-25,1004,Eyeliner,100,200,100,2,00331,India
555165,2023-12-25,1009,Moisturizer,250,500,250,2,00331,India
816462,2023-12-25,1005,Nail Polish,50,100,50,2,00009,India
816462,2023-12-25,1012,Body Lotion,200,400,200,2,00009,India
816462,2023-12-25,1008,Makeup Remover,80,160,80,2,00009,India
558093,2023-12-25,1005,Nail Polish,50,100,50,2,00281,India
558093,2023-12-25,1007,Eyeshadow,200,400,200,2,00281,India
558093,2023-12-25,1004,Eyeliner,100,200,100,2,00281,India
614133,2023-12-25,1004,Eyeliner,100,200,100,2,00364,India
481885,2023-12-25,1003,Foundation,300,600,300,2,00231,India
481885,2023-12-25,1006,Blush,150,300,150,2,00231,India
481885,2023-12-25,1002,Mascara,200,400,200,2,00231,India
835651,2023-12-25,1009,Moisturizer,250,500,250,2,00096,India
835651,2023-12-25,1003,Foundation,300,600,300,2,00096,India
835651,2023-12-25,1005,Nail Polish,50,100,50,2,00096,India
376670,2023-12-25,1004,Eyeliner,100,200,100,2,00251,India
376670,2023-12-25,1007,Eyeshadow,200,400,200,2,00251,India
376670,2023-12-25,1009,Moisturizer,250,500,250,2,00251,India
376670,2023-12-25,1003,Foundation,300,600,300,2,00251,India
598792,2023-12-25,1012,Body Lotion,200,400,200,2,00346,India
598792,2023-12-25,1007,Eyeshadow,200,400,200,2,00346,India
598792,2023-12-25,1005,Nail Polish,50,100,50,2,00346,India
881261,2023-12-25,1008,Makeup Remover,80,160,80,2,00471,India
881261,2023-12-25,1004,Eyeliner,100,200,100,2,00471,India
881261,2023-12-25,1007,Eyeshadow,200,400,200,2,00471,India
881261,2023-12-25,1009,Moisturizer,250,500,250,2,00471,India
483140,2023-12-25,1001,Lipstick,150,300,150,2,00056,India
483140,2023-12-25,1003,Foundation,300,600,300,2,00056,India
483140,2023-12-25,1012,Body Lotion,200,400,200,2,00056,India
610441,2023-12-25,1007,Eyeshadow,200,400,200,2,00025,India
833858,2023-12-25,1005,Nail Polish,50,100,50,2,00316,India
224569,2023-12-25,1004,Eyeliner,100,200,100,2,00178,India
224569,2023-12-25,1006,Blush,150,300,150,2,00178,India
301687,2023-12-25,1002,Mascara,200,400,200,2,00399,India
301687,2023-12-25,1003,Foundation,300,600,300,2,00399,India
301687,2023-12-25,1012,Body Lotion,200,400,200,2,00399,India
202729,2023-12-25,1009,Moisturizer,250,500,250,2,00320,India
202729,2023-12-25,1006,Blush,150,300,150,2,00320,India
889721,2023-12-25,1001,Lipstick,150,300,150,2,00476,India
889721,2023-12-25,1007,Eyeshadow,200,400,200,2,00476,India
504373,2023-12-25,1007,Eyeshadow,200,400,200,2,00396,India
504373,2023-12-25,1009,Moisturizer,250,500,250,2,00396,India
423212,2023-12-25,1004,Eyeliner,100,200,100,2,00065,India
423212,2023-12-25,1002,Mascara,200,400,200,2,00065,India
423212,2023-12-25,1008,Makeup Remover,80,160,80,2,00065,India
113939,2023-12-25,1003,Foundation,300,600,300,2,00309,India
297574,2023-12-25,1007,Eyeshadow,200,400,200,2,00363,India
297574,2023-12-25,1012,Body Lotion,200,400,200,2,00363,India
297574,2023-12-25,1004,Eyeliner,100,200,100,2,00363,India
955878,2023-12-25,1008,Makeup Remover,80,160,80,2,00345,India
253742,2023-12-25,1007,Eyeshadow,200,400,200,2,00162,India
253742,2023-12-25,1002,Mascara,200,400,200,2,00162,India
253742,2023-12-25,1003,Foundation,300,600,300,2,00162,India
943301,2023-12-25,1004,Eyeliner,100,200,100,2,00494,India
943301,2023-12-25,1006,Blush,150,300,150,2,00494,India
127400,2023-12-25,1009,Moisturizer,250,500,250,2,00165,India
127400,2023-12-25,1012,Body Lotion,200,400,200,2,00165,India
127400,2023-12-25,1006,Blush,150,300,150,2,00165,India
349187,2023-12-25,1004,Eyeliner,100,200,100,2,00380,India
349187,2023-12-25,1005,Nail Polish,50,100,50,2,00380,India
349187,2023-12-25,1012,Body Lotion,200,400,200,2,00380,India
349187,2023-12-25,1006,Blush,150,300,150,2,00380,India
281505,2023-12-25,1001,Lipstick,150,300,150,2,00489,India
203210,2023-12-25,1006,Blush,150,300,150,2,00065,India
203210,2023-12-25,1004,Eyeliner,100,200,100,2,00065,India
203210,2023-12-25,1012,Body Lotion,200,400,200,2,00065,India
203210,2023-12-25,1007,Eyeshadow,200,400,200,2,00065,India
203210,2023-12-25,1001,Lipstick,150,300,150,2,00065,India
892073,2023-12-25,1008,Makeup Remover,80,160,80,2,00337,India
892073,2023-12-25,1006,Blush,150,300,150,2,00337,India
352063,2023-12-25,1006,Blush,150,300,150,2,00193,India
352063,2023-12-25,1005,Nail Polish,50,100,50,2,00193,India
352063,2023-12-25,1007,Eyeshadow,200,400,200,2,00193,India
352063,2023-12-25,1009,Moisturizer,250,500,250,2,00193,India
810766,2023-12-25,1005,Nail Polish,50,100,50,2,00432,India
810766,2023-12-25,1003,Foundation,300,600,300,2,00432,India
810766,2023-12-25,1004,Eyeliner,100,200,100,2,00432,India
322656,2023-12-25,1008,Makeup Remover,80,160,80,2,00371,India
391491,2023-12-25,1006,Blush,150,300,150,2,00052,India
391491,2023-12-25,1003,Foundation,300,600,300,2,00052,India
391491,2023-12-25,1012,Body Lotion,200,400,200,2,00052,India
391491,2023-12-25,1005,Nail Polish,50,100,50,2,00052,India
604147,2023-12-25,1004,Eyeliner,100,200,100,2,00111,India
475517,2023-12-25,1005,Nail Polish,50,100,50,2,00498,India
475517,2023-12-25,1009,Moisturizer,250,500,250,2,00498,India
475517,2023-12-25,1008,Makeup Remover,80,160,80,2,00498,India
475517,2023-12-25,1001,Lipstick,150,300,150,2,00498,India
510490,2023-12-25,1001,Lipstick,150,300,150,2,00306,India
530332,2023-12-25,1001,Lipstick,150,300,150,2,00245,India
329725,2023-12-25,1007,Eyeshadow,200,400,200,2,00467,India
329725,2023-12-25,1003,Foundation,300,600,300,2,00467,India
364947,2023-12-25,1003,Foundation,300,600,300,2,00298,India
364947,2023-12-25,1007,Eyeshadow,200,400,200,2,00298,India
364947,2023-12-25,1012,Body Lotion,200,400,200,2,00298,India
364947,2023-12-25,1004,Eyeliner,100,200,100,2,00298,India
596241,2023-12-25,1001,Lipstick,150,300,150,2,00406,India
656364,2023-12-25,1004,Eyeliner,100,200,100,2,00300,India
191973,2023-12-25,1012,Body Lotion,200,400,200,2,00358,India
191973,2023-12-25,1005,Nail Polish,50,100,50,2,00358,India
756010,2023-12-25,1003,Foundation,300,600,300,2,00356,India
158565,2023-12-25,1009,Moisturizer,250,500,250,2,00119,India
158565,2023-12-25,1001,Lipstick,150,300,150,2,00119,India
158565,2023-12-25,1006,Blush,150,300,150,2,00119,India
314938,2023-12-25,1005,Nail Polish,50,100,50,2,00385,India
314938,2023-12-25,1006,Blush,150,300,150,2,00385,India
314938,2023-12-25,1001,Lipstick,150,300,150,2,00385,India
364633,2023-12-25,1002,Mascara,200,400,200,2,00183,India
364633,2023-12-25,1004,Eyeliner,100,200,100,2,00183,India
364633,2023-12-25,1012,Body Lotion,200,400,200,2,00183,India
282560,2023-12-26,1001,Lipstick,150,300,150,2,00427,India
282560,2023-12-26,1008,Makeup Remover,80,160,80,2,00427,India
900108,2023-12-26,1002,Mascara,200,400,200,2,00131,India
900108,2023-12-26,1007,Eyeshadow,200,400,200,2,00131,India
900108,2023-12-26,1009,Moisturizer,250,500,250,2,00131,India
900108,2023-12-26,1008,Makeup Remover,80,160,80,2,00131,India
900108,2023-12-26,1005,Nail Polish,50,100,50,2,00131,India
292807,2023-12-26,1005,Nail Polish,50,100,50,2,00267,India
976584,2023-12-26,1007,Eyeshadow,200,400,200,2,00342,India
976584,2023-12-26,1003,Foundation,300,600,300,2,00342,India
653806,2023-12-26,1002,Mascara,200,400,200,2,00247,India
653806,2023-12-26,1006,Blush,150,300,150,2,00247,India
638168,2023-12-26,1006,Blush,150,300,150,2,00123,India
638168,2023-12-26,1012,Body Lotion,200,400,200,2,00123,India
315499,2023-12-26,1001,Lipstick,150,300,150,2,00069,India
370696,2023-12-26,1004,Eyeliner,100,200,100,2,00240,India
569104,2023-12-26,1003,Foundation,300,600,300,2,00215,India
569104,2023-12-26,1006,Blush,150,300,150,2,00215,India
569104,2023-12-26,1002,Mascara,200,400,200,2,00215,India
169702,2023-12-26,1003,Foundation,300,600,300,2,00454,India
169702,2023-12-26,1007,Eyeshadow,200,400,200,2,00454,India
256110,2023-12-26,1012,Body Lotion,200,400,200,2,00240,India
256110,2023-12-26,1003,Foundation,300,600,300,2,00240,India
256110,2023-12-26,1005,Nail Polish,50,100,50,2,00240,India
256110,2023-12-26,1008,Makeup Remover,80,160,80,2,00240,India
418934,2023-12-26,1012,Body Lotion,200,400,200,2,00116,India
418934,2023-12-26,1009,Moisturizer,250,500,250,2,00116,India
418934,2023-12-26,1004,Eyeliner,100,200,100,2,00116,India
418934,2023-12-26,1005,Nail Polish,50,100,50,2,00116,India
852081,2023-12-26,1008,Makeup Remover,80,160,80,2,00315,India
852081,2023-12-26,1004,Eyeliner,100,200,100,2,00315,India
852081,2023-12-26,1002,Mascara,200,400,200,2,00315,India
852081,2023-12-26,1001,Lipstick,150,300,150,2,00315,India
858240,2023-12-26,1002,Mascara,200,400,200,2,00467,India
858240,2023-12-26,1012,Body Lotion,200,400,200,2,00467,India
858240,2023-12-26,1001,Lipstick,150,300,150,2,00467,India
662070,2023-12-26,1007,Eyeshadow,200,400,200,2,00384,India
890587,2023-12-26,1008,Makeup Remover,80,160,80,2,00401,India
890587,2023-12-26,1012,Body Lotion,200,400,200,2,00401,India
890587,2023-12-26,1002,Mascara,200,400,200,2,00401,India
890587,2023-12-26,1004,Eyeliner,100,200,100,2,00401,India
799727,2023-12-26,1012,Body Lotion,200,400,200,2,00052,India
189142,2023-12-26,1002,Mascara,200,400,200,2,00184,India
189142,2023-12-26,1009,Moisturizer,250,500,250,2,00184,India
189142,2023-12-26,1001,Lipstick,150,300,150,2,00184,India
552761,2023-12-26,1003,Foundation,300,600,300,2,00296,India
552761,2023-12-26,1002,Mascara,200,400,200,2,00296,India
552761,2023-12-26,1004,Eyeliner,100,200,100,2,00296,India
360987,2023-12-26,1004,Eyeliner,100,200,100,2,00273,India
360987,2023-12-26,1002,Mascara,200,400,200,2,00273,India
180771,2023-12-26,1002,Mascara,200,400,200,2,00435,India
180771,2023-12-26,1009,Moisturizer,250,500,250,2,00435,India
619875,2023-12-26,1005,Nail Polish,50,100,50,2,00357,India
619875,2023-12-26,1006,Blush,150,300,150,2,00357,India
619875,2023-12-26,1004,Eyeliner,100,200,100,2,00357,India
619875,2023-12-26,1002,Mascara,200,400,200,2,00357,India
619875,2023-12-26,1008,Makeup Remover,80,160,80,2,00357,India
380244,2023-12-26,1012,Body Lotion,200,400,200,2,00471,India
380244,2023-12-26,1007,Eyeshadow,200,400,200,2,00471,India
380244,2023-12-26,1002,Mascara,200,400,200,2,00471,India
380244,2023-12-26,1001,Lipstick,150,300,150,2,00471,India
146889,2023-12-26,1004,Eyeliner,100,200,100,2,00141,India
146889,2023-12-26,1003,Foundation,300,600,300,2,00141,India
146889,2023-12-26,1009,Moisturizer,250,500,250,2,00141,India
168269,2023-12-26,1012,Body Lotion,200,400,200,2,00313,India
168269,2023-12-26,1009,Moisturizer,250,500,250,2,00313,India
168269,2023-12-26,1005,Nail Polish,50,100,50,2,00313,India
168269,2023-12-26,1007,Eyeshadow,200,400,200,2,00313,India
849430,2023-12-26,1003,Foundation,300,600,300,2,00498,India
849430,2023-12-26,1008,Makeup Remover,80,160,80,2,00498,India
863268,2023-12-26,1007,Eyeshadow,200,400,200,2,00417,India
863268,2023-12-26,1012,Body Lotion,200,400,200,2,00417,India
863268,2023-12-26,1009,Moisturizer,250,500,250,2,00417,India
863268,2023-12-26,1002,Mascara,200,400,200,2,00417,India
298494,2023-12-26,1007,Eyeshadow,200,400,200,2,00483,India
195895,2023-12-26,1009,Moisturizer,250,500,250,2,00385,India
195895,2023-12-26,1003,Foundation,300,600,300,2,00385,India
195895,2023-12-26,1012,Body Lotion,200,400,200,2,00385,India
195895,2023-12-26,1004,Eyeliner,100,200,100,2,00385,India
595600,2023-12-26,1007,Eyeshadow,200,400,200,2,00100,India
595600,2023-12-26,1012,Body Lotion,200,400,200,2,00100,India
595600,2023-12-26,1004,Eyeliner,100,200,100,2,00100,India
791007,2023-12-27,1006,Blush,150,300,150,2,00047,India
791007,2023-12-27,1001,Lipstick,150,300,150,2,00047,India
278177,2023-12-27,1004,Eyeliner,100,200,100,2,00490,India
278177,2023-12-27,1009,Moisturizer,250,500,250,2,00490,India
278177,2023-12-27,1003,Foundation,300,600,300,2,00490,India
278177,2023-12-27,1008,Makeup Remover,80,160,80,2,00490,India
278177,2023-12-27,1012,Body Lotion,200,400,200,2,00490,India
319405,2023-12-27,1006,Blush,150,300,150,2,00394,India
319405,2023-12-27,1005,Nail Polish,50,100,50,2,00394,India
319405,2023-12-27,1001,Lipstick,150,300,150,2,00394,India
319405,2023-12-27,1009,Moisturizer,250,500,250,2,00394,India
319405,2023-12-27,1007,Eyeshadow,200,400,200,2,00394,India
129352,2023-12-27,1002,Mascara,200,400,200,2,00280,India
915979,2023-12-27,1006,Blush,150,300,150,2,00009,India
915979,2023-12-27,1012,Body Lotion,200,400,200,2,00009,India
718984,2023-12-27,1008,Makeup Remover,80,160,80,2,00212,India
220607,2023-12-27,1004,Eyeliner,100,200,100,2,00167,India
220607,2023-12-27,1005,Nail Polish,50,100,50,2,00167,India
220607,2023-12-27,1008,Makeup Remover,80,160,80,2,00167,India
220607,2023-12-27,1006,Blush,150,300,150,2,00167,India
120294,2023-12-27,1007,Eyeshadow,200,400,200,2,00377,India
120294,2023-12-27,1003,Foundation,300,600,300,2,00377,India
384289,2023-12-27,1012,Body Lotion,200,400,200,2,00082,India
384289,2023-12-27,1008,Makeup Remover,80,160,80,2,00082,India
384289,2023-12-27,1005,Nail Polish,50,100,50,2,00082,India
391130,2023-12-27,1002,Mascara,200,400,200,2,00428,India
391130,2023-12-27,1009,Moisturizer,250,500,250,2,00428,India
391130,2023-12-27,1012,Body Lotion,200,400,200,2,00428,India
391130,2023-12-27,1001,Lipstick,150,300,150,2,00428,India
641057,2023-12-27,1006,Blush,150,300,150,2,00125,India
641057,2023-12-27,1004,Eyeliner,100,200,100,2,00125,India
641057,2023-12-27,1009,Moisturizer,250,500,250,2,00125,India
883122,2023-12-27,1003,Foundation,300,600,300,2,00477,India
153110,2023-12-27,1001,Lipstick,150,300,150,2,00439,India
153110,2023-12-27,1007,Eyeshadow,200,400,200,2,00439,India
153110,2023-12-27,1004,Eyeliner,100,200,100,2,00439,India
153110,2023-12-27,1008,Makeup Remover,80,160,80,2,00439,India
153110,2023-12-27,1006,Blush,150,300,150,2,00439,India
158898,2023-12-27,1006,Blush,150,300,150,2,00453,India
305075,2023-12-27,1008,Makeup Remover,80,160,80,2,00318,India
305075,2023-12-27,1004,Eyeliner,100,200,100,2,00318,India
785384,2023-12-27,1007,Eyeshadow,200,400,200,2,00018,India
785384,2023-12-27,1002,Mascara,200,400,200,2,00018,India
785384,2023-12-27,1008,Makeup Remover,80,160,80,2,00018,India
601585,2023-12-27,1005,Nail Polish,50,100,50,2,00194,India
601585,2023-12-27,1003,Foundation,300,600,300,2,00194,India
601585,2023-12-27,1002,Mascara,200,400,200,2,00194,India
405455,2023-12-27,1006,Blush,150,300,150,2,00151,India
662827,2023-12-27,1007,Eyeshadow,200,400,200,2,00407,India
662827,2023-12-27,1005,Nail Polish,50,100,50,2,00407,India
662827,2023-12-27,1006,Blush,150,300,150,2,00407,India
917502,2023-12-27,1012,Body Lotion,200,400,200,2,00187,India
917502,2023-12-27,1008,Makeup Remover,80,160,80,2,00187,India
917502,2023-12-27,1001,Lipstick,150,300,150,2,00187,India
308296,2023-12-27,1012,Body Lotion,200,400,200,2,00329,India
308296,2023-12-27,1006,Blush,150,300,150,2,00329,India
308296,2023-12-27,1002,Mascara,200,400,200,2,00329,India
670050,2023-12-27,1002,Mascara,200,400,200,2,00421,India
670050,2023-12-27,1012,Body Lotion,200,400,200,2,00421,India
670050,2023-12-27,1008,Makeup Remover,80,160,80,2,00421,India
670050,2023-12-27,1003,Foundation,300,600,300,2,00421,India
670050,2023-12-27,1001,Lipstick,150,300,150,2,00421,India
668480,2023-12-27,1007,Eyeshadow,200,400,200,2,00433,India
668480,2023-12-27,1003,Foundation,300,600,300,2,00433,India
318239,2023-12-27,1009,Moisturizer,250,500,250,2,00147,India
318239,2023-12-27,1001,Lipstick,150,300,150,2,00147,India
318239,2023-12-27,1003,Foundation,300,600,300,2,00147,India
383220,2023-12-27,1008,Makeup Remover,80,160,80,2,00231,India
383220,2023-12-27,1006,Blush,150,300,150,2,00231,India
383220,2023-12-27,1007,Eyeshadow,200,400,200,2,00231,India
986996,2023-12-27,1012,Body Lotion,200,400,200,2,00261,India
986996,2023-12-27,1004,Eyeliner,100,200,100,2,00261,India
986996,2023-12-27,1008,Makeup Remover,80,160,80,2,00261,India
986996,2023-12-27,1006,Blush,150,300,150,2,00261,India
986996,2023-12-27,1003,Foundation,300,600,300,2,00261,India
335496,2023-12-27,1005,Nail Polish,50,100,50,2,00409,India
985450,2023-12-27,1008,Makeup Remover,80,160,80,2,00440,India
985450,2023-12-27,1002,Mascara,200,400,200,2,00440,India
985450,2023-12-27,1006,Blush,150,300,150,2,00440,India
864153,2023-12-27,1002,Mascara,200,400,200,2,00489,India
864153,2023-12-27,1007,Eyeshadow,200,400,200,2,00489,India
864153,2023-12-27,1008,Makeup Remover,80,160,80,2,00489,India
864153,2023-12-27,1006,Blush,150,300,150,2,00489,India
937687,2023-12-27,1001,Lipstick,150,300,150,2,00152,India
120334,2023-12-27,1005,Nail Polish,50,100,50,2,00445,India
181438,2023-12-27,1009,Moisturizer,250,500,250,2,00167,India
181438,2023-12-27,1005,Nail Polish,50,100,50,2,00167,India
181438,2023-12-27,1008,Makeup Remover,80,160,80,2,00167,India
181438,2023-12-27,1012,Body Lotion,200,400,200,2,00167,India
870604,2023-12-27,1009,Moisturizer,250,500,250,2,00216,India
870604,2023-12-27,1003,Foundation,300,600,300,2,00216,India
870604,2023-12-27,1002,Mascara,200,400,200,2,00216,India
870604,2023-12-27,1001,Lipstick,150,300,150,2,00216,India
448824,2023-12-27,1001,Lipstick,150,300,150,2,00392,India
448824,2023-12-27,1009,Moisturizer,250,500,250,2,00392,India
448824,2023-12-27,1006,Blush,150,300,150,2,00392,India
513750,2023-12-28,1007,Eyeshadow,200,400,200,2,00306,India
513750,2023-12-28,1009,Moisturizer,250,500,250,2,00306,India
513750,2023-12-28,1002,Mascara,200,400,200,2,00306,India
513750,2023-12-28,1003,Foundation,300,600,300,2,00306,India
715707,2023-12-28,1001,Lipstick,150,300,150,2,00374,India
715707,2023-12-28,1002,Mascara,200,400,200,2,00374,India
715707,2023-12-28,1008,Makeup Remover,80,160,80,2,00374,India
715707,2023-12-28,1012,Body Lotion,200,400,200,2,00374,India
715707,2023-12-28,1009,Moisturizer,250,500,250,2,00374,India
562399,2023-12-28,1005,Nail Polish,50,100,50,2,00416,India
758960,2023-12-28,1001,Lipstick,150,300,150,2,00007,India
758960,2023-12-28,1003,Foundation,300,600,300,2,00007,India
758960,2023-12-28,1004,Eyeliner,100,200,100,2,00007,India
758960,2023-12-28,1005,Nail Polish,50,100,50,2,00007,India
510546,2023-12-28,1008,Makeup Remover,80,160,80,2,00434,India
510546,2023-12-28,1003,Foundation,300,600,300,2,00434,India
510546,2023-12-28,1012,Body Lotion,200,400,200,2,00434,India
680861,2023-12-28,1005,Nail Polish,50,100,50,2,00402,India
567695,2023-12-28,1007,Eyeshadow,200,400,200,2,00005,India
567695,2023-12-28,1004,Eyeliner,100,200,100,2,00005,India
188371,2023-12-28,1007,Eyeshadow,200,400,200,2,00204,India
188371,2023-12-28,1001,Lipstick,150,300,150,2,00204,India
514219,2023-12-28,1006,Blush,150,300,150,2,00071,India
514219,2023-12-28,1004,Eyeliner,100,200,100,2,00071,India
523174,2023-12-28,1006,Blush,150,300,150,2,00052,India
958130,2023-12-28,1006,Blush,150,300,150,2,00212,India
958130,2023-12-28,1003,Foundation,300,600,300,2,00212,India
847271,2023-12-28,1009,Moisturizer,250,500,250,2,00077,India
898022,2023-12-28,1009,Moisturizer,250,500,250,2,00465,India
898022,2023-12-28,1012,Body Lotion,200,400,200,2,00465,India
898022,2023-12-28,1008,Makeup Remover,80,160,80,2,00465,India
898022,2023-12-28,1003,Foundation,300,600,300,2,00465,India
271470,2023-12-28,1009,Moisturizer,250,500,250,2,00423,India
271470,2023-12-28,1001,Lipstick,150,300,150,2,00423,India
396923,2023-12-28,1012,Body Lotion,200,400,200,2,00075,India
396923,2023-12-28,1001,Lipstick,150,300,150,2,00075,India
675217,2023-12-28,1003,Foundation,300,600,300,2,00120,India
594893,2023-12-28,1012,Body Lotion,200,400,200,2,00491,India
608318,2023-12-28,1007,Eyeshadow,200,400,200,2,00292,India
608318,2023-12-28,1001,Lipstick,150,300,150,2,00292,India
676453,2023-12-28,1005,Nail Polish,50,100,50,2,00195,India
676453,2023-12-28,1006,Blush,150,300,150,2,00195,India
676453,2023-12-28,1012,Body Lotion,200,400,200,2,00195,India
676453,2023-12-28,1007,Eyeshadow,200,400,200,2,00195,India
676453,2023-12-28,1008,Makeup Remover,80,160,80,2,00195,India
292728,2023-12-28,1007,Eyeshadow,200,400,200,2,00077,India
292728,2023-12-28,1004,Eyeliner,100,200,100,2,00077,India
292728,2023-12-28,1012,Body Lotion,200,400,200,2,00077,India
185185,2023-12-28,1006,Blush,150,300,150,2,00140,India
185185,2023-12-28,1005,Nail Polish,50,100,50,2,00140,India
185185,2023-12-28,1004,Eyeliner,100,200,100,2,00140,India
341517,2023-12-28,1002,Mascara,200,400,200,2,00247,India
341517,2023-12-28,1006,Blush,150,300,150,2,00247,India
341517,2023-12-28,1001,Lipstick,150,300,150,2,00247,India
806990,2023-12-28,1002,Mascara,200,400,200,2,00103,India
806990,2023-12-28,1003,Foundation,300,600,300,2,00103,India
692247,2023-12-28,1005,Nail Polish,50,100,50,2,00270,India
692247,2023-12-28,1003,Foundation,300,600,300,2,00270,India
692247,2023-12-28,1008,Makeup Remover,80,160,80,2,00270,India
547839,2023-12-28,1001,Lipstick,150,300,150,2,00460,India
547839,2023-12-28,1002,Mascara,200,400,200,2,00460,India
547839,2023-12-28,1007,Eyeshadow,200,400,200,2,00460,India
100993,2023-12-28,1006,Blush,150,300,150,2,00457,India
250457,2023-12-28,1012,Body Lotion,200,400,200,2,00200,India
495695,2023-12-28,1009,Moisturizer,250,500,250,2,00005,India
495695,2023-12-28,1007,Eyeshadow,200,400,200,2,00005,India
495695,2023-12-28,1003,Foundation,300,600,300,2,00005,India
374167,2023-12-28,1001,Lipstick,150,300,150,2,00007,India
374167,2023-12-28,1012,Body Lotion,200,400,200,2,00007,India
374167,2023-12-28,1007,Eyeshadow,200,400,200,2,00007,India
374167,2023-12-28,1004,Eyeliner,100,200,100,2,00007,India
374167,2023-12-28,1009,Moisturizer,250,500,250,2,00007,India
295416,2023-12-28,1007,Eyeshadow,200,400,200,2,00388,India
234045,2023-12-28,1008,Makeup Remover,80,160,80,2,00131,India
234045,2023-12-28,1007,Eyeshadow,200,400,200,2,00131,India
234045,2023-12-28,1012,Body Lotion,200,400,200,2,00131,India
234045,2023-12-28,1004,Eyeliner,100,200,100,2,00131,India
566113,2023-12-28,1003,Foundation,300,600,300,2,00174,India
566113,2023-12-28,1008,Makeup Remover,80,160,80,2,00174,India
566113,2023-12-28,1007,Eyeshadow,200,400,200,2,00174,India
569183,2023-12-28,1003,Foundation,300,600,300,2,00213,India
569183,2023-12-28,1007,Eyeshadow,200,400,200,2,00213,India
808856,2023-12-28,1007,Eyeshadow,200,400,200,2,00476,India
731393,2023-12-28,1004,Eyeliner,100,200,100,2,00052,India
947328,2023-12-28,1008,Makeup Remover,80,160,80,2,00496,India
947328,2023-12-28,1009,Moisturizer,250,500,250,2,00496,India
322262,2023-12-28,1002,Mascara,200,400,200,2,00035,India
322262,2023-12-28,1008,Makeup Remover,80,160,80,2,00035,India
874021,2023-12-28,1006,Blush,150,300,150,2,00028,India
874021,2023-12-28,1012,Body Lotion,200,400,200,2,00028,India
828045,2023-12-28,1012,Body Lotion,200,400,200,2,00344,India
828045,2023-12-28,1006,Blush,150,300,150,2,00344,India
233053,2023-12-28,1002,Mascara,200,400,200,2,00180,India
529350,2023-12-28,1007,Eyeshadow,200,400,200,2,00216,India
529350,2023-12-28,1004,Eyeliner,100,200,100,2,00216,India
529350,2023-12-28,1005,Nail Polish,50,100,50,2,00216,India
529350,2023-12-28,1008,Makeup Remover,80,160,80,2,00216,India
538311,2023-12-28,1006,Blush,150,300,150,2,00034,India
344573,2023-12-28,1007,Eyeshadow,200,400,200,2,00211,India
344573,2023-12-28,1003,Foundation,300,600,300,2,00211,India
344573,2023-12-28,1012,Body Lotion,200,400,200,2,00211,India
962279,2023-12-28,1012,Body Lotion,200,400,200,2,00102,India
859752,2023-12-28,1005,Nail Polish,50,100,50,2,00281,India
889033,2023-12-28,1009,Moisturizer,250,500,250,2,00455,India
889033,2023-12-28,1008,Makeup Remover,80,160,80,2,00455,India
889033,2023-12-28,1006,Blush,150,300,150,2,00455,India
413168,2023-12-28,1005,Nail Polish,50,100,50,2,00310,India
413168,2023-12-28,1003,Foundation,300,600,300,2,00310,India
413168,2023-12-28,1004,Eyeliner,100,200,100,2,00310,India
845209,2023-12-28,1007,Eyeshadow,200,400,200,2,00474,India
845209,2023-12-28,1002,Mascara,200,400,200,2,00474,India
845209,2023-12-28,1001,Lipstick,150,300,150,2,00474,India
159402,2023-12-28,1001,Lipstick,150,300,150,2,00134,India
159402,2023-12-28,1007,Eyeshadow,200,400,200,2,00134,India
585163,2023-12-28,1007,Eyeshadow,200,400,200,2,00107,India
585163,2023-12-28,1009,Moisturizer,250,500,250,2,00107,India
697032,2023-12-29,1002,Mascara,200,400,200,2,00441,India
697032,2023-12-29,1005,Nail Polish,50,100,50,2,00441,India
697032,2023-12-29,1008,Makeup Remover,80,160,80,2,00441,India
697032,2023-12-29,1001,Lipstick,150,300,150,2,00441,India
333378,2023-12-29,1008,Makeup Remover,80,160,80,2,00365,India
333378,2023-12-29,1005,Nail Polish,50,100,50,2,00365,India
333378,2023-12-29,1004,Eyeliner,100,200,100,2,00365,India
333378,2023-12-29,1007,Eyeshadow,200,400,200,2,00365,India
150042,2023-12-29,1008,Makeup Remover,80,160,80,2,00210,India
150042,2023-12-29,1004,Eyeliner,100,200,100,2,00210,India
150042,2023-12-29,1002,Mascara,200,400,200,2,00210,India
150042,2023-12-29,1007,Eyeshadow,200,400,200,2,00210,India
150042,2023-12-29,1009,Moisturizer,250,500,250,2,00210,India
368051,2023-12-29,1012,Body Lotion,200,400,200,2,00304,India
368051,2023-12-29,1009,Moisturizer,250,500,250,2,00304,India
873191,2023-12-29,1003,Foundation,300,600,300,2,00384,India
873191,2023-12-29,1001,Lipstick,150,300,150,2,00384,India
873191,2023-12-29,1012,Body Lotion,200,400,200,2,00384,India
797848,2023-12-29,1005,Nail Polish,50,100,50,2,00144,India
797848,2023-12-29,1012,Body Lotion,200,400,200,2,00144,India
144161,2023-12-29,1012,Body Lotion,200,400,200,2,00077,India
144161,2023-12-29,1009,Moisturizer,250,500,250,2,00077,India
144161,2023-12-29,1004,Eyeliner,100,200,100,2,00077,India
969833,2023-12-29,1003,Foundation,300,600,300,2,00491,India
969833,2023-12-29,1009,Moisturizer,250,500,250,2,00491,India
256383,2023-12-29,1007,Eyeshadow,200,400,200,2,00415,India
256383,2023-12-29,1003,Foundation,300,600,300,2,00415,India
994266,2023-12-29,1006,Blush,150,300,150,2,00425,India
994266,2023-12-29,1007,Eyeshadow,200,400,200,2,00425,India
832196,2023-12-29,1009,Moisturizer,250,500,250,2,00449,India
832196,2023-12-29,1012,Body Lotion,200,400,200,2,00449,India
832196,2023-12-29,1008,Makeup Remover,80,160,80,2,00449,India
547170,2023-12-29,1008,Makeup Remover,80,160,80,2,00261,India
547170,2023-12-29,1002,Mascara,200,400,200,2,00261,India
407516,2023-12-29,1008,Makeup Remover,80,160,80,2,00080,India
407516,2023-12-29,1006,Blush,150,300,150,2,00080,India
407516,2023-12-29,1005,Nail Polish,50,100,50,2,00080,India
407516,2023-12-29,1002,Mascara,200,400,200,2,00080,India
707322,2023-12-29,1012,Body Lotion,200,400,200,2,00398,India
707322,2023-12-29,1009,Moisturizer,250,500,250,2,00398,India
707322,2023-12-29,1002,Mascara,200,400,200,2,00398,India
569672,2023-12-29,1001,Lipstick,150,300,150,2,00348,India
569672,2023-12-29,1007,Eyeshadow,200,400,200,2,00348,India
569672,2023-12-29,1004,Eyeliner,100,200,100,2,00348,India
452447,2023-12-29,1009,Moisturizer,250,500,250,2,00374,India
452447,2023-12-29,1001,Lipstick,150,300,150,2,00374,India
452447,2023-12-29,1002,Mascara,200,400,200,2,00374,India
342563,2023-12-29,1005,Nail Polish,50,100,50,2,00186,India
742634,2023-12-29,1004,Eyeliner,100,200,100,2,00118,India
742634,2023-12-29,1002,Mascara,200,400,200,2,00118,India
993759,2023-12-29,1004,Eyeliner,100,200,100,2,00228,India
399876,2023-12-29,1004,Eyeliner,100,200,100,2,00239,India
399876,2023-12-29,1003,Foundation,300,600,300,2,00239,India
133617,2023-12-29,1006,Blush,150,300,150,2,00308,India
133617,2023-12-29,1012,Body Lotion,200,400,200,2,00308,India
208553,2023-12-29,1009,Moisturizer,250,500,250,2,00215,India
975588,2023-12-29,1001,Lipstick,150,300,150,2,00267,India
975588,2023-12-29,1008,Makeup Remover,80,160,80,2,00267,India
975588,2023-12-29,1012,Body Lotion,200,400,200,2,00267,India
975588,2023-12-29,1006,Blush,150,300,150,2,00267,India
975588,2023-12-29,1003,Foundation,300,600,300,2,00267,India
910117,2023-12-29,1009,Moisturizer,250,500,250,2,00414,India
910117,2023-12-29,1002,Mascara,200,400,200,2,00414,India
738307,2023-12-29,1012,Body Lotion,200,400,200,2,00323,India
738307,2023-12-29,1004,Eyeliner,100,200,100,2,00323,India
939269,2023-12-29,1003,Foundation,300,600,300,2,00436,India
939269,2023-12-29,1002,Mascara,200,400,200,2,00436,India
236362,2023-12-29,1012,Body Lotion,200,400,200,2,00422,India
420997,2023-12-29,1004,Eyeliner,100,200,100,2,00480,India
680329,2023-12-29,1002,Mascara,200,400,200,2,00325,India
680329,2023-12-29,1008,Makeup Remover,80,160,80,2,00325,India
183162,2023-12-29,1007,Eyeshadow,200,400,200,2,00270,India
598462,2023-12-29,1009,Moisturizer,250,500,250,2,00208,India
598462,2023-12-29,1012,Body Lotion,200,400,200,2,00208,India
598462,2023-12-29,1003,Foundation,300,600,300,2,00208,India
598462,2023-12-29,1001,Lipstick,150,300,150,2,00208,India
598462,2023-12-29,1007,Eyeshadow,200,400,200,2,00208,India
381868,2023-12-29,1001,Lipstick,150,300,150,2,00299,India
141429,2023-12-29,1012,Body Lotion,200,400,200,2,00308,India
141429,2023-12-29,1006,Blush,150,300,150,2,00308,India
141429,2023-12-29,1009,Moisturizer,250,500,250,2,00308,India
809874,2023-12-29,1001,Lipstick,150,300,150,2,00335,India
809874,2023-12-29,1007,Eyeshadow,200,400,200,2,00335,India
809874,2023-12-29,1012,Body Lotion,200,400,200,2,00335,India
809874,2023-12-29,1008,Makeup Remover,80,160,80,2,00335,India
838784,2023-12-29,1007,Eyeshadow,200,400,200,2,00419,India
838784,2023-12-29,1002,Mascara,200,400,200,2,00419,India
838784,2023-12-29,1003,Foundation,300,600,300,2,00419,India
838784,2023-12-29,1005,Nail Polish,50,100,50,2,00419,India
412374,2023-12-29,1006,Blush,150,300,150,2,00298,India
412374,2023-12-29,1009,Moisturizer,250,500,250,2,00298,India
412374,2023-12-29,1007,Eyeshadow,200,400,200,2,00298,India
162792,2023-12-29,1001,Lipstick,150,300,150,2,00343,India
162792,2023-12-29,1002,Mascara,200,400,200,2,00343,India
162792,2023-12-29,1008,Makeup Remover,80,160,80,2,00343,India
162792,2023-12-29,1003,Foundation,300,600,300,2,00343,India
782135,2023-12-30,1005,Nail Polish,50,100,50,2,00191,India
620482,2023-12-30,1003,Foundation,300,600,300,2,00500,India
620482,2023-12-30,1009,Moisturizer,250,500,250,2,00500,India
620482,2023-12-30,1007,Eyeshadow,200,400,200,2,00500,India
489514,2023-12-30,1005,Nail Polish,50,100,50,2,00393,India
161021,2023-12-30,1007,Eyeshadow,200,400,200,2,00477,India
945047,2023-12-30,1009,Moisturizer,250,500,250,2,00198,India
945047,2023-12-30,1007,Eyeshadow,200,400,200,2,00198,India
720106,2023-12-30,1003,Foundation,300,600,300,2,00024,India
720106,2023-12-30,1007,Eyeshadow,200,400,200,2,00024,India
720106,2023-12-30,1002,Mascara,200,400,200,2,00024,India
465834,2023-12-30,1001,Lipstick,150,300,150,2,00188,India
465834,2023-12-30,1005,Nail Polish,50,100,50,2,00188,India
284113,2023-12-30,1001,Lipstick,150,300,150,2,00245,India
284113,2023-12-30,1007,Eyeshadow,200,400,200,2,00245,India
916098,2023-12-30,1003,Foundation,300,600,300,2,00371,India
916098,2023-12-30,1006,Blush,150,300,150,2,00371,India
916098,2023-12-30,1012,Body Lotion,200,400,200,2,00371,India
424440,2023-12-30,1001,Lipstick,150,300,150,2,00286,India
755662,2023-12-30,1012,Body Lotion,200,400,200,2,00136,India
755662,2023-12-30,1006,Blush,150,300,150,2,00136,India
755662,2023-12-30,1004,Eyeliner,100,200,100,2,00136,India
889573,2023-12-30,1003,Foundation,300,600,300,2,00344,India
889573,2023-12-30,1001,Lipstick,150,300,150,2,00344,India
889573,2023-12-30,1004,Eyeliner,100,200,100,2,00344,India
974272,2023-12-30,1001,Lipstick,150,300,150,2,00137,India
974272,2023-12-30,1006,Blush,150,300,150,2,00137,India
974272,2023-12-30,1002,Mascara,200,400,200,2,00137,India
516335,2023-12-30,1012,Body Lotion,200,400,200,2,00417,India
516335,2023-12-30,1007,Eyeshadow,200,400,200,2,00417,India
516335,2023-12-30,1005,Nail Polish,50,100,50,2,00417,India
516335,2023-12-30,1004,Eyeliner,100,200,100,2,00417,India
639420,2023-12-30,1006,Blush,150,300,150,2,00277,India
639420,2023-12-30,1003,Foundation,300,600,300,2,00277,India
639420,2023-12-30,1004,Eyeliner,100,200,100,2,00277,India
639420,2023-12-30,1001,Lipstick,150,300,150,2,00277,India
122974,2023-12-30,1004,Eyeliner,100,200,100,2,00265,India
122974,2023-12-30,1009,Moisturizer,250,500,250,2,00265,India
626517,2023-12-30,1003,Foundation,300,600,300,2,00376,India
890750,2023-12-30,1004,Eyeliner,100,200,100,2,00328,India
890750,2023-12-30,1008,Makeup Remover,80,160,80,2,00328,India
890750,2023-12-30,1009,Moisturizer,250,500,250,2,00328,India
857609,2023-12-30,1007,Eyeshadow,200,400,200,2,00415,India
857609,2023-12-30,1006,Blush,150,300,150,2,00415,India
486661,2023-12-30,1012,Body Lotion,200,400,200,2,00188,India
486661,2023-12-30,1006,Blush,150,300,150,2,00188,India
902186,2023-12-30,1007,Eyeshadow,200,400,200,2,00313,India
902186,2023-12-30,1006,Blush,150,300,150,2,00313,India
902186,2023-12-30,1002,Mascara,200,400,200,2,00313,India
902186,2023-12-30,1004,Eyeliner,100,200,100,2,00313,India
902186,2023-12-30,1008,Makeup Remover,80,160,80,2,00313,India
850505,2023-12-30,1004,Eyeliner,100,200,100,2,00008,India
850505,2023-12-30,1002,Mascara,200,400,200,2,00008,India
850505,2023-12-30,1008,Makeup Remover,80,160,80,2,00008,India
784256,2023-12-30,1006,Blush,150,300,150,2,00447,India
784256,2023-12-30,1002,Mascara,200,400,200,2,00447,India
394896,2023-12-30,1008,Makeup Remover,80,160,80,2,00109,India
394896,2023-12-30,1002,Mascara,200,400,200,2,00109,India
394896,2023-12-30,1009,Moisturizer,250,500,250,2,00109,India
294937,2023-12-30,1005,Nail Polish,50,100,50,2,00357,India
801800,2023-12-30,1003,Foundation,300,600,300,2,00223,India
801800,2023-12-30,1001,Lipstick,150,300,150,2,00223,India
801800,2023-12-30,1002,Mascara,200,400,200,2,00223,India
801800,2023-12-30,1005,Nail Polish,50,100,50,2,00223,India
187449,2023-12-30,1006,Blush,150,300,150,2,00107,India
779583,2023-12-30,1004,Eyeliner,100,200,100,2,00490,India
779583,2023-12-30,1001,Lipstick,150,300,150,2,00490,India
779583,2023-12-30,1008,Makeup Remover,80,160,80,2,00490,India
779583,2023-12-30,1005,Nail Polish,50,100,50,2,00490,India
788630,2023-12-30,1009,Moisturizer,250,500,250,2,00431,India
788630,2023-12-30,1007,Eyeshadow,200,400,200,2,00431,India
788630,2023-12-30,1005,Nail Polish,50,100,50,2,00431,India
788630,2023-12-30,1004,Eyeliner,100,200,100,2,00431,India
493873,2023-12-30,1006,Blush,150,300,150,2,00480,India
493873,2023-12-30,1005,Nail Polish,50,100,50,2,00480,India
835372,2023-12-31,1009,Moisturizer,250,500,250,2,00360,India
835372,2023-12-31,1001,Lipstick,150,300,150,2,00360,India
835372,2023-12-31,1008,Makeup Remover,80,160,80,2,00360,India
835372,2023-12-31,1006,Blush,150,300,150,2,00360,India
803949,2023-12-31,1003,Foundation,300,600,300,2,00391,India
803949,2023-12-31,1008,Makeup Remover,80,160,80,2,00391,India
803949,2023-12-31,1001,Lipstick,150,300,150,2,00391,India
441024,2023-12-31,1007,Eyeshadow,200,400,200,2,00374,India
716331,2023-12-31,1002,Mascara,200,400,200,2,00002,India
716331,2023-12-31,1007,Eyeshadow,200,400,200,2,00002,India
716331,2023-12-31,1003,Foundation,300,600,300,2,00002,India
716331,2023-12-31,1008,Makeup Remover,80,160,80,2,00002,India
484832,2023-12-31,1001,Lipstick,150,300,150,2,00398,India
484832,2023-12-31,1007,Eyeshadow,200,400,200,2,00398,India
430219,2023-12-31,1009,Moisturizer,250,500,250,2,00295,India
430219,2023-12-31,1012,Body Lotion,200,400,200,2,00295,India
430219,2023-12-31,1007,Eyeshadow,200,400,200,2,00295,India
430219,2023-12-31,1001,Lipstick,150,300,150,2,00295,India
910981,2023-12-31,1007,Eyeshadow,200,400,200,2,00449,India
910981,2023-12-31,1008,Makeup Remover,80,160,80,2,00449,India
910981,2023-12-31,1002,Mascara,200,400,200,2,00449,India
910981,2023-12-31,1005,Nail Polish,50,100,50,2,00449,India
789951,2023-12-31,1004,Eyeliner,100,200,100,2,00442,India
789951,2023-12-31,1001,Lipstick,150,300,150,2,00442,India
555341,2023-12-31,1003,Foundation,300,600,300,2,00215,India
702198,2023-12-31,1002,Mascara,200,400,200,2,00414,India
702198,2023-12-31,1003,Foundation,300,600,300,2,00414,India
347148,2023-12-31,1003,Foundation,300,600,300,2,00045,India
347148,2023-12-31,1008,Makeup Remover,80,160,80,2,00045,India
347148,2023-12-31,1002,Mascara,200,400,200,2,00045,India
347148,2023-12-31,1007,Eyeshadow,200,400,200,2,00045,India
728169,2023-12-31,1006,Blush,150,300,150,2,00393,India
728169,2023-12-31,1005,Nail Polish,50,100,50,2,00393,India
728169,2023-12-31,1009,Moisturizer,250,500,250,2,00393,India
728169,2023-12-31,1003,Foundation,300,600,300,2,00393,India
728169,2023-12-31,1007,Eyeshadow,200,400,200,2,00393,India
179014,2023-12-31,1004,Eyeliner,100,200,100,2,00170,India
919913,2023-12-31,1008,Makeup Remover,80,160,80,2,00320,India
919913,2023-12-31,1012,Body Lotion,200,400,200,2,00320,India
919913,2023-12-31,1007,Eyeshadow,200,400,200,2,00320,India
919913,2023-12-31,1001,Lipstick,150,300,150,2,00320,India
302181,2023-12-31,1008,Makeup Remover,80,160,80,2,00010,India
302181,2023-12-31,1002,Mascara,200,400,200,2,00010,India
589550,2023-12-31,1003,Foundation,300,600,300,2,00378,India
589550,2023-12-31,1009,Moisturizer,250,500,250,2,00378,India
589550,2023-12-31,1001,Lipstick,150,300,150,2,00378,India
589550,2023-12-31,1008,Makeup Remover,80,160,80,2,00378,India
764502,2023-12-31,1003,Foundation,300,600,300,2,00363,India
225602,2023-12-31,1004,Eyeliner,100,200,100,2,00079,India
225602,2023-12-31,1003,Foundation,300,600,300,2,00079,India
225602,2023-12-31,1012,Body Lotion,200,400,200,2,00079,India
420201,2023-12-31,1008,Makeup Remover,80,160,80,2,00443,India
420201,2023-12-31,1004,Eyeliner,100,200,100,2,00443,India
420201,2023-12-31,1002,Mascara,200,400,200,2,00443,India
920187,2023-12-31,1005,Nail Polish,50,100,50,2,00377,India
920187,2023-12-31,1012,Body Lotion,200,400,200,2,00377,India
765724,2023-12-31,1006,Blush,150,300,150,2,00126,India
230777,2023-12-31,1003,Foundation,300,600,300,2,00367,India
230777,2023-12-31,1007,Eyeshadow,200,400,200,2,00367,India
230777,2023-12-31,1009,Moisturizer,250,500,250,2,00367,India
888887,2023-12-31,1005,Nail Polish,50,100,50,2,00102,India
888887,2023-12-31,1007,Eyeshadow,200,400,200,2,00102,India
800448,2023-12-31,1006,Blush,150,300,150,2,00429,India
800448,2023-12-31,1007,Eyeshadow,200,400,200,2,00429,India
553816,2023-12-31,1004,Eyeliner,100,200,100,2,00353,India
553816,2023-12-31,1007,Eyeshadow,200,400,200,2,00353,India
553816,2023-12-31,1005,Nail Polish,50,100,50,2,00353,India
553816,2023-12-31,1012,Body Lotion,200,400,200,2,00353,India
793080,2023-12-31,1012,Body Lotion,200,400,200,2,00417,India
415621,2023-12-31,1007,Eyeshadow,200,400,200,2,00135,India
415621,2023-12-31,1002,Mascara,200,400,200,2,00135,India
415621,2023-12-31,1004,Eyeliner,100,200,100,2,00135,India
415621,2023-12-31,1003,Foundation,300,600,300,2,00135,India
764628,2023-12-31,1007,Eyeshadow,200,400,200,2,00202,India
764628,2023-12-31,1003,Foundation,300,600,300,2,00202,India
609361,2023-12-31,1006,Blush,150,300,150,2,00167,India
751398,2023-12-31,1001,Lipstick,150,300,150,2,00260,India
478301,2023-12-31,1003,Foundation,300,600,300,2,00442,India
478301,2023-12-31,1001,Lipstick,150,300,150,2,00442,India
478301,2023-12-31,1009,Moisturizer,250,500,250,2,00442,India
478301,2023-12-31,1002,Mascara,200,400,200,2,00442,India
920545,2023-12-31,1008,Makeup Remover,80,160,80,2,00132,India
920545,2023-12-31,1001,Lipstick,150,300,150,2,00132,India
920545,2023-12-31,1002,Mascara,200,400,200,2,00132,India
920545,2023-12-31,1007,Eyeshadow,200,400,200,2,00132,India
381854,2023-12-31,1004,Eyeliner,100,200,100,2,00040,India
381854,2023-12-31,1003,Foundation,300,600,300,2,00040,India
366723,2023-12-31,1007,Eyeshadow,200,400,200,2,00171,India
366723,2023-12-31,1004,Eyeliner,100,200,100,2,00171,India
366723,2023-12-31,1002,Mascara,200,400,200,2,00171,India
811890,2023-12-31,1002,Mascara,200,400,200,2,00149,India
882152,2023-12-31,1007,Eyeshadow,200,400,200,2,00092,India
581129,2023-12-31,1003,Foundation,300,600,300,2,00422,India
581129,2023-12-31,1004,Eyeliner,100,200,100,2,00422,India
581129,2023-12-31,1001,Lipstick,150,300,150,2,00422,India
272984,2023-12-31,1005,Nail Polish,50,100,50,2,00193,India
272984,2023-12-31,1007,Eyeshadow,200,400,200,2,00193,India
604081,2023-12-31,1012,Body Lotion,200,400,200,2,00193,India
662499,2023-12-31,1004,Eyeliner,100,200,100,2,00298,India
662499,2023-12-31,1005,Nail Polish,50,100,50,2,00298,India
830876,2024-01-01,1005,Nail Polish,50,100,50,2,00080,India
813170,2024-01-01,1002,Mascara,200,400,200,2,00212,India
780449,2024-01-01,1009,Moisturizer,250,500,250,2,00275,India
780449,2024-01-01,1008,Makeup Remover,80,160,80,2,00275,India
780449,2024-01-01,1001,Lipstick,150,300,150,2,00275,India
780449,2024-01-01,1006,Blush,150,300,150,2,00275,India
485216,2024-01-01,1009,Moisturizer,250,500,250,2,00310,India
485216,2024-01-01,1004,Eyeliner,100,200,100,2,00310,India
485216,2024-01-01,1012,Body Lotion,200,400,200,2,00310,India
485216,2024-01-01,1002,Mascara,200,400,200,2,00310,India
485216,2024-01-01,1005,Nail Polish,50,100,50,2,00310,India
811546,2024-01-01,1004,Eyeliner,100,200,100,2,00154,India
811546,2024-01-01,1008,Makeup Remover,80,160,80,2,00154,India
811546,2024-01-01,1006,Blush,150,300,150,2,00154,India
571530,2024-01-01,1009,Moisturizer,250,500,250,2,00282,India
604225,2024-01-01,1004,Eyeliner,100,200,100,2,00314,India
604225,2024-01-01,1005,Nail Polish,50,100,50,2,00314,India
604225,2024-01-01,1006,Blush,150,300,150,2,00314,India
604225,2024-01-01,1002,Mascara,200,400,200,2,00314,India
681865,2024-01-01,1005,Nail Polish,50,100,50,2,00204,India
574866,2024-01-01,1009,Moisturizer,250,500,250,2,00282,India
574866,2024-01-01,1007,Eyeshadow,200,400,200,2,00282,India
574866,2024-01-01,1002,Mascara,200,400,200,2,00282,India
574866,2024-01-01,1005,Nail Polish,50,100,50,2,00282,India
984230,2024-01-01,1007,Eyeshadow,200,400,200,2,00390,India
984230,2024-01-01,1006,Blush,150,300,150,2,00390,India
984230,2024-01-01,1008,Makeup Remover,80,160,80,2,00390,India
984230,2024-01-01,1009,Moisturizer,250,500,250,2,00390,India
131689,2024-01-01,1012,Body Lotion,200,400,200,2,00388,India
131689,2024-01-01,1004,Eyeliner,100,200,100,2,00388,India
131689,2024-01-01,1003,Foundation,300,600,300,2,00388,India
131689,2024-01-01,1002,Mascara,200,400,200,2,00388,India
273583,2024-01-01,1002,Mascara,200,400,200,2,00228,India
273583,2024-01-01,1006,Blush,150,300,150,2,00228,India
333806,2024-01-01,1009,Moisturizer,250,500,250,2,00213,India
737663,2024-01-01,1001,Lipstick,150,300,150,2,00247,India
737663,2024-01-01,1012,Body Lotion,200,400,200,2,00247,India
825204,2024-01-01,1001,Lipstick,150,300,150,2,00411,India
825204,2024-01-01,1004,Eyeliner,100,200,100,2,00411,India
825204,2024-01-01,1007,Eyeshadow,200,400,200,2,00411,India
825204,2024-01-01,1002,Mascara,200,400,200,2,00411,India
267119,2024-01-01,1002,Mascara,200,400,200,2,00241,India
267119,2024-01-01,1012,Body Lotion,200,400,200,2,00241,India
905177,2024-01-01,1004,Eyeliner,100,200,100,2,00080,India
905177,2024-01-01,1002,Mascara,200,400,200,2,00080,India
870658,2024-01-01,1007,Eyeshadow,200,400,200,2,00335,India
394460,2024-01-01,1006,Blush,150,300,150,2,00347,India
394460,2024-01-01,1005,Nail Polish,50,100,50,2,00347,India
394460,2024-01-01,1007,Eyeshadow,200,400,200,2,00347,India
869343,2024-01-01,1004,Eyeliner,100,200,100,2,00424,India
869343,2024-01-01,1003,Foundation,300,600,300,2,00424,India
869343,2024-01-01,1008,Makeup Remover,80,160,80,2,00424,India
353815,2024-01-01,1008,Makeup Remover,80,160,80,2,00412,India
353815,2024-01-01,1009,Moisturizer,250,500,250,2,00412,India
353815,2024-01-01,1012,Body Lotion,200,400,200,2,00412,India
395578,2024-01-01,1001,Lipstick,150,300,150,2,00283,India
395578,2024-01-01,1009,Moisturizer,250,500,250,2,00283,India
395578,2024-01-01,1007,Eyeshadow,200,400,200,2,00283,India
395578,2024-01-01,1005,Nail Polish,50,100,50,2,00283,India
935395,2024-01-01,1006,Blush,150,300,150,2,00023,India
935395,2024-01-01,1002,Mascara,200,400,200,2,00023,India
935395,2024-01-01,1003,Foundation,300,600,300,2,00023,India
935395,2024-01-01,1008,Makeup Remover,80,160,80,2,00023,India
332502,2024-01-01,1004,Eyeliner,100,200,100,2,00278,India
332502,2024-01-01,1009,Moisturizer,250,500,250,2,00278,India
332502,2024-01-01,1001,Lipstick,150,300,150,2,00278,India
544286,2024-01-01,1001,Lipstick,150,300,150,2,00230,India
544286,2024-01-01,1009,Moisturizer,250,500,250,2,00230,India
637791,2024-01-01,1001,Lipstick,150,300,150,2,00027,India
637791,2024-01-01,1002,Mascara,200,400,200,2,00027,India
637791,2024-01-01,1006,Blush,150,300,150,2,00027,India
173461,2024-01-01,1003,Foundation,300,600,300,2,00170,India
173461,2024-01-01,1002,Mascara,200,400,200,2,00170,India
205432,2024-01-01,1008,Makeup Remover,80,160,80,2,00377,India
205432,2024-01-01,1005,Nail Polish,50,100,50,2,00377,India
205432,2024-01-01,1003,Foundation,300,600,300,2,00377,India
820683,2024-01-01,1007,Eyeshadow,200,400,200,2,00242,India
820683,2024-01-01,1003,Foundation,300,600,300,2,00242,India
820683,2024-01-01,1012,Body Lotion,200,400,200,2,00242,India
820683,2024-01-01,1006,Blush,150,300,150,2,00242,India
189881,2024-01-01,1007,Eyeshadow,200,400,200,2,00459,India
189881,2024-01-01,1006,Blush,150,300,150,2,00459,India
744878,2024-01-01,1001,Lipstick,150,300,150,2,00385,India
744878,2024-01-01,1007,Eyeshadow,200,400,200,2,00385,India
744878,2024-01-01,1008,Makeup Remover,80,160,80,2,00385,India
504332,2024-01-01,1012,Body Lotion,200,400,200,2,00189,India
134231,2024-01-01,1004,Eyeliner,100,200,100,2,00281,India
134231,2024-01-01,1009,Moisturizer,250,500,250,2,00281,India
199028,2024-01-01,1002,Mascara,200,400,200,2,00351,India
238182,2024-01-01,1001,Lipstick,150,300,150,2,00093,India
238182,2024-01-01,1003,Foundation,300,600,300,2,00093,India
238182,2024-01-01,1007,Eyeshadow,200,400,200,2,00093,India
929221,2024-01-01,1002,Mascara,200,400,200,2,00089,India
929221,2024-01-01,1001,Lipstick,150,300,150,2,00089,India
929221,2024-01-01,1006,Blush,150,300,150,2,00089,India
929221,2024-01-01,1008,Makeup Remover,80,160,80,2,00089,India
570631,2024-01-02,1005,Nail Polish,50,100,50,2,00282,India
570631,2024-01-02,1008,Makeup Remover,80,160,80,2,00282,India
570631,2024-01-02,1001,Lipstick,150,300,150,2,00282,India
812359,2024-01-02,1008,Makeup Remover,80,160,80,2,00062,India
812359,2024-01-02,1007,Eyeshadow,200,400,200,2,00062,India
194615,2024-01-02,1008,Makeup Remover,80,160,80,2,00451,India
194615,2024-01-02,1006,Blush,150,300,150,2,00451,India
687347,2024-01-02,1006,Blush,150,300,150,2,00455,India
360940,2024-01-02,1007,Eyeshadow,200,400,200,2,00431,India
360940,2024-01-02,1001,Lipstick,150,300,150,2,00431,India
860398,2024-01-02,1003,Foundation,300,600,300,2,00319,India
899083,2024-01-02,1003,Foundation,300,600,300,2,00389,India
899083,2024-01-02,1008,Makeup Remover,80,160,80,2,00389,India
899083,2024-01-02,1004,Eyeliner,100,200,100,2,00389,India
899083,2024-01-02,1009,Moisturizer,250,500,250,2,00389,India
820400,2024-01-02,1007,Eyeshadow,200,400,200,2,00099,India
103050,2024-01-02,1004,Eyeliner,100,200,100,2,00327,India
103050,2024-01-02,1001,Lipstick,150,300,150,2,00327,India
128294,2024-01-02,1007,Eyeshadow,200,400,200,2,00044,India
128294,2024-01-02,1005,Nail Polish,50,100,50,2,00044,India
487916,2024-01-02,1007,Eyeshadow,200,400,200,2,00440,India
487916,2024-01-02,1009,Moisturizer,250,500,250,2,00440,India
487916,2024-01-02,1004,Eyeliner,100,200,100,2,00440,India
781645,2024-01-02,1012,Body Lotion,200,400,200,2,00217,India
781645,2024-01-02,1005,Nail Polish,50,100,50,2,00217,India
781645,2024-01-02,1003,Foundation,300,600,300,2,00217,India
781645,2024-01-02,1009,Moisturizer,250,500,250,2,00217,India
320953,2024-01-02,1003,Foundation,300,600,300,2,00164,India
249567,2024-01-02,1009,Moisturizer,250,500,250,2,00267,India
249567,2024-01-02,1001,Lipstick,150,300,150,2,00267,India
881813,2024-01-02,1004,Eyeliner,100,200,100,2,00416,India
881813,2024-01-02,1007,Eyeshadow,200,400,200,2,00416,India
881813,2024-01-02,1003,Foundation,300,600,300,2,00416,India
881813,2024-01-02,1005,Nail Polish,50,100,50,2,00416,India
881813,2024-01-02,1001,Lipstick,150,300,150,2,00416,India
360162,2024-01-02,1008,Makeup Remover,80,160,80,2,00483,India
360162,2024-01-02,1006,Blush,150,300,150,2,00483,India
360162,2024-01-02,1003,Foundation,300,600,300,2,00483,India
313477,2024-01-02,1007,Eyeshadow,200,400,200,2,00425,India
923536,2024-01-02,1012,Body Lotion,200,400,200,2,00227,India
923536,2024-01-02,1002,Mascara,200,400,200,2,00227,India
558652,2024-01-02,1008,Makeup Remover,80,160,80,2,00425,India
960827,2024-01-02,1003,Foundation,300,600,300,2,00166,India
366651,2024-01-02,1002,Mascara,200,400,200,2,00234,India
366651,2024-01-02,1008,Makeup Remover,80,160,80,2,00234,India
366651,2024-01-02,1005,Nail Polish,50,100,50,2,00234,India
366651,2024-01-02,1007,Eyeshadow,200,400,200,2,00234,India
376235,2024-01-02,1006,Blush,150,300,150,2,00327,India
376235,2024-01-02,1003,Foundation,300,600,300,2,00327,India
376235,2024-01-02,1008,Makeup Remover,80,160,80,2,00327,India
916389,2024-01-02,1008,Makeup Remover,80,160,80,2,00372,India
916389,2024-01-02,1004,Eyeliner,100,200,100,2,00372,India
810712,2024-01-02,1009,Moisturizer,250,500,250,2,00309,India
810712,2024-01-02,1007,Eyeshadow,200,400,200,2,00309,India
810712,2024-01-02,1006,Blush,150,300,150,2,00309,India
810712,2024-01-02,1001,Lipstick,150,300,150,2,00309,India
299851,2024-01-02,1001,Lipstick,150,300,150,2,00032,India
299851,2024-01-02,1007,Eyeshadow,200,400,200,2,00032,India
299851,2024-01-02,1008,Makeup Remover,80,160,80,2,00032,India
299851,2024-01-02,1006,Blush,150,300,150,2,00032,India
300507,2024-01-02,1009,Moisturizer,250,500,250,2,00413,India
300507,2024-01-02,1012,Body Lotion,200,400,200,2,00413,India
300507,2024-01-02,1007,Eyeshadow,200,400,200,2,00413,India
300507,2024-01-02,1002,Mascara,200,400,200,2,00413,India
525153,2024-01-02,1012,Body Lotion,200,400,200,2,00422,India
525153,2024-01-02,1003,Foundation,300,600,300,2,00422,India
525153,2024-01-02,1006,Blush,150,300,150,2,00422,India
525153,2024-01-02,1008,Makeup Remover,80,160,80,2,00422,India
253285,2024-01-02,1006,Blush,150,300,150,2,00418,India
253285,2024-01-02,1009,Moisturizer,250,500,250,2,00418,India
253285,2024-01-02,1001,Lipstick,150,300,150,2,00418,India
226038,2024-01-02,1009,Moisturizer,250,500,250,2,00264,India
688045,2024-01-02,1001,Lipstick,150,300,150,2,00288,India
382689,2024-01-02,1012,Body Lotion,200,400,200,2,00023,India
382689,2024-01-02,1005,Nail Polish,50,100,50,2,00023,India
382689,2024-01-02,1003,Foundation,300,600,300,2,00023,India
613186,2024-01-02,1008,Makeup Remover,80,160,80,2,00132,India
792208,2024-01-02,1008,Makeup Remover,80,160,80,2,00184,India
792208,2024-01-02,1012,Body Lotion,200,400,200,2,00184,India
792208,2024-01-02,1003,Foundation,300,600,300,2,00184,India
974065,2024-01-02,1007,Eyeshadow,200,400,200,2,00021,India
974065,2024-01-02,1003,Foundation,300,600,300,2,00021,India
204807,2024-01-03,1002,Mascara,200,400,200,2,00420,India
204807,2024-01-03,1001,Lipstick,150,300,150,2,00420,India
204807,2024-01-03,1003,Foundation,300,600,300,2,00420,India
155200,2024-01-03,1009,Moisturizer,250,500,250,2,00241,India
155200,2024-01-03,1005,Nail Polish,50,100,50,2,00241,India
734128,2024-01-03,1002,Mascara,200,400,200,2,00334,India
734128,2024-01-03,1008,Makeup Remover,80,160,80,2,00334,India
734128,2024-01-03,1001,Lipstick,150,300,150,2,00334,India
734128,2024-01-03,1009,Moisturizer,250,500,250,2,00334,India
734128,2024-01-03,1006,Blush,150,300,150,2,00334,India
896880,2024-01-03,1002,Mascara,200,400,200,2,00294,India
896880,2024-01-03,1003,Foundation,300,600,300,2,00294,India
896880,2024-01-03,1005,Nail Polish,50,100,50,2,00294,India
297158,2024-01-03,1012,Body Lotion,200,400,200,2,00346,India
980892,2024-01-03,1012,Body Lotion,200,400,200,2,00235,India
980892,2024-01-03,1009,Moisturizer,250,500,250,2,00235,India
740267,2024-01-03,1009,Moisturizer,250,500,250,2,00313,India
937866,2024-01-03,1007,Eyeshadow,200,400,200,2,00054,India
937866,2024-01-03,1006,Blush,150,300,150,2,00054,India
937866,2024-01-03,1001,Lipstick,150,300,150,2,00054,India
937866,2024-01-03,1009,Moisturizer,250,500,250,2,00054,India
447905,2024-01-03,1004,Eyeliner,100,200,100,2,00164,India
447905,2024-01-03,1005,Nail Polish,50,100,50,2,00164,India
750191,2024-01-03,1004,Eyeliner,100,200,100,2,00118,India
149037,2024-01-03,1012,Body Lotion,200,400,200,2,00238,India
149037,2024-01-03,1007,Eyeshadow,200,400,200,2,00238,India
878352,2024-01-03,1006,Blush,150,300,150,2,00111,India
407035,2024-01-03,1006,Blush,150,300,150,2,00414,India
407035,2024-01-03,1012,Body Lotion,200,400,200,2,00414,India
407035,2024-01-03,1002,Mascara,200,400,200,2,00414,India
407035,2024-01-03,1004,Eyeliner,100,200,100,2,00414,India
407035,2024-01-03,1007,Eyeshadow,200,400,200,2,00414,India
398727,2024-01-03,1003,Foundation,300,600,300,2,00106,India
398727,2024-01-03,1005,Nail Polish,50,100,50,2,00106,India
398727,2024-01-03,1006,Blush,150,300,150,2,00106,India
196965,2024-01-03,1006,Blush,150,300,150,2,00032,India
196965,2024-01-03,1008,Makeup Remover,80,160,80,2,00032,India
196965,2024-01-03,1003,Foundation,300,600,300,2,00032,India
888772,2024-01-03,1005,Nail Polish,50,100,50,2,00296,India
888772,2024-01-03,1004,Eyeliner,100,200,100,2,00296,India
888772,2024-01-03,1009,Moisturizer,250,500,250,2,00296,India
539094,2024-01-03,1009,Moisturizer,250,500,250,2,00343,India
539094,2024-01-03,1002,Mascara,200,400,200,2,00343,India
539094,2024-01-03,1006,Blush,150,300,150,2,00343,India
539094,2024-01-03,1012,Body Lotion,200,400,200,2,00343,India
458389,2024-01-03,1005,Nail Polish,50,100,50,2,00056,India
458389,2024-01-03,1006,Blush,150,300,150,2,00056,India
458389,2024-01-03,1007,Eyeshadow,200,400,200,2,00056,India
458389,2024-01-03,1009,Moisturizer,250,500,250,2,00056,India
492770,2024-01-03,1005,Nail Polish,50,100,50,2,00132,India
492770,2024-01-03,1002,Mascara,200,400,200,2,00132,India
492770,2024-01-03,1001,Lipstick,150,300,150,2,00132,India
492770,2024-01-03,1008,Makeup Remover,80,160,80,2,00132,India
492770,2024-01-03,1003,Foundation,300,600,300,2,00132,India
200045,2024-01-03,1005,Nail Polish,50,100,50,2,00094,India
200045,2024-01-03,1007,Eyeshadow,200,400,200,2,00094,India
200045,2024-01-03,1012,Body Lotion,200,400,200,2,00094,India
200045,2024-01-03,1002,Mascara,200,400,200,2,00094,India
228721,2024-01-03,1007,Eyeshadow,200,400,200,2,00367,India
228721,2024-01-03,1006,Blush,150,300,150,2,00367,India
228721,2024-01-03,1003,Foundation,300,600,300,2,00367,India
273362,2024-01-03,1012,Body Lotion,200,400,200,2,00154,India
348480,2024-01-03,1012,Body Lotion,200,400,200,2,00224,India
348480,2024-01-03,1002,Mascara,200,400,200,2,00224,India
219920,2024-01-03,1012,Body Lotion,200,400,200,2,00114,India
219920,2024-01-03,1007,Eyeshadow,200,400,200,2,00114,India
266752,2024-01-03,1005,Nail Polish,50,100,50,2,00044,India
266752,2024-01-03,1003,Foundation,300,600,300,2,00044,India
452843,2024-01-03,1009,Moisturizer,250,500,250,2,00492,India
452843,2024-01-03,1001,Lipstick,150,300,150,2,00492,India
452843,2024-01-03,1002,Mascara,200,400,200,2,00492,India
464358,2024-01-03,1007,Eyeshadow,200,400,200,2,00314,India
464358,2024-01-03,1001,Lipstick,150,300,150,2,00314,India
746325,2024-01-03,1001,Lipstick,150,300,150,2,00359,India
902711,2024-01-03,1003,Foundation,300,600,300,2,00428,India
902711,2024-01-03,1005,Nail Polish,50,100,50,2,00428,India
902711,2024-01-03,1008,Makeup Remover,80,160,80,2,00428,India
757116,2024-01-03,1002,Mascara,200,400,200,2,00467,India
757116,2024-01-03,1009,Moisturizer,250,500,250,2,00467,India
757116,2024-01-03,1006,Blush,150,300,150,2,00467,India
747979,2024-01-04,1003,Foundation,300,600,300,2,00426,India
747979,2024-01-04,1002,Mascara,200,400,200,2,00426,India
747979,2024-01-04,1008,Makeup Remover,80,160,80,2,00426,India
896994,2024-01-04,1009,Moisturizer,250,500,250,2,00148,India
896994,2024-01-04,1004,Eyeliner,100,200,100,2,00148,India
896994,2024-01-04,1012,Body Lotion,200,400,200,2,00148,India
896994,2024-01-04,1008,Makeup Remover,80,160,80,2,00148,India
896994,2024-01-04,1006,Blush,150,300,150,2,00148,India
638470,2024-01-04,1002,Mascara,200,400,200,2,00437,India
638470,2024-01-04,1003,Foundation,300,600,300,2,00437,India
638470,2024-01-04,1009,Moisturizer,250,500,250,2,00437,India
899186,2024-01-04,1001,Lipstick,150,300,150,2,00391,India
899186,2024-01-04,1007,Eyeshadow,200,400,200,2,00391,India
807070,2024-01-04,1006,Blush,150,300,150,2,00487,India
807070,2024-01-04,1012,Body Lotion,200,400,200,2,00487,India
807070,2024-01-04,1003,Foundation,300,600,300,2,00487,India
807070,2024-01-04,1004,Eyeliner,100,200,100,2,00487,India
530820,2024-01-04,1009,Moisturizer,250,500,250,2,00285,India
530820,2024-01-04,1007,Eyeshadow,200,400,200,2,00285,India
530820,2024-01-04,1012,Body Lotion,200,400,200,2,00285,India
919308,2024-01-04,1008,Makeup Remover,80,160,80,2,00274,India
610167,2024-01-04,1005,Nail Polish,50,100,50,2,00329,India
610167,2024-01-04,1002,Mascara,200,400,200,2,00329,India
145279,2024-01-04,1007,Eyeshadow,200,400,200,2,00165,India
805135,2024-01-04,1009,Moisturizer,250,500,250,2,00127,India
805135,2024-01-04,1001,Lipstick,150,300,150,2,00127,India
805135,2024-01-04,1007,Eyeshadow,200,400,200,2,00127,India
805135,2024-01-04,1008,Makeup Remover,80,160,80,2,00127,India
805135,2024-01-04,1004,Eyeliner,100,200,100,2,00127,India
110729,2024-01-04,1002,Mascara,200,400,200,2,00025,India
110729,2024-01-04,1006,Blush,150,300,150,2,00025,India
654651,2024-01-04,1001,Lipstick,150,300,150,2,00401,India
654651,2024-01-04,1008,Makeup Remover,80,160,80,2,00401,India
323725,2024-01-04,1007,Eyeshadow,200,400,200,2,00403,India
323725,2024-01-04,1005,Nail Polish,50,100,50,2,00403,India
590168,2024-01-04,1004,Eyeliner,100,200,100,2,00102,India
386876,2024-01-04,1007,Eyeshadow,200,400,200,2,00272,India
386876,2024-01-04,1003,Foundation,300,600,300,2,00272,India
386876,2024-01-04,1004,Eyeliner,100,200,100,2,00272,India
386876,2024-01-04,1005,Nail Polish,50,100,50,2,00272,India
769064,2024-01-04,1004,Eyeliner,100,200,100,2,00222,India
769064,2024-01-04,1009,Moisturizer,250,500,250,2,00222,India
769064,2024-01-04,1007,Eyeshadow,200,400,200,2,00222,India
769064,2024-01-04,1006,Blush,150,300,150,2,00222,India
293652,2024-01-04,1008,Makeup Remover,80,160,80,2,00357,India
293652,2024-01-04,1009,Moisturizer,250,500,250,2,00357,India
952533,2024-01-04,1007,Eyeshadow,200,400,200,2,00425,India
952533,2024-01-04,1003,Foundation,300,600,300,2,00425,India
129246,2024-01-04,1008,Makeup Remover,80,160,80,2,00143,India
129246,2024-01-04,1002,Mascara,200,400,200,2,00143,India
129246,2024-01-04,1003,Foundation,300,600,300,2,00143,India
129246,2024-01-04,1007,Eyeshadow,200,400,200,2,00143,India
129246,2024-01-04,1004,Eyeliner,100,200,100,2,00143,India
334417,2024-01-04,1006,Blush,150,300,150,2,00387,India
334417,2024-01-04,1009,Moisturizer,250,500,250,2,00387,India
879304,2024-01-04,1001,Lipstick,150,300,150,2,00331,India
187449,2024-01-04,1003,Foundation,300,600,300,2,00107,India
187449,2024-01-04,1007,Eyeshadow,200,400,200,2,00107,India
187449,2024-01-04,1012,Body Lotion,200,400,200,2,00107,India
187449,2024-01-04,1008,Makeup Remover,80,160,80,2,00107,India
813610,2024-01-04,1005,Nail Polish,50,100,50,2,00265,India
813610,2024-01-04,1012,Body Lotion,200,400,200,2,00265,India
813610,2024-01-04,1002,Mascara,200,400,200,2,00265,India
813610,2024-01-04,1007,Eyeshadow,200,400,200,2,00265,India
218744,2024-01-04,1001,Lipstick,150,300,150,2,00065,India
218744,2024-01-04,1002,Mascara,200,400,200,2,00065,India
560525,2024-01-04,1007,Eyeshadow,200,400,200,2,00203,India
809537,2024-01-04,1007,Eyeshadow,200,400,200,2,00002,India
315787,2024-01-04,1002,Mascara,200,400,200,2,00234,India
326890,2024-01-04,1005,Nail Polish,50,100,50,2,00235,India
326890,2024-01-04,1001,Lipstick,150,300,150,2,00235,India
326890,2024-01-04,1009,Moisturizer,250,500,250,2,00235,India
483229,2024-01-04,1012,Body Lotion,200,400,200,2,00266,India
483229,2024-01-04,1007,Eyeshadow,200,400,200,2,00266,India
483229,2024-01-04,1001,Lipstick,150,300,150,2,00266,India
960752,2024-01-04,1006,Blush,150,300,150,2,00245,India
960752,2024-01-04,1005,Nail Polish,50,100,50,2,00245,India
190008,2024-01-04,1009,Moisturizer,250,500,250,2,00119,India
190008,2024-01-04,1006,Blush,150,300,150,2,00119,India
190008,2024-01-04,1002,Mascara,200,400,200,2,00119,India
190008,2024-01-04,1004,Eyeliner,100,200,100,2,00119,India
588358,2024-01-04,1001,Lipstick,150,300,150,2,00209,India
588358,2024-01-04,1006,Blush,150,300,150,2,00209,India
969439,2024-01-04,1002,Mascara,200,400,200,2,00252,India
969439,2024-01-04,1008,Makeup Remover,80,160,80,2,00252,India
579734,2024-01-04,1002,Mascara,200,400,200,2,00021,India
579734,2024-01-04,1007,Eyeshadow,200,400,200,2,00021,India
579734,2024-01-04,1006,Blush,150,300,150,2,00021,India
558819,2024-01-04,1009,Moisturizer,250,500,250,2,00299,India
558819,2024-01-04,1002,Mascara,200,400,200,2,00299,India
931016,2024-01-04,1006,Blush,150,300,150,2,00156,India
931016,2024-01-04,1008,Makeup Remover,80,160,80,2,00156,India
931016,2024-01-04,1003,Foundation,300,600,300,2,00156,India
851854,2024-01-04,1004,Eyeliner,100,200,100,2,00285,India
851854,2024-01-04,1007,Eyeshadow,200,400,200,2,00285,India
658157,2024-01-04,1004,Eyeliner,100,200,100,2,00455,India
851671,2024-01-04,1008,Makeup Remover,80,160,80,2,00122,India
851671,2024-01-04,1005,Nail Polish,50,100,50,2,00122,India
851671,2024-01-04,1012,Body Lotion,200,400,200,2,00122,India
311600,2024-01-04,1009,Moisturizer,250,500,250,2,00259,India
311600,2024-01-04,1002,Mascara,200,400,200,2,00259,India
941712,2024-01-04,1012,Body Lotion,200,400,200,2,00165,India
469102,2024-01-04,1005,Nail Polish,50,100,50,2,00022,India
469102,2024-01-04,1007,Eyeshadow,200,400,200,2,00022,India
469102,2024-01-04,1012,Body Lotion,200,400,200,2,00022,India
469102,2024-01-04,1008,Makeup Remover,80,160,80,2,00022,India
617867,2024-01-04,1008,Makeup Remover,80,160,80,2,00117,India
488305,2024-01-05,1012,Body Lotion,200,400,200,2,00468,India
488305,2024-01-05,1008,Makeup Remover,80,160,80,2,00468,India
841011,2024-01-05,1001,Lipstick,150,300,150,2,00351,India
841011,2024-01-05,1005,Nail Polish,50,100,50,2,00351,India
841011,2024-01-05,1012,Body Lotion,200,400,200,2,00351,India
720047,2024-01-05,1008,Makeup Remover,80,160,80,2,00112,India
720047,2024-01-05,1002,Mascara,200,400,200,2,00112,India
916047,2024-01-05,1004,Eyeliner,100,200,100,2,00191,India
916047,2024-01-05,1012,Body Lotion,200,400,200,2,00191,India
916047,2024-01-05,1005,Nail Polish,50,100,50,2,00191,India
916047,2024-01-05,1007,Eyeshadow,200,400,200,2,00191,India
853322,2024-01-05,1012,Body Lotion,200,400,200,2,00415,India
828301,2024-01-05,1009,Moisturizer,250,500,250,2,00402,India
828301,2024-01-05,1002,Mascara,200,400,200,2,00402,India
828301,2024-01-05,1006,Blush,150,300,150,2,00402,India
828301,2024-01-05,1007,Eyeshadow,200,400,200,2,00402,India
824847,2024-01-05,1012,Body Lotion,200,400,200,2,00184,India
824847,2024-01-05,1006,Blush,150,300,150,2,00184,India
824847,2024-01-05,1001,Lipstick,150,300,150,2,00184,India
824847,2024-01-05,1009,Moisturizer,250,500,250,2,00184,India
673185,2024-01-05,1012,Body Lotion,200,400,200,2,00320,India
218208,2024-01-05,1001,Lipstick,150,300,150,2,00426,India
218208,2024-01-05,1002,Mascara,200,400,200,2,00426,India
218208,2024-01-05,1007,Eyeshadow,200,400,200,2,00426,India
218208,2024-01-05,1008,Makeup Remover,80,160,80,2,00426,India
329190,2024-01-05,1004,Eyeliner,100,200,100,2,00208,India
329190,2024-01-05,1002,Mascara,200,400,200,2,00208,India
329190,2024-01-05,1008,Makeup Remover,80,160,80,2,00208,India
432381,2024-01-05,1004,Eyeliner,100,200,100,2,00333,India
432381,2024-01-05,1002,Mascara,200,400,200,2,00333,India
214116,2024-01-05,1012,Body Lotion,200,400,200,2,00100,India
261723,2024-01-05,1005,Nail Polish,50,100,50,2,00476,India
402326,2024-01-05,1004,Eyeliner,100,200,100,2,00074,India
402326,2024-01-05,1002,Mascara,200,400,200,2,00074,India
402326,2024-01-05,1008,Makeup Remover,80,160,80,2,00074,India
402326,2024-01-05,1012,Body Lotion,200,400,200,2,00074,India
730962,2024-01-05,1001,Lipstick,150,300,150,2,00026,India
730962,2024-01-05,1008,Makeup Remover,80,160,80,2,00026,India
438296,2024-01-05,1007,Eyeshadow,200,400,200,2,00284,India
438296,2024-01-05,1005,Nail Polish,50,100,50,2,00284,India
438296,2024-01-05,1006,Blush,150,300,150,2,00284,India
438296,2024-01-05,1003,Foundation,300,600,300,2,00284,India
438296,2024-01-05,1012,Body Lotion,200,400,200,2,00284,India
434979,2024-01-05,1004,Eyeliner,100,200,100,2,00061,India
434979,2024-01-05,1006,Blush,150,300,150,2,00061,India
434979,2024-01-05,1012,Body Lotion,200,400,200,2,00061,India
525856,2024-01-05,1005,Nail Polish,50,100,50,2,00065,India
525856,2024-01-05,1004,Eyeliner,100,200,100,2,00065,India
856949,2024-01-05,1005,Nail Polish,50,100,50,2,00355,India
325649,2024-01-05,1012,Body Lotion,200,400,200,2,00199,India
779279,2024-01-05,1004,Eyeliner,100,200,100,2,00046,India
779279,2024-01-05,1012,Body Lotion,200,400,200,2,00046,India
779279,2024-01-05,1002,Mascara,200,400,200,2,00046,India
779279,2024-01-05,1007,Eyeshadow,200,400,200,2,00046,India
483413,2024-01-05,1003,Foundation,300,600,300,2,00286,India
483413,2024-01-05,1004,Eyeliner,100,200,100,2,00286,India
483413,2024-01-05,1001,Lipstick,150,300,150,2,00286,India
483413,2024-01-05,1006,Blush,150,300,150,2,00286,India
483413,2024-01-05,1009,Moisturizer,250,500,250,2,00286,India
750249,2024-01-05,1005,Nail Polish,50,100,50,2,00356,India
750249,2024-01-05,1006,Blush,150,300,150,2,00356,India
346623,2024-01-05,1003,Foundation,300,600,300,2,00060,India
928727,2024-01-05,1007,Eyeshadow,200,400,200,2,00417,India
928727,2024-01-05,1008,Makeup Remover,80,160,80,2,00417,India
833103,2024-01-05,1002,Mascara,200,400,200,2,00300,India
833103,2024-01-05,1012,Body Lotion,200,400,200,2,00300,India
833103,2024-01-05,1008,Makeup Remover,80,160,80,2,00300,India
833103,2024-01-05,1006,Blush,150,300,150,2,00300,India
833103,2024-01-05,1007,Eyeshadow,200,400,200,2,00300,India
124289,2024-01-05,1002,Mascara,200,400,200,2,00263,India
124289,2024-01-05,1004,Eyeliner,100,200,100,2,00263,India
124289,2024-01-05,1007,Eyeshadow,200,400,200,2,00263,India
616430,2024-01-05,1001,Lipstick,150,300,150,2,00258,India
616430,2024-01-05,1009,Moisturizer,250,500,250,2,00258,India
616430,2024-01-05,1005,Nail Polish,50,100,50,2,00258,India
644986,2024-01-05,1009,Moisturizer,250,500,250,2,00225,India
644986,2024-01-05,1004,Eyeliner,100,200,100,2,00225,India
421080,2024-01-05,1003,Foundation,300,600,300,2,00455,India
421080,2024-01-05,1001,Lipstick,150,300,150,2,00455,India
421080,2024-01-05,1004,Eyeliner,100,200,100,2,00455,India
960628,2024-01-05,1007,Eyeshadow,200,400,200,2,00277,India
960628,2024-01-05,1004,Eyeliner,100,200,100,2,00277,India
960628,2024-01-05,1003,Foundation,300,600,300,2,00277,India
251623,2024-01-05,1007,Eyeshadow,200,400,200,2,00058,India
251623,2024-01-05,1005,Nail Polish,50,100,50,2,00058,India
251623,2024-01-05,1004,Eyeliner,100,200,100,2,00058,India
861601,2024-01-05,1002,Mascara,200,400,200,2,00379,India
861601,2024-01-05,1005,Nail Polish,50,100,50,2,00379,India
861601,2024-01-05,1012,Body Lotion,200,400,200,2,00379,India
799453,2024-01-05,1009,Moisturizer,250,500,250,2,00397,India
799453,2024-01-05,1008,Makeup Remover,80,160,80,2,00397,India
799453,2024-01-05,1007,Eyeshadow,200,400,200,2,00397,India
799453,2024-01-05,1002,Mascara,200,400,200,2,00397,India
379232,2024-01-05,1009,Moisturizer,250,500,250,2,00379,India
501037,2024-01-05,1002,Mascara,200,400,200,2,00404,India
501037,2024-01-05,1003,Foundation,300,600,300,2,00404,India
501037,2024-01-05,1008,Makeup Remover,80,160,80,2,00404,India
684722,2024-01-05,1012,Body Lotion,200,400,200,2,00212,India
684722,2024-01-05,1008,Makeup Remover,80,160,80,2,00212,India
684722,2024-01-05,1009,Moisturizer,250,500,250,2,00212,India
684722,2024-01-05,1007,Eyeshadow,200,400,200,2,00212,India
684722,2024-01-05,1002,Mascara,200,400,200,2,00212,India
999578,2024-01-05,1005,Nail Polish,50,100,50,2,00436,India
833172,2024-01-05,1005,Nail Polish,50,100,50,2,00015,India
833172,2024-01-05,1006,Blush,150,300,150,2,00015,India
983090,2024-01-05,1004,Eyeliner,100,200,100,2,00405,India
983090,2024-01-05,1009,Moisturizer,250,500,250,2,00405,India
184115,2024-01-05,1003,Foundation,300,600,300,2,00274,India
184115,2024-01-05,1001,Lipstick,150,300,150,2,00274,India
184115,2024-01-05,1006,Blush,150,300,150,2,00274,India
129495,2024-01-05,1007,Eyeshadow,200,400,200,2,00280,India
129495,2024-01-05,1006,Blush,150,300,150,2,00280,India
129495,2024-01-05,1005,Nail Polish,50,100,50,2,00280,India
318322,2024-01-06,1009,Moisturizer,250,500,250,2,00129,India
318322,2024-01-06,1004,Eyeliner,100,200,100,2,00129,India
882808,2024-01-06,1001,Lipstick,150,300,150,2,00293,India
882808,2024-01-06,1004,Eyeliner,100,200,100,2,00293,India
882808,2024-01-06,1009,Moisturizer,250,500,250,2,00293,India
882808,2024-01-06,1008,Makeup Remover,80,160,80,2,00293,India
132654,2024-01-06,1006,Blush,150,300,150,2,00038,India
132654,2024-01-06,1008,Makeup Remover,80,160,80,2,00038,India
132654,2024-01-06,1003,Foundation,300,600,300,2,00038,India
947923,2024-01-06,1007,Eyeshadow,200,400,200,2,00340,India
947923,2024-01-06,1003,Foundation,300,600,300,2,00340,India
185343,2024-01-06,1002,Mascara,200,400,200,2,00054,India
321764,2024-01-06,1009,Moisturizer,250,500,250,2,00077,India
174674,2024-01-06,1006,Blush,150,300,150,2,00036,India
174674,2024-01-06,1005,Nail Polish,50,100,50,2,00036,India
167987,2024-01-06,1005,Nail Polish,50,100,50,2,00425,India
167987,2024-01-06,1007,Eyeshadow,200,400,200,2,00425,India
167987,2024-01-06,1002,Mascara,200,400,200,2,00425,India
183588,2024-01-06,1009,Moisturizer,250,500,250,2,00392,India
183588,2024-01-06,1007,Eyeshadow,200,400,200,2,00392,India
183588,2024-01-06,1001,Lipstick,150,300,150,2,00392,India
183588,2024-01-06,1003,Foundation,300,600,300,2,00392,India
183588,2024-01-06,1006,Blush,150,300,150,2,00392,India
274070,2024-01-06,1008,Makeup Remover,80,160,80,2,00031,India
274070,2024-01-06,1002,Mascara,200,400,200,2,00031,India
513119,2024-01-06,1003,Foundation,300,600,300,2,00256,India
513119,2024-01-06,1004,Eyeliner,100,200,100,2,00256,India
513119,2024-01-06,1006,Blush,150,300,150,2,00256,India
513119,2024-01-06,1007,Eyeshadow,200,400,200,2,00256,India
513119,2024-01-06,1005,Nail Polish,50,100,50,2,00256,India
971902,2024-01-06,1002,Mascara,200,400,200,2,00137,India
971902,2024-01-06,1001,Lipstick,150,300,150,2,00137,India
861818,2024-01-06,1009,Moisturizer,250,500,250,2,00233,India
760393,2024-01-06,1003,Foundation,300,600,300,2,00001,India
760393,2024-01-06,1009,Moisturizer,250,500,250,2,00001,India
760393,2024-01-06,1008,Makeup Remover,80,160,80,2,00001,India
760393,2024-01-06,1002,Mascara,200,400,200,2,00001,India
201096,2024-01-06,1001,Lipstick,150,300,150,2,00488,India
638653,2024-01-06,1005,Nail Polish,50,100,50,2,00174,India
423949,2024-01-06,1006,Blush,150,300,150,2,00358,India
423949,2024-01-06,1004,Eyeliner,100,200,100,2,00358,India
423949,2024-01-06,1012,Body Lotion,200,400,200,2,00358,India
781644,2024-01-06,1004,Eyeliner,100,200,100,2,00351,India
224081,2024-01-06,1001,Lipstick,150,300,150,2,00110,India
528642,2024-01-06,1012,Body Lotion,200,400,200,2,00067,India
719696,2024-01-06,1005,Nail Polish,50,100,50,2,00444,India
758060,2024-01-06,1003,Foundation,300,600,300,2,00496,India
758060,2024-01-06,1002,Mascara,200,400,200,2,00496,India
758060,2024-01-06,1006,Blush,150,300,150,2,00496,India
517881,2024-01-06,1007,Eyeshadow,200,400,200,2,00188,India
517881,2024-01-06,1008,Makeup Remover,80,160,80,2,00188,India
517881,2024-01-06,1004,Eyeliner,100,200,100,2,00188,India
865175,2024-01-06,1012,Body Lotion,200,400,200,2,00403,India
865175,2024-01-06,1007,Eyeshadow,200,400,200,2,00403,India
865175,2024-01-06,1002,Mascara,200,400,200,2,00403,India
277619,2024-01-06,1012,Body Lotion,200,400,200,2,00343,India
277619,2024-01-06,1009,Moisturizer,250,500,250,2,00343,India
277619,2024-01-06,1006,Blush,150,300,150,2,00343,India
277619,2024-01-06,1008,Makeup Remover,80,160,80,2,00343,India
920155,2024-01-06,1009,Moisturizer,250,500,250,2,00075,India
920155,2024-01-06,1007,Eyeshadow,200,400,200,2,00075,India
920155,2024-01-06,1004,Eyeliner,100,200,100,2,00075,India
807004,2024-01-06,1005,Nail Polish,50,100,50,2,00014,India
306306,2024-01-06,1006,Blush,150,300,150,2,00462,India
881955,2024-01-06,1009,Moisturizer,250,500,250,2,00468,India
881955,2024-01-06,1005,Nail Polish,50,100,50,2,00468,India
881955,2024-01-06,1006,Blush,150,300,150,2,00468,India
881955,2024-01-06,1008,Makeup Remover,80,160,80,2,00468,India
541719,2024-01-06,1006,Blush,150,300,150,2,00170,India
541719,2024-01-06,1012,Body Lotion,200,400,200,2,00170,India
541719,2024-01-06,1003,Foundation,300,600,300,2,00170,India
569671,2024-01-06,1012,Body Lotion,200,400,200,2,00459,India
312620,2024-01-06,1004,Eyeliner,100,200,100,2,00074,India
312620,2024-01-06,1001,Lipstick,150,300,150,2,00074,India
804379,2024-01-06,1002,Mascara,200,400,200,2,00182,India
804379,2024-01-06,1003,Foundation,300,600,300,2,00182,India
493847,2024-01-06,1002,Mascara,200,400,200,2,00035,India
493847,2024-01-06,1007,Eyeshadow,200,400,200,2,00035,India
493847,2024-01-06,1001,Lipstick,150,300,150,2,00035,India
493847,2024-01-06,1009,Moisturizer,250,500,250,2,00035,India
778534,2024-01-07,1002,Mascara,200,400,200,2,00389,India
778534,2024-01-07,1007,Eyeshadow,200,400,200,2,00389,India
778534,2024-01-07,1005,Nail Polish,50,100,50,2,00389,India
778534,2024-01-07,1003,Foundation,300,600,300,2,00389,India
851644,2024-01-07,1001,Lipstick,150,300,150,2,00121,India
851644,2024-01-07,1008,Makeup Remover,80,160,80,2,00121,India
851644,2024-01-07,1005,Nail Polish,50,100,50,2,00121,India
851644,2024-01-07,1006,Blush,150,300,150,2,00121,India
851644,2024-01-07,1003,Foundation,300,600,300,2,00121,India
866718,2024-01-07,1003,Foundation,300,600,300,2,00053,India
875964,2024-01-07,1002,Mascara,200,400,200,2,00389,India
875964,2024-01-07,1009,Moisturizer,250,500,250,2,00389,India
875964,2024-01-07,1004,Eyeliner,100,200,100,2,00389,India
875964,2024-01-07,1006,Blush,150,300,150,2,00389,India
532589,2024-01-07,1007,Eyeshadow,200,400,200,2,00223,India
532589,2024-01-07,1004,Eyeliner,100,200,100,2,00223,India
540034,2024-01-07,1002,Mascara,200,400,200,2,00371,India
540034,2024-01-07,1006,Blush,150,300,150,2,00371,India
540034,2024-01-07,1008,Makeup Remover,80,160,80,2,00371,India
540034,2024-01-07,1012,Body Lotion,200,400,200,2,00371,India
107626,2024-01-07,1012,Body Lotion,200,400,200,2,00149,India
107626,2024-01-07,1006,Blush,150,300,150,2,00149,India
107626,2024-01-07,1002,Mascara,200,400,200,2,00149,India
640819,2024-01-07,1008,Makeup Remover,80,160,80,2,00201,India
640819,2024-01-07,1001,Lipstick,150,300,150,2,00201,India
640819,2024-01-07,1002,Mascara,200,400,200,2,00201,India
276360,2024-01-07,1007,Eyeshadow,200,400,200,2,00039,India
276360,2024-01-07,1002,Mascara,200,400,200,2,00039,India
276360,2024-01-07,1009,Moisturizer,250,500,250,2,00039,India
882885,2024-01-07,1008,Makeup Remover,80,160,80,2,00014,India
882885,2024-01-07,1006,Blush,150,300,150,2,00014,India
882885,2024-01-07,1009,Moisturizer,250,500,250,2,00014,India
346220,2024-01-07,1012,Body Lotion,200,400,200,2,00025,India
346220,2024-01-07,1001,Lipstick,150,300,150,2,00025,India
346220,2024-01-07,1004,Eyeliner,100,200,100,2,00025,India
346220,2024-01-07,1006,Blush,150,300,150,2,00025,India
269631,2024-01-07,1008,Makeup Remover,80,160,80,2,00006,India
269631,2024-01-07,1001,Lipstick,150,300,150,2,00006,India
544433,2024-01-07,1006,Blush,150,300,150,2,00413,India
544433,2024-01-07,1008,Makeup Remover,80,160,80,2,00413,India
363560,2024-01-07,1001,Lipstick,150,300,150,2,00451,India
363560,2024-01-07,1009,Moisturizer,250,500,250,2,00451,India
527663,2024-01-07,1002,Mascara,200,400,200,2,00095,India
527663,2024-01-07,1006,Blush,150,300,150,2,00095,India
527663,2024-01-07,1008,Makeup Remover,80,160,80,2,00095,India
105383,2024-01-07,1007,Eyeshadow,200,400,200,2,00425,India
105383,2024-01-07,1012,Body Lotion,200,400,200,2,00425,India
105383,2024-01-07,1009,Moisturizer,250,500,250,2,00425,India
105383,2024-01-07,1002,Mascara,200,400,200,2,00425,India
105383,2024-01-07,1004,Eyeliner,100,200,100,2,00425,India
618465,2024-01-07,1001,Lipstick,150,300,150,2,00495,India
618465,2024-01-07,1009,Moisturizer,250,500,250,2,00495,India
618465,2024-01-07,1006,Blush,150,300,150,2,00495,India
618465,2024-01-07,1005,Nail Polish,50,100,50,2,00495,India
758027,2024-01-07,1004,Eyeliner,100,200,100,2,00049,India
758027,2024-01-07,1001,Lipstick,150,300,150,2,00049,India
838931,2024-01-07,1012,Body Lotion,200,400,200,2,00014,India
838931,2024-01-07,1005,Nail Polish,50,100,50,2,00014,India
838931,2024-01-07,1008,Makeup Remover,80,160,80,2,00014,India
270013,2024-01-07,1009,Moisturizer,250,500,250,2,00007,India
270013,2024-01-07,1005,Nail Polish,50,100,50,2,00007,India
423576,2024-01-07,1003,Foundation,300,600,300,2,00341,India
423576,2024-01-07,1007,Eyeshadow,200,400,200,2,00341,India
423576,2024-01-07,1008,Makeup Remover,80,160,80,2,00341,India
715695,2024-01-07,1008,Makeup Remover,80,160,80,2,00380,India
715695,2024-01-07,1007,Eyeshadow,200,400,200,2,00380,India
715695,2024-01-07,1002,Mascara,200,400,200,2,00380,India
365023,2024-01-07,1012,Body Lotion,200,400,200,2,00277,India
119747,2024-01-07,1007,Eyeshadow,200,400,200,2,00464,India
119747,2024-01-07,1006,Blush,150,300,150,2,00464,India
119747,2024-01-07,1012,Body Lotion,200,400,200,2,00464,India
545839,2024-01-07,1003,Foundation,300,600,300,2,00330,India
545839,2024-01-07,1001,Lipstick,150,300,150,2,00330,India
545839,2024-01-07,1007,Eyeshadow,200,400,200,2,00330,India
216417,2024-01-07,1004,Eyeliner,100,200,100,2,00272,India
216417,2024-01-07,1002,Mascara,200,400,200,2,00272,India
216417,2024-01-07,1007,Eyeshadow,200,400,200,2,00272,India
216417,2024-01-07,1005,Nail Polish,50,100,50,2,00272,India
929773,2024-01-07,1004,Eyeliner,100,200,100,2,00155,India
929773,2024-01-07,1008,Makeup Remover,80,160,80,2,00155,India
929773,2024-01-07,1012,Body Lotion,200,400,200,2,00155,India
929773,2024-01-07,1007,Eyeshadow,200,400,200,2,00155,India
105508,2024-01-07,1006,Blush,150,300,150,2,00353,India
105508,2024-01-07,1005,Nail Polish,50,100,50,2,00353,India
105508,2024-01-07,1009,Moisturizer,250,500,250,2,00353,India
105508,2024-01-07,1012,Body Lotion,200,400,200,2,00353,India
839942,2024-01-07,1009,Moisturizer,250,500,250,2,00344,India
579098,2024-01-07,1006,Blush,150,300,150,2,00001,India
579098,2024-01-07,1005,Nail Polish,50,100,50,2,00001,India
277075,2024-01-07,1001,Lipstick,150,300,150,2,00094,India
277075,2024-01-07,1002,Mascara,200,400,200,2,00094,India
277075,2024-01-07,1004,Eyeliner,100,200,100,2,00094,India
277075,2024-01-07,1012,Body Lotion,200,400,200,2,00094,India
516087,2024-01-07,1005,Nail Polish,50,100,50,2,00178,India
516087,2024-01-07,1008,Makeup Remover,80,160,80,2,00178,India
516087,2024-01-07,1007,Eyeshadow,200,400,200,2,00178,India
516087,2024-01-07,1002,Mascara,200,400,200,2,00178,India
861872,2024-01-07,1006,Blush,150,300,150,2,00483,India
861872,2024-01-07,1009,Moisturizer,250,500,250,2,00483,India
861872,2024-01-07,1008,Makeup Remover,80,160,80,2,00483,India
861872,2024-01-07,1005,Nail Polish,50,100,50,2,00483,India
167752,2024-01-07,1002,Mascara,200,400,200,2,00376,India
167752,2024-01-07,1008,Makeup Remover,80,160,80,2,00376,India
167752,2024-01-07,1003,Foundation,300,600,300,2,00376,India
133317,2024-01-07,1006,Blush,150,300,150,2,00490,India
133317,2024-01-07,1005,Nail Polish,50,100,50,2,00490,India
243590,2024-01-07,1008,Makeup Remover,80,160,80,2,00488,India
243590,2024-01-07,1003,Foundation,300,600,300,2,00488,India
243590,2024-01-07,1002,Mascara,200,400,200,2,00488,India
243590,2024-01-07,1004,Eyeliner,100,200,100,2,00488,India
470105,2024-01-07,1003,Foundation,300,600,300,2,00394,India
470105,2024-01-07,1009,Moisturizer,250,500,250,2,00394,India
576704,2024-01-07,1002,Mascara,200,400,200,2,00003,India
576704,2024-01-07,1012,Body Lotion,200,400,200,2,00003,India
459822,2024-01-07,1004,Eyeliner,100,200,100,2,00404,India
459822,2024-01-07,1002,Mascara,200,400,200,2,00404,India
133719,2024-01-07,1003,Foundation,300,600,300,2,00346,India
128848,2024-01-07,1001,Lipstick,150,300,150,2,00121,India
102418,2024-01-07,1007,Eyeshadow,200,400,200,2,00140,India
214683,2024-01-07,1004,Eyeliner,100,200,100,2,00229,India
214683,2024-01-07,1012,Body Lotion,200,400,200,2,00229,India
214683,2024-01-07,1003,Foundation,300,600,300,2,00229,India
925961,2024-01-07,1012,Body Lotion,200,400,200,2,00051,India
925961,2024-01-07,1001,Lipstick,150,300,150,2,00051,India
925961,2024-01-07,1003,Foundation,300,600,300,2,00051,India
438004,2024-01-07,1005,Nail Polish,50,100,50,2,00422,India
438004,2024-01-07,1004,Eyeliner,100,200,100,2,00422,India
438004,2024-01-07,1002,Mascara,200,400,200,2,00422,India
438004,2024-01-07,1008,Makeup Remover,80,160,80,2,00422,India
438004,2024-01-07,1003,Foundation,300,600,300,2,00422,India
704301,2024-01-08,1001,Lipstick,150,300,150,2,00104,India
704301,2024-01-08,1004,Eyeliner,100,200,100,2,00104,India
704301,2024-01-08,1006,Blush,150,300,150,2,00104,India
530825,2024-01-08,1009,Moisturizer,250,500,250,2,00372,India
772854,2024-01-08,1012,Body Lotion,200,400,200,2,00470,India
595220,2024-01-08,1005,Nail Polish,50,100,50,2,00105,India
595220,2024-01-08,1004,Eyeliner,100,200,100,2,00105,India
233871,2024-01-08,1007,Eyeshadow,200,400,200,2,00151,India
233871,2024-01-08,1009,Moisturizer,250,500,250,2,00151,India
943765,2024-01-08,1001,Lipstick,150,300,150,2,00180,India
943765,2024-01-08,1007,Eyeshadow,200,400,200,2,00180,India
263159,2024-01-08,1012,Body Lotion,200,400,200,2,00372,India
419987,2024-01-08,1007,Eyeshadow,200,400,200,2,00276,India
419987,2024-01-08,1004,Eyeliner,100,200,100,2,00276,India
419987,2024-01-08,1001,Lipstick,150,300,150,2,00276,India
419987,2024-01-08,1008,Makeup Remover,80,160,80,2,00276,India
812881,2024-01-08,1007,Eyeshadow,200,400,200,2,00129,India
812881,2024-01-08,1001,Lipstick,150,300,150,2,00129,India
812881,2024-01-08,1005,Nail Polish,50,100,50,2,00129,India
708373,2024-01-08,1001,Lipstick,150,300,150,2,00421,India
708373,2024-01-08,1007,Eyeshadow,200,400,200,2,00421,India
944087,2024-01-08,1005,Nail Polish,50,100,50,2,00165,India
579939,2024-01-08,1007,Eyeshadow,200,400,200,2,00420,India
579939,2024-01-08,1001,Lipstick,150,300,150,2,00420,India
579939,2024-01-08,1003,Foundation,300,600,300,2,00420,India
579939,2024-01-08,1006,Blush,150,300,150,2,00420,India
265421,2024-01-08,1005,Nail Polish,50,100,50,2,00337,India
265421,2024-01-08,1012,Body Lotion,200,400,200,2,00337,India
719613,2024-01-08,1007,Eyeshadow,200,400,200,2,00293,India
719613,2024-01-08,1002,Mascara,200,400,200,2,00293,India
719613,2024-01-08,1003,Foundation,300,600,300,2,00293,India
719613,2024-01-08,1001,Lipstick,150,300,150,2,00293,India
719613,2024-01-08,1005,Nail Polish,50,100,50,2,00293,India
393378,2024-01-08,1005,Nail Polish,50,100,50,2,00467,India
393378,2024-01-08,1004,Eyeliner,100,200,100,2,00467,India
393378,2024-01-08,1009,Moisturizer,250,500,250,2,00467,India
393378,2024-01-08,1008,Makeup Remover,80,160,80,2,00467,India
295374,2024-01-08,1006,Blush,150,300,150,2,00037,India
295374,2024-01-08,1003,Foundation,300,600,300,2,00037,India
511751,2024-01-08,1003,Foundation,300,600,300,2,00218,India
517558,2024-01-08,1012,Body Lotion,200,400,200,2,00337,India
392816,2024-01-08,1005,Nail Polish,50,100,50,2,00452,India
392816,2024-01-08,1004,Eyeliner,100,200,100,2,00452,India
392816,2024-01-08,1007,Eyeshadow,200,400,200,2,00452,India
846061,2024-01-08,1012,Body Lotion,200,400,200,2,00048,India
846061,2024-01-08,1005,Nail Polish,50,100,50,2,00048,India
846061,2024-01-08,1003,Foundation,300,600,300,2,00048,India
846061,2024-01-08,1001,Lipstick,150,300,150,2,00048,India
846061,2024-01-08,1002,Mascara,200,400,200,2,00048,India
427557,2024-01-08,1009,Moisturizer,250,500,250,2,00245,India
427557,2024-01-08,1003,Foundation,300,600,300,2,00245,India
898355,2024-01-08,1002,Mascara,200,400,200,2,00105,India
861584,2024-01-08,1006,Blush,150,300,150,2,00457,India
861584,2024-01-08,1009,Moisturizer,250,500,250,2,00457,India
861584,2024-01-08,1005,Nail Polish,50,100,50,2,00457,India
333173,2024-01-08,1002,Mascara,200,400,200,2,00350,India
345411,2024-01-08,1002,Mascara,200,400,200,2,00178,India
345411,2024-01-08,1012,Body Lotion,200,400,200,2,00178,India
345411,2024-01-08,1005,Nail Polish,50,100,50,2,00178,India
292055,2024-01-08,1004,Eyeliner,100,200,100,2,00171,India
125886,2024-01-08,1009,Moisturizer,250,500,250,2,00265,India
882216,2024-01-08,1005,Nail Polish,50,100,50,2,00275,India
841822,2024-01-08,1007,Eyeshadow,200,400,200,2,00065,India
841822,2024-01-08,1002,Mascara,200,400,200,2,00065,India
841822,2024-01-08,1001,Lipstick,150,300,150,2,00065,India
841822,2024-01-08,1012,Body Lotion,200,400,200,2,00065,India
293452,2024-01-08,1002,Mascara,200,400,200,2,00282,India
293452,2024-01-08,1005,Nail Polish,50,100,50,2,00282,India
293452,2024-01-08,1001,Lipstick,150,300,150,2,00282,India
412693,2024-01-08,1005,Nail Polish,50,100,50,2,00242,India
412693,2024-01-08,1007,Eyeshadow,200,400,200,2,00242,India
412693,2024-01-08,1002,Mascara,200,400,200,2,00242,India
997372,2024-01-08,1004,Eyeliner,100,200,100,2,00247,India
997372,2024-01-08,1003,Foundation,300,600,300,2,00247,India
997372,2024-01-08,1008,Makeup Remover,80,160,80,2,00247,India
306769,2024-01-08,1007,Eyeshadow,200,400,200,2,00310,India
306769,2024-01-08,1005,Nail Polish,50,100,50,2,00310,India
306769,2024-01-08,1008,Makeup Remover,80,160,80,2,00310,India
122240,2024-01-08,1001,Lipstick,150,300,150,2,00439,India
122240,2024-01-08,1008,Makeup Remover,80,160,80,2,00439,India
122240,2024-01-08,1006,Blush,150,300,150,2,00439,India
944066,2024-01-08,1005,Nail Polish,50,100,50,2,00292,India
944066,2024-01-08,1006,Blush,150,300,150,2,00292,India
944066,2024-01-08,1001,Lipstick,150,300,150,2,00292,India
334421,2024-01-09,1007,Eyeshadow,200,400,200,2,00308,India
853067,2024-01-09,1002,Mascara,200,400,200,2,00377,India
695551,2024-01-09,1007,Eyeshadow,200,400,200,2,00453,India
695551,2024-01-09,1004,Eyeliner,100,200,100,2,00453,India
695551,2024-01-09,1001,Lipstick,150,300,150,2,00453,India
695551,2024-01-09,1002,Mascara,200,400,200,2,00453,India
906527,2024-01-09,1008,Makeup Remover,80,160,80,2,00017,India
906527,2024-01-09,1004,Eyeliner,100,200,100,2,00017,India
771412,2024-01-09,1006,Blush,150,300,150,2,00107,India
771412,2024-01-09,1004,Eyeliner,100,200,100,2,00107,India
771412,2024-01-09,1009,Moisturizer,250,500,250,2,00107,India
311397,2024-01-09,1012,Body Lotion,200,400,200,2,00352,India
311397,2024-01-09,1001,Lipstick,150,300,150,2,00352,India
318514,2024-01-09,1008,Makeup Remover,80,160,80,2,00392,India
318514,2024-01-09,1003,Foundation,300,600,300,2,00392,India
986717,2024-01-09,1009,Moisturizer,250,500,250,2,00357,India
986717,2024-01-09,1001,Lipstick,150,300,150,2,00357,India
986717,2024-01-09,1006,Blush,150,300,150,2,00357,India
986717,2024-01-09,1012,Body Lotion,200,400,200,2,00357,India
126183,2024-01-09,1002,Mascara,200,400,200,2,00025,India
446568,2024-01-09,1002,Mascara,200,400,200,2,00315,India
446568,2024-01-09,1012,Body Lotion,200,400,200,2,00315,India
446568,2024-01-09,1001,Lipstick,150,300,150,2,00315,India
748608,2024-01-09,1007,Eyeshadow,200,400,200,2,00039,India
218547,2024-01-09,1001,Lipstick,150,300,150,2,00061,India
218547,2024-01-09,1006,Blush,150,300,150,2,00061,India
950427,2024-01-09,1005,Nail Polish,50,100,50,2,00354,India
950427,2024-01-09,1012,Body Lotion,200,400,200,2,00354,India
950427,2024-01-09,1003,Foundation,300,600,300,2,00354,India
430656,2024-01-09,1001,Lipstick,150,300,150,2,00177,India
430656,2024-01-09,1003,Foundation,300,600,300,2,00177,India
407581,2024-01-09,1008,Makeup Remover,80,160,80,2,00047,India
958168,2024-01-09,1012,Body Lotion,200,400,200,2,00130,India
376102,2024-01-09,1012,Body Lotion,200,400,200,2,00259,India
376102,2024-01-09,1001,Lipstick,150,300,150,2,00259,India
376102,2024-01-09,1006,Blush,150,300,150,2,00259,India
376102,2024-01-09,1003,Foundation,300,600,300,2,00259,India
437391,2024-01-09,1002,Mascara,200,400,200,2,00026,India
182422,2024-01-09,1002,Mascara,200,400,200,2,00188,India
280139,2024-01-09,1007,Eyeshadow,200,400,200,2,00068,India
280139,2024-01-09,1009,Moisturizer,250,500,250,2,00068,India
280139,2024-01-09,1002,Mascara,200,400,200,2,00068,India
578312,2024-01-09,1001,Lipstick,150,300,150,2,00434,India
578312,2024-01-09,1008,Makeup Remover,80,160,80,2,00434,India
578312,2024-01-09,1012,Body Lotion,200,400,200,2,00434,India
578312,2024-01-09,1002,Mascara,200,400,200,2,00434,India
708533,2024-01-09,1009,Moisturizer,250,500,250,2,00349,India
708533,2024-01-09,1004,Eyeliner,100,200,100,2,00349,India
708533,2024-01-09,1002,Mascara,200,400,200,2,00349,India
708533,2024-01-09,1012,Body Lotion,200,400,200,2,00349,India
176095,2024-01-09,1007,Eyeshadow,200,400,200,2,00437,India
176095,2024-01-09,1003,Foundation,300,600,300,2,00437,India
249216,2024-01-09,1004,Eyeliner,100,200,100,2,00009,India
249216,2024-01-09,1009,Moisturizer,250,500,250,2,00009,India
249216,2024-01-09,1008,Makeup Remover,80,160,80,2,00009,India
249216,2024-01-09,1001,Lipstick,150,300,150,2,00009,India
228770,2024-01-09,1002,Mascara,200,400,200,2,00347,India
228770,2024-01-09,1012,Body Lotion,200,400,200,2,00347,India
228770,2024-01-09,1009,Moisturizer,250,500,250,2,00347,India
228770,2024-01-09,1001,Lipstick,150,300,150,2,00347,India
242318,2024-01-09,1001,Lipstick,150,300,150,2,00206,India
242318,2024-01-09,1009,Moisturizer,250,500,250,2,00206,India
242318,2024-01-09,1012,Body Lotion,200,400,200,2,00206,India
534797,2024-01-09,1001,Lipstick,150,300,150,2,00236,India
534797,2024-01-09,1006,Blush,150,300,150,2,00236,India
534797,2024-01-09,1003,Foundation,300,600,300,2,00236,India
552652,2024-01-09,1003,Foundation,300,600,300,2,00341,India
602860,2024-01-09,1003,Foundation,300,600,300,2,00071,India
368186,2024-01-09,1001,Lipstick,150,300,150,2,00441,India
368186,2024-01-09,1003,Foundation,300,600,300,2,00441,India
368186,2024-01-09,1005,Nail Polish,50,100,50,2,00441,India
368186,2024-01-09,1012,Body Lotion,200,400,200,2,00441,India
368186,2024-01-09,1002,Mascara,200,400,200,2,00441,India
100747,2024-01-09,1009,Moisturizer,250,500,250,2,00178,India
100747,2024-01-09,1002,Mascara,200,400,200,2,00178,India
213405,2024-01-09,1009,Moisturizer,250,500,250,2,00014,India
213405,2024-01-09,1006,Blush,150,300,150,2,00014,India
213405,2024-01-09,1002,Mascara,200,400,200,2,00014,India
969902,2024-01-09,1005,Nail Polish,50,100,50,2,00182,India
969902,2024-01-09,1009,Moisturizer,250,500,250,2,00182,India
969902,2024-01-09,1001,Lipstick,150,300,150,2,00182,India
820076,2024-01-09,1007,Eyeshadow,200,400,200,2,00337,India
933828,2024-01-09,1003,Foundation,300,600,300,2,00153,India
707611,2024-01-09,1004,Eyeliner,100,200,100,2,00200,India
707611,2024-01-09,1002,Mascara,200,400,200,2,00200,India
737433,2024-01-09,1012,Body Lotion,200,400,200,2,00329,India
737433,2024-01-09,1008,Makeup Remover,80,160,80,2,00329,India
737433,2024-01-09,1001,Lipstick,150,300,150,2,00329,India
563655,2024-01-09,1003,Foundation,300,600,300,2,00042,India
563655,2024-01-09,1007,Eyeshadow,200,400,200,2,00042,India
664085,2024-01-09,1003,Foundation,300,600,300,2,00304,India
664085,2024-01-09,1012,Body Lotion,200,400,200,2,00304,India
664085,2024-01-09,1001,Lipstick,150,300,150,2,00304,India
664085,2024-01-09,1007,Eyeshadow,200,400,200,2,00304,India
423051,2024-01-09,1012,Body Lotion,200,400,200,2,00252,India
423051,2024-01-09,1001,Lipstick,150,300,150,2,00252,India
423051,2024-01-09,1002,Mascara,200,400,200,2,00252,India
423051,2024-01-09,1004,Eyeliner,100,200,100,2,00252,India
794356,2024-01-09,1009,Moisturizer,250,500,250,2,00407,India
489908,2024-01-09,1002,Mascara,200,400,200,2,00222,India
489908,2024-01-09,1006,Blush,150,300,150,2,00222,India
489908,2024-01-09,1005,Nail Polish,50,100,50,2,00222,India
489908,2024-01-09,1009,Moisturizer,250,500,250,2,00222,India
250804,2024-01-09,1001,Lipstick,150,300,150,2,00037,India
250804,2024-01-09,1009,Moisturizer,250,500,250,2,00037,India
250804,2024-01-09,1007,Eyeshadow,200,400,200,2,00037,India
511684,2024-01-09,1008,Makeup Remover,80,160,80,2,00392,India
511684,2024-01-09,1004,Eyeliner,100,200,100,2,00392,India
511684,2024-01-09,1005,Nail Polish,50,100,50,2,00392,India
511684,2024-01-09,1006,Blush,150,300,150,2,00392,India
511684,2024-01-09,1012,Body Lotion,200,400,200,2,00392,India
269075,2024-01-10,1008,Makeup Remover,80,160,80,2,00024,India
269075,2024-01-10,1004,Eyeliner,100,200,100,2,00024,India
269075,2024-01-10,1012,Body Lotion,200,400,200,2,00024,India
390135,2024-01-10,1003,Foundation,300,600,300,2,00390,India
390135,2024-01-10,1005,Nail Polish,50,100,50,2,00390,India
496045,2024-01-10,1005,Nail Polish,50,100,50,2,00478,India
548364,2024-01-10,1007,Eyeshadow,200,400,200,2,00021,India
548364,2024-01-10,1004,Eyeliner,100,200,100,2,00021,India
548364,2024-01-10,1001,Lipstick,150,300,150,2,00021,India
922694,2024-01-10,1003,Foundation,300,600,300,2,00174,India
922694,2024-01-10,1006,Blush,150,300,150,2,00174,India
921077,2024-01-10,1002,Mascara,200,400,200,2,00098,India
921077,2024-01-10,1005,Nail Polish,50,100,50,2,00098,India
117518,2024-01-10,1008,Makeup Remover,80,160,80,2,00157,India
117518,2024-01-10,1009,Moisturizer,250,500,250,2,00157,India
117518,2024-01-10,1002,Mascara,200,400,200,2,00157,India
117518,2024-01-10,1001,Lipstick,150,300,150,2,00157,India
157616,2024-01-10,1007,Eyeshadow,200,400,200,2,00040,India
157616,2024-01-10,1003,Foundation,300,600,300,2,00040,India
536038,2024-01-10,1008,Makeup Remover,80,160,80,2,00364,India
536038,2024-01-10,1012,Body Lotion,200,400,200,2,00364,India
536038,2024-01-10,1005,Nail Polish,50,100,50,2,00364,India
536038,2024-01-10,1002,Mascara,200,400,200,2,00364,India
536038,2024-01-10,1001,Lipstick,150,300,150,2,00364,India
515234,2024-01-10,1009,Moisturizer,250,500,250,2,00414,India
515234,2024-01-10,1006,Blush,150,300,150,2,00414,India
515234,2024-01-10,1005,Nail Polish,50,100,50,2,00414,India
515234,2024-01-10,1004,Eyeliner,100,200,100,2,00414,India
228159,2024-01-10,1006,Blush,150,300,150,2,00318,India
228159,2024-01-10,1008,Makeup Remover,80,160,80,2,00318,India
228159,2024-01-10,1003,Foundation,300,600,300,2,00318,India
228159,2024-01-10,1012,Body Lotion,200,400,200,2,00318,India
228159,2024-01-10,1001,Lipstick,150,300,150,2,00318,India
748524,2024-01-10,1005,Nail Polish,50,100,50,2,00270,India
791247,2024-01-10,1009,Moisturizer,250,500,250,2,00079,India
791247,2024-01-10,1002,Mascara,200,400,200,2,00079,India
791247,2024-01-10,1004,Eyeliner,100,200,100,2,00079,India
791247,2024-01-10,1003,Foundation,300,600,300,2,00079,India
872867,2024-01-10,1006,Blush,150,300,150,2,00301,India
872867,2024-01-10,1001,Lipstick,150,300,150,2,00301,India
721799,2024-01-10,1007,Eyeshadow,200,400,200,2,00101,India
721799,2024-01-10,1012,Body Lotion,200,400,200,2,00101,India
721799,2024-01-10,1001,Lipstick,150,300,150,2,00101,India
444256,2024-01-10,1009,Moisturizer,250,500,250,2,00248,India
444256,2024-01-10,1012,Body Lotion,200,400,200,2,00248,India
184869,2024-01-10,1003,Foundation,300,600,300,2,00405,India
184869,2024-01-10,1006,Blush,150,300,150,2,00405,India
107758,2024-01-10,1004,Eyeliner,100,200,100,2,00170,India
107758,2024-01-10,1009,Moisturizer,250,500,250,2,00170,India
504112,2024-01-10,1002,Mascara,200,400,200,2,00345,India
504112,2024-01-10,1006,Blush,150,300,150,2,00345,India
403990,2024-01-10,1008,Makeup Remover,80,160,80,2,00199,India
403990,2024-01-10,1009,Moisturizer,250,500,250,2,00199,India
769863,2024-01-10,1007,Eyeshadow,200,400,200,2,00459,India
769863,2024-01-10,1004,Eyeliner,100,200,100,2,00459,India
769863,2024-01-10,1001,Lipstick,150,300,150,2,00459,India
769863,2024-01-10,1009,Moisturizer,250,500,250,2,00459,India
283850,2024-01-10,1008,Makeup Remover,80,160,80,2,00411,India
283850,2024-01-10,1009,Moisturizer,250,500,250,2,00411,India
749585,2024-01-10,1009,Moisturizer,250,500,250,2,00412,India
749585,2024-01-10,1007,Eyeshadow,200,400,200,2,00412,India
267366,2024-01-10,1009,Moisturizer,250,500,250,2,00372,India
267366,2024-01-10,1006,Blush,150,300,150,2,00372,India
267366,2024-01-10,1001,Lipstick,150,300,150,2,00372,India
267366,2024-01-10,1004,Eyeliner,100,200,100,2,00372,India
267366,2024-01-10,1008,Makeup Remover,80,160,80,2,00372,India
112458,2024-01-10,1001,Lipstick,150,300,150,2,00157,India
112458,2024-01-10,1002,Mascara,200,400,200,2,00157,India
107774,2024-01-10,1004,Eyeliner,100,200,100,2,00062,India
107774,2024-01-10,1002,Mascara,200,400,200,2,00062,India
107774,2024-01-10,1012,Body Lotion,200,400,200,2,00062,India
502545,2024-01-10,1005,Nail Polish,50,100,50,2,00273,India
502545,2024-01-10,1012,Body Lotion,200,400,200,2,00273,India
768711,2024-01-10,1002,Mascara,200,400,200,2,00320,India
768711,2024-01-10,1006,Blush,150,300,150,2,00320,India
768711,2024-01-10,1008,Makeup Remover,80,160,80,2,00320,India
768711,2024-01-10,1005,Nail Polish,50,100,50,2,00320,India
768711,2024-01-10,1001,Lipstick,150,300,150,2,00320,India
102640,2024-01-10,1012,Body Lotion,200,400,200,2,00017,India
102640,2024-01-10,1007,Eyeshadow,200,400,200,2,00017,India
102640,2024-01-10,1009,Moisturizer,250,500,250,2,00017,India
698845,2024-01-10,1006,Blush,150,300,150,2,00203,India
698845,2024-01-10,1012,Body Lotion,200,400,200,2,00203,India
778937,2024-01-10,1002,Mascara,200,400,200,2,00306,India
778937,2024-01-10,1009,Moisturizer,250,500,250,2,00306,India
778937,2024-01-10,1006,Blush,150,300,150,2,00306,India
548413,2024-01-10,1003,Foundation,300,600,300,2,00221,India
548413,2024-01-10,1012,Body Lotion,200,400,200,2,00221,India
548413,2024-01-10,1009,Moisturizer,250,500,250,2,00221,India
548413,2024-01-10,1005,Nail Polish,50,100,50,2,00221,India
792626,2024-01-10,1009,Moisturizer,250,500,250,2,00476,India
792626,2024-01-10,1006,Blush,150,300,150,2,00476,India
792626,2024-01-10,1005,Nail Polish,50,100,50,2,00476,India
853728,2024-01-10,1006,Blush,150,300,150,2,00123,India
119196,2024-01-10,1002,Mascara,200,400,200,2,00175,India
119196,2024-01-10,1009,Moisturizer,250,500,250,2,00175,India
119196,2024-01-10,1007,Eyeshadow,200,400,200,2,00175,India
119196,2024-01-10,1006,Blush,150,300,150,2,00175,India
639256,2024-01-10,1009,Moisturizer,250,500,250,2,00403,India
639256,2024-01-10,1001,Lipstick,150,300,150,2,00403,India
639256,2024-01-10,1012,Body Lotion,200,400,200,2,00403,India
639256,2024-01-10,1004,Eyeliner,100,200,100,2,00403,India
958657,2024-01-10,1012,Body Lotion,200,400,200,2,00292,India
958657,2024-01-10,1004,Eyeliner,100,200,100,2,00292,India
958657,2024-01-10,1002,Mascara,200,400,200,2,00292,India
958657,2024-01-10,1001,Lipstick,150,300,150,2,00292,India
712103,2024-01-10,1004,Eyeliner,100,200,100,2,00147,India
712103,2024-01-10,1009,Moisturizer,250,500,250,2,00147,India
712103,2024-01-10,1005,Nail Polish,50,100,50,2,00147,India
712103,2024-01-10,1003,Foundation,300,600,300,2,00147,India
632358,2024-01-10,1004,Eyeliner,100,200,100,2,00215,India
632358,2024-01-10,1006,Blush,150,300,150,2,00215,India
632358,2024-01-10,1007,Eyeshadow,200,400,200,2,00215,India
632358,2024-01-10,1008,Makeup Remover,80,160,80,2,00215,India
632358,2024-01-10,1012,Body Lotion,200,400,200,2,00215,India
609904,2024-01-10,1002,Mascara,200,400,200,2,00373,India
609904,2024-01-10,1008,Makeup Remover,80,160,80,2,00373,India
609904,2024-01-10,1007,Eyeshadow,200,400,200,2,00373,India
609904,2024-01-10,1012,Body Lotion,200,400,200,2,00373,India
271034,2024-01-11,1008,Makeup Remover,80,160,80,2,00275,India
271034,2024-01-11,1001,Lipstick,150,300,150,2,00275,India
271034,2024-01-11,1003,Foundation,300,600,300,2,00275,India
840545,2024-01-11,1004,Eyeliner,100,200,100,2,00321,India
840545,2024-01-11,1008,Makeup Remover,80,160,80,2,00321,India
840545,2024-01-11,1006,Blush,150,300,150,2,00321,India
512896,2024-01-11,1008,Makeup Remover,80,160,80,2,00105,India
512896,2024-01-11,1005,Nail Polish,50,100,50,2,00105,India
512896,2024-01-11,1002,Mascara,200,400,200,2,00105,India
754662,2024-01-11,1002,Mascara,200,400,200,2,00275,India
754662,2024-01-11,1005,Nail Polish,50,100,50,2,00275,India
754662,2024-01-11,1006,Blush,150,300,150,2,00275,India
117711,2024-01-11,1002,Mascara,200,400,200,2,00019,India
117711,2024-01-11,1008,Makeup Remover,80,160,80,2,00019,India
759151,2024-01-11,1009,Moisturizer,250,500,250,2,00195,India
759151,2024-01-11,1003,Foundation,300,600,300,2,00195,India
759151,2024-01-11,1002,Mascara,200,400,200,2,00195,India
759151,2024-01-11,1012,Body Lotion,200,400,200,2,00195,India
313814,2024-01-11,1003,Foundation,300,600,300,2,00371,India
313814,2024-01-11,1007,Eyeshadow,200,400,200,2,00371,India
313814,2024-01-11,1006,Blush,150,300,150,2,00371,India
336715,2024-01-11,1007,Eyeshadow,200,400,200,2,00373,India
350857,2024-01-11,1012,Body Lotion,200,400,200,2,00374,India
421696,2024-01-11,1004,Eyeliner,100,200,100,2,00490,India
806853,2024-01-11,1008,Makeup Remover,80,160,80,2,00391,India
806853,2024-01-11,1009,Moisturizer,250,500,250,2,00391,India
709604,2024-01-11,1005,Nail Polish,50,100,50,2,00369,India
709604,2024-01-11,1001,Lipstick,150,300,150,2,00369,India
709604,2024-01-11,1008,Makeup Remover,80,160,80,2,00369,India
709604,2024-01-11,1004,Eyeliner,100,200,100,2,00369,India
656068,2024-01-11,1009,Moisturizer,250,500,250,2,00400,India
264304,2024-01-11,1006,Blush,150,300,150,2,00498,India
264304,2024-01-11,1004,Eyeliner,100,200,100,2,00498,India
264304,2024-01-11,1007,Eyeshadow,200,400,200,2,00498,India
347672,2024-01-11,1012,Body Lotion,200,400,200,2,00013,India
732928,2024-01-11,1009,Moisturizer,250,500,250,2,00447,India
732928,2024-01-11,1004,Eyeliner,100,200,100,2,00447,India
469865,2024-01-11,1012,Body Lotion,200,400,200,2,00019,India
469865,2024-01-11,1008,Makeup Remover,80,160,80,2,00019,India
469865,2024-01-11,1002,Mascara,200,400,200,2,00019,India
340228,2024-01-11,1002,Mascara,200,400,200,2,00051,India
340228,2024-01-11,1008,Makeup Remover,80,160,80,2,00051,India
340228,2024-01-11,1006,Blush,150,300,150,2,00051,India
340228,2024-01-11,1001,Lipstick,150,300,150,2,00051,India
340228,2024-01-11,1004,Eyeliner,100,200,100,2,00051,India
864391,2024-01-11,1008,Makeup Remover,80,160,80,2,00120,India
864391,2024-01-11,1002,Mascara,200,400,200,2,00120,India
864391,2024-01-11,1007,Eyeshadow,200,400,200,2,00120,India
864391,2024-01-11,1001,Lipstick,150,300,150,2,00120,India
189800,2024-01-11,1001,Lipstick,150,300,150,2,00288,India
189800,2024-01-11,1007,Eyeshadow,200,400,200,2,00288,India
189800,2024-01-11,1005,Nail Polish,50,100,50,2,00288,India
916649,2024-01-11,1007,Eyeshadow,200,400,200,2,00325,India
916649,2024-01-11,1009,Moisturizer,250,500,250,2,00325,India
916649,2024-01-11,1012,Body Lotion,200,400,200,2,00325,India
856400,2024-01-11,1005,Nail Polish,50,100,50,2,00155,India
856400,2024-01-11,1007,Eyeshadow,200,400,200,2,00155,India
856400,2024-01-11,1012,Body Lotion,200,400,200,2,00155,India
149772,2024-01-11,1012,Body Lotion,200,400,200,2,00257,India
149772,2024-01-11,1004,Eyeliner,100,200,100,2,00257,India
149772,2024-01-11,1001,Lipstick,150,300,150,2,00257,India
149772,2024-01-11,1007,Eyeshadow,200,400,200,2,00257,India
685927,2024-01-11,1005,Nail Polish,50,100,50,2,00384,India
685927,2024-01-11,1004,Eyeliner,100,200,100,2,00384,India
685927,2024-01-11,1003,Foundation,300,600,300,2,00384,India
919425,2024-01-11,1002,Mascara,200,400,200,2,00072,India
370435,2024-01-11,1008,Makeup Remover,80,160,80,2,00115,India
370435,2024-01-11,1009,Moisturizer,250,500,250,2,00115,India
806651,2024-01-11,1012,Body Lotion,200,400,200,2,00425,India
806651,2024-01-11,1002,Mascara,200,400,200,2,00425,India
806651,2024-01-11,1007,Eyeshadow,200,400,200,2,00425,India
741730,2024-01-11,1012,Body Lotion,200,400,200,2,00256,India
741730,2024-01-11,1002,Mascara,200,400,200,2,00256,India
741730,2024-01-11,1008,Makeup Remover,80,160,80,2,00256,India
741730,2024-01-11,1005,Nail Polish,50,100,50,2,00256,India
741730,2024-01-11,1006,Blush,150,300,150,2,00256,India
180340,2024-01-11,1002,Mascara,200,400,200,2,00472,India
180340,2024-01-11,1012,Body Lotion,200,400,200,2,00472,India
315863,2024-01-11,1001,Lipstick,150,300,150,2,00265,India
315863,2024-01-11,1004,Eyeliner,100,200,100,2,00265,India
315863,2024-01-11,1005,Nail Polish,50,100,50,2,00265,India
886440,2024-01-11,1004,Eyeliner,100,200,100,2,00304,India
886440,2024-01-11,1005,Nail Polish,50,100,50,2,00304,India
319307,2024-01-11,1009,Moisturizer,250,500,250,2,00096,India
319307,2024-01-11,1006,Blush,150,300,150,2,00096,India
189079,2024-01-11,1006,Blush,150,300,150,2,00342,India
625050,2024-01-11,1003,Foundation,300,600,300,2,00400,India
625050,2024-01-11,1005,Nail Polish,50,100,50,2,00400,India
625050,2024-01-11,1006,Blush,150,300,150,2,00400,India
625050,2024-01-11,1002,Mascara,200,400,200,2,00400,India
515683,2024-01-11,1008,Makeup Remover,80,160,80,2,00491,India
515683,2024-01-11,1006,Blush,150,300,150,2,00491,India
565093,2024-01-11,1004,Eyeliner,100,200,100,2,00463,India
565093,2024-01-11,1003,Foundation,300,600,300,2,00463,India
565093,2024-01-11,1006,Blush,150,300,150,2,00463,India
253615,2024-01-11,1003,Foundation,300,600,300,2,00467,India
253615,2024-01-11,1009,Moisturizer,250,500,250,2,00467,India
253615,2024-01-11,1007,Eyeshadow,200,400,200,2,00467,India
117511,2024-01-11,1002,Mascara,200,400,200,2,00258,India
117511,2024-01-11,1006,Blush,150,300,150,2,00258,India
117511,2024-01-11,1003,Foundation,300,600,300,2,00258,India
324227,2024-01-11,1009,Moisturizer,250,500,250,2,00323,India
324227,2024-01-11,1003,Foundation,300,600,300,2,00323,India
324227,2024-01-11,1001,Lipstick,150,300,150,2,00323,India
442286,2024-01-11,1006,Blush,150,300,150,2,00220,India
442286,2024-01-11,1003,Foundation,300,600,300,2,00220,India
243518,2024-01-11,1007,Eyeshadow,200,400,200,2,00015,India
243518,2024-01-11,1008,Makeup Remover,80,160,80,2,00015,India
361218,2024-01-11,1008,Makeup Remover,80,160,80,2,00462,India
195878,2024-01-11,1005,Nail Polish,50,100,50,2,00416,India
195878,2024-01-11,1012,Body Lotion,200,400,200,2,00416,India
762728,2024-01-12,1006,Blush,150,300,150,2,00115,India
762728,2024-01-12,1007,Eyeshadow,200,400,200,2,00115,India
762728,2024-01-12,1004,Eyeliner,100,200,100,2,00115,India
321515,2024-01-12,1006,Blush,150,300,150,2,00413,India
321515,2024-01-12,1005,Nail Polish,50,100,50,2,00413,India
671269,2024-01-12,1009,Moisturizer,250,500,250,2,00316,India
671269,2024-01-12,1001,Lipstick,150,300,150,2,00316,India
897401,2024-01-12,1007,Eyeshadow,200,400,200,2,00056,India
897401,2024-01-12,1003,Foundation,300,600,300,2,00056,India
159434,2024-01-12,1003,Foundation,300,600,300,2,00083,India
493270,2024-01-12,1004,Eyeliner,100,200,100,2,00386,India
493270,2024-01-12,1002,Mascara,200,400,200,2,00386,India
493270,2024-01-12,1012,Body Lotion,200,400,200,2,00386,India
426394,2024-01-12,1008,Makeup Remover,80,160,80,2,00479,India
426394,2024-01-12,1004,Eyeliner,100,200,100,2,00479,India
426394,2024-01-12,1005,Nail Polish,50,100,50,2,00479,India
426394,2024-01-12,1006,Blush,150,300,150,2,00479,India
888768,2024-01-12,1012,Body Lotion,200,400,200,2,00314,India
888768,2024-01-12,1003,Foundation,300,600,300,2,00314,India
888768,2024-01-12,1007,Eyeshadow,200,400,200,2,00314,India
888768,2024-01-12,1002,Mascara,200,400,200,2,00314,India
888768,2024-01-12,1004,Eyeliner,100,200,100,2,00314,India
681337,2024-01-12,1008,Makeup Remover,80,160,80,2,00483,India
681337,2024-01-12,1005,Nail Polish,50,100,50,2,00483,India
461578,2024-01-12,1012,Body Lotion,200,400,200,2,00221,India
913383,2024-01-12,1009,Moisturizer,250,500,250,2,00099,India
913383,2024-01-12,1005,Nail Polish,50,100,50,2,00099,India
913383,2024-01-12,1007,Eyeshadow,200,400,200,2,00099,India
148207,2024-01-12,1001,Lipstick,150,300,150,2,00457,India
148207,2024-01-12,1002,Mascara,200,400,200,2,00457,India
884625,2024-01-12,1002,Mascara,200,400,200,2,00429,India
864562,2024-01-12,1008,Makeup Remover,80,160,80,2,00388,India
864562,2024-01-12,1009,Moisturizer,250,500,250,2,00388,India
864562,2024-01-12,1005,Nail Polish,50,100,50,2,00388,India
864562,2024-01-12,1002,Mascara,200,400,200,2,00388,India
133554,2024-01-12,1005,Nail Polish,50,100,50,2,00174,India
133554,2024-01-12,1006,Blush,150,300,150,2,00174,India
133554,2024-01-12,1003,Foundation,300,600,300,2,00174,India
133554,2024-01-12,1004,Eyeliner,100,200,100,2,00174,India
133554,2024-01-12,1012,Body Lotion,200,400,200,2,00174,India
733497,2024-01-12,1001,Lipstick,150,300,150,2,00040,India
733497,2024-01-12,1002,Mascara,200,400,200,2,00040,India
713660,2024-01-12,1003,Foundation,300,600,300,2,00313,India
343598,2024-01-12,1002,Mascara,200,400,200,2,00263,India
343598,2024-01-12,1008,Makeup Remover,80,160,80,2,00263,India
343598,2024-01-12,1006,Blush,150,300,150,2,00263,India
343598,2024-01-12,1005,Nail Polish,50,100,50,2,00263,India
837797,2024-01-12,1006,Blush,150,300,150,2,00417,India
155957,2024-01-12,1003,Foundation,300,600,300,2,00077,India
155957,2024-01-12,1005,Nail Polish,50,100,50,2,00077,India
539850,2024-01-12,1009,Moisturizer,250,500,250,2,00477,India
539850,2024-01-12,1001,Lipstick,150,300,150,2,00477,India
500496,2024-01-12,1012,Body Lotion,200,400,200,2,00408,India
421963,2024-01-12,1009,Moisturizer,250,500,250,2,00114,India
421963,2024-01-12,1003,Foundation,300,600,300,2,00114,India
421963,2024-01-12,1005,Nail Polish,50,100,50,2,00114,India
421963,2024-01-12,1002,Mascara,200,400,200,2,00114,India
472612,2024-01-12,1012,Body Lotion,200,400,200,2,00129,India
472612,2024-01-12,1009,Moisturizer,250,500,250,2,00129,India
918410,2024-01-12,1001,Lipstick,150,300,150,2,00034,India
918410,2024-01-12,1005,Nail Polish,50,100,50,2,00034,India
654378,2024-01-12,1001,Lipstick,150,300,150,2,00055,India
183170,2024-01-12,1005,Nail Polish,50,100,50,2,00226,India
183170,2024-01-12,1009,Moisturizer,250,500,250,2,00226,India
183170,2024-01-12,1002,Mascara,200,400,200,2,00226,India
777037,2024-01-12,1012,Body Lotion,200,400,200,2,00177,India
777037,2024-01-12,1006,Blush,150,300,150,2,00177,India
115314,2024-01-12,1008,Makeup Remover,80,160,80,2,00333,India
916695,2024-01-12,1008,Makeup Remover,80,160,80,2,00007,India
916695,2024-01-12,1006,Blush,150,300,150,2,00007,India
916695,2024-01-12,1002,Mascara,200,400,200,2,00007,India
865619,2024-01-12,1005,Nail Polish,50,100,50,2,00056,India
469706,2024-01-12,1001,Lipstick,150,300,150,2,00257,India
284662,2024-01-12,1012,Body Lotion,200,400,200,2,00489,India
711729,2024-01-12,1008,Makeup Remover,80,160,80,2,00051,India
711729,2024-01-12,1002,Mascara,200,400,200,2,00051,India
402724,2024-01-12,1001,Lipstick,150,300,150,2,00309,India
402724,2024-01-12,1012,Body Lotion,200,400,200,2,00309,India
896053,2024-01-12,1009,Moisturizer,250,500,250,2,00176,India
324859,2024-01-12,1009,Moisturizer,250,500,250,2,00075,India
324859,2024-01-12,1002,Mascara,200,400,200,2,00075,India
324859,2024-01-12,1006,Blush,150,300,150,2,00075,India
324859,2024-01-12,1012,Body Lotion,200,400,200,2,00075,India
783256,2024-01-12,1007,Eyeshadow,200,400,200,2,00078,India
783256,2024-01-12,1008,Makeup Remover,80,160,80,2,00078,India
783256,2024-01-12,1004,Eyeliner,100,200,100,2,00078,India
783256,2024-01-12,1006,Blush,150,300,150,2,00078,India
235364,2024-01-12,1008,Makeup Remover,80,160,80,2,00130,India
235364,2024-01-12,1009,Moisturizer,250,500,250,2,00130,India
283556,2024-01-13,1004,Eyeliner,100,200,100,2,00177,India
754748,2024-01-13,1008,Makeup Remover,80,160,80,2,00167,India
754748,2024-01-13,1009,Moisturizer,250,500,250,2,00167,India
754748,2024-01-13,1004,Eyeliner,100,200,100,2,00167,India
754748,2024-01-13,1002,Mascara,200,400,200,2,00167,India
754748,2024-01-13,1005,Nail Polish,50,100,50,2,00167,India
483242,2024-01-13,1004,Eyeliner,100,200,100,2,00063,India
483242,2024-01-13,1006,Blush,150,300,150,2,00063,India
346443,2024-01-13,1009,Moisturizer,250,500,250,2,00143,India
346443,2024-01-13,1008,Makeup Remover,80,160,80,2,00143,India
346443,2024-01-13,1001,Lipstick,150,300,150,2,00143,India
346443,2024-01-13,1006,Blush,150,300,150,2,00143,India
346443,2024-01-13,1005,Nail Polish,50,100,50,2,00143,India
375496,2024-01-13,1004,Eyeliner,100,200,100,2,00063,India
961560,2024-01-13,1008,Makeup Remover,80,160,80,2,00253,India
961560,2024-01-13,1006,Blush,150,300,150,2,00253,India
716536,2024-01-13,1005,Nail Polish,50,100,50,2,00006,India
716536,2024-01-13,1009,Moisturizer,250,500,250,2,00006,India
716536,2024-01-13,1002,Mascara,200,400,200,2,00006,India
716536,2024-01-13,1004,Eyeliner,100,200,100,2,00006,India
960599,2024-01-13,1006,Blush,150,300,150,2,00225,India
960599,2024-01-13,1002,Mascara,200,400,200,2,00225,India
960599,2024-01-13,1005,Nail Polish,50,100,50,2,00225,India
960599,2024-01-13,1009,Moisturizer,250,500,250,2,00225,India
960599,2024-01-13,1004,Eyeliner,100,200,100,2,00225,India
278627,2024-01-13,1006,Blush,150,300,150,2,00473,India
278627,2024-01-13,1001,Lipstick,150,300,150,2,00473,India
278627,2024-01-13,1009,Moisturizer,250,500,250,2,00473,India
536011,2024-01-13,1008,Makeup Remover,80,160,80,2,00440,India
536011,2024-01-13,1006,Blush,150,300,150,2,00440,India
536011,2024-01-13,1004,Eyeliner,100,200,100,2,00440,India
536011,2024-01-13,1003,Foundation,300,600,300,2,00440,India
900595,2024-01-13,1005,Nail Polish,50,100,50,2,00121,India
900595,2024-01-13,1009,Moisturizer,250,500,250,2,00121,India
975436,2024-01-13,1004,Eyeliner,100,200,100,2,00482,India
975436,2024-01-13,1002,Mascara,200,400,200,2,00482,India
975436,2024-01-13,1007,Eyeshadow,200,400,200,2,00482,India
975436,2024-01-13,1001,Lipstick,150,300,150,2,00482,India
542082,2024-01-13,1008,Makeup Remover,80,160,80,2,00056,India
868278,2024-01-13,1003,Foundation,300,600,300,2,00096,India
868278,2024-01-13,1002,Mascara,200,400,200,2,00096,India
868278,2024-01-13,1007,Eyeshadow,200,400,200,2,00096,India
939518,2024-01-13,1001,Lipstick,150,300,150,2,00439,India
939518,2024-01-13,1004,Eyeliner,100,200,100,2,00439,India
939518,2024-01-13,1003,Foundation,300,600,300,2,00439,India
464928,2024-01-13,1012,Body Lotion,200,400,200,2,00026,India
464928,2024-01-13,1002,Mascara,200,400,200,2,00026,India
464928,2024-01-13,1003,Foundation,300,600,300,2,00026,India
786477,2024-01-13,1001,Lipstick,150,300,150,2,00395,India
895811,2024-01-13,1008,Makeup Remover,80,160,80,2,00172,India
895811,2024-01-13,1002,Mascara,200,400,200,2,00172,India
772808,2024-01-13,1004,Eyeliner,100,200,100,2,00320,India
772808,2024-01-13,1003,Foundation,300,600,300,2,00320,India
772808,2024-01-13,1006,Blush,150,300,150,2,00320,India
772808,2024-01-13,1002,Mascara,200,400,200,2,00320,India
680378,2024-01-13,1003,Foundation,300,600,300,2,00062,India
680378,2024-01-13,1012,Body Lotion,200,400,200,2,00062,India
680378,2024-01-13,1005,Nail Polish,50,100,50,2,00062,India
680378,2024-01-13,1006,Blush,150,300,150,2,00062,India
680378,2024-01-13,1002,Mascara,200,400,200,2,00062,India
344098,2024-01-13,1002,Mascara,200,400,200,2,00359,India
344098,2024-01-13,1001,Lipstick,150,300,150,2,00359,India
630353,2024-01-13,1004,Eyeliner,100,200,100,2,00305,India
630353,2024-01-13,1007,Eyeshadow,200,400,200,2,00305,India
630353,2024-01-13,1008,Makeup Remover,80,160,80,2,00305,India
630353,2024-01-13,1002,Mascara,200,400,200,2,00305,India
630353,2024-01-13,1003,Foundation,300,600,300,2,00305,India
281093,2024-01-13,1012,Body Lotion,200,400,200,2,00301,India
281093,2024-01-13,1008,Makeup Remover,80,160,80,2,00301,India
647602,2024-01-13,1007,Eyeshadow,200,400,200,2,00106,India
941526,2024-01-13,1005,Nail Polish,50,100,50,2,00055,India
941526,2024-01-13,1009,Moisturizer,250,500,250,2,00055,India
464632,2024-01-13,1009,Moisturizer,250,500,250,2,00383,India
464632,2024-01-13,1012,Body Lotion,200,400,200,2,00383,India
464632,2024-01-13,1005,Nail Polish,50,100,50,2,00383,India
464632,2024-01-13,1001,Lipstick,150,300,150,2,00383,India
464632,2024-01-13,1004,Eyeliner,100,200,100,2,00383,India
655129,2024-01-13,1006,Blush,150,300,150,2,00138,India
655129,2024-01-13,1012,Body Lotion,200,400,200,2,00138,India
784138,2024-01-13,1001,Lipstick,150,300,150,2,00122,India
784138,2024-01-13,1005,Nail Polish,50,100,50,2,00122,India
784138,2024-01-13,1008,Makeup Remover,80,160,80,2,00122,India
459589,2024-01-13,1004,Eyeliner,100,200,100,2,00460,India
459589,2024-01-13,1002,Mascara,200,400,200,2,00460,India
555114,2024-01-13,1012,Body Lotion,200,400,200,2,00227,India
555114,2024-01-13,1005,Nail Polish,50,100,50,2,00227,India
471876,2024-01-13,1004,Eyeliner,100,200,100,2,00493,India
301485,2024-01-13,1009,Moisturizer,250,500,250,2,00204,India
520307,2024-01-13,1003,Foundation,300,600,300,2,00188,India
520307,2024-01-13,1005,Nail Polish,50,100,50,2,00188,India
520307,2024-01-13,1004,Eyeliner,100,200,100,2,00188,India
520307,2024-01-13,1008,Makeup Remover,80,160,80,2,00188,India
309903,2024-01-13,1001,Lipstick,150,300,150,2,00009,India
309903,2024-01-13,1004,Eyeliner,100,200,100,2,00009,India
309903,2024-01-13,1005,Nail Polish,50,100,50,2,00009,India
309903,2024-01-13,1012,Body Lotion,200,400,200,2,00009,India
309903,2024-01-13,1006,Blush,150,300,150,2,00009,India
552015,2024-01-13,1005,Nail Polish,50,100,50,2,00335,India
552015,2024-01-13,1004,Eyeliner,100,200,100,2,00335,India
552015,2024-01-13,1007,Eyeshadow,200,400,200,2,00335,India
552015,2024-01-13,1002,Mascara,200,400,200,2,00335,India
194776,2024-01-13,1009,Moisturizer,250,500,250,2,00252,India
194776,2024-01-13,1004,Eyeliner,100,200,100,2,00252,India
194776,2024-01-13,1003,Foundation,300,600,300,2,00252,India
936564,2024-01-13,1002,Mascara,200,400,200,2,00432,India
936564,2024-01-13,1007,Eyeshadow,200,400,200,2,00432,India
814658,2024-01-13,1007,Eyeshadow,200,400,200,2,00088,India
814658,2024-01-13,1008,Makeup Remover,80,160,80,2,00088,India
814658,2024-01-13,1004,Eyeliner,100,200,100,2,00088,India
814658,2024-01-13,1001,Lipstick,150,300,150,2,00088,India
953367,2024-01-13,1001,Lipstick,150,300,150,2,00143,India
953367,2024-01-13,1008,Makeup Remover,80,160,80,2,00143,India
366188,2024-01-13,1003,Foundation,300,600,300,2,00171,India
366188,2024-01-13,1012,Body Lotion,200,400,200,2,00171,India
350827,2024-01-13,1002,Mascara,200,400,200,2,00089,India
350827,2024-01-13,1008,Makeup Remover,80,160,80,2,00089,India
350827,2024-01-13,1009,Moisturizer,250,500,250,2,00089,India
350827,2024-01-13,1007,Eyeshadow,200,400,200,2,00089,India
301119,2024-01-13,1009,Moisturizer,250,500,250,2,00293,India
301119,2024-01-13,1012,Body Lotion,200,400,200,2,00293,India
301119,2024-01-13,1008,Makeup Remover,80,160,80,2,00293,India
301119,2024-01-13,1002,Mascara,200,400,200,2,00293,India
631459,2024-01-14,1002,Mascara,200,400,200,2,00298,India
631459,2024-01-14,1012,Body Lotion,200,400,200,2,00298,India
631459,2024-01-14,1004,Eyeliner,100,200,100,2,00298,India
390029,2024-01-14,1003,Foundation,300,600,300,2,00054,India
390029,2024-01-14,1007,Eyeshadow,200,400,200,2,00054,India
390029,2024-01-14,1012,Body Lotion,200,400,200,2,00054,India
390029,2024-01-14,1005,Nail Polish,50,100,50,2,00054,India
896104,2024-01-14,1009,Moisturizer,250,500,250,2,00296,India
896104,2024-01-14,1008,Makeup Remover,80,160,80,2,00296,India
896104,2024-01-14,1002,Mascara,200,400,200,2,00296,India
702842,2024-01-14,1008,Makeup Remover,80,160,80,2,00374,India
702842,2024-01-14,1012,Body Lotion,200,400,200,2,00374,India
702842,2024-01-14,1005,Nail Polish,50,100,50,2,00374,India
702842,2024-01-14,1009,Moisturizer,250,500,250,2,00374,India
922976,2024-01-14,1002,Mascara,200,400,200,2,00299,India
954466,2024-01-14,1006,Blush,150,300,150,2,00490,India
940318,2024-01-14,1007,Eyeshadow,200,400,200,2,00109,India
940318,2024-01-14,1002,Mascara,200,400,200,2,00109,India
940318,2024-01-14,1008,Makeup Remover,80,160,80,2,00109,India
940318,2024-01-14,1004,Eyeliner,100,200,100,2,00109,India
372694,2024-01-14,1003,Foundation,300,600,300,2,00154,India
372694,2024-01-14,1001,Lipstick,150,300,150,2,00154,India
372694,2024-01-14,1006,Blush,150,300,150,2,00154,India
491379,2024-01-14,1007,Eyeshadow,200,400,200,2,00470,India
491379,2024-01-14,1002,Mascara,200,400,200,2,00470,India
491379,2024-01-14,1006,Blush,150,300,150,2,00470,India
491379,2024-01-14,1005,Nail Polish,50,100,50,2,00470,India
844129,2024-01-14,1002,Mascara,200,400,200,2,00101,India
844129,2024-01-14,1006,Blush,150,300,150,2,00101,India
132583,2024-01-14,1012,Body Lotion,200,400,200,2,00156,India
132583,2024-01-14,1008,Makeup Remover,80,160,80,2,00156,India
132583,2024-01-14,1001,Lipstick,150,300,150,2,00156,India
132840,2024-01-14,1012,Body Lotion,200,400,200,2,00411,India
132840,2024-01-14,1008,Makeup Remover,80,160,80,2,00411,India
132840,2024-01-14,1004,Eyeliner,100,200,100,2,00411,India
132840,2024-01-14,1006,Blush,150,300,150,2,00411,India
316205,2024-01-14,1012,Body Lotion,200,400,200,2,00396,India
316205,2024-01-14,1003,Foundation,300,600,300,2,00396,India
316205,2024-01-14,1001,Lipstick,150,300,150,2,00396,India
316205,2024-01-14,1008,Makeup Remover,80,160,80,2,00396,India
732095,2024-01-14,1002,Mascara,200,400,200,2,00058,India
732095,2024-01-14,1004,Eyeliner,100,200,100,2,00058,India
732095,2024-01-14,1006,Blush,150,300,150,2,00058,India
519847,2024-01-14,1007,Eyeshadow,200,400,200,2,00346,India
164766,2024-01-14,1001,Lipstick,150,300,150,2,00119,India
164766,2024-01-14,1009,Moisturizer,250,500,250,2,00119,India
164766,2024-01-14,1008,Makeup Remover,80,160,80,2,00119,India
164766,2024-01-14,1005,Nail Polish,50,100,50,2,00119,India
569651,2024-01-14,1004,Eyeliner,100,200,100,2,00466,India
364163,2024-01-14,1006,Blush,150,300,150,2,00323,India
364163,2024-01-14,1012,Body Lotion,200,400,200,2,00323,India
364163,2024-01-14,1007,Eyeshadow,200,400,200,2,00323,India
364163,2024-01-14,1002,Mascara,200,400,200,2,00323,India
357842,2024-01-14,1002,Mascara,200,400,200,2,00353,India
357842,2024-01-14,1012,Body Lotion,200,400,200,2,00353,India
357842,2024-01-14,1006,Blush,150,300,150,2,00353,India
357842,2024-01-14,1001,Lipstick,150,300,150,2,00353,India
643370,2024-01-14,1007,Eyeshadow,200,400,200,2,00387,India
643370,2024-01-14,1001,Lipstick,150,300,150,2,00387,India
643370,2024-01-14,1012,Body Lotion,200,400,200,2,00387,India
683037,2024-01-14,1002,Mascara,200,400,200,2,00228,India
938220,2024-01-14,1012,Body Lotion,200,400,200,2,00093,India
938220,2024-01-14,1007,Eyeshadow,200,400,200,2,00093,India
401365,2024-01-14,1006,Blush,150,300,150,2,00096,India
401365,2024-01-14,1002,Mascara,200,400,200,2,00096,India
826058,2024-01-14,1007,Eyeshadow,200,400,200,2,00419,India
826058,2024-01-14,1002,Mascara,200,400,200,2,00419,India
826058,2024-01-14,1009,Moisturizer,250,500,250,2,00419,India
126434,2024-01-14,1001,Lipstick,150,300,150,2,00390,India
126434,2024-01-14,1006,Blush,150,300,150,2,00390,India
777052,2024-01-14,1012,Body Lotion,200,400,200,2,00491,India
987026,2024-01-14,1006,Blush,150,300,150,2,00265,India
987026,2024-01-14,1004,Eyeliner,100,200,100,2,00265,India
516392,2024-01-14,1001,Lipstick,150,300,150,2,00461,India
339331,2024-01-14,1007,Eyeshadow,200,400,200,2,00319,India
339331,2024-01-14,1008,Makeup Remover,80,160,80,2,00319,India
339331,2024-01-14,1009,Moisturizer,250,500,250,2,00319,India
835649,2024-01-14,1012,Body Lotion,200,400,200,2,00435,India
835649,2024-01-14,1007,Eyeshadow,200,400,200,2,00435,India
439102,2024-01-15,1005,Nail Polish,50,100,50,2,00203,India
439102,2024-01-15,1006,Blush,150,300,150,2,00203,India
439102,2024-01-15,1003,Foundation,300,600,300,2,00203,India
132178,2024-01-15,1005,Nail Polish,50,100,50,2,00291,India
132178,2024-01-15,1009,Moisturizer,250,500,250,2,00291,India
132178,2024-01-15,1006,Blush,150,300,150,2,00291,India
919199,2024-01-15,1003,Foundation,300,600,300,2,00253,India
919199,2024-01-15,1005,Nail Polish,50,100,50,2,00253,India
919199,2024-01-15,1002,Mascara,200,400,200,2,00253,India
919199,2024-01-15,1004,Eyeliner,100,200,100,2,00253,India
498178,2024-01-15,1004,Eyeliner,100,200,100,2,00308,India
498178,2024-01-15,1008,Makeup Remover,80,160,80,2,00308,India
762681,2024-01-15,1003,Foundation,300,600,300,2,00075,India
762681,2024-01-15,1007,Eyeshadow,200,400,200,2,00075,India
762681,2024-01-15,1001,Lipstick,150,300,150,2,00075,India
762681,2024-01-15,1012,Body Lotion,200,400,200,2,00075,India
335206,2024-01-15,1003,Foundation,300,600,300,2,00405,India
335206,2024-01-15,1004,Eyeliner,100,200,100,2,00405,India
966668,2024-01-15,1008,Makeup Remover,80,160,80,2,00015,India
966668,2024-01-15,1005,Nail Polish,50,100,50,2,00015,India
966668,2024-01-15,1012,Body Lotion,200,400,200,2,00015,India
966668,2024-01-15,1007,Eyeshadow,200,400,200,2,00015,India
996687,2024-01-15,1007,Eyeshadow,200,400,200,2,00019,India
344518,2024-01-15,1009,Moisturizer,250,500,250,2,00387,India
319354,2024-01-15,1007,Eyeshadow,200,400,200,2,00167,India
319354,2024-01-15,1005,Nail Polish,50,100,50,2,00167,India
319354,2024-01-15,1001,Lipstick,150,300,150,2,00167,India
905709,2024-01-15,1006,Blush,150,300,150,2,00315,India
360987,2024-01-15,1003,Foundation,300,600,300,2,00273,India
360987,2024-01-15,1006,Blush,150,300,150,2,00273,India
620478,2024-01-15,1001,Lipstick,150,300,150,2,00364,India
518204,2024-01-15,1009,Moisturizer,250,500,250,2,00353,India
518204,2024-01-15,1005,Nail Polish,50,100,50,2,00353,India
518204,2024-01-15,1001,Lipstick,150,300,150,2,00353,India
518204,2024-01-15,1007,Eyeshadow,200,400,200,2,00353,India
518204,2024-01-15,1003,Foundation,300,600,300,2,00353,India
927408,2024-01-15,1012,Body Lotion,200,400,200,2,00383,India
927408,2024-01-15,1007,Eyeshadow,200,400,200,2,00383,India
927408,2024-01-15,1003,Foundation,300,600,300,2,00383,India
927408,2024-01-15,1005,Nail Polish,50,100,50,2,00383,India
167233,2024-01-15,1003,Foundation,300,600,300,2,00229,India
167233,2024-01-15,1006,Blush,150,300,150,2,00229,India
167233,2024-01-15,1002,Mascara,200,400,200,2,00229,India
944975,2024-01-15,1004,Eyeliner,100,200,100,2,00138,India
944975,2024-01-15,1008,Makeup Remover,80,160,80,2,00138,India
944975,2024-01-15,1001,Lipstick,150,300,150,2,00138,India
672079,2024-01-15,1007,Eyeshadow,200,400,200,2,00123,India
672079,2024-01-15,1012,Body Lotion,200,400,200,2,00123,India
912564,2024-01-15,1004,Eyeliner,100,200,100,2,00121,India
912564,2024-01-15,1001,Lipstick,150,300,150,2,00121,India
143792,2024-01-15,1012,Body Lotion,200,400,200,2,00241,India
241119,2024-01-15,1012,Body Lotion,200,400,200,2,00140,India
241119,2024-01-15,1008,Makeup Remover,80,160,80,2,00140,India
241119,2024-01-15,1002,Mascara,200,400,200,2,00140,India
219706,2024-01-15,1009,Moisturizer,250,500,250,2,00292,India
879197,2024-01-15,1008,Makeup Remover,80,160,80,2,00395,India
644105,2024-01-15,1009,Moisturizer,250,500,250,2,00064,India
839107,2024-01-15,1005,Nail Polish,50,100,50,2,00322,India
839107,2024-01-15,1006,Blush,150,300,150,2,00322,India
839107,2024-01-15,1004,Eyeliner,100,200,100,2,00322,India
839107,2024-01-15,1001,Lipstick,150,300,150,2,00322,India
702187,2024-01-15,1012,Body Lotion,200,400,200,2,00091,India
702187,2024-01-15,1006,Blush,150,300,150,2,00091,India
702187,2024-01-15,1005,Nail Polish,50,100,50,2,00091,India
702187,2024-01-15,1003,Foundation,300,600,300,2,00091,India
702187,2024-01-15,1002,Mascara,200,400,200,2,00091,India
562996,2024-01-15,1003,Foundation,300,600,300,2,00243,India
562996,2024-01-15,1012,Body Lotion,200,400,200,2,00243,India
562996,2024-01-15,1008,Makeup Remover,80,160,80,2,00243,India
562996,2024-01-15,1006,Blush,150,300,150,2,00243,India
813969,2024-01-15,1005,Nail Polish,50,100,50,2,00009,India
813969,2024-01-15,1012,Body Lotion,200,400,200,2,00009,India
813969,2024-01-15,1008,Makeup Remover,80,160,80,2,00009,India
540502,2024-01-15,1002,Mascara,200,400,200,2,00428,India
671860,2024-01-15,1005,Nail Polish,50,100,50,2,00492,India
671860,2024-01-15,1004,Eyeliner,100,200,100,2,00492,India
528905,2024-01-15,1003,Foundation,300,600,300,2,00011,India
528905,2024-01-15,1005,Nail Polish,50,100,50,2,00011,India
528905,2024-01-15,1009,Moisturizer,250,500,250,2,00011,India
996732,2024-01-15,1008,Makeup Remover,80,160,80,2,00138,India
996732,2024-01-15,1012,Body Lotion,200,400,200,2,00138,India
996732,2024-01-15,1005,Nail Polish,50,100,50,2,00138,India
996732,2024-01-15,1004,Eyeliner,100,200,100,2,00138,India
170395,2024-01-15,1001,Lipstick,150,300,150,2,00324,India
170395,2024-01-15,1008,Makeup Remover,80,160,80,2,00324,India
170395,2024-01-15,1006,Blush,150,300,150,2,00324,India
170395,2024-01-15,1007,Eyeshadow,200,400,200,2,00324,India
170395,2024-01-15,1005,Nail Polish,50,100,50,2,00324,India
802962,2024-01-15,1003,Foundation,300,600,300,2,00061,India
802962,2024-01-15,1009,Moisturizer,250,500,250,2,00061,India
802962,2024-01-15,1007,Eyeshadow,200,400,200,2,00061,India
697994,2024-01-15,1008,Makeup Remover,80,160,80,2,00375,India
697994,2024-01-15,1003,Foundation,300,600,300,2,00375,India
697994,2024-01-15,1007,Eyeshadow,200,400,200,2,00375,India
726905,2024-01-15,1001,Lipstick,150,300,150,2,00197,India
726905,2024-01-15,1002,Mascara,200,400,200,2,00197,India
726905,2024-01-15,1012,Body Lotion,200,400,200,2,00197,India
726905,2024-01-15,1008,Makeup Remover,80,160,80,2,00197,India
357000,2024-01-15,1006,Blush,150,300,150,2,00453,India
357000,2024-01-15,1005,Nail Polish,50,100,50,2,00453,India
357000,2024-01-15,1009,Moisturizer,250,500,250,2,00453,India
357000,2024-01-15,1012,Body Lotion,200,400,200,2,00453,India
512765,2024-01-15,1001,Lipstick,150,300,150,2,00144,India
512765,2024-01-15,1007,Eyeshadow,200,400,200,2,00144,India
355051,2024-01-15,1005,Nail Polish,50,100,50,2,00497,India
248852,2024-01-15,1004,Eyeliner,100,200,100,2,00247,India
721671,2024-01-15,1009,Moisturizer,250,500,250,2,00093,India
721671,2024-01-15,1003,Foundation,300,600,300,2,00093,India
721671,2024-01-15,1001,Lipstick,150,300,150,2,00093,India
996584,2024-01-15,1009,Moisturizer,250,500,250,2,00479,India
996584,2024-01-15,1007,Eyeshadow,200,400,200,2,00479,India
996584,2024-01-15,1005,Nail Polish,50,100,50,2,00479,India
996584,2024-01-15,1012,Body Lotion,200,400,200,2,00479,India
631607,2024-01-15,1009,Moisturizer,250,500,250,2,00267,India
264680,2024-01-15,1002,Mascara,200,400,200,2,00191,India
264680,2024-01-15,1001,Lipstick,150,300,150,2,00191,India
264680,2024-01-15,1009,Moisturizer,250,500,250,2,00191,India
264680,2024-01-15,1007,Eyeshadow,200,400,200,2,00191,India
264680,2024-01-15,1004,Eyeliner,100,200,100,2,00191,India
854175,2024-01-15,1012,Body Lotion,200,400,200,2,00457,India
854175,2024-01-15,1008,Makeup Remover,80,160,80,2,00457,India
854175,2024-01-15,1003,Foundation,300,600,300,2,00457,India
536794,2024-01-15,1009,Moisturizer,250,500,250,2,00041,India
536794,2024-01-15,1012,Body Lotion,200,400,200,2,00041,India
536794,2024-01-15,1008,Makeup Remover,80,160,80,2,00041,India
370872,2024-01-16,1002,Mascara,200,400,200,2,00015,India
370872,2024-01-16,1008,Makeup Remover,80,160,80,2,00015,India
370872,2024-01-16,1007,Eyeshadow,200,400,200,2,00015,India
370872,2024-01-16,1006,Blush,150,300,150,2,00015,India
513066,2024-01-16,1002,Mascara,200,400,200,2,00207,India
513066,2024-01-16,1003,Foundation,300,600,300,2,00207,India
513066,2024-01-16,1001,Lipstick,150,300,150,2,00207,India
689900,2024-01-16,1009,Moisturizer,250,500,250,2,00403,India
689900,2024-01-16,1008,Makeup Remover,80,160,80,2,00403,India
689900,2024-01-16,1012,Body Lotion,200,400,200,2,00403,India
689900,2024-01-16,1003,Foundation,300,600,300,2,00403,India
192891,2024-01-16,1007,Eyeshadow,200,400,200,2,00162,India
192891,2024-01-16,1004,Eyeliner,100,200,100,2,00162,India
192891,2024-01-16,1012,Body Lotion,200,400,200,2,00162,India
192891,2024-01-16,1008,Makeup Remover,80,160,80,2,00162,India
596607,2024-01-16,1007,Eyeshadow,200,400,200,2,00357,India
596607,2024-01-16,1003,Foundation,300,600,300,2,00357,India
596607,2024-01-16,1012,Body Lotion,200,400,200,2,00357,India
596607,2024-01-16,1002,Mascara,200,400,200,2,00357,India
596607,2024-01-16,1006,Blush,150,300,150,2,00357,India
734303,2024-01-16,1012,Body Lotion,200,400,200,2,00128,India
119938,2024-01-16,1002,Mascara,200,400,200,2,00365,India
119938,2024-01-16,1003,Foundation,300,600,300,2,00365,India
119938,2024-01-16,1007,Eyeshadow,200,400,200,2,00365,India
174878,2024-01-16,1006,Blush,150,300,150,2,00469,India
174878,2024-01-16,1009,Moisturizer,250,500,250,2,00469,India
174878,2024-01-16,1008,Makeup Remover,80,160,80,2,00469,India
337483,2024-01-16,1002,Mascara,200,400,200,2,00095,India
684459,2024-01-16,1003,Foundation,300,600,300,2,00407,India
684459,2024-01-16,1001,Lipstick,150,300,150,2,00407,India
684459,2024-01-16,1008,Makeup Remover,80,160,80,2,00407,India
431062,2024-01-16,1001,Lipstick,150,300,150,2,00124,India
431062,2024-01-16,1004,Eyeliner,100,200,100,2,00124,India
431062,2024-01-16,1007,Eyeshadow,200,400,200,2,00124,India
550335,2024-01-16,1009,Moisturizer,250,500,250,2,00243,India
550335,2024-01-16,1005,Nail Polish,50,100,50,2,00243,India
728203,2024-01-16,1007,Eyeshadow,200,400,200,2,00211,India
728203,2024-01-16,1006,Blush,150,300,150,2,00211,India
728203,2024-01-16,1004,Eyeliner,100,200,100,2,00211,India
728203,2024-01-16,1008,Makeup Remover,80,160,80,2,00211,India
224883,2024-01-16,1003,Foundation,300,600,300,2,00040,India
175563,2024-01-16,1003,Foundation,300,600,300,2,00017,India
760229,2024-01-16,1012,Body Lotion,200,400,200,2,00318,India
760229,2024-01-16,1005,Nail Polish,50,100,50,2,00318,India
760229,2024-01-16,1004,Eyeliner,100,200,100,2,00318,India
760229,2024-01-16,1003,Foundation,300,600,300,2,00318,India
760229,2024-01-16,1001,Lipstick,150,300,150,2,00318,India
215604,2024-01-16,1009,Moisturizer,250,500,250,2,00430,India
215604,2024-01-16,1003,Foundation,300,600,300,2,00430,India
642972,2024-01-16,1012,Body Lotion,200,400,200,2,00400,India
642972,2024-01-16,1002,Mascara,200,400,200,2,00400,India
642972,2024-01-16,1008,Makeup Remover,80,160,80,2,00400,India
871728,2024-01-16,1012,Body Lotion,200,400,200,2,00491,India
900160,2024-01-16,1012,Body Lotion,200,400,200,2,00331,India
900160,2024-01-16,1007,Eyeshadow,200,400,200,2,00331,India
944057,2024-01-16,1009,Moisturizer,250,500,250,2,00035,India
248188,2024-01-16,1003,Foundation,300,600,300,2,00376,India
248188,2024-01-16,1007,Eyeshadow,200,400,200,2,00376,India
279200,2024-01-16,1003,Foundation,300,600,300,2,00390,India
465443,2024-01-16,1007,Eyeshadow,200,400,200,2,00206,India
465443,2024-01-16,1001,Lipstick,150,300,150,2,00206,India
465443,2024-01-16,1005,Nail Polish,50,100,50,2,00206,India
465443,2024-01-16,1009,Moisturizer,250,500,250,2,00206,India
628407,2024-01-16,1006,Blush,150,300,150,2,00292,India
628407,2024-01-16,1004,Eyeliner,100,200,100,2,00292,India
628407,2024-01-16,1005,Nail Polish,50,100,50,2,00292,India
856836,2024-01-16,1006,Blush,150,300,150,2,00017,India
996481,2024-01-16,1012,Body Lotion,200,400,200,2,00326,India
996481,2024-01-16,1008,Makeup Remover,80,160,80,2,00326,India
996481,2024-01-16,1009,Moisturizer,250,500,250,2,00326,India
747787,2024-01-16,1012,Body Lotion,200,400,200,2,00376,India
747787,2024-01-16,1009,Moisturizer,250,500,250,2,00376,India
509508,2024-01-16,1005,Nail Polish,50,100,50,2,00259,India
509508,2024-01-16,1012,Body Lotion,200,400,200,2,00259,India
509508,2024-01-16,1008,Makeup Remover,80,160,80,2,00259,India
509508,2024-01-16,1001,Lipstick,150,300,150,2,00259,India
509508,2024-01-16,1006,Blush,150,300,150,2,00259,India
328048,2024-01-16,1006,Blush,150,300,150,2,00108,India
702219,2024-01-16,1009,Moisturizer,250,500,250,2,00263,India
702219,2024-01-16,1006,Blush,150,300,150,2,00263,India
702219,2024-01-16,1007,Eyeshadow,200,400,200,2,00263,India
100121,2024-01-16,1007,Eyeshadow,200,400,200,2,00429,India
100121,2024-01-16,1009,Moisturizer,250,500,250,2,00429,India
212170,2024-01-16,1009,Moisturizer,250,500,250,2,00289,India
212170,2024-01-16,1007,Eyeshadow,200,400,200,2,00289,India
212170,2024-01-16,1004,Eyeliner,100,200,100,2,00289,India
212170,2024-01-16,1008,Makeup Remover,80,160,80,2,00289,India
212170,2024-01-16,1002,Mascara,200,400,200,2,00289,India
966990,2024-01-16,1004,Eyeliner,100,200,100,2,00140,India
966990,2024-01-16,1003,Foundation,300,600,300,2,00140,India
966990,2024-01-16,1006,Blush,150,300,150,2,00140,India
348734,2024-01-16,1007,Eyeshadow,200,400,200,2,00174,India
225467,2024-01-16,1002,Mascara,200,400,200,2,00267,India
225467,2024-01-16,1003,Foundation,300,600,300,2,00267,India
225467,2024-01-16,1004,Eyeliner,100,200,100,2,00267,India
225467,2024-01-16,1009,Moisturizer,250,500,250,2,00267,India
528182,2024-01-16,1012,Body Lotion,200,400,200,2,00403,India
528182,2024-01-16,1005,Nail Polish,50,100,50,2,00403,India
528182,2024-01-16,1008,Makeup Remover,80,160,80,2,00403,India
286971,2024-01-16,1001,Lipstick,150,300,150,2,00443,India
286971,2024-01-16,1008,Makeup Remover,80,160,80,2,00443,India
286971,2024-01-16,1004,Eyeliner,100,200,100,2,00443,India
158156,2024-01-16,1002,Mascara,200,400,200,2,00032,India
176516,2024-01-16,1008,Makeup Remover,80,160,80,2,00467,India
176516,2024-01-16,1006,Blush,150,300,150,2,00467,India
176516,2024-01-16,1001,Lipstick,150,300,150,2,00467,India
176516,2024-01-16,1002,Mascara,200,400,200,2,00467,India
750719,2024-01-16,1003,Foundation,300,600,300,2,00470,India
585261,2024-01-16,1007,Eyeshadow,200,400,200,2,00130,India
585261,2024-01-16,1005,Nail Polish,50,100,50,2,00130,India
585261,2024-01-16,1012,Body Lotion,200,400,200,2,00130,India
585261,2024-01-16,1009,Moisturizer,250,500,250,2,00130,India
177602,2024-01-16,1007,Eyeshadow,200,400,200,2,00081,India
177602,2024-01-16,1002,Mascara,200,400,200,2,00081,India
177602,2024-01-16,1004,Eyeliner,100,200,100,2,00081,India
177602,2024-01-16,1009,Moisturizer,250,500,250,2,00081,India
919074,2024-01-16,1007,Eyeshadow,200,400,200,2,00090,India
919074,2024-01-16,1004,Eyeliner,100,200,100,2,00090,India
919074,2024-01-16,1008,Makeup Remover,80,160,80,2,00090,India
974011,2024-01-16,1001,Lipstick,150,300,150,2,00031,India
974011,2024-01-16,1002,Mascara,200,400,200,2,00031,India
974011,2024-01-16,1008,Makeup Remover,80,160,80,2,00031,India
974011,2024-01-16,1012,Body Lotion,200,400,200,2,00031,India
757697,2024-01-16,1004,Eyeliner,100,200,100,2,00112,India
757697,2024-01-16,1008,Makeup Remover,80,160,80,2,00112,India
757697,2024-01-16,1012,Body Lotion,200,400,200,2,00112,India
757697,2024-01-16,1001,Lipstick,150,300,150,2,00112,India
645753,2024-01-17,1003,Foundation,300,600,300,2,00375,India
149694,2024-01-17,1012,Body Lotion,200,400,200,2,00161,India
149694,2024-01-17,1003,Foundation,300,600,300,2,00161,India
149694,2024-01-17,1007,Eyeshadow,200,400,200,2,00161,India
149694,2024-01-17,1009,Moisturizer,250,500,250,2,00161,India
247883,2024-01-17,1004,Eyeliner,100,200,100,2,00021,India
247883,2024-01-17,1009,Moisturizer,250,500,250,2,00021,India
637466,2024-01-17,1009,Moisturizer,250,500,250,2,00454,India
637466,2024-01-17,1003,Foundation,300,600,300,2,00454,India
637466,2024-01-17,1004,Eyeliner,100,200,100,2,00454,India
930974,2024-01-17,1003,Foundation,300,600,300,2,00160,India
383776,2024-01-17,1003,Foundation,300,600,300,2,00032,India
383776,2024-01-17,1007,Eyeshadow,200,400,200,2,00032,India
383776,2024-01-17,1002,Mascara,200,400,200,2,00032,India
383776,2024-01-17,1001,Lipstick,150,300,150,2,00032,India
613079,2024-01-17,1006,Blush,150,300,150,2,00486,India
613079,2024-01-17,1004,Eyeliner,100,200,100,2,00486,India
801463,2024-01-17,1008,Makeup Remover,80,160,80,2,00442,India
801463,2024-01-17,1006,Blush,150,300,150,2,00442,India
386220,2024-01-17,1001,Lipstick,150,300,150,2,00197,India
992463,2024-01-17,1008,Makeup Remover,80,160,80,2,00056,India
992463,2024-01-17,1006,Blush,150,300,150,2,00056,India
619756,2024-01-17,1009,Moisturizer,250,500,250,2,00159,India
619756,2024-01-17,1005,Nail Polish,50,100,50,2,00159,India
454473,2024-01-17,1003,Foundation,300,600,300,2,00311,India
454473,2024-01-17,1005,Nail Polish,50,100,50,2,00311,India
454473,2024-01-17,1001,Lipstick,150,300,150,2,00311,India
454473,2024-01-17,1012,Body Lotion,200,400,200,2,00311,India
319487,2024-01-17,1012,Body Lotion,200,400,200,2,00179,India
319487,2024-01-17,1005,Nail Polish,50,100,50,2,00179,India
319487,2024-01-17,1003,Foundation,300,600,300,2,00179,India
319487,2024-01-17,1007,Eyeshadow,200,400,200,2,00179,India
669024,2024-01-17,1009,Moisturizer,250,500,250,2,00377,India
669024,2024-01-17,1004,Eyeliner,100,200,100,2,00377,India
113793,2024-01-17,1005,Nail Polish,50,100,50,2,00350,India
113793,2024-01-17,1001,Lipstick,150,300,150,2,00350,India
113793,2024-01-17,1007,Eyeshadow,200,400,200,2,00350,India
113793,2024-01-17,1002,Mascara,200,400,200,2,00350,India
536993,2024-01-17,1002,Mascara,200,400,200,2,00447,India
531309,2024-01-17,1009,Moisturizer,250,500,250,2,00150,India
531309,2024-01-17,1005,Nail Polish,50,100,50,2,00150,India
531309,2024-01-17,1006,Blush,150,300,150,2,00150,India
891085,2024-01-17,1006,Blush,150,300,150,2,00438,India
482029,2024-01-17,1002,Mascara,200,400,200,2,00032,India
482029,2024-01-17,1004,Eyeliner,100,200,100,2,00032,India
482029,2024-01-17,1009,Moisturizer,250,500,250,2,00032,India
482029,2024-01-17,1007,Eyeshadow,200,400,200,2,00032,India
289367,2024-01-17,1003,Foundation,300,600,300,2,00244,India
289367,2024-01-17,1008,Makeup Remover,80,160,80,2,00244,India
508394,2024-01-17,1004,Eyeliner,100,200,100,2,00098,India
508394,2024-01-17,1002,Mascara,200,400,200,2,00098,India
508394,2024-01-17,1008,Makeup Remover,80,160,80,2,00098,India
765008,2024-01-17,1005,Nail Polish,50,100,50,2,00484,India
765008,2024-01-17,1012,Body Lotion,200,400,200,2,00484,India
765008,2024-01-17,1004,Eyeliner,100,200,100,2,00484,India
177516,2024-01-17,1002,Mascara,200,400,200,2,00416,India
177516,2024-01-17,1009,Moisturizer,250,500,250,2,00416,India
177516,2024-01-17,1012,Body Lotion,200,400,200,2,00416,India
868374,2024-01-17,1012,Body Lotion,200,400,200,2,00381,India
868374,2024-01-17,1001,Lipstick,150,300,150,2,00381,India
868374,2024-01-17,1002,Mascara,200,400,200,2,00381,India
868401,2024-01-17,1009,Moisturizer,250,500,250,2,00301,India
210301,2024-01-17,1012,Body Lotion,200,400,200,2,00387,India
210301,2024-01-17,1008,Makeup Remover,80,160,80,2,00387,India
210301,2024-01-17,1009,Moisturizer,250,500,250,2,00387,India
210301,2024-01-17,1006,Blush,150,300,150,2,00387,India
210301,2024-01-17,1001,Lipstick,150,300,150,2,00387,India
203898,2024-01-17,1003,Foundation,300,600,300,2,00461,India
203898,2024-01-17,1007,Eyeshadow,200,400,200,2,00461,India
599639,2024-01-17,1002,Mascara,200,400,200,2,00056,India
599639,2024-01-17,1009,Moisturizer,250,500,250,2,00056,India
612327,2024-01-17,1008,Makeup Remover,80,160,80,2,00478,India
612327,2024-01-17,1012,Body Lotion,200,400,200,2,00478,India
612327,2024-01-17,1003,Foundation,300,600,300,2,00478,India
612327,2024-01-17,1001,Lipstick,150,300,150,2,00478,India
457542,2024-01-17,1003,Foundation,300,600,300,2,00261,India
457542,2024-01-17,1006,Blush,150,300,150,2,00261,India
287484,2024-01-17,1008,Makeup Remover,80,160,80,2,00253,India
287484,2024-01-17,1009,Moisturizer,250,500,250,2,00253,India
287484,2024-01-17,1004,Eyeliner,100,200,100,2,00253,India
287484,2024-01-17,1007,Eyeshadow,200,400,200,2,00253,India
339600,2024-01-17,1006,Blush,150,300,150,2,00215,India
279215,2024-01-17,1009,Moisturizer,250,500,250,2,00179,India
279215,2024-01-17,1003,Foundation,300,600,300,2,00179,India
279215,2024-01-17,1008,Makeup Remover,80,160,80,2,00179,India
274769,2024-01-17,1008,Makeup Remover,80,160,80,2,00255,India
274769,2024-01-17,1002,Mascara,200,400,200,2,00255,India
274769,2024-01-17,1003,Foundation,300,600,300,2,00255,India
274769,2024-01-17,1009,Moisturizer,250,500,250,2,00255,India
192720,2024-01-17,1008,Makeup Remover,80,160,80,2,00470,India
192720,2024-01-17,1002,Mascara,200,400,200,2,00470,India
353969,2024-01-17,1012,Body Lotion,200,400,200,2,00311,India
353969,2024-01-17,1002,Mascara,200,400,200,2,00311,India
353969,2024-01-17,1003,Foundation,300,600,300,2,00311,India
353969,2024-01-17,1001,Lipstick,150,300,150,2,00311,India
353969,2024-01-17,1007,Eyeshadow,200,400,200,2,00311,India
609414,2024-01-17,1004,Eyeliner,100,200,100,2,00339,India
609414,2024-01-17,1012,Body Lotion,200,400,200,2,00339,India
609414,2024-01-17,1003,Foundation,300,600,300,2,00339,India
595444,2024-01-17,1004,Eyeliner,100,200,100,2,00298,India
595444,2024-01-17,1002,Mascara,200,400,200,2,00298,India
595444,2024-01-17,1009,Moisturizer,250,500,250,2,00298,India
383618,2024-01-17,1002,Mascara,200,400,200,2,00446,India
383618,2024-01-17,1007,Eyeshadow,200,400,200,2,00446,India
383618,2024-01-17,1012,Body Lotion,200,400,200,2,00446,India
658935,2024-01-17,1008,Makeup Remover,80,160,80,2,00255,India
658935,2024-01-17,1004,Eyeliner,100,200,100,2,00255,India
658935,2024-01-17,1001,Lipstick,150,300,150,2,00255,India
891986,2024-01-18,1001,Lipstick,150,300,150,2,00206,India
174097,2024-01-18,1006,Blush,150,300,150,2,00491,India
174097,2024-01-18,1004,Eyeliner,100,200,100,2,00491,India
174097,2024-01-18,1005,Nail Polish,50,100,50,2,00491,India
304830,2024-01-18,1012,Body Lotion,200,400,200,2,00428,India
532474,2024-01-18,1004,Eyeliner,100,200,100,2,00405,India
911350,2024-01-18,1002,Mascara,200,400,200,2,00086,India
911350,2024-01-18,1006,Blush,150,300,150,2,00086,India
100725,2024-01-18,1002,Mascara,200,400,200,2,00128,India
100725,2024-01-18,1003,Foundation,300,600,300,2,00128,India
100725,2024-01-18,1006,Blush,150,300,150,2,00128,India
100725,2024-01-18,1012,Body Lotion,200,400,200,2,00128,India
177275,2024-01-18,1001,Lipstick,150,300,150,2,00278,India
177275,2024-01-18,1012,Body Lotion,200,400,200,2,00278,India
690061,2024-01-18,1012,Body Lotion,200,400,200,2,00136,India
690061,2024-01-18,1005,Nail Polish,50,100,50,2,00136,India
690061,2024-01-18,1007,Eyeshadow,200,400,200,2,00136,India
711433,2024-01-18,1001,Lipstick,150,300,150,2,00077,India
711433,2024-01-18,1009,Moisturizer,250,500,250,2,00077,India
711433,2024-01-18,1006,Blush,150,300,150,2,00077,India
227852,2024-01-18,1002,Mascara,200,400,200,2,00071,India
402792,2024-01-18,1002,Mascara,200,400,200,2,00204,India
402792,2024-01-18,1004,Eyeliner,100,200,100,2,00204,India
704922,2024-01-18,1005,Nail Polish,50,100,50,2,00018,India
704922,2024-01-18,1001,Lipstick,150,300,150,2,00018,India
194503,2024-01-18,1012,Body Lotion,200,400,200,2,00293,India
194503,2024-01-18,1002,Mascara,200,400,200,2,00293,India
194503,2024-01-18,1008,Makeup Remover,80,160,80,2,00293,India
194503,2024-01-18,1005,Nail Polish,50,100,50,2,00293,India
521887,2024-01-18,1009,Moisturizer,250,500,250,2,00374,India
263459,2024-01-18,1009,Moisturizer,250,500,250,2,00486,India
263459,2024-01-18,1004,Eyeliner,100,200,100,2,00486,India
563491,2024-01-18,1005,Nail Polish,50,100,50,2,00310,India
563491,2024-01-18,1004,Eyeliner,100,200,100,2,00310,India
563491,2024-01-18,1009,Moisturizer,250,500,250,2,00310,India
977323,2024-01-18,1006,Blush,150,300,150,2,00112,India
977323,2024-01-18,1012,Body Lotion,200,400,200,2,00112,India
977323,2024-01-18,1003,Foundation,300,600,300,2,00112,India
977323,2024-01-18,1004,Eyeliner,100,200,100,2,00112,India
414016,2024-01-18,1005,Nail Polish,50,100,50,2,00431,India
414016,2024-01-18,1006,Blush,150,300,150,2,00431,India
414016,2024-01-18,1001,Lipstick,150,300,150,2,00431,India
958379,2024-01-18,1012,Body Lotion,200,400,200,2,00241,India
958379,2024-01-18,1003,Foundation,300,600,300,2,00241,India
958379,2024-01-18,1007,Eyeshadow,200,400,200,2,00241,India
958379,2024-01-18,1009,Moisturizer,250,500,250,2,00241,India
958379,2024-01-18,1008,Makeup Remover,80,160,80,2,00241,India
584153,2024-01-18,1007,Eyeshadow,200,400,200,2,00426,India
584153,2024-01-18,1012,Body Lotion,200,400,200,2,00426,India
287266,2024-01-18,1003,Foundation,300,600,300,2,00494,India
287266,2024-01-18,1008,Makeup Remover,80,160,80,2,00494,India
287266,2024-01-18,1001,Lipstick,150,300,150,2,00494,India
897457,2024-01-18,1001,Lipstick,150,300,150,2,00034,India
897457,2024-01-18,1008,Makeup Remover,80,160,80,2,00034,India
897457,2024-01-18,1002,Mascara,200,400,200,2,00034,India
897457,2024-01-18,1003,Foundation,300,600,300,2,00034,India
295458,2024-01-18,1005,Nail Polish,50,100,50,2,00196,India
295458,2024-01-18,1004,Eyeliner,100,200,100,2,00196,India
898937,2024-01-18,1007,Eyeshadow,200,400,200,2,00433,India
898937,2024-01-18,1005,Nail Polish,50,100,50,2,00433,India
898937,2024-01-18,1001,Lipstick,150,300,150,2,00433,India
906445,2024-01-18,1009,Moisturizer,250,500,250,2,00086,India
653651,2024-01-18,1007,Eyeshadow,200,400,200,2,00257,India
653651,2024-01-18,1005,Nail Polish,50,100,50,2,00257,India
798397,2024-01-18,1012,Body Lotion,200,400,200,2,00471,India
464059,2024-01-18,1009,Moisturizer,250,500,250,2,00259,India
464059,2024-01-18,1008,Makeup Remover,80,160,80,2,00259,India
871510,2024-01-18,1012,Body Lotion,200,400,200,2,00465,India
871510,2024-01-18,1009,Moisturizer,250,500,250,2,00465,India
871510,2024-01-18,1005,Nail Polish,50,100,50,2,00465,India
871510,2024-01-18,1001,Lipstick,150,300,150,2,00465,India
343398,2024-01-18,1003,Foundation,300,600,300,2,00418,India
117814,2024-01-18,1003,Foundation,300,600,300,2,00334,India
117814,2024-01-18,1001,Lipstick,150,300,150,2,00334,India
117814,2024-01-18,1007,Eyeshadow,200,400,200,2,00334,India
117814,2024-01-18,1006,Blush,150,300,150,2,00334,India
279187,2024-01-19,1012,Body Lotion,200,400,200,2,00256,India
279187,2024-01-19,1009,Moisturizer,250,500,250,2,00256,India
279187,2024-01-19,1002,Mascara,200,400,200,2,00256,India
227707,2024-01-19,1004,Eyeliner,100,200,100,2,00193,India
227707,2024-01-19,1003,Foundation,300,600,300,2,00193,India
227707,2024-01-19,1006,Blush,150,300,150,2,00193,India
227707,2024-01-19,1002,Mascara,200,400,200,2,00193,India
305750,2024-01-19,1006,Blush,150,300,150,2,00430,India
305750,2024-01-19,1007,Eyeshadow,200,400,200,2,00430,India
305750,2024-01-19,1005,Nail Polish,50,100,50,2,00430,India
305750,2024-01-19,1003,Foundation,300,600,300,2,00430,India
305750,2024-01-19,1009,Moisturizer,250,500,250,2,00430,India
364329,2024-01-19,1001,Lipstick,150,300,150,2,00368,India
364329,2024-01-19,1002,Mascara,200,400,200,2,00368,India
364329,2024-01-19,1003,Foundation,300,600,300,2,00368,India
887286,2024-01-19,1012,Body Lotion,200,400,200,2,00225,India
887286,2024-01-19,1001,Lipstick,150,300,150,2,00225,India
887286,2024-01-19,1004,Eyeliner,100,200,100,2,00225,India
887286,2024-01-19,1009,Moisturizer,250,500,250,2,00225,India
887286,2024-01-19,1007,Eyeshadow,200,400,200,2,00225,India
725214,2024-01-19,1012,Body Lotion,200,400,200,2,00368,India
807359,2024-01-19,1005,Nail Polish,50,100,50,2,00176,India
807359,2024-01-19,1007,Eyeshadow,200,400,200,2,00176,India
807359,2024-01-19,1008,Makeup Remover,80,160,80,2,00176,India
807359,2024-01-19,1001,Lipstick,150,300,150,2,00176,India
807359,2024-01-19,1004,Eyeliner,100,200,100,2,00176,India
889795,2024-01-19,1002,Mascara,200,400,200,2,00188,India
990508,2024-01-19,1006,Blush,150,300,150,2,00150,India
752246,2024-01-19,1001,Lipstick,150,300,150,2,00143,India
752246,2024-01-19,1005,Nail Polish,50,100,50,2,00143,India
752246,2024-01-19,1006,Blush,150,300,150,2,00143,India
125781,2024-01-19,1005,Nail Polish,50,100,50,2,00239,India
125781,2024-01-19,1009,Moisturizer,250,500,250,2,00239,India
125781,2024-01-19,1001,Lipstick,150,300,150,2,00239,India
125781,2024-01-19,1012,Body Lotion,200,400,200,2,00239,India
125781,2024-01-19,1008,Makeup Remover,80,160,80,2,00239,India
628022,2024-01-19,1008,Makeup Remover,80,160,80,2,00433,India
628022,2024-01-19,1004,Eyeliner,100,200,100,2,00433,India
628022,2024-01-19,1003,Foundation,300,600,300,2,00433,India
628022,2024-01-19,1012,Body Lotion,200,400,200,2,00433,India
552885,2024-01-19,1004,Eyeliner,100,200,100,2,00387,India
264078,2024-01-19,1004,Eyeliner,100,200,100,2,00458,India
264078,2024-01-19,1001,Lipstick,150,300,150,2,00458,India
264078,2024-01-19,1012,Body Lotion,200,400,200,2,00458,India
264078,2024-01-19,1007,Eyeshadow,200,400,200,2,00458,India
181562,2024-01-19,1006,Blush,150,300,150,2,00313,India
181562,2024-01-19,1007,Eyeshadow,200,400,200,2,00313,India
113404,2024-01-19,1001,Lipstick,150,300,150,2,00283,India
113404,2024-01-19,1006,Blush,150,300,150,2,00283,India
113404,2024-01-19,1005,Nail Polish,50,100,50,2,00283,India
113404,2024-01-19,1003,Foundation,300,600,300,2,00283,India
859202,2024-01-19,1007,Eyeshadow,200,400,200,2,00329,India
859202,2024-01-19,1001,Lipstick,150,300,150,2,00329,India
859202,2024-01-19,1008,Makeup Remover,80,160,80,2,00329,India
376840,2024-01-19,1012,Body Lotion,200,400,200,2,00158,India
376840,2024-01-19,1005,Nail Polish,50,100,50,2,00158,India
449310,2024-01-19,1005,Nail Polish,50,100,50,2,00318,India
449310,2024-01-19,1009,Moisturizer,250,500,250,2,00318,India
449310,2024-01-19,1002,Mascara,200,400,200,2,00318,India
449310,2024-01-19,1008,Makeup Remover,80,160,80,2,00318,India
449310,2024-01-19,1007,Eyeshadow,200,400,200,2,00318,India
695364,2024-01-19,1007,Eyeshadow,200,400,200,2,00315,India
695364,2024-01-19,1001,Lipstick,150,300,150,2,00315,India
695364,2024-01-19,1002,Mascara,200,400,200,2,00315,India
303399,2024-01-19,1002,Mascara,200,400,200,2,00140,India
303399,2024-01-19,1006,Blush,150,300,150,2,00140,India
834472,2024-01-19,1001,Lipstick,150,300,150,2,00265,India
834472,2024-01-19,1003,Foundation,300,600,300,2,00265,India
520280,2024-01-19,1009,Moisturizer,250,500,250,2,00114,India
520280,2024-01-19,1004,Eyeliner,100,200,100,2,00114,India
520280,2024-01-19,1005,Nail Polish,50,100,50,2,00114,India
821375,2024-01-19,1007,Eyeshadow,200,400,200,2,00085,India
821375,2024-01-19,1004,Eyeliner,100,200,100,2,00085,India
821375,2024-01-19,1008,Makeup Remover,80,160,80,2,00085,India
821375,2024-01-19,1009,Moisturizer,250,500,250,2,00085,India
821375,2024-01-19,1003,Foundation,300,600,300,2,00085,India
519621,2024-01-19,1012,Body Lotion,200,400,200,2,00096,India
519621,2024-01-19,1008,Makeup Remover,80,160,80,2,00096,India
519621,2024-01-19,1003,Foundation,300,600,300,2,00096,India
474564,2024-01-19,1006,Blush,150,300,150,2,00372,India
474564,2024-01-19,1009,Moisturizer,250,500,250,2,00372,India
474564,2024-01-19,1008,Makeup Remover,80,160,80,2,00372,India
103058,2024-01-19,1003,Foundation,300,600,300,2,00322,India
103058,2024-01-19,1007,Eyeshadow,200,400,200,2,00322,India
346252,2024-01-19,1008,Makeup Remover,80,160,80,2,00062,India
346252,2024-01-19,1003,Foundation,300,600,300,2,00062,India
346252,2024-01-19,1009,Moisturizer,250,500,250,2,00062,India
346252,2024-01-19,1007,Eyeshadow,200,400,200,2,00062,India
859688,2024-01-19,1008,Makeup Remover,80,160,80,2,00474,India
859688,2024-01-19,1009,Moisturizer,250,500,250,2,00474,India
859688,2024-01-19,1005,Nail Polish,50,100,50,2,00474,India
859688,2024-01-19,1002,Mascara,200,400,200,2,00474,India
859688,2024-01-19,1012,Body Lotion,200,400,200,2,00474,India
464944,2024-01-19,1008,Makeup Remover,80,160,80,2,00483,India
464944,2024-01-19,1012,Body Lotion,200,400,200,2,00483,India
939977,2024-01-19,1002,Mascara,200,400,200,2,00457,India
640442,2024-01-19,1012,Body Lotion,200,400,200,2,00412,India
640442,2024-01-19,1003,Foundation,300,600,300,2,00412,India
640442,2024-01-19,1005,Nail Polish,50,100,50,2,00412,India
640442,2024-01-19,1006,Blush,150,300,150,2,00412,India
287862,2024-01-19,1002,Mascara,200,400,200,2,00160,India
287862,2024-01-19,1001,Lipstick,150,300,150,2,00160,India
287862,2024-01-19,1005,Nail Polish,50,100,50,2,00160,India
597993,2024-01-19,1003,Foundation,300,600,300,2,00168,India
597993,2024-01-19,1004,Eyeliner,100,200,100,2,00168,India
518769,2024-01-19,1002,Mascara,200,400,200,2,00281,India
518769,2024-01-19,1012,Body Lotion,200,400,200,2,00281,India
518769,2024-01-19,1009,Moisturizer,250,500,250,2,00281,India
426798,2024-01-19,1008,Makeup Remover,80,160,80,2,00134,India
426798,2024-01-19,1012,Body Lotion,200,400,200,2,00134,India
426798,2024-01-19,1009,Moisturizer,250,500,250,2,00134,India
171920,2024-01-19,1008,Makeup Remover,80,160,80,2,00492,India
171920,2024-01-19,1005,Nail Polish,50,100,50,2,00492,India
171920,2024-01-19,1003,Foundation,300,600,300,2,00492,India
171920,2024-01-19,1001,Lipstick,150,300,150,2,00492,India
171920,2024-01-19,1006,Blush,150,300,150,2,00492,India
545189,2024-01-19,1003,Foundation,300,600,300,2,00254,India
545189,2024-01-19,1007,Eyeshadow,200,400,200,2,00254,India
730442,2024-01-19,1009,Moisturizer,250,500,250,2,00493,India
730442,2024-01-19,1005,Nail Polish,50,100,50,2,00493,India
618399,2024-01-19,1007,Eyeshadow,200,400,200,2,00188,India
689063,2024-01-19,1006,Blush,150,300,150,2,00127,India
689063,2024-01-19,1012,Body Lotion,200,400,200,2,00127,India
324250,2024-01-19,1002,Mascara,200,400,200,2,00476,India
324250,2024-01-19,1003,Foundation,300,600,300,2,00476,India
324250,2024-01-19,1008,Makeup Remover,80,160,80,2,00476,India
904865,2024-01-19,1005,Nail Polish,50,100,50,2,00423,India
904865,2024-01-19,1004,Eyeliner,100,200,100,2,00423,India
650969,2024-01-19,1004,Eyeliner,100,200,100,2,00342,India
650969,2024-01-19,1012,Body Lotion,200,400,200,2,00342,India
591068,2024-01-19,1012,Body Lotion,200,400,200,2,00388,India
591068,2024-01-19,1009,Moisturizer,250,500,250,2,00388,India
120411,2024-01-19,1004,Eyeliner,100,200,100,2,00099,India
502230,2024-01-19,1001,Lipstick,150,300,150,2,00403,India
502230,2024-01-19,1006,Blush,150,300,150,2,00403,India
677975,2024-01-20,1001,Lipstick,150,300,150,2,00048,India
677975,2024-01-20,1007,Eyeshadow,200,400,200,2,00048,India
677975,2024-01-20,1003,Foundation,300,600,300,2,00048,India
590260,2024-01-20,1009,Moisturizer,250,500,250,2,00340,India
590260,2024-01-20,1006,Blush,150,300,150,2,00340,India
590260,2024-01-20,1005,Nail Polish,50,100,50,2,00340,India
637004,2024-01-20,1009,Moisturizer,250,500,250,2,00372,India
637004,2024-01-20,1012,Body Lotion,200,400,200,2,00372,India
637004,2024-01-20,1001,Lipstick,150,300,150,2,00372,India
741121,2024-01-20,1001,Lipstick,150,300,150,2,00285,India
741121,2024-01-20,1007,Eyeshadow,200,400,200,2,00285,India
741121,2024-01-20,1008,Makeup Remover,80,160,80,2,00285,India
261921,2024-01-20,1005,Nail Polish,50,100,50,2,00316,India
173815,2024-01-20,1001,Lipstick,150,300,150,2,00248,India
627215,2024-01-20,1009,Moisturizer,250,500,250,2,00475,India
469506,2024-01-20,1005,Nail Polish,50,100,50,2,00364,India
469506,2024-01-20,1004,Eyeliner,100,200,100,2,00364,India
469506,2024-01-20,1002,Mascara,200,400,200,2,00364,India
771595,2024-01-20,1008,Makeup Remover,80,160,80,2,00312,India
771595,2024-01-20,1003,Foundation,300,600,300,2,00312,India
771595,2024-01-20,1006,Blush,150,300,150,2,00312,India
437191,2024-01-20,1001,Lipstick,150,300,150,2,00153,India
725132,2024-01-20,1001,Lipstick,150,300,150,2,00369,India
725132,2024-01-20,1008,Makeup Remover,80,160,80,2,00369,India
395060,2024-01-20,1005,Nail Polish,50,100,50,2,00167,India
395060,2024-01-20,1009,Moisturizer,250,500,250,2,00167,India
395060,2024-01-20,1006,Blush,150,300,150,2,00167,India
395060,2024-01-20,1012,Body Lotion,200,400,200,2,00167,India
395060,2024-01-20,1001,Lipstick,150,300,150,2,00167,India
211014,2024-01-20,1002,Mascara,200,400,200,2,00192,India
211014,2024-01-20,1006,Blush,150,300,150,2,00192,India
509641,2024-01-20,1006,Blush,150,300,150,2,00064,India
515075,2024-01-20,1005,Nail Polish,50,100,50,2,00246,India
765208,2024-01-20,1004,Eyeliner,100,200,100,2,00118,India
765208,2024-01-20,1005,Nail Polish,50,100,50,2,00118,India
550405,2024-01-20,1003,Foundation,300,600,300,2,00168,India
440169,2024-01-20,1005,Nail Polish,50,100,50,2,00032,India
440169,2024-01-20,1009,Moisturizer,250,500,250,2,00032,India
440169,2024-01-20,1007,Eyeshadow,200,400,200,2,00032,India
731441,2024-01-20,1004,Eyeliner,100,200,100,2,00403,India
731441,2024-01-20,1002,Mascara,200,400,200,2,00403,India
731441,2024-01-20,1008,Makeup Remover,80,160,80,2,00403,India
731441,2024-01-20,1005,Nail Polish,50,100,50,2,00403,India
731441,2024-01-20,1006,Blush,150,300,150,2,00403,India
526541,2024-01-20,1009,Moisturizer,250,500,250,2,00056,India
526541,2024-01-20,1002,Mascara,200,400,200,2,00056,India
526541,2024-01-20,1005,Nail Polish,50,100,50,2,00056,India
237714,2024-01-20,1004,Eyeliner,100,200,100,2,00190,India
237714,2024-01-20,1005,Nail Polish,50,100,50,2,00190,India
570319,2024-01-20,1002,Mascara,200,400,200,2,00411,India
837277,2024-01-20,1007,Eyeshadow,200,400,200,2,00042,India
837277,2024-01-20,1008,Makeup Remover,80,160,80,2,00042,India
270357,2024-01-20,1008,Makeup Remover,80,160,80,2,00340,India
270357,2024-01-20,1009,Moisturizer,250,500,250,2,00340,India
270357,2024-01-20,1007,Eyeshadow,200,400,200,2,00340,India
846333,2024-01-20,1005,Nail Polish,50,100,50,2,00131,India
846333,2024-01-20,1009,Moisturizer,250,500,250,2,00131,India
527154,2024-01-20,1003,Foundation,300,600,300,2,00235,India
527154,2024-01-20,1007,Eyeshadow,200,400,200,2,00235,India
527154,2024-01-20,1006,Blush,150,300,150,2,00235,India
860851,2024-01-20,1005,Nail Polish,50,100,50,2,00236,India
860851,2024-01-20,1006,Blush,150,300,150,2,00236,India
860851,2024-01-20,1007,Eyeshadow,200,400,200,2,00236,India
860851,2024-01-20,1003,Foundation,300,600,300,2,00236,India
402825,2024-01-20,1002,Mascara,200,400,200,2,00069,India
402825,2024-01-20,1005,Nail Polish,50,100,50,2,00069,India
402825,2024-01-20,1008,Makeup Remover,80,160,80,2,00069,India
402825,2024-01-20,1006,Blush,150,300,150,2,00069,India
402825,2024-01-20,1004,Eyeliner,100,200,100,2,00069,India
896937,2024-01-20,1001,Lipstick,150,300,150,2,00209,India
260319,2024-01-20,1009,Moisturizer,250,500,250,2,00411,India
260319,2024-01-20,1005,Nail Polish,50,100,50,2,00411,India
260319,2024-01-20,1012,Body Lotion,200,400,200,2,00411,India
398338,2024-01-20,1003,Foundation,300,600,300,2,00055,India
398338,2024-01-20,1001,Lipstick,150,300,150,2,00055,India
398338,2024-01-20,1004,Eyeliner,100,200,100,2,00055,India
651239,2024-01-20,1001,Lipstick,150,300,150,2,00128,India
651239,2024-01-20,1002,Mascara,200,400,200,2,00128,India
651239,2024-01-20,1007,Eyeshadow,200,400,200,2,00128,India
159206,2024-01-20,1006,Blush,150,300,150,2,00375,India
159206,2024-01-20,1004,Eyeliner,100,200,100,2,00375,India
645565,2024-01-20,1007,Eyeshadow,200,400,200,2,00085,India
645565,2024-01-20,1006,Blush,150,300,150,2,00085,India
497649,2024-01-20,1002,Mascara,200,400,200,2,00424,India
990382,2024-01-20,1001,Lipstick,150,300,150,2,00008,India
990382,2024-01-20,1007,Eyeshadow,200,400,200,2,00008,India
990382,2024-01-20,1003,Foundation,300,600,300,2,00008,India
399425,2024-01-20,1012,Body Lotion,200,400,200,2,00264,India
399425,2024-01-20,1001,Lipstick,150,300,150,2,00264,India
399425,2024-01-20,1008,Makeup Remover,80,160,80,2,00264,India
399425,2024-01-20,1005,Nail Polish,50,100,50,2,00264,India
288829,2024-01-20,1004,Eyeliner,100,200,100,2,00326,India
288829,2024-01-20,1003,Foundation,300,600,300,2,00326,India
288829,2024-01-20,1008,Makeup Remover,80,160,80,2,00326,India
213187,2024-01-20,1004,Eyeliner,100,200,100,2,00361,India
213187,2024-01-20,1003,Foundation,300,600,300,2,00361,India
213187,2024-01-20,1006,Blush,150,300,150,2,00361,India
334819,2024-01-20,1009,Moisturizer,250,500,250,2,00153,India
334819,2024-01-20,1006,Blush,150,300,150,2,00153,India
569987,2024-01-20,1001,Lipstick,150,300,150,2,00359,India
569987,2024-01-20,1006,Blush,150,300,150,2,00359,India
569987,2024-01-20,1003,Foundation,300,600,300,2,00359,India
569987,2024-01-20,1009,Moisturizer,250,500,250,2,00359,India
478846,2024-01-20,1006,Blush,150,300,150,2,00073,India
478846,2024-01-20,1005,Nail Polish,50,100,50,2,00073,India
478846,2024-01-20,1007,Eyeshadow,200,400,200,2,00073,India
366457,2024-01-20,1009,Moisturizer,250,500,250,2,00421,India
843961,2024-01-20,1008,Makeup Remover,80,160,80,2,00289,India
131966,2024-01-20,1002,Mascara,200,400,200,2,00432,India
131966,2024-01-20,1012,Body Lotion,200,400,200,2,00432,India
131966,2024-01-20,1003,Foundation,300,600,300,2,00432,India
417132,2024-01-20,1005,Nail Polish,50,100,50,2,00196,India
417132,2024-01-20,1009,Moisturizer,250,500,250,2,00196,India
113396,2024-01-21,1006,Blush,150,300,150,2,00146,India
113396,2024-01-21,1007,Eyeshadow,200,400,200,2,00146,India
113396,2024-01-21,1003,Foundation,300,600,300,2,00146,India
113396,2024-01-21,1001,Lipstick,150,300,150,2,00146,India
169729,2024-01-21,1004,Eyeliner,100,200,100,2,00242,India
904794,2024-01-21,1003,Foundation,300,600,300,2,00008,India
904794,2024-01-21,1009,Moisturizer,250,500,250,2,00008,India
324645,2024-01-21,1012,Body Lotion,200,400,200,2,00057,India
324645,2024-01-21,1007,Eyeshadow,200,400,200,2,00057,India
324645,2024-01-21,1002,Mascara,200,400,200,2,00057,India
985487,2024-01-21,1009,Moisturizer,250,500,250,2,00418,India
985487,2024-01-21,1012,Body Lotion,200,400,200,2,00418,India
193166,2024-01-21,1004,Eyeliner,100,200,100,2,00447,India
193166,2024-01-21,1002,Mascara,200,400,200,2,00447,India
193166,2024-01-21,1003,Foundation,300,600,300,2,00447,India
193166,2024-01-21,1012,Body Lotion,200,400,200,2,00447,India
809577,2024-01-21,1007,Eyeshadow,200,400,200,2,00298,India
809577,2024-01-21,1012,Body Lotion,200,400,200,2,00298,India
809577,2024-01-21,1006,Blush,150,300,150,2,00298,India
514784,2024-01-21,1008,Makeup Remover,80,160,80,2,00364,India
514784,2024-01-21,1012,Body Lotion,200,400,200,2,00364,India
558085,2024-01-21,1001,Lipstick,150,300,150,2,00414,India
558085,2024-01-21,1008,Makeup Remover,80,160,80,2,00414,India
558085,2024-01-21,1004,Eyeliner,100,200,100,2,00414,India
558085,2024-01-21,1009,Moisturizer,250,500,250,2,00414,India
370509,2024-01-21,1002,Mascara,200,400,200,2,00323,India
488776,2024-01-21,1004,Eyeliner,100,200,100,2,00031,India
488776,2024-01-21,1001,Lipstick,150,300,150,2,00031,India
258031,2024-01-21,1005,Nail Polish,50,100,50,2,00294,India
258031,2024-01-21,1012,Body Lotion,200,400,200,2,00294,India
746521,2024-01-21,1012,Body Lotion,200,400,200,2,00341,India
201800,2024-01-21,1005,Nail Polish,50,100,50,2,00431,India
201800,2024-01-21,1009,Moisturizer,250,500,250,2,00431,India
201800,2024-01-21,1012,Body Lotion,200,400,200,2,00431,India
201800,2024-01-21,1006,Blush,150,300,150,2,00431,India
201800,2024-01-21,1004,Eyeliner,100,200,100,2,00431,India
214530,2024-01-21,1005,Nail Polish,50,100,50,2,00198,India
214530,2024-01-21,1007,Eyeshadow,200,400,200,2,00198,India
917443,2024-01-21,1009,Moisturizer,250,500,250,2,00266,India
917443,2024-01-21,1012,Body Lotion,200,400,200,2,00266,India
917443,2024-01-21,1007,Eyeshadow,200,400,200,2,00266,India
917443,2024-01-21,1005,Nail Polish,50,100,50,2,00266,India
683265,2024-01-21,1004,Eyeliner,100,200,100,2,00411,India
166028,2024-01-21,1002,Mascara,200,400,200,2,00362,India
913396,2024-01-21,1001,Lipstick,150,300,150,2,00365,India
913396,2024-01-21,1004,Eyeliner,100,200,100,2,00365,India
913396,2024-01-21,1008,Makeup Remover,80,160,80,2,00365,India
195343,2024-01-21,1012,Body Lotion,200,400,200,2,00194,India
195343,2024-01-21,1005,Nail Polish,50,100,50,2,00194,India
195343,2024-01-21,1004,Eyeliner,100,200,100,2,00194,India
541087,2024-01-21,1009,Moisturizer,250,500,250,2,00299,India
541087,2024-01-21,1002,Mascara,200,400,200,2,00299,India
541087,2024-01-21,1001,Lipstick,150,300,150,2,00299,India
460881,2024-01-21,1006,Blush,150,300,150,2,00407,India
460881,2024-01-21,1003,Foundation,300,600,300,2,00407,India
460881,2024-01-21,1004,Eyeliner,100,200,100,2,00407,India
790901,2024-01-21,1009,Moisturizer,250,500,250,2,00002,India
790901,2024-01-21,1007,Eyeshadow,200,400,200,2,00002,India
776324,2024-01-21,1001,Lipstick,150,300,150,2,00142,India
776324,2024-01-21,1002,Mascara,200,400,200,2,00142,India
776324,2024-01-21,1003,Foundation,300,600,300,2,00142,India
465151,2024-01-21,1002,Mascara,200,400,200,2,00308,India
465151,2024-01-21,1004,Eyeliner,100,200,100,2,00308,India
460359,2024-01-21,1002,Mascara,200,400,200,2,00477,India
460359,2024-01-21,1001,Lipstick,150,300,150,2,00477,India
460359,2024-01-21,1004,Eyeliner,100,200,100,2,00477,India
460359,2024-01-21,1006,Blush,150,300,150,2,00477,India
460359,2024-01-21,1012,Body Lotion,200,400,200,2,00477,India
349583,2024-01-21,1001,Lipstick,150,300,150,2,00313,India
349583,2024-01-21,1006,Blush,150,300,150,2,00313,India
812003,2024-01-21,1002,Mascara,200,400,200,2,00164,India
790259,2024-01-21,1002,Mascara,200,400,200,2,00060,India
790259,2024-01-21,1008,Makeup Remover,80,160,80,2,00060,India
790259,2024-01-21,1012,Body Lotion,200,400,200,2,00060,India
790259,2024-01-21,1009,Moisturizer,250,500,250,2,00060,India
382852,2024-01-21,1003,Foundation,300,600,300,2,00165,India
382852,2024-01-21,1001,Lipstick,150,300,150,2,00165,India
382852,2024-01-21,1005,Nail Polish,50,100,50,2,00165,India
382852,2024-01-21,1007,Eyeshadow,200,400,200,2,00165,India
586257,2024-01-21,1003,Foundation,300,600,300,2,00445,India
923625,2024-01-21,1002,Mascara,200,400,200,2,00076,India
782690,2024-01-21,1001,Lipstick,150,300,150,2,00397,India
782690,2024-01-21,1009,Moisturizer,250,500,250,2,00397,India
782690,2024-01-21,1003,Foundation,300,600,300,2,00397,India
502316,2024-01-21,1005,Nail Polish,50,100,50,2,00089,India
502316,2024-01-21,1004,Eyeliner,100,200,100,2,00089,India
502316,2024-01-21,1006,Blush,150,300,150,2,00089,India
502316,2024-01-21,1002,Mascara,200,400,200,2,00089,India
502316,2024-01-21,1007,Eyeshadow,200,400,200,2,00089,India
348299,2024-01-21,1005,Nail Polish,50,100,50,2,00197,India
348299,2024-01-21,1002,Mascara,200,400,200,2,00197,India
806293,2024-01-21,1002,Mascara,200,400,200,2,00374,India
718472,2024-01-21,1004,Eyeliner,100,200,100,2,00485,India
939617,2024-01-21,1002,Mascara,200,400,200,2,00066,India
204615,2024-01-21,1008,Makeup Remover,80,160,80,2,00206,India
204615,2024-01-21,1004,Eyeliner,100,200,100,2,00206,India
204615,2024-01-21,1006,Blush,150,300,150,2,00206,India
456456,2024-01-21,1005,Nail Polish,50,100,50,2,00477,India
456456,2024-01-21,1006,Blush,150,300,150,2,00477,India
456456,2024-01-21,1008,Makeup Remover,80,160,80,2,00477,India
456456,2024-01-21,1012,Body Lotion,200,400,200,2,00477,India
456456,2024-01-21,1004,Eyeliner,100,200,100,2,00477,India
195647,2024-01-21,1007,Eyeshadow,200,400,200,2,00226,India
195647,2024-01-21,1001,Lipstick,150,300,150,2,00226,India
195647,2024-01-21,1003,Foundation,300,600,300,2,00226,India
959974,2024-01-21,1006,Blush,150,300,150,2,00062,India
959974,2024-01-21,1002,Mascara,200,400,200,2,00062,India
959974,2024-01-21,1004,Eyeliner,100,200,100,2,00062,India
534848,2024-01-21,1002,Mascara,200,400,200,2,00428,India
656281,2024-01-21,1003,Foundation,300,600,300,2,00096,India
145249,2024-01-21,1006,Blush,150,300,150,2,00492,India
145249,2024-01-21,1002,Mascara,200,400,200,2,00492,India
145249,2024-01-21,1004,Eyeliner,100,200,100,2,00492,India
173652,2024-01-22,1006,Blush,150,300,150,2,00205,India
150023,2024-01-22,1006,Blush,150,300,150,2,00227,India
150023,2024-01-22,1005,Nail Polish,50,100,50,2,00227,India
150023,2024-01-22,1012,Body Lotion,200,400,200,2,00227,India
150023,2024-01-22,1009,Moisturizer,250,500,250,2,00227,India
915446,2024-01-22,1006,Blush,150,300,150,2,00404,India
915446,2024-01-22,1001,Lipstick,150,300,150,2,00404,India
915446,2024-01-22,1005,Nail Polish,50,100,50,2,00404,India
928622,2024-01-22,1007,Eyeshadow,200,400,200,2,00131,India
928622,2024-01-22,1006,Blush,150,300,150,2,00131,India
928622,2024-01-22,1008,Makeup Remover,80,160,80,2,00131,India
634391,2024-01-22,1003,Foundation,300,600,300,2,00198,India
634391,2024-01-22,1001,Lipstick,150,300,150,2,00198,India
266297,2024-01-22,1002,Mascara,200,400,200,2,00051,India
266297,2024-01-22,1004,Eyeliner,100,200,100,2,00051,India
699835,2024-01-22,1004,Eyeliner,100,200,100,2,00039,India
699835,2024-01-22,1009,Moisturizer,250,500,250,2,00039,India
547199,2024-01-22,1005,Nail Polish,50,100,50,2,00110,India
547199,2024-01-22,1009,Moisturizer,250,500,250,2,00110,India
547199,2024-01-22,1003,Foundation,300,600,300,2,00110,India
547199,2024-01-22,1006,Blush,150,300,150,2,00110,India
815684,2024-01-22,1001,Lipstick,150,300,150,2,00121,India
815684,2024-01-22,1006,Blush,150,300,150,2,00121,India
815684,2024-01-22,1002,Mascara,200,400,200,2,00121,India
815684,2024-01-22,1012,Body Lotion,200,400,200,2,00121,India
815684,2024-01-22,1009,Moisturizer,250,500,250,2,00121,India
570285,2024-01-22,1007,Eyeshadow,200,400,200,2,00457,India
570285,2024-01-22,1012,Body Lotion,200,400,200,2,00457,India
570285,2024-01-22,1003,Foundation,300,600,300,2,00457,India
570285,2024-01-22,1006,Blush,150,300,150,2,00457,India
570285,2024-01-22,1005,Nail Polish,50,100,50,2,00457,India
985093,2024-01-22,1004,Eyeliner,100,200,100,2,00344,India
985093,2024-01-22,1001,Lipstick,150,300,150,2,00344,India
985093,2024-01-22,1002,Mascara,200,400,200,2,00344,India
931454,2024-01-22,1008,Makeup Remover,80,160,80,2,00007,India
931454,2024-01-22,1009,Moisturizer,250,500,250,2,00007,India
931454,2024-01-22,1005,Nail Polish,50,100,50,2,00007,India
883521,2024-01-22,1005,Nail Polish,50,100,50,2,00436,India
883521,2024-01-22,1003,Foundation,300,600,300,2,00436,India
883521,2024-01-22,1007,Eyeshadow,200,400,200,2,00436,India
883521,2024-01-22,1001,Lipstick,150,300,150,2,00436,India
528337,2024-01-22,1009,Moisturizer,250,500,250,2,00032,India
406233,2024-01-22,1003,Foundation,300,600,300,2,00455,India
953904,2024-01-22,1003,Foundation,300,600,300,2,00444,India
953904,2024-01-22,1007,Eyeshadow,200,400,200,2,00444,India
953904,2024-01-22,1001,Lipstick,150,300,150,2,00444,India
618172,2024-01-22,1004,Eyeliner,100,200,100,2,00453,India
889306,2024-01-22,1008,Makeup Remover,80,160,80,2,00465,India
889306,2024-01-22,1004,Eyeliner,100,200,100,2,00465,India
889306,2024-01-22,1001,Lipstick,150,300,150,2,00465,India
741856,2024-01-22,1002,Mascara,200,400,200,2,00426,India
741856,2024-01-22,1006,Blush,150,300,150,2,00426,India
741856,2024-01-22,1008,Makeup Remover,80,160,80,2,00426,India
957256,2024-01-22,1007,Eyeshadow,200,400,200,2,00240,India
957256,2024-01-22,1005,Nail Polish,50,100,50,2,00240,India
957256,2024-01-22,1008,Makeup Remover,80,160,80,2,00240,India
957256,2024-01-22,1012,Body Lotion,200,400,200,2,00240,India
573727,2024-01-22,1002,Mascara,200,400,200,2,00312,India
573727,2024-01-22,1012,Body Lotion,200,400,200,2,00312,India
739691,2024-01-22,1002,Mascara,200,400,200,2,00448,India
739691,2024-01-22,1006,Blush,150,300,150,2,00448,India
739691,2024-01-22,1009,Moisturizer,250,500,250,2,00448,India
494935,2024-01-22,1007,Eyeshadow,200,400,200,2,00320,India
494935,2024-01-22,1003,Foundation,300,600,300,2,00320,India
494935,2024-01-22,1001,Lipstick,150,300,150,2,00320,India
156080,2024-01-22,1009,Moisturizer,250,500,250,2,00143,India
156080,2024-01-22,1001,Lipstick,150,300,150,2,00143,India
761093,2024-01-22,1001,Lipstick,150,300,150,2,00282,India
761093,2024-01-22,1004,Eyeliner,100,200,100,2,00282,India
817144,2024-01-22,1012,Body Lotion,200,400,200,2,00181,India
817144,2024-01-22,1005,Nail Polish,50,100,50,2,00181,India
817144,2024-01-22,1003,Foundation,300,600,300,2,00181,India
817144,2024-01-22,1008,Makeup Remover,80,160,80,2,00181,India
817144,2024-01-22,1004,Eyeliner,100,200,100,2,00181,India
390943,2024-01-22,1001,Lipstick,150,300,150,2,00122,India
390943,2024-01-22,1008,Makeup Remover,80,160,80,2,00122,India
390943,2024-01-22,1006,Blush,150,300,150,2,00122,India
597834,2024-01-22,1007,Eyeshadow,200,400,200,2,00132,India
597834,2024-01-22,1003,Foundation,300,600,300,2,00132,India
597834,2024-01-22,1004,Eyeliner,100,200,100,2,00132,India
597834,2024-01-22,1008,Makeup Remover,80,160,80,2,00132,India
767765,2024-01-22,1007,Eyeshadow,200,400,200,2,00025,India
767765,2024-01-22,1004,Eyeliner,100,200,100,2,00025,India
767765,2024-01-22,1012,Body Lotion,200,400,200,2,00025,India
957470,2024-01-22,1009,Moisturizer,250,500,250,2,00406,India
957470,2024-01-22,1012,Body Lotion,200,400,200,2,00406,India
957470,2024-01-22,1002,Mascara,200,400,200,2,00406,India
732764,2024-01-22,1003,Foundation,300,600,300,2,00183,India
732764,2024-01-22,1002,Mascara,200,400,200,2,00183,India
470931,2024-01-22,1007,Eyeshadow,200,400,200,2,00264,India
387083,2024-01-22,1004,Eyeliner,100,200,100,2,00451,India
387083,2024-01-22,1007,Eyeshadow,200,400,200,2,00451,India
265779,2024-01-23,1003,Foundation,300,600,300,2,00409,India
945697,2024-01-23,1003,Foundation,300,600,300,2,00159,India
945697,2024-01-23,1002,Mascara,200,400,200,2,00159,India
994321,2024-01-23,1004,Eyeliner,100,200,100,2,00457,India
908895,2024-01-23,1008,Makeup Remover,80,160,80,2,00342,India
908895,2024-01-23,1012,Body Lotion,200,400,200,2,00342,India
908895,2024-01-23,1001,Lipstick,150,300,150,2,00342,India
999067,2024-01-23,1004,Eyeliner,100,200,100,2,00285,India
999067,2024-01-23,1001,Lipstick,150,300,150,2,00285,India
999067,2024-01-23,1008,Makeup Remover,80,160,80,2,00285,India
999067,2024-01-23,1002,Mascara,200,400,200,2,00285,India
999067,2024-01-23,1009,Moisturizer,250,500,250,2,00285,India
879142,2024-01-23,1009,Moisturizer,250,500,250,2,00138,India
879142,2024-01-23,1001,Lipstick,150,300,150,2,00138,India
879142,2024-01-23,1003,Foundation,300,600,300,2,00138,India
879142,2024-01-23,1002,Mascara,200,400,200,2,00138,India
217926,2024-01-23,1001,Lipstick,150,300,150,2,00053,India
692808,2024-01-23,1007,Eyeshadow,200,400,200,2,00159,India
842028,2024-01-23,1003,Foundation,300,600,300,2,00153,India
673358,2024-01-23,1007,Eyeshadow,200,400,200,2,00151,India
673358,2024-01-23,1012,Body Lotion,200,400,200,2,00151,India
640374,2024-01-23,1004,Eyeliner,100,200,100,2,00320,India
768063,2024-01-23,1005,Nail Polish,50,100,50,2,00246,India
768063,2024-01-23,1007,Eyeshadow,200,400,200,2,00246,India
555073,2024-01-23,1003,Foundation,300,600,300,2,00288,India
555073,2024-01-23,1009,Moisturizer,250,500,250,2,00288,India
308952,2024-01-23,1007,Eyeshadow,200,400,200,2,00238,India
308952,2024-01-23,1001,Lipstick,150,300,150,2,00238,India
308952,2024-01-23,1002,Mascara,200,400,200,2,00238,India
764843,2024-01-23,1012,Body Lotion,200,400,200,2,00361,India
764843,2024-01-23,1008,Makeup Remover,80,160,80,2,00361,India
764843,2024-01-23,1007,Eyeshadow,200,400,200,2,00361,India
764843,2024-01-23,1009,Moisturizer,250,500,250,2,00361,India
971944,2024-01-23,1003,Foundation,300,600,300,2,00060,India
971944,2024-01-23,1005,Nail Polish,50,100,50,2,00060,India
971944,2024-01-23,1004,Eyeliner,100,200,100,2,00060,India
971944,2024-01-23,1001,Lipstick,150,300,150,2,00060,India
312568,2024-01-23,1001,Lipstick,150,300,150,2,00450,India
335802,2024-01-23,1008,Makeup Remover,80,160,80,2,00068,India
335802,2024-01-23,1003,Foundation,300,600,300,2,00068,India
335802,2024-01-23,1002,Mascara,200,400,200,2,00068,India
517072,2024-01-23,1002,Mascara,200,400,200,2,00224,India
546888,2024-01-23,1007,Eyeshadow,200,400,200,2,00250,India
546888,2024-01-23,1001,Lipstick,150,300,150,2,00250,India
546888,2024-01-23,1004,Eyeliner,100,200,100,2,00250,India
689414,2024-01-23,1001,Lipstick,150,300,150,2,00496,India
875371,2024-01-23,1006,Blush,150,300,150,2,00439,India
875371,2024-01-23,1003,Foundation,300,600,300,2,00439,India
875371,2024-01-23,1005,Nail Polish,50,100,50,2,00439,India
903822,2024-01-23,1001,Lipstick,150,300,150,2,00067,India
903822,2024-01-23,1004,Eyeliner,100,200,100,2,00067,India
343710,2024-01-23,1007,Eyeshadow,200,400,200,2,00290,India
343710,2024-01-23,1006,Blush,150,300,150,2,00290,India
498718,2024-01-23,1001,Lipstick,150,300,150,2,00222,India
498718,2024-01-23,1003,Foundation,300,600,300,2,00222,India
498718,2024-01-23,1008,Makeup Remover,80,160,80,2,00222,India
700556,2024-01-23,1005,Nail Polish,50,100,50,2,00311,India
700556,2024-01-23,1001,Lipstick,150,300,150,2,00311,India
700556,2024-01-23,1007,Eyeshadow,200,400,200,2,00311,India
673695,2024-01-23,1009,Moisturizer,250,500,250,2,00418,India
441745,2024-01-23,1007,Eyeshadow,200,400,200,2,00097,India
441745,2024-01-23,1003,Foundation,300,600,300,2,00097,India
441745,2024-01-23,1008,Makeup Remover,80,160,80,2,00097,India
931981,2024-01-23,1005,Nail Polish,50,100,50,2,00424,India
931981,2024-01-23,1007,Eyeshadow,200,400,200,2,00424,India
931981,2024-01-23,1002,Mascara,200,400,200,2,00424,India
528867,2024-01-23,1005,Nail Polish,50,100,50,2,00240,India
528867,2024-01-23,1001,Lipstick,150,300,150,2,00240,India
528867,2024-01-23,1004,Eyeliner,100,200,100,2,00240,India
528867,2024-01-23,1003,Foundation,300,600,300,2,00240,India
735156,2024-01-24,1012,Body Lotion,200,400,200,2,00412,India
690729,2024-01-24,1005,Nail Polish,50,100,50,2,00207,India
690729,2024-01-24,1004,Eyeliner,100,200,100,2,00207,India
690729,2024-01-24,1001,Lipstick,150,300,150,2,00207,India
332182,2024-01-24,1002,Mascara,200,400,200,2,00273,India
332182,2024-01-24,1012,Body Lotion,200,400,200,2,00273,India
332182,2024-01-24,1005,Nail Polish,50,100,50,2,00273,India
635159,2024-01-24,1004,Eyeliner,100,200,100,2,00281,India
635159,2024-01-24,1002,Mascara,200,400,200,2,00281,India
635159,2024-01-24,1005,Nail Polish,50,100,50,2,00281,India
416073,2024-01-24,1003,Foundation,300,600,300,2,00179,India
416073,2024-01-24,1004,Eyeliner,100,200,100,2,00179,India
178017,2024-01-24,1012,Body Lotion,200,400,200,2,00185,India
357741,2024-01-24,1012,Body Lotion,200,400,200,2,00154,India
357741,2024-01-24,1005,Nail Polish,50,100,50,2,00154,India
357741,2024-01-24,1003,Foundation,300,600,300,2,00154,India
357741,2024-01-24,1004,Eyeliner,100,200,100,2,00154,India
912895,2024-01-24,1012,Body Lotion,200,400,200,2,00064,India
912895,2024-01-24,1004,Eyeliner,100,200,100,2,00064,India
912895,2024-01-24,1006,Blush,150,300,150,2,00064,India
912895,2024-01-24,1003,Foundation,300,600,300,2,00064,India
912895,2024-01-24,1001,Lipstick,150,300,150,2,00064,India
874221,2024-01-24,1002,Mascara,200,400,200,2,00142,India
874221,2024-01-24,1003,Foundation,300,600,300,2,00142,India
874221,2024-01-24,1008,Makeup Remover,80,160,80,2,00142,India
874221,2024-01-24,1009,Moisturizer,250,500,250,2,00142,India
874221,2024-01-24,1004,Eyeliner,100,200,100,2,00142,India
120789,2024-01-24,1003,Foundation,300,600,300,2,00035,India
120789,2024-01-24,1007,Eyeshadow,200,400,200,2,00035,India
120789,2024-01-24,1006,Blush,150,300,150,2,00035,India
120789,2024-01-24,1012,Body Lotion,200,400,200,2,00035,India
143216,2024-01-24,1008,Makeup Remover,80,160,80,2,00215,India
143216,2024-01-24,1005,Nail Polish,50,100,50,2,00215,India
659916,2024-01-24,1009,Moisturizer,250,500,250,2,00189,India
933093,2024-01-24,1002,Mascara,200,400,200,2,00165,India
933093,2024-01-24,1008,Makeup Remover,80,160,80,2,00165,India
320073,2024-01-24,1012,Body Lotion,200,400,200,2,00327,India
320073,2024-01-24,1008,Makeup Remover,80,160,80,2,00327,India
884713,2024-01-24,1003,Foundation,300,600,300,2,00269,India
884713,2024-01-24,1006,Blush,150,300,150,2,00269,India
198024,2024-01-24,1007,Eyeshadow,200,400,200,2,00004,India
198024,2024-01-24,1004,Eyeliner,100,200,100,2,00004,India
128495,2024-01-24,1009,Moisturizer,250,500,250,2,00453,India
128495,2024-01-24,1001,Lipstick,150,300,150,2,00453,India
128495,2024-01-24,1004,Eyeliner,100,200,100,2,00453,India
128495,2024-01-24,1007,Eyeshadow,200,400,200,2,00453,India
149971,2024-01-24,1012,Body Lotion,200,400,200,2,00053,India
149971,2024-01-24,1009,Moisturizer,250,500,250,2,00053,India
149971,2024-01-24,1007,Eyeshadow,200,400,200,2,00053,India
149971,2024-01-24,1002,Mascara,200,400,200,2,00053,India
763164,2024-01-24,1002,Mascara,200,400,200,2,00466,India
403030,2024-01-24,1003,Foundation,300,600,300,2,00121,India
648999,2024-01-24,1005,Nail Polish,50,100,50,2,00380,India
648999,2024-01-24,1001,Lipstick,150,300,150,2,00380,India
103247,2024-01-24,1007,Eyeshadow,200,400,200,2,00156,India
103247,2024-01-24,1012,Body Lotion,200,400,200,2,00156,India
103247,2024-01-24,1008,Makeup Remover,80,160,80,2,00156,India
103247,2024-01-24,1004,Eyeliner,100,200,100,2,00156,India
928389,2024-01-24,1005,Nail Polish,50,100,50,2,00278,India
928389,2024-01-24,1008,Makeup Remover,80,160,80,2,00278,India
928389,2024-01-24,1004,Eyeliner,100,200,100,2,00278,India
928389,2024-01-24,1002,Mascara,200,400,200,2,00278,India
439927,2024-01-24,1007,Eyeshadow,200,400,200,2,00155,India
439927,2024-01-24,1004,Eyeliner,100,200,100,2,00155,India
439927,2024-01-24,1012,Body Lotion,200,400,200,2,00155,India
750600,2024-01-24,1005,Nail Polish,50,100,50,2,00302,India
394221,2024-01-24,1002,Mascara,200,400,200,2,00109,India
841945,2024-01-24,1001,Lipstick,150,300,150,2,00144,India
841945,2024-01-24,1003,Foundation,300,600,300,2,00144,India
841945,2024-01-24,1007,Eyeshadow,200,400,200,2,00144,India
859479,2024-01-24,1002,Mascara,200,400,200,2,00415,India
859479,2024-01-24,1008,Makeup Remover,80,160,80,2,00415,India
393858,2024-01-24,1006,Blush,150,300,150,2,00068,India
825770,2024-01-24,1008,Makeup Remover,80,160,80,2,00313,India
825770,2024-01-24,1009,Moisturizer,250,500,250,2,00313,India
552176,2024-01-24,1012,Body Lotion,200,400,200,2,00312,India
552176,2024-01-24,1007,Eyeshadow,200,400,200,2,00312,India
552176,2024-01-24,1004,Eyeliner,100,200,100,2,00312,India
928525,2024-01-24,1008,Makeup Remover,80,160,80,2,00232,India
928525,2024-01-24,1006,Blush,150,300,150,2,00232,India
928525,2024-01-24,1005,Nail Polish,50,100,50,2,00232,India
928525,2024-01-24,1001,Lipstick,150,300,150,2,00232,India
128884,2024-01-24,1006,Blush,150,300,150,2,00421,India
706942,2024-01-24,1008,Makeup Remover,80,160,80,2,00044,India
706942,2024-01-24,1009,Moisturizer,250,500,250,2,00044,India
706942,2024-01-24,1007,Eyeshadow,200,400,200,2,00044,India
603869,2024-01-24,1012,Body Lotion,200,400,200,2,00372,India
603869,2024-01-24,1001,Lipstick,150,300,150,2,00372,India
603869,2024-01-24,1005,Nail Polish,50,100,50,2,00372,India
603869,2024-01-24,1002,Mascara,200,400,200,2,00372,India
736069,2024-01-24,1006,Blush,150,300,150,2,00424,India
736069,2024-01-24,1003,Foundation,300,600,300,2,00424,India
226938,2024-01-24,1008,Makeup Remover,80,160,80,2,00383,India
226938,2024-01-24,1007,Eyeshadow,200,400,200,2,00383,India
999879,2024-01-25,1005,Nail Polish,50,100,50,2,00344,India
227076,2024-01-25,1006,Blush,150,300,150,2,00339,India
227076,2024-01-25,1007,Eyeshadow,200,400,200,2,00339,India
227076,2024-01-25,1002,Mascara,200,400,200,2,00339,India
913576,2024-01-25,1008,Makeup Remover,80,160,80,2,00309,India
913576,2024-01-25,1002,Mascara,200,400,200,2,00309,India
913576,2024-01-25,1004,Eyeliner,100,200,100,2,00309,India
784674,2024-01-25,1005,Nail Polish,50,100,50,2,00008,India
784674,2024-01-25,1007,Eyeshadow,200,400,200,2,00008,India
784674,2024-01-25,1009,Moisturizer,250,500,250,2,00008,India
722999,2024-01-25,1005,Nail Polish,50,100,50,2,00354,India
722999,2024-01-25,1001,Lipstick,150,300,150,2,00354,India
418393,2024-01-25,1005,Nail Polish,50,100,50,2,00212,India
418393,2024-01-25,1004,Eyeliner,100,200,100,2,00212,India
434308,2024-01-25,1008,Makeup Remover,80,160,80,2,00153,India
434308,2024-01-25,1002,Mascara,200,400,200,2,00153,India
434308,2024-01-25,1007,Eyeshadow,200,400,200,2,00153,India
997202,2024-01-25,1003,Foundation,300,600,300,2,00359,India
997202,2024-01-25,1008,Makeup Remover,80,160,80,2,00359,India
439501,2024-01-25,1002,Mascara,200,400,200,2,00245,India
439501,2024-01-25,1001,Lipstick,150,300,150,2,00245,India
935441,2024-01-25,1007,Eyeshadow,200,400,200,2,00001,India
935441,2024-01-25,1002,Mascara,200,400,200,2,00001,India
935441,2024-01-25,1009,Moisturizer,250,500,250,2,00001,India
799902,2024-01-25,1012,Body Lotion,200,400,200,2,00050,India
799902,2024-01-25,1005,Nail Polish,50,100,50,2,00050,India
799902,2024-01-25,1003,Foundation,300,600,300,2,00050,India
531795,2024-01-25,1012,Body Lotion,200,400,200,2,00345,India
531795,2024-01-25,1001,Lipstick,150,300,150,2,00345,India
531795,2024-01-25,1002,Mascara,200,400,200,2,00345,India
192868,2024-01-25,1012,Body Lotion,200,400,200,2,00238,India
410935,2024-01-25,1009,Moisturizer,250,500,250,2,00370,India
410935,2024-01-25,1006,Blush,150,300,150,2,00370,India
410935,2024-01-25,1007,Eyeshadow,200,400,200,2,00370,India
827935,2024-01-25,1003,Foundation,300,600,300,2,00387,India
827935,2024-01-25,1006,Blush,150,300,150,2,00387,India
524433,2024-01-25,1008,Makeup Remover,80,160,80,2,00263,India
524433,2024-01-25,1012,Body Lotion,200,400,200,2,00263,India
524433,2024-01-25,1003,Foundation,300,600,300,2,00263,India
524433,2024-01-25,1009,Moisturizer,250,500,250,2,00263,India
676466,2024-01-25,1001,Lipstick,150,300,150,2,00254,India
676466,2024-01-25,1006,Blush,150,300,150,2,00254,India
676466,2024-01-25,1004,Eyeliner,100,200,100,2,00254,India
761249,2024-01-25,1001,Lipstick,150,300,150,2,00384,India
761249,2024-01-25,1003,Foundation,300,600,300,2,00384,India
761249,2024-01-25,1006,Blush,150,300,150,2,00384,India
761249,2024-01-25,1012,Body Lotion,200,400,200,2,00384,India
293974,2024-01-25,1007,Eyeshadow,200,400,200,2,00326,India
293974,2024-01-25,1003,Foundation,300,600,300,2,00326,India
293974,2024-01-25,1006,Blush,150,300,150,2,00326,India
293974,2024-01-25,1012,Body Lotion,200,400,200,2,00326,India
407545,2024-01-25,1007,Eyeshadow,200,400,200,2,00300,India
407545,2024-01-25,1012,Body Lotion,200,400,200,2,00300,India
407545,2024-01-25,1005,Nail Polish,50,100,50,2,00300,India
537344,2024-01-25,1002,Mascara,200,400,200,2,00087,India
537344,2024-01-25,1007,Eyeshadow,200,400,200,2,00087,India
537344,2024-01-25,1008,Makeup Remover,80,160,80,2,00087,India
652431,2024-01-25,1007,Eyeshadow,200,400,200,2,00205,India
652431,2024-01-25,1004,Eyeliner,100,200,100,2,00205,India
652431,2024-01-25,1008,Makeup Remover,80,160,80,2,00205,India
652431,2024-01-25,1012,Body Lotion,200,400,200,2,00205,India
546365,2024-01-25,1009,Moisturizer,250,500,250,2,00177,India
546365,2024-01-25,1005,Nail Polish,50,100,50,2,00177,India
546365,2024-01-25,1003,Foundation,300,600,300,2,00177,India
289706,2024-01-25,1002,Mascara,200,400,200,2,00410,India
289706,2024-01-25,1008,Makeup Remover,80,160,80,2,00410,India
289706,2024-01-25,1007,Eyeshadow,200,400,200,2,00410,India
289706,2024-01-25,1012,Body Lotion,200,400,200,2,00410,India
226797,2024-01-25,1012,Body Lotion,200,400,200,2,00476,India
226797,2024-01-25,1001,Lipstick,150,300,150,2,00476,India
798592,2024-01-25,1002,Mascara,200,400,200,2,00082,India
798592,2024-01-25,1012,Body Lotion,200,400,200,2,00082,India
798592,2024-01-25,1009,Moisturizer,250,500,250,2,00082,India
277526,2024-01-25,1005,Nail Polish,50,100,50,2,00062,India
277526,2024-01-25,1001,Lipstick,150,300,150,2,00062,India
715706,2024-01-25,1001,Lipstick,150,300,150,2,00353,India
715706,2024-01-25,1003,Foundation,300,600,300,2,00353,India
715706,2024-01-25,1009,Moisturizer,250,500,250,2,00353,India
724136,2024-01-25,1005,Nail Polish,50,100,50,2,00435,India
724136,2024-01-25,1001,Lipstick,150,300,150,2,00435,India
724136,2024-01-25,1008,Makeup Remover,80,160,80,2,00435,India
452894,2024-01-25,1001,Lipstick,150,300,150,2,00268,India
636787,2024-01-25,1012,Body Lotion,200,400,200,2,00422,India
636787,2024-01-25,1006,Blush,150,300,150,2,00422,India
636787,2024-01-25,1003,Foundation,300,600,300,2,00422,India
636787,2024-01-25,1007,Eyeshadow,200,400,200,2,00422,India
503544,2024-01-25,1006,Blush,150,300,150,2,00199,India
503544,2024-01-25,1007,Eyeshadow,200,400,200,2,00199,India
693128,2024-01-25,1006,Blush,150,300,150,2,00180,India
693128,2024-01-25,1001,Lipstick,150,300,150,2,00180,India
693128,2024-01-25,1004,Eyeliner,100,200,100,2,00180,India
693128,2024-01-25,1008,Makeup Remover,80,160,80,2,00180,India
994714,2024-01-25,1001,Lipstick,150,300,150,2,00218,India
994714,2024-01-25,1007,Eyeshadow,200,400,200,2,00218,India
994714,2024-01-25,1009,Moisturizer,250,500,250,2,00218,India
730801,2024-01-25,1008,Makeup Remover,80,160,80,2,00180,India
730801,2024-01-25,1009,Moisturizer,250,500,250,2,00180,India
730801,2024-01-25,1005,Nail Polish,50,100,50,2,00180,India
730801,2024-01-25,1012,Body Lotion,200,400,200,2,00180,India
605875,2024-01-25,1007,Eyeshadow,200,400,200,2,00162,India
605875,2024-01-25,1004,Eyeliner,100,200,100,2,00162,India
605875,2024-01-25,1008,Makeup Remover,80,160,80,2,00162,India
605875,2024-01-25,1003,Foundation,300,600,300,2,00162,India
548305,2024-01-25,1003,Foundation,300,600,300,2,00010,India
548305,2024-01-25,1002,Mascara,200,400,200,2,00010,India
548305,2024-01-25,1004,Eyeliner,100,200,100,2,00010,India
548305,2024-01-25,1001,Lipstick,150,300,150,2,00010,India
935342,2024-01-25,1005,Nail Polish,50,100,50,2,00335,India
520621,2024-01-25,1004,Eyeliner,100,200,100,2,00464,India
520621,2024-01-25,1006,Blush,150,300,150,2,00464,India
520621,2024-01-25,1005,Nail Polish,50,100,50,2,00464,India
520621,2024-01-25,1002,Mascara,200,400,200,2,00464,India
551550,2024-01-26,1005,Nail Polish,50,100,50,2,00187,India
502531,2024-01-26,1002,Mascara,200,400,200,2,00065,India
502531,2024-01-26,1006,Blush,150,300,150,2,00065,India
395039,2024-01-26,1012,Body Lotion,200,400,200,2,00050,India
395039,2024-01-26,1005,Nail Polish,50,100,50,2,00050,India
395039,2024-01-26,1008,Makeup Remover,80,160,80,2,00050,India
395039,2024-01-26,1001,Lipstick,150,300,150,2,00050,India
655172,2024-01-26,1002,Mascara,200,400,200,2,00008,India
655172,2024-01-26,1003,Foundation,300,600,300,2,00008,India
417310,2024-01-26,1003,Foundation,300,600,300,2,00156,India
417310,2024-01-26,1007,Eyeshadow,200,400,200,2,00156,India
417310,2024-01-26,1002,Mascara,200,400,200,2,00156,India
756555,2024-01-26,1007,Eyeshadow,200,400,200,2,00240,India
756555,2024-01-26,1001,Lipstick,150,300,150,2,00240,India
792202,2024-01-26,1002,Mascara,200,400,200,2,00338,India
792202,2024-01-26,1005,Nail Polish,50,100,50,2,00338,India
792202,2024-01-26,1004,Eyeliner,100,200,100,2,00338,India
951103,2024-01-26,1001,Lipstick,150,300,150,2,00434,India
951103,2024-01-26,1006,Blush,150,300,150,2,00434,India
951103,2024-01-26,1012,Body Lotion,200,400,200,2,00434,India
774912,2024-01-26,1007,Eyeshadow,200,400,200,2,00264,India
774912,2024-01-26,1009,Moisturizer,250,500,250,2,00264,India
774912,2024-01-26,1001,Lipstick,150,300,150,2,00264,India
774912,2024-01-26,1008,Makeup Remover,80,160,80,2,00264,India
774912,2024-01-26,1012,Body Lotion,200,400,200,2,00264,India
184601,2024-01-26,1007,Eyeshadow,200,400,200,2,00158,India
584353,2024-01-26,1004,Eyeliner,100,200,100,2,00074,India
584353,2024-01-26,1002,Mascara,200,400,200,2,00074,India
584353,2024-01-26,1001,Lipstick,150,300,150,2,00074,India
487131,2024-01-26,1012,Body Lotion,200,400,200,2,00007,India
487131,2024-01-26,1004,Eyeliner,100,200,100,2,00007,India
135811,2024-01-26,1005,Nail Polish,50,100,50,2,00361,India
135811,2024-01-26,1003,Foundation,300,600,300,2,00361,India
628832,2024-01-26,1006,Blush,150,300,150,2,00053,India
665118,2024-01-26,1005,Nail Polish,50,100,50,2,00347,India
665118,2024-01-26,1007,Eyeshadow,200,400,200,2,00347,India
783394,2024-01-26,1007,Eyeshadow,200,400,200,2,00020,India
783394,2024-01-26,1008,Makeup Remover,80,160,80,2,00020,India
783394,2024-01-26,1001,Lipstick,150,300,150,2,00020,India
783394,2024-01-26,1005,Nail Polish,50,100,50,2,00020,India
995902,2024-01-26,1008,Makeup Remover,80,160,80,2,00420,India
995902,2024-01-26,1003,Foundation,300,600,300,2,00420,India
995902,2024-01-26,1004,Eyeliner,100,200,100,2,00420,India
117958,2024-01-26,1007,Eyeshadow,200,400,200,2,00454,India
781622,2024-01-26,1002,Mascara,200,400,200,2,00337,India
850124,2024-01-26,1006,Blush,150,300,150,2,00020,India
850124,2024-01-26,1008,Makeup Remover,80,160,80,2,00020,India
850124,2024-01-26,1007,Eyeshadow,200,400,200,2,00020,India
850124,2024-01-26,1003,Foundation,300,600,300,2,00020,India
290562,2024-01-26,1006,Blush,150,300,150,2,00041,India
290562,2024-01-26,1009,Moisturizer,250,500,250,2,00041,India
859675,2024-01-26,1007,Eyeshadow,200,400,200,2,00374,India
859675,2024-01-26,1003,Foundation,300,600,300,2,00374,India
859675,2024-01-26,1002,Mascara,200,400,200,2,00374,India
859675,2024-01-26,1009,Moisturizer,250,500,250,2,00374,India
312137,2024-01-26,1003,Foundation,300,600,300,2,00241,India
312137,2024-01-26,1002,Mascara,200,400,200,2,00241,India
640655,2024-01-26,1012,Body Lotion,200,400,200,2,00423,India
640655,2024-01-26,1008,Makeup Remover,80,160,80,2,00423,India
640655,2024-01-26,1001,Lipstick,150,300,150,2,00423,India
640655,2024-01-26,1007,Eyeshadow,200,400,200,2,00423,India
697237,2024-01-26,1009,Moisturizer,250,500,250,2,00190,India
697237,2024-01-26,1006,Blush,150,300,150,2,00190,India
697237,2024-01-26,1012,Body Lotion,200,400,200,2,00190,India
697237,2024-01-26,1004,Eyeliner,100,200,100,2,00190,India
428685,2024-01-26,1001,Lipstick,150,300,150,2,00391,India
428685,2024-01-26,1012,Body Lotion,200,400,200,2,00391,India
597757,2024-01-26,1005,Nail Polish,50,100,50,2,00155,India
765917,2024-01-26,1002,Mascara,200,400,200,2,00136,India
765917,2024-01-26,1005,Nail Polish,50,100,50,2,00136,India
765917,2024-01-26,1012,Body Lotion,200,400,200,2,00136,India
765917,2024-01-26,1001,Lipstick,150,300,150,2,00136,India
765917,2024-01-26,1007,Eyeshadow,200,400,200,2,00136,India
132166,2024-01-26,1012,Body Lotion,200,400,200,2,00191,India
132166,2024-01-26,1009,Moisturizer,250,500,250,2,00191,India
132166,2024-01-26,1006,Blush,150,300,150,2,00191,India
132166,2024-01-26,1005,Nail Polish,50,100,50,2,00191,India
252835,2024-01-26,1012,Body Lotion,200,400,200,2,00413,India
252835,2024-01-26,1004,Eyeliner,100,200,100,2,00413,India
638129,2024-01-26,1007,Eyeshadow,200,400,200,2,00129,India
638129,2024-01-26,1012,Body Lotion,200,400,200,2,00129,India
751076,2024-01-26,1012,Body Lotion,200,400,200,2,00179,India
471685,2024-01-26,1002,Mascara,200,400,200,2,00157,India
471685,2024-01-26,1008,Makeup Remover,80,160,80,2,00157,India
471685,2024-01-26,1006,Blush,150,300,150,2,00157,India
471685,2024-01-26,1004,Eyeliner,100,200,100,2,00157,India
475513,2024-01-26,1007,Eyeshadow,200,400,200,2,00177,India
475513,2024-01-26,1004,Eyeliner,100,200,100,2,00177,India
475513,2024-01-26,1001,Lipstick,150,300,150,2,00177,India
529789,2024-01-26,1004,Eyeliner,100,200,100,2,00419,India
908722,2024-01-26,1004,Eyeliner,100,200,100,2,00217,India
908722,2024-01-26,1002,Mascara,200,400,200,2,00217,India
908722,2024-01-26,1012,Body Lotion,200,400,200,2,00217,India
505967,2024-01-26,1005,Nail Polish,50,100,50,2,00400,India
505967,2024-01-26,1001,Lipstick,150,300,150,2,00400,India
691889,2024-01-26,1004,Eyeliner,100,200,100,2,00417,India
691889,2024-01-26,1002,Mascara,200,400,200,2,00417,India
372752,2024-01-26,1006,Blush,150,300,150,2,00317,India
372752,2024-01-26,1012,Body Lotion,200,400,200,2,00317,India
242037,2024-01-26,1005,Nail Polish,50,100,50,2,00183,India
242037,2024-01-26,1001,Lipstick,150,300,150,2,00183,India
242037,2024-01-26,1004,Eyeliner,100,200,100,2,00183,India
242037,2024-01-26,1012,Body Lotion,200,400,200,2,00183,India
832610,2024-01-26,1001,Lipstick,150,300,150,2,00104,India
832610,2024-01-26,1002,Mascara,200,400,200,2,00104,India
832610,2024-01-26,1012,Body Lotion,200,400,200,2,00104,India
336812,2024-01-26,1006,Blush,150,300,150,2,00274,India
336812,2024-01-26,1004,Eyeliner,100,200,100,2,00274,India
336812,2024-01-26,1008,Makeup Remover,80,160,80,2,00274,India
566862,2024-01-27,1006,Blush,150,300,150,2,00015,India
968026,2024-01-27,1004,Eyeliner,100,200,100,2,00206,India
968026,2024-01-27,1006,Blush,150,300,150,2,00206,India
968026,2024-01-27,1001,Lipstick,150,300,150,2,00206,India
968026,2024-01-27,1005,Nail Polish,50,100,50,2,00206,India
247991,2024-01-27,1008,Makeup Remover,80,160,80,2,00412,India
247991,2024-01-27,1007,Eyeshadow,200,400,200,2,00412,India
247991,2024-01-27,1004,Eyeliner,100,200,100,2,00412,India
247991,2024-01-27,1003,Foundation,300,600,300,2,00412,India
140202,2024-01-27,1005,Nail Polish,50,100,50,2,00232,India
140202,2024-01-27,1008,Makeup Remover,80,160,80,2,00232,India
140202,2024-01-27,1009,Moisturizer,250,500,250,2,00232,India
140202,2024-01-27,1012,Body Lotion,200,400,200,2,00232,India
946787,2024-01-27,1001,Lipstick,150,300,150,2,00155,India
946787,2024-01-27,1012,Body Lotion,200,400,200,2,00155,India
946787,2024-01-27,1005,Nail Polish,50,100,50,2,00155,India
646926,2024-01-27,1008,Makeup Remover,80,160,80,2,00213,India
646926,2024-01-27,1009,Moisturizer,250,500,250,2,00213,India
646926,2024-01-27,1002,Mascara,200,400,200,2,00213,India
646926,2024-01-27,1004,Eyeliner,100,200,100,2,00213,India
508600,2024-01-27,1009,Moisturizer,250,500,250,2,00084,India
508600,2024-01-27,1006,Blush,150,300,150,2,00084,India
508600,2024-01-27,1003,Foundation,300,600,300,2,00084,India
508600,2024-01-27,1008,Makeup Remover,80,160,80,2,00084,India
743801,2024-01-27,1005,Nail Polish,50,100,50,2,00485,India
743801,2024-01-27,1012,Body Lotion,200,400,200,2,00485,India
752341,2024-01-27,1005,Nail Polish,50,100,50,2,00381,India
752341,2024-01-27,1008,Makeup Remover,80,160,80,2,00381,India
752341,2024-01-27,1009,Moisturizer,250,500,250,2,00381,India
660442,2024-01-27,1004,Eyeliner,100,200,100,2,00224,India
660442,2024-01-27,1006,Blush,150,300,150,2,00224,India
648053,2024-01-27,1003,Foundation,300,600,300,2,00315,India
665702,2024-01-27,1006,Blush,150,300,150,2,00180,India
665702,2024-01-27,1003,Foundation,300,600,300,2,00180,India
665702,2024-01-27,1002,Mascara,200,400,200,2,00180,India
673226,2024-01-27,1001,Lipstick,150,300,150,2,00399,India
673226,2024-01-27,1005,Nail Polish,50,100,50,2,00399,India
673226,2024-01-27,1003,Foundation,300,600,300,2,00399,India
515664,2024-01-27,1009,Moisturizer,250,500,250,2,00452,India
515664,2024-01-27,1008,Makeup Remover,80,160,80,2,00452,India
515664,2024-01-27,1005,Nail Polish,50,100,50,2,00452,India
515664,2024-01-27,1004,Eyeliner,100,200,100,2,00452,India
515664,2024-01-27,1007,Eyeshadow,200,400,200,2,00452,India
759870,2024-01-27,1008,Makeup Remover,80,160,80,2,00363,India
759870,2024-01-27,1007,Eyeshadow,200,400,200,2,00363,India
759870,2024-01-27,1006,Blush,150,300,150,2,00363,India
932542,2024-01-27,1006,Blush,150,300,150,2,00474,India
932542,2024-01-27,1001,Lipstick,150,300,150,2,00474,India
833314,2024-01-27,1006,Blush,150,300,150,2,00461,India
833314,2024-01-27,1004,Eyeliner,100,200,100,2,00461,India
833314,2024-01-27,1008,Makeup Remover,80,160,80,2,00461,India
833314,2024-01-27,1012,Body Lotion,200,400,200,2,00461,India
689938,2024-01-27,1001,Lipstick,150,300,150,2,00498,India
689938,2024-01-27,1004,Eyeliner,100,200,100,2,00498,India
689938,2024-01-27,1012,Body Lotion,200,400,200,2,00498,India
877390,2024-01-27,1007,Eyeshadow,200,400,200,2,00008,India
877390,2024-01-27,1009,Moisturizer,250,500,250,2,00008,India
877390,2024-01-27,1012,Body Lotion,200,400,200,2,00008,India
854720,2024-01-27,1005,Nail Polish,50,100,50,2,00169,India
854720,2024-01-27,1003,Foundation,300,600,300,2,00169,India
854720,2024-01-27,1007,Eyeshadow,200,400,200,2,00169,India
937022,2024-01-27,1003,Foundation,300,600,300,2,00311,India
937022,2024-01-27,1001,Lipstick,150,300,150,2,00311,India
516164,2024-01-27,1002,Mascara,200,400,200,2,00044,India
516164,2024-01-27,1012,Body Lotion,200,400,200,2,00044,India
516164,2024-01-27,1005,Nail Polish,50,100,50,2,00044,India
971141,2024-01-27,1002,Mascara,200,400,200,2,00212,India
971141,2024-01-27,1009,Moisturizer,250,500,250,2,00212,India
971141,2024-01-27,1007,Eyeshadow,200,400,200,2,00212,India
630444,2024-01-27,1002,Mascara,200,400,200,2,00197,India
630444,2024-01-27,1007,Eyeshadow,200,400,200,2,00197,India
456758,2024-01-27,1007,Eyeshadow,200,400,200,2,00446,India
456758,2024-01-27,1001,Lipstick,150,300,150,2,00446,India
456758,2024-01-27,1006,Blush,150,300,150,2,00446,India
951743,2024-01-27,1001,Lipstick,150,300,150,2,00455,India
945358,2024-01-27,1001,Lipstick,150,300,150,2,00329,India
945358,2024-01-27,1009,Moisturizer,250,500,250,2,00329,India
945358,2024-01-27,1006,Blush,150,300,150,2,00329,India
945358,2024-01-27,1005,Nail Polish,50,100,50,2,00329,India
334868,2024-01-27,1002,Mascara,200,400,200,2,00448,India
334868,2024-01-27,1008,Makeup Remover,80,160,80,2,00448,India
836107,2024-01-27,1012,Body Lotion,200,400,200,2,00207,India
836107,2024-01-27,1006,Blush,150,300,150,2,00207,India
836107,2024-01-27,1002,Mascara,200,400,200,2,00207,India
836107,2024-01-27,1001,Lipstick,150,300,150,2,00207,India
709576,2024-01-27,1004,Eyeliner,100,200,100,2,00038,India
708901,2024-01-27,1005,Nail Polish,50,100,50,2,00468,India
708901,2024-01-27,1008,Makeup Remover,80,160,80,2,00468,India
708901,2024-01-27,1007,Eyeshadow,200,400,200,2,00468,India
767988,2024-01-27,1002,Mascara,200,400,200,2,00105,India
767988,2024-01-27,1009,Moisturizer,250,500,250,2,00105,India
686009,2024-01-27,1006,Blush,150,300,150,2,00332,India
686009,2024-01-27,1012,Body Lotion,200,400,200,2,00332,India
674002,2024-01-27,1006,Blush,150,300,150,2,00374,India
674002,2024-01-27,1002,Mascara,200,400,200,2,00374,India
577791,2024-01-27,1003,Foundation,300,600,300,2,00414,India
577791,2024-01-27,1007,Eyeshadow,200,400,200,2,00414,India
778413,2024-01-27,1006,Blush,150,300,150,2,00427,India
778413,2024-01-27,1009,Moisturizer,250,500,250,2,00427,India
778413,2024-01-27,1002,Mascara,200,400,200,2,00427,India
540377,2024-01-27,1007,Eyeshadow,200,400,200,2,00058,India
998259,2024-01-27,1012,Body Lotion,200,400,200,2,00414,India
998259,2024-01-27,1009,Moisturizer,250,500,250,2,00414,India
998259,2024-01-27,1001,Lipstick,150,300,150,2,00414,India
998259,2024-01-27,1008,Makeup Remover,80,160,80,2,00414,India
237960,2024-01-27,1009,Moisturizer,250,500,250,2,00387,India
360572,2024-01-27,1008,Makeup Remover,80,160,80,2,00142,India
695687,2024-01-27,1001,Lipstick,150,300,150,2,00026,India
695687,2024-01-27,1006,Blush,150,300,150,2,00026,India
917868,2024-01-27,1002,Mascara,200,400,200,2,00373,India
917868,2024-01-27,1005,Nail Polish,50,100,50,2,00373,India
917868,2024-01-27,1004,Eyeliner,100,200,100,2,00373,India
175161,2024-01-27,1001,Lipstick,150,300,150,2,00111,India
175161,2024-01-27,1007,Eyeshadow,200,400,200,2,00111,India
175161,2024-01-27,1009,Moisturizer,250,500,250,2,00111,India
386502,2024-01-27,1007,Eyeshadow,200,400,200,2,00243,India
420665,2024-01-27,1001,Lipstick,150,300,150,2,00454,India
420665,2024-01-27,1003,Foundation,300,600,300,2,00454,India
420665,2024-01-27,1002,Mascara,200,400,200,2,00454,India
417014,2024-01-27,1012,Body Lotion,200,400,200,2,00494,India
498885,2024-01-27,1003,Foundation,300,600,300,2,00021,India
498885,2024-01-27,1012,Body Lotion,200,400,200,2,00021,India
498885,2024-01-27,1002,Mascara,200,400,200,2,00021,India
498885,2024-01-27,1009,Moisturizer,250,500,250,2,00021,India
316016,2024-01-27,1005,Nail Polish,50,100,50,2,00258,India
419356,2024-01-27,1005,Nail Polish,50,100,50,2,00494,India
419356,2024-01-27,1008,Makeup Remover,80,160,80,2,00494,India
419356,2024-01-27,1007,Eyeshadow,200,400,200,2,00494,India
419356,2024-01-27,1012,Body Lotion,200,400,200,2,00494,India
901813,2024-01-27,1012,Body Lotion,200,400,200,2,00486,India
901813,2024-01-27,1009,Moisturizer,250,500,250,2,00486,India
901813,2024-01-27,1002,Mascara,200,400,200,2,00486,India
862418,2024-01-28,1005,Nail Polish,50,100,50,2,00173,India
862418,2024-01-28,1003,Foundation,300,600,300,2,00173,India
862418,2024-01-28,1009,Moisturizer,250,500,250,2,00173,India
862418,2024-01-28,1008,Makeup Remover,80,160,80,2,00173,India
975815,2024-01-28,1008,Makeup Remover,80,160,80,2,00278,India
173906,2024-01-28,1012,Body Lotion,200,400,200,2,00222,India
173906,2024-01-28,1008,Makeup Remover,80,160,80,2,00222,India
173906,2024-01-28,1007,Eyeshadow,200,400,200,2,00222,India
173906,2024-01-28,1001,Lipstick,150,300,150,2,00222,India
224107,2024-01-28,1001,Lipstick,150,300,150,2,00176,India
224107,2024-01-28,1003,Foundation,300,600,300,2,00176,India
224107,2024-01-28,1009,Moisturizer,250,500,250,2,00176,India
528697,2024-01-28,1002,Mascara,200,400,200,2,00344,India
528697,2024-01-28,1007,Eyeshadow,200,400,200,2,00344,India
288010,2024-01-28,1003,Foundation,300,600,300,2,00257,India
296434,2024-01-28,1004,Eyeliner,100,200,100,2,00368,India
296434,2024-01-28,1003,Foundation,300,600,300,2,00368,India
296434,2024-01-28,1009,Moisturizer,250,500,250,2,00368,India
296434,2024-01-28,1012,Body Lotion,200,400,200,2,00368,India
320588,2024-01-28,1001,Lipstick,150,300,150,2,00057,India
398176,2024-01-28,1005,Nail Polish,50,100,50,2,00038,India
398176,2024-01-28,1004,Eyeliner,100,200,100,2,00038,India
398176,2024-01-28,1008,Makeup Remover,80,160,80,2,00038,India
833724,2024-01-28,1006,Blush,150,300,150,2,00155,India
833724,2024-01-28,1007,Eyeshadow,200,400,200,2,00155,India
883581,2024-01-28,1008,Makeup Remover,80,160,80,2,00106,India
643251,2024-01-28,1004,Eyeliner,100,200,100,2,00326,India
628671,2024-01-28,1005,Nail Polish,50,100,50,2,00045,India
628671,2024-01-28,1003,Foundation,300,600,300,2,00045,India
628671,2024-01-28,1008,Makeup Remover,80,160,80,2,00045,India
628671,2024-01-28,1004,Eyeliner,100,200,100,2,00045,India
343191,2024-01-28,1012,Body Lotion,200,400,200,2,00472,India
343191,2024-01-28,1007,Eyeshadow,200,400,200,2,00472,India
343191,2024-01-28,1001,Lipstick,150,300,150,2,00472,India
724507,2024-01-28,1004,Eyeliner,100,200,100,2,00051,India
660456,2024-01-28,1008,Makeup Remover,80,160,80,2,00497,India
660456,2024-01-28,1012,Body Lotion,200,400,200,2,00497,India
739047,2024-01-28,1012,Body Lotion,200,400,200,2,00315,India
739047,2024-01-28,1004,Eyeliner,100,200,100,2,00315,India
739047,2024-01-28,1001,Lipstick,150,300,150,2,00315,India
739047,2024-01-28,1005,Nail Polish,50,100,50,2,00315,India
739047,2024-01-28,1002,Mascara,200,400,200,2,00315,India
189710,2024-01-28,1012,Body Lotion,200,400,200,2,00136,India
189710,2024-01-28,1009,Moisturizer,250,500,250,2,00136,India
189710,2024-01-28,1003,Foundation,300,600,300,2,00136,India
185160,2024-01-28,1003,Foundation,300,600,300,2,00147,India
978991,2024-01-28,1002,Mascara,200,400,200,2,00160,India
978991,2024-01-28,1009,Moisturizer,250,500,250,2,00160,India
177052,2024-01-28,1004,Eyeliner,100,200,100,2,00009,India
177052,2024-01-28,1003,Foundation,300,600,300,2,00009,India
177052,2024-01-28,1012,Body Lotion,200,400,200,2,00009,India
177052,2024-01-28,1006,Blush,150,300,150,2,00009,India
274031,2024-01-28,1003,Foundation,300,600,300,2,00278,India
774528,2024-01-28,1008,Makeup Remover,80,160,80,2,00287,India
774528,2024-01-28,1009,Moisturizer,250,500,250,2,00287,India
774528,2024-01-28,1007,Eyeshadow,200,400,200,2,00287,India
774528,2024-01-28,1004,Eyeliner,100,200,100,2,00287,India
185232,2024-01-28,1007,Eyeshadow,200,400,200,2,00346,India
185232,2024-01-28,1006,Blush,150,300,150,2,00346,India
325470,2024-01-28,1007,Eyeshadow,200,400,200,2,00116,India
325470,2024-01-28,1006,Blush,150,300,150,2,00116,India
325470,2024-01-28,1002,Mascara,200,400,200,2,00116,India
466547,2024-01-28,1003,Foundation,300,600,300,2,00499,India
466547,2024-01-28,1009,Moisturizer,250,500,250,2,00499,India
466547,2024-01-28,1007,Eyeshadow,200,400,200,2,00499,India
358303,2024-01-28,1005,Nail Polish,50,100,50,2,00117,India
358303,2024-01-28,1002,Mascara,200,400,200,2,00117,India
358303,2024-01-28,1012,Body Lotion,200,400,200,2,00117,India
206158,2024-01-28,1008,Makeup Remover,80,160,80,2,00033,India
206158,2024-01-28,1003,Foundation,300,600,300,2,00033,India
206158,2024-01-28,1001,Lipstick,150,300,150,2,00033,India
874753,2024-01-28,1004,Eyeliner,100,200,100,2,00187,India
900888,2024-01-28,1003,Foundation,300,600,300,2,00369,India
900888,2024-01-28,1012,Body Lotion,200,400,200,2,00369,India
479447,2024-01-28,1006,Blush,150,300,150,2,00326,India
479447,2024-01-28,1002,Mascara,200,400,200,2,00326,India
448622,2024-01-28,1006,Blush,150,300,150,2,00029,India
448622,2024-01-28,1005,Nail Polish,50,100,50,2,00029,India
513463,2024-01-28,1012,Body Lotion,200,400,200,2,00302,India
306352,2024-01-28,1004,Eyeliner,100,200,100,2,00370,India
306352,2024-01-28,1008,Makeup Remover,80,160,80,2,00370,India
306352,2024-01-28,1006,Blush,150,300,150,2,00370,India
306352,2024-01-28,1007,Eyeshadow,200,400,200,2,00370,India
392629,2024-01-28,1008,Makeup Remover,80,160,80,2,00325,India
392629,2024-01-28,1005,Nail Polish,50,100,50,2,00325,India
392629,2024-01-28,1003,Foundation,300,600,300,2,00325,India
392629,2024-01-28,1001,Lipstick,150,300,150,2,00325,India
422324,2024-01-28,1007,Eyeshadow,200,400,200,2,00231,India
422324,2024-01-28,1006,Blush,150,300,150,2,00231,India
325818,2024-01-28,1001,Lipstick,150,300,150,2,00206,India
578639,2024-01-28,1008,Makeup Remover,80,160,80,2,00017,India
578639,2024-01-28,1009,Moisturizer,250,500,250,2,00017,India
212042,2024-01-28,1005,Nail Polish,50,100,50,2,00210,India
212042,2024-01-28,1006,Blush,150,300,150,2,00210,India
212042,2024-01-28,1007,Eyeshadow,200,400,200,2,00210,India
861859,2024-01-28,1007,Eyeshadow,200,400,200,2,00070,India
861859,2024-01-28,1002,Mascara,200,400,200,2,00070,India
861859,2024-01-28,1004,Eyeliner,100,200,100,2,00070,India
861859,2024-01-28,1006,Blush,150,300,150,2,00070,India
713672,2024-01-28,1009,Moisturizer,250,500,250,2,00239,India
713672,2024-01-28,1004,Eyeliner,100,200,100,2,00239,India
649572,2024-01-28,1003,Foundation,300,600,300,2,00218,India
328816,2024-01-28,1002,Mascara,200,400,200,2,00251,India
328816,2024-01-28,1003,Foundation,300,600,300,2,00251,India
328816,2024-01-28,1006,Blush,150,300,150,2,00251,India
328816,2024-01-28,1001,Lipstick,150,300,150,2,00251,India
685461,2024-01-29,1005,Nail Polish,50,100,50,2,00230,India
685461,2024-01-29,1002,Mascara,200,400,200,2,00230,India
251896,2024-01-29,1004,Eyeliner,100,200,100,2,00377,India
251896,2024-01-29,1012,Body Lotion,200,400,200,2,00377,India
251896,2024-01-29,1007,Eyeshadow,200,400,200,2,00377,India
801163,2024-01-29,1006,Blush,150,300,150,2,00128,India
801163,2024-01-29,1012,Body Lotion,200,400,200,2,00128,India
801163,2024-01-29,1002,Mascara,200,400,200,2,00128,India
801163,2024-01-29,1007,Eyeshadow,200,400,200,2,00128,India
801163,2024-01-29,1003,Foundation,300,600,300,2,00128,India
679165,2024-01-29,1012,Body Lotion,200,400,200,2,00463,India
679165,2024-01-29,1008,Makeup Remover,80,160,80,2,00463,India
679165,2024-01-29,1005,Nail Polish,50,100,50,2,00463,India
679165,2024-01-29,1007,Eyeshadow,200,400,200,2,00463,India
679165,2024-01-29,1003,Foundation,300,600,300,2,00463,India
762062,2024-01-29,1012,Body Lotion,200,400,200,2,00181,India
762062,2024-01-29,1004,Eyeliner,100,200,100,2,00181,India
762062,2024-01-29,1005,Nail Polish,50,100,50,2,00181,India
363824,2024-01-29,1002,Mascara,200,400,200,2,00250,India
363824,2024-01-29,1008,Makeup Remover,80,160,80,2,00250,India
363824,2024-01-29,1001,Lipstick,150,300,150,2,00250,India
559897,2024-01-29,1005,Nail Polish,50,100,50,2,00204,India
559897,2024-01-29,1007,Eyeshadow,200,400,200,2,00204,India
216501,2024-01-29,1004,Eyeliner,100,200,100,2,00036,India
894767,2024-01-29,1003,Foundation,300,600,300,2,00077,India
894767,2024-01-29,1001,Lipstick,150,300,150,2,00077,India
894767,2024-01-29,1007,Eyeshadow,200,400,200,2,00077,India
894767,2024-01-29,1012,Body Lotion,200,400,200,2,00077,India
150052,2024-01-29,1007,Eyeshadow,200,400,200,2,00408,India
150052,2024-01-29,1006,Blush,150,300,150,2,00408,India
150052,2024-01-29,1001,Lipstick,150,300,150,2,00408,India
488591,2024-01-29,1008,Makeup Remover,80,160,80,2,00134,India
662240,2024-01-29,1007,Eyeshadow,200,400,200,2,00286,India
662240,2024-01-29,1012,Body Lotion,200,400,200,2,00286,India
662240,2024-01-29,1004,Eyeliner,100,200,100,2,00286,India
662240,2024-01-29,1003,Foundation,300,600,300,2,00286,India
857950,2024-01-29,1007,Eyeshadow,200,400,200,2,00259,India
850238,2024-01-29,1009,Moisturizer,250,500,250,2,00343,India
850238,2024-01-29,1005,Nail Polish,50,100,50,2,00343,India
850238,2024-01-29,1006,Blush,150,300,150,2,00343,India
850238,2024-01-29,1007,Eyeshadow,200,400,200,2,00343,India
850238,2024-01-29,1001,Lipstick,150,300,150,2,00343,India
817613,2024-01-29,1005,Nail Polish,50,100,50,2,00168,India
758178,2024-01-29,1007,Eyeshadow,200,400,200,2,00411,India
537029,2024-01-29,1012,Body Lotion,200,400,200,2,00492,India
537029,2024-01-29,1009,Moisturizer,250,500,250,2,00492,India
537029,2024-01-29,1001,Lipstick,150,300,150,2,00492,India
107481,2024-01-29,1009,Moisturizer,250,500,250,2,00454,India
107481,2024-01-29,1005,Nail Polish,50,100,50,2,00454,India
107481,2024-01-29,1008,Makeup Remover,80,160,80,2,00454,India
107481,2024-01-29,1001,Lipstick,150,300,150,2,00454,India
276393,2024-01-29,1005,Nail Polish,50,100,50,2,00132,India
276393,2024-01-29,1003,Foundation,300,600,300,2,00132,India
276393,2024-01-29,1009,Moisturizer,250,500,250,2,00132,India
658872,2024-01-29,1003,Foundation,300,600,300,2,00087,India
636170,2024-01-29,1003,Foundation,300,600,300,2,00466,India
636170,2024-01-29,1005,Nail Polish,50,100,50,2,00466,India
636170,2024-01-29,1002,Mascara,200,400,200,2,00466,India
621056,2024-01-29,1003,Foundation,300,600,300,2,00041,India
621056,2024-01-29,1002,Mascara,200,400,200,2,00041,India
621056,2024-01-29,1009,Moisturizer,250,500,250,2,00041,India
239283,2024-01-29,1003,Foundation,300,600,300,2,00159,India
171277,2024-01-29,1007,Eyeshadow,200,400,200,2,00076,India
332343,2024-01-29,1006,Blush,150,300,150,2,00221,India
304519,2024-01-29,1006,Blush,150,300,150,2,00389,India
304519,2024-01-29,1004,Eyeliner,100,200,100,2,00389,India
382376,2024-01-29,1001,Lipstick,150,300,150,2,00401,India
382376,2024-01-29,1012,Body Lotion,200,400,200,2,00401,India
382376,2024-01-29,1008,Makeup Remover,80,160,80,2,00401,India
767253,2024-01-29,1003,Foundation,300,600,300,2,00415,India
767253,2024-01-29,1006,Blush,150,300,150,2,00415,India
767253,2024-01-29,1007,Eyeshadow,200,400,200,2,00415,India
998054,2024-01-29,1004,Eyeliner,100,200,100,2,00463,India
998054,2024-01-29,1009,Moisturizer,250,500,250,2,00463,India
912965,2024-01-29,1012,Body Lotion,200,400,200,2,00068,India
749481,2024-01-29,1003,Foundation,300,600,300,2,00264,India
749481,2024-01-29,1004,Eyeliner,100,200,100,2,00264,India
749481,2024-01-29,1008,Makeup Remover,80,160,80,2,00264,India
952177,2024-01-29,1008,Makeup Remover,80,160,80,2,00474,India
952177,2024-01-29,1001,Lipstick,150,300,150,2,00474,India
726016,2024-01-29,1009,Moisturizer,250,500,250,2,00365,India
726016,2024-01-29,1005,Nail Polish,50,100,50,2,00365,India
726016,2024-01-29,1008,Makeup Remover,80,160,80,2,00365,India
617075,2024-01-29,1007,Eyeshadow,200,400,200,2,00340,India
617075,2024-01-29,1005,Nail Polish,50,100,50,2,00340,India
617075,2024-01-29,1003,Foundation,300,600,300,2,00340,India
617075,2024-01-29,1012,Body Lotion,200,400,200,2,00340,India
220483,2024-01-29,1009,Moisturizer,250,500,250,2,00321,India
512202,2024-01-29,1003,Foundation,300,600,300,2,00061,India
186504,2024-01-30,1008,Makeup Remover,80,160,80,2,00486,India
192998,2024-01-30,1004,Eyeliner,100,200,100,2,00493,India
868652,2024-01-30,1003,Foundation,300,600,300,2,00425,India
392398,2024-01-30,1007,Eyeshadow,200,400,200,2,00252,India
392398,2024-01-30,1001,Lipstick,150,300,150,2,00252,India
392398,2024-01-30,1004,Eyeliner,100,200,100,2,00252,India
392398,2024-01-30,1002,Mascara,200,400,200,2,00252,India
950666,2024-01-30,1001,Lipstick,150,300,150,2,00099,India
612867,2024-01-30,1001,Lipstick,150,300,150,2,00163,India
612867,2024-01-30,1004,Eyeliner,100,200,100,2,00163,India
612867,2024-01-30,1007,Eyeshadow,200,400,200,2,00163,India
612867,2024-01-30,1012,Body Lotion,200,400,200,2,00163,India
494500,2024-01-30,1003,Foundation,300,600,300,2,00075,India
494500,2024-01-30,1004,Eyeliner,100,200,100,2,00075,India
494500,2024-01-30,1012,Body Lotion,200,400,200,2,00075,India
950424,2024-01-30,1002,Mascara,200,400,200,2,00006,India
323905,2024-01-30,1004,Eyeliner,100,200,100,2,00479,India
323905,2024-01-30,1007,Eyeshadow,200,400,200,2,00479,India
323905,2024-01-30,1006,Blush,150,300,150,2,00479,India
554760,2024-01-30,1003,Foundation,300,600,300,2,00350,India
554760,2024-01-30,1007,Eyeshadow,200,400,200,2,00350,India
577361,2024-01-30,1004,Eyeliner,100,200,100,2,00297,India
577361,2024-01-30,1007,Eyeshadow,200,400,200,2,00297,India
577361,2024-01-30,1002,Mascara,200,400,200,2,00297,India
577361,2024-01-30,1008,Makeup Remover,80,160,80,2,00297,India
912480,2024-01-30,1006,Blush,150,300,150,2,00182,India
912480,2024-01-30,1002,Mascara,200,400,200,2,00182,India
912480,2024-01-30,1005,Nail Polish,50,100,50,2,00182,India
553039,2024-01-30,1001,Lipstick,150,300,150,2,00465,India
550054,2024-01-30,1001,Lipstick,150,300,150,2,00120,India
550054,2024-01-30,1005,Nail Polish,50,100,50,2,00120,India
550054,2024-01-30,1006,Blush,150,300,150,2,00120,India
550054,2024-01-30,1002,Mascara,200,400,200,2,00120,India
550054,2024-01-30,1012,Body Lotion,200,400,200,2,00120,India
613367,2024-01-30,1001,Lipstick,150,300,150,2,00393,India
613367,2024-01-30,1002,Mascara,200,400,200,2,00393,India
613367,2024-01-30,1004,Eyeliner,100,200,100,2,00393,India
613367,2024-01-30,1012,Body Lotion,200,400,200,2,00393,India
387031,2024-01-30,1006,Blush,150,300,150,2,00069,India
911723,2024-01-30,1004,Eyeliner,100,200,100,2,00120,India
911723,2024-01-30,1005,Nail Polish,50,100,50,2,00120,India
813697,2024-01-30,1007,Eyeshadow,200,400,200,2,00013,India
813697,2024-01-30,1009,Moisturizer,250,500,250,2,00013,India
813697,2024-01-30,1005,Nail Polish,50,100,50,2,00013,India
899740,2024-01-30,1007,Eyeshadow,200,400,200,2,00191,India
899740,2024-01-30,1008,Makeup Remover,80,160,80,2,00191,India
899740,2024-01-30,1009,Moisturizer,250,500,250,2,00191,India
747057,2024-01-30,1002,Mascara,200,400,200,2,00171,India
656287,2024-01-30,1006,Blush,150,300,150,2,00095,India
656287,2024-01-30,1003,Foundation,300,600,300,2,00095,India
706985,2024-01-30,1007,Eyeshadow,200,400,200,2,00237,India
201879,2024-01-30,1008,Makeup Remover,80,160,80,2,00273,India
201879,2024-01-30,1001,Lipstick,150,300,150,2,00273,India
818858,2024-01-30,1012,Body Lotion,200,400,200,2,00080,India
818858,2024-01-30,1004,Eyeliner,100,200,100,2,00080,India
818858,2024-01-30,1009,Moisturizer,250,500,250,2,00080,India
818858,2024-01-30,1007,Eyeshadow,200,400,200,2,00080,India
605525,2024-01-30,1012,Body Lotion,200,400,200,2,00297,India
605525,2024-01-30,1006,Blush,150,300,150,2,00297,India
437256,2024-01-30,1009,Moisturizer,250,500,250,2,00426,India
437256,2024-01-30,1003,Foundation,300,600,300,2,00426,India
437256,2024-01-30,1004,Eyeliner,100,200,100,2,00426,India
564123,2024-01-30,1005,Nail Polish,50,100,50,2,00228,India
896417,2024-01-30,1003,Foundation,300,600,300,2,00004,India
896417,2024-01-30,1007,Eyeshadow,200,400,200,2,00004,India
896417,2024-01-30,1001,Lipstick,150,300,150,2,00004,India
896417,2024-01-30,1002,Mascara,200,400,200,2,00004,India
896417,2024-01-30,1004,Eyeliner,100,200,100,2,00004,India
344087,2024-01-30,1001,Lipstick,150,300,150,2,00350,India
344087,2024-01-30,1007,Eyeshadow,200,400,200,2,00350,India
888923,2024-01-30,1003,Foundation,300,600,300,2,00103,India
888923,2024-01-30,1002,Mascara,200,400,200,2,00103,India
888923,2024-01-30,1006,Blush,150,300,150,2,00103,India
999985,2024-01-30,1002,Mascara,200,400,200,2,00437,India
999985,2024-01-30,1007,Eyeshadow,200,400,200,2,00437,India
596964,2024-01-30,1008,Makeup Remover,80,160,80,2,00135,India
244357,2024-01-30,1007,Eyeshadow,200,400,200,2,00077,India
244357,2024-01-30,1009,Moisturizer,250,500,250,2,00077,India
786113,2024-01-30,1002,Mascara,200,400,200,2,00453,India
786113,2024-01-30,1001,Lipstick,150,300,150,2,00453,India
786113,2024-01-30,1009,Moisturizer,250,500,250,2,00453,India
786113,2024-01-30,1008,Makeup Remover,80,160,80,2,00453,India
827902,2024-01-30,1007,Eyeshadow,200,400,200,2,00179,India
827902,2024-01-30,1006,Blush,150,300,150,2,00179,India
827902,2024-01-30,1002,Mascara,200,400,200,2,00179,India
611038,2024-01-30,1004,Eyeliner,100,200,100,2,00179,India
611038,2024-01-30,1001,Lipstick,150,300,150,2,00179,India
611038,2024-01-30,1007,Eyeshadow,200,400,200,2,00179,India
611038,2024-01-30,1006,Blush,150,300,150,2,00179,India
157743,2024-01-30,1009,Moisturizer,250,500,250,2,00372,India
157743,2024-01-30,1001,Lipstick,150,300,150,2,00372,India
157743,2024-01-30,1012,Body Lotion,200,400,200,2,00372,India
157743,2024-01-30,1005,Nail Polish,50,100,50,2,00372,India
157743,2024-01-30,1007,Eyeshadow,200,400,200,2,00372,India
503835,2024-01-30,1012,Body Lotion,200,400,200,2,00287,India
503835,2024-01-30,1009,Moisturizer,250,500,250,2,00287,India
255577,2024-01-30,1006,Blush,150,300,150,2,00491,India
255577,2024-01-30,1002,Mascara,200,400,200,2,00491,India
949710,2024-01-30,1005,Nail Polish,50,100,50,2,00395,India
949710,2024-01-30,1008,Makeup Remover,80,160,80,2,00395,India
949710,2024-01-30,1007,Eyeshadow,200,400,200,2,00395,India
949710,2024-01-30,1006,Blush,150,300,150,2,00395,India
949710,2024-01-30,1009,Moisturizer,250,500,250,2,00395,India
713869,2024-01-30,1006,Blush,150,300,150,2,00373,India
493331,2024-01-31,1007,Eyeshadow,200,400,200,2,00094,India
524424,2024-01-31,1006,Blush,150,300,150,2,00021,India
524424,2024-01-31,1008,Makeup Remover,80,160,80,2,00021,India
524424,2024-01-31,1002,Mascara,200,400,200,2,00021,India
204363,2024-01-31,1007,Eyeshadow,200,400,200,2,00307,India
204363,2024-01-31,1006,Blush,150,300,150,2,00307,India
204363,2024-01-31,1001,Lipstick,150,300,150,2,00307,India
777611,2024-01-31,1006,Blush,150,300,150,2,00351,India
777611,2024-01-31,1012,Body Lotion,200,400,200,2,00351,India
777611,2024-01-31,1005,Nail Polish,50,100,50,2,00351,India
103390,2024-01-31,1004,Eyeliner,100,200,100,2,00472,India
103390,2024-01-31,1006,Blush,150,300,150,2,00472,India
401261,2024-01-31,1006,Blush,150,300,150,2,00057,India
401261,2024-01-31,1005,Nail Polish,50,100,50,2,00057,India
401261,2024-01-31,1008,Makeup Remover,80,160,80,2,00057,India
573727,2024-01-31,1012,Body Lotion,200,400,200,2,00312,India
573727,2024-01-31,1007,Eyeshadow,200,400,200,2,00312,India
616100,2024-01-31,1007,Eyeshadow,200,400,200,2,00180,India
616100,2024-01-31,1004,Eyeliner,100,200,100,2,00180,India
219333,2024-01-31,1012,Body Lotion,200,400,200,2,00018,India
346888,2024-01-31,1005,Nail Polish,50,100,50,2,00118,India
346888,2024-01-31,1006,Blush,150,300,150,2,00118,India
346888,2024-01-31,1001,Lipstick,150,300,150,2,00118,India
346888,2024-01-31,1003,Foundation,300,600,300,2,00118,India
994395,2024-01-31,1001,Lipstick,150,300,150,2,00086,India
994395,2024-01-31,1002,Mascara,200,400,200,2,00086,India
767279,2024-01-31,1005,Nail Polish,50,100,50,2,00315,India
767279,2024-01-31,1003,Foundation,300,600,300,2,00315,India
512632,2024-01-31,1004,Eyeliner,100,200,100,2,00311,India
512632,2024-01-31,1012,Body Lotion,200,400,200,2,00311,India
493492,2024-01-31,1009,Moisturizer,250,500,250,2,00003,India
493492,2024-01-31,1003,Foundation,300,600,300,2,00003,India
493492,2024-01-31,1006,Blush,150,300,150,2,00003,India
192640,2024-01-31,1009,Moisturizer,250,500,250,2,00277,India
192640,2024-01-31,1006,Blush,150,300,150,2,00277,India
210505,2024-01-31,1001,Lipstick,150,300,150,2,00118,India
316696,2024-01-31,1004,Eyeliner,100,200,100,2,00497,India
316696,2024-01-31,1012,Body Lotion,200,400,200,2,00497,India
316696,2024-01-31,1003,Foundation,300,600,300,2,00497,India
621619,2024-01-31,1004,Eyeliner,100,200,100,2,00453,India
621619,2024-01-31,1006,Blush,150,300,150,2,00453,India
621619,2024-01-31,1012,Body Lotion,200,400,200,2,00453,India
621619,2024-01-31,1001,Lipstick,150,300,150,2,00453,India
160148,2024-01-31,1009,Moisturizer,250,500,250,2,00219,India
160148,2024-01-31,1005,Nail Polish,50,100,50,2,00219,India
932600,2024-01-31,1003,Foundation,300,600,300,2,00157,India
932600,2024-01-31,1006,Blush,150,300,150,2,00157,India
948796,2024-01-31,1012,Body Lotion,200,400,200,2,00446,India
948796,2024-01-31,1007,Eyeshadow,200,400,200,2,00446,India
948796,2024-01-31,1004,Eyeliner,100,200,100,2,00446,India
263307,2024-01-31,1012,Body Lotion,200,400,200,2,00215,India
263307,2024-01-31,1009,Moisturizer,250,500,250,2,00215,India
263307,2024-01-31,1007,Eyeshadow,200,400,200,2,00215,India
343418,2024-01-31,1012,Body Lotion,200,400,200,2,00305,India
343418,2024-01-31,1006,Blush,150,300,150,2,00305,India
343418,2024-01-31,1004,Eyeliner,100,200,100,2,00305,India
343418,2024-01-31,1009,Moisturizer,250,500,250,2,00305,India
254260,2024-01-31,1008,Makeup Remover,80,160,80,2,00079,India
891461,2024-01-31,1004,Eyeliner,100,200,100,2,00358,India
891461,2024-01-31,1005,Nail Polish,50,100,50,2,00358,India
891461,2024-01-31,1012,Body Lotion,200,400,200,2,00358,India
891461,2024-01-31,1009,Moisturizer,250,500,250,2,00358,India
560184,2024-01-31,1008,Makeup Remover,80,160,80,2,00161,India
560184,2024-01-31,1004,Eyeliner,100,200,100,2,00161,India
560184,2024-01-31,1007,Eyeshadow,200,400,200,2,00161,India
560184,2024-01-31,1005,Nail Polish,50,100,50,2,00161,India
228893,2024-01-31,1005,Nail Polish,50,100,50,2,00177,India
228893,2024-01-31,1002,Mascara,200,400,200,2,00177,India
228893,2024-01-31,1004,Eyeliner,100,200,100,2,00177,India
228893,2024-01-31,1008,Makeup Remover,80,160,80,2,00177,India
228893,2024-01-31,1007,Eyeshadow,200,400,200,2,00177,India
737852,2024-01-31,1003,Foundation,300,600,300,2,00385,India
737852,2024-01-31,1006,Blush,150,300,150,2,00385,India
737852,2024-01-31,1005,Nail Polish,50,100,50,2,00385,India
737852,2024-01-31,1009,Moisturizer,250,500,250,2,00385,India
467229,2024-01-31,1005,Nail Polish,50,100,50,2,00410,India
670240,2024-01-31,1004,Eyeliner,100,200,100,2,00219,India
670240,2024-01-31,1008,Makeup Remover,80,160,80,2,00219,India
670240,2024-01-31,1012,Body Lotion,200,400,200,2,00219,India
670240,2024-01-31,1001,Lipstick,150,300,150,2,00219,India
110738,2024-01-31,1005,Nail Polish,50,100,50,2,00362,India
110738,2024-01-31,1002,Mascara,200,400,200,2,00362,India
110738,2024-01-31,1007,Eyeshadow,200,400,200,2,00362,India
654029,2024-01-31,1001,Lipstick,150,300,150,2,00236,India
654029,2024-01-31,1003,Foundation,300,600,300,2,00236,India
654029,2024-01-31,1012,Body Lotion,200,400,200,2,00236,India
654029,2024-01-31,1009,Moisturizer,250,500,250,2,00236,India
245501,2024-01-31,1007,Eyeshadow,200,400,200,2,00288,India
809173,2024-01-31,1006,Blush,150,300,150,2,00442,India
809173,2024-01-31,1004,Eyeliner,100,200,100,2,00442,India
809173,2024-01-31,1002,Mascara,200,400,200,2,00442,India
809173,2024-01-31,1001,Lipstick,150,300,150,2,00442,India
710121,2024-01-31,1007,Eyeshadow,200,400,200,2,00016,India
710121,2024-01-31,1009,Moisturizer,250,500,250,2,00016,India
710121,2024-01-31,1012,Body Lotion,200,400,200,2,00016,India
710121,2024-01-31,1005,Nail Polish,50,100,50,2,00016,India
424524,2024-01-31,1012,Body Lotion,200,400,200,2,00067,India
424524,2024-01-31,1002,Mascara,200,400,200,2,00067,India
424524,2024-01-31,1005,Nail Polish,50,100,50,2,00067,India
424524,2024-01-31,1006,Blush,150,300,150,2,00067,India
650685,2024-01-31,1003,Foundation,300,600,300,2,00004,India
650685,2024-01-31,1005,Nail Polish,50,100,50,2,00004,India
522641,2024-01-31,1008,Makeup Remover,80,160,80,2,00089,India
522641,2024-01-31,1007,Eyeshadow,200,400,200,2,00089,India
492354,2024-02-01,1009,Moisturizer,250,500,250,2,00144,India
463900,2024-02-01,1007,Eyeshadow,200,400,200,1,00091,India
463900,2024-02-01,1008,Makeup Remover,80,160,80,1,00091,India
463900,2024-02-01,1002,Mascara,200,400,200,1,00091,India
463900,2024-02-01,1004,Eyeliner,100,200,100,1,00091,India
463900,2024-02-01,1001,Lipstick,150,300,150,1,00091,India
457684,2024-02-01,1008,Makeup Remover,80,160,80,1,00285,India
457684,2024-02-01,1009,Moisturizer,250,500,250,2,00285,India
457684,2024-02-01,1002,Mascara,200,400,200,1,00285,India
457684,2024-02-01,1006,Blush,150,300,150,1,00285,India
503357,2024-02-01,1008,Makeup Remover,80,160,80,1,00324,India
503357,2024-02-01,1006,Blush,150,300,150,1,00324,India
503357,2024-02-01,1012,Body Lotion,200,400,200,2,00324,India
503357,2024-02-01,1005,Nail Polish,50,100,50,1,00324,India
503357,2024-02-01,1007,Eyeshadow,200,400,200,1,00324,India
324107,2024-02-01,1005,Nail Polish,50,100,50,1,00436,India
876326,2024-02-01,1002,Mascara,200,400,200,1,00426,India
581247,2024-02-01,1001,Lipstick,150,300,150,1,00232,India
315672,2024-02-01,1012,Body Lotion,200,400,200,2,00152,India
315672,2024-02-01,1008,Makeup Remover,80,160,80,1,00152,India
315672,2024-02-01,1003,Foundation,300,600,300,1,00152,India
214792,2024-02-01,1005,Nail Polish,50,100,50,1,00006,India
838347,2024-02-01,1006,Blush,150,300,150,1,00368,India
838347,2024-02-01,1001,Lipstick,150,300,150,1,00368,India
838347,2024-02-01,1004,Eyeliner,100,200,100,1,00368,India
796382,2024-02-01,1006,Blush,150,300,150,1,00273,India
796382,2024-02-01,1001,Lipstick,150,300,150,1,00273,India
796382,2024-02-01,1003,Foundation,300,600,300,1,00273,India
796382,2024-02-01,1002,Mascara,200,400,200,1,00273,India
796382,2024-02-01,1005,Nail Polish,50,100,50,1,00273,India
239621,2024-02-01,1005,Nail Polish,50,100,50,1,00460,India
239621,2024-02-01,1004,Eyeliner,100,200,100,1,00460,India
239621,2024-02-01,1003,Foundation,300,600,300,1,00460,India
239621,2024-02-01,1002,Mascara,200,400,200,1,00460,India
665121,2024-02-01,1004,Eyeliner,100,200,100,1,00371,India
665121,2024-02-01,1009,Moisturizer,250,500,250,2,00371,India
665121,2024-02-01,1001,Lipstick,150,300,150,1,00371,India
665121,2024-02-01,1002,Mascara,200,400,200,1,00371,India
635820,2024-02-01,1009,Moisturizer,250,500,250,2,00145,India
833852,2024-02-01,1009,Moisturizer,250,500,250,2,00044,India
833852,2024-02-01,1001,Lipstick,150,300,150,1,00044,India
833852,2024-02-01,1008,Makeup Remover,80,160,80,1,00044,India
888917,2024-02-01,1003,Foundation,300,600,300,1,00399,India
888917,2024-02-01,1004,Eyeliner,100,200,100,1,00399,India
716396,2024-02-01,1012,Body Lotion,200,400,200,2,00325,India
716396,2024-02-01,1001,Lipstick,150,300,150,1,00325,India
716396,2024-02-01,1004,Eyeliner,100,200,100,1,00325,India
433333,2024-02-01,1001,Lipstick,150,300,150,1,00254,India
433333,2024-02-01,1007,Eyeshadow,200,400,200,1,00254,India
433333,2024-02-01,1008,Makeup Remover,80,160,80,1,00254,India
433333,2024-02-01,1002,Mascara,200,400,200,1,00254,India
889467,2024-02-01,1004,Eyeliner,100,200,100,1,00092,India
889467,2024-02-01,1009,Moisturizer,250,500,250,2,00092,India
889467,2024-02-01,1006,Blush,150,300,150,1,00092,India
889467,2024-02-01,1003,Foundation,300,600,300,1,00092,India
667970,2024-02-01,1006,Blush,150,300,150,1,00183,India
667970,2024-02-01,1002,Mascara,200,400,200,1,00183,India
331937,2024-02-01,1001,Lipstick,150,300,150,1,00090,India
331937,2024-02-01,1003,Foundation,300,600,300,1,00090,India
331937,2024-02-01,1012,Body Lotion,200,400,200,2,00090,India
331937,2024-02-01,1008,Makeup Remover,80,160,80,1,00090,India
743200,2024-02-01,1005,Nail Polish,50,100,50,1,00212,India
728818,2024-02-01,1009,Moisturizer,250,500,250,2,00062,India
728818,2024-02-01,1008,Makeup Remover,80,160,80,1,00062,India
829201,2024-02-01,1008,Makeup Remover,80,160,80,1,00420,India
829201,2024-02-01,1004,Eyeliner,100,200,100,1,00420,India
133462,2024-02-01,1008,Makeup Remover,80,160,80,1,00326,India
133462,2024-02-01,1003,Foundation,300,600,300,1,00326,India
852455,2024-02-01,1008,Makeup Remover,80,160,80,1,00339,India
852455,2024-02-01,1004,Eyeliner,100,200,100,1,00339,India
804196,2024-02-01,1006,Blush,150,300,150,1,00328,India
804196,2024-02-01,1012,Body Lotion,200,400,200,2,00328,India
804196,2024-02-01,1009,Moisturizer,250,500,250,2,00328,India
892202,2024-02-01,1003,Foundation,300,600,300,1,00131,India
892202,2024-02-01,1001,Lipstick,150,300,150,1,00131,India
760055,2024-02-01,1004,Eyeliner,100,200,100,1,00176,India
760055,2024-02-01,1008,Makeup Remover,80,160,80,1,00176,India
470092,2024-02-01,1012,Body Lotion,200,400,200,2,00289,India
472834,2024-02-01,1007,Eyeshadow,200,400,200,1,00368,India
472834,2024-02-01,1003,Foundation,300,600,300,1,00368,India
105218,2024-02-01,1003,Foundation,300,600,300,1,00250,India
105218,2024-02-01,1006,Blush,150,300,150,1,00250,India
245346,2024-02-01,1006,Blush,150,300,150,1,00314,India
210309,2024-02-01,1004,Eyeliner,100,200,100,1,00057,India
210309,2024-02-01,1002,Mascara,200,400,200,1,00057,India
210309,2024-02-01,1005,Nail Polish,50,100,50,1,00057,India
210309,2024-02-01,1006,Blush,150,300,150,1,00057,India
888248,2024-02-01,1008,Makeup Remover,80,160,80,1,00370,India
888248,2024-02-01,1004,Eyeliner,100,200,100,1,00370,India
888248,2024-02-01,1005,Nail Polish,50,100,50,1,00370,India
888248,2024-02-01,1006,Blush,150,300,150,1,00370,India
888248,2024-02-01,1003,Foundation,300,600,300,1,00370,India
616661,2024-02-01,1003,Foundation,300,600,300,1,00161,India
616661,2024-02-01,1006,Blush,150,300,150,1,00161,India
741969,2024-02-01,1007,Eyeshadow,200,400,200,1,00156,India
741969,2024-02-01,1012,Body Lotion,200,400,200,2,00156,India
741969,2024-02-01,1008,Makeup Remover,80,160,80,1,00156,India
612050,2024-02-01,1004,Eyeliner,100,200,100,1,00054,India
612050,2024-02-01,1007,Eyeshadow,200,400,200,1,00054,India
342905,2024-02-01,1008,Makeup Remover,80,160,80,1,00456,India
342905,2024-02-01,1009,Moisturizer,250,500,250,2,00456,India
342905,2024-02-01,1005,Nail Polish,50,100,50,1,00456,India
453010,2024-02-02,1003,Foundation,300,600,300,1,00051,India
453010,2024-02-02,1002,Mascara,200,400,200,1,00051,India
232791,2024-02-02,1009,Moisturizer,250,500,250,2,00099,India
232791,2024-02-02,1003,Foundation,300,600,300,1,00099,India
232791,2024-02-02,1002,Mascara,200,400,200,1,00099,India
643450,2024-02-02,1006,Blush,150,300,150,1,00458,India
643450,2024-02-02,1009,Moisturizer,250,500,250,2,00458,India
643450,2024-02-02,1004,Eyeliner,100,200,100,1,00458,India
496400,2024-02-02,1003,Foundation,300,600,300,1,00353,India
458991,2024-02-02,1006,Blush,150,300,150,1,00176,India
458991,2024-02-02,1009,Moisturizer,250,500,250,2,00176,India
458991,2024-02-02,1002,Mascara,200,400,200,1,00176,India
458991,2024-02-02,1003,Foundation,300,600,300,1,00176,India
458991,2024-02-02,1005,Nail Polish,50,100,50,1,00176,India
182771,2024-02-02,1005,Nail Polish,50,100,50,1,00070,India
182771,2024-02-02,1007,Eyeshadow,200,400,200,1,00070,India
182771,2024-02-02,1002,Mascara,200,400,200,1,00070,India
182616,2024-02-02,1008,Makeup Remover,80,160,80,1,00082,India
960570,2024-02-02,1012,Body Lotion,200,400,200,2,00041,India
960570,2024-02-02,1003,Foundation,300,600,300,1,00041,India
960570,2024-02-02,1006,Blush,150,300,150,1,00041,India
361190,2024-02-02,1007,Eyeshadow,200,400,200,1,00008,India
171101,2024-02-02,1003,Foundation,300,600,300,1,00445,India
171101,2024-02-02,1001,Lipstick,150,300,150,1,00445,India
171101,2024-02-02,1005,Nail Polish,50,100,50,1,00445,India
588629,2024-02-02,1001,Lipstick,150,300,150,1,00341,India
588629,2024-02-02,1003,Foundation,300,600,300,1,00341,India
588629,2024-02-02,1005,Nail Polish,50,100,50,1,00341,India
153947,2024-02-02,1004,Eyeliner,100,200,100,1,00224,India
153947,2024-02-02,1005,Nail Polish,50,100,50,1,00224,India
650285,2024-02-02,1006,Blush,150,300,150,1,00002,India
650285,2024-02-02,1004,Eyeliner,100,200,100,1,00002,India
709949,2024-02-02,1007,Eyeshadow,200,400,200,1,00035,India
709949,2024-02-02,1005,Nail Polish,50,100,50,1,00035,India
709949,2024-02-02,1008,Makeup Remover,80,160,80,1,00035,India
921114,2024-02-02,1001,Lipstick,150,300,150,1,00302,India
921114,2024-02-02,1002,Mascara,200,400,200,1,00302,India
921114,2024-02-02,1003,Foundation,300,600,300,1,00302,India
921114,2024-02-02,1009,Moisturizer,250,500,250,2,00302,India
921114,2024-02-02,1012,Body Lotion,200,400,200,2,00302,India
962810,2024-02-02,1007,Eyeshadow,200,400,200,1,00096,India
962810,2024-02-02,1005,Nail Polish,50,100,50,1,00096,India
962810,2024-02-02,1002,Mascara,200,400,200,1,00096,India
962810,2024-02-02,1003,Foundation,300,600,300,1,00096,India
962810,2024-02-02,1004,Eyeliner,100,200,100,1,00096,India
624230,2024-02-02,1004,Eyeliner,100,200,100,1,00365,India
624230,2024-02-02,1001,Lipstick,150,300,150,1,00365,India
624230,2024-02-02,1006,Blush,150,300,150,1,00365,India
700976,2024-02-02,1005,Nail Polish,50,100,50,1,00039,India
700976,2024-02-02,1002,Mascara,200,400,200,1,00039,India
700976,2024-02-02,1003,Foundation,300,600,300,1,00039,India
856623,2024-02-02,1003,Foundation,300,600,300,1,00479,India
856623,2024-02-02,1009,Moisturizer,250,500,250,2,00479,India
856623,2024-02-02,1008,Makeup Remover,80,160,80,1,00479,India
856623,2024-02-02,1004,Eyeliner,100,200,100,1,00479,India
500692,2024-02-02,1001,Lipstick,150,300,150,1,00260,India
148747,2024-02-02,1003,Foundation,300,600,300,1,00376,India
109142,2024-02-02,1004,Eyeliner,100,200,100,1,00261,India
109142,2024-02-02,1009,Moisturizer,250,500,250,2,00261,India
109142,2024-02-02,1012,Body Lotion,200,400,200,2,00261,India
109142,2024-02-02,1003,Foundation,300,600,300,1,00261,India
302519,2024-02-02,1004,Eyeliner,100,200,100,1,00215,India
268593,2024-02-02,1001,Lipstick,150,300,150,1,00214,India
268593,2024-02-02,1002,Mascara,200,400,200,1,00214,India
274302,2024-02-02,1005,Nail Polish,50,100,50,1,00174,India
274302,2024-02-02,1007,Eyeshadow,200,400,200,1,00174,India
274302,2024-02-02,1008,Makeup Remover,80,160,80,1,00174,India
418919,2024-02-02,1001,Lipstick,150,300,150,1,00079,India
418919,2024-02-02,1012,Body Lotion,200,400,200,2,00079,India
418919,2024-02-02,1007,Eyeshadow,200,400,200,1,00079,India
141133,2024-02-02,1012,Body Lotion,200,400,200,2,00293,India
141133,2024-02-02,1006,Blush,150,300,150,1,00293,India
141133,2024-02-02,1008,Makeup Remover,80,160,80,1,00293,India
809794,2024-02-02,1002,Mascara,200,400,200,1,00090,India
809794,2024-02-02,1007,Eyeshadow,200,400,200,1,00090,India
809794,2024-02-02,1005,Nail Polish,50,100,50,1,00090,India
809794,2024-02-02,1003,Foundation,300,600,300,1,00090,India
948666,2024-02-02,1005,Nail Polish,50,100,50,1,00482,India
948666,2024-02-02,1002,Mascara,200,400,200,1,00482,India
948666,2024-02-02,1004,Eyeliner,100,200,100,1,00482,India
139847,2024-02-02,1004,Eyeliner,100,200,100,1,00180,India
139847,2024-02-02,1007,Eyeshadow,200,400,200,1,00180,India
917266,2024-02-02,1001,Lipstick,150,300,150,1,00079,India
727529,2024-02-02,1005,Nail Polish,50,100,50,1,00150,India
727529,2024-02-02,1004,Eyeliner,100,200,100,1,00150,India
727529,2024-02-02,1002,Mascara,200,400,200,1,00150,India
727529,2024-02-02,1001,Lipstick,150,300,150,1,00150,India
727529,2024-02-02,1003,Foundation,300,600,300,1,00150,India
272536,2024-02-02,1008,Makeup Remover,80,160,80,1,00425,India
272536,2024-02-02,1007,Eyeshadow,200,400,200,1,00425,India
272536,2024-02-02,1006,Blush,150,300,150,1,00425,India
926608,2024-02-02,1003,Foundation,300,600,300,1,00066,India
926608,2024-02-02,1002,Mascara,200,400,200,1,00066,India
502850,2024-02-02,1009,Moisturizer,250,500,250,2,00445,India
502850,2024-02-02,1004,Eyeliner,100,200,100,1,00445,India
502850,2024-02-02,1005,Nail Polish,50,100,50,1,00445,India
910710,2024-02-02,1007,Eyeshadow,200,400,200,1,00112,India
610506,2024-02-02,1005,Nail Polish,50,100,50,1,00272,India
610506,2024-02-02,1003,Foundation,300,600,300,1,00272,India
610506,2024-02-02,1012,Body Lotion,200,400,200,2,00272,India
610506,2024-02-02,1006,Blush,150,300,150,1,00272,India
592487,2024-02-02,1012,Body Lotion,200,400,200,2,00263,India
592487,2024-02-02,1001,Lipstick,150,300,150,1,00263,India
592487,2024-02-02,1009,Moisturizer,250,500,250,2,00263,India
592487,2024-02-02,1006,Blush,150,300,150,1,00263,India
893688,2024-02-02,1007,Eyeshadow,200,400,200,1,00373,India
758498,2024-02-02,1002,Mascara,200,400,200,1,00500,India
758498,2024-02-02,1006,Blush,150,300,150,1,00500,India
758498,2024-02-02,1009,Moisturizer,250,500,250,2,00500,India
772086,2024-02-02,1005,Nail Polish,50,100,50,1,00116,India
772086,2024-02-02,1008,Makeup Remover,80,160,80,1,00116,India
756462,2024-02-02,1008,Makeup Remover,80,160,80,1,00411,India
756462,2024-02-02,1004,Eyeliner,100,200,100,1,00411,India
756462,2024-02-02,1006,Blush,150,300,150,1,00411,India
756462,2024-02-02,1009,Moisturizer,250,500,250,2,00411,India
756462,2024-02-02,1003,Foundation,300,600,300,1,00411,India
303340,2024-02-02,1005,Nail Polish,50,100,50,1,00047,India
294293,2024-02-02,1006,Blush,150,300,150,1,00418,India
294293,2024-02-02,1007,Eyeshadow,200,400,200,1,00418,India
210717,2024-02-02,1012,Body Lotion,200,400,200,2,00097,India
210717,2024-02-02,1004,Eyeliner,100,200,100,1,00097,India
244879,2024-02-02,1005,Nail Polish,50,100,50,1,00024,India
244879,2024-02-02,1007,Eyeshadow,200,400,200,1,00024,India
244879,2024-02-02,1002,Mascara,200,400,200,1,00024,India
428651,2024-02-02,1007,Eyeshadow,200,400,200,1,00298,India
428651,2024-02-02,1003,Foundation,300,600,300,1,00298,India
428651,2024-02-02,1005,Nail Polish,50,100,50,1,00298,India
904848,2024-02-02,1006,Blush,150,300,150,1,00240,India
904848,2024-02-02,1012,Body Lotion,200,400,200,2,00240,India
904848,2024-02-02,1005,Nail Polish,50,100,50,1,00240,India
904848,2024-02-02,1009,Moisturizer,250,500,250,2,00240,India
423324,2024-02-03,1007,Eyeshadow,200,400,200,1,00492,India
423324,2024-02-03,1012,Body Lotion,200,400,200,2,00492,India
423324,2024-02-03,1008,Makeup Remover,80,160,80,1,00492,India
761153,2024-02-03,1005,Nail Polish,50,100,50,1,00326,India
761153,2024-02-03,1004,Eyeliner,100,200,100,1,00326,India
761153,2024-02-03,1001,Lipstick,150,300,150,1,00326,India
761153,2024-02-03,1008,Makeup Remover,80,160,80,1,00326,India
268336,2024-02-03,1012,Body Lotion,200,400,200,2,00464,India
268336,2024-02-03,1004,Eyeliner,100,200,100,1,00464,India
268336,2024-02-03,1003,Foundation,300,600,300,1,00464,India
259137,2024-02-03,1003,Foundation,300,600,300,1,00039,India
259137,2024-02-03,1007,Eyeshadow,200,400,200,1,00039,India
259137,2024-02-03,1008,Makeup Remover,80,160,80,1,00039,India
826125,2024-02-03,1004,Eyeliner,100,200,100,1,00391,India
964989,2024-02-03,1008,Makeup Remover,80,160,80,1,00144,India
922667,2024-02-03,1009,Moisturizer,250,500,250,2,00064,India
922667,2024-02-03,1007,Eyeshadow,200,400,200,1,00064,India
922667,2024-02-03,1003,Foundation,300,600,300,1,00064,India
922667,2024-02-03,1012,Body Lotion,200,400,200,2,00064,India
922667,2024-02-03,1001,Lipstick,150,300,150,1,00064,India
182271,2024-02-03,1003,Foundation,300,600,300,1,00231,India
182271,2024-02-03,1007,Eyeshadow,200,400,200,1,00231,India
182271,2024-02-03,1004,Eyeliner,100,200,100,1,00231,India
182271,2024-02-03,1009,Moisturizer,250,500,250,2,00231,India
365345,2024-02-03,1001,Lipstick,150,300,150,1,00361,India
365345,2024-02-03,1002,Mascara,200,400,200,1,00361,India
365345,2024-02-03,1012,Body Lotion,200,400,200,2,00361,India
365345,2024-02-03,1006,Blush,150,300,150,1,00361,India
293681,2024-02-03,1008,Makeup Remover,80,160,80,1,00070,India
293681,2024-02-03,1002,Mascara,200,400,200,1,00070,India
320982,2024-02-03,1004,Eyeliner,100,200,100,1,00384,India
320982,2024-02-03,1009,Moisturizer,250,500,250,2,00384,India
320982,2024-02-03,1007,Eyeshadow,200,400,200,1,00384,India
320982,2024-02-03,1005,Nail Polish,50,100,50,1,00384,India
854567,2024-02-03,1002,Mascara,200,400,200,1,00387,India
854567,2024-02-03,1006,Blush,150,300,150,1,00387,India
854567,2024-02-03,1008,Makeup Remover,80,160,80,1,00387,India
854567,2024-02-03,1003,Foundation,300,600,300,1,00387,India
854567,2024-02-03,1004,Eyeliner,100,200,100,1,00387,India
792825,2024-02-03,1008,Makeup Remover,80,160,80,1,00001,India
792825,2024-02-03,1004,Eyeliner,100,200,100,1,00001,India
792825,2024-02-03,1006,Blush,150,300,150,1,00001,India
792825,2024-02-03,1005,Nail Polish,50,100,50,1,00001,India
563494,2024-02-03,1012,Body Lotion,200,400,200,2,00390,India
515791,2024-02-03,1012,Body Lotion,200,400,200,2,00256,India
515791,2024-02-03,1008,Makeup Remover,80,160,80,1,00256,India
515791,2024-02-03,1009,Moisturizer,250,500,250,2,00256,India
135974,2024-02-03,1002,Mascara,200,400,200,1,00062,India
135974,2024-02-03,1009,Moisturizer,250,500,250,2,00062,India
882165,2024-02-03,1007,Eyeshadow,200,400,200,1,00077,India
122656,2024-02-03,1012,Body Lotion,200,400,200,2,00245,India
130354,2024-02-03,1005,Nail Polish,50,100,50,1,00230,India
130354,2024-02-03,1003,Foundation,300,600,300,1,00230,India
130354,2024-02-03,1007,Eyeshadow,200,400,200,1,00230,India
130354,2024-02-03,1012,Body Lotion,200,400,200,2,00230,India
825655,2024-02-03,1003,Foundation,300,600,300,1,00337,India
825655,2024-02-03,1007,Eyeshadow,200,400,200,1,00337,India
825655,2024-02-03,1006,Blush,150,300,150,1,00337,India
825655,2024-02-03,1002,Mascara,200,400,200,1,00337,India
825655,2024-02-03,1009,Moisturizer,250,500,250,2,00337,India
225171,2024-02-03,1008,Makeup Remover,80,160,80,1,00491,India
225171,2024-02-03,1001,Lipstick,150,300,150,1,00491,India
225171,2024-02-03,1007,Eyeshadow,200,400,200,1,00491,India
225171,2024-02-03,1005,Nail Polish,50,100,50,1,00491,India
160105,2024-02-03,1006,Blush,150,300,150,1,00315,India
160105,2024-02-03,1002,Mascara,200,400,200,1,00315,India
160105,2024-02-03,1008,Makeup Remover,80,160,80,1,00315,India
160105,2024-02-03,1009,Moisturizer,250,500,250,2,00315,India
160105,2024-02-03,1007,Eyeshadow,200,400,200,1,00315,India
823436,2024-02-03,1004,Eyeliner,100,200,100,1,00400,India
167200,2024-02-03,1001,Lipstick,150,300,150,1,00072,India
734091,2024-02-03,1006,Blush,150,300,150,1,00041,India
185651,2024-02-03,1002,Mascara,200,400,200,1,00215,India
185651,2024-02-03,1007,Eyeshadow,200,400,200,1,00215,India
185651,2024-02-03,1006,Blush,150,300,150,1,00215,India
785943,2024-02-03,1012,Body Lotion,200,400,200,2,00378,India
988715,2024-02-03,1001,Lipstick,150,300,150,1,00314,India
988715,2024-02-03,1002,Mascara,200,400,200,1,00314,India
988715,2024-02-03,1006,Blush,150,300,150,1,00314,India
988715,2024-02-03,1005,Nail Polish,50,100,50,1,00314,India
162076,2024-02-03,1009,Moisturizer,250,500,250,2,00224,India
162076,2024-02-03,1007,Eyeshadow,200,400,200,1,00224,India
162076,2024-02-03,1004,Eyeliner,100,200,100,1,00224,India
520515,2024-02-03,1002,Mascara,200,400,200,1,00028,India
520515,2024-02-03,1008,Makeup Remover,80,160,80,1,00028,India
257179,2024-02-03,1006,Blush,150,300,150,1,00379,India
257179,2024-02-03,1009,Moisturizer,250,500,250,2,00379,India
257179,2024-02-03,1008,Makeup Remover,80,160,80,1,00379,India
631414,2024-02-03,1007,Eyeshadow,200,400,200,1,00490,India
631414,2024-02-03,1009,Moisturizer,250,500,250,2,00490,India
631414,2024-02-03,1006,Blush,150,300,150,1,00490,India
631414,2024-02-03,1003,Foundation,300,600,300,1,00490,India
996608,2024-02-03,1012,Body Lotion,200,400,200,2,00002,India
996608,2024-02-03,1007,Eyeshadow,200,400,200,1,00002,India
996608,2024-02-03,1004,Eyeliner,100,200,100,1,00002,India
889236,2024-02-03,1003,Foundation,300,600,300,1,00307,India
889236,2024-02-03,1007,Eyeshadow,200,400,200,1,00307,India
679350,2024-02-03,1005,Nail Polish,50,100,50,1,00082,India
679350,2024-02-03,1009,Moisturizer,250,500,250,2,00082,India
219587,2024-02-03,1003,Foundation,300,600,300,1,00438,India
219587,2024-02-03,1004,Eyeliner,100,200,100,1,00438,India
219587,2024-02-03,1009,Moisturizer,250,500,250,2,00438,India
219587,2024-02-03,1002,Mascara,200,400,200,1,00438,India
219587,2024-02-03,1005,Nail Polish,50,100,50,1,00438,India
126869,2024-02-03,1009,Moisturizer,250,500,250,2,00256,India
126869,2024-02-03,1003,Foundation,300,600,300,1,00256,India
779521,2024-02-03,1005,Nail Polish,50,100,50,1,00358,India
779521,2024-02-03,1002,Mascara,200,400,200,1,00358,India
779521,2024-02-03,1007,Eyeshadow,200,400,200,1,00358,India
779521,2024-02-03,1006,Blush,150,300,150,1,00358,India
831983,2024-02-03,1001,Lipstick,150,300,150,1,00231,India
831983,2024-02-03,1004,Eyeliner,100,200,100,1,00231,India
831983,2024-02-03,1007,Eyeshadow,200,400,200,1,00231,India
255481,2024-02-03,1009,Moisturizer,250,500,250,2,00442,India
255481,2024-02-03,1005,Nail Polish,50,100,50,1,00442,India
255481,2024-02-03,1008,Makeup Remover,80,160,80,1,00442,India
255481,2024-02-03,1001,Lipstick,150,300,150,1,00442,India
620568,2024-02-03,1005,Nail Polish,50,100,50,1,00234,India
644105,2024-02-03,1001,Lipstick,150,300,150,1,00064,India
644105,2024-02-03,1002,Mascara,200,400,200,1,00064,India
644105,2024-02-03,1003,Foundation,300,600,300,1,00064,India
644105,2024-02-03,1004,Eyeliner,100,200,100,1,00064,India
725021,2024-02-03,1007,Eyeshadow,200,400,200,1,00188,India
725021,2024-02-03,1009,Moisturizer,250,500,250,2,00188,India
439532,2024-02-03,1004,Eyeliner,100,200,100,1,00050,India
439532,2024-02-03,1001,Lipstick,150,300,150,1,00050,India
901394,2024-02-03,1009,Moisturizer,250,500,250,2,00044,India
901394,2024-02-03,1001,Lipstick,150,300,150,1,00044,India
901394,2024-02-03,1007,Eyeshadow,200,400,200,1,00044,India
901394,2024-02-03,1008,Makeup Remover,80,160,80,1,00044,India
901394,2024-02-03,1002,Mascara,200,400,200,1,00044,India
126469,2024-02-03,1004,Eyeliner,100,200,100,1,00401,India
660575,2024-02-03,1004,Eyeliner,100,200,100,1,00121,India
660575,2024-02-03,1007,Eyeshadow,200,400,200,1,00121,India
660575,2024-02-03,1003,Foundation,300,600,300,1,00121,India
912096,2024-02-04,1012,Body Lotion,200,400,200,2,00169,India
912096,2024-02-04,1006,Blush,150,300,150,1,00169,India
912096,2024-02-04,1008,Makeup Remover,80,160,80,1,00169,India
912096,2024-02-04,1003,Foundation,300,600,300,1,00169,India
902716,2024-02-04,1005,Nail Polish,50,100,50,1,00091,India
470753,2024-02-04,1006,Blush,150,300,150,1,00088,India
470753,2024-02-04,1008,Makeup Remover,80,160,80,1,00088,India
470753,2024-02-04,1005,Nail Polish,50,100,50,1,00088,India
208095,2024-02-04,1004,Eyeliner,100,200,100,1,00181,India
208095,2024-02-04,1005,Nail Polish,50,100,50,1,00181,India
208095,2024-02-04,1007,Eyeshadow,200,400,200,1,00181,India
208095,2024-02-04,1002,Mascara,200,400,200,1,00181,India
936656,2024-02-04,1002,Mascara,200,400,200,1,00130,India
936656,2024-02-04,1001,Lipstick,150,300,150,1,00130,India
303216,2024-02-04,1005,Nail Polish,50,100,50,1,00366,India
303216,2024-02-04,1012,Body Lotion,200,400,200,2,00366,India
303216,2024-02-04,1006,Blush,150,300,150,1,00366,India
303216,2024-02-04,1007,Eyeshadow,200,400,200,1,00366,India
303216,2024-02-04,1003,Foundation,300,600,300,1,00366,India
667396,2024-02-04,1006,Blush,150,300,150,1,00327,India
211649,2024-02-04,1006,Blush,150,300,150,1,00115,India
211649,2024-02-04,1005,Nail Polish,50,100,50,1,00115,India
211649,2024-02-04,1001,Lipstick,150,300,150,1,00115,India
211649,2024-02-04,1008,Makeup Remover,80,160,80,1,00115,India
639830,2024-02-04,1002,Mascara,200,400,200,1,00115,India
915993,2024-02-04,1002,Mascara,200,400,200,1,00077,India
915993,2024-02-04,1005,Nail Polish,50,100,50,1,00077,India
915993,2024-02-04,1006,Blush,150,300,150,1,00077,India
446127,2024-02-04,1003,Foundation,300,600,300,1,00255,India
446127,2024-02-04,1009,Moisturizer,250,500,250,2,00255,India
518258,2024-02-04,1003,Foundation,300,600,300,1,00279,India
518258,2024-02-04,1007,Eyeshadow,200,400,200,1,00279,India
518258,2024-02-04,1005,Nail Polish,50,100,50,1,00279,India
161547,2024-02-04,1001,Lipstick,150,300,150,1,00108,India
954195,2024-02-04,1008,Makeup Remover,80,160,80,1,00129,India
954195,2024-02-04,1004,Eyeliner,100,200,100,1,00129,India
954195,2024-02-04,1001,Lipstick,150,300,150,1,00129,India
954195,2024-02-04,1003,Foundation,300,600,300,1,00129,India
689161,2024-02-04,1012,Body Lotion,200,400,200,2,00040,India
689161,2024-02-04,1005,Nail Polish,50,100,50,1,00040,India
689161,2024-02-04,1006,Blush,150,300,150,1,00040,India
689161,2024-02-04,1004,Eyeliner,100,200,100,1,00040,India
634491,2024-02-04,1001,Lipstick,150,300,150,1,00038,India
634491,2024-02-04,1007,Eyeshadow,200,400,200,1,00038,India
797415,2024-02-04,1002,Mascara,200,400,200,1,00440,India
797415,2024-02-04,1012,Body Lotion,200,400,200,2,00440,India
797415,2024-02-04,1004,Eyeliner,100,200,100,1,00440,India
446559,2024-02-04,1012,Body Lotion,200,400,200,2,00349,India
446559,2024-02-04,1005,Nail Polish,50,100,50,1,00349,India
993096,2024-02-04,1002,Mascara,200,400,200,1,00162,India
993096,2024-02-04,1005,Nail Polish,50,100,50,1,00162,India
993096,2024-02-04,1004,Eyeliner,100,200,100,1,00162,India
993096,2024-02-04,1012,Body Lotion,200,400,200,2,00162,India
806772,2024-02-04,1004,Eyeliner,100,200,100,1,00370,India
995554,2024-02-04,1004,Eyeliner,100,200,100,1,00085,India
995554,2024-02-04,1001,Lipstick,150,300,150,1,00085,India
995554,2024-02-04,1005,Nail Polish,50,100,50,1,00085,India
995554,2024-02-04,1002,Mascara,200,400,200,1,00085,India
343827,2024-02-04,1007,Eyeshadow,200,400,200,1,00346,India
343827,2024-02-04,1004,Eyeliner,100,200,100,1,00346,India
343827,2024-02-04,1006,Blush,150,300,150,1,00346,India
343827,2024-02-04,1009,Moisturizer,250,500,250,2,00346,India
721629,2024-02-04,1007,Eyeshadow,200,400,200,1,00099,India
721629,2024-02-04,1009,Moisturizer,250,500,250,2,00099,India
721629,2024-02-04,1004,Eyeliner,100,200,100,1,00099,India
832625,2024-02-04,1006,Blush,150,300,150,1,00254,India
832625,2024-02-04,1008,Makeup Remover,80,160,80,1,00254,India
832625,2024-02-04,1002,Mascara,200,400,200,1,00254,India
348112,2024-02-04,1003,Foundation,300,600,300,1,00496,India
348112,2024-02-04,1012,Body Lotion,200,400,200,2,00496,India
348112,2024-02-04,1007,Eyeshadow,200,400,200,1,00496,India
348112,2024-02-04,1004,Eyeliner,100,200,100,1,00496,India
439173,2024-02-04,1009,Moisturizer,250,500,250,2,00227,India
439173,2024-02-04,1005,Nail Polish,50,100,50,1,00227,India
439173,2024-02-04,1008,Makeup Remover,80,160,80,1,00227,India
439173,2024-02-04,1004,Eyeliner,100,200,100,1,00227,India
533605,2024-02-04,1005,Nail Polish,50,100,50,1,00293,India
920285,2024-02-04,1003,Foundation,300,600,300,1,00307,India
920285,2024-02-04,1005,Nail Polish,50,100,50,1,00307,India
920285,2024-02-04,1006,Blush,150,300,150,1,00307,India
110243,2024-02-04,1004,Eyeliner,100,200,100,1,00191,India
110243,2024-02-04,1006,Blush,150,300,150,1,00191,India
110243,2024-02-04,1008,Makeup Remover,80,160,80,1,00191,India
481455,2024-02-04,1008,Makeup Remover,80,160,80,1,00429,India
481455,2024-02-04,1003,Foundation,300,600,300,1,00429,India
481455,2024-02-04,1002,Mascara,200,400,200,1,00429,India
481455,2024-02-04,1012,Body Lotion,200,400,200,2,00429,India
351848,2024-02-04,1005,Nail Polish,50,100,50,1,00377,India
470291,2024-02-04,1007,Eyeshadow,200,400,200,1,00267,India
651851,2024-02-05,1001,Lipstick,150,300,150,1,00409,India
651851,2024-02-05,1008,Makeup Remover,80,160,80,1,00409,India
651851,2024-02-05,1007,Eyeshadow,200,400,200,1,00409,India
136305,2024-02-05,1002,Mascara,200,400,200,1,00109,India
136305,2024-02-05,1007,Eyeshadow,200,400,200,1,00109,India
136305,2024-02-05,1004,Eyeliner,100,200,100,1,00109,India
136305,2024-02-05,1005,Nail Polish,50,100,50,1,00109,India
765287,2024-02-05,1002,Mascara,200,400,200,1,00036,India
765287,2024-02-05,1003,Foundation,300,600,300,1,00036,India
280181,2024-02-05,1007,Eyeshadow,200,400,200,1,00184,India
973506,2024-02-05,1003,Foundation,300,600,300,1,00041,India
973506,2024-02-05,1012,Body Lotion,200,400,200,2,00041,India
688689,2024-02-05,1009,Moisturizer,250,500,250,2,00331,India
221397,2024-02-05,1006,Blush,150,300,150,1,00469,India
221397,2024-02-05,1012,Body Lotion,200,400,200,2,00469,India
221397,2024-02-05,1008,Makeup Remover,80,160,80,1,00469,India
114562,2024-02-05,1009,Moisturizer,250,500,250,2,00362,India
114562,2024-02-05,1003,Foundation,300,600,300,1,00362,India
114562,2024-02-05,1008,Makeup Remover,80,160,80,1,00362,India
902765,2024-02-05,1008,Makeup Remover,80,160,80,1,00187,India
902765,2024-02-05,1002,Mascara,200,400,200,1,00187,India
902765,2024-02-05,1004,Eyeliner,100,200,100,1,00187,India
902765,2024-02-05,1009,Moisturizer,250,500,250,2,00187,India
177733,2024-02-05,1004,Eyeliner,100,200,100,1,00209,India
177733,2024-02-05,1001,Lipstick,150,300,150,1,00209,India
177733,2024-02-05,1002,Mascara,200,400,200,1,00209,India
177733,2024-02-05,1012,Body Lotion,200,400,200,2,00209,India
711054,2024-02-05,1001,Lipstick,150,300,150,1,00295,India
711054,2024-02-05,1007,Eyeshadow,200,400,200,1,00295,India
711054,2024-02-05,1009,Moisturizer,250,500,250,2,00295,India
711054,2024-02-05,1002,Mascara,200,400,200,1,00295,India
956728,2024-02-05,1012,Body Lotion,200,400,200,2,00293,India
956728,2024-02-05,1005,Nail Polish,50,100,50,1,00293,India
261179,2024-02-05,1012,Body Lotion,200,400,200,2,00229,India
261179,2024-02-05,1004,Eyeliner,100,200,100,1,00229,India
225137,2024-02-05,1002,Mascara,200,400,200,1,00441,India
604080,2024-02-05,1003,Foundation,300,600,300,1,00446,India
604080,2024-02-05,1005,Nail Polish,50,100,50,1,00446,India
604080,2024-02-05,1007,Eyeshadow,200,400,200,1,00446,India
604080,2024-02-05,1002,Mascara,200,400,200,1,00446,India
469720,2024-02-05,1008,Makeup Remover,80,160,80,1,00183,India
448520,2024-02-05,1012,Body Lotion,200,400,200,2,00017,India
289472,2024-02-05,1005,Nail Polish,50,100,50,1,00285,India
289472,2024-02-05,1009,Moisturizer,250,500,250,2,00285,India
961073,2024-02-05,1006,Blush,150,300,150,1,00009,India
961073,2024-02-05,1001,Lipstick,150,300,150,1,00009,India
684451,2024-02-05,1009,Moisturizer,250,500,250,2,00456,India
684451,2024-02-05,1005,Nail Polish,50,100,50,1,00456,India
684451,2024-02-05,1003,Foundation,300,600,300,1,00456,India
684451,2024-02-05,1001,Lipstick,150,300,150,1,00456,India
365547,2024-02-05,1001,Lipstick,150,300,150,1,00023,India
365547,2024-02-05,1007,Eyeshadow,200,400,200,1,00023,India
365547,2024-02-05,1003,Foundation,300,600,300,1,00023,India
369790,2024-02-05,1003,Foundation,300,600,300,1,00006,India
369790,2024-02-05,1004,Eyeliner,100,200,100,1,00006,India
267969,2024-02-05,1008,Makeup Remover,80,160,80,1,00035,India
267969,2024-02-05,1005,Nail Polish,50,100,50,1,00035,India
267969,2024-02-05,1004,Eyeliner,100,200,100,1,00035,India
994109,2024-02-05,1002,Mascara,200,400,200,1,00186,India
586303,2024-02-05,1002,Mascara,200,400,200,1,00253,India
260360,2024-02-05,1003,Foundation,300,600,300,1,00236,India
260360,2024-02-05,1012,Body Lotion,200,400,200,2,00236,India
260360,2024-02-05,1007,Eyeshadow,200,400,200,1,00236,India
410564,2024-02-05,1005,Nail Polish,50,100,50,1,00338,India
410564,2024-02-05,1009,Moisturizer,250,500,250,2,00338,India
410564,2024-02-05,1001,Lipstick,150,300,150,1,00338,India
492604,2024-02-05,1009,Moisturizer,250,500,250,2,00386,India
492604,2024-02-05,1003,Foundation,300,600,300,1,00386,India
492604,2024-02-05,1002,Mascara,200,400,200,1,00386,India
492604,2024-02-05,1012,Body Lotion,200,400,200,2,00386,India
857008,2024-02-05,1002,Mascara,200,400,200,1,00275,India
857008,2024-02-05,1012,Body Lotion,200,400,200,2,00275,India
348369,2024-02-05,1009,Moisturizer,250,500,250,2,00186,India
602400,2024-02-05,1003,Foundation,300,600,300,1,00498,India
602400,2024-02-05,1007,Eyeshadow,200,400,200,1,00498,India
602400,2024-02-05,1005,Nail Polish,50,100,50,1,00498,India
776495,2024-02-05,1003,Foundation,300,600,300,1,00392,India
776495,2024-02-05,1006,Blush,150,300,150,1,00392,India
228858,2024-02-05,1012,Body Lotion,200,400,200,2,00477,India
316168,2024-02-05,1009,Moisturizer,250,500,250,2,00380,India
316168,2024-02-05,1006,Blush,150,300,150,1,00380,India
316168,2024-02-05,1001,Lipstick,150,300,150,1,00380,India
943054,2024-02-05,1003,Foundation,300,600,300,1,00406,India
377127,2024-02-05,1008,Makeup Remover,80,160,80,1,00143,India
790862,2024-02-05,1009,Moisturizer,250,500,250,2,00457,India
790862,2024-02-05,1001,Lipstick,150,300,150,1,00457,India
256075,2024-02-05,1001,Lipstick,150,300,150,1,00331,India
832061,2024-02-05,1002,Mascara,200,400,200,1,00111,India
832061,2024-02-05,1004,Eyeliner,100,200,100,1,00111,India
343413,2024-02-05,1003,Foundation,300,600,300,1,00492,India
343413,2024-02-05,1007,Eyeshadow,200,400,200,1,00492,India
602261,2024-02-05,1004,Eyeliner,100,200,100,1,00126,India
602261,2024-02-05,1012,Body Lotion,200,400,200,2,00126,India
656644,2024-02-05,1007,Eyeshadow,200,400,200,1,00458,India
194585,2024-02-05,1003,Foundation,300,600,300,1,00327,India
944880,2024-02-05,1008,Makeup Remover,80,160,80,1,00088,India
944880,2024-02-05,1009,Moisturizer,250,500,250,2,00088,India
944880,2024-02-05,1012,Body Lotion,200,400,200,2,00088,India
944880,2024-02-05,1005,Nail Polish,50,100,50,1,00088,India
600405,2024-02-05,1002,Mascara,200,400,200,1,00147,India
600405,2024-02-05,1007,Eyeshadow,200,400,200,1,00147,India
754801,2024-02-05,1003,Foundation,300,600,300,1,00413,India
754801,2024-02-05,1009,Moisturizer,250,500,250,2,00413,India
754801,2024-02-05,1002,Mascara,200,400,200,1,00413,India
754801,2024-02-05,1012,Body Lotion,200,400,200,2,00413,India
642154,2024-02-05,1007,Eyeshadow,200,400,200,1,00173,India
642154,2024-02-05,1008,Makeup Remover,80,160,80,1,00173,India
642154,2024-02-05,1002,Mascara,200,400,200,1,00173,India
642154,2024-02-05,1009,Moisturizer,250,500,250,2,00173,India
642154,2024-02-05,1001,Lipstick,150,300,150,1,00173,India
839818,2024-02-05,1003,Foundation,300,600,300,1,00327,India
839818,2024-02-05,1008,Makeup Remover,80,160,80,1,00327,India
839818,2024-02-05,1002,Mascara,200,400,200,1,00327,India
839818,2024-02-05,1012,Body Lotion,200,400,200,2,00327,India
142094,2024-02-06,1003,Foundation,300,600,300,1,00119,India
142094,2024-02-06,1007,Eyeshadow,200,400,200,1,00119,India
156207,2024-02-06,1006,Blush,150,300,150,1,00251,India
156207,2024-02-06,1004,Eyeliner,100,200,100,1,00251,India
676332,2024-02-06,1012,Body Lotion,200,400,200,2,00314,India
688393,2024-02-06,1012,Body Lotion,200,400,200,2,00315,India
688393,2024-02-06,1009,Moisturizer,250,500,250,2,00315,India
688393,2024-02-06,1002,Mascara,200,400,200,1,00315,India
802281,2024-02-06,1003,Foundation,300,600,300,1,00335,India
802281,2024-02-06,1009,Moisturizer,250,500,250,2,00335,India
802281,2024-02-06,1012,Body Lotion,200,400,200,2,00335,India
781963,2024-02-06,1003,Foundation,300,600,300,1,00246,India
170567,2024-02-06,1004,Eyeliner,100,200,100,1,00055,India
170567,2024-02-06,1008,Makeup Remover,80,160,80,1,00055,India
502107,2024-02-06,1008,Makeup Remover,80,160,80,1,00011,India
286774,2024-02-06,1012,Body Lotion,200,400,200,2,00277,India
286774,2024-02-06,1009,Moisturizer,250,500,250,2,00277,India
286774,2024-02-06,1005,Nail Polish,50,100,50,1,00277,India
883615,2024-02-06,1002,Mascara,200,400,200,1,00413,India
883615,2024-02-06,1003,Foundation,300,600,300,1,00413,India
883615,2024-02-06,1006,Blush,150,300,150,1,00413,India
704516,2024-02-06,1002,Mascara,200,400,200,1,00299,India
704516,2024-02-06,1001,Lipstick,150,300,150,1,00299,India
238280,2024-02-06,1005,Nail Polish,50,100,50,1,00172,India
238280,2024-02-06,1001,Lipstick,150,300,150,1,00172,India
238280,2024-02-06,1004,Eyeliner,100,200,100,1,00172,India
763026,2024-02-06,1003,Foundation,300,600,300,1,00243,India
763026,2024-02-06,1012,Body Lotion,200,400,200,2,00243,India
586299,2024-02-06,1004,Eyeliner,100,200,100,1,00018,India
586299,2024-02-06,1002,Mascara,200,400,200,1,00018,India
531448,2024-02-06,1006,Blush,150,300,150,1,00398,India
179806,2024-02-06,1001,Lipstick,150,300,150,1,00179,India
179806,2024-02-06,1003,Foundation,300,600,300,1,00179,India
179806,2024-02-06,1004,Eyeliner,100,200,100,1,00179,India
179806,2024-02-06,1006,Blush,150,300,150,1,00179,India
490727,2024-02-06,1003,Foundation,300,600,300,1,00181,India
385026,2024-02-06,1009,Moisturizer,250,500,250,2,00137,India
385026,2024-02-06,1007,Eyeshadow,200,400,200,1,00137,India
505999,2024-02-06,1001,Lipstick,150,300,150,1,00136,India
505999,2024-02-06,1007,Eyeshadow,200,400,200,1,00136,India
168578,2024-02-06,1012,Body Lotion,200,400,200,2,00064,India
168578,2024-02-06,1004,Eyeliner,100,200,100,1,00064,India
168578,2024-02-06,1007,Eyeshadow,200,400,200,1,00064,India
168578,2024-02-06,1001,Lipstick,150,300,150,1,00064,India
121033,2024-02-06,1003,Foundation,300,600,300,1,00046,India
120302,2024-02-06,1007,Eyeshadow,200,400,200,1,00304,India
514949,2024-02-06,1003,Foundation,300,600,300,1,00469,India
514949,2024-02-06,1012,Body Lotion,200,400,200,2,00469,India
514949,2024-02-06,1005,Nail Polish,50,100,50,1,00469,India
216085,2024-02-06,1009,Moisturizer,250,500,250,2,00066,India
216085,2024-02-06,1006,Blush,150,300,150,1,00066,India
216085,2024-02-06,1012,Body Lotion,200,400,200,2,00066,India
216085,2024-02-06,1004,Eyeliner,100,200,100,1,00066,India
429541,2024-02-06,1008,Makeup Remover,80,160,80,1,00184,India
429541,2024-02-06,1005,Nail Polish,50,100,50,1,00184,India
429541,2024-02-06,1012,Body Lotion,200,400,200,2,00184,India
418940,2024-02-06,1008,Makeup Remover,80,160,80,1,00113,India
418940,2024-02-06,1009,Moisturizer,250,500,250,2,00113,India
855347,2024-02-06,1005,Nail Polish,50,100,50,1,00467,India
855347,2024-02-06,1001,Lipstick,150,300,150,1,00467,India
855347,2024-02-06,1002,Mascara,200,400,200,1,00467,India
855347,2024-02-06,1009,Moisturizer,250,500,250,2,00467,India
817242,2024-02-06,1007,Eyeshadow,200,400,200,1,00338,India
817242,2024-02-06,1002,Mascara,200,400,200,1,00338,India
817242,2024-02-06,1006,Blush,150,300,150,1,00338,India
152940,2024-02-06,1004,Eyeliner,100,200,100,1,00343,India
152940,2024-02-06,1007,Eyeshadow,200,400,200,1,00343,India
912413,2024-02-06,1003,Foundation,300,600,300,1,00440,India
912413,2024-02-06,1005,Nail Polish,50,100,50,1,00440,India
382976,2024-02-06,1002,Mascara,200,400,200,1,00037,India
382976,2024-02-06,1004,Eyeliner,100,200,100,1,00037,India
382976,2024-02-06,1009,Moisturizer,250,500,250,2,00037,India
749276,2024-02-06,1002,Mascara,200,400,200,1,00128,India
749276,2024-02-06,1008,Makeup Remover,80,160,80,1,00128,India
390553,2024-02-06,1002,Mascara,200,400,200,1,00019,India
390553,2024-02-06,1009,Moisturizer,250,500,250,2,00019,India
390553,2024-02-06,1004,Eyeliner,100,200,100,1,00019,India
390553,2024-02-06,1006,Blush,150,300,150,1,00019,India
805521,2024-02-06,1003,Foundation,300,600,300,1,00054,India
805521,2024-02-06,1012,Body Lotion,200,400,200,2,00054,India
805521,2024-02-06,1005,Nail Polish,50,100,50,1,00054,India
953327,2024-02-06,1007,Eyeshadow,200,400,200,1,00350,India
483787,2024-02-06,1009,Moisturizer,250,500,250,2,00212,India
483787,2024-02-06,1005,Nail Polish,50,100,50,1,00212,India
483787,2024-02-06,1012,Body Lotion,200,400,200,2,00212,India
483787,2024-02-06,1001,Lipstick,150,300,150,1,00212,India
945579,2024-02-06,1009,Moisturizer,250,500,250,2,00144,India
945579,2024-02-06,1004,Eyeliner,100,200,100,1,00144,India
945579,2024-02-06,1001,Lipstick,150,300,150,1,00144,India
406638,2024-02-06,1001,Lipstick,150,300,150,1,00427,India
406638,2024-02-06,1003,Foundation,300,600,300,1,00427,India
406638,2024-02-06,1007,Eyeshadow,200,400,200,1,00427,India
378287,2024-02-06,1002,Mascara,200,400,200,1,00437,India
378287,2024-02-06,1004,Eyeliner,100,200,100,1,00437,India
587732,2024-02-06,1003,Foundation,300,600,300,1,00250,India
587732,2024-02-06,1004,Eyeliner,100,200,100,1,00250,India
587732,2024-02-06,1008,Makeup Remover,80,160,80,1,00250,India
587732,2024-02-06,1012,Body Lotion,200,400,200,2,00250,India
133413,2024-02-06,1007,Eyeshadow,200,400,200,1,00366,India
133413,2024-02-06,1009,Moisturizer,250,500,250,2,00366,India
327657,2024-02-06,1005,Nail Polish,50,100,50,1,00461,India
327657,2024-02-06,1007,Eyeshadow,200,400,200,1,00461,India
327657,2024-02-06,1003,Foundation,300,600,300,1,00461,India
350117,2024-02-06,1002,Mascara,200,400,200,1,00323,India
350117,2024-02-06,1004,Eyeliner,100,200,100,1,00323,India
685371,2024-02-06,1005,Nail Polish,50,100,50,1,00225,India
258850,2024-02-06,1007,Eyeshadow,200,400,200,1,00282,India
258850,2024-02-06,1002,Mascara,200,400,200,1,00282,India
258850,2024-02-06,1012,Body Lotion,200,400,200,2,00282,India
106546,2024-02-06,1007,Eyeshadow,200,400,200,1,00371,India
106546,2024-02-06,1004,Eyeliner,100,200,100,1,00371,India
469993,2024-02-06,1007,Eyeshadow,200,400,200,1,00253,India
469993,2024-02-06,1001,Lipstick,150,300,150,1,00253,India
469993,2024-02-06,1008,Makeup Remover,80,160,80,1,00253,India
469993,2024-02-06,1005,Nail Polish,50,100,50,1,00253,India
110531,2024-02-06,1004,Eyeliner,100,200,100,1,00463,India
110531,2024-02-06,1008,Makeup Remover,80,160,80,1,00463,India
110531,2024-02-06,1009,Moisturizer,250,500,250,2,00463,India
110531,2024-02-06,1012,Body Lotion,200,400,200,2,00463,India
833455,2024-02-07,1006,Blush,150,300,150,1,00461,India
446810,2024-02-07,1006,Blush,150,300,150,1,00116,India
446810,2024-02-07,1007,Eyeshadow,200,400,200,1,00116,India
994546,2024-02-07,1012,Body Lotion,200,400,200,2,00359,India
994546,2024-02-07,1008,Makeup Remover,80,160,80,1,00359,India
994546,2024-02-07,1004,Eyeliner,100,200,100,1,00359,India
762981,2024-02-07,1007,Eyeshadow,200,400,200,1,00354,India
762981,2024-02-07,1001,Lipstick,150,300,150,1,00354,India
762981,2024-02-07,1004,Eyeliner,100,200,100,1,00354,India
494455,2024-02-07,1008,Makeup Remover,80,160,80,1,00267,India
494455,2024-02-07,1006,Blush,150,300,150,1,00267,India
522228,2024-02-07,1004,Eyeliner,100,200,100,1,00264,India
522228,2024-02-07,1008,Makeup Remover,80,160,80,1,00264,India
522228,2024-02-07,1002,Mascara,200,400,200,1,00264,India
522228,2024-02-07,1009,Moisturizer,250,500,250,2,00264,India
512236,2024-02-07,1004,Eyeliner,100,200,100,1,00069,India
512236,2024-02-07,1012,Body Lotion,200,400,200,2,00069,India
512236,2024-02-07,1006,Blush,150,300,150,1,00069,India
264650,2024-02-07,1005,Nail Polish,50,100,50,1,00372,India
816623,2024-02-07,1003,Foundation,300,600,300,1,00271,India
903159,2024-02-07,1002,Mascara,200,400,200,1,00413,India
903159,2024-02-07,1012,Body Lotion,200,400,200,2,00413,India
903159,2024-02-07,1003,Foundation,300,600,300,1,00413,India
903159,2024-02-07,1004,Eyeliner,100,200,100,1,00413,India
709734,2024-02-07,1001,Lipstick,150,300,150,1,00060,India
256727,2024-02-07,1006,Blush,150,300,150,1,00081,India
256727,2024-02-07,1003,Foundation,300,600,300,1,00081,India
256727,2024-02-07,1004,Eyeliner,100,200,100,1,00081,India
256727,2024-02-07,1002,Mascara,200,400,200,1,00081,India
946158,2024-02-07,1012,Body Lotion,200,400,200,2,00412,India
946158,2024-02-07,1009,Moisturizer,250,500,250,2,00412,India
946158,2024-02-07,1001,Lipstick,150,300,150,1,00412,India
984430,2024-02-07,1012,Body Lotion,200,400,200,2,00313,India
984430,2024-02-07,1006,Blush,150,300,150,1,00313,India
984430,2024-02-07,1002,Mascara,200,400,200,1,00313,India
984430,2024-02-07,1004,Eyeliner,100,200,100,1,00313,India
202689,2024-02-07,1005,Nail Polish,50,100,50,1,00234,India
769041,2024-02-07,1007,Eyeshadow,200,400,200,1,00010,India
472830,2024-02-07,1004,Eyeliner,100,200,100,1,00199,India
472830,2024-02-07,1009,Moisturizer,250,500,250,2,00199,India
472830,2024-02-07,1005,Nail Polish,50,100,50,1,00199,India
472830,2024-02-07,1006,Blush,150,300,150,1,00199,India
341651,2024-02-07,1001,Lipstick,150,300,150,1,00320,India
341651,2024-02-07,1006,Blush,150,300,150,1,00320,India
341651,2024-02-07,1012,Body Lotion,200,400,200,2,00320,India
879855,2024-02-07,1008,Makeup Remover,80,160,80,1,00325,India
879855,2024-02-07,1001,Lipstick,150,300,150,1,00325,India
879855,2024-02-07,1006,Blush,150,300,150,1,00325,India
282017,2024-02-07,1008,Makeup Remover,80,160,80,1,00310,India
929071,2024-02-07,1003,Foundation,300,600,300,1,00335,India
929071,2024-02-07,1006,Blush,150,300,150,1,00335,India
929071,2024-02-07,1007,Eyeshadow,200,400,200,1,00335,India
929071,2024-02-07,1009,Moisturizer,250,500,250,2,00335,India
709892,2024-02-07,1006,Blush,150,300,150,1,00031,India
709892,2024-02-07,1009,Moisturizer,250,500,250,2,00031,India
490876,2024-02-07,1012,Body Lotion,200,400,200,2,00208,India
490876,2024-02-07,1008,Makeup Remover,80,160,80,1,00208,India
490876,2024-02-07,1004,Eyeliner,100,200,100,1,00208,India
149254,2024-02-07,1006,Blush,150,300,150,1,00206,India
149254,2024-02-07,1009,Moisturizer,250,500,250,2,00206,India
149254,2024-02-07,1012,Body Lotion,200,400,200,2,00206,India
149254,2024-02-07,1003,Foundation,300,600,300,1,00206,India
460342,2024-02-07,1007,Eyeshadow,200,400,200,1,00058,India
460342,2024-02-07,1003,Foundation,300,600,300,1,00058,India
216087,2024-02-07,1006,Blush,150,300,150,1,00148,India
216087,2024-02-07,1008,Makeup Remover,80,160,80,1,00148,India
266456,2024-02-07,1006,Blush,150,300,150,1,00491,India
266456,2024-02-07,1007,Eyeshadow,200,400,200,1,00491,India
266456,2024-02-07,1003,Foundation,300,600,300,1,00491,India
344601,2024-02-07,1009,Moisturizer,250,500,250,2,00283,India
377177,2024-02-07,1005,Nail Polish,50,100,50,1,00497,India
377177,2024-02-07,1008,Makeup Remover,80,160,80,1,00497,India
377177,2024-02-07,1003,Foundation,300,600,300,1,00497,India
377177,2024-02-07,1002,Mascara,200,400,200,1,00497,India
693393,2024-02-07,1009,Moisturizer,250,500,250,2,00396,India
693393,2024-02-07,1001,Lipstick,150,300,150,1,00396,India
157479,2024-02-07,1003,Foundation,300,600,300,1,00278,India
157479,2024-02-07,1009,Moisturizer,250,500,250,2,00278,India
157479,2024-02-07,1007,Eyeshadow,200,400,200,1,00278,India
157479,2024-02-07,1001,Lipstick,150,300,150,1,00278,India
157479,2024-02-07,1004,Eyeliner,100,200,100,1,00278,India
354321,2024-02-07,1012,Body Lotion,200,400,200,2,00145,India
354321,2024-02-07,1007,Eyeshadow,200,400,200,1,00145,India
133343,2024-02-07,1008,Makeup Remover,80,160,80,1,00428,India
133343,2024-02-07,1003,Foundation,300,600,300,1,00428,India
585987,2024-02-07,1003,Foundation,300,600,300,1,00027,India
682208,2024-02-07,1002,Mascara,200,400,200,1,00010,India
682208,2024-02-07,1001,Lipstick,150,300,150,1,00010,India
682208,2024-02-07,1012,Body Lotion,200,400,200,2,00010,India
682208,2024-02-07,1008,Makeup Remover,80,160,80,1,00010,India
682208,2024-02-07,1004,Eyeliner,100,200,100,1,00010,India
652026,2024-02-07,1007,Eyeshadow,200,400,200,1,00119,India
652026,2024-02-07,1006,Blush,150,300,150,1,00119,India
987978,2024-02-07,1008,Makeup Remover,80,160,80,1,00018,India
987978,2024-02-07,1009,Moisturizer,250,500,250,2,00018,India
987978,2024-02-07,1001,Lipstick,150,300,150,1,00018,India
987978,2024-02-07,1007,Eyeshadow,200,400,200,1,00018,India
987978,2024-02-07,1003,Foundation,300,600,300,1,00018,India
166183,2024-02-07,1004,Eyeliner,100,200,100,1,00186,India
691241,2024-02-07,1008,Makeup Remover,80,160,80,1,00343,India
454040,2024-02-07,1002,Mascara,200,400,200,1,00349,India
964755,2024-02-07,1002,Mascara,200,400,200,1,00126,India
964755,2024-02-07,1007,Eyeshadow,200,400,200,1,00126,India
847034,2024-02-07,1008,Makeup Remover,80,160,80,1,00395,India
847034,2024-02-07,1007,Eyeshadow,200,400,200,1,00395,India
847034,2024-02-07,1003,Foundation,300,600,300,1,00395,India
332787,2024-02-07,1009,Moisturizer,250,500,250,2,00017,India
332787,2024-02-07,1002,Mascara,200,400,200,1,00017,India
332787,2024-02-07,1006,Blush,150,300,150,1,00017,India
579021,2024-02-07,1005,Nail Polish,50,100,50,1,00468,India
579021,2024-02-07,1008,Makeup Remover,80,160,80,1,00468,India
108917,2024-02-07,1012,Body Lotion,200,400,200,2,00272,India
108917,2024-02-07,1007,Eyeshadow,200,400,200,1,00272,India
108917,2024-02-07,1002,Mascara,200,400,200,1,00272,India
526080,2024-02-07,1003,Foundation,300,600,300,1,00393,India
526080,2024-02-07,1008,Makeup Remover,80,160,80,1,00393,India
526080,2024-02-07,1006,Blush,150,300,150,1,00393,India
526080,2024-02-07,1005,Nail Polish,50,100,50,1,00393,India
303043,2024-02-07,1004,Eyeliner,100,200,100,1,00478,India
759183,2024-02-07,1004,Eyeliner,100,200,100,1,00187,India
533007,2024-02-07,1005,Nail Polish,50,100,50,1,00115,India
533007,2024-02-07,1006,Blush,150,300,150,1,00115,India
533007,2024-02-07,1007,Eyeshadow,200,400,200,1,00115,India
533007,2024-02-07,1001,Lipstick,150,300,150,1,00115,India
432600,2024-02-07,1008,Makeup Remover,80,160,80,1,00299,India
432600,2024-02-07,1002,Mascara,200,400,200,1,00299,India
432600,2024-02-07,1001,Lipstick,150,300,150,1,00299,India
432600,2024-02-07,1003,Foundation,300,600,300,1,00299,India
432600,2024-02-07,1007,Eyeshadow,200,400,200,1,00299,India
861032,2024-02-08,1009,Moisturizer,250,500,250,2,00256,India
357291,2024-02-08,1007,Eyeshadow,200,400,200,1,00126,India
357291,2024-02-08,1008,Makeup Remover,80,160,80,1,00126,India
496291,2024-02-08,1009,Moisturizer,250,500,250,2,00262,India
716640,2024-02-08,1003,Foundation,300,600,300,1,00227,India
716640,2024-02-08,1012,Body Lotion,200,400,200,2,00227,India
716640,2024-02-08,1009,Moisturizer,250,500,250,2,00227,India
716640,2024-02-08,1001,Lipstick,150,300,150,1,00227,India
712531,2024-02-08,1006,Blush,150,300,150,1,00389,India
947348,2024-02-08,1001,Lipstick,150,300,150,1,00278,India
947348,2024-02-08,1008,Makeup Remover,80,160,80,1,00278,India
947348,2024-02-08,1012,Body Lotion,200,400,200,2,00278,India
947348,2024-02-08,1009,Moisturizer,250,500,250,2,00278,India
362636,2024-02-08,1003,Foundation,300,600,300,1,00334,India
989605,2024-02-08,1012,Body Lotion,200,400,200,2,00254,India
351787,2024-02-08,1004,Eyeliner,100,200,100,1,00463,India
766470,2024-02-08,1005,Nail Polish,50,100,50,1,00258,India
766470,2024-02-08,1003,Foundation,300,600,300,1,00258,India
705579,2024-02-08,1004,Eyeliner,100,200,100,1,00138,India
705579,2024-02-08,1012,Body Lotion,200,400,200,2,00138,India
705579,2024-02-08,1005,Nail Polish,50,100,50,1,00138,India
156680,2024-02-08,1009,Moisturizer,250,500,250,2,00432,India
793357,2024-02-08,1003,Foundation,300,600,300,1,00029,India
793357,2024-02-08,1004,Eyeliner,100,200,100,1,00029,India
809967,2024-02-08,1009,Moisturizer,250,500,250,2,00043,India
809967,2024-02-08,1007,Eyeshadow,200,400,200,1,00043,India
809967,2024-02-08,1005,Nail Polish,50,100,50,1,00043,India
350039,2024-02-08,1005,Nail Polish,50,100,50,1,00124,India
350039,2024-02-08,1007,Eyeshadow,200,400,200,1,00124,India
350039,2024-02-08,1009,Moisturizer,250,500,250,2,00124,India
370930,2024-02-08,1006,Blush,150,300,150,1,00477,India
370930,2024-02-08,1005,Nail Polish,50,100,50,1,00477,India
370930,2024-02-08,1007,Eyeshadow,200,400,200,1,00477,India
804380,2024-02-08,1012,Body Lotion,200,400,200,2,00083,India
804380,2024-02-08,1004,Eyeliner,100,200,100,1,00083,India
804380,2024-02-08,1005,Nail Polish,50,100,50,1,00083,India
233772,2024-02-08,1004,Eyeliner,100,200,100,1,00051,India
233772,2024-02-08,1001,Lipstick,150,300,150,1,00051,India
336007,2024-02-08,1004,Eyeliner,100,200,100,1,00354,India
336007,2024-02-08,1008,Makeup Remover,80,160,80,1,00354,India
777843,2024-02-08,1001,Lipstick,150,300,150,1,00255,India
777843,2024-02-08,1006,Blush,150,300,150,1,00255,India
777843,2024-02-08,1003,Foundation,300,600,300,1,00255,India
777843,2024-02-08,1012,Body Lotion,200,400,200,2,00255,India
852682,2024-02-08,1012,Body Lotion,200,400,200,2,00058,India
852682,2024-02-08,1009,Moisturizer,250,500,250,2,00058,India
852682,2024-02-08,1001,Lipstick,150,300,150,1,00058,India
499161,2024-02-08,1003,Foundation,300,600,300,1,00147,India
303372,2024-02-08,1002,Mascara,200,400,200,1,00279,India
882575,2024-02-08,1009,Moisturizer,250,500,250,2,00235,India
882575,2024-02-08,1003,Foundation,300,600,300,1,00235,India
882575,2024-02-08,1012,Body Lotion,200,400,200,2,00235,India
882575,2024-02-08,1006,Blush,150,300,150,1,00235,India
464310,2024-02-08,1001,Lipstick,150,300,150,1,00151,India
295727,2024-02-08,1007,Eyeshadow,200,400,200,1,00248,India
424653,2024-02-08,1012,Body Lotion,200,400,200,2,00100,India
424653,2024-02-08,1001,Lipstick,150,300,150,1,00100,India
359385,2024-02-08,1008,Makeup Remover,80,160,80,1,00362,India
808622,2024-02-08,1002,Mascara,200,400,200,1,00484,India
808622,2024-02-08,1003,Foundation,300,600,300,1,00484,India
366941,2024-02-08,1005,Nail Polish,50,100,50,1,00369,India
366941,2024-02-08,1008,Makeup Remover,80,160,80,1,00369,India
366941,2024-02-08,1001,Lipstick,150,300,150,1,00369,India
366941,2024-02-08,1002,Mascara,200,400,200,1,00369,India
770522,2024-02-08,1012,Body Lotion,200,400,200,2,00285,India
770522,2024-02-08,1004,Eyeliner,100,200,100,1,00285,India
155276,2024-02-09,1003,Foundation,300,600,300,1,00268,India
155276,2024-02-09,1002,Mascara,200,400,200,1,00268,India
260517,2024-02-09,1006,Blush,150,300,150,1,00154,India
260517,2024-02-09,1004,Eyeliner,100,200,100,1,00154,India
260517,2024-02-09,1009,Moisturizer,250,500,250,2,00154,India
621905,2024-02-09,1006,Blush,150,300,150,1,00072,India
621905,2024-02-09,1005,Nail Polish,50,100,50,1,00072,India
621905,2024-02-09,1004,Eyeliner,100,200,100,1,00072,India
496501,2024-02-09,1003,Foundation,300,600,300,1,00300,India
372498,2024-02-09,1009,Moisturizer,250,500,250,2,00243,India
785930,2024-02-09,1003,Foundation,300,600,300,1,00261,India
785930,2024-02-09,1008,Makeup Remover,80,160,80,1,00261,India
785930,2024-02-09,1012,Body Lotion,200,400,200,2,00261,India
785930,2024-02-09,1001,Lipstick,150,300,150,1,00261,India
147358,2024-02-09,1008,Makeup Remover,80,160,80,1,00028,India
147358,2024-02-09,1009,Moisturizer,250,500,250,2,00028,India
765979,2024-02-09,1005,Nail Polish,50,100,50,1,00064,India
765979,2024-02-09,1003,Foundation,300,600,300,1,00064,India
514753,2024-02-09,1008,Makeup Remover,80,160,80,1,00170,India
514753,2024-02-09,1002,Mascara,200,400,200,1,00170,India
677795,2024-02-09,1012,Body Lotion,200,400,200,2,00460,India
677795,2024-02-09,1002,Mascara,200,400,200,1,00460,India
968515,2024-02-09,1009,Moisturizer,250,500,250,2,00086,India
968515,2024-02-09,1012,Body Lotion,200,400,200,2,00086,India
968515,2024-02-09,1002,Mascara,200,400,200,1,00086,India
968515,2024-02-09,1007,Eyeshadow,200,400,200,1,00086,India
968515,2024-02-09,1001,Lipstick,150,300,150,1,00086,India
112666,2024-02-09,1008,Makeup Remover,80,160,80,1,00407,India
112666,2024-02-09,1012,Body Lotion,200,400,200,2,00407,India
604143,2024-02-09,1002,Mascara,200,400,200,1,00047,India
604143,2024-02-09,1006,Blush,150,300,150,1,00047,India
604143,2024-02-09,1001,Lipstick,150,300,150,1,00047,India
580936,2024-02-09,1009,Moisturizer,250,500,250,2,00318,India
478386,2024-02-09,1007,Eyeshadow,200,400,200,1,00359,India
478386,2024-02-09,1009,Moisturizer,250,500,250,2,00359,India
478386,2024-02-09,1005,Nail Polish,50,100,50,1,00359,India
863759,2024-02-09,1005,Nail Polish,50,100,50,1,00207,India
863759,2024-02-09,1009,Moisturizer,250,500,250,2,00207,India
863759,2024-02-09,1008,Makeup Remover,80,160,80,1,00207,India
870105,2024-02-09,1009,Moisturizer,250,500,250,2,00347,India
870105,2024-02-09,1002,Mascara,200,400,200,1,00347,India
870105,2024-02-09,1008,Makeup Remover,80,160,80,1,00347,India
216923,2024-02-09,1004,Eyeliner,100,200,100,1,00188,India
216923,2024-02-09,1007,Eyeshadow,200,400,200,1,00188,India
216923,2024-02-09,1005,Nail Polish,50,100,50,1,00188,India
745829,2024-02-09,1006,Blush,150,300,150,1,00230,India
745829,2024-02-09,1007,Eyeshadow,200,400,200,1,00230,India
535283,2024-02-09,1001,Lipstick,150,300,150,1,00301,India
535283,2024-02-09,1008,Makeup Remover,80,160,80,1,00301,India
535283,2024-02-09,1005,Nail Polish,50,100,50,1,00301,India
535283,2024-02-09,1006,Blush,150,300,150,1,00301,India
804073,2024-02-09,1004,Eyeliner,100,200,100,1,00186,India
804073,2024-02-09,1006,Blush,150,300,150,1,00186,India
804073,2024-02-09,1005,Nail Polish,50,100,50,1,00186,India
779163,2024-02-09,1006,Blush,150,300,150,1,00086,India
779163,2024-02-09,1002,Mascara,200,400,200,1,00086,India
779163,2024-02-09,1001,Lipstick,150,300,150,1,00086,India
779163,2024-02-09,1005,Nail Polish,50,100,50,1,00086,India
243929,2024-02-09,1009,Moisturizer,250,500,250,2,00371,India
518831,2024-02-09,1007,Eyeshadow,200,400,200,1,00166,India
518831,2024-02-09,1009,Moisturizer,250,500,250,2,00166,India
518831,2024-02-09,1008,Makeup Remover,80,160,80,1,00166,India
518831,2024-02-09,1001,Lipstick,150,300,150,1,00166,India
830610,2024-02-09,1009,Moisturizer,250,500,250,2,00061,India
741586,2024-02-09,1009,Moisturizer,250,500,250,2,00380,India
741586,2024-02-09,1006,Blush,150,300,150,1,00380,India
503682,2024-02-09,1004,Eyeliner,100,200,100,1,00216,India
503682,2024-02-09,1009,Moisturizer,250,500,250,2,00216,India
503682,2024-02-09,1007,Eyeshadow,200,400,200,1,00216,India
594431,2024-02-09,1005,Nail Polish,50,100,50,1,00459,India
594431,2024-02-09,1001,Lipstick,150,300,150,1,00459,India
632424,2024-02-09,1008,Makeup Remover,80,160,80,1,00397,India
869869,2024-02-09,1012,Body Lotion,200,400,200,2,00015,India
869869,2024-02-09,1009,Moisturizer,250,500,250,2,00015,India
869869,2024-02-09,1002,Mascara,200,400,200,1,00015,India
869869,2024-02-09,1006,Blush,150,300,150,1,00015,India
745612,2024-02-09,1002,Mascara,200,400,200,1,00400,India
745612,2024-02-09,1012,Body Lotion,200,400,200,2,00400,India
409771,2024-02-09,1004,Eyeliner,100,200,100,1,00367,India
409771,2024-02-09,1006,Blush,150,300,150,1,00367,India
409771,2024-02-09,1009,Moisturizer,250,500,250,2,00367,India
409771,2024-02-09,1012,Body Lotion,200,400,200,2,00367,India
417544,2024-02-09,1009,Moisturizer,250,500,250,2,00321,India
417544,2024-02-09,1007,Eyeshadow,200,400,200,1,00321,India
417544,2024-02-09,1004,Eyeliner,100,200,100,1,00321,India
875364,2024-02-09,1003,Foundation,300,600,300,1,00178,India
875364,2024-02-09,1005,Nail Polish,50,100,50,1,00178,India
875364,2024-02-09,1004,Eyeliner,100,200,100,1,00178,India
875364,2024-02-09,1002,Mascara,200,400,200,1,00178,India
893545,2024-02-09,1009,Moisturizer,250,500,250,2,00153,India
893545,2024-02-09,1003,Foundation,300,600,300,1,00153,India
893545,2024-02-09,1012,Body Lotion,200,400,200,2,00153,India
369693,2024-02-09,1009,Moisturizer,250,500,250,2,00146,India
369693,2024-02-09,1005,Nail Polish,50,100,50,1,00146,India
369693,2024-02-09,1006,Blush,150,300,150,1,00146,India
657889,2024-02-09,1002,Mascara,200,400,200,1,00071,India
657889,2024-02-09,1003,Foundation,300,600,300,1,00071,India
657889,2024-02-09,1012,Body Lotion,200,400,200,2,00071,India
689612,2024-02-09,1005,Nail Polish,50,100,50,1,00188,India
233226,2024-02-09,1003,Foundation,300,600,300,1,00246,India
233226,2024-02-09,1008,Makeup Remover,80,160,80,1,00246,India
356329,2024-02-09,1004,Eyeliner,100,200,100,1,00290,India
356329,2024-02-09,1003,Foundation,300,600,300,1,00290,India
848406,2024-02-09,1003,Foundation,300,600,300,1,00088,India
848406,2024-02-09,1012,Body Lotion,200,400,200,2,00088,India
848406,2024-02-09,1005,Nail Polish,50,100,50,1,00088,India
848406,2024-02-09,1007,Eyeshadow,200,400,200,1,00088,India
329294,2024-02-09,1003,Foundation,300,600,300,1,00201,India
329294,2024-02-09,1008,Makeup Remover,80,160,80,1,00201,India
329294,2024-02-09,1009,Moisturizer,250,500,250,2,00201,India
666244,2024-02-09,1003,Foundation,300,600,300,1,00453,India
666244,2024-02-09,1007,Eyeshadow,200,400,200,1,00453,India
666244,2024-02-09,1012,Body Lotion,200,400,200,2,00453,India
129089,2024-02-09,1005,Nail Polish,50,100,50,1,00304,India
129089,2024-02-09,1001,Lipstick,150,300,150,1,00304,India
129089,2024-02-09,1002,Mascara,200,400,200,1,00304,India
129089,2024-02-09,1003,Foundation,300,600,300,1,00304,India
302913,2024-02-09,1012,Body Lotion,200,400,200,2,00274,India
302913,2024-02-09,1008,Makeup Remover,80,160,80,1,00274,India
302913,2024-02-09,1002,Mascara,200,400,200,1,00274,India
450515,2024-02-09,1012,Body Lotion,200,400,200,2,00218,India
450515,2024-02-09,1006,Blush,150,300,150,1,00218,India
363462,2024-02-10,1009,Moisturizer,250,500,250,2,00223,India
363462,2024-02-10,1001,Lipstick,150,300,150,1,00223,India
363462,2024-02-10,1006,Blush,150,300,150,1,00223,India
436126,2024-02-10,1009,Moisturizer,250,500,250,2,00438,India
436126,2024-02-10,1002,Mascara,200,400,200,1,00438,India
736935,2024-02-10,1002,Mascara,200,400,200,1,00439,India
978086,2024-02-10,1009,Moisturizer,250,500,250,2,00370,India
978086,2024-02-10,1012,Body Lotion,200,400,200,2,00370,India
826401,2024-02-10,1008,Makeup Remover,80,160,80,1,00391,India
826401,2024-02-10,1009,Moisturizer,250,500,250,2,00391,India
826401,2024-02-10,1001,Lipstick,150,300,150,1,00391,India
521112,2024-02-10,1006,Blush,150,300,150,1,00470,India
521112,2024-02-10,1009,Moisturizer,250,500,250,2,00470,India
521112,2024-02-10,1004,Eyeliner,100,200,100,1,00470,India
987724,2024-02-10,1006,Blush,150,300,150,1,00091,India
987724,2024-02-10,1004,Eyeliner,100,200,100,1,00091,India
987724,2024-02-10,1008,Makeup Remover,80,160,80,1,00091,India
987724,2024-02-10,1007,Eyeshadow,200,400,200,1,00091,India
229519,2024-02-10,1003,Foundation,300,600,300,1,00274,India
229519,2024-02-10,1005,Nail Polish,50,100,50,1,00274,India
229519,2024-02-10,1009,Moisturizer,250,500,250,2,00274,India
229519,2024-02-10,1001,Lipstick,150,300,150,1,00274,India
229519,2024-02-10,1004,Eyeliner,100,200,100,1,00274,India
133879,2024-02-10,1008,Makeup Remover,80,160,80,1,00430,India
133879,2024-02-10,1005,Nail Polish,50,100,50,1,00430,India
133879,2024-02-10,1004,Eyeliner,100,200,100,1,00430,India
133879,2024-02-10,1001,Lipstick,150,300,150,1,00430,India
133879,2024-02-10,1003,Foundation,300,600,300,1,00430,India
691299,2024-02-10,1008,Makeup Remover,80,160,80,1,00200,India
862491,2024-02-10,1005,Nail Polish,50,100,50,1,00205,India
862491,2024-02-10,1006,Blush,150,300,150,1,00205,India
862491,2024-02-10,1012,Body Lotion,200,400,200,2,00205,India
862491,2024-02-10,1008,Makeup Remover,80,160,80,1,00205,India
974018,2024-02-10,1002,Mascara,200,400,200,1,00038,India
974018,2024-02-10,1012,Body Lotion,200,400,200,2,00038,India
201588,2024-02-10,1007,Eyeshadow,200,400,200,1,00268,India
201588,2024-02-10,1002,Mascara,200,400,200,1,00268,India
630297,2024-02-10,1003,Foundation,300,600,300,1,00387,India
131359,2024-02-10,1005,Nail Polish,50,100,50,1,00240,India
144359,2024-02-10,1008,Makeup Remover,80,160,80,1,00005,India
595161,2024-02-10,1009,Moisturizer,250,500,250,2,00495,India
648746,2024-02-10,1007,Eyeshadow,200,400,200,1,00097,India
681927,2024-02-10,1001,Lipstick,150,300,150,1,00214,India
762887,2024-02-10,1009,Moisturizer,250,500,250,2,00193,India
762887,2024-02-10,1003,Foundation,300,600,300,1,00193,India
276650,2024-02-10,1007,Eyeshadow,200,400,200,1,00277,India
276650,2024-02-10,1008,Makeup Remover,80,160,80,1,00277,India
276650,2024-02-10,1001,Lipstick,150,300,150,1,00277,India
276650,2024-02-10,1004,Eyeliner,100,200,100,1,00277,India
913720,2024-02-10,1005,Nail Polish,50,100,50,1,00294,India
913720,2024-02-10,1009,Moisturizer,250,500,250,2,00294,India
913720,2024-02-10,1003,Foundation,300,600,300,1,00294,India
913720,2024-02-10,1002,Mascara,200,400,200,1,00294,India
111311,2024-02-10,1006,Blush,150,300,150,1,00247,India
567226,2024-02-10,1012,Body Lotion,200,400,200,2,00326,India
567226,2024-02-10,1004,Eyeliner,100,200,100,1,00326,India
804660,2024-02-10,1007,Eyeshadow,200,400,200,1,00043,India
804660,2024-02-10,1003,Foundation,300,600,300,1,00043,India
804660,2024-02-10,1009,Moisturizer,250,500,250,2,00043,India
804660,2024-02-10,1001,Lipstick,150,300,150,1,00043,India
730829,2024-02-10,1002,Mascara,200,400,200,1,00306,India
730829,2024-02-10,1008,Makeup Remover,80,160,80,1,00306,India
332899,2024-02-10,1006,Blush,150,300,150,1,00372,India
332899,2024-02-10,1005,Nail Polish,50,100,50,1,00372,India
332899,2024-02-10,1009,Moisturizer,250,500,250,2,00372,India
332899,2024-02-10,1007,Eyeshadow,200,400,200,1,00372,India
498954,2024-02-10,1009,Moisturizer,250,500,250,2,00450,India
498954,2024-02-10,1006,Blush,150,300,150,1,00450,India
538153,2024-02-10,1002,Mascara,200,400,200,1,00138,India
538153,2024-02-10,1005,Nail Polish,50,100,50,1,00138,India
561404,2024-02-10,1002,Mascara,200,400,200,1,00350,India
561404,2024-02-10,1007,Eyeshadow,200,400,200,1,00350,India
561404,2024-02-10,1003,Foundation,300,600,300,1,00350,India
561404,2024-02-10,1001,Lipstick,150,300,150,1,00350,India
379502,2024-02-10,1009,Moisturizer,250,500,250,2,00160,India
379502,2024-02-10,1002,Mascara,200,400,200,1,00160,India
379502,2024-02-10,1003,Foundation,300,600,300,1,00160,India
379502,2024-02-10,1006,Blush,150,300,150,1,00160,India
368310,2024-02-11,1008,Makeup Remover,80,160,80,1,00279,India
368310,2024-02-11,1005,Nail Polish,50,100,50,1,00279,India
368310,2024-02-11,1003,Foundation,300,600,300,1,00279,India
368310,2024-02-11,1001,Lipstick,150,300,150,1,00279,India
570301,2024-02-11,1012,Body Lotion,200,400,200,2,00161,India
570301,2024-02-11,1009,Moisturizer,250,500,250,2,00161,India
570301,2024-02-11,1008,Makeup Remover,80,160,80,1,00161,India
522887,2024-02-11,1001,Lipstick,150,300,150,1,00433,India
522887,2024-02-11,1003,Foundation,300,600,300,1,00433,India
830004,2024-02-11,1007,Eyeshadow,200,400,200,1,00414,India
945267,2024-02-11,1005,Nail Polish,50,100,50,1,00234,India
945267,2024-02-11,1006,Blush,150,300,150,1,00234,India
596558,2024-02-11,1005,Nail Polish,50,100,50,1,00101,India
105454,2024-02-11,1007,Eyeshadow,200,400,200,1,00490,India
105454,2024-02-11,1004,Eyeliner,100,200,100,1,00490,India
105454,2024-02-11,1005,Nail Polish,50,100,50,1,00490,India
529277,2024-02-11,1009,Moisturizer,250,500,250,2,00027,India
529277,2024-02-11,1012,Body Lotion,200,400,200,2,00027,India
529277,2024-02-11,1003,Foundation,300,600,300,1,00027,India
529277,2024-02-11,1006,Blush,150,300,150,1,00027,India
906365,2024-02-11,1002,Mascara,200,400,200,1,00484,India
906365,2024-02-11,1003,Foundation,300,600,300,1,00484,India
102577,2024-02-11,1008,Makeup Remover,80,160,80,1,00255,India
102577,2024-02-11,1012,Body Lotion,200,400,200,2,00255,India
102577,2024-02-11,1003,Foundation,300,600,300,1,00255,India
465966,2024-02-11,1005,Nail Polish,50,100,50,1,00373,India
465966,2024-02-11,1003,Foundation,300,600,300,1,00373,India
959598,2024-02-11,1003,Foundation,300,600,300,1,00355,India
959598,2024-02-11,1005,Nail Polish,50,100,50,1,00355,India
959598,2024-02-11,1008,Makeup Remover,80,160,80,1,00355,India
433912,2024-02-11,1012,Body Lotion,200,400,200,2,00451,India
433912,2024-02-11,1006,Blush,150,300,150,1,00451,India
508032,2024-02-11,1002,Mascara,200,400,200,1,00247,India
508032,2024-02-11,1012,Body Lotion,200,400,200,2,00247,India
508032,2024-02-11,1003,Foundation,300,600,300,1,00247,India
487498,2024-02-11,1007,Eyeshadow,200,400,200,1,00391,India
487498,2024-02-11,1009,Moisturizer,250,500,250,2,00391,India
487498,2024-02-11,1003,Foundation,300,600,300,1,00391,India
127149,2024-02-11,1001,Lipstick,150,300,150,1,00084,India
127149,2024-02-11,1003,Foundation,300,600,300,1,00084,India
127149,2024-02-11,1007,Eyeshadow,200,400,200,1,00084,India
127149,2024-02-11,1004,Eyeliner,100,200,100,1,00084,India
772702,2024-02-11,1009,Moisturizer,250,500,250,2,00198,India
772702,2024-02-11,1007,Eyeshadow,200,400,200,1,00198,India
772702,2024-02-11,1004,Eyeliner,100,200,100,1,00198,India
623754,2024-02-11,1001,Lipstick,150,300,150,1,00137,India
623754,2024-02-11,1006,Blush,150,300,150,1,00137,India
623754,2024-02-11,1012,Body Lotion,200,400,200,2,00137,India
634432,2024-02-11,1003,Foundation,300,600,300,1,00036,India
356835,2024-02-11,1012,Body Lotion,200,400,200,2,00043,India
640861,2024-02-11,1001,Lipstick,150,300,150,1,00046,India
640861,2024-02-11,1009,Moisturizer,250,500,250,2,00046,India
688177,2024-02-11,1007,Eyeshadow,200,400,200,1,00453,India
688177,2024-02-11,1003,Foundation,300,600,300,1,00453,India
633008,2024-02-11,1006,Blush,150,300,150,1,00380,India
633008,2024-02-11,1007,Eyeshadow,200,400,200,1,00380,India
633008,2024-02-11,1001,Lipstick,150,300,150,1,00380,India
188562,2024-02-11,1003,Foundation,300,600,300,1,00218,India
188562,2024-02-11,1006,Blush,150,300,150,1,00218,India
188562,2024-02-11,1002,Mascara,200,400,200,1,00218,India
188562,2024-02-11,1007,Eyeshadow,200,400,200,1,00218,India
444680,2024-02-11,1012,Body Lotion,200,400,200,2,00124,India
444680,2024-02-11,1001,Lipstick,150,300,150,1,00124,India
255676,2024-02-11,1007,Eyeshadow,200,400,200,1,00475,India
255676,2024-02-11,1004,Eyeliner,100,200,100,1,00475,India
255676,2024-02-11,1008,Makeup Remover,80,160,80,1,00475,India
970154,2024-02-11,1012,Body Lotion,200,400,200,2,00447,India
970154,2024-02-11,1006,Blush,150,300,150,1,00447,India
970154,2024-02-11,1002,Mascara,200,400,200,1,00447,India
970154,2024-02-11,1005,Nail Polish,50,100,50,1,00447,India
970154,2024-02-11,1004,Eyeliner,100,200,100,1,00447,India
441530,2024-02-11,1003,Foundation,300,600,300,1,00360,India
441530,2024-02-11,1006,Blush,150,300,150,1,00360,India
441530,2024-02-11,1008,Makeup Remover,80,160,80,1,00360,India
441530,2024-02-11,1004,Eyeliner,100,200,100,1,00360,India
689875,2024-02-11,1002,Mascara,200,400,200,1,00269,India
840926,2024-02-11,1007,Eyeshadow,200,400,200,1,00196,India
582263,2024-02-11,1001,Lipstick,150,300,150,1,00121,India
582263,2024-02-11,1002,Mascara,200,400,200,1,00121,India
833401,2024-02-11,1007,Eyeshadow,200,400,200,1,00171,India
833401,2024-02-11,1009,Moisturizer,250,500,250,2,00171,India
833401,2024-02-11,1003,Foundation,300,600,300,1,00171,India
833401,2024-02-11,1012,Body Lotion,200,400,200,2,00171,India
106631,2024-02-11,1007,Eyeshadow,200,400,200,1,00294,India
106631,2024-02-11,1012,Body Lotion,200,400,200,2,00294,India
106631,2024-02-11,1009,Moisturizer,250,500,250,2,00294,India
106631,2024-02-11,1004,Eyeliner,100,200,100,1,00294,India
796421,2024-02-11,1009,Moisturizer,250,500,250,2,00442,India
796421,2024-02-11,1012,Body Lotion,200,400,200,2,00442,India
796421,2024-02-11,1004,Eyeliner,100,200,100,1,00442,India
796421,2024-02-11,1007,Eyeshadow,200,400,200,1,00442,India
293353,2024-02-11,1005,Nail Polish,50,100,50,1,00116,India
293353,2024-02-11,1004,Eyeliner,100,200,100,1,00116,India
293353,2024-02-11,1006,Blush,150,300,150,1,00116,India
293353,2024-02-11,1001,Lipstick,150,300,150,1,00116,India
677093,2024-02-11,1004,Eyeliner,100,200,100,1,00338,India
677093,2024-02-11,1001,Lipstick,150,300,150,1,00338,India
677093,2024-02-11,1002,Mascara,200,400,200,1,00338,India
305537,2024-02-11,1012,Body Lotion,200,400,200,2,00202,India
305537,2024-02-11,1001,Lipstick,150,300,150,1,00202,India
305537,2024-02-11,1006,Blush,150,300,150,1,00202,India
305537,2024-02-11,1008,Makeup Remover,80,160,80,1,00202,India
305537,2024-02-11,1003,Foundation,300,600,300,1,00202,India
135891,2024-02-11,1004,Eyeliner,100,200,100,1,00383,India
135891,2024-02-11,1002,Mascara,200,400,200,1,00383,India
289229,2024-02-11,1007,Eyeshadow,200,400,200,1,00103,India
982065,2024-02-11,1005,Nail Polish,50,100,50,1,00305,India
982065,2024-02-11,1006,Blush,150,300,150,1,00305,India
982065,2024-02-11,1008,Makeup Remover,80,160,80,1,00305,India
982065,2024-02-11,1009,Moisturizer,250,500,250,2,00305,India
853217,2024-02-12,1003,Foundation,300,600,300,1,00357,India
853217,2024-02-12,1005,Nail Polish,50,100,50,1,00357,India
853217,2024-02-12,1004,Eyeliner,100,200,100,1,00357,India
981533,2024-02-12,1009,Moisturizer,250,500,250,2,00338,India
981533,2024-02-12,1004,Eyeliner,100,200,100,1,00338,India
981533,2024-02-12,1001,Lipstick,150,300,150,1,00338,India
981533,2024-02-12,1005,Nail Polish,50,100,50,1,00338,India
981533,2024-02-12,1008,Makeup Remover,80,160,80,1,00338,India
429383,2024-02-12,1009,Moisturizer,250,500,250,2,00101,India
429383,2024-02-12,1005,Nail Polish,50,100,50,1,00101,India
429383,2024-02-12,1004,Eyeliner,100,200,100,1,00101,India
127623,2024-02-12,1009,Moisturizer,250,500,250,2,00215,India
127623,2024-02-12,1004,Eyeliner,100,200,100,1,00215,India
127623,2024-02-12,1005,Nail Polish,50,100,50,1,00215,India
127623,2024-02-12,1007,Eyeshadow,200,400,200,1,00215,India
299292,2024-02-12,1001,Lipstick,150,300,150,1,00066,India
299292,2024-02-12,1009,Moisturizer,250,500,250,2,00066,India
283522,2024-02-12,1006,Blush,150,300,150,1,00227,India
283522,2024-02-12,1012,Body Lotion,200,400,200,2,00227,India
283522,2024-02-12,1001,Lipstick,150,300,150,1,00227,India
808391,2024-02-12,1008,Makeup Remover,80,160,80,1,00148,India
436330,2024-02-12,1008,Makeup Remover,80,160,80,1,00310,India
436330,2024-02-12,1002,Mascara,200,400,200,1,00310,India
436330,2024-02-12,1001,Lipstick,150,300,150,1,00310,India
710380,2024-02-12,1008,Makeup Remover,80,160,80,1,00105,India
710380,2024-02-12,1006,Blush,150,300,150,1,00105,India
710380,2024-02-12,1009,Moisturizer,250,500,250,2,00105,India
710380,2024-02-12,1012,Body Lotion,200,400,200,2,00105,India
710380,2024-02-12,1005,Nail Polish,50,100,50,1,00105,India
342906,2024-02-12,1002,Mascara,200,400,200,1,00291,India
342906,2024-02-12,1001,Lipstick,150,300,150,1,00291,India
342906,2024-02-12,1008,Makeup Remover,80,160,80,1,00291,India
342906,2024-02-12,1006,Blush,150,300,150,1,00291,India
129441,2024-02-12,1009,Moisturizer,250,500,250,2,00148,India
236655,2024-02-12,1003,Foundation,300,600,300,1,00435,India
236655,2024-02-12,1008,Makeup Remover,80,160,80,1,00435,India
236655,2024-02-12,1001,Lipstick,150,300,150,1,00435,India
236655,2024-02-12,1007,Eyeshadow,200,400,200,1,00435,India
489296,2024-02-12,1005,Nail Polish,50,100,50,1,00480,India
197312,2024-02-12,1005,Nail Polish,50,100,50,1,00306,India
197312,2024-02-12,1006,Blush,150,300,150,1,00306,India
197312,2024-02-12,1009,Moisturizer,250,500,250,2,00306,India
197312,2024-02-12,1002,Mascara,200,400,200,1,00306,India
307244,2024-02-12,1001,Lipstick,150,300,150,1,00061,India
523059,2024-02-12,1006,Blush,150,300,150,1,00038,India
523059,2024-02-12,1009,Moisturizer,250,500,250,2,00038,India
523059,2024-02-12,1003,Foundation,300,600,300,1,00038,India
523059,2024-02-12,1008,Makeup Remover,80,160,80,1,00038,India
523059,2024-02-12,1005,Nail Polish,50,100,50,1,00038,India
659422,2024-02-12,1002,Mascara,200,400,200,1,00098,India
659422,2024-02-12,1004,Eyeliner,100,200,100,1,00098,India
659422,2024-02-12,1007,Eyeshadow,200,400,200,1,00098,India
659422,2024-02-12,1012,Body Lotion,200,400,200,2,00098,India
170509,2024-02-12,1007,Eyeshadow,200,400,200,1,00142,India
170509,2024-02-12,1009,Moisturizer,250,500,250,2,00142,India
170509,2024-02-12,1002,Mascara,200,400,200,1,00142,India
471758,2024-02-12,1009,Moisturizer,250,500,250,2,00416,India
471758,2024-02-12,1003,Foundation,300,600,300,1,00416,India
471758,2024-02-12,1006,Blush,150,300,150,1,00416,India
888801,2024-02-12,1005,Nail Polish,50,100,50,1,00370,India
834829,2024-02-12,1006,Blush,150,300,150,1,00026,India
834829,2024-02-12,1008,Makeup Remover,80,160,80,1,00026,India
834829,2024-02-12,1005,Nail Polish,50,100,50,1,00026,India
834829,2024-02-12,1002,Mascara,200,400,200,1,00026,India
683811,2024-02-12,1004,Eyeliner,100,200,100,1,00111,India
726137,2024-02-12,1001,Lipstick,150,300,150,1,00387,India
726137,2024-02-12,1007,Eyeshadow,200,400,200,1,00387,India
726137,2024-02-12,1006,Blush,150,300,150,1,00387,India
836302,2024-02-12,1002,Mascara,200,400,200,1,00137,India
836302,2024-02-12,1012,Body Lotion,200,400,200,2,00137,India
836302,2024-02-12,1008,Makeup Remover,80,160,80,1,00137,India
285654,2024-02-12,1001,Lipstick,150,300,150,1,00455,India
285654,2024-02-12,1007,Eyeshadow,200,400,200,1,00455,India
285654,2024-02-12,1005,Nail Polish,50,100,50,1,00455,India
285654,2024-02-12,1012,Body Lotion,200,400,200,2,00455,India
308958,2024-02-12,1001,Lipstick,150,300,150,1,00398,India
308958,2024-02-12,1009,Moisturizer,250,500,250,2,00398,India
645996,2024-02-12,1006,Blush,150,300,150,1,00121,India
645996,2024-02-12,1004,Eyeliner,100,200,100,1,00121,India
481096,2024-02-12,1001,Lipstick,150,300,150,1,00424,India
716574,2024-02-12,1003,Foundation,300,600,300,1,00463,India
716574,2024-02-12,1005,Nail Polish,50,100,50,1,00463,India
716574,2024-02-12,1006,Blush,150,300,150,1,00463,India
716574,2024-02-12,1007,Eyeshadow,200,400,200,1,00463,India
548510,2024-02-12,1004,Eyeliner,100,200,100,1,00380,India
836897,2024-02-13,1003,Foundation,300,600,300,1,00171,India
836897,2024-02-13,1006,Blush,150,300,150,1,00171,India
325571,2024-02-13,1007,Eyeshadow,200,400,200,1,00141,India
325571,2024-02-13,1002,Mascara,200,400,200,1,00141,India
325571,2024-02-13,1001,Lipstick,150,300,150,1,00141,India
325571,2024-02-13,1006,Blush,150,300,150,1,00141,India
722831,2024-02-13,1003,Foundation,300,600,300,1,00102,India
722831,2024-02-13,1008,Makeup Remover,80,160,80,1,00102,India
722831,2024-02-13,1009,Moisturizer,250,500,250,2,00102,India
270610,2024-02-13,1009,Moisturizer,250,500,250,2,00205,India
270610,2024-02-13,1005,Nail Polish,50,100,50,1,00205,India
270610,2024-02-13,1003,Foundation,300,600,300,1,00205,India
805186,2024-02-13,1004,Eyeliner,100,200,100,1,00471,India
805186,2024-02-13,1006,Blush,150,300,150,1,00471,India
805186,2024-02-13,1012,Body Lotion,200,400,200,2,00471,India
318411,2024-02-13,1002,Mascara,200,400,200,1,00224,India
318411,2024-02-13,1005,Nail Polish,50,100,50,1,00224,India
318411,2024-02-13,1006,Blush,150,300,150,1,00224,India
318411,2024-02-13,1003,Foundation,300,600,300,1,00224,India
318411,2024-02-13,1007,Eyeshadow,200,400,200,1,00224,India
323152,2024-02-13,1001,Lipstick,150,300,150,1,00151,India
323152,2024-02-13,1002,Mascara,200,400,200,1,00151,India
323152,2024-02-13,1009,Moisturizer,250,500,250,2,00151,India
323152,2024-02-13,1004,Eyeliner,100,200,100,1,00151,India
405120,2024-02-13,1001,Lipstick,150,300,150,1,00475,India
405120,2024-02-13,1003,Foundation,300,600,300,1,00475,India
405120,2024-02-13,1004,Eyeliner,100,200,100,1,00475,India
680254,2024-02-13,1003,Foundation,300,600,300,1,00157,India
680254,2024-02-13,1009,Moisturizer,250,500,250,2,00157,India
680254,2024-02-13,1006,Blush,150,300,150,1,00157,India
488264,2024-02-13,1009,Moisturizer,250,500,250,2,00292,India
488264,2024-02-13,1005,Nail Polish,50,100,50,1,00292,India
488264,2024-02-13,1003,Foundation,300,600,300,1,00292,India
134315,2024-02-13,1009,Moisturizer,250,500,250,2,00327,India
134315,2024-02-13,1008,Makeup Remover,80,160,80,1,00327,India
134315,2024-02-13,1002,Mascara,200,400,200,1,00327,India
134315,2024-02-13,1004,Eyeliner,100,200,100,1,00327,India
290943,2024-02-13,1004,Eyeliner,100,200,100,1,00106,India
290943,2024-02-13,1003,Foundation,300,600,300,1,00106,India
290943,2024-02-13,1008,Makeup Remover,80,160,80,1,00106,India
290943,2024-02-13,1001,Lipstick,150,300,150,1,00106,India
896169,2024-02-13,1001,Lipstick,150,300,150,1,00373,India
833555,2024-02-13,1009,Moisturizer,250,500,250,2,00017,India
219035,2024-02-13,1002,Mascara,200,400,200,1,00424,India
674579,2024-02-13,1005,Nail Polish,50,100,50,1,00138,India
674579,2024-02-13,1001,Lipstick,150,300,150,1,00138,India
674579,2024-02-13,1008,Makeup Remover,80,160,80,1,00138,India
674579,2024-02-13,1003,Foundation,300,600,300,1,00138,India
723841,2024-02-13,1008,Makeup Remover,80,160,80,1,00254,India
346041,2024-02-13,1006,Blush,150,300,150,1,00337,India
346041,2024-02-13,1005,Nail Polish,50,100,50,1,00337,India
109313,2024-02-13,1012,Body Lotion,200,400,200,2,00309,India
109313,2024-02-13,1003,Foundation,300,600,300,1,00309,India
109313,2024-02-13,1002,Mascara,200,400,200,1,00309,India
833946,2024-02-13,1004,Eyeliner,100,200,100,1,00467,India
833946,2024-02-13,1006,Blush,150,300,150,1,00467,India
833946,2024-02-13,1012,Body Lotion,200,400,200,2,00467,India
173146,2024-02-13,1006,Blush,150,300,150,1,00246,India
173146,2024-02-13,1001,Lipstick,150,300,150,1,00246,India
250001,2024-02-13,1008,Makeup Remover,80,160,80,1,00050,India
250001,2024-02-13,1001,Lipstick,150,300,150,1,00050,India
250001,2024-02-13,1009,Moisturizer,250,500,250,2,00050,India
440956,2024-02-13,1003,Foundation,300,600,300,1,00427,India
440956,2024-02-13,1009,Moisturizer,250,500,250,2,00427,India
440956,2024-02-13,1007,Eyeshadow,200,400,200,1,00427,India
440956,2024-02-13,1001,Lipstick,150,300,150,1,00427,India
535758,2024-02-13,1001,Lipstick,150,300,150,1,00387,India
535758,2024-02-13,1006,Blush,150,300,150,1,00387,India
629516,2024-02-13,1006,Blush,150,300,150,1,00078,India
629516,2024-02-13,1007,Eyeshadow,200,400,200,1,00078,India
629516,2024-02-13,1004,Eyeliner,100,200,100,1,00078,India
788132,2024-02-13,1006,Blush,150,300,150,1,00228,India
788132,2024-02-13,1001,Lipstick,150,300,150,1,00228,India
788132,2024-02-13,1008,Makeup Remover,80,160,80,1,00228,India
788132,2024-02-13,1005,Nail Polish,50,100,50,1,00228,India
788132,2024-02-13,1003,Foundation,300,600,300,1,00228,India
461197,2024-02-13,1004,Eyeliner,100,200,100,1,00133,India
379557,2024-02-13,1006,Blush,150,300,150,1,00210,India
648165,2024-02-13,1002,Mascara,200,400,200,1,00146,India
648165,2024-02-13,1012,Body Lotion,200,400,200,2,00146,India
161932,2024-02-13,1009,Moisturizer,250,500,250,2,00324,India
161932,2024-02-13,1012,Body Lotion,200,400,200,2,00324,India
161932,2024-02-13,1004,Eyeliner,100,200,100,1,00324,India
337058,2024-02-13,1006,Blush,150,300,150,1,00365,India
294969,2024-02-13,1005,Nail Polish,50,100,50,1,00188,India
212700,2024-02-13,1006,Blush,150,300,150,1,00288,India
935770,2024-02-13,1012,Body Lotion,200,400,200,2,00306,India
935770,2024-02-13,1008,Makeup Remover,80,160,80,1,00306,India
950022,2024-02-13,1002,Mascara,200,400,200,1,00162,India
950022,2024-02-13,1009,Moisturizer,250,500,250,2,00162,India
575352,2024-02-13,1005,Nail Polish,50,100,50,1,00109,India
195076,2024-02-13,1009,Moisturizer,250,500,250,2,00262,India
195076,2024-02-13,1006,Blush,150,300,150,1,00262,India
195076,2024-02-13,1007,Eyeshadow,200,400,200,1,00262,India
195076,2024-02-13,1005,Nail Polish,50,100,50,1,00262,India
740734,2024-02-13,1003,Foundation,300,600,300,1,00411,India
740734,2024-02-13,1006,Blush,150,300,150,1,00411,India
574821,2024-02-14,1001,Lipstick,150,300,150,1,00076,India
574821,2024-02-14,1004,Eyeliner,100,200,100,1,00076,India
574821,2024-02-14,1009,Moisturizer,250,500,250,2,00076,India
574821,2024-02-14,1006,Blush,150,300,150,1,00076,India
687129,2024-02-14,1008,Makeup Remover,80,160,80,1,00329,India
687129,2024-02-14,1006,Blush,150,300,150,1,00329,India
851449,2024-02-14,1009,Moisturizer,250,500,250,2,00129,India
851449,2024-02-14,1003,Foundation,300,600,300,1,00129,India
101716,2024-02-14,1006,Blush,150,300,150,1,00203,India
101716,2024-02-14,1008,Makeup Remover,80,160,80,1,00203,India
530549,2024-02-14,1002,Mascara,200,400,200,1,00446,India
128911,2024-02-14,1004,Eyeliner,100,200,100,1,00100,India
128911,2024-02-14,1008,Makeup Remover,80,160,80,1,00100,India
896902,2024-02-14,1007,Eyeshadow,200,400,200,1,00118,India
896902,2024-02-14,1008,Makeup Remover,80,160,80,1,00118,India
896902,2024-02-14,1003,Foundation,300,600,300,1,00118,India
896902,2024-02-14,1006,Blush,150,300,150,1,00118,India
896902,2024-02-14,1009,Moisturizer,250,500,250,2,00118,India
522515,2024-02-14,1008,Makeup Remover,80,160,80,1,00396,India
522515,2024-02-14,1006,Blush,150,300,150,1,00396,India
541036,2024-02-14,1001,Lipstick,150,300,150,1,00007,India
541036,2024-02-14,1005,Nail Polish,50,100,50,1,00007,India
541036,2024-02-14,1003,Foundation,300,600,300,1,00007,India
136028,2024-02-14,1003,Foundation,300,600,300,1,00401,India
136028,2024-02-14,1001,Lipstick,150,300,150,1,00401,India
136028,2024-02-14,1009,Moisturizer,250,500,250,2,00401,India
136028,2024-02-14,1008,Makeup Remover,80,160,80,1,00401,India
376413,2024-02-14,1008,Makeup Remover,80,160,80,1,00317,India
376413,2024-02-14,1005,Nail Polish,50,100,50,1,00317,India
491521,2024-02-14,1012,Body Lotion,200,400,200,2,00175,India
789106,2024-02-14,1002,Mascara,200,400,200,1,00153,India
789106,2024-02-14,1001,Lipstick,150,300,150,1,00153,India
789106,2024-02-14,1008,Makeup Remover,80,160,80,1,00153,India
789106,2024-02-14,1012,Body Lotion,200,400,200,2,00153,India
848813,2024-02-14,1003,Foundation,300,600,300,1,00429,India
157064,2024-02-14,1006,Blush,150,300,150,1,00046,India
157064,2024-02-14,1002,Mascara,200,400,200,1,00046,India
157064,2024-02-14,1008,Makeup Remover,80,160,80,1,00046,India
725036,2024-02-14,1001,Lipstick,150,300,150,1,00410,India
725036,2024-02-14,1003,Foundation,300,600,300,1,00410,India
725036,2024-02-14,1008,Makeup Remover,80,160,80,1,00410,India
725036,2024-02-14,1006,Blush,150,300,150,1,00410,India
281943,2024-02-14,1008,Makeup Remover,80,160,80,1,00270,India
531156,2024-02-14,1002,Mascara,200,400,200,1,00253,India
401595,2024-02-14,1004,Eyeliner,100,200,100,1,00462,India
310572,2024-02-14,1012,Body Lotion,200,400,200,2,00046,India
310572,2024-02-14,1004,Eyeliner,100,200,100,1,00046,India
310572,2024-02-14,1005,Nail Polish,50,100,50,1,00046,India
606704,2024-02-14,1009,Moisturizer,250,500,250,2,00038,India
606704,2024-02-14,1003,Foundation,300,600,300,1,00038,India
566238,2024-02-14,1003,Foundation,300,600,300,1,00490,India
566238,2024-02-14,1007,Eyeshadow,200,400,200,1,00490,India
566238,2024-02-14,1001,Lipstick,150,300,150,1,00490,India
566238,2024-02-14,1002,Mascara,200,400,200,1,00490,India
421499,2024-02-14,1012,Body Lotion,200,400,200,2,00225,India
421499,2024-02-14,1008,Makeup Remover,80,160,80,1,00225,India
421499,2024-02-14,1006,Blush,150,300,150,1,00225,India
720110,2024-02-14,1005,Nail Polish,50,100,50,1,00249,India
720110,2024-02-14,1003,Foundation,300,600,300,1,00249,India
758016,2024-02-14,1009,Moisturizer,250,500,250,2,00202,India
758016,2024-02-14,1002,Mascara,200,400,200,1,00202,India
205149,2024-02-14,1004,Eyeliner,100,200,100,1,00054,India
205149,2024-02-14,1001,Lipstick,150,300,150,1,00054,India
205149,2024-02-14,1002,Mascara,200,400,200,1,00054,India
927655,2024-02-14,1001,Lipstick,150,300,150,1,00017,India
927655,2024-02-14,1004,Eyeliner,100,200,100,1,00017,India
927655,2024-02-14,1003,Foundation,300,600,300,1,00017,India
224960,2024-02-14,1005,Nail Polish,50,100,50,1,00133,India
224960,2024-02-14,1001,Lipstick,150,300,150,1,00133,India
224960,2024-02-14,1002,Mascara,200,400,200,1,00133,India
224960,2024-02-14,1008,Makeup Remover,80,160,80,1,00133,India
224960,2024-02-14,1012,Body Lotion,200,400,200,2,00133,India
305213,2024-02-14,1004,Eyeliner,100,200,100,1,00450,India
305213,2024-02-14,1009,Moisturizer,250,500,250,2,00450,India
305213,2024-02-14,1008,Makeup Remover,80,160,80,1,00450,India
644237,2024-02-14,1008,Makeup Remover,80,160,80,1,00411,India
644237,2024-02-14,1004,Eyeliner,100,200,100,1,00411,India
644237,2024-02-14,1002,Mascara,200,400,200,1,00411,India
624473,2024-02-14,1008,Makeup Remover,80,160,80,1,00008,India
624473,2024-02-14,1012,Body Lotion,200,400,200,2,00008,India
471222,2024-02-14,1004,Eyeliner,100,200,100,1,00115,India
862280,2024-02-14,1001,Lipstick,150,300,150,1,00337,India
862280,2024-02-14,1007,Eyeshadow,200,400,200,1,00337,India
699884,2024-02-14,1006,Blush,150,300,150,1,00372,India
108391,2024-02-15,1002,Mascara,200,400,200,1,00428,India
108391,2024-02-15,1006,Blush,150,300,150,1,00428,India
656997,2024-02-15,1004,Eyeliner,100,200,100,1,00233,India
656997,2024-02-15,1009,Moisturizer,250,500,250,2,00233,India
656997,2024-02-15,1001,Lipstick,150,300,150,1,00233,India
839522,2024-02-15,1003,Foundation,300,600,300,1,00151,India
200737,2024-02-15,1006,Blush,150,300,150,1,00298,India
200737,2024-02-15,1005,Nail Polish,50,100,50,1,00298,India
200737,2024-02-15,1009,Moisturizer,250,500,250,2,00298,India
172745,2024-02-15,1007,Eyeshadow,200,400,200,1,00271,India
172745,2024-02-15,1009,Moisturizer,250,500,250,2,00271,India
108100,2024-02-15,1009,Moisturizer,250,500,250,2,00405,India
108100,2024-02-15,1008,Makeup Remover,80,160,80,1,00405,India
108100,2024-02-15,1005,Nail Polish,50,100,50,1,00405,India
902539,2024-02-15,1003,Foundation,300,600,300,1,00172,India
917364,2024-02-15,1003,Foundation,300,600,300,1,00271,India
917364,2024-02-15,1002,Mascara,200,400,200,1,00271,India
645563,2024-02-15,1007,Eyeshadow,200,400,200,1,00166,India
741874,2024-02-15,1006,Blush,150,300,150,1,00046,India
188040,2024-02-15,1004,Eyeliner,100,200,100,1,00075,India
188040,2024-02-15,1007,Eyeshadow,200,400,200,1,00075,India
255186,2024-02-15,1012,Body Lotion,200,400,200,2,00103,India
255186,2024-02-15,1009,Moisturizer,250,500,250,2,00103,India
823224,2024-02-15,1002,Mascara,200,400,200,1,00182,India
142169,2024-02-15,1003,Foundation,300,600,300,1,00062,India
142169,2024-02-15,1012,Body Lotion,200,400,200,2,00062,India
609344,2024-02-15,1012,Body Lotion,200,400,200,2,00237,India
429824,2024-02-15,1009,Moisturizer,250,500,250,2,00400,India
429824,2024-02-15,1002,Mascara,200,400,200,1,00400,India
429824,2024-02-15,1006,Blush,150,300,150,1,00400,India
601304,2024-02-15,1008,Makeup Remover,80,160,80,1,00284,India
601304,2024-02-15,1003,Foundation,300,600,300,1,00284,India
601304,2024-02-15,1012,Body Lotion,200,400,200,2,00284,India
601304,2024-02-15,1007,Eyeshadow,200,400,200,1,00284,India
617302,2024-02-15,1012,Body Lotion,200,400,200,2,00105,India
617302,2024-02-15,1007,Eyeshadow,200,400,200,1,00105,India
838937,2024-02-15,1009,Moisturizer,250,500,250,2,00177,India
838937,2024-02-15,1007,Eyeshadow,200,400,200,1,00177,India
838937,2024-02-15,1005,Nail Polish,50,100,50,1,00177,India
469405,2024-02-15,1003,Foundation,300,600,300,1,00292,India
469405,2024-02-15,1007,Eyeshadow,200,400,200,1,00292,India
469405,2024-02-15,1005,Nail Polish,50,100,50,1,00292,India
341994,2024-02-15,1005,Nail Polish,50,100,50,1,00481,India
341994,2024-02-15,1003,Foundation,300,600,300,1,00481,India
341994,2024-02-15,1006,Blush,150,300,150,1,00481,India
341994,2024-02-15,1012,Body Lotion,200,400,200,2,00481,India
791692,2024-02-15,1003,Foundation,300,600,300,1,00218,India
791692,2024-02-15,1002,Mascara,200,400,200,1,00218,India
791692,2024-02-15,1004,Eyeliner,100,200,100,1,00218,India
791692,2024-02-15,1001,Lipstick,150,300,150,1,00218,India
872366,2024-02-15,1003,Foundation,300,600,300,1,00238,India
872366,2024-02-15,1012,Body Lotion,200,400,200,2,00238,India
872366,2024-02-15,1001,Lipstick,150,300,150,1,00238,India
286794,2024-02-15,1002,Mascara,200,400,200,1,00352,India
286794,2024-02-15,1005,Nail Polish,50,100,50,1,00352,India
286794,2024-02-15,1003,Foundation,300,600,300,1,00352,India
286794,2024-02-15,1001,Lipstick,150,300,150,1,00352,India
286794,2024-02-15,1006,Blush,150,300,150,1,00352,India
600305,2024-02-15,1009,Moisturizer,250,500,250,2,00045,India
600305,2024-02-15,1004,Eyeliner,100,200,100,1,00045,India
600305,2024-02-15,1008,Makeup Remover,80,160,80,1,00045,India
600305,2024-02-15,1007,Eyeshadow,200,400,200,1,00045,India
769222,2024-02-15,1002,Mascara,200,400,200,1,00114,India
769222,2024-02-15,1005,Nail Polish,50,100,50,1,00114,India
723691,2024-02-15,1008,Makeup Remover,80,160,80,1,00471,India
723691,2024-02-15,1004,Eyeliner,100,200,100,1,00471,India
723691,2024-02-15,1001,Lipstick,150,300,150,1,00471,India
375618,2024-02-15,1003,Foundation,300,600,300,1,00426,India
375618,2024-02-15,1002,Mascara,200,400,200,1,00426,India
871718,2024-02-15,1004,Eyeliner,100,200,100,1,00228,India
871718,2024-02-15,1003,Foundation,300,600,300,1,00228,India
231959,2024-02-15,1001,Lipstick,150,300,150,1,00348,India
231959,2024-02-15,1009,Moisturizer,250,500,250,2,00348,India
231959,2024-02-15,1003,Foundation,300,600,300,1,00348,India
921355,2024-02-15,1009,Moisturizer,250,500,250,2,00063,India
921355,2024-02-15,1001,Lipstick,150,300,150,1,00063,India
921355,2024-02-15,1004,Eyeliner,100,200,100,1,00063,India
900309,2024-02-15,1003,Foundation,300,600,300,1,00468,India
900309,2024-02-15,1005,Nail Polish,50,100,50,1,00468,India
900309,2024-02-15,1002,Mascara,200,400,200,1,00468,India
238652,2024-02-15,1012,Body Lotion,200,400,200,2,00496,India
238652,2024-02-15,1005,Nail Polish,50,100,50,1,00496,India
238652,2024-02-15,1006,Blush,150,300,150,1,00496,India
165905,2024-02-15,1007,Eyeshadow,200,400,200,1,00477,India
165905,2024-02-15,1009,Moisturizer,250,500,250,2,00477,India
165905,2024-02-15,1012,Body Lotion,200,400,200,2,00477,India
447236,2024-02-15,1006,Blush,150,300,150,1,00358,India
447236,2024-02-15,1002,Mascara,200,400,200,1,00358,India
447236,2024-02-15,1001,Lipstick,150,300,150,1,00358,India
447236,2024-02-15,1009,Moisturizer,250,500,250,2,00358,India
179768,2024-02-15,1001,Lipstick,150,300,150,1,00194,India
179768,2024-02-15,1005,Nail Polish,50,100,50,1,00194,India
297276,2024-02-15,1002,Mascara,200,400,200,1,00434,India
345499,2024-02-15,1005,Nail Polish,50,100,50,1,00020,India
607343,2024-02-15,1007,Eyeshadow,200,400,200,1,00135,India
607343,2024-02-15,1006,Blush,150,300,150,1,00135,India
607343,2024-02-15,1003,Foundation,300,600,300,1,00135,India
607343,2024-02-15,1008,Makeup Remover,80,160,80,1,00135,India
607343,2024-02-15,1012,Body Lotion,200,400,200,2,00135,India
107442,2024-02-15,1005,Nail Polish,50,100,50,1,00419,India
107442,2024-02-15,1008,Makeup Remover,80,160,80,1,00419,India
107442,2024-02-15,1006,Blush,150,300,150,1,00419,India
107442,2024-02-15,1007,Eyeshadow,200,400,200,1,00419,India
264712,2024-02-15,1007,Eyeshadow,200,400,200,1,00275,India
300929,2024-02-16,1006,Blush,150,300,150,1,00122,India
300929,2024-02-16,1004,Eyeliner,100,200,100,1,00122,India
837610,2024-02-16,1004,Eyeliner,100,200,100,1,00123,India
837610,2024-02-16,1012,Body Lotion,200,400,200,2,00123,India
837610,2024-02-16,1005,Nail Polish,50,100,50,1,00123,India
349101,2024-02-16,1007,Eyeshadow,200,400,200,1,00080,India
349101,2024-02-16,1004,Eyeliner,100,200,100,1,00080,India
376597,2024-02-16,1006,Blush,150,300,150,1,00192,India
376597,2024-02-16,1003,Foundation,300,600,300,1,00192,India
376597,2024-02-16,1004,Eyeliner,100,200,100,1,00192,India
881857,2024-02-16,1009,Moisturizer,250,500,250,2,00269,India
881857,2024-02-16,1012,Body Lotion,200,400,200,2,00269,India
272296,2024-02-16,1008,Makeup Remover,80,160,80,1,00467,India
272296,2024-02-16,1009,Moisturizer,250,500,250,2,00467,India
272296,2024-02-16,1005,Nail Polish,50,100,50,1,00467,India
272296,2024-02-16,1006,Blush,150,300,150,1,00467,India
227760,2024-02-16,1003,Foundation,300,600,300,1,00321,India
227760,2024-02-16,1012,Body Lotion,200,400,200,2,00321,India
227760,2024-02-16,1004,Eyeliner,100,200,100,1,00321,India
227760,2024-02-16,1005,Nail Polish,50,100,50,1,00321,India
227760,2024-02-16,1002,Mascara,200,400,200,1,00321,India
368300,2024-02-16,1007,Eyeshadow,200,400,200,1,00455,India
368300,2024-02-16,1009,Moisturizer,250,500,250,2,00455,India
368300,2024-02-16,1012,Body Lotion,200,400,200,2,00455,India
318670,2024-02-16,1008,Makeup Remover,80,160,80,1,00189,India
318670,2024-02-16,1002,Mascara,200,400,200,1,00189,India
318670,2024-02-16,1003,Foundation,300,600,300,1,00189,India
840862,2024-02-16,1004,Eyeliner,100,200,100,1,00294,India
560394,2024-02-16,1009,Moisturizer,250,500,250,2,00288,India
560394,2024-02-16,1005,Nail Polish,50,100,50,1,00288,India
560394,2024-02-16,1012,Body Lotion,200,400,200,2,00288,India
560394,2024-02-16,1004,Eyeliner,100,200,100,1,00288,India
653291,2024-02-16,1004,Eyeliner,100,200,100,1,00494,India
141903,2024-02-16,1007,Eyeshadow,200,400,200,1,00272,India
141903,2024-02-16,1006,Blush,150,300,150,1,00272,India
803203,2024-02-16,1006,Blush,150,300,150,1,00297,India
803203,2024-02-16,1003,Foundation,300,600,300,1,00297,India
803203,2024-02-16,1002,Mascara,200,400,200,1,00297,India
803203,2024-02-16,1001,Lipstick,150,300,150,1,00297,India
572093,2024-02-16,1006,Blush,150,300,150,1,00288,India
572093,2024-02-16,1009,Moisturizer,250,500,250,2,00288,India
572093,2024-02-16,1008,Makeup Remover,80,160,80,1,00288,India
572093,2024-02-16,1003,Foundation,300,600,300,1,00288,India
402167,2024-02-16,1002,Mascara,200,400,200,1,00339,India
402167,2024-02-16,1004,Eyeliner,100,200,100,1,00339,India
402167,2024-02-16,1008,Makeup Remover,80,160,80,1,00339,India
703966,2024-02-16,1004,Eyeliner,100,200,100,1,00269,India
703966,2024-02-16,1008,Makeup Remover,80,160,80,1,00269,India
703966,2024-02-16,1007,Eyeshadow,200,400,200,1,00269,India
703966,2024-02-16,1002,Mascara,200,400,200,1,00269,India
608888,2024-02-16,1004,Eyeliner,100,200,100,1,00489,India
608888,2024-02-16,1002,Mascara,200,400,200,1,00489,India
594879,2024-02-16,1012,Body Lotion,200,400,200,2,00420,India
594879,2024-02-16,1007,Eyeshadow,200,400,200,1,00420,India
594879,2024-02-16,1005,Nail Polish,50,100,50,1,00420,India
224978,2024-02-16,1007,Eyeshadow,200,400,200,1,00187,India
224978,2024-02-16,1003,Foundation,300,600,300,1,00187,India
224978,2024-02-16,1002,Mascara,200,400,200,1,00187,India
393079,2024-02-16,1001,Lipstick,150,300,150,1,00432,India
393079,2024-02-16,1009,Moisturizer,250,500,250,2,00432,India
577722,2024-02-16,1003,Foundation,300,600,300,1,00443,India
778987,2024-02-16,1003,Foundation,300,600,300,1,00133,India
778987,2024-02-16,1012,Body Lotion,200,400,200,2,00133,India
778987,2024-02-16,1005,Nail Polish,50,100,50,1,00133,India
883500,2024-02-16,1003,Foundation,300,600,300,1,00177,India
883500,2024-02-16,1005,Nail Polish,50,100,50,1,00177,India
883500,2024-02-16,1007,Eyeshadow,200,400,200,1,00177,India
883500,2024-02-16,1002,Mascara,200,400,200,1,00177,India
883500,2024-02-16,1008,Makeup Remover,80,160,80,1,00177,India
844921,2024-02-16,1004,Eyeliner,100,200,100,1,00222,India
844921,2024-02-16,1002,Mascara,200,400,200,1,00222,India
844921,2024-02-16,1005,Nail Polish,50,100,50,1,00222,India
844921,2024-02-16,1003,Foundation,300,600,300,1,00222,India
456576,2024-02-16,1003,Foundation,300,600,300,1,00179,India
456576,2024-02-16,1005,Nail Polish,50,100,50,1,00179,India
456576,2024-02-16,1001,Lipstick,150,300,150,1,00179,India
823106,2024-02-16,1003,Foundation,300,600,300,1,00157,India
982867,2024-02-16,1004,Eyeliner,100,200,100,1,00309,India
814146,2024-02-16,1012,Body Lotion,200,400,200,2,00480,India
814146,2024-02-16,1001,Lipstick,150,300,150,1,00480,India
814146,2024-02-16,1007,Eyeshadow,200,400,200,1,00480,India
570574,2024-02-16,1012,Body Lotion,200,400,200,2,00452,India
570574,2024-02-16,1004,Eyeliner,100,200,100,1,00452,India
985491,2024-02-16,1007,Eyeshadow,200,400,200,1,00029,India
985491,2024-02-16,1001,Lipstick,150,300,150,1,00029,India
985491,2024-02-16,1002,Mascara,200,400,200,1,00029,India
985491,2024-02-16,1008,Makeup Remover,80,160,80,1,00029,India
985491,2024-02-16,1004,Eyeliner,100,200,100,1,00029,India
395978,2024-02-16,1008,Makeup Remover,80,160,80,1,00022,India
395978,2024-02-16,1005,Nail Polish,50,100,50,1,00022,India
395978,2024-02-16,1007,Eyeshadow,200,400,200,1,00022,India
424662,2024-02-16,1008,Makeup Remover,80,160,80,1,00342,India
424662,2024-02-16,1007,Eyeshadow,200,400,200,1,00342,India
424662,2024-02-16,1002,Mascara,200,400,200,1,00342,India
792117,2024-02-16,1003,Foundation,300,600,300,1,00431,India
792117,2024-02-16,1004,Eyeliner,100,200,100,1,00431,India
792117,2024-02-16,1002,Mascara,200,400,200,1,00431,India
432556,2024-02-16,1009,Moisturizer,250,500,250,2,00059,India
432556,2024-02-16,1001,Lipstick,150,300,150,1,00059,India
432556,2024-02-16,1003,Foundation,300,600,300,1,00059,India
432556,2024-02-16,1012,Body Lotion,200,400,200,2,00059,India
360716,2024-02-16,1005,Nail Polish,50,100,50,1,00301,India
355276,2024-02-17,1004,Eyeliner,100,200,100,1,00309,India
355276,2024-02-17,1003,Foundation,300,600,300,1,00309,India
505196,2024-02-17,1012,Body Lotion,200,400,200,2,00195,India
505196,2024-02-17,1004,Eyeliner,100,200,100,1,00195,India
371751,2024-02-17,1012,Body Lotion,200,400,200,2,00237,India
371751,2024-02-17,1003,Foundation,300,600,300,1,00237,India
971334,2024-02-17,1008,Makeup Remover,80,160,80,1,00357,India
579713,2024-02-17,1002,Mascara,200,400,200,1,00093,India
579713,2024-02-17,1003,Foundation,300,600,300,1,00093,India
316984,2024-02-17,1006,Blush,150,300,150,1,00427,India
316984,2024-02-17,1005,Nail Polish,50,100,50,1,00427,India
316984,2024-02-17,1009,Moisturizer,250,500,250,2,00427,India
316984,2024-02-17,1008,Makeup Remover,80,160,80,1,00427,India
316984,2024-02-17,1002,Mascara,200,400,200,1,00427,India
220205,2024-02-17,1002,Mascara,200,400,200,1,00335,India
220205,2024-02-17,1007,Eyeshadow,200,400,200,1,00335,India
220205,2024-02-17,1003,Foundation,300,600,300,1,00335,India
677784,2024-02-17,1002,Mascara,200,400,200,1,00450,India
677784,2024-02-17,1009,Moisturizer,250,500,250,2,00450,India
651711,2024-02-17,1012,Body Lotion,200,400,200,2,00039,India
651711,2024-02-17,1004,Eyeliner,100,200,100,1,00039,India
651711,2024-02-17,1007,Eyeshadow,200,400,200,1,00039,India
758346,2024-02-17,1002,Mascara,200,400,200,1,00152,India
758346,2024-02-17,1012,Body Lotion,200,400,200,2,00152,India
823558,2024-02-17,1012,Body Lotion,200,400,200,2,00075,India
345267,2024-02-17,1005,Nail Polish,50,100,50,1,00029,India
345267,2024-02-17,1007,Eyeshadow,200,400,200,1,00029,India
345267,2024-02-17,1009,Moisturizer,250,500,250,2,00029,India
345267,2024-02-17,1002,Mascara,200,400,200,1,00029,India
530690,2024-02-17,1003,Foundation,300,600,300,1,00207,India
530690,2024-02-17,1012,Body Lotion,200,400,200,2,00207,India
530690,2024-02-17,1002,Mascara,200,400,200,1,00207,India
712507,2024-02-17,1001,Lipstick,150,300,150,1,00419,India
712507,2024-02-17,1008,Makeup Remover,80,160,80,1,00419,India
999393,2024-02-17,1005,Nail Polish,50,100,50,1,00078,India
999393,2024-02-17,1012,Body Lotion,200,400,200,2,00078,India
999393,2024-02-17,1001,Lipstick,150,300,150,1,00078,India
999393,2024-02-17,1006,Blush,150,300,150,1,00078,India
753761,2024-02-17,1006,Blush,150,300,150,1,00160,India
753761,2024-02-17,1003,Foundation,300,600,300,1,00160,India
753761,2024-02-17,1012,Body Lotion,200,400,200,2,00160,India
201226,2024-02-17,1006,Blush,150,300,150,1,00118,India
201226,2024-02-17,1007,Eyeshadow,200,400,200,1,00118,India
201226,2024-02-17,1009,Moisturizer,250,500,250,2,00118,India
201226,2024-02-17,1012,Body Lotion,200,400,200,2,00118,India
345941,2024-02-17,1002,Mascara,200,400,200,1,00190,India
345941,2024-02-17,1012,Body Lotion,200,400,200,2,00190,India
345941,2024-02-17,1003,Foundation,300,600,300,1,00190,India
108263,2024-02-17,1001,Lipstick,150,300,150,1,00451,India
108263,2024-02-17,1003,Foundation,300,600,300,1,00451,India
108263,2024-02-17,1008,Makeup Remover,80,160,80,1,00451,India
799275,2024-02-17,1001,Lipstick,150,300,150,1,00024,India
250983,2024-02-17,1009,Moisturizer,250,500,250,2,00471,India
250983,2024-02-17,1008,Makeup Remover,80,160,80,1,00471,India
250983,2024-02-17,1002,Mascara,200,400,200,1,00471,India
840728,2024-02-17,1006,Blush,150,300,150,1,00214,India
840728,2024-02-17,1012,Body Lotion,200,400,200,2,00214,India
840728,2024-02-17,1007,Eyeshadow,200,400,200,1,00214,India
553889,2024-02-17,1008,Makeup Remover,80,160,80,1,00272,India
553889,2024-02-17,1009,Moisturizer,250,500,250,2,00272,India
833404,2024-02-17,1008,Makeup Remover,80,160,80,1,00114,India
833404,2024-02-17,1004,Eyeliner,100,200,100,1,00114,India
912494,2024-02-17,1007,Eyeshadow,200,400,200,1,00195,India
912494,2024-02-17,1005,Nail Polish,50,100,50,1,00195,India
614446,2024-02-17,1002,Mascara,200,400,200,1,00075,India
614446,2024-02-17,1001,Lipstick,150,300,150,1,00075,India
614446,2024-02-17,1008,Makeup Remover,80,160,80,1,00075,India
979992,2024-02-17,1007,Eyeshadow,200,400,200,1,00088,India
979992,2024-02-17,1005,Nail Polish,50,100,50,1,00088,India
270818,2024-02-17,1008,Makeup Remover,80,160,80,1,00334,India
270818,2024-02-17,1004,Eyeliner,100,200,100,1,00334,India
270818,2024-02-17,1005,Nail Polish,50,100,50,1,00334,India
270818,2024-02-17,1007,Eyeshadow,200,400,200,1,00334,India
270818,2024-02-17,1009,Moisturizer,250,500,250,2,00334,India
692583,2024-02-17,1012,Body Lotion,200,400,200,2,00038,India
692583,2024-02-17,1005,Nail Polish,50,100,50,1,00038,India
695152,2024-02-17,1004,Eyeliner,100,200,100,1,00087,India
695152,2024-02-17,1009,Moisturizer,250,500,250,2,00087,India
953860,2024-02-17,1005,Nail Polish,50,100,50,1,00230,India
811921,2024-02-17,1002,Mascara,200,400,200,1,00440,India
811921,2024-02-17,1007,Eyeshadow,200,400,200,1,00440,India
811921,2024-02-17,1004,Eyeliner,100,200,100,1,00440,India
828285,2024-02-17,1008,Makeup Remover,80,160,80,1,00424,India
225936,2024-02-17,1012,Body Lotion,200,400,200,2,00095,India
225936,2024-02-17,1003,Foundation,300,600,300,1,00095,India
251152,2024-02-17,1009,Moisturizer,250,500,250,2,00070,India
251152,2024-02-17,1001,Lipstick,150,300,150,1,00070,India
251152,2024-02-17,1012,Body Lotion,200,400,200,2,00070,India
251152,2024-02-17,1002,Mascara,200,400,200,1,00070,India
415520,2024-02-17,1009,Moisturizer,250,500,250,2,00469,India
915749,2024-02-17,1006,Blush,150,300,150,1,00345,India
915749,2024-02-17,1001,Lipstick,150,300,150,1,00345,India
915749,2024-02-17,1007,Eyeshadow,200,400,200,1,00345,India
915749,2024-02-17,1002,Mascara,200,400,200,1,00345,India
732880,2024-02-17,1004,Eyeliner,100,200,100,1,00074,India
732880,2024-02-17,1009,Moisturizer,250,500,250,2,00074,India
469947,2024-02-18,1009,Moisturizer,250,500,250,2,00135,India
469947,2024-02-18,1002,Mascara,200,400,200,1,00135,India
469947,2024-02-18,1001,Lipstick,150,300,150,1,00135,India
469947,2024-02-18,1005,Nail Polish,50,100,50,1,00135,India
483695,2024-02-18,1009,Moisturizer,250,500,250,2,00037,India
483695,2024-02-18,1008,Makeup Remover,80,160,80,1,00037,India
244863,2024-02-18,1012,Body Lotion,200,400,200,2,00209,India
244863,2024-02-18,1003,Foundation,300,600,300,1,00209,India
244863,2024-02-18,1001,Lipstick,150,300,150,1,00209,India
713971,2024-02-18,1012,Body Lotion,200,400,200,2,00089,India
713971,2024-02-18,1005,Nail Polish,50,100,50,1,00089,India
713971,2024-02-18,1006,Blush,150,300,150,1,00089,India
633289,2024-02-18,1012,Body Lotion,200,400,200,2,00081,India
633289,2024-02-18,1002,Mascara,200,400,200,1,00081,India
633289,2024-02-18,1004,Eyeliner,100,200,100,1,00081,India
633289,2024-02-18,1006,Blush,150,300,150,1,00081,India
633289,2024-02-18,1007,Eyeshadow,200,400,200,1,00081,India
304445,2024-02-18,1009,Moisturizer,250,500,250,2,00491,India
304445,2024-02-18,1002,Mascara,200,400,200,1,00491,India
304445,2024-02-18,1012,Body Lotion,200,400,200,2,00491,India
377774,2024-02-18,1006,Blush,150,300,150,1,00442,India
377774,2024-02-18,1009,Moisturizer,250,500,250,2,00442,India
377774,2024-02-18,1012,Body Lotion,200,400,200,2,00442,India
377774,2024-02-18,1003,Foundation,300,600,300,1,00442,India
377774,2024-02-18,1002,Mascara,200,400,200,1,00442,India
253929,2024-02-18,1004,Eyeliner,100,200,100,1,00297,India
253929,2024-02-18,1008,Makeup Remover,80,160,80,1,00297,India
253929,2024-02-18,1005,Nail Polish,50,100,50,1,00297,India
253929,2024-02-18,1012,Body Lotion,200,400,200,2,00297,India
253929,2024-02-18,1006,Blush,150,300,150,1,00297,India
934379,2024-02-18,1001,Lipstick,150,300,150,1,00326,India
934379,2024-02-18,1008,Makeup Remover,80,160,80,1,00326,India
934379,2024-02-18,1006,Blush,150,300,150,1,00326,India
528233,2024-02-18,1008,Makeup Remover,80,160,80,1,00114,India
528233,2024-02-18,1002,Mascara,200,400,200,1,00114,India
351877,2024-02-18,1003,Foundation,300,600,300,1,00172,India
351877,2024-02-18,1012,Body Lotion,200,400,200,2,00172,India
351877,2024-02-18,1008,Makeup Remover,80,160,80,1,00172,India
123444,2024-02-18,1004,Eyeliner,100,200,100,1,00467,India
123444,2024-02-18,1007,Eyeshadow,200,400,200,1,00467,India
686541,2024-02-18,1005,Nail Polish,50,100,50,1,00399,India
686541,2024-02-18,1007,Eyeshadow,200,400,200,1,00399,India
947198,2024-02-18,1003,Foundation,300,600,300,1,00049,India
947198,2024-02-18,1002,Mascara,200,400,200,1,00049,India
947198,2024-02-18,1001,Lipstick,150,300,150,1,00049,India
947198,2024-02-18,1007,Eyeshadow,200,400,200,1,00049,India
939124,2024-02-18,1007,Eyeshadow,200,400,200,1,00282,India
715848,2024-02-18,1009,Moisturizer,250,500,250,2,00313,India
715848,2024-02-18,1003,Foundation,300,600,300,1,00313,India
292701,2024-02-18,1004,Eyeliner,100,200,100,1,00208,India
969225,2024-02-18,1004,Eyeliner,100,200,100,1,00157,India
969225,2024-02-18,1007,Eyeshadow,200,400,200,1,00157,India
969225,2024-02-18,1008,Makeup Remover,80,160,80,1,00157,India
345630,2024-02-18,1001,Lipstick,150,300,150,1,00494,India
345630,2024-02-18,1007,Eyeshadow,200,400,200,1,00494,India
345630,2024-02-18,1005,Nail Polish,50,100,50,1,00494,India
345630,2024-02-18,1004,Eyeliner,100,200,100,1,00494,India
338270,2024-02-18,1006,Blush,150,300,150,1,00408,India
338270,2024-02-18,1005,Nail Polish,50,100,50,1,00408,India
941113,2024-02-18,1005,Nail Polish,50,100,50,1,00323,India
941113,2024-02-18,1002,Mascara,200,400,200,1,00323,India
757764,2024-02-18,1006,Blush,150,300,150,1,00199,India
757764,2024-02-18,1008,Makeup Remover,80,160,80,1,00199,India
757764,2024-02-18,1003,Foundation,300,600,300,1,00199,India
757764,2024-02-18,1007,Eyeshadow,200,400,200,1,00199,India
146247,2024-02-18,1005,Nail Polish,50,100,50,1,00144,India
136682,2024-02-18,1003,Foundation,300,600,300,1,00393,India
136682,2024-02-18,1012,Body Lotion,200,400,200,2,00393,India
136682,2024-02-18,1006,Blush,150,300,150,1,00393,India
253520,2024-02-18,1008,Makeup Remover,80,160,80,1,00251,India
253520,2024-02-18,1004,Eyeliner,100,200,100,1,00251,India
822926,2024-02-18,1002,Mascara,200,400,200,1,00126,India
822926,2024-02-18,1009,Moisturizer,250,500,250,2,00126,India
822926,2024-02-18,1008,Makeup Remover,80,160,80,1,00126,India
241162,2024-02-18,1004,Eyeliner,100,200,100,1,00316,India
241162,2024-02-18,1008,Makeup Remover,80,160,80,1,00316,India
241162,2024-02-18,1002,Mascara,200,400,200,1,00316,India
241162,2024-02-18,1006,Blush,150,300,150,1,00316,India
241162,2024-02-18,1009,Moisturizer,250,500,250,2,00316,India
872051,2024-02-18,1005,Nail Polish,50,100,50,1,00220,India
872051,2024-02-18,1002,Mascara,200,400,200,1,00220,India
872051,2024-02-18,1004,Eyeliner,100,200,100,1,00220,India
872051,2024-02-18,1003,Foundation,300,600,300,1,00220,India
872051,2024-02-18,1007,Eyeshadow,200,400,200,1,00220,India
830771,2024-02-18,1006,Blush,150,300,150,1,00124,India
830771,2024-02-18,1012,Body Lotion,200,400,200,2,00124,India
169682,2024-02-18,1001,Lipstick,150,300,150,1,00137,India
169682,2024-02-18,1004,Eyeliner,100,200,100,1,00137,India
169682,2024-02-18,1006,Blush,150,300,150,1,00137,India
105015,2024-02-18,1009,Moisturizer,250,500,250,2,00281,India
105015,2024-02-18,1008,Makeup Remover,80,160,80,1,00281,India
105015,2024-02-18,1006,Blush,150,300,150,1,00281,India
105015,2024-02-18,1004,Eyeliner,100,200,100,1,00281,India
334328,2024-02-18,1012,Body Lotion,200,400,200,2,00349,India
334328,2024-02-18,1007,Eyeshadow,200,400,200,1,00349,India
334328,2024-02-18,1003,Foundation,300,600,300,1,00349,India
334328,2024-02-18,1001,Lipstick,150,300,150,1,00349,India
458735,2024-02-18,1006,Blush,150,300,150,1,00398,India
730693,2024-02-18,1004,Eyeliner,100,200,100,1,00162,India
730693,2024-02-18,1012,Body Lotion,200,400,200,2,00162,India
730693,2024-02-18,1008,Makeup Remover,80,160,80,1,00162,India
366191,2024-02-18,1003,Foundation,300,600,300,1,00282,India
366191,2024-02-18,1007,Eyeshadow,200,400,200,1,00282,India
622749,2024-02-18,1008,Makeup Remover,80,160,80,1,00247,India
622749,2024-02-18,1005,Nail Polish,50,100,50,1,00247,India
573244,2024-02-18,1009,Moisturizer,250,500,250,2,00456,India
573244,2024-02-18,1001,Lipstick,150,300,150,1,00456,India
607007,2024-02-18,1009,Moisturizer,250,500,250,2,00119,India
607007,2024-02-18,1001,Lipstick,150,300,150,1,00119,India
607007,2024-02-18,1008,Makeup Remover,80,160,80,1,00119,India
917609,2024-02-18,1012,Body Lotion,200,400,200,2,00074,India
917609,2024-02-18,1002,Mascara,200,400,200,1,00074,India
217095,2024-02-18,1006,Blush,150,300,150,1,00021,India
940085,2024-02-18,1004,Eyeliner,100,200,100,1,00411,India
940085,2024-02-18,1005,Nail Polish,50,100,50,1,00411,India
940085,2024-02-18,1009,Moisturizer,250,500,250,2,00411,India
940085,2024-02-18,1001,Lipstick,150,300,150,1,00411,India
644178,2024-02-18,1005,Nail Polish,50,100,50,1,00120,India
644178,2024-02-18,1003,Foundation,300,600,300,1,00120,India
343951,2024-02-18,1009,Moisturizer,250,500,250,2,00499,India
216646,2024-02-19,1004,Eyeliner,100,200,100,1,00196,India
216646,2024-02-19,1009,Moisturizer,250,500,250,2,00196,India
216646,2024-02-19,1008,Makeup Remover,80,160,80,1,00196,India
437451,2024-02-19,1002,Mascara,200,400,200,1,00248,India
245231,2024-02-19,1002,Mascara,200,400,200,1,00313,India
245231,2024-02-19,1004,Eyeliner,100,200,100,1,00313,India
226047,2024-02-19,1008,Makeup Remover,80,160,80,1,00396,India
226047,2024-02-19,1007,Eyeshadow,200,400,200,1,00396,India
226047,2024-02-19,1004,Eyeliner,100,200,100,1,00396,India
226047,2024-02-19,1002,Mascara,200,400,200,1,00396,India
895264,2024-02-19,1012,Body Lotion,200,400,200,2,00039,India
462343,2024-02-19,1008,Makeup Remover,80,160,80,1,00445,India
462343,2024-02-19,1009,Moisturizer,250,500,250,2,00445,India
462343,2024-02-19,1005,Nail Polish,50,100,50,1,00445,India
462343,2024-02-19,1001,Lipstick,150,300,150,1,00445,India
462343,2024-02-19,1004,Eyeliner,100,200,100,1,00445,India
833667,2024-02-19,1005,Nail Polish,50,100,50,1,00087,India
780173,2024-02-19,1012,Body Lotion,200,400,200,2,00130,India
780173,2024-02-19,1004,Eyeliner,100,200,100,1,00130,India
780173,2024-02-19,1007,Eyeshadow,200,400,200,1,00130,India
780173,2024-02-19,1003,Foundation,300,600,300,1,00130,India
892916,2024-02-19,1012,Body Lotion,200,400,200,2,00131,India
892916,2024-02-19,1008,Makeup Remover,80,160,80,1,00131,India
892916,2024-02-19,1009,Moisturizer,250,500,250,2,00131,India
892916,2024-02-19,1002,Mascara,200,400,200,1,00131,India
892916,2024-02-19,1006,Blush,150,300,150,1,00131,India
173344,2024-02-19,1003,Foundation,300,600,300,1,00186,India
173344,2024-02-19,1007,Eyeshadow,200,400,200,1,00186,India
173344,2024-02-19,1008,Makeup Remover,80,160,80,1,00186,India
173344,2024-02-19,1009,Moisturizer,250,500,250,2,00186,India
754428,2024-02-19,1012,Body Lotion,200,400,200,2,00051,India
754428,2024-02-19,1001,Lipstick,150,300,150,1,00051,India
394153,2024-02-19,1006,Blush,150,300,150,1,00157,India
394153,2024-02-19,1012,Body Lotion,200,400,200,2,00157,India
394153,2024-02-19,1007,Eyeshadow,200,400,200,1,00157,India
394153,2024-02-19,1002,Mascara,200,400,200,1,00157,India
394153,2024-02-19,1003,Foundation,300,600,300,1,00157,India
499735,2024-02-19,1001,Lipstick,150,300,150,1,00126,India
499735,2024-02-19,1002,Mascara,200,400,200,1,00126,India
967339,2024-02-19,1007,Eyeshadow,200,400,200,1,00078,India
967339,2024-02-19,1001,Lipstick,150,300,150,1,00078,India
967339,2024-02-19,1012,Body Lotion,200,400,200,2,00078,India
967339,2024-02-19,1004,Eyeliner,100,200,100,1,00078,India
166991,2024-02-19,1006,Blush,150,300,150,1,00201,India
166991,2024-02-19,1008,Makeup Remover,80,160,80,1,00201,India
167427,2024-02-19,1008,Makeup Remover,80,160,80,1,00104,India
167427,2024-02-19,1003,Foundation,300,600,300,1,00104,India
167427,2024-02-19,1001,Lipstick,150,300,150,1,00104,India
182654,2024-02-19,1001,Lipstick,150,300,150,1,00214,India
182654,2024-02-19,1008,Makeup Remover,80,160,80,1,00214,India
182654,2024-02-19,1006,Blush,150,300,150,1,00214,India
232554,2024-02-19,1003,Foundation,300,600,300,1,00099,India
176946,2024-02-19,1004,Eyeliner,100,200,100,1,00063,India
176946,2024-02-19,1005,Nail Polish,50,100,50,1,00063,India
176946,2024-02-19,1006,Blush,150,300,150,1,00063,India
176946,2024-02-19,1008,Makeup Remover,80,160,80,1,00063,India
197911,2024-02-19,1012,Body Lotion,200,400,200,2,00155,India
386440,2024-02-19,1002,Mascara,200,400,200,1,00197,India
386440,2024-02-19,1007,Eyeshadow,200,400,200,1,00197,India
386440,2024-02-19,1005,Nail Polish,50,100,50,1,00197,India
386440,2024-02-19,1003,Foundation,300,600,300,1,00197,India
495518,2024-02-19,1012,Body Lotion,200,400,200,2,00463,India
716454,2024-02-19,1005,Nail Polish,50,100,50,1,00288,India
716454,2024-02-19,1003,Foundation,300,600,300,1,00288,India
331687,2024-02-19,1007,Eyeshadow,200,400,200,1,00140,India
331687,2024-02-19,1002,Mascara,200,400,200,1,00140,India
331687,2024-02-19,1012,Body Lotion,200,400,200,2,00140,India
331687,2024-02-19,1008,Makeup Remover,80,160,80,1,00140,India
110076,2024-02-19,1002,Mascara,200,400,200,1,00405,India
110076,2024-02-19,1008,Makeup Remover,80,160,80,1,00405,India
110076,2024-02-19,1012,Body Lotion,200,400,200,2,00405,India
110076,2024-02-19,1006,Blush,150,300,150,1,00405,India
869780,2024-02-19,1006,Blush,150,300,150,1,00438,India
869780,2024-02-19,1005,Nail Polish,50,100,50,1,00438,India
869780,2024-02-19,1002,Mascara,200,400,200,1,00438,India
184525,2024-02-19,1005,Nail Polish,50,100,50,1,00044,India
462746,2024-02-19,1008,Makeup Remover,80,160,80,1,00339,India
652647,2024-02-19,1002,Mascara,200,400,200,1,00230,India
652647,2024-02-19,1006,Blush,150,300,150,1,00230,India
652647,2024-02-19,1007,Eyeshadow,200,400,200,1,00230,India
453878,2024-02-19,1007,Eyeshadow,200,400,200,1,00460,India
453878,2024-02-19,1004,Eyeliner,100,200,100,1,00460,India
324337,2024-02-19,1009,Moisturizer,250,500,250,2,00306,India
324337,2024-02-19,1008,Makeup Remover,80,160,80,1,00306,India
772623,2024-02-19,1012,Body Lotion,200,400,200,2,00137,India
945103,2024-02-19,1007,Eyeshadow,200,400,200,1,00451,India
945103,2024-02-19,1012,Body Lotion,200,400,200,2,00451,India
945103,2024-02-19,1001,Lipstick,150,300,150,1,00451,India
948154,2024-02-19,1009,Moisturizer,250,500,250,2,00487,India
948154,2024-02-19,1008,Makeup Remover,80,160,80,1,00487,India
948154,2024-02-19,1006,Blush,150,300,150,1,00487,India
948154,2024-02-19,1001,Lipstick,150,300,150,1,00487,India
948154,2024-02-19,1012,Body Lotion,200,400,200,2,00487,India
897431,2024-02-19,1007,Eyeshadow,200,400,200,1,00467,India
897431,2024-02-19,1004,Eyeliner,100,200,100,1,00467,India
897431,2024-02-19,1008,Makeup Remover,80,160,80,1,00467,India
601995,2024-02-19,1002,Mascara,200,400,200,1,00253,India
601995,2024-02-19,1005,Nail Polish,50,100,50,1,00253,India
583698,2024-02-19,1008,Makeup Remover,80,160,80,1,00415,India
181781,2024-02-19,1005,Nail Polish,50,100,50,1,00086,India
110206,2024-02-19,1012,Body Lotion,200,400,200,2,00498,India
110206,2024-02-19,1006,Blush,150,300,150,1,00498,India
110206,2024-02-19,1004,Eyeliner,100,200,100,1,00498,India
110206,2024-02-19,1008,Makeup Remover,80,160,80,1,00498,India
772321,2024-02-19,1007,Eyeshadow,200,400,200,1,00001,India
772321,2024-02-19,1001,Lipstick,150,300,150,1,00001,India
772321,2024-02-19,1005,Nail Polish,50,100,50,1,00001,India
955104,2024-02-19,1001,Lipstick,150,300,150,1,00168,India
123551,2024-02-19,1009,Moisturizer,250,500,250,2,00420,India
123551,2024-02-19,1003,Foundation,300,600,300,1,00420,India
681925,2024-02-19,1005,Nail Polish,50,100,50,1,00335,India
681925,2024-02-19,1012,Body Lotion,200,400,200,2,00335,India
681925,2024-02-19,1001,Lipstick,150,300,150,1,00335,India
681925,2024-02-19,1004,Eyeliner,100,200,100,1,00335,India
681925,2024-02-19,1003,Foundation,300,600,300,1,00335,India
177108,2024-02-19,1008,Makeup Remover,80,160,80,1,00449,India
177108,2024-02-19,1012,Body Lotion,200,400,200,2,00449,India
177108,2024-02-19,1007,Eyeshadow,200,400,200,1,00449,India
973607,2024-02-19,1006,Blush,150,300,150,1,00348,India
973607,2024-02-19,1009,Moisturizer,250,500,250,2,00348,India
973607,2024-02-19,1003,Foundation,300,600,300,1,00348,India
973607,2024-02-19,1012,Body Lotion,200,400,200,2,00348,India
359702,2024-02-19,1009,Moisturizer,250,500,250,2,00460,India
359702,2024-02-19,1006,Blush,150,300,150,1,00460,India
359702,2024-02-19,1005,Nail Polish,50,100,50,1,00460,India
359702,2024-02-19,1004,Eyeliner,100,200,100,1,00460,India
318405,2024-02-19,1009,Moisturizer,250,500,250,2,00352,India
318405,2024-02-19,1003,Foundation,300,600,300,1,00352,India
138377,2024-02-20,1004,Eyeliner,100,200,100,1,00313,India
138377,2024-02-20,1008,Makeup Remover,80,160,80,1,00313,India
981985,2024-02-20,1003,Foundation,300,600,300,1,00431,India
981985,2024-02-20,1002,Mascara,200,400,200,1,00431,India
627282,2024-02-20,1002,Mascara,200,400,200,1,00112,India
842258,2024-02-20,1006,Blush,150,300,150,1,00209,India
842258,2024-02-20,1003,Foundation,300,600,300,1,00209,India
386520,2024-02-20,1004,Eyeliner,100,200,100,1,00319,India
386520,2024-02-20,1006,Blush,150,300,150,1,00319,India
386520,2024-02-20,1003,Foundation,300,600,300,1,00319,India
653257,2024-02-20,1001,Lipstick,150,300,150,1,00024,India
653257,2024-02-20,1002,Mascara,200,400,200,1,00024,India
653257,2024-02-20,1009,Moisturizer,250,500,250,2,00024,India
653257,2024-02-20,1006,Blush,150,300,150,1,00024,India
107580,2024-02-20,1003,Foundation,300,600,300,1,00345,India
107580,2024-02-20,1007,Eyeshadow,200,400,200,1,00345,India
107580,2024-02-20,1004,Eyeliner,100,200,100,1,00345,India
107580,2024-02-20,1012,Body Lotion,200,400,200,2,00345,India
501596,2024-02-20,1006,Blush,150,300,150,1,00087,India
790827,2024-02-20,1003,Foundation,300,600,300,1,00145,India
249351,2024-02-20,1005,Nail Polish,50,100,50,1,00289,India
249351,2024-02-20,1012,Body Lotion,200,400,200,2,00289,India
767170,2024-02-20,1004,Eyeliner,100,200,100,1,00044,India
767170,2024-02-20,1003,Foundation,300,600,300,1,00044,India
767170,2024-02-20,1001,Lipstick,150,300,150,1,00044,India
767170,2024-02-20,1006,Blush,150,300,150,1,00044,India
246681,2024-02-20,1005,Nail Polish,50,100,50,1,00128,India
246681,2024-02-20,1003,Foundation,300,600,300,1,00128,India
246681,2024-02-20,1004,Eyeliner,100,200,100,1,00128,India
246681,2024-02-20,1008,Makeup Remover,80,160,80,1,00128,India
950041,2024-02-20,1003,Foundation,300,600,300,1,00498,India
486940,2024-02-20,1008,Makeup Remover,80,160,80,1,00200,India
486940,2024-02-20,1009,Moisturizer,250,500,250,2,00200,India
313146,2024-02-20,1006,Blush,150,300,150,1,00164,India
374368,2024-02-20,1003,Foundation,300,600,300,1,00200,India
838348,2024-02-20,1002,Mascara,200,400,200,1,00183,India
838348,2024-02-20,1006,Blush,150,300,150,1,00183,India
637461,2024-02-20,1008,Makeup Remover,80,160,80,1,00296,India
637461,2024-02-20,1001,Lipstick,150,300,150,1,00296,India
637461,2024-02-20,1012,Body Lotion,200,400,200,2,00296,India
637461,2024-02-20,1007,Eyeshadow,200,400,200,1,00296,India
807548,2024-02-20,1003,Foundation,300,600,300,1,00258,India
711660,2024-02-20,1001,Lipstick,150,300,150,1,00290,India
711660,2024-02-20,1009,Moisturizer,250,500,250,2,00290,India
417274,2024-02-20,1008,Makeup Remover,80,160,80,1,00327,India
417274,2024-02-20,1012,Body Lotion,200,400,200,2,00327,India
417274,2024-02-20,1003,Foundation,300,600,300,1,00327,India
810525,2024-02-20,1009,Moisturizer,250,500,250,2,00353,India
810525,2024-02-20,1002,Mascara,200,400,200,1,00353,India
594621,2024-02-20,1001,Lipstick,150,300,150,1,00148,India
594621,2024-02-20,1009,Moisturizer,250,500,250,2,00148,India
449441,2024-02-20,1005,Nail Polish,50,100,50,1,00378,India
449441,2024-02-20,1008,Makeup Remover,80,160,80,1,00378,India
957484,2024-02-20,1007,Eyeshadow,200,400,200,1,00097,India
957484,2024-02-20,1003,Foundation,300,600,300,1,00097,India
854236,2024-02-20,1009,Moisturizer,250,500,250,2,00159,India
854236,2024-02-20,1004,Eyeliner,100,200,100,1,00159,India
854236,2024-02-20,1005,Nail Polish,50,100,50,1,00159,India
854236,2024-02-20,1007,Eyeshadow,200,400,200,1,00159,India
854236,2024-02-20,1001,Lipstick,150,300,150,1,00159,India
881893,2024-02-20,1003,Foundation,300,600,300,1,00190,India
381083,2024-02-20,1002,Mascara,200,400,200,1,00071,India
381083,2024-02-20,1009,Moisturizer,250,500,250,2,00071,India
381083,2024-02-20,1001,Lipstick,150,300,150,1,00071,India
997970,2024-02-20,1003,Foundation,300,600,300,1,00355,India
997970,2024-02-20,1005,Nail Polish,50,100,50,1,00355,India
997970,2024-02-20,1001,Lipstick,150,300,150,1,00355,India
997970,2024-02-20,1002,Mascara,200,400,200,1,00355,India
997970,2024-02-20,1008,Makeup Remover,80,160,80,1,00355,India
564282,2024-02-20,1005,Nail Polish,50,100,50,1,00122,India
564282,2024-02-20,1003,Foundation,300,600,300,1,00122,India
564282,2024-02-20,1012,Body Lotion,200,400,200,2,00122,India
118328,2024-02-20,1008,Makeup Remover,80,160,80,1,00424,India
118328,2024-02-20,1005,Nail Polish,50,100,50,1,00424,India
841645,2024-02-20,1003,Foundation,300,600,300,1,00374,India
841645,2024-02-20,1001,Lipstick,150,300,150,1,00374,India
