InvoiceNo,InvoiceDate,StockCode,Description,Cost_Price,UnitPrice,Profit,Quantity,CustomerID,Country
192562,2023-02-20,506,monitor,3249,8000,4751,1,00001,India
192562,2023-02-20,503,mixer,1349,3249,1900,1,00001,India
192562,2023-02-20,507,washing machine,6990,16490,9500,1,00001,India
945551,2023-02-20,507,washing machine,6990,16490,9500,1,00002,India
945551,2023-02-20,501,iphone 15,60000,80000,20000,1,00002,India
945551,2023-02-20,505,oven,18490,24000,5510,1,00002,India
640937,2023-02-20,503,mixer,1349,3249,1900,1,00003,India
640937,2023-02-20,501,iphone 15,60000,80000,20000,1,00003,India
640937,2023-02-20,505,oven,18490,24000,5510,1,00003,India
387168,2023-02-20,505,oven,18490,24000,5510,1,00004,India
387168,2023-02-20,504,iron,449,879,430,1,00004,India
387168,2023-02-20,501,iphone 15,60000,80000,20000,1,00004,India
820195,2023-02-20,501,iphone 15,60000,80000,20000,1,00005,India
820195,2023-02-20,507,washing machine,6990,16490,9500,1,00005,India
820195,2023-02-20,504,iron,449,879,430,1,00005,India
596665,2023-02-20,505,oven,18490,24000,5510,1,00006,India
718791,2023-02-20,502,iphone 15 pro max,100000,135000,35000,1,00007,India
829399,2023-02-20,503,mixer,1349,3249,1900,1,00008,India
160371,2023-02-20,502,iphone 15 pro max,100000,135000,35000,1,00009,India
160371,2023-02-20,507,washing machine,6990,16490,9500,1,00009,India
160371,2023-02-20,503,mixer,1349,3249,1900,1,00009,India
900512,2023-02-20,501,iphone 15,60000,80000,20000,1,00010,India
900512,2023-02-20,502,iphone 15 pro max,100000,135000,35000,1,00010,India
900512,2023-02-20,503,mixer,1349,3249,1900,1,00010,India
243467,2023-02-20,504,iron,449,879,430,1,00011,India
243467,2023-02-20,507,washing machine,6990,16490,9500,1,00011,India
243467,2023-02-20,501,iphone 15,60000,80000,20000,1,00011,India
456366,2023-02-20,505,oven,18490,24000,5510,1,00012,India
456366,2023-02-20,501,iphone 15,60000,80000,20000,1,00012,India
456366,2023-02-20,503,mixer,1349,3249,1900,1,00012,India
456366,2023-02-20,507,washing machine,6990,16490,9500,1,00012,India
607468,2023-02-20,505,oven,18490,24000,5510,1,00013,India
607468,2023-02-20,504,iron,449,879,430,1,00013,India
607468,2023-02-20,502,iphone 15 pro max,100000,135000,35000,1,00013,India
444209,2023-02-20,506,monitor,3249,8000,4751,1,00014,India
444209,2023-02-20,507,washing machine,6990,16490,9500,1,00014,India
444209,2023-02-20,504,iron,449,879,430,1,00014,India
444209,2023-02-20,501,iphone 15,60000,80000,20000,1,00014,India
244652,2023-02-20,502,iphone 15 pro max,100000,135000,35000,1,00015,India
244652,2023-02-20,505,oven,18490,24000,5510,1,00015,India
758854,2023-02-20,507,washing machine,6990,16490,9500,1,00016,India
321976,2023-02-20,503,mixer,1349,3249,1900,1,00017,India
321976,2023-02-20,507,washing machine,6990,16490,9500,1,00017,India
464401,2023-02-20,503,mixer,1349,3249,1900,1,00018,India
464401,2023-02-20,506,monitor,3249,8000,4751,1,00018,India
481943,2023-02-20,506,monitor,3249,8000,4751,1,00019,India
481943,2023-02-20,501,iphone 15,60000,80000,20000,1,00019,India
355406,2023-02-20,502,iphone 15 pro max,100000,135000,35000,1,00020,India
674087,2023-02-20,507,washing machine,6990,16490,9500,1,00021,India
674087,2023-02-20,506,monitor,3249,8000,4751,1,00021,India
674087,2023-02-20,502,iphone 15 pro max,100000,135000,35000,1,00021,India
674087,2023-02-20,505,oven,18490,24000,5510,1,00021,India
200933,2023-02-20,501,iphone 15,60000,80000,20000,1,00022,India
200933,2023-02-20,504,iron,449,879,430,1,00022,India
200933,2023-02-20,506,monitor,3249,8000,4751,1,00022,India
218421,2023-02-20,506,monitor,3249,8000,4751,1,00023,India
218421,2023-02-20,505,oven,18490,24000,5510,1,00023,India
218421,2023-02-20,504,iron,449,879,430,1,00023,India
588635,2023-02-20,505,oven,18490,24000,5510,1,00024,India
588635,2023-02-20,501,iphone 15,60000,80000,20000,1,00024,India
588635,2023-02-20,507,washing machine,6990,16490,9500,1,00024,India
895098,2023-02-20,501,iphone 15,60000,80000,20000,1,00025,India
115682,2023-02-20,503,mixer,1349,3249,1900,1,00026,India
115682,2023-02-20,502,iphone 15 pro max,100000,135000,35000,1,00026,India
115682,2023-02-20,505,oven,18490,24000,5510,1,00026,India
115682,2023-02-20,507,washing machine,6990,16490,9500,1,00026,India
115682,2023-02-20,506,monitor,3249,8000,4751,1,00026,India
345075,2023-02-20,503,mixer,1349,3249,1900,1,00027,India
345075,2023-02-20,501,iphone 15,60000,80000,20000,1,00027,India
345075,2023-02-20,506,monitor,3249,8000,4751,1,00027,India
887193,2023-02-20,507,washing machine,6990,16490,9500,1,00028,India
887193,2023-02-20,501,iphone 15,60000,80000,20000,1,00028,India
887193,2023-02-20,502,iphone 15 pro max,100000,135000,35000,1,00028,India
483751,2023-02-20,505,oven,18490,24000,5510,1,00029,India
483751,2023-02-20,501,iphone 15,60000,80000,20000,1,00029,India
483751,2023-02-20,504,iron,449,879,430,1,00029,India
483751,2023-02-20,503,mixer,1349,3249,1900,1,00029,India
895499,2023-02-20,504,iron,449,879,430,1,00030,India
895499,2023-02-20,506,monitor,3249,8000,4751,1,00030,India
772911,2023-02-20,506,monitor,3249,8000,4751,1,00031,India
772911,2023-02-20,507,washing machine,6990,16490,9500,1,00031,India
772911,2023-02-20,503,mixer,1349,3249,1900,1,00031,India
814765,2023-02-20,501,iphone 15,60000,80000,20000,1,00032,India
814765,2023-02-20,505,oven,18490,24000,5510,1,00032,India
814765,2023-02-20,507,washing machine,6990,16490,9500,1,00032,India
550686,2023-02-20,501,iphone 15,60000,80000,20000,1,00033,India
550686,2023-02-20,503,mixer,1349,3249,1900,1,00033,India
694685,2023-02-20,502,iphone 15 pro max,100000,135000,35000,1,00034,India
694685,2023-02-20,501,iphone 15,60000,80000,20000,1,00034,India
694685,2023-02-20,507,washing machine,6990,16490,9500,1,00034,India
694685,2023-02-20,503,mixer,1349,3249,1900,1,00034,India
694685,2023-02-20,504,iron,449,879,430,1,00034,India
845528,2023-02-20,504,iron,449,879,430,1,00035,India
845528,2023-02-20,501,iphone 15,60000,80000,20000,1,00035,India
845528,2023-02-20,502,iphone 15 pro max,100000,135000,35000,1,00035,India
845528,2023-02-20,506,monitor,3249,8000,4751,1,00035,India
177734,2023-02-20,505,oven,18490,24000,5510,1,00036,India
177734,2023-02-20,503,mixer,1349,3249,1900,1,00036,India
177734,2023-02-20,506,monitor,3249,8000,4751,1,00036,India
177734,2023-02-20,501,iphone 15,60000,80000,20000,1,00036,India
946009,2023-02-20,501,iphone 15,60000,80000,20000,1,00037,India
946009,2023-02-20,506,monitor,3249,8000,4751,1,00037,India
946009,2023-02-20,505,oven,18490,24000,5510,1,00037,India
946009,2023-02-20,503,mixer,1349,3249,1900,1,00037,India
125394,2023-02-20,507,washing machine,6990,16490,9500,1,00038,India
125394,2023-02-20,505,oven,18490,24000,5510,1,00038,India
877621,2023-02-20,503,mixer,1349,3249,1900,1,00039,India
317498,2023-02-20,502,iphone 15 pro max,100000,135000,35000,1,00040,India
317498,2023-02-20,504,iron,449,879,430,1,00040,India
317498,2023-02-20,507,washing machine,6990,16490,9500,1,00040,India
317498,2023-02-20,505,oven,18490,24000,5510,1,00040,India
870175,2023-02-20,506,monitor,3249,8000,4751,1,00041,India
870175,2023-02-20,503,mixer,1349,3249,1900,1,00041,India
870175,2023-02-20,504,iron,449,879,430,1,00041,India
312331,2023-02-20,502,iphone 15 pro max,100000,135000,35000,1,00042,India
312331,2023-02-20,504,iron,449,879,430,1,00042,India
476623,2023-02-20,504,iron,449,879,430,1,00043,India
476623,2023-02-20,503,mixer,1349,3249,1900,1,00043,India
608533,2023-02-20,501,iphone 15,60000,80000,20000,1,00044,India
608533,2023-02-20,502,iphone 15 pro max,100000,135000,35000,1,00044,India
608533,2023-02-20,503,mixer,1349,3249,1900,1,00044,India
722575,2023-02-20,504,iron,449,879,430,1,00045,India
887523,2023-02-20,505,oven,18490,24000,5510,1,00046,India
887523,2023-02-20,506,monitor,3249,8000,4751,1,00046,India
887523,2023-02-20,502,iphone 15 pro max,100000,135000,35000,1,00046,India
245112,2023-02-20,502,iphone 15 pro max,100000,135000,35000,1,00047,India
245112,2023-02-20,506,monitor,3249,8000,4751,1,00047,India
779130,2023-02-20,503,mixer,1349,3249,1900,1,00048,India
779130,2023-02-20,506,monitor,3249,8000,4751,1,00048,India
317926,2023-02-20,503,mixer,1349,3249,1900,1,00049,India
317926,2023-02-20,501,iphone 15,60000,80000,20000,1,00049,India
994738,2023-02-20,506,monitor,3249,8000,4751,1,00050,India
107890,2023-02-20,504,iron,449,879,430,1,00051,India
107890,2023-02-20,505,oven,18490,24000,5510,1,00051,India
763690,2023-02-20,506,monitor,3249,8000,4751,1,00052,India
763690,2023-02-20,503,mixer,1349,3249,1900,1,00052,India
141894,2023-02-20,507,washing machine,6990,16490,9500,1,00053,India
481246,2023-02-20,506,monitor,3249,8000,4751,1,00054,India
481246,2023-02-20,502,iphone 15 pro max,100000,135000,35000,1,00054,India
436036,2023-02-20,506,monitor,3249,8000,4751,1,00055,India
436036,2023-02-20,503,mixer,1349,3249,1900,1,00055,India
294697,2023-02-20,504,iron,449,879,430,1,00056,India
589106,2023-02-20,502,iphone 15 pro max,100000,135000,35000,1,00057,India
589106,2023-02-20,505,oven,18490,24000,5510,1,00057,India
589106,2023-02-20,507,washing machine,6990,16490,9500,1,00057,India
589106,2023-02-20,501,iphone 15,60000,80000,20000,1,00057,India
589106,2023-02-20,506,monitor,3249,8000,4751,1,00057,India
876579,2023-02-20,501,iphone 15,60000,80000,20000,1,00058,India
876579,2023-02-20,502,iphone 15 pro max,100000,135000,35000,1,00058,India
215474,2023-02-20,505,oven,18490,24000,5510,1,00059,India
310904,2023-02-20,505,oven,18490,24000,5510,1,00060,India
310904,2023-02-20,504,iron,449,879,430,1,00060,India
310904,2023-02-20,502,iphone 15 pro max,100000,135000,35000,1,00060,India
310904,2023-02-20,506,monitor,3249,8000,4751,1,00060,India
218551,2023-02-20,507,washing machine,6990,16490,9500,1,00061,India
460130,2023-02-20,501,iphone 15,60000,80000,20000,1,00062,India
460130,2023-02-20,506,monitor,3249,8000,4751,1,00062,India
394899,2023-02-20,503,mixer,1349,3249,1900,1,00063,India
394899,2023-02-20,504,iron,449,879,430,1,00063,India
394899,2023-02-20,506,monitor,3249,8000,4751,1,00063,India
696725,2023-02-20,507,washing machine,6990,16490,9500,1,00064,India
696725,2023-02-20,501,iphone 15,60000,80000,20000,1,00064,India
154863,2023-02-21,504,iron,449,879,430,1,00065,India
154863,2023-02-21,506,monitor,3249,8000,4751,1,00065,India
154863,2023-02-21,507,washing machine,6990,16490,9500,1,00065,India
216744,2023-02-21,504,iron,449,879,430,1,00066,India
216744,2023-02-21,502,iphone 15 pro max,100000,135000,35000,1,00066,India
216744,2023-02-21,503,mixer,1349,3249,1900,1,00066,India
337410,2023-02-21,507,washing machine,6990,16490,9500,1,00067,India
927721,2023-02-21,502,iphone 15 pro max,100000,135000,35000,1,00068,India
764778,2023-02-21,503,mixer,1349,3249,1900,1,00069,India
764778,2023-02-21,504,iron,449,879,430,1,00069,India
764778,2023-02-21,502,iphone 15 pro max,100000,135000,35000,1,00069,India
444755,2023-02-21,505,oven,18490,24000,5510,1,00070,India
444755,2023-02-21,504,iron,449,879,430,1,00070,India
444755,2023-02-21,503,mixer,1349,3249,1900,1,00070,India
639259,2023-02-21,505,oven,18490,24000,5510,1,00071,India
639259,2023-02-21,502,iphone 15 pro max,100000,135000,35000,1,00071,India
573380,2023-02-21,505,oven,18490,24000,5510,1,00072,India
573380,2023-02-21,503,mixer,1349,3249,1900,1,00072,India
573380,2023-02-21,506,monitor,3249,8000,4751,1,00072,India
573380,2023-02-21,502,iphone 15 pro max,100000,135000,35000,1,00072,India
963725,2023-02-21,503,mixer,1349,3249,1900,1,00073,India
963725,2023-02-21,504,iron,449,879,430,1,00073,India
963725,2023-02-21,502,iphone 15 pro max,100000,135000,35000,1,00073,India
275329,2023-02-21,501,iphone 15,60000,80000,20000,1,00074,India
275329,2023-02-21,505,oven,18490,24000,5510,1,00074,India
325637,2023-02-21,505,oven,18490,24000,5510,1,00075,India
325637,2023-02-21,502,iphone 15 pro max,100000,135000,35000,1,00075,India
325637,2023-02-21,501,iphone 15,60000,80000,20000,1,00075,India
925237,2023-02-21,501,iphone 15,60000,80000,20000,1,00076,India
668245,2023-02-21,506,monitor,3249,8000,4751,1,00077,India
668245,2023-02-21,501,iphone 15,60000,80000,20000,1,00077,India
668245,2023-02-21,505,oven,18490,24000,5510,1,00077,India
668245,2023-02-21,502,iphone 15 pro max,100000,135000,35000,1,00077,India
373604,2023-02-21,506,monitor,3249,8000,4751,1,00078,India
373604,2023-02-21,505,oven,18490,24000,5510,1,00078,India
373604,2023-02-21,507,washing machine,6990,16490,9500,1,00078,India
373604,2023-02-21,504,iron,449,879,430,1,00078,India
373604,2023-02-21,502,iphone 15 pro max,100000,135000,35000,1,00078,India
360205,2023-02-21,504,iron,449,879,430,1,00079,India
360205,2023-02-21,505,oven,18490,24000,5510,1,00079,India
360205,2023-02-21,502,iphone 15 pro max,100000,135000,35000,1,00079,India
785741,2023-02-21,505,oven,18490,24000,5510,1,00080,India
785741,2023-02-21,501,iphone 15,60000,80000,20000,1,00080,India
785741,2023-02-21,502,iphone 15 pro max,100000,135000,35000,1,00080,India
785741,2023-02-21,507,washing machine,6990,16490,9500,1,00080,India
900295,2023-02-21,501,iphone 15,60000,80000,20000,1,00081,India
618103,2023-02-21,503,mixer,1349,3249,1900,1,00082,India
680586,2023-02-21,503,mixer,1349,3249,1900,1,00083,India
680586,2023-02-21,506,monitor,3249,8000,4751,1,00083,India
903312,2023-02-21,506,monitor,3249,8000,4751,1,00084,India
903312,2023-02-21,502,iphone 15 pro max,100000,135000,35000,1,00084,India
689601,2023-02-21,502,iphone 15 pro max,100000,135000,35000,1,00085,India
689601,2023-02-21,503,mixer,1349,3249,1900,1,00085,India
689601,2023-02-21,507,washing machine,6990,16490,9500,1,00085,India
689601,2023-02-21,504,iron,449,879,430,1,00085,India
855052,2023-02-21,504,iron,449,879,430,1,00086,India
929432,2023-02-21,504,iron,449,879,430,1,00087,India
929432,2023-02-21,502,iphone 15 pro max,100000,135000,35000,1,00087,India
929432,2023-02-21,503,mixer,1349,3249,1900,1,00087,India
342303,2023-02-21,504,iron,449,879,430,1,00088,India
342303,2023-02-21,505,oven,18490,24000,5510,1,00088,India
700153,2023-02-21,502,iphone 15 pro max,100000,135000,35000,1,00089,India
700153,2023-02-21,506,monitor,3249,8000,4751,1,00089,India
700153,2023-02-21,501,iphone 15,60000,80000,20000,1,00089,India
700153,2023-02-21,507,washing machine,6990,16490,9500,1,00089,India
857769,2023-02-21,506,monitor,3249,8000,4751,1,00090,India
756785,2023-02-21,502,iphone 15 pro max,100000,135000,35000,1,00091,India
756785,2023-02-21,501,iphone 15,60000,80000,20000,1,00091,India
756785,2023-02-21,504,iron,449,879,430,1,00091,India
756785,2023-02-21,507,washing machine,6990,16490,9500,1,00091,India
456385,2023-02-21,501,iphone 15,60000,80000,20000,1,00092,India
456385,2023-02-21,506,monitor,3249,8000,4751,1,00092,India
456385,2023-02-21,505,oven,18490,24000,5510,1,00092,India
633039,2023-02-21,507,washing machine,6990,16490,9500,1,00093,India
633039,2023-02-21,501,iphone 15,60000,80000,20000,1,00093,India
633039,2023-02-21,506,monitor,3249,8000,4751,1,00093,India
633039,2023-02-21,503,mixer,1349,3249,1900,1,00093,India
544664,2023-02-21,505,oven,18490,24000,5510,1,00094,India
544664,2023-02-21,504,iron,449,879,430,1,00094,India
544664,2023-02-21,506,monitor,3249,8000,4751,1,00094,India
544664,2023-02-21,507,washing machine,6990,16490,9500,1,00094,India
544664,2023-02-21,502,iphone 15 pro max,100000,135000,35000,1,00094,India
138400,2023-02-21,503,mixer,1349,3249,1900,1,00095,India
138400,2023-02-21,504,iron,449,879,430,1,00095,India
241799,2023-02-21,504,iron,449,879,430,1,00096,India
241799,2023-02-21,506,monitor,3249,8000,4751,1,00096,India
241799,2023-02-21,503,mixer,1349,3249,1900,1,00096,India
387846,2023-02-21,503,mixer,1349,3249,1900,1,00097,India
387846,2023-02-21,502,iphone 15 pro max,100000,135000,35000,1,00097,India
466825,2023-02-21,505,oven,18490,24000,5510,1,00098,India
466825,2023-02-21,506,monitor,3249,8000,4751,1,00098,India
466825,2023-02-21,504,iron,449,879,430,1,00098,India
466825,2023-02-21,501,iphone 15,60000,80000,20000,1,00098,India
204713,2023-02-21,507,washing machine,6990,16490,9500,1,00099,India
692691,2023-02-21,503,mixer,1349,3249,1900,1,00100,India
692691,2023-02-21,506,monitor,3249,8000,4751,1,00100,India
825040,2023-02-21,501,iphone 15,60000,80000,20000,1,00101,India
825040,2023-02-21,507,washing machine,6990,16490,9500,1,00101,India
825040,2023-02-21,502,iphone 15 pro max,100000,135000,35000,1,00101,India
825040,2023-02-21,505,oven,18490,24000,5510,1,00101,India
719795,2023-02-21,502,iphone 15 pro max,100000,135000,35000,1,00102,India
719795,2023-02-21,505,oven,18490,24000,5510,1,00102,India
719795,2023-02-21,507,washing machine,6990,16490,9500,1,00102,India
719795,2023-02-21,506,monitor,3249,8000,4751,1,00102,India
887935,2023-02-21,505,oven,18490,24000,5510,1,00103,India
887935,2023-02-21,506,monitor,3249,8000,4751,1,00103,India
737926,2023-02-21,505,oven,18490,24000,5510,1,00104,India
737926,2023-02-21,502,iphone 15 pro max,100000,135000,35000,1,00104,India
737926,2023-02-21,501,iphone 15,60000,80000,20000,1,00104,India
737926,2023-02-21,503,mixer,1349,3249,1900,1,00104,India
374540,2023-02-21,502,iphone 15 pro max,100000,135000,35000,1,00105,India
892557,2023-02-21,505,oven,18490,24000,5510,1,00106,India
892557,2023-02-21,501,iphone 15,60000,80000,20000,1,00106,India
298461,2023-02-21,506,monitor,3249,8000,4751,1,00107,India
298461,2023-02-21,505,oven,18490,24000,5510,1,00107,India
298461,2023-02-21,504,iron,449,879,430,1,00107,India
144565,2023-02-21,505,oven,18490,24000,5510,1,00108,India
710377,2023-02-21,507,washing machine,6990,16490,9500,1,00109,India
710377,2023-02-21,505,oven,18490,24000,5510,1,00109,India
710377,2023-02-21,504,iron,449,879,430,1,00109,India
152996,2023-02-21,504,iron,449,879,430,1,00110,India
580905,2023-02-21,502,iphone 15 pro max,100000,135000,35000,1,00111,India
580905,2023-02-21,504,iron,449,879,430,1,00111,India
580905,2023-02-21,503,mixer,1349,3249,1900,1,00111,India
580905,2023-02-21,506,monitor,3249,8000,4751,1,00111,India
580905,2023-02-21,501,iphone 15,60000,80000,20000,1,00111,India
651325,2023-02-21,503,mixer,1349,3249,1900,1,00112,India
651325,2023-02-21,504,iron,449,879,430,1,00112,India
651325,2023-02-21,505,oven,18490,24000,5510,1,00112,India
651325,2023-02-21,501,iphone 15,60000,80000,20000,1,00112,India
777738,2023-02-21,505,oven,18490,24000,5510,1,00113,India
777738,2023-02-21,501,iphone 15,60000,80000,20000,1,00113,India
777738,2023-02-21,503,mixer,1349,3249,1900,1,00113,India
653841,2023-02-21,501,iphone 15,60000,80000,20000,1,00114,India
653841,2023-02-21,502,iphone 15 pro max,100000,135000,35000,1,00114,India
653841,2023-02-21,507,washing machine,6990,16490,9500,1,00114,India
653841,2023-02-21,505,oven,18490,24000,5510,1,00114,India
653841,2023-02-21,506,monitor,3249,8000,4751,1,00114,India
289087,2023-02-21,505,oven,18490,24000,5510,1,00115,India
990967,2023-02-21,504,iron,449,879,430,1,00116,India
990967,2023-02-21,507,washing machine,6990,16490,9500,1,00116,India
990967,2023-02-21,503,mixer,1349,3249,1900,1,00116,India
283890,2023-02-21,502,iphone 15 pro max,100000,135000,35000,1,00117,India
283890,2023-02-21,504,iron,449,879,430,1,00117,India
145832,2023-02-21,501,iphone 15,60000,80000,20000,1,00118,India
145832,2023-02-21,507,washing machine,6990,16490,9500,1,00118,India
897718,2023-02-21,504,iron,449,879,430,1,00119,India
897718,2023-02-21,506,monitor,3249,8000,4751,1,00119,India
897718,2023-02-21,505,oven,18490,24000,5510,1,00119,India
897718,2023-02-21,501,iphone 15,60000,80000,20000,1,00119,India
868075,2023-02-21,506,monitor,3249,8000,4751,1,00120,India
322239,2023-02-21,503,mixer,1349,3249,1900,1,00121,India
322239,2023-02-21,507,washing machine,6990,16490,9500,1,00121,India
322239,2023-02-21,506,monitor,3249,8000,4751,1,00121,India
322239,2023-02-21,501,iphone 15,60000,80000,20000,1,00121,India
838261,2023-02-21,501,iphone 15,60000,80000,20000,1,00122,India
672644,2023-02-21,507,washing machine,6990,16490,9500,1,00123,India
672644,2023-02-21,505,oven,18490,24000,5510,1,00123,India
672644,2023-02-21,502,iphone 15 pro max,100000,135000,35000,1,00123,India
689992,2023-02-21,502,iphone 15 pro max,100000,135000,35000,1,00124,India
689992,2023-02-21,506,monitor,3249,8000,4751,1,00124,India
689992,2023-02-21,507,washing machine,6990,16490,9500,1,00124,India
689992,2023-02-21,501,iphone 15,60000,80000,20000,1,00124,India
689992,2023-02-21,503,mixer,1349,3249,1900,1,00124,India
742578,2023-02-21,501,iphone 15,60000,80000,20000,1,00125,India
742578,2023-02-21,505,oven,18490,24000,5510,1,00125,India
742578,2023-02-21,504,iron,449,879,430,1,00125,India
742578,2023-02-21,506,monitor,3249,8000,4751,1,00125,India
907138,2023-02-21,505,oven,18490,24000,5510,1,00126,India
907138,2023-02-21,504,iron,449,879,430,1,00126,India
907138,2023-02-21,502,iphone 15 pro max,100000,135000,35000,1,00126,India
907138,2023-02-21,501,iphone 15,60000,80000,20000,1,00126,India
721516,2023-02-21,507,washing machine,6990,16490,9500,1,00127,India
721516,2023-02-21,504,iron,449,879,430,1,00127,India
721516,2023-02-21,503,mixer,1349,3249,1900,1,00127,India
721516,2023-02-21,502,iphone 15 pro max,100000,135000,35000,1,00127,India
315182,2023-02-21,505,oven,18490,24000,5510,1,00128,India
315182,2023-02-21,502,iphone 15 pro max,100000,135000,35000,1,00128,India
315182,2023-02-21,503,mixer,1349,3249,1900,1,00128,India
503130,2023-02-21,505,oven,18490,24000,5510,1,00129,India
503130,2023-02-21,504,iron,449,879,430,1,00129,India
503130,2023-02-21,506,monitor,3249,8000,4751,1,00129,India
503130,2023-02-21,501,iphone 15,60000,80000,20000,1,00129,India
503130,2023-02-21,507,washing machine,6990,16490,9500,1,00129,India
650492,2023-02-21,503,mixer,1349,3249,1900,1,00130,India
789298,2023-02-21,501,iphone 15,60000,80000,20000,1,00131,India
789298,2023-02-21,505,oven,18490,24000,5510,1,00131,India
789298,2023-02-21,502,iphone 15 pro max,100000,135000,35000,1,00131,India
478101,2023-02-21,504,iron,449,879,430,1,00132,India
478101,2023-02-21,503,mixer,1349,3249,1900,1,00132,India
994917,2023-02-21,501,iphone 15,60000,80000,20000,1,00133,India
994917,2023-02-21,507,washing machine,6990,16490,9500,1,00133,India
994917,2023-02-21,504,iron,449,879,430,1,00133,India
556725,2023-02-21,507,washing machine,6990,16490,9500,1,00134,India
556725,2023-02-21,501,iphone 15,60000,80000,20000,1,00134,India
556725,2023-02-21,504,iron,449,879,430,1,00134,India
266407,2023-02-21,501,iphone 15,60000,80000,20000,1,00135,India
266407,2023-02-21,503,mixer,1349,3249,1900,1,00135,India
266407,2023-02-21,504,iron,449,879,430,1,00135,India
764739,2023-02-21,501,iphone 15,60000,80000,20000,1,00136,India
764739,2023-02-21,507,washing machine,6990,16490,9500,1,00136,India
407871,2023-02-21,504,iron,449,879,430,1,00137,India
407871,2023-02-21,501,iphone 15,60000,80000,20000,1,00137,India
737208,2023-02-21,505,oven,18490,24000,5510,1,00138,India
737208,2023-02-21,507,washing machine,6990,16490,9500,1,00138,India
737208,2023-02-21,502,iphone 15 pro max,100000,135000,35000,1,00138,India
602854,2023-02-21,507,washing machine,6990,16490,9500,1,00139,India
602854,2023-02-21,503,mixer,1349,3249,1900,1,00139,India
602854,2023-02-21,502,iphone 15 pro max,100000,135000,35000,1,00139,India
602854,2023-02-21,501,iphone 15,60000,80000,20000,1,00139,India
766227,2023-02-21,507,washing machine,6990,16490,9500,1,00140,India
766227,2023-02-21,503,mixer,1349,3249,1900,1,00140,India
766227,2023-02-21,502,iphone 15 pro max,100000,135000,35000,1,00140,India
120298,2023-02-21,502,iphone 15 pro max,100000,135000,35000,1,00141,India
120298,2023-02-21,504,iron,449,879,430,1,00141,India
598109,2023-02-21,505,oven,18490,24000,5510,1,00142,India
598109,2023-02-21,503,mixer,1349,3249,1900,1,00142,India
598109,2023-02-21,501,iphone 15,60000,80000,20000,1,00142,India
983839,2023-02-22,506,monitor,3249,8000,4751,1,00143,India
983839,2023-02-22,502,iphone 15 pro max,100000,135000,35000,1,00143,India
983839,2023-02-22,503,mixer,1349,3249,1900,1,00143,India
385849,2023-02-22,506,monitor,3249,8000,4751,1,00144,India
632173,2023-02-22,503,mixer,1349,3249,1900,1,00145,India
632173,2023-02-22,506,monitor,3249,8000,4751,1,00145,India
355818,2023-02-22,505,oven,18490,24000,5510,1,00146,India
355818,2023-02-22,506,monitor,3249,8000,4751,1,00146,India
355818,2023-02-22,501,iphone 15,60000,80000,20000,1,00146,India
355818,2023-02-22,504,iron,449,879,430,1,00146,India
438854,2023-02-22,501,iphone 15,60000,80000,20000,1,00147,India
438854,2023-02-22,507,washing machine,6990,16490,9500,1,00147,India
611199,2023-02-22,506,monitor,3249,8000,4751,1,00148,India
611199,2023-02-22,504,iron,449,879,430,1,00148,India
611199,2023-02-22,505,oven,18490,24000,5510,1,00148,India
180522,2023-02-22,501,iphone 15,60000,80000,20000,1,00149,India
180522,2023-02-22,506,monitor,3249,8000,4751,1,00149,India
180522,2023-02-22,507,washing machine,6990,16490,9500,1,00149,India
398733,2023-02-22,507,washing machine,6990,16490,9500,1,00150,India
302278,2023-02-22,506,monitor,3249,8000,4751,1,00151,India
302278,2023-02-22,503,mixer,1349,3249,1900,1,00151,India
831238,2023-02-22,501,iphone 15,60000,80000,20000,1,00152,India
831238,2023-02-22,505,oven,18490,24000,5510,1,00152,India
486946,2023-02-22,502,iphone 15 pro max,100000,135000,35000,1,00153,India
486946,2023-02-22,505,oven,18490,24000,5510,1,00153,India
228426,2023-02-22,503,mixer,1349,3249,1900,1,00154,India
228426,2023-02-22,506,monitor,3249,8000,4751,1,00154,India
228426,2023-02-22,502,iphone 15 pro max,100000,135000,35000,1,00154,India
447977,2023-02-22,503,mixer,1349,3249,1900,1,00155,India
447977,2023-02-22,501,iphone 15,60000,80000,20000,1,00155,India
916443,2023-02-22,502,iphone 15 pro max,100000,135000,35000,1,00156,India
916443,2023-02-22,504,iron,449,879,430,1,00156,India
117598,2023-02-22,503,mixer,1349,3249,1900,1,00157,India
117598,2023-02-22,505,oven,18490,24000,5510,1,00157,India
117598,2023-02-22,504,iron,449,879,430,1,00157,India
117598,2023-02-22,506,monitor,3249,8000,4751,1,00157,India
839285,2023-02-22,507,washing machine,6990,16490,9500,1,00158,India
839285,2023-02-22,504,iron,449,879,430,1,00158,India
527076,2023-02-22,505,oven,18490,24000,5510,1,00159,India
527076,2023-02-22,506,monitor,3249,8000,4751,1,00159,India
527076,2023-02-22,504,iron,449,879,430,1,00159,India
771559,2023-02-22,506,monitor,3249,8000,4751,1,00160,India
771559,2023-02-22,507,washing machine,6990,16490,9500,1,00160,India
771559,2023-02-22,502,iphone 15 pro max,100000,135000,35000,1,00160,India
992665,2023-02-22,501,iphone 15,60000,80000,20000,1,00161,India
992665,2023-02-22,506,monitor,3249,8000,4751,1,00161,India
992665,2023-02-22,502,iphone 15 pro max,100000,135000,35000,1,00161,India
992665,2023-02-22,504,iron,449,879,430,1,00161,India
774294,2023-02-22,507,washing machine,6990,16490,9500,1,00162,India
668461,2023-02-22,504,iron,449,879,430,1,00163,India
668461,2023-02-22,503,mixer,1349,3249,1900,1,00163,India
932252,2023-02-22,502,iphone 15 pro max,100000,135000,35000,1,00164,India
932252,2023-02-22,504,iron,449,879,430,1,00164,India
932252,2023-02-22,501,iphone 15,60000,80000,20000,1,00164,India
932252,2023-02-22,505,oven,18490,24000,5510,1,00164,India
984599,2023-02-22,502,iphone 15 pro max,100000,135000,35000,1,00165,India
984599,2023-02-22,504,iron,449,879,430,1,00165,India
984599,2023-02-22,507,washing machine,6990,16490,9500,1,00165,India
984599,2023-02-22,501,iphone 15,60000,80000,20000,1,00165,India
470905,2023-02-22,501,iphone 15,60000,80000,20000,1,00166,India
610356,2023-02-22,502,iphone 15 pro max,100000,135000,35000,1,00167,India
610356,2023-02-22,501,iphone 15,60000,80000,20000,1,00167,India
610356,2023-02-22,506,monitor,3249,8000,4751,1,00167,India
909015,2023-02-22,507,washing machine,6990,16490,9500,1,00168,India
909015,2023-02-22,505,oven,18490,24000,5510,1,00168,India
909015,2023-02-22,502,iphone 15 pro max,100000,135000,35000,1,00168,India
152940,2023-02-22,502,iphone 15 pro max,100000,135000,35000,1,00169,India
152940,2023-02-22,506,monitor,3249,8000,4751,1,00169,India
739369,2023-02-22,504,iron,449,879,430,1,00170,India
739369,2023-02-22,502,iphone 15 pro max,100000,135000,35000,1,00170,India
739369,2023-02-22,506,monitor,3249,8000,4751,1,00170,India
739369,2023-02-22,503,mixer,1349,3249,1900,1,00170,India
723258,2023-02-22,505,oven,18490,24000,5510,1,00171,India
723258,2023-02-22,501,iphone 15,60000,80000,20000,1,00171,India
438511,2023-02-22,506,monitor,3249,8000,4751,1,00172,India
438511,2023-02-22,501,iphone 15,60000,80000,20000,1,00172,India
438511,2023-02-22,504,iron,449,879,430,1,00172,India
829264,2023-02-22,502,iphone 15 pro max,100000,135000,35000,1,00173,India
829264,2023-02-22,505,oven,18490,24000,5510,1,00173,India
829264,2023-02-22,501,iphone 15,60000,80000,20000,1,00173,India
771060,2023-02-22,506,monitor,3249,8000,4751,1,00174,India
771060,2023-02-22,507,washing machine,6990,16490,9500,1,00174,India
771060,2023-02-22,505,oven,18490,24000,5510,1,00174,India
771060,2023-02-22,501,iphone 15,60000,80000,20000,1,00174,India
691511,2023-02-22,505,oven,18490,24000,5510,1,00175,India
691511,2023-02-22,501,iphone 15,60000,80000,20000,1,00175,India
297789,2023-02-22,504,iron,449,879,430,1,00176,India
379589,2023-02-22,505,oven,18490,24000,5510,1,00177,India
379589,2023-02-22,504,iron,449,879,430,1,00177,India
379589,2023-02-22,506,monitor,3249,8000,4751,1,00177,India
379589,2023-02-22,502,iphone 15 pro max,100000,135000,35000,1,00177,India
290024,2023-02-22,506,monitor,3249,8000,4751,1,00178,India
243785,2023-02-22,502,iphone 15 pro max,100000,135000,35000,1,00179,India
243785,2023-02-22,507,washing machine,6990,16490,9500,1,00179,India
285220,2023-02-22,501,iphone 15,60000,80000,20000,1,00180,India
285220,2023-02-22,502,iphone 15 pro max,100000,135000,35000,1,00180,India
285220,2023-02-22,507,washing machine,6990,16490,9500,1,00180,India
285220,2023-02-22,503,mixer,1349,3249,1900,1,00180,India
330587,2023-02-22,504,iron,449,879,430,1,00181,India
854168,2023-02-22,502,iphone 15 pro max,100000,135000,35000,1,00182,India
854168,2023-02-22,504,iron,449,879,430,1,00182,India
854168,2023-02-22,506,monitor,3249,8000,4751,1,00182,India
397398,2023-02-22,501,iphone 15,60000,80000,20000,1,00183,India
397398,2023-02-22,505,oven,18490,24000,5510,1,00183,India
397398,2023-02-22,507,washing machine,6990,16490,9500,1,00183,India
423619,2023-02-22,503,mixer,1349,3249,1900,1,00184,India
423619,2023-02-22,505,oven,18490,24000,5510,1,00184,India
423619,2023-02-22,502,iphone 15 pro max,100000,135000,35000,1,00184,India
428833,2023-02-22,507,washing machine,6990,16490,9500,1,00185,India
428833,2023-02-22,506,monitor,3249,8000,4751,1,00185,India
428833,2023-02-22,504,iron,449,879,430,1,00185,India
428833,2023-02-22,501,iphone 15,60000,80000,20000,1,00185,India
473398,2023-02-22,507,washing machine,6990,16490,9500,1,00186,India
473398,2023-02-22,502,iphone 15 pro max,100000,135000,35000,1,00186,India
473398,2023-02-22,504,iron,449,879,430,1,00186,India
473398,2023-02-22,501,iphone 15,60000,80000,20000,1,00186,India
876751,2023-02-22,505,oven,18490,24000,5510,1,00187,India
876751,2023-02-22,507,washing machine,6990,16490,9500,1,00187,India
876751,2023-02-22,506,monitor,3249,8000,4751,1,00187,India
969501,2023-02-22,504,iron,449,879,430,1,00188,India
683344,2023-02-22,507,washing machine,6990,16490,9500,1,00189,India
683344,2023-02-22,502,iphone 15 pro max,100000,135000,35000,1,00189,India
683344,2023-02-22,505,oven,18490,24000,5510,1,00189,India
370040,2023-02-22,505,oven,18490,24000,5510,1,00190,India
788594,2023-02-22,502,iphone 15 pro max,100000,135000,35000,1,00191,India
788594,2023-02-22,501,iphone 15,60000,80000,20000,1,00191,India
788594,2023-02-22,505,oven,18490,24000,5510,1,00191,India
514690,2023-02-22,504,iron,449,879,430,1,00192,India
514690,2023-02-22,502,iphone 15 pro max,100000,135000,35000,1,00192,India
618862,2023-02-22,505,oven,18490,24000,5510,1,00193,India
618862,2023-02-22,504,iron,449,879,430,1,00193,India
394491,2023-02-22,506,monitor,3249,8000,4751,1,00194,India
890244,2023-02-22,504,iron,449,879,430,1,00195,India
890244,2023-02-22,502,iphone 15 pro max,100000,135000,35000,1,00195,India
890244,2023-02-22,505,oven,18490,24000,5510,1,00195,India
708955,2023-02-22,503,mixer,1349,3249,1900,1,00196,India
807150,2023-02-22,503,mixer,1349,3249,1900,1,00197,India
799285,2023-02-22,504,iron,449,879,430,1,00198,India
799285,2023-02-22,506,monitor,3249,8000,4751,1,00198,India
344877,2023-02-22,502,iphone 15 pro max,100000,135000,35000,1,00199,India
344877,2023-02-22,506,monitor,3249,8000,4751,1,00199,India
344877,2023-02-22,504,iron,449,879,430,1,00199,India
336985,2023-02-22,504,iron,449,879,430,1,00200,India
336985,2023-02-22,506,monitor,3249,8000,4751,1,00200,India
336985,2023-02-22,501,iphone 15,60000,80000,20000,1,00200,India
346514,2023-02-22,503,mixer,1349,3249,1900,1,00201,India
346514,2023-02-22,505,oven,18490,24000,5510,1,00201,India
572992,2023-02-22,503,mixer,1349,3249,1900,1,00202,India
572992,2023-02-22,507,washing machine,6990,16490,9500,1,00202,India
572992,2023-02-22,506,monitor,3249,8000,4751,1,00202,India
769258,2023-02-22,505,oven,18490,24000,5510,1,00203,India
550031,2023-02-22,502,iphone 15 pro max,100000,135000,35000,1,00204,India
550031,2023-02-22,505,oven,18490,24000,5510,1,00204,India
156841,2023-02-22,506,monitor,3249,8000,4751,1,00205,India
156841,2023-02-22,505,oven,18490,24000,5510,1,00205,India
361408,2023-02-22,507,washing machine,6990,16490,9500,1,00206,India
441567,2023-02-22,506,monitor,3249,8000,4751,1,00207,India
441567,2023-02-22,503,mixer,1349,3249,1900,1,00207,India
441567,2023-02-22,502,iphone 15 pro max,100000,135000,35000,1,00207,India
441567,2023-02-22,507,washing machine,6990,16490,9500,1,00207,India
484972,2023-02-22,501,iphone 15,60000,80000,20000,1,00208,India
484972,2023-02-22,504,iron,449,879,430,1,00208,India
271545,2023-02-22,507,washing machine,6990,16490,9500,1,00209,India
271545,2023-02-22,502,iphone 15 pro max,100000,135000,35000,1,00209,India
136378,2023-02-22,501,iphone 15,60000,80000,20000,1,00210,India
806082,2023-02-23,505,oven,18490,24000,5510,1,00211,India
779397,2023-02-23,506,monitor,3249,8000,4751,1,00212,India
383805,2023-02-23,503,mixer,1349,3249,1900,1,00213,India
383805,2023-02-23,501,iphone 15,60000,80000,20000,1,00213,India
383805,2023-02-23,502,iphone 15 pro max,100000,135000,35000,1,00213,India
383805,2023-02-23,505,oven,18490,24000,5510,1,00213,India
822710,2023-02-23,504,iron,449,879,430,1,00214,India
822710,2023-02-23,507,washing machine,6990,16490,9500,1,00214,India
822710,2023-02-23,502,iphone 15 pro max,100000,135000,35000,1,00214,India
515756,2023-02-23,501,iphone 15,60000,80000,20000,1,00215,India
515756,2023-02-23,507,washing machine,6990,16490,9500,1,00215,India
927523,2023-02-23,501,iphone 15,60000,80000,20000,1,00216,India
927523,2023-02-23,502,iphone 15 pro max,100000,135000,35000,1,00216,India
927523,2023-02-23,507,washing machine,6990,16490,9500,1,00216,India
888275,2023-02-23,503,mixer,1349,3249,1900,1,00217,India
156772,2023-02-23,501,iphone 15,60000,80000,20000,1,00218,India
156772,2023-02-23,506,monitor,3249,8000,4751,1,00218,India
156772,2023-02-23,502,iphone 15 pro max,100000,135000,35000,1,00218,India
156772,2023-02-23,504,iron,449,879,430,1,00218,India
606543,2023-02-23,504,iron,449,879,430,1,00219,India
606543,2023-02-23,501,iphone 15,60000,80000,20000,1,00219,India
606543,2023-02-23,505,oven,18490,24000,5510,1,00219,India
946409,2023-02-23,501,iphone 15,60000,80000,20000,1,00220,India
946409,2023-02-23,503,mixer,1349,3249,1900,1,00220,India
946409,2023-02-23,502,iphone 15 pro max,100000,135000,35000,1,00220,India
758549,2023-02-23,501,iphone 15,60000,80000,20000,1,00221,India
758549,2023-02-23,507,washing machine,6990,16490,9500,1,00221,India
758549,2023-02-23,504,iron,449,879,430,1,00221,India
664263,2023-02-23,507,washing machine,6990,16490,9500,1,00222,India
664263,2023-02-23,502,iphone 15 pro max,100000,135000,35000,1,00222,India
664263,2023-02-23,501,iphone 15,60000,80000,20000,1,00222,India
664263,2023-02-23,503,mixer,1349,3249,1900,1,00222,India
896120,2023-02-23,501,iphone 15,60000,80000,20000,1,00223,India
896120,2023-02-23,506,monitor,3249,8000,4751,1,00223,India
896120,2023-02-23,507,washing machine,6990,16490,9500,1,00223,India
896120,2023-02-23,502,iphone 15 pro max,100000,135000,35000,1,00223,India
160748,2023-02-23,502,iphone 15 pro max,100000,135000,35000,1,00224,India
160748,2023-02-23,505,oven,18490,24000,5510,1,00224,India
160748,2023-02-23,507,washing machine,6990,16490,9500,1,00224,India
423549,2023-02-23,505,oven,18490,24000,5510,1,00225,India
423549,2023-02-23,506,monitor,3249,8000,4751,1,00225,India
423549,2023-02-23,502,iphone 15 pro max,100000,135000,35000,1,00225,India
654185,2023-02-23,506,monitor,3249,8000,4751,1,00226,India
654185,2023-02-23,501,iphone 15,60000,80000,20000,1,00226,India
654185,2023-02-23,503,mixer,1349,3249,1900,1,00226,India
439981,2023-02-23,504,iron,449,879,430,1,00227,India
439981,2023-02-23,503,mixer,1349,3249,1900,1,00227,India
555387,2023-02-23,502,iphone 15 pro max,100000,135000,35000,1,00228,India
555387,2023-02-23,506,monitor,3249,8000,4751,1,00228,India
579920,2023-02-23,503,mixer,1349,3249,1900,1,00229,India
579920,2023-02-23,501,iphone 15,60000,80000,20000,1,00229,India
579920,2023-02-23,502,iphone 15 pro max,100000,135000,35000,1,00229,India
579920,2023-02-23,504,iron,449,879,430,1,00229,India
276002,2023-02-23,501,iphone 15,60000,80000,20000,1,00230,India
276002,2023-02-23,505,oven,18490,24000,5510,1,00230,India
276002,2023-02-23,506,monitor,3249,8000,4751,1,00230,India
142380,2023-02-23,507,washing machine,6990,16490,9500,1,00231,India
142380,2023-02-23,502,iphone 15 pro max,100000,135000,35000,1,00231,India
142380,2023-02-23,505,oven,18490,24000,5510,1,00231,India
919834,2023-02-23,507,washing machine,6990,16490,9500,1,00232,India
742703,2023-02-23,501,iphone 15,60000,80000,20000,1,00233,India
742703,2023-02-23,502,iphone 15 pro max,100000,135000,35000,1,00233,India
332077,2023-02-23,503,mixer,1349,3249,1900,1,00234,India
332077,2023-02-23,507,washing machine,6990,16490,9500,1,00234,India
332077,2023-02-23,504,iron,449,879,430,1,00234,India
289113,2023-02-23,507,washing machine,6990,16490,9500,1,00235,India
289113,2023-02-23,506,monitor,3249,8000,4751,1,00235,India
289113,2023-02-23,501,iphone 15,60000,80000,20000,1,00235,India
289113,2023-02-23,503,mixer,1349,3249,1900,1,00235,India
289113,2023-02-23,504,iron,449,879,430,1,00235,India
616773,2023-02-23,504,iron,449,879,430,1,00236,India
616773,2023-02-23,503,mixer,1349,3249,1900,1,00236,India
616773,2023-02-23,507,washing machine,6990,16490,9500,1,00236,India
206628,2023-02-23,505,oven,18490,24000,5510,1,00237,India
206628,2023-02-23,506,monitor,3249,8000,4751,1,00237,India
890289,2023-02-23,507,washing machine,6990,16490,9500,1,00238,India
890289,2023-02-23,501,iphone 15,60000,80000,20000,1,00238,India
890289,2023-02-23,505,oven,18490,24000,5510,1,00238,India
890289,2023-02-23,503,mixer,1349,3249,1900,1,00238,India
571011,2023-02-23,501,iphone 15,60000,80000,20000,1,00239,India
571011,2023-02-23,504,iron,449,879,430,1,00239,India
571011,2023-02-23,503,mixer,1349,3249,1900,1,00239,India
355066,2023-02-23,506,monitor,3249,8000,4751,1,00240,India
198864,2023-02-23,506,monitor,3249,8000,4751,1,00241,India
198864,2023-02-23,503,mixer,1349,3249,1900,1,00241,India
198864,2023-02-23,507,washing machine,6990,16490,9500,1,00241,India
693517,2023-02-23,504,iron,449,879,430,1,00242,India
693517,2023-02-23,507,washing machine,6990,16490,9500,1,00242,India
722411,2023-02-23,505,oven,18490,24000,5510,1,00243,India
954651,2023-02-23,506,monitor,3249,8000,4751,1,00244,India
954651,2023-02-23,505,oven,18490,24000,5510,1,00244,India
954651,2023-02-23,502,iphone 15 pro max,100000,135000,35000,1,00244,India
954651,2023-02-23,504,iron,449,879,430,1,00244,India
656383,2023-02-23,507,washing machine,6990,16490,9500,1,00245,India
656383,2023-02-23,506,monitor,3249,8000,4751,1,00245,India
656383,2023-02-23,501,iphone 15,60000,80000,20000,1,00245,India
656383,2023-02-23,502,iphone 15 pro max,100000,135000,35000,1,00245,India
506325,2023-02-23,507,washing machine,6990,16490,9500,1,00246,India
506325,2023-02-23,502,iphone 15 pro max,100000,135000,35000,1,00246,India
506325,2023-02-23,505,oven,18490,24000,5510,1,00246,India
506325,2023-02-23,504,iron,449,879,430,1,00246,India
506325,2023-02-23,506,monitor,3249,8000,4751,1,00246,India
734875,2023-02-23,504,iron,449,879,430,1,00247,India
734875,2023-02-23,503,mixer,1349,3249,1900,1,00247,India
747992,2023-02-23,504,iron,449,879,430,1,00248,India
747992,2023-02-23,503,mixer,1349,3249,1900,1,00248,India
747992,2023-02-23,501,iphone 15,60000,80000,20000,1,00248,India
771596,2023-02-23,502,iphone 15 pro max,100000,135000,35000,1,00249,India
771596,2023-02-23,505,oven,18490,24000,5510,1,00249,India
771596,2023-02-23,501,iphone 15,60000,80000,20000,1,00249,India
771596,2023-02-23,506,monitor,3249,8000,4751,1,00249,India
307582,2023-02-23,507,washing machine,6990,16490,9500,1,00250,India
307582,2023-02-23,503,mixer,1349,3249,1900,1,00250,India
307582,2023-02-23,501,iphone 15,60000,80000,20000,1,00250,India
570954,2023-02-23,507,washing machine,6990,16490,9500,1,00251,India
570954,2023-02-23,503,mixer,1349,3249,1900,1,00251,India
457676,2023-02-23,501,iphone 15,60000,80000,20000,1,00252,India
457676,2023-02-23,507,washing machine,6990,16490,9500,1,00252,India
615982,2023-02-23,507,washing machine,6990,16490,9500,1,00253,India
615982,2023-02-23,503,mixer,1349,3249,1900,1,00253,India
862615,2023-02-23,507,washing machine,6990,16490,9500,1,00254,India
862615,2023-02-23,501,iphone 15,60000,80000,20000,1,00254,India
862615,2023-02-23,502,iphone 15 pro max,100000,135000,35000,1,00254,India
741946,2023-02-23,507,washing machine,6990,16490,9500,1,00255,India
741946,2023-02-23,503,mixer,1349,3249,1900,1,00255,India
741946,2023-02-23,502,iphone 15 pro max,100000,135000,35000,1,00255,India
741946,2023-02-23,505,oven,18490,24000,5510,1,00255,India
545224,2023-02-23,505,oven,18490,24000,5510,1,00256,India
545224,2023-02-23,501,iphone 15,60000,80000,20000,1,00256,India
545224,2023-02-23,502,iphone 15 pro max,100000,135000,35000,1,00256,India
545224,2023-02-23,504,iron,449,879,430,1,00256,India
545224,2023-02-23,506,monitor,3249,8000,4751,1,00256,India
776906,2023-02-23,503,mixer,1349,3249,1900,1,00257,India
776906,2023-02-23,506,monitor,3249,8000,4751,1,00257,India
601904,2023-02-23,507,washing machine,6990,16490,9500,1,00258,India
601904,2023-02-23,505,oven,18490,24000,5510,1,00258,India
601904,2023-02-23,504,iron,449,879,430,1,00258,India
784296,2023-02-23,502,iphone 15 pro max,100000,135000,35000,1,00259,India
784296,2023-02-23,507,washing machine,6990,16490,9500,1,00259,India
784296,2023-02-23,504,iron,449,879,430,1,00259,India
942841,2023-02-23,503,mixer,1349,3249,1900,1,00260,India
942841,2023-02-23,507,washing machine,6990,16490,9500,1,00260,India
942841,2023-02-23,501,iphone 15,60000,80000,20000,1,00260,India
479736,2023-02-23,505,oven,18490,24000,5510,1,00261,India
479736,2023-02-23,504,iron,449,879,430,1,00261,India
363383,2023-02-23,507,washing machine,6990,16490,9500,1,00262,India
363383,2023-02-23,504,iron,449,879,430,1,00262,India
686805,2023-02-23,506,monitor,3249,8000,4751,1,00263,India
686805,2023-02-23,504,iron,449,879,430,1,00263,India
686805,2023-02-23,503,mixer,1349,3249,1900,1,00263,India
686805,2023-02-23,502,iphone 15 pro max,100000,135000,35000,1,00263,India
686805,2023-02-23,505,oven,18490,24000,5510,1,00263,India
715016,2023-02-23,504,iron,449,879,430,1,00264,India
715016,2023-02-23,505,oven,18490,24000,5510,1,00264,India
715016,2023-02-23,506,monitor,3249,8000,4751,1,00264,India
587973,2023-02-23,501,iphone 15,60000,80000,20000,1,00265,India
587973,2023-02-23,506,monitor,3249,8000,4751,1,00265,India
587973,2023-02-23,502,iphone 15 pro max,100000,135000,35000,1,00265,India
146256,2023-02-23,502,iphone 15 pro max,100000,135000,35000,1,00266,India
146256,2023-02-23,501,iphone 15,60000,80000,20000,1,00266,India
146256,2023-02-23,505,oven,18490,24000,5510,1,00266,India
115731,2023-02-23,507,washing machine,6990,16490,9500,1,00267,India
115731,2023-02-23,502,iphone 15 pro max,100000,135000,35000,1,00267,India
205140,2023-02-23,506,monitor,3249,8000,4751,1,00268,India
902008,2023-02-23,501,iphone 15,60000,80000,20000,1,00269,India
902008,2023-02-23,506,monitor,3249,8000,4751,1,00269,India
902008,2023-02-23,504,iron,449,879,430,1,00269,India
164682,2023-02-23,504,iron,449,879,430,1,00270,India
266984,2023-02-23,505,oven,18490,24000,5510,1,00271,India
266984,2023-02-23,501,iphone 15,60000,80000,20000,1,00271,India
266984,2023-02-23,504,iron,449,879,430,1,00271,India
266984,2023-02-23,503,mixer,1349,3249,1900,1,00271,India
441737,2023-02-23,501,iphone 15,60000,80000,20000,1,00272,India
441737,2023-02-23,506,monitor,3249,8000,4751,1,00272,India
547504,2023-02-23,501,iphone 15,60000,80000,20000,1,00273,India
547504,2023-02-23,505,oven,18490,24000,5510,1,00273,India
426856,2023-02-23,506,monitor,3249,8000,4751,1,00274,India
426856,2023-02-23,503,mixer,1349,3249,1900,1,00274,India
183658,2023-02-23,501,iphone 15,60000,80000,20000,1,00275,India
183658,2023-02-23,507,washing machine,6990,16490,9500,1,00275,India
183658,2023-02-23,502,iphone 15 pro max,100000,135000,35000,1,00275,India
183658,2023-02-23,504,iron,449,879,430,1,00275,India
824158,2023-02-23,505,oven,18490,24000,5510,1,00276,India
824158,2023-02-23,506,monitor,3249,8000,4751,1,00276,India
824158,2023-02-23,503,mixer,1349,3249,1900,1,00276,India
152340,2023-02-23,505,oven,18490,24000,5510,1,00277,India
152340,2023-02-23,506,monitor,3249,8000,4751,1,00277,India
152340,2023-02-23,503,mixer,1349,3249,1900,1,00277,India
152340,2023-02-23,504,iron,449,879,430,1,00277,India
738490,2023-02-23,501,iphone 15,60000,80000,20000,1,00278,India
738490,2023-02-23,503,mixer,1349,3249,1900,1,00278,India
781622,2023-02-23,504,iron,449,879,430,1,00279,India
781622,2023-02-23,505,oven,18490,24000,5510,1,00279,India
781622,2023-02-23,502,iphone 15 pro max,100000,135000,35000,1,00279,India
781622,2023-02-23,506,monitor,3249,8000,4751,1,00279,India
127342,2023-02-23,506,monitor,3249,8000,4751,1,00280,India
127342,2023-02-23,503,mixer,1349,3249,1900,1,00280,India
127342,2023-02-23,502,iphone 15 pro max,100000,135000,35000,1,00280,India
892438,2023-02-24,506,monitor,3249,8000,4751,1,00281,India
892438,2023-02-24,503,mixer,1349,3249,1900,1,00281,India
217116,2023-02-24,504,iron,449,879,430,1,00282,India
217116,2023-02-24,503,mixer,1349,3249,1900,1,00282,India
217116,2023-02-24,502,iphone 15 pro max,100000,135000,35000,1,00282,India
410917,2023-02-24,506,monitor,3249,8000,4751,1,00283,India
410917,2023-02-24,507,washing machine,6990,16490,9500,1,00283,India
410917,2023-02-24,503,mixer,1349,3249,1900,1,00283,India
410917,2023-02-24,501,iphone 15,60000,80000,20000,1,00283,India
121733,2023-02-24,505,oven,18490,24000,5510,1,00284,India
121733,2023-02-24,502,iphone 15 pro max,100000,135000,35000,1,00284,India
121733,2023-02-24,506,monitor,3249,8000,4751,1,00284,India
812415,2023-02-24,502,iphone 15 pro max,100000,135000,35000,1,00285,India
877509,2023-02-24,506,monitor,3249,8000,4751,1,00286,India
533310,2023-02-24,505,oven,18490,24000,5510,1,00287,India
533310,2023-02-24,507,washing machine,6990,16490,9500,1,00287,India
533310,2023-02-24,504,iron,449,879,430,1,00287,India
533310,2023-02-24,502,iphone 15 pro max,100000,135000,35000,1,00287,India
291096,2023-02-24,507,washing machine,6990,16490,9500,1,00288,India
617199,2023-02-24,503,mixer,1349,3249,1900,1,00289,India
257180,2023-02-24,504,iron,449,879,430,1,00290,India
220513,2023-02-24,504,iron,449,879,430,1,00291,India
220513,2023-02-24,503,mixer,1349,3249,1900,1,00291,India
220513,2023-02-24,502,iphone 15 pro max,100000,135000,35000,1,00291,India
164082,2023-02-24,502,iphone 15 pro max,100000,135000,35000,1,00292,India
164082,2023-02-24,506,monitor,3249,8000,4751,1,00292,India
164082,2023-02-24,504,iron,449,879,430,1,00292,India
164082,2023-02-24,505,oven,18490,24000,5510,1,00292,India
167600,2023-02-24,507,washing machine,6990,16490,9500,1,00293,India
167600,2023-02-24,503,mixer,1349,3249,1900,1,00293,India
167600,2023-02-24,502,iphone 15 pro max,100000,135000,35000,1,00293,India
167600,2023-02-24,506,monitor,3249,8000,4751,1,00293,India
113754,2023-02-24,504,iron,449,879,430,1,00294,India
633545,2023-02-24,507,washing machine,6990,16490,9500,1,00295,India
633545,2023-02-24,505,oven,18490,24000,5510,1,00295,India
633545,2023-02-24,504,iron,449,879,430,1,00295,India
633545,2023-02-24,502,iphone 15 pro max,100000,135000,35000,1,00295,India
385176,2023-02-24,504,iron,449,879,430,1,00296,India
385176,2023-02-24,502,iphone 15 pro max,100000,135000,35000,1,00296,India
305199,2023-02-24,501,iphone 15,60000,80000,20000,1,00297,India
305199,2023-02-24,507,washing machine,6990,16490,9500,1,00297,India
305199,2023-02-24,503,mixer,1349,3249,1900,1,00297,India
305199,2023-02-24,506,monitor,3249,8000,4751,1,00297,India
305199,2023-02-24,505,oven,18490,24000,5510,1,00297,India
235569,2023-02-24,504,iron,449,879,430,1,00298,India
235569,2023-02-24,502,iphone 15 pro max,100000,135000,35000,1,00298,India
976444,2023-02-24,507,washing machine,6990,16490,9500,1,00299,India
976444,2023-02-24,504,iron,449,879,430,1,00299,India
976444,2023-02-24,503,mixer,1349,3249,1900,1,00299,India
976444,2023-02-24,501,iphone 15,60000,80000,20000,1,00299,India
759239,2023-02-24,505,oven,18490,24000,5510,1,00300,India
759239,2023-02-24,506,monitor,3249,8000,4751,1,00300,India
759239,2023-02-24,501,iphone 15,60000,80000,20000,1,00300,India
556287,2023-02-24,502,iphone 15 pro max,100000,135000,35000,1,00301,India
556287,2023-02-24,504,iron,449,879,430,1,00301,India
556287,2023-02-24,501,iphone 15,60000,80000,20000,1,00301,India
556287,2023-02-24,503,mixer,1349,3249,1900,1,00301,India
759130,2023-02-24,505,oven,18490,24000,5510,1,00302,India
517040,2023-02-24,501,iphone 15,60000,80000,20000,1,00303,India
410134,2023-02-24,505,oven,18490,24000,5510,1,00304,India
566386,2023-02-24,503,mixer,1349,3249,1900,1,00305,India
566386,2023-02-24,505,oven,18490,24000,5510,1,00305,India
641445,2023-02-24,504,iron,449,879,430,1,00306,India
641445,2023-02-24,507,washing machine,6990,16490,9500,1,00306,India
641445,2023-02-24,506,monitor,3249,8000,4751,1,00306,India
868225,2023-02-24,502,iphone 15 pro max,100000,135000,35000,1,00307,India
868225,2023-02-24,501,iphone 15,60000,80000,20000,1,00307,India
868225,2023-02-24,504,iron,449,879,430,1,00307,India
272240,2023-02-24,506,monitor,3249,8000,4751,1,00308,India
188816,2023-02-24,507,washing machine,6990,16490,9500,1,00309,India
188816,2023-02-24,501,iphone 15,60000,80000,20000,1,00309,India
188816,2023-02-24,502,iphone 15 pro max,100000,135000,35000,1,00309,India
188816,2023-02-24,503,mixer,1349,3249,1900,1,00309,India
188816,2023-02-24,506,monitor,3249,8000,4751,1,00309,India
349561,2023-02-24,503,mixer,1349,3249,1900,1,00310,India
974076,2023-02-24,504,iron,449,879,430,1,00311,India
298894,2023-02-24,507,washing machine,6990,16490,9500,1,00312,India
298894,2023-02-24,501,iphone 15,60000,80000,20000,1,00312,India
298894,2023-02-24,505,oven,18490,24000,5510,1,00312,India
298894,2023-02-24,503,mixer,1349,3249,1900,1,00312,India
595859,2023-02-24,505,oven,18490,24000,5510,1,00313,India
595859,2023-02-24,503,mixer,1349,3249,1900,1,00313,India
907582,2023-02-24,502,iphone 15 pro max,100000,135000,35000,1,00314,India
907582,2023-02-24,503,mixer,1349,3249,1900,1,00314,India
907582,2023-02-24,506,monitor,3249,8000,4751,1,00314,India
907582,2023-02-24,501,iphone 15,60000,80000,20000,1,00314,India
820004,2023-02-24,503,mixer,1349,3249,1900,1,00315,India
820004,2023-02-24,506,monitor,3249,8000,4751,1,00315,India
820004,2023-02-24,505,oven,18490,24000,5510,1,00315,India
891749,2023-02-24,504,iron,449,879,430,1,00316,India
891749,2023-02-24,501,iphone 15,60000,80000,20000,1,00316,India
699049,2023-02-24,502,iphone 15 pro max,100000,135000,35000,1,00317,India
699049,2023-02-24,503,mixer,1349,3249,1900,1,00317,India
699049,2023-02-24,501,iphone 15,60000,80000,20000,1,00317,India
355599,2023-02-24,507,washing machine,6990,16490,9500,1,00318,India
355599,2023-02-24,504,iron,449,879,430,1,00318,India
355599,2023-02-24,502,iphone 15 pro max,100000,135000,35000,1,00318,India
198460,2023-02-24,507,washing machine,6990,16490,9500,1,00319,India
198460,2023-02-24,503,mixer,1349,3249,1900,1,00319,India
198460,2023-02-24,502,iphone 15 pro max,100000,135000,35000,1,00319,India
198460,2023-02-24,504,iron,449,879,430,1,00319,India
878394,2023-02-24,506,monitor,3249,8000,4751,1,00320,India
878394,2023-02-24,507,washing machine,6990,16490,9500,1,00320,India
596760,2023-02-24,507,washing machine,6990,16490,9500,1,00321,India
986866,2023-02-24,507,washing machine,6990,16490,9500,1,00322,India
986866,2023-02-24,504,iron,449,879,430,1,00322,India
986866,2023-02-24,503,mixer,1349,3249,1900,1,00322,India
986866,2023-02-24,506,monitor,3249,8000,4751,1,00322,India
918584,2023-02-24,501,iphone 15,60000,80000,20000,1,00323,India
918584,2023-02-24,506,monitor,3249,8000,4751,1,00323,India
750080,2023-02-24,502,iphone 15 pro max,100000,135000,35000,1,00324,India
750080,2023-02-24,501,iphone 15,60000,80000,20000,1,00324,India
750080,2023-02-24,507,washing machine,6990,16490,9500,1,00324,India
789913,2023-02-24,504,iron,449,879,430,1,00325,India
789913,2023-02-24,505,oven,18490,24000,5510,1,00325,India
153799,2023-02-24,504,iron,449,879,430,1,00326,India
153799,2023-02-24,501,iphone 15,60000,80000,20000,1,00326,India
153799,2023-02-24,507,washing machine,6990,16490,9500,1,00326,India
177490,2023-02-24,507,washing machine,6990,16490,9500,1,00327,India
946911,2023-02-24,506,monitor,3249,8000,4751,1,00328,India
946911,2023-02-24,505,oven,18490,24000,5510,1,00328,India
946911,2023-02-24,503,mixer,1349,3249,1900,1,00328,India
946911,2023-02-24,502,iphone 15 pro max,100000,135000,35000,1,00328,India
461447,2023-02-24,507,washing machine,6990,16490,9500,1,00329,India
461447,2023-02-24,504,iron,449,879,430,1,00329,India
159131,2023-02-24,504,iron,449,879,430,1,00330,India
207146,2023-02-24,503,mixer,1349,3249,1900,1,00331,India
207146,2023-02-24,507,washing machine,6990,16490,9500,1,00331,India
350836,2023-02-24,504,iron,449,879,430,1,00332,India
350836,2023-02-24,506,monitor,3249,8000,4751,1,00332,India
213073,2023-02-24,502,iphone 15 pro max,100000,135000,35000,1,00333,India
213073,2023-02-24,501,iphone 15,60000,80000,20000,1,00333,India
213073,2023-02-24,504,iron,449,879,430,1,00333,India
532266,2023-02-24,502,iphone 15 pro max,100000,135000,35000,1,00334,India
532266,2023-02-24,504,iron,449,879,430,1,00334,India
532266,2023-02-24,503,mixer,1349,3249,1900,1,00334,India
606418,2023-02-24,501,iphone 15,60000,80000,20000,1,00335,India
606418,2023-02-24,507,washing machine,6990,16490,9500,1,00335,India
706891,2023-02-24,503,mixer,1349,3249,1900,1,00336,India
706891,2023-02-24,501,iphone 15,60000,80000,20000,1,00336,India
933496,2023-02-24,504,iron,449,879,430,1,00337,India
933496,2023-02-24,501,iphone 15,60000,80000,20000,1,00337,India
539448,2023-02-24,503,mixer,1349,3249,1900,1,00338,India
539448,2023-02-24,502,iphone 15 pro max,100000,135000,35000,1,00338,India
862128,2023-02-24,504,iron,449,879,430,1,00339,India
862128,2023-02-24,503,mixer,1349,3249,1900,1,00339,India
862128,2023-02-24,505,oven,18490,24000,5510,1,00339,India
862128,2023-02-24,507,washing machine,6990,16490,9500,1,00339,India
208782,2023-02-24,501,iphone 15,60000,80000,20000,1,00340,India
208782,2023-02-24,506,monitor,3249,8000,4751,1,00340,India
831351,2023-02-24,501,iphone 15,60000,80000,20000,1,00341,India
831351,2023-02-24,503,mixer,1349,3249,1900,1,00341,India
831351,2023-02-24,502,iphone 15 pro max,100000,135000,35000,1,00341,India
316524,2023-02-24,502,iphone 15 pro max,100000,135000,35000,1,00342,India
316524,2023-02-24,505,oven,18490,24000,5510,1,00342,India
316524,2023-02-24,507,washing machine,6990,16490,9500,1,00342,India
439989,2023-02-24,504,iron,449,879,430,1,00343,India
439989,2023-02-24,502,iphone 15 pro max,100000,135000,35000,1,00343,India
439989,2023-02-24,503,mixer,1349,3249,1900,1,00343,India
130511,2023-02-24,501,iphone 15,60000,80000,20000,1,00344,India
130511,2023-02-24,502,iphone 15 pro max,100000,135000,35000,1,00344,India
951845,2023-02-24,503,mixer,1349,3249,1900,1,00345,India
668199,2023-02-24,501,iphone 15,60000,80000,20000,1,00346,India
668199,2023-02-24,507,washing machine,6990,16490,9500,1,00346,India
668199,2023-02-24,503,mixer,1349,3249,1900,1,00346,India
405920,2023-02-24,505,oven,18490,24000,5510,1,00347,India
405920,2023-02-24,507,washing machine,6990,16490,9500,1,00347,India
450404,2023-02-24,507,washing machine,6990,16490,9500,1,00348,India
450404,2023-02-24,503,mixer,1349,3249,1900,1,00348,India
552468,2023-02-24,504,iron,449,879,430,1,00349,India
552468,2023-02-24,506,monitor,3249,8000,4751,1,00349,India
552468,2023-02-24,507,washing machine,6990,16490,9500,1,00349,India
485192,2023-02-24,507,washing machine,6990,16490,9500,1,00350,India
485192,2023-02-24,504,iron,449,879,430,1,00350,India
557109,2023-02-24,505,oven,18490,24000,5510,1,00351,India
686340,2023-02-24,507,washing machine,6990,16490,9500,1,00352,India
686340,2023-02-24,505,oven,18490,24000,5510,1,00352,India
686340,2023-02-24,503,mixer,1349,3249,1900,1,00352,India
946013,2023-02-24,505,oven,18490,24000,5510,1,00353,India
946013,2023-02-24,506,monitor,3249,8000,4751,1,00353,India
772742,2023-02-24,507,washing machine,6990,16490,9500,1,00354,India
772742,2023-02-24,501,iphone 15,60000,80000,20000,1,00354,India
772742,2023-02-24,506,monitor,3249,8000,4751,1,00354,India
772742,2023-02-24,502,iphone 15 pro max,100000,135000,35000,1,00354,India
955397,2023-02-24,507,washing machine,6990,16490,9500,1,00355,India
955397,2023-02-24,504,iron,449,879,430,1,00355,India
216978,2023-02-24,502,iphone 15 pro max,100000,135000,35000,1,00356,India
216978,2023-02-24,506,monitor,3249,8000,4751,1,00356,India
216978,2023-02-24,501,iphone 15,60000,80000,20000,1,00356,India
406170,2023-02-24,505,oven,18490,24000,5510,1,00357,India
406170,2023-02-24,506,monitor,3249,8000,4751,1,00357,India
234662,2023-02-24,507,washing machine,6990,16490,9500,1,00358,India
234662,2023-02-24,506,monitor,3249,8000,4751,1,00358,India
234662,2023-02-24,505,oven,18490,24000,5510,1,00358,India
888055,2023-02-24,507,washing machine,6990,16490,9500,1,00359,India
888055,2023-02-24,504,iron,449,879,430,1,00359,India
888055,2023-02-24,503,mixer,1349,3249,1900,1,00359,India
888055,2023-02-24,506,monitor,3249,8000,4751,1,00359,India
888055,2023-02-24,505,oven,18490,24000,5510,1,00359,India
942194,2023-02-24,504,iron,449,879,430,1,00360,India
942194,2023-02-24,501,iphone 15,60000,80000,20000,1,00360,India
942194,2023-02-24,502,iphone 15 pro max,100000,135000,35000,1,00360,India
738386,2023-02-24,506,monitor,3249,8000,4751,1,00361,India
627669,2023-02-24,504,iron,449,879,430,1,00362,India
385005,2023-02-24,507,washing machine,6990,16490,9500,1,00363,India
385005,2023-02-24,501,iphone 15,60000,80000,20000,1,00363,India
607993,2023-02-24,502,iphone 15 pro max,100000,135000,35000,1,00364,India
607993,2023-02-24,504,iron,449,879,430,1,00364,India
607993,2023-02-24,505,oven,18490,24000,5510,1,00364,India
607993,2023-02-24,506,monitor,3249,8000,4751,1,00364,India
103880,2023-02-24,503,mixer,1349,3249,1900,1,00365,India
103880,2023-02-24,507,washing machine,6990,16490,9500,1,00365,India
598862,2023-02-25,507,washing machine,6990,16490,9500,1,00366,India
598862,2023-02-25,505,oven,18490,24000,5510,1,00366,India
598862,2023-02-25,502,iphone 15 pro max,100000,135000,35000,1,00366,India
184882,2023-02-25,501,iphone 15,60000,80000,20000,1,00367,India
340523,2023-02-25,501,iphone 15,60000,80000,20000,1,00368,India
605428,2023-02-25,501,iphone 15,60000,80000,20000,1,00369,India
605428,2023-02-25,502,iphone 15 pro max,100000,135000,35000,1,00369,India
605428,2023-02-25,504,iron,449,879,430,1,00369,India
383508,2023-02-25,503,mixer,1349,3249,1900,1,00370,India
383508,2023-02-25,501,iphone 15,60000,80000,20000,1,00370,India
383508,2023-02-25,502,iphone 15 pro max,100000,135000,35000,1,00370,India
383508,2023-02-25,507,washing machine,6990,16490,9500,1,00370,India
724879,2023-02-25,505,oven,18490,24000,5510,1,00371,India
724879,2023-02-25,501,iphone 15,60000,80000,20000,1,00371,India
610078,2023-02-25,503,mixer,1349,3249,1900,1,00372,India
610078,2023-02-25,507,washing machine,6990,16490,9500,1,00372,India
610078,2023-02-25,504,iron,449,879,430,1,00372,India
823493,2023-02-25,501,iphone 15,60000,80000,20000,1,00373,India
629140,2023-02-25,504,iron,449,879,430,1,00374,India
629140,2023-02-25,501,iphone 15,60000,80000,20000,1,00374,India
629140,2023-02-25,506,monitor,3249,8000,4751,1,00374,India
274423,2023-02-25,503,mixer,1349,3249,1900,1,00375,India
952821,2023-02-25,504,iron,449,879,430,1,00376,India
952821,2023-02-25,506,monitor,3249,8000,4751,1,00376,India
124680,2023-02-25,505,oven,18490,24000,5510,1,00377,India
124680,2023-02-25,506,monitor,3249,8000,4751,1,00377,India
124680,2023-02-25,503,mixer,1349,3249,1900,1,00377,India
779236,2023-02-25,504,iron,449,879,430,1,00378,India
682568,2023-02-25,501,iphone 15,60000,80000,20000,1,00379,India
682568,2023-02-25,507,washing machine,6990,16490,9500,1,00379,India
682568,2023-02-25,504,iron,449,879,430,1,00379,India
947552,2023-02-25,503,mixer,1349,3249,1900,1,00380,India
947552,2023-02-25,504,iron,449,879,430,1,00380,India
432738,2023-02-25,506,monitor,3249,8000,4751,1,00381,India
432738,2023-02-25,505,oven,18490,24000,5510,1,00381,India
432738,2023-02-25,504,iron,449,879,430,1,00381,India
855544,2023-02-25,503,mixer,1349,3249,1900,1,00382,India
855544,2023-02-25,502,iphone 15 pro max,100000,135000,35000,1,00382,India
855544,2023-02-25,507,washing machine,6990,16490,9500,1,00382,India
823117,2023-02-25,503,mixer,1349,3249,1900,1,00383,India
823117,2023-02-25,504,iron,449,879,430,1,00383,India
558180,2023-02-25,504,iron,449,879,430,1,00384,India
558180,2023-02-25,506,monitor,3249,8000,4751,1,00384,India
558180,2023-02-25,502,iphone 15 pro max,100000,135000,35000,1,00384,India
558180,2023-02-25,501,iphone 15,60000,80000,20000,1,00384,India
361587,2023-02-25,505,oven,18490,24000,5510,1,00385,India
361587,2023-02-25,502,iphone 15 pro max,100000,135000,35000,1,00385,India
361587,2023-02-25,507,washing machine,6990,16490,9500,1,00385,India
862945,2023-02-25,501,iphone 15,60000,80000,20000,1,00386,India
862945,2023-02-25,502,iphone 15 pro max,100000,135000,35000,1,00386,India
862945,2023-02-25,503,mixer,1349,3249,1900,1,00386,India
862945,2023-02-25,504,iron,449,879,430,1,00386,India
664232,2023-02-25,502,iphone 15 pro max,100000,135000,35000,1,00387,India
664232,2023-02-25,503,mixer,1349,3249,1900,1,00387,India
628471,2023-02-25,502,iphone 15 pro max,100000,135000,35000,1,00388,India
340714,2023-02-25,504,iron,449,879,430,1,00389,India
340714,2023-02-25,502,iphone 15 pro max,100000,135000,35000,1,00389,India
171325,2023-02-25,505,oven,18490,24000,5510,1,00390,India
171325,2023-02-25,507,washing machine,6990,16490,9500,1,00390,India
171325,2023-02-25,506,monitor,3249,8000,4751,1,00390,India
976914,2023-02-25,506,monitor,3249,8000,4751,1,00391,India
399351,2023-02-25,502,iphone 15 pro max,100000,135000,35000,1,00392,India
399351,2023-02-25,505,oven,18490,24000,5510,1,00392,India
801718,2023-02-25,507,washing machine,6990,16490,9500,1,00393,India
801718,2023-02-25,506,monitor,3249,8000,4751,1,00393,India
801718,2023-02-25,503,mixer,1349,3249,1900,1,00393,India
801718,2023-02-25,505,oven,18490,24000,5510,1,00393,India
861620,2023-02-25,501,iphone 15,60000,80000,20000,1,00394,India
861620,2023-02-25,505,oven,18490,24000,5510,1,00394,India
123722,2023-02-25,505,oven,18490,24000,5510,1,00395,India
123722,2023-02-25,503,mixer,1349,3249,1900,1,00395,India
969340,2023-02-25,507,washing machine,6990,16490,9500,1,00396,India
969340,2023-02-25,505,oven,18490,24000,5510,1,00396,India
973043,2023-02-25,506,monitor,3249,8000,4751,1,00397,India
197870,2023-02-25,502,iphone 15 pro max,100000,135000,35000,1,00398,India
197870,2023-02-25,504,iron,449,879,430,1,00398,India
197870,2023-02-25,503,mixer,1349,3249,1900,1,00398,India
961057,2023-02-25,504,iron,449,879,430,1,00399,India
961057,2023-02-25,501,iphone 15,60000,80000,20000,1,00399,India
947890,2023-02-25,507,washing machine,6990,16490,9500,1,00400,India
947890,2023-02-25,501,iphone 15,60000,80000,20000,1,00400,India
947890,2023-02-25,503,mixer,1349,3249,1900,1,00400,India
947890,2023-02-25,504,iron,449,879,430,1,00400,India
444716,2023-02-25,501,iphone 15,60000,80000,20000,1,00401,India
131849,2023-02-25,506,monitor,3249,8000,4751,1,00402,India
131849,2023-02-25,501,iphone 15,60000,80000,20000,1,00402,India
131849,2023-02-25,502,iphone 15 pro max,100000,135000,35000,1,00402,India
131849,2023-02-25,507,washing machine,6990,16490,9500,1,00402,India
738000,2023-02-25,505,oven,18490,24000,5510,1,00403,India
738000,2023-02-25,503,mixer,1349,3249,1900,1,00403,India
881010,2023-02-25,502,iphone 15 pro max,100000,135000,35000,1,00404,India
881010,2023-02-25,506,monitor,3249,8000,4751,1,00404,India
656246,2023-02-25,503,mixer,1349,3249,1900,1,00405,India
314999,2023-02-25,505,oven,18490,24000,5510,1,00406,India
314999,2023-02-25,506,monitor,3249,8000,4751,1,00406,India
417785,2023-02-25,507,washing machine,6990,16490,9500,1,00407,India
779187,2023-02-25,501,iphone 15,60000,80000,20000,1,00408,India
779187,2023-02-25,507,washing machine,6990,16490,9500,1,00408,India
779187,2023-02-25,503,mixer,1349,3249,1900,1,00408,India
714825,2023-02-25,505,oven,18490,24000,5510,1,00409,India
714825,2023-02-25,506,monitor,3249,8000,4751,1,00409,India
714825,2023-02-25,501,iphone 15,60000,80000,20000,1,00409,India
714825,2023-02-25,504,iron,449,879,430,1,00409,India
396596,2023-02-25,502,iphone 15 pro max,100000,135000,35000,1,00410,India
396596,2023-02-25,507,washing machine,6990,16490,9500,1,00410,India
396596,2023-02-25,504,iron,449,879,430,1,00410,India
396596,2023-02-25,506,monitor,3249,8000,4751,1,00410,India
751413,2023-02-25,503,mixer,1349,3249,1900,1,00411,India
751413,2023-02-25,504,iron,449,879,430,1,00411,India
751413,2023-02-25,502,iphone 15 pro max,100000,135000,35000,1,00411,India
756976,2023-02-25,507,washing machine,6990,16490,9500,1,00412,India
756976,2023-02-25,501,iphone 15,60000,80000,20000,1,00412,India
756976,2023-02-25,503,mixer,1349,3249,1900,1,00412,India
756976,2023-02-25,505,oven,18490,24000,5510,1,00412,India
944394,2023-02-25,501,iphone 15,60000,80000,20000,1,00413,India
770628,2023-02-25,503,mixer,1349,3249,1900,1,00414,India
527970,2023-02-25,507,washing machine,6990,16490,9500,1,00415,India
527970,2023-02-25,504,iron,449,879,430,1,00415,India
359303,2023-02-25,507,washing machine,6990,16490,9500,1,00416,India
359303,2023-02-25,503,mixer,1349,3249,1900,1,00416,India
359303,2023-02-25,506,monitor,3249,8000,4751,1,00416,India
408307,2023-02-25,501,iphone 15,60000,80000,20000,1,00417,India
408307,2023-02-25,503,mixer,1349,3249,1900,1,00417,India
408307,2023-02-25,507,washing machine,6990,16490,9500,1,00417,India
408307,2023-02-25,504,iron,449,879,430,1,00417,India
902492,2023-02-25,506,monitor,3249,8000,4751,1,00418,India
902492,2023-02-25,502,iphone 15 pro max,100000,135000,35000,1,00418,India
495395,2023-02-25,504,iron,449,879,430,1,00419,India
495395,2023-02-25,506,monitor,3249,8000,4751,1,00419,India
495395,2023-02-25,502,iphone 15 pro max,100000,135000,35000,1,00419,India
157360,2023-02-25,503,mixer,1349,3249,1900,1,00420,India
157360,2023-02-25,504,iron,449,879,430,1,00420,India
895663,2023-02-25,502,iphone 15 pro max,100000,135000,35000,1,00421,India
895663,2023-02-25,501,iphone 15,60000,80000,20000,1,00421,India
505913,2023-02-26,501,iphone 15,60000,80000,20000,1,00422,India
505913,2023-02-26,504,iron,449,879,430,1,00422,India
505913,2023-02-26,506,monitor,3249,8000,4751,1,00422,India
505913,2023-02-26,503,mixer,1349,3249,1900,1,00422,India
558821,2023-02-26,505,oven,18490,24000,5510,1,00423,India
558821,2023-02-26,504,iron,449,879,430,1,00423,India
558821,2023-02-26,501,iphone 15,60000,80000,20000,1,00423,India
493494,2023-02-26,502,iphone 15 pro max,100000,135000,35000,1,00424,India
493494,2023-02-26,506,monitor,3249,8000,4751,1,00424,India
813219,2023-02-26,507,washing machine,6990,16490,9500,1,00425,India
813219,2023-02-26,502,iphone 15 pro max,100000,135000,35000,1,00425,India
813219,2023-02-26,503,mixer,1349,3249,1900,1,00425,India
190886,2023-02-26,506,monitor,3249,8000,4751,1,00426,India
190886,2023-02-26,502,iphone 15 pro max,100000,135000,35000,1,00426,India
190886,2023-02-26,507,washing machine,6990,16490,9500,1,00426,India
697323,2023-02-26,507,washing machine,6990,16490,9500,1,00427,India
697323,2023-02-26,501,iphone 15,60000,80000,20000,1,00427,India
863956,2023-02-26,507,washing machine,6990,16490,9500,1,00428,India
863956,2023-02-26,505,oven,18490,24000,5510,1,00428,India
863956,2023-02-26,502,iphone 15 pro max,100000,135000,35000,1,00428,India
241722,2023-02-26,502,iphone 15 pro max,100000,135000,35000,1,00429,India
241722,2023-02-26,504,iron,449,879,430,1,00429,India
241722,2023-02-26,503,mixer,1349,3249,1900,1,00429,India
241722,2023-02-26,505,oven,18490,24000,5510,1,00429,India
574854,2023-02-26,504,iron,449,879,430,1,00430,India
574854,2023-02-26,501,iphone 15,60000,80000,20000,1,00430,India
713647,2023-02-26,504,iron,449,879,430,1,00431,India
713647,2023-02-26,502,iphone 15 pro max,100000,135000,35000,1,00431,India
713647,2023-02-26,505,oven,18490,24000,5510,1,00431,India
441921,2023-02-26,504,iron,449,879,430,1,00432,India
441921,2023-02-26,505,oven,18490,24000,5510,1,00432,India
239918,2023-02-26,503,mixer,1349,3249,1900,1,00433,India
239918,2023-02-26,502,iphone 15 pro max,100000,135000,35000,1,00433,India
239918,2023-02-26,501,iphone 15,60000,80000,20000,1,00433,India
798632,2023-02-26,507,washing machine,6990,16490,9500,1,00434,India
798632,2023-02-26,505,oven,18490,24000,5510,1,00434,India
189384,2023-02-26,501,iphone 15,60000,80000,20000,1,00435,India
189384,2023-02-26,507,washing machine,6990,16490,9500,1,00435,India
349554,2023-02-26,501,iphone 15,60000,80000,20000,1,00436,India
349554,2023-02-26,507,washing machine,6990,16490,9500,1,00436,India
349554,2023-02-26,503,mixer,1349,3249,1900,1,00436,India
349554,2023-02-26,505,oven,18490,24000,5510,1,00436,India
549632,2023-02-26,505,oven,18490,24000,5510,1,00437,India
549632,2023-02-26,506,monitor,3249,8000,4751,1,00437,India
549632,2023-02-26,503,mixer,1349,3249,1900,1,00437,India
549632,2023-02-26,507,washing machine,6990,16490,9500,1,00437,India
422737,2023-02-26,503,mixer,1349,3249,1900,1,00438,India
422737,2023-02-26,501,iphone 15,60000,80000,20000,1,00438,India
463579,2023-02-26,506,monitor,3249,8000,4751,1,00439,India
463579,2023-02-26,507,washing machine,6990,16490,9500,1,00439,India
463579,2023-02-26,501,iphone 15,60000,80000,20000,1,00439,India
570354,2023-02-26,506,monitor,3249,8000,4751,1,00440,India
570354,2023-02-26,501,iphone 15,60000,80000,20000,1,00440,India
570354,2023-02-26,505,oven,18490,24000,5510,1,00440,India
570354,2023-02-26,507,washing machine,6990,16490,9500,1,00440,India
775640,2023-02-26,504,iron,449,879,430,1,00441,India
726902,2023-02-26,506,monitor,3249,8000,4751,1,00442,India
285742,2023-02-26,506,monitor,3249,8000,4751,1,00443,India
285742,2023-02-26,503,mixer,1349,3249,1900,1,00443,India
285742,2023-02-26,505,oven,18490,24000,5510,1,00443,India
285742,2023-02-26,502,iphone 15 pro max,100000,135000,35000,1,00443,India
947562,2023-02-26,507,washing machine,6990,16490,9500,1,00444,India
947562,2023-02-26,503,mixer,1349,3249,1900,1,00444,India
947562,2023-02-26,504,iron,449,879,430,1,00444,India
947562,2023-02-26,501,iphone 15,60000,80000,20000,1,00444,India
947562,2023-02-26,502,iphone 15 pro max,100000,135000,35000,1,00444,India
106774,2023-02-26,504,iron,449,879,430,1,00445,India
106774,2023-02-26,505,oven,18490,24000,5510,1,00445,India
106774,2023-02-26,501,iphone 15,60000,80000,20000,1,00445,India
106774,2023-02-26,507,washing machine,6990,16490,9500,1,00445,India
504233,2023-02-26,506,monitor,3249,8000,4751,1,00446,India
504233,2023-02-26,504,iron,449,879,430,1,00446,India
349377,2023-02-26,503,mixer,1349,3249,1900,1,00447,India
981767,2023-02-26,505,oven,18490,24000,5510,1,00448,India
981767,2023-02-26,502,iphone 15 pro max,100000,135000,35000,1,00448,India
981767,2023-02-26,506,monitor,3249,8000,4751,1,00448,India
981767,2023-02-26,501,iphone 15,60000,80000,20000,1,00448,India
960261,2023-02-26,504,iron,449,879,430,1,00449,India
960261,2023-02-26,501,iphone 15,60000,80000,20000,1,00449,India
734272,2023-02-26,507,washing machine,6990,16490,9500,1,00450,India
807442,2023-02-26,507,washing machine,6990,16490,9500,1,00451,India
807442,2023-02-26,504,iron,449,879,430,1,00451,India
807442,2023-02-26,501,iphone 15,60000,80000,20000,1,00451,India
858144,2023-02-26,506,monitor,3249,8000,4751,1,00452,India
858144,2023-02-26,507,washing machine,6990,16490,9500,1,00452,India
858144,2023-02-26,505,oven,18490,24000,5510,1,00452,India
395972,2023-02-26,502,iphone 15 pro max,100000,135000,35000,1,00453,India
395972,2023-02-26,507,washing machine,6990,16490,9500,1,00453,India
395972,2023-02-26,506,monitor,3249,8000,4751,1,00453,India
259948,2023-02-26,505,oven,18490,24000,5510,1,00454,India
105694,2023-02-26,505,oven,18490,24000,5510,1,00455,India
105694,2023-02-26,507,washing machine,6990,16490,9500,1,00455,India
105694,2023-02-26,501,iphone 15,60000,80000,20000,1,00455,India
105694,2023-02-26,506,monitor,3249,8000,4751,1,00455,India
765327,2023-02-26,507,washing machine,6990,16490,9500,1,00456,India
765327,2023-02-26,503,mixer,1349,3249,1900,1,00456,India
765327,2023-02-26,505,oven,18490,24000,5510,1,00456,India
676470,2023-02-26,506,monitor,3249,8000,4751,1,00457,India
676470,2023-02-26,502,iphone 15 pro max,100000,135000,35000,1,00457,India
676470,2023-02-26,504,iron,449,879,430,1,00457,India
146658,2023-02-26,507,washing machine,6990,16490,9500,1,00458,India
146658,2023-02-26,506,monitor,3249,8000,4751,1,00458,India
921627,2023-02-26,505,oven,18490,24000,5510,1,00459,India
921627,2023-02-26,504,iron,449,879,430,1,00459,India
144232,2023-02-26,504,iron,449,879,430,1,00460,India
144232,2023-02-26,502,iphone 15 pro max,100000,135000,35000,1,00460,India
144232,2023-02-26,506,monitor,3249,8000,4751,1,00460,India
144232,2023-02-26,503,mixer,1349,3249,1900,1,00460,India
781259,2023-02-26,504,iron,449,879,430,1,00461,India
781259,2023-02-26,503,mixer,1349,3249,1900,1,00461,India
781259,2023-02-26,506,monitor,3249,8000,4751,1,00461,India
714624,2023-02-26,503,mixer,1349,3249,1900,1,00462,India
787760,2023-02-26,501,iphone 15,60000,80000,20000,1,00463,India
679735,2023-02-26,503,mixer,1349,3249,1900,1,00464,India
679735,2023-02-26,507,washing machine,6990,16490,9500,1,00464,India
679735,2023-02-26,506,monitor,3249,8000,4751,1,00464,India
613950,2023-02-26,507,washing machine,6990,16490,9500,1,00465,India
646933,2023-02-26,506,monitor,3249,8000,4751,1,00466,India
646933,2023-02-26,504,iron,449,879,430,1,00466,India
146440,2023-02-26,505,oven,18490,24000,5510,1,00467,India
146440,2023-02-26,507,washing machine,6990,16490,9500,1,00467,India
146440,2023-02-26,506,monitor,3249,8000,4751,1,00467,India
146440,2023-02-26,502,iphone 15 pro max,100000,135000,35000,1,00467,India
907591,2023-02-26,504,iron,449,879,430,1,00468,India
907591,2023-02-26,503,mixer,1349,3249,1900,1,00468,India
636656,2023-02-26,507,washing machine,6990,16490,9500,1,00469,India
636656,2023-02-26,504,iron,449,879,430,1,00469,India
706135,2023-02-26,505,oven,18490,24000,5510,1,00470,India
706135,2023-02-26,506,monitor,3249,8000,4751,1,00470,India
706135,2023-02-26,504,iron,449,879,430,1,00470,India
120084,2023-02-26,501,iphone 15,60000,80000,20000,1,00471,India
120084,2023-02-26,504,iron,449,879,430,1,00471,India
312250,2023-02-26,503,mixer,1349,3249,1900,1,00472,India
671849,2023-02-26,507,washing machine,6990,16490,9500,1,00473,India
671849,2023-02-26,506,monitor,3249,8000,4751,1,00473,India
671849,2023-02-26,504,iron,449,879,430,1,00473,India
671849,2023-02-26,501,iphone 15,60000,80000,20000,1,00473,India
750881,2023-02-26,507,washing machine,6990,16490,9500,1,00474,India
750881,2023-02-26,503,mixer,1349,3249,1900,1,00474,India
750881,2023-02-26,504,iron,449,879,430,1,00474,India
738249,2023-02-26,501,iphone 15,60000,80000,20000,1,00475,India
738249,2023-02-26,506,monitor,3249,8000,4751,1,00475,India
738249,2023-02-26,507,washing machine,6990,16490,9500,1,00475,India
788962,2023-02-26,502,iphone 15 pro max,100000,135000,35000,1,00476,India
677315,2023-02-26,501,iphone 15,60000,80000,20000,1,00477,India
677315,2023-02-26,506,monitor,3249,8000,4751,1,00477,India
677315,2023-02-26,505,oven,18490,24000,5510,1,00477,India
229006,2023-02-26,504,iron,449,879,430,1,00478,India
229006,2023-02-26,506,monitor,3249,8000,4751,1,00478,India
229006,2023-02-26,507,washing machine,6990,16490,9500,1,00478,India
763672,2023-02-26,503,mixer,1349,3249,1900,1,00479,India
947671,2023-02-26,507,washing machine,6990,16490,9500,1,00480,India
736366,2023-02-26,501,iphone 15,60000,80000,20000,1,00481,India
535922,2023-02-26,505,oven,18490,24000,5510,1,00482,India
535922,2023-02-26,501,iphone 15,60000,80000,20000,1,00482,India
181446,2023-02-26,503,mixer,1349,3249,1900,1,00483,India
181446,2023-02-26,502,iphone 15 pro max,100000,135000,35000,1,00483,India
181446,2023-02-26,501,iphone 15,60000,80000,20000,1,00483,India
260666,2023-02-26,504,iron,449,879,430,1,00484,India
260666,2023-02-26,501,iphone 15,60000,80000,20000,1,00484,India
260666,2023-02-26,502,iphone 15 pro max,100000,135000,35000,1,00484,India
260666,2023-02-26,503,mixer,1349,3249,1900,1,00484,India
871991,2023-02-26,506,monitor,3249,8000,4751,1,00485,India
871991,2023-02-26,502,iphone 15 pro max,100000,135000,35000,1,00485,India
709290,2023-02-26,507,washing machine,6990,16490,9500,1,00486,India
709290,2023-02-26,504,iron,449,879,430,1,00486,India
709290,2023-02-26,501,iphone 15,60000,80000,20000,1,00486,India
709290,2023-02-26,502,iphone 15 pro max,100000,135000,35000,1,00486,India
492348,2023-02-26,503,mixer,1349,3249,1900,1,00487,India
492348,2023-02-26,506,monitor,3249,8000,4751,1,00487,India
710501,2023-02-26,507,washing machine,6990,16490,9500,1,00488,India
710501,2023-02-26,504,iron,449,879,430,1,00488,India
710501,2023-02-26,502,iphone 15 pro max,100000,135000,35000,1,00488,India
773437,2023-02-26,506,monitor,3249,8000,4751,1,00489,India
773437,2023-02-26,501,iphone 15,60000,80000,20000,1,00489,India
773437,2023-02-26,504,iron,449,879,430,1,00489,India
495276,2023-02-26,504,iron,449,879,430,1,00490,India
495276,2023-02-26,505,oven,18490,24000,5510,1,00490,India
495276,2023-02-26,502,iphone 15 pro max,100000,135000,35000,1,00490,India
495276,2023-02-26,507,washing machine,6990,16490,9500,1,00490,India
712582,2023-02-26,506,monitor,3249,8000,4751,1,00491,India
712582,2023-02-26,504,iron,449,879,430,1,00491,India
712582,2023-02-26,501,iphone 15,60000,80000,20000,1,00491,India
736241,2023-02-26,507,washing machine,6990,16490,9500,1,00492,India
736241,2023-02-26,502,iphone 15 pro max,100000,135000,35000,1,00492,India
736241,2023-02-26,503,mixer,1349,3249,1900,1,00492,India
151115,2023-02-26,501,iphone 15,60000,80000,20000,1,00493,India
151115,2023-02-26,502,iphone 15 pro max,100000,135000,35000,1,00493,India
646658,2023-02-26,503,mixer,1349,3249,1900,1,00494,India
639924,2023-02-26,503,mixer,1349,3249,1900,1,00495,India
639924,2023-02-26,506,monitor,3249,8000,4751,1,00495,India
639924,2023-02-26,501,iphone 15,60000,80000,20000,1,00495,India
647239,2023-02-26,507,washing machine,6990,16490,9500,1,00496,India
451849,2023-02-26,507,washing machine,6990,16490,9500,1,00497,India
451849,2023-02-26,501,iphone 15,60000,80000,20000,1,00497,India
451849,2023-02-26,502,iphone 15 pro max,100000,135000,35000,1,00497,India
451849,2023-02-26,506,monitor,3249,8000,4751,1,00497,India
876152,2023-02-26,506,monitor,3249,8000,4751,1,00498,India
876152,2023-02-26,502,iphone 15 pro max,100000,135000,35000,1,00498,India
876152,2023-02-26,507,washing machine,6990,16490,9500,1,00498,India
876152,2023-02-26,505,oven,18490,24000,5510,1,00498,India
533922,2023-02-26,507,washing machine,6990,16490,9500,1,00499,India
572377,2023-02-26,503,mixer,1349,3249,1900,1,00500,India
649106,2023-02-27,502,iphone 15 pro max,100000,135000,35000,1,00316,India
179436,2023-02-27,506,monitor,3249,8000,4751,1,00177,India
179436,2023-02-27,507,washing machine,6990,16490,9500,1,00177,India
179436,2023-02-27,505,oven,18490,24000,5510,1,00177,India
734666,2023-02-27,506,monitor,3249,8000,4751,1,00493,India
734666,2023-02-27,502,iphone 15 pro max,100000,135000,35000,1,00493,India
734666,2023-02-27,507,washing machine,6990,16490,9500,1,00493,India
150689,2023-02-27,505,oven,18490,24000,5510,1,00270,India
296867,2023-02-27,506,monitor,3249,8000,4751,1,00089,India
296867,2023-02-27,501,iphone 15,60000,80000,20000,1,00089,India
983386,2023-02-27,505,oven,18490,24000,5510,1,00035,India
983386,2023-02-27,502,iphone 15 pro max,100000,135000,35000,1,00035,India
983386,2023-02-27,506,monitor,3249,8000,4751,1,00035,India
983386,2023-02-27,501,iphone 15,60000,80000,20000,1,00035,India
693988,2023-02-27,505,oven,18490,24000,5510,1,00006,India
693988,2023-02-27,507,washing machine,6990,16490,9500,1,00006,India
791547,2023-02-27,501,iphone 15,60000,80000,20000,1,00144,India
791547,2023-02-27,507,washing machine,6990,16490,9500,1,00144,India
791547,2023-02-27,505,oven,18490,24000,5510,1,00144,India
664037,2023-02-27,501,iphone 15,60000,80000,20000,1,00390,India
664037,2023-02-27,503,mixer,1349,3249,1900,1,00390,India
312204,2023-02-27,501,iphone 15,60000,80000,20000,1,00473,India
312204,2023-02-27,507,washing machine,6990,16490,9500,1,00473,India
312204,2023-02-27,503,mixer,1349,3249,1900,1,00473,India
105137,2023-02-27,502,iphone 15 pro max,100000,135000,35000,1,00499,India
137955,2023-02-27,501,iphone 15,60000,80000,20000,1,00048,India
137955,2023-02-27,504,iron,449,879,430,1,00048,India
137955,2023-02-27,502,iphone 15 pro max,100000,135000,35000,1,00048,India
767861,2023-02-27,505,oven,18490,24000,5510,1,00403,India
678799,2023-02-27,506,monitor,3249,8000,4751,1,00495,India
678799,2023-02-27,505,oven,18490,24000,5510,1,00495,India
703372,2023-02-27,505,oven,18490,24000,5510,1,00495,India
703372,2023-02-27,506,monitor,3249,8000,4751,1,00495,India
703372,2023-02-27,504,iron,449,879,430,1,00495,India
512028,2023-02-27,504,iron,449,879,430,1,00075,India
512028,2023-02-27,501,iphone 15,60000,80000,20000,1,00075,India
512028,2023-02-27,506,monitor,3249,8000,4751,1,00075,India
504071,2023-02-27,505,oven,18490,24000,5510,1,00430,India
504071,2023-02-27,504,iron,449,879,430,1,00430,India
504071,2023-02-27,501,iphone 15,60000,80000,20000,1,00430,India
347070,2023-02-27,503,mixer,1349,3249,1900,1,00009,India
347070,2023-02-27,506,monitor,3249,8000,4751,1,00009,India
347070,2023-02-27,504,iron,449,879,430,1,00009,India
347070,2023-02-27,502,iphone 15 pro max,100000,135000,35000,1,00009,India
777428,2023-02-27,505,oven,18490,24000,5510,1,00339,India
777428,2023-02-27,503,mixer,1349,3249,1900,1,00339,India
265541,2023-02-27,505,oven,18490,24000,5510,1,00419,India
265541,2023-02-27,504,iron,449,879,430,1,00419,India
265541,2023-02-27,502,iphone 15 pro max,100000,135000,35000,1,00419,India
265541,2023-02-27,507,washing machine,6990,16490,9500,1,00419,India
272337,2023-02-27,501,iphone 15,60000,80000,20000,1,00287,India
814764,2023-02-27,503,mixer,1349,3249,1900,1,00222,India
814764,2023-02-27,506,monitor,3249,8000,4751,1,00222,India
814764,2023-02-27,505,oven,18490,24000,5510,1,00222,India
814764,2023-02-27,507,washing machine,6990,16490,9500,1,00222,India
603994,2023-02-27,504,iron,449,879,430,1,00171,India
625312,2023-02-27,504,iron,449,879,430,1,00033,India
625312,2023-02-27,506,monitor,3249,8000,4751,1,00033,India
756845,2023-02-27,506,monitor,3249,8000,4751,1,00356,India
756845,2023-02-27,503,mixer,1349,3249,1900,1,00356,India
756845,2023-02-27,504,iron,449,879,430,1,00356,India
756845,2023-02-27,505,oven,18490,24000,5510,1,00356,India
945155,2023-02-27,503,mixer,1349,3249,1900,1,00073,India
945155,2023-02-27,502,iphone 15 pro max,100000,135000,35000,1,00073,India
945155,2023-02-27,505,oven,18490,24000,5510,1,00073,India
624868,2023-02-27,505,oven,18490,24000,5510,1,00044,India
624868,2023-02-27,504,iron,449,879,430,1,00044,India
624868,2023-02-27,503,mixer,1349,3249,1900,1,00044,India
624868,2023-02-27,506,monitor,3249,8000,4751,1,00044,India
435894,2023-02-27,507,washing machine,6990,16490,9500,1,00099,India
435894,2023-02-27,504,iron,449,879,430,1,00099,India
435894,2023-02-27,506,monitor,3249,8000,4751,1,00099,India
435894,2023-02-27,503,mixer,1349,3249,1900,1,00099,India
844747,2023-02-27,504,iron,449,879,430,1,00469,India
473364,2023-02-27,506,monitor,3249,8000,4751,1,00410,India
473364,2023-02-27,502,iphone 15 pro max,100000,135000,35000,1,00410,India
947842,2023-02-27,502,iphone 15 pro max,100000,135000,35000,1,00382,India
947842,2023-02-27,504,iron,449,879,430,1,00382,India
947842,2023-02-27,503,mixer,1349,3249,1900,1,00382,India
947842,2023-02-27,501,iphone 15,60000,80000,20000,1,00382,India
194685,2023-02-27,503,mixer,1349,3249,1900,1,00005,India
194685,2023-02-27,502,iphone 15 pro max,100000,135000,35000,1,00005,India
639241,2023-02-27,501,iphone 15,60000,80000,20000,1,00443,India
639241,2023-02-27,504,iron,449,879,430,1,00443,India
574470,2023-02-27,503,mixer,1349,3249,1900,1,00324,India
574470,2023-02-27,504,iron,449,879,430,1,00324,India
574470,2023-02-27,505,oven,18490,24000,5510,1,00324,India
832767,2023-02-27,506,monitor,3249,8000,4751,1,00129,India
832767,2023-02-27,505,oven,18490,24000,5510,1,00129,India
832767,2023-02-27,504,iron,449,879,430,1,00129,India
832767,2023-02-27,503,mixer,1349,3249,1900,1,00129,India
898699,2023-02-27,502,iphone 15 pro max,100000,135000,35000,1,00143,India
898699,2023-02-27,504,iron,449,879,430,1,00143,India
898699,2023-02-27,501,iphone 15,60000,80000,20000,1,00143,India
898699,2023-02-27,503,mixer,1349,3249,1900,1,00143,India
898699,2023-02-27,507,washing machine,6990,16490,9500,1,00143,India
163479,2023-02-27,502,iphone 15 pro max,100000,135000,35000,1,00144,India
163479,2023-02-27,503,mixer,1349,3249,1900,1,00144,India
163479,2023-02-27,505,oven,18490,24000,5510,1,00144,India
163479,2023-02-27,507,washing machine,6990,16490,9500,1,00144,India
535516,2023-02-27,505,oven,18490,24000,5510,1,00190,India
755368,2023-02-27,503,mixer,1349,3249,1900,1,00346,India
602054,2023-02-27,504,iron,449,879,430,1,00041,India
602054,2023-02-27,507,washing machine,6990,16490,9500,1,00041,India
602054,2023-02-27,503,mixer,1349,3249,1900,1,00041,India
602054,2023-02-27,506,monitor,3249,8000,4751,1,00041,India
489320,2023-02-27,505,oven,18490,24000,5510,1,00439,India
489320,2023-02-27,503,mixer,1349,3249,1900,1,00439,India
489320,2023-02-27,507,washing machine,6990,16490,9500,1,00439,India
489320,2023-02-27,501,iphone 15,60000,80000,20000,1,00439,India
489320,2023-02-27,506,monitor,3249,8000,4751,1,00439,India
393061,2023-02-27,505,oven,18490,24000,5510,1,00199,India
393061,2023-02-27,503,mixer,1349,3249,1900,1,00199,India
393061,2023-02-27,506,monitor,3249,8000,4751,1,00199,India
393061,2023-02-27,507,washing machine,6990,16490,9500,1,00199,India
876013,2023-02-27,505,oven,18490,24000,5510,1,00436,India
876013,2023-02-27,502,iphone 15 pro max,100000,135000,35000,1,00436,India
216114,2023-02-27,503,mixer,1349,3249,1900,1,00408,India
216114,2023-02-27,504,iron,449,879,430,1,00408,India
592316,2023-02-27,505,oven,18490,24000,5510,1,00272,India
592316,2023-02-27,507,washing machine,6990,16490,9500,1,00272,India
592316,2023-02-27,503,mixer,1349,3249,1900,1,00272,India
592316,2023-02-27,504,iron,449,879,430,1,00272,India
592316,2023-02-27,506,monitor,3249,8000,4751,1,00272,India
627118,2023-02-27,502,iphone 15 pro max,100000,135000,35000,1,00357,India
388414,2023-02-27,503,mixer,1349,3249,1900,1,00452,India
388414,2023-02-27,505,oven,18490,24000,5510,1,00452,India
388414,2023-02-27,507,washing machine,6990,16490,9500,1,00452,India
388414,2023-02-27,502,iphone 15 pro max,100000,135000,35000,1,00452,India
866271,2023-02-27,506,monitor,3249,8000,4751,1,00077,India
866271,2023-02-27,502,iphone 15 pro max,100000,135000,35000,1,00077,India
866271,2023-02-27,504,iron,449,879,430,1,00077,India
495865,2023-02-27,501,iphone 15,60000,80000,20000,1,00209,India
760126,2023-02-27,501,iphone 15,60000,80000,20000,1,00284,India
760126,2023-02-27,504,iron,449,879,430,1,00284,India
358501,2023-02-27,504,iron,449,879,430,1,00367,India
358501,2023-02-27,507,washing machine,6990,16490,9500,1,00367,India
358501,2023-02-27,502,iphone 15 pro max,100000,135000,35000,1,00367,India
358501,2023-02-27,505,oven,18490,24000,5510,1,00367,India
641806,2023-02-27,501,iphone 15,60000,80000,20000,1,00287,India
641806,2023-02-27,507,washing machine,6990,16490,9500,1,00287,India
959463,2023-02-27,503,mixer,1349,3249,1900,1,00268,India
959463,2023-02-27,507,washing machine,6990,16490,9500,1,00268,India
959463,2023-02-27,501,iphone 15,60000,80000,20000,1,00268,India
818572,2023-02-27,507,washing machine,6990,16490,9500,1,00050,India
492529,2023-02-27,503,mixer,1349,3249,1900,1,00049,India
492529,2023-02-27,502,iphone 15 pro max,100000,135000,35000,1,00049,India
492529,2023-02-27,501,iphone 15,60000,80000,20000,1,00049,India
514386,2023-02-27,503,mixer,1349,3249,1900,1,00063,India
514386,2023-02-27,501,iphone 15,60000,80000,20000,1,00063,India
514386,2023-02-27,507,washing machine,6990,16490,9500,1,00063,India
244759,2023-02-27,506,monitor,3249,8000,4751,1,00359,India
244759,2023-02-27,503,mixer,1349,3249,1900,1,00359,India
244759,2023-02-27,505,oven,18490,24000,5510,1,00359,India
196595,2023-02-27,501,iphone 15,60000,80000,20000,1,00325,India
207169,2023-02-27,507,washing machine,6990,16490,9500,1,00141,India
207169,2023-02-27,506,monitor,3249,8000,4751,1,00141,India
207169,2023-02-27,501,iphone 15,60000,80000,20000,1,00141,India
876423,2023-02-27,501,iphone 15,60000,80000,20000,1,00469,India
876423,2023-02-27,504,iron,449,879,430,1,00469,India
479349,2023-02-27,501,iphone 15,60000,80000,20000,1,00315,India
498257,2023-02-27,502,iphone 15 pro max,100000,135000,35000,1,00206,India
498257,2023-02-27,507,washing machine,6990,16490,9500,1,00206,India
800568,2023-02-27,502,iphone 15 pro max,100000,135000,35000,1,00098,India
905514,2023-02-27,503,mixer,1349,3249,1900,1,00380,India
846837,2023-02-27,507,washing machine,6990,16490,9500,1,00179,India
846837,2023-02-27,501,iphone 15,60000,80000,20000,1,00179,India
846837,2023-02-27,505,oven,18490,24000,5510,1,00179,India
706286,2023-02-27,505,oven,18490,24000,5510,1,00144,India
706286,2023-02-27,506,monitor,3249,8000,4751,1,00144,India
706286,2023-02-27,502,iphone 15 pro max,100000,135000,35000,1,00144,India
706286,2023-02-27,504,iron,449,879,430,1,00144,India
706286,2023-02-27,501,iphone 15,60000,80000,20000,1,00144,India
695370,2023-02-27,501,iphone 15,60000,80000,20000,1,00370,India
695370,2023-02-27,503,mixer,1349,3249,1900,1,00370,India
809217,2023-02-27,502,iphone 15 pro max,100000,135000,35000,1,00109,India
809217,2023-02-27,503,mixer,1349,3249,1900,1,00109,India
809217,2023-02-27,504,iron,449,879,430,1,00109,India
389706,2023-02-27,507,washing machine,6990,16490,9500,1,00146,India
389706,2023-02-27,505,oven,18490,24000,5510,1,00146,India
108309,2023-02-27,501,iphone 15,60000,80000,20000,1,00448,India
108309,2023-02-27,506,monitor,3249,8000,4751,1,00448,India
108309,2023-02-27,502,iphone 15 pro max,100000,135000,35000,1,00448,India
947431,2023-02-27,504,iron,449,879,430,1,00242,India
947431,2023-02-27,502,iphone 15 pro max,100000,135000,35000,1,00242,India
947431,2023-02-27,506,monitor,3249,8000,4751,1,00242,India
947431,2023-02-27,505,oven,18490,24000,5510,1,00242,India
970997,2023-02-27,503,mixer,1349,3249,1900,1,00499,India
970997,2023-02-27,501,iphone 15,60000,80000,20000,1,00499,India
101389,2023-02-27,506,monitor,3249,8000,4751,1,00438,India
178418,2023-02-27,503,mixer,1349,3249,1900,1,00429,India
580724,2023-02-27,501,iphone 15,60000,80000,20000,1,00196,India
532749,2023-02-27,504,iron,449,879,430,1,00474,India
532749,2023-02-27,505,oven,18490,24000,5510,1,00474,India
897308,2023-02-27,501,iphone 15,60000,80000,20000,1,00256,India
897308,2023-02-27,507,washing machine,6990,16490,9500,1,00256,India
897308,2023-02-27,503,mixer,1349,3249,1900,1,00256,India
897308,2023-02-27,502,iphone 15 pro max,100000,135000,35000,1,00256,India
897308,2023-02-27,506,monitor,3249,8000,4751,1,00256,India
362380,2023-02-27,504,iron,449,879,430,1,00439,India
362380,2023-02-27,506,monitor,3249,8000,4751,1,00439,India
362380,2023-02-27,502,iphone 15 pro max,100000,135000,35000,1,00439,India
362380,2023-02-27,507,washing machine,6990,16490,9500,1,00439,India
583314,2023-02-27,504,iron,449,879,430,1,00457,India
583314,2023-02-27,506,monitor,3249,8000,4751,1,00457,India
583314,2023-02-27,501,iphone 15,60000,80000,20000,1,00457,India
604291,2023-02-27,507,washing machine,6990,16490,9500,1,00248,India
604291,2023-02-27,503,mixer,1349,3249,1900,1,00248,India
592965,2023-02-27,504,iron,449,879,430,1,00114,India
190180,2023-02-27,504,iron,449,879,430,1,00074,India
190180,2023-02-27,506,monitor,3249,8000,4751,1,00074,India
190180,2023-02-27,507,washing machine,6990,16490,9500,1,00074,India
190180,2023-02-27,503,mixer,1349,3249,1900,1,00074,India
765797,2023-02-27,506,monitor,3249,8000,4751,1,00213,India
872636,2023-02-27,506,monitor,3249,8000,4751,1,00123,India
872636,2023-02-27,504,iron,449,879,430,1,00123,India
872636,2023-02-27,505,oven,18490,24000,5510,1,00123,India
978744,2023-02-28,503,mixer,1349,3249,1900,1,00078,India
978744,2023-02-28,501,iphone 15,60000,80000,20000,1,00078,India
660758,2023-02-28,501,iphone 15,60000,80000,20000,1,00479,India
660758,2023-02-28,507,washing machine,6990,16490,9500,1,00479,India
259356,2023-02-28,501,iphone 15,60000,80000,20000,1,00107,India
719314,2023-02-28,503,mixer,1349,3249,1900,1,00005,India
719314,2023-02-28,507,washing machine,6990,16490,9500,1,00005,India
719314,2023-02-28,505,oven,18490,24000,5510,1,00005,India
719314,2023-02-28,502,iphone 15 pro max,100000,135000,35000,1,00005,India
671634,2023-02-28,502,iphone 15 pro max,100000,135000,35000,1,00289,India
671634,2023-02-28,506,monitor,3249,8000,4751,1,00289,India
671634,2023-02-28,505,oven,18490,24000,5510,1,00289,India
671634,2023-02-28,503,mixer,1349,3249,1900,1,00289,India
179473,2023-02-28,506,monitor,3249,8000,4751,1,00413,India
179473,2023-02-28,503,mixer,1349,3249,1900,1,00413,India
179473,2023-02-28,501,iphone 15,60000,80000,20000,1,00413,India
495991,2023-02-28,503,mixer,1349,3249,1900,1,00338,India
525452,2023-02-28,506,monitor,3249,8000,4751,1,00100,India
525452,2023-02-28,505,oven,18490,24000,5510,1,00100,India
525452,2023-02-28,501,iphone 15,60000,80000,20000,1,00100,India
498709,2023-02-28,506,monitor,3249,8000,4751,1,00335,India
498709,2023-02-28,501,iphone 15,60000,80000,20000,1,00335,India
498709,2023-02-28,503,mixer,1349,3249,1900,1,00335,India
619009,2023-02-28,501,iphone 15,60000,80000,20000,1,00227,India
619009,2023-02-28,502,iphone 15 pro max,100000,135000,35000,1,00227,India
619009,2023-02-28,504,iron,449,879,430,1,00227,India
619009,2023-02-28,506,monitor,3249,8000,4751,1,00227,India
681987,2023-02-28,507,washing machine,6990,16490,9500,1,00224,India
494621,2023-02-28,506,monitor,3249,8000,4751,1,00101,India
240236,2023-02-28,505,oven,18490,24000,5510,1,00144,India
981788,2023-02-28,503,mixer,1349,3249,1900,1,00033,India
742486,2023-02-28,506,monitor,3249,8000,4751,1,00421,India
485805,2023-02-28,507,washing machine,6990,16490,9500,1,00116,India
203128,2023-02-28,503,mixer,1349,3249,1900,1,00153,India
203128,2023-02-28,506,monitor,3249,8000,4751,1,00153,India
203128,2023-02-28,507,washing machine,6990,16490,9500,1,00153,India
689618,2023-02-28,506,monitor,3249,8000,4751,1,00295,India
451818,2023-02-28,507,washing machine,6990,16490,9500,1,00233,India
451818,2023-02-28,503,mixer,1349,3249,1900,1,00233,India
451818,2023-02-28,501,iphone 15,60000,80000,20000,1,00233,India
451818,2023-02-28,504,iron,449,879,430,1,00233,India
874901,2023-02-28,505,oven,18490,24000,5510,1,00138,India
874901,2023-02-28,504,iron,449,879,430,1,00138,India
874901,2023-02-28,502,iphone 15 pro max,100000,135000,35000,1,00138,India
874901,2023-02-28,503,mixer,1349,3249,1900,1,00138,India
225550,2023-02-28,503,mixer,1349,3249,1900,1,00017,India
225550,2023-02-28,507,washing machine,6990,16490,9500,1,00017,India
225550,2023-02-28,502,iphone 15 pro max,100000,135000,35000,1,00017,India
454279,2023-02-28,507,washing machine,6990,16490,9500,1,00327,India
454279,2023-02-28,503,mixer,1349,3249,1900,1,00327,India
454279,2023-02-28,506,monitor,3249,8000,4751,1,00327,India
454279,2023-02-28,501,iphone 15,60000,80000,20000,1,00327,India
463922,2023-02-28,503,mixer,1349,3249,1900,1,00297,India
463922,2023-02-28,505,oven,18490,24000,5510,1,00297,India
463922,2023-02-28,502,iphone 15 pro max,100000,135000,35000,1,00297,India
463922,2023-02-28,504,iron,449,879,430,1,00297,India
776236,2023-02-28,504,iron,449,879,430,1,00310,India
134111,2023-02-28,504,iron,449,879,430,1,00496,India
134111,2023-02-28,503,mixer,1349,3249,1900,1,00496,India
134111,2023-02-28,505,oven,18490,24000,5510,1,00496,India
134111,2023-02-28,502,iphone 15 pro max,100000,135000,35000,1,00496,India
134111,2023-02-28,506,monitor,3249,8000,4751,1,00496,India
450736,2023-02-28,507,washing machine,6990,16490,9500,1,00313,India
450736,2023-02-28,506,monitor,3249,8000,4751,1,00313,India
450736,2023-02-28,505,oven,18490,24000,5510,1,00313,India
956718,2023-02-28,502,iphone 15 pro max,100000,135000,35000,1,00081,India
956718,2023-02-28,506,monitor,3249,8000,4751,1,00081,India
956718,2023-02-28,507,washing machine,6990,16490,9500,1,00081,India
224095,2023-02-28,502,iphone 15 pro max,100000,135000,35000,1,00445,India
224095,2023-02-28,507,washing machine,6990,16490,9500,1,00445,India
169360,2023-02-28,501,iphone 15,60000,80000,20000,1,00044,India
169360,2023-02-28,507,washing machine,6990,16490,9500,1,00044,India
583465,2023-02-28,503,mixer,1349,3249,1900,1,00148,India
583465,2023-02-28,507,washing machine,6990,16490,9500,1,00148,India
583465,2023-02-28,505,oven,18490,24000,5510,1,00148,India
583465,2023-02-28,502,iphone 15 pro max,100000,135000,35000,1,00148,India
473005,2023-02-28,501,iphone 15,60000,80000,20000,1,00023,India
575297,2023-02-28,505,oven,18490,24000,5510,1,00265,India
262711,2023-02-28,501,iphone 15,60000,80000,20000,1,00235,India
840605,2023-02-28,504,iron,449,879,430,1,00037,India
840605,2023-02-28,503,mixer,1349,3249,1900,1,00037,India
840605,2023-02-28,502,iphone 15 pro max,100000,135000,35000,1,00037,India
442726,2023-02-28,505,oven,18490,24000,5510,1,00146,India
442726,2023-02-28,503,mixer,1349,3249,1900,1,00146,India
442726,2023-02-28,502,iphone 15 pro max,100000,135000,35000,1,00146,India
364326,2023-02-28,503,mixer,1349,3249,1900,1,00007,India
364326,2023-02-28,504,iron,449,879,430,1,00007,India
786466,2023-02-28,502,iphone 15 pro max,100000,135000,35000,1,00374,India
786466,2023-02-28,504,iron,449,879,430,1,00374,India
786466,2023-02-28,501,iphone 15,60000,80000,20000,1,00374,India
786466,2023-02-28,507,washing machine,6990,16490,9500,1,00374,India
786466,2023-02-28,506,monitor,3249,8000,4751,1,00374,India
925576,2023-02-28,507,washing machine,6990,16490,9500,1,00120,India
925576,2023-02-28,503,mixer,1349,3249,1900,1,00120,India
925576,2023-02-28,501,iphone 15,60000,80000,20000,1,00120,India
925576,2023-02-28,502,iphone 15 pro max,100000,135000,35000,1,00120,India
199222,2023-02-28,503,mixer,1349,3249,1900,1,00217,India
284205,2023-02-28,502,iphone 15 pro max,100000,135000,35000,1,00188,India
284205,2023-02-28,503,mixer,1349,3249,1900,1,00188,India
284205,2023-02-28,506,monitor,3249,8000,4751,1,00188,India
284205,2023-02-28,501,iphone 15,60000,80000,20000,1,00188,India
664855,2023-02-28,504,iron,449,879,430,1,00110,India
664855,2023-02-28,506,monitor,3249,8000,4751,1,00110,India
664855,2023-02-28,503,mixer,1349,3249,1900,1,00110,India
260054,2023-02-28,507,washing machine,6990,16490,9500,1,00089,India
260054,2023-02-28,501,iphone 15,60000,80000,20000,1,00089,India
260054,2023-02-28,506,monitor,3249,8000,4751,1,00089,India
140236,2023-02-28,505,oven,18490,24000,5510,1,00230,India
140236,2023-02-28,507,washing machine,6990,16490,9500,1,00230,India
652625,2023-02-28,507,washing machine,6990,16490,9500,1,00342,India
652625,2023-02-28,501,iphone 15,60000,80000,20000,1,00342,India
993209,2023-02-28,507,washing machine,6990,16490,9500,1,00155,India
993209,2023-02-28,503,mixer,1349,3249,1900,1,00155,India
730435,2023-02-28,507,washing machine,6990,16490,9500,1,00493,India
730435,2023-02-28,501,iphone 15,60000,80000,20000,1,00493,India
730435,2023-02-28,503,mixer,1349,3249,1900,1,00493,India
730435,2023-02-28,504,iron,449,879,430,1,00493,India
943180,2023-02-28,502,iphone 15 pro max,100000,135000,35000,1,00297,India
943180,2023-02-28,503,mixer,1349,3249,1900,1,00297,India
943180,2023-02-28,501,iphone 15,60000,80000,20000,1,00297,India
915321,2023-02-28,502,iphone 15 pro max,100000,135000,35000,1,00086,India
915321,2023-02-28,505,oven,18490,24000,5510,1,00086,India
813520,2023-02-28,506,monitor,3249,8000,4751,1,00331,India
813520,2023-02-28,503,mixer,1349,3249,1900,1,00331,India
278611,2023-02-28,502,iphone 15 pro max,100000,135000,35000,1,00443,India
278611,2023-02-28,501,iphone 15,60000,80000,20000,1,00443,India
278611,2023-02-28,505,oven,18490,24000,5510,1,00443,India
829292,2023-02-28,502,iphone 15 pro max,100000,135000,35000,1,00015,India
829292,2023-02-28,507,washing machine,6990,16490,9500,1,00015,India
971960,2023-02-28,503,mixer,1349,3249,1900,1,00334,India
971960,2023-02-28,502,iphone 15 pro max,100000,135000,35000,1,00334,India
971960,2023-02-28,504,iron,449,879,430,1,00334,India
175221,2023-02-28,506,monitor,3249,8000,4751,1,00391,India
858924,2023-02-28,507,washing machine,6990,16490,9500,1,00454,India
213895,2023-02-28,501,iphone 15,60000,80000,20000,1,00311,India
213895,2023-02-28,507,washing machine,6990,16490,9500,1,00311,India
213895,2023-02-28,506,monitor,3249,8000,4751,1,00311,India
126027,2023-02-28,505,oven,18490,24000,5510,1,00386,India
126027,2023-02-28,502,iphone 15 pro max,100000,135000,35000,1,00386,India
719705,2023-02-28,502,iphone 15 pro max,100000,135000,35000,1,00207,India
719705,2023-02-28,507,washing machine,6990,16490,9500,1,00207,India
719705,2023-02-28,504,iron,449,879,430,1,00207,India
719705,2023-02-28,501,iphone 15,60000,80000,20000,1,00207,India
749631,2023-02-28,506,monitor,3249,8000,4751,1,00181,India
749631,2023-02-28,504,iron,449,879,430,1,00181,India
749631,2023-02-28,507,washing machine,6990,16490,9500,1,00181,India
162747,2023-02-28,504,iron,449,879,430,1,00230,India
162747,2023-02-28,507,washing machine,6990,16490,9500,1,00230,India
162747,2023-02-28,502,iphone 15 pro max,100000,135000,35000,1,00230,India
162747,2023-02-28,506,monitor,3249,8000,4751,1,00230,India
357857,2023-02-28,506,monitor,3249,8000,4751,1,00446,India
703271,2023-02-28,507,washing machine,6990,16490,9500,1,00065,India
506768,2023-02-28,504,iron,449,879,430,1,00257,India
506768,2023-02-28,502,iphone 15 pro max,100000,135000,35000,1,00257,India
506768,2023-02-28,507,washing machine,6990,16490,9500,1,00257,India
506768,2023-02-28,501,iphone 15,60000,80000,20000,1,00257,India
615272,2023-02-28,501,iphone 15,60000,80000,20000,1,00331,India
615272,2023-02-28,507,washing machine,6990,16490,9500,1,00331,India
615272,2023-02-28,502,iphone 15 pro max,100000,135000,35000,1,00331,India
520350,2023-02-28,507,washing machine,6990,16490,9500,1,00202,India
812000,2023-02-28,505,oven,18490,24000,5510,1,00081,India
812000,2023-02-28,502,iphone 15 pro max,100000,135000,35000,1,00081,India
812000,2023-02-28,501,iphone 15,60000,80000,20000,1,00081,India
224219,2023-02-28,501,iphone 15,60000,80000,20000,1,00190,India
224219,2023-02-28,507,washing machine,6990,16490,9500,1,00190,India
224219,2023-02-28,503,mixer,1349,3249,1900,1,00190,India
927228,2023-02-28,507,washing machine,6990,16490,9500,1,00207,India
684542,2023-02-28,506,monitor,3249,8000,4751,1,00250,India
684542,2023-02-28,504,iron,449,879,430,1,00250,India
514096,2023-02-28,502,iphone 15 pro max,100000,135000,35000,1,00031,India
974218,2023-02-28,503,mixer,1349,3249,1900,1,00471,India
974218,2023-02-28,502,iphone 15 pro max,100000,135000,35000,1,00471,India
541719,2023-02-28,504,iron,449,879,430,1,00153,India
541719,2023-02-28,502,iphone 15 pro max,100000,135000,35000,1,00153,India
541719,2023-02-28,507,washing machine,6990,16490,9500,1,00153,India
964540,2023-02-28,506,monitor,3249,8000,4751,1,00344,India
964540,2023-02-28,502,iphone 15 pro max,100000,135000,35000,1,00344,India
964540,2023-02-28,504,iron,449,879,430,1,00344,India
169625,2023-02-28,506,monitor,3249,8000,4751,1,00365,India
169625,2023-02-28,507,washing machine,6990,16490,9500,1,00365,India
523717,2023-02-28,503,mixer,1349,3249,1900,1,00284,India
523717,2023-02-28,505,oven,18490,24000,5510,1,00284,India
523717,2023-02-28,501,iphone 15,60000,80000,20000,1,00284,India
464730,2023-02-28,501,iphone 15,60000,80000,20000,1,00286,India
464730,2023-02-28,505,oven,18490,24000,5510,1,00286,India
464730,2023-02-28,502,iphone 15 pro max,100000,135000,35000,1,00286,India
464730,2023-02-28,507,washing machine,6990,16490,9500,1,00286,India
118552,2023-02-28,502,iphone 15 pro max,100000,135000,35000,1,00330,India
328117,2023-02-28,507,washing machine,6990,16490,9500,1,00465,India
328117,2023-02-28,504,iron,449,879,430,1,00465,India
328117,2023-02-28,505,oven,18490,24000,5510,1,00465,India
291247,2023-02-28,503,mixer,1349,3249,1900,1,00489,India
291247,2023-02-28,501,iphone 15,60000,80000,20000,1,00489,India
291247,2023-02-28,502,iphone 15 pro max,100000,135000,35000,1,00489,India
107814,2023-02-28,506,monitor,3249,8000,4751,1,00465,India
107814,2023-02-28,503,mixer,1349,3249,1900,1,00465,India
996324,2023-03-01,505,oven,18490,24000,5510,1,00063,India
996324,2023-03-01,501,iphone 15,60000,80000,20000,1,00063,India
359669,2023-03-01,503,mixer,1349,3249,1900,1,00040,India
359669,2023-03-01,502,iphone 15 pro max,100000,135000,35000,1,00040,India
359669,2023-03-01,507,washing machine,6990,16490,9500,1,00040,India
359669,2023-03-01,504,iron,449,879,430,1,00040,India
175204,2023-03-01,501,iphone 15,60000,80000,20000,1,00330,India
175204,2023-03-01,503,mixer,1349,3249,1900,1,00330,India
218115,2023-03-01,501,iphone 15,60000,80000,20000,1,00360,India
160830,2023-03-01,502,iphone 15 pro max,100000,135000,35000,1,00190,India
160830,2023-03-01,506,monitor,3249,8000,4751,1,00190,India
760121,2023-03-01,502,iphone 15 pro max,100000,135000,35000,1,00295,India
182752,2023-03-01,503,mixer,1349,3249,1900,1,00434,India
182752,2023-03-01,502,iphone 15 pro max,100000,135000,35000,1,00434,India
214302,2023-03-01,502,iphone 15 pro max,100000,135000,35000,1,00344,India
214302,2023-03-01,501,iphone 15,60000,80000,20000,1,00344,India
214302,2023-03-01,504,iron,449,879,430,1,00344,India
214302,2023-03-01,507,washing machine,6990,16490,9500,1,00344,India
949857,2023-03-01,502,iphone 15 pro max,100000,135000,35000,1,00262,India
743529,2023-03-01,506,monitor,3249,8000,4751,1,00122,India
743529,2023-03-01,503,mixer,1349,3249,1900,1,00122,India
341582,2023-03-01,506,monitor,3249,8000,4751,1,00122,India
341582,2023-03-01,501,iphone 15,60000,80000,20000,1,00122,India
593870,2023-03-01,501,iphone 15,60000,80000,20000,1,00220,India
593870,2023-03-01,506,monitor,3249,8000,4751,1,00220,India
593870,2023-03-01,507,washing machine,6990,16490,9500,1,00220,India
404925,2023-03-01,506,monitor,3249,8000,4751,1,00340,India
404925,2023-03-01,501,iphone 15,60000,80000,20000,1,00340,India
404925,2023-03-01,505,oven,18490,24000,5510,1,00340,India
973155,2023-03-01,504,iron,449,879,430,1,00061,India
973155,2023-03-01,506,monitor,3249,8000,4751,1,00061,India
646415,2023-03-01,501,iphone 15,60000,80000,20000,1,00310,India
646415,2023-03-01,506,monitor,3249,8000,4751,1,00310,India
646415,2023-03-01,505,oven,18490,24000,5510,1,00310,India
879668,2023-03-01,503,mixer,1349,3249,1900,1,00189,India
879668,2023-03-01,502,iphone 15 pro max,100000,135000,35000,1,00189,India
987008,2023-03-01,507,washing machine,6990,16490,9500,1,00260,India
406905,2023-03-01,506,monitor,3249,8000,4751,1,00286,India
406905,2023-03-01,502,iphone 15 pro max,100000,135000,35000,1,00286,India
353810,2023-03-01,503,mixer,1349,3249,1900,1,00072,India
353810,2023-03-01,506,monitor,3249,8000,4751,1,00072,India
353810,2023-03-01,502,iphone 15 pro max,100000,135000,35000,1,00072,India
346904,2023-03-01,504,iron,449,879,430,1,00429,India
346904,2023-03-01,505,oven,18490,24000,5510,1,00429,India
666492,2023-03-01,503,mixer,1349,3249,1900,1,00442,India
666492,2023-03-01,505,oven,18490,24000,5510,1,00442,India
666492,2023-03-01,501,iphone 15,60000,80000,20000,1,00442,India
311682,2023-03-01,507,washing machine,6990,16490,9500,1,00278,India
450676,2023-03-01,506,monitor,3249,8000,4751,1,00290,India
450676,2023-03-01,502,iphone 15 pro max,100000,135000,35000,1,00290,India
624886,2023-03-01,505,oven,18490,24000,5510,1,00120,India
624886,2023-03-01,507,washing machine,6990,16490,9500,1,00120,India
299882,2023-03-01,504,iron,449,879,430,1,00301,India
299882,2023-03-01,503,mixer,1349,3249,1900,1,00301,India
299882,2023-03-01,507,washing machine,6990,16490,9500,1,00301,India
299882,2023-03-01,502,iphone 15 pro max,100000,135000,35000,1,00301,India
982432,2023-03-01,503,mixer,1349,3249,1900,1,00152,India
982432,2023-03-01,504,iron,449,879,430,1,00152,India
996915,2023-03-01,504,iron,449,879,430,1,00107,India
996915,2023-03-01,502,iphone 15 pro max,100000,135000,35000,1,00107,India
996915,2023-03-01,505,oven,18490,24000,5510,1,00107,India
259508,2023-03-01,504,iron,449,879,430,1,00358,India
259508,2023-03-01,503,mixer,1349,3249,1900,1,00358,India
259508,2023-03-01,507,washing machine,6990,16490,9500,1,00358,India
355501,2023-03-01,507,washing machine,6990,16490,9500,1,00120,India
355501,2023-03-01,504,iron,449,879,430,1,00120,India
892279,2023-03-01,503,mixer,1349,3249,1900,1,00132,India
501443,2023-03-01,506,monitor,3249,8000,4751,1,00466,India
501443,2023-03-01,502,iphone 15 pro max,100000,135000,35000,1,00466,India
501443,2023-03-01,505,oven,18490,24000,5510,1,00466,India
501443,2023-03-01,503,mixer,1349,3249,1900,1,00466,India
414714,2023-03-01,503,mixer,1349,3249,1900,1,00465,India
208346,2023-03-01,505,oven,18490,24000,5510,1,00169,India
208346,2023-03-01,506,monitor,3249,8000,4751,1,00169,India
591187,2023-03-01,504,iron,449,879,430,1,00025,India
591187,2023-03-01,501,iphone 15,60000,80000,20000,1,00025,India
135423,2023-03-01,507,washing machine,6990,16490,9500,1,00164,India
135423,2023-03-01,503,mixer,1349,3249,1900,1,00164,India
135423,2023-03-01,506,monitor,3249,8000,4751,1,00164,India
135423,2023-03-01,502,iphone 15 pro max,100000,135000,35000,1,00164,India
787734,2023-03-01,502,iphone 15 pro max,100000,135000,35000,1,00494,India
787734,2023-03-01,507,washing machine,6990,16490,9500,1,00494,India
787734,2023-03-01,503,mixer,1349,3249,1900,1,00494,India
787734,2023-03-01,501,iphone 15,60000,80000,20000,1,00494,India
789457,2023-03-01,507,washing machine,6990,16490,9500,1,00220,India
943318,2023-03-01,504,iron,449,879,430,1,00363,India
429023,2023-03-01,503,mixer,1349,3249,1900,1,00482,India
429023,2023-03-01,505,oven,18490,24000,5510,1,00482,India
429023,2023-03-01,504,iron,449,879,430,1,00482,India
529195,2023-03-01,505,oven,18490,24000,5510,1,00329,India
529195,2023-03-01,502,iphone 15 pro max,100000,135000,35000,1,00329,India
529195,2023-03-01,503,mixer,1349,3249,1900,1,00329,India
529195,2023-03-01,504,iron,449,879,430,1,00329,India
270435,2023-03-01,501,iphone 15,60000,80000,20000,1,00095,India
270435,2023-03-01,505,oven,18490,24000,5510,1,00095,India
270435,2023-03-01,503,mixer,1349,3249,1900,1,00095,India
756902,2023-03-01,506,monitor,3249,8000,4751,1,00227,India
756902,2023-03-01,507,washing machine,6990,16490,9500,1,00227,India
756902,2023-03-01,501,iphone 15,60000,80000,20000,1,00227,India
756902,2023-03-01,503,mixer,1349,3249,1900,1,00227,India
454085,2023-03-01,507,washing machine,6990,16490,9500,1,00467,India
454085,2023-03-01,504,iron,449,879,430,1,00467,India
454085,2023-03-01,503,mixer,1349,3249,1900,1,00467,India
968870,2023-03-01,501,iphone 15,60000,80000,20000,1,00389,India
968870,2023-03-01,506,monitor,3249,8000,4751,1,00389,India
968870,2023-03-01,502,iphone 15 pro max,100000,135000,35000,1,00389,India
968870,2023-03-01,507,washing machine,6990,16490,9500,1,00389,India
734892,2023-03-01,507,washing machine,6990,16490,9500,1,00104,India
734892,2023-03-01,502,iphone 15 pro max,100000,135000,35000,1,00104,India
734892,2023-03-01,506,monitor,3249,8000,4751,1,00104,India
734892,2023-03-01,504,iron,449,879,430,1,00104,India
734892,2023-03-01,503,mixer,1349,3249,1900,1,00104,India
272240,2023-03-01,505,oven,18490,24000,5510,1,00308,India
272240,2023-03-01,504,iron,449,879,430,1,00308,India
328718,2023-03-01,504,iron,449,879,430,1,00482,India
328718,2023-03-01,507,washing machine,6990,16490,9500,1,00482,India
328718,2023-03-01,505,oven,18490,24000,5510,1,00482,India
507524,2023-03-01,506,monitor,3249,8000,4751,1,00433,India
507524,2023-03-01,507,washing machine,6990,16490,9500,1,00433,India
507524,2023-03-01,505,oven,18490,24000,5510,1,00433,India
390994,2023-03-01,504,iron,449,879,430,1,00248,India
381952,2023-03-01,503,mixer,1349,3249,1900,1,00465,India
381952,2023-03-01,501,iphone 15,60000,80000,20000,1,00465,India
381952,2023-03-01,507,washing machine,6990,16490,9500,1,00465,India
381952,2023-03-01,504,iron,449,879,430,1,00465,India
212754,2023-03-01,506,monitor,3249,8000,4751,1,00135,India
212754,2023-03-01,501,iphone 15,60000,80000,20000,1,00135,India
212754,2023-03-01,505,oven,18490,24000,5510,1,00135,India
655939,2023-03-01,503,mixer,1349,3249,1900,1,00159,India
655939,2023-03-01,505,oven,18490,24000,5510,1,00159,India
655939,2023-03-01,501,iphone 15,60000,80000,20000,1,00159,India
655939,2023-03-01,507,washing machine,6990,16490,9500,1,00159,India
306570,2023-03-01,501,iphone 15,60000,80000,20000,1,00287,India
990842,2023-03-01,507,washing machine,6990,16490,9500,1,00144,India
990842,2023-03-01,505,oven,18490,24000,5510,1,00144,India
990842,2023-03-01,503,mixer,1349,3249,1900,1,00144,India
442869,2023-03-01,501,iphone 15,60000,80000,20000,1,00371,India
442869,2023-03-01,502,iphone 15 pro max,100000,135000,35000,1,00371,India
680417,2023-03-01,502,iphone 15 pro max,100000,135000,35000,1,00291,India
680417,2023-03-01,505,oven,18490,24000,5510,1,00291,India
680417,2023-03-01,503,mixer,1349,3249,1900,1,00291,India
152959,2023-03-01,504,iron,449,879,430,1,00434,India
791034,2023-03-01,506,monitor,3249,8000,4751,1,00243,India
151493,2023-03-01,501,iphone 15,60000,80000,20000,1,00064,India
452798,2023-03-01,502,iphone 15 pro max,100000,135000,35000,1,00458,India
452798,2023-03-01,507,washing machine,6990,16490,9500,1,00458,India
325795,2023-03-01,507,washing machine,6990,16490,9500,1,00056,India
325795,2023-03-01,505,oven,18490,24000,5510,1,00056,India
680638,2023-03-01,503,mixer,1349,3249,1900,1,00031,India
772529,2023-03-01,502,iphone 15 pro max,100000,135000,35000,1,00154,India
772529,2023-03-01,507,washing machine,6990,16490,9500,1,00154,India
818777,2023-03-01,504,iron,449,879,430,1,00229,India
818777,2023-03-01,502,iphone 15 pro max,100000,135000,35000,1,00229,India
818777,2023-03-01,501,iphone 15,60000,80000,20000,1,00229,India
578638,2023-03-01,506,monitor,3249,8000,4751,1,00345,India
578638,2023-03-01,505,oven,18490,24000,5510,1,00345,India
578638,2023-03-01,502,iphone 15 pro max,100000,135000,35000,1,00345,India
578638,2023-03-01,504,iron,449,879,430,1,00345,India
893274,2023-03-01,507,washing machine,6990,16490,9500,1,00370,India
438786,2023-03-01,501,iphone 15,60000,80000,20000,1,00204,India
273351,2023-03-01,506,monitor,3249,8000,4751,1,00252,India
273351,2023-03-01,507,washing machine,6990,16490,9500,1,00252,India
273351,2023-03-01,502,iphone 15 pro max,100000,135000,35000,1,00252,India
273351,2023-03-01,503,mixer,1349,3249,1900,1,00252,India
612417,2023-03-01,501,iphone 15,60000,80000,20000,1,00301,India
612417,2023-03-01,505,oven,18490,24000,5510,1,00301,India
612417,2023-03-01,504,iron,449,879,430,1,00301,India
884170,2023-03-01,502,iphone 15 pro max,100000,135000,35000,1,00122,India
550310,2023-03-01,506,monitor,3249,8000,4751,1,00194,India
338624,2023-03-01,507,washing machine,6990,16490,9500,1,00196,India
338624,2023-03-01,502,iphone 15 pro max,100000,135000,35000,1,00196,India
338624,2023-03-01,501,iphone 15,60000,80000,20000,1,00196,India
338624,2023-03-01,506,monitor,3249,8000,4751,1,00196,India
893240,2023-03-01,503,mixer,1349,3249,1900,1,00428,India
893240,2023-03-01,506,monitor,3249,8000,4751,1,00428,India
893240,2023-03-01,507,washing machine,6990,16490,9500,1,00428,India
883234,2023-03-01,503,mixer,1349,3249,1900,1,00293,India
883234,2023-03-01,502,iphone 15 pro max,100000,135000,35000,1,00293,India
883234,2023-03-01,504,iron,449,879,430,1,00293,India
883234,2023-03-01,506,monitor,3249,8000,4751,1,00293,India
396172,2023-03-01,506,monitor,3249,8000,4751,1,00162,India
396172,2023-03-01,502,iphone 15 pro max,100000,135000,35000,1,00162,India
396172,2023-03-01,504,iron,449,879,430,1,00162,India
848655,2023-03-01,504,iron,449,879,430,1,00365,India
848655,2023-03-01,507,washing machine,6990,16490,9500,1,00365,India
848655,2023-03-01,503,mixer,1349,3249,1900,1,00365,India
420043,2023-03-01,506,monitor,3249,8000,4751,1,00301,India
420043,2023-03-01,505,oven,18490,24000,5510,1,00301,India
689787,2023-03-01,502,iphone 15 pro max,100000,135000,35000,1,00434,India
689787,2023-03-01,506,monitor,3249,8000,4751,1,00434,India
689787,2023-03-01,501,iphone 15,60000,80000,20000,1,00434,India
934894,2023-03-01,502,iphone 15 pro max,100000,135000,35000,1,00168,India
922079,2023-03-01,503,mixer,1349,3249,1900,1,00424,India
922079,2023-03-01,506,monitor,3249,8000,4751,1,00424,India
922079,2023-03-01,501,iphone 15,60000,80000,20000,1,00424,India
620461,2023-03-01,503,mixer,1349,3249,1900,1,00160,India
620461,2023-03-01,507,washing machine,6990,16490,9500,1,00160,India
620461,2023-03-01,506,monitor,3249,8000,4751,1,00160,India
620461,2023-03-01,504,iron,449,879,430,1,00160,India
193303,2023-03-01,505,oven,18490,24000,5510,1,00230,India
926077,2023-03-01,503,mixer,1349,3249,1900,1,00373,India
709621,2023-03-01,503,mixer,1349,3249,1900,1,00103,India
709621,2023-03-01,506,monitor,3249,8000,4751,1,00103,India
709621,2023-03-01,504,iron,449,879,430,1,00103,India
709621,2023-03-01,501,iphone 15,60000,80000,20000,1,00103,India
584014,2023-03-01,501,iphone 15,60000,80000,20000,1,00293,India
584014,2023-03-01,504,iron,449,879,430,1,00293,India
584014,2023-03-01,507,washing machine,6990,16490,9500,1,00293,India
547293,2023-03-01,503,mixer,1349,3249,1900,1,00054,India
547293,2023-03-01,502,iphone 15 pro max,100000,135000,35000,1,00054,India
547293,2023-03-01,507,washing machine,6990,16490,9500,1,00054,India
789131,2023-03-01,506,monitor,3249,8000,4751,1,00326,India
789131,2023-03-01,505,oven,18490,24000,5510,1,00326,India
789131,2023-03-01,502,iphone 15 pro max,100000,135000,35000,1,00326,India
789131,2023-03-01,507,washing machine,6990,16490,9500,1,00326,India
228424,2023-03-01,507,washing machine,6990,16490,9500,1,00038,India
228424,2023-03-01,502,iphone 15 pro max,100000,135000,35000,1,00038,India
723882,2023-03-01,502,iphone 15 pro max,100000,135000,35000,1,00368,India
474151,2023-03-01,505,oven,18490,24000,5510,1,00199,India
474151,2023-03-01,507,washing machine,6990,16490,9500,1,00199,India
474151,2023-03-01,504,iron,449,879,430,1,00199,India
474151,2023-03-01,503,mixer,1349,3249,1900,1,00199,India
271607,2023-03-01,502,iphone 15 pro max,100000,135000,35000,1,00088,India
271607,2023-03-01,503,mixer,1349,3249,1900,1,00088,India
271607,2023-03-01,505,oven,18490,24000,5510,1,00088,India
475622,2023-03-01,503,mixer,1349,3249,1900,1,00403,India
475622,2023-03-01,502,iphone 15 pro max,100000,135000,35000,1,00403,India
120618,2023-03-01,504,iron,449,879,430,1,00041,India
120618,2023-03-01,502,iphone 15 pro max,100000,135000,35000,1,00041,India
120618,2023-03-01,506,monitor,3249,8000,4751,1,00041,India
120618,2023-03-01,507,washing machine,6990,16490,9500,1,00041,India
257664,2023-03-01,506,monitor,3249,8000,4751,1,00389,India
257664,2023-03-01,507,washing machine,6990,16490,9500,1,00389,India
595271,2023-03-01,507,washing machine,6990,16490,9500,1,00264,India
595271,2023-03-01,504,iron,449,879,430,1,00264,India
595271,2023-03-01,503,mixer,1349,3249,1900,1,00264,India
815699,2023-03-01,502,iphone 15 pro max,100000,135000,35000,1,00112,India
815699,2023-03-01,503,mixer,1349,3249,1900,1,00112,India
815699,2023-03-01,504,iron,449,879,430,1,00112,India
946841,2023-03-01,505,oven,18490,24000,5510,1,00344,India
946841,2023-03-01,506,monitor,3249,8000,4751,1,00344,India
946841,2023-03-01,504,iron,449,879,430,1,00344,India
900665,2023-03-01,505,oven,18490,24000,5510,1,00100,India
362819,2023-03-01,502,iphone 15 pro max,100000,135000,35000,1,00134,India
955398,2023-03-01,504,iron,449,879,430,1,00316,India
375843,2023-03-02,507,washing machine,6990,16490,9500,1,00106,India
375843,2023-03-02,502,iphone 15 pro max,100000,135000,35000,1,00106,India
375843,2023-03-02,503,mixer,1349,3249,1900,1,00106,India
222165,2023-03-02,506,monitor,3249,8000,4751,1,00381,India
222165,2023-03-02,502,iphone 15 pro max,100000,135000,35000,1,00381,India
222165,2023-03-02,505,oven,18490,24000,5510,1,00381,India
222165,2023-03-02,501,iphone 15,60000,80000,20000,1,00381,India
762444,2023-03-02,502,iphone 15 pro max,100000,135000,35000,1,00403,India
620336,2023-03-02,504,iron,449,879,430,1,00355,India
620336,2023-03-02,502,iphone 15 pro max,100000,135000,35000,1,00355,India
620336,2023-03-02,501,iphone 15,60000,80000,20000,1,00355,India
620336,2023-03-02,506,monitor,3249,8000,4751,1,00355,India
695164,2023-03-02,504,iron,449,879,430,1,00293,India
695164,2023-03-02,503,mixer,1349,3249,1900,1,00293,India
486999,2023-03-02,503,mixer,1349,3249,1900,1,00300,India
486999,2023-03-02,501,iphone 15,60000,80000,20000,1,00300,India
486999,2023-03-02,504,iron,449,879,430,1,00300,India
486999,2023-03-02,505,oven,18490,24000,5510,1,00300,India
486999,2023-03-02,502,iphone 15 pro max,100000,135000,35000,1,00300,India
842803,2023-03-02,503,mixer,1349,3249,1900,1,00425,India
842803,2023-03-02,502,iphone 15 pro max,100000,135000,35000,1,00425,India
842803,2023-03-02,505,oven,18490,24000,5510,1,00425,India
475726,2023-03-02,502,iphone 15 pro max,100000,135000,35000,1,00068,India
648197,2023-03-02,503,mixer,1349,3249,1900,1,00448,India
623984,2023-03-02,507,washing machine,6990,16490,9500,1,00465,India
623984,2023-03-02,505,oven,18490,24000,5510,1,00465,India
623984,2023-03-02,506,monitor,3249,8000,4751,1,00465,India
623984,2023-03-02,504,iron,449,879,430,1,00465,India
777446,2023-03-02,506,monitor,3249,8000,4751,1,00186,India
724310,2023-03-02,502,iphone 15 pro max,100000,135000,35000,1,00383,India
724310,2023-03-02,503,mixer,1349,3249,1900,1,00383,India
439718,2023-03-02,504,iron,449,879,430,1,00179,India
439718,2023-03-02,501,iphone 15,60000,80000,20000,1,00179,India
188685,2023-03-02,504,iron,449,879,430,1,00026,India
188685,2023-03-02,502,iphone 15 pro max,100000,135000,35000,1,00026,India
188685,2023-03-02,501,iphone 15,60000,80000,20000,1,00026,India
924963,2023-03-02,505,oven,18490,24000,5510,1,00125,India
924963,2023-03-02,503,mixer,1349,3249,1900,1,00125,India
862360,2023-03-02,507,washing machine,6990,16490,9500,1,00244,India
772536,2023-03-02,501,iphone 15,60000,80000,20000,1,00218,India
772536,2023-03-02,506,monitor,3249,8000,4751,1,00218,India
772536,2023-03-02,505,oven,18490,24000,5510,1,00218,India
738551,2023-03-02,505,oven,18490,24000,5510,1,00032,India
369819,2023-03-02,505,oven,18490,24000,5510,1,00050,India
369819,2023-03-02,502,iphone 15 pro max,100000,135000,35000,1,00050,India
589991,2023-03-02,502,iphone 15 pro max,100000,135000,35000,1,00395,India
589991,2023-03-02,505,oven,18490,24000,5510,1,00395,India
589991,2023-03-02,503,mixer,1349,3249,1900,1,00395,India
677189,2023-03-02,507,washing machine,6990,16490,9500,1,00432,India
677189,2023-03-02,502,iphone 15 pro max,100000,135000,35000,1,00432,India
677189,2023-03-02,505,oven,18490,24000,5510,1,00432,India
677189,2023-03-02,504,iron,449,879,430,1,00432,India
996107,2023-03-02,507,washing machine,6990,16490,9500,1,00331,India
844155,2023-03-02,503,mixer,1349,3249,1900,1,00222,India
844155,2023-03-02,501,iphone 15,60000,80000,20000,1,00222,India
771944,2023-03-02,501,iphone 15,60000,80000,20000,1,00304,India
771944,2023-03-02,505,oven,18490,24000,5510,1,00304,India
771944,2023-03-02,506,monitor,3249,8000,4751,1,00304,India
220863,2023-03-02,506,monitor,3249,8000,4751,1,00281,India
220863,2023-03-02,501,iphone 15,60000,80000,20000,1,00281,India
220863,2023-03-02,505,oven,18490,24000,5510,1,00281,India
186819,2023-03-02,505,oven,18490,24000,5510,1,00261,India
140448,2023-03-02,507,washing machine,6990,16490,9500,1,00434,India
504406,2023-03-02,506,monitor,3249,8000,4751,1,00035,India
504406,2023-03-02,501,iphone 15,60000,80000,20000,1,00035,India
504406,2023-03-02,502,iphone 15 pro max,100000,135000,35000,1,00035,India
504406,2023-03-02,504,iron,449,879,430,1,00035,India
524649,2023-03-02,501,iphone 15,60000,80000,20000,1,00079,India
776490,2023-03-02,501,iphone 15,60000,80000,20000,1,00303,India
776490,2023-03-02,505,oven,18490,24000,5510,1,00303,India
776490,2023-03-02,507,washing machine,6990,16490,9500,1,00303,India
776490,2023-03-02,502,iphone 15 pro max,100000,135000,35000,1,00303,India
975056,2023-03-02,502,iphone 15 pro max,100000,135000,35000,1,00392,India
975056,2023-03-02,504,iron,449,879,430,1,00392,India
975056,2023-03-02,503,mixer,1349,3249,1900,1,00392,India
954424,2023-03-02,501,iphone 15,60000,80000,20000,1,00107,India
954424,2023-03-02,505,oven,18490,24000,5510,1,00107,India
954424,2023-03-02,504,iron,449,879,430,1,00107,India
954424,2023-03-02,506,monitor,3249,8000,4751,1,00107,India
351898,2023-03-02,503,mixer,1349,3249,1900,1,00014,India
370166,2023-03-02,502,iphone 15 pro max,100000,135000,35000,1,00285,India
370166,2023-03-02,504,iron,449,879,430,1,00285,India
110250,2023-03-02,504,iron,449,879,430,1,00108,India
110250,2023-03-02,501,iphone 15,60000,80000,20000,1,00108,India
110250,2023-03-02,502,iphone 15 pro max,100000,135000,35000,1,00108,India
655516,2023-03-02,507,washing machine,6990,16490,9500,1,00242,India
476362,2023-03-02,503,mixer,1349,3249,1900,1,00155,India
476362,2023-03-02,505,oven,18490,24000,5510,1,00155,India
476362,2023-03-02,502,iphone 15 pro max,100000,135000,35000,1,00155,India
476362,2023-03-02,504,iron,449,879,430,1,00155,India
519615,2023-03-02,504,iron,449,879,430,1,00197,India
519615,2023-03-02,507,washing machine,6990,16490,9500,1,00197,India
519615,2023-03-02,506,monitor,3249,8000,4751,1,00197,India
228208,2023-03-02,507,washing machine,6990,16490,9500,1,00360,India
228208,2023-03-02,502,iphone 15 pro max,100000,135000,35000,1,00360,India
228208,2023-03-02,501,iphone 15,60000,80000,20000,1,00360,India
228208,2023-03-02,504,iron,449,879,430,1,00360,India
429481,2023-03-02,505,oven,18490,24000,5510,1,00318,India
429481,2023-03-02,507,washing machine,6990,16490,9500,1,00318,India
201040,2023-03-02,504,iron,449,879,430,1,00109,India
201040,2023-03-02,502,iphone 15 pro max,100000,135000,35000,1,00109,India
927308,2023-03-02,506,monitor,3249,8000,4751,1,00376,India
400961,2023-03-02,504,iron,449,879,430,1,00491,India
400961,2023-03-02,501,iphone 15,60000,80000,20000,1,00491,India
906244,2023-03-02,505,oven,18490,24000,5510,1,00426,India
906244,2023-03-02,503,mixer,1349,3249,1900,1,00426,India
479683,2023-03-02,502,iphone 15 pro max,100000,135000,35000,1,00076,India
479683,2023-03-02,501,iphone 15,60000,80000,20000,1,00076,India
479683,2023-03-02,505,oven,18490,24000,5510,1,00076,India
704629,2023-03-02,507,washing machine,6990,16490,9500,1,00233,India
704629,2023-03-02,504,iron,449,879,430,1,00233,India
704629,2023-03-02,501,iphone 15,60000,80000,20000,1,00233,India
428378,2023-03-02,506,monitor,3249,8000,4751,1,00487,India
742304,2023-03-02,507,washing machine,6990,16490,9500,1,00458,India
742304,2023-03-02,505,oven,18490,24000,5510,1,00458,India
386567,2023-03-02,501,iphone 15,60000,80000,20000,1,00478,India
386567,2023-03-02,507,washing machine,6990,16490,9500,1,00478,India
386567,2023-03-02,503,mixer,1349,3249,1900,1,00478,India
386567,2023-03-02,502,iphone 15 pro max,100000,135000,35000,1,00478,India
386567,2023-03-02,506,monitor,3249,8000,4751,1,00478,India
523906,2023-03-02,506,monitor,3249,8000,4751,1,00489,India
995783,2023-03-02,505,oven,18490,24000,5510,1,00308,India
995783,2023-03-02,506,monitor,3249,8000,4751,1,00308,India
995783,2023-03-02,503,mixer,1349,3249,1900,1,00308,India
995783,2023-03-02,502,iphone 15 pro max,100000,135000,35000,1,00308,India
118382,2023-03-02,501,iphone 15,60000,80000,20000,1,00320,India
118382,2023-03-02,503,mixer,1349,3249,1900,1,00320,India
850885,2023-03-02,501,iphone 15,60000,80000,20000,1,00496,India
850885,2023-03-02,507,washing machine,6990,16490,9500,1,00496,India
850885,2023-03-02,506,monitor,3249,8000,4751,1,00496,India
850885,2023-03-02,503,mixer,1349,3249,1900,1,00496,India
307740,2023-03-02,501,iphone 15,60000,80000,20000,1,00087,India
307740,2023-03-02,505,oven,18490,24000,5510,1,00087,India
307740,2023-03-02,506,monitor,3249,8000,4751,1,00087,India
477287,2023-03-02,503,mixer,1349,3249,1900,1,00333,India
477287,2023-03-02,506,monitor,3249,8000,4751,1,00333,India
477287,2023-03-02,507,washing machine,6990,16490,9500,1,00333,India
747345,2023-03-02,506,monitor,3249,8000,4751,1,00031,India
747345,2023-03-02,504,iron,449,879,430,1,00031,India
584035,2023-03-02,503,mixer,1349,3249,1900,1,00179,India
145364,2023-03-02,507,washing machine,6990,16490,9500,1,00330,India
145364,2023-03-02,503,mixer,1349,3249,1900,1,00330,India
145364,2023-03-02,506,monitor,3249,8000,4751,1,00330,India
145364,2023-03-02,501,iphone 15,60000,80000,20000,1,00330,India
506307,2023-03-03,505,oven,18490,24000,5510,1,00149,India
506307,2023-03-03,502,iphone 15 pro max,100000,135000,35000,1,00149,India
376148,2023-03-03,506,monitor,3249,8000,4751,1,00335,India
376148,2023-03-03,504,iron,449,879,430,1,00335,India
376148,2023-03-03,507,washing machine,6990,16490,9500,1,00335,India
740447,2023-03-03,501,iphone 15,60000,80000,20000,1,00085,India
740447,2023-03-03,503,mixer,1349,3249,1900,1,00085,India
740447,2023-03-03,505,oven,18490,24000,5510,1,00085,India
740447,2023-03-03,502,iphone 15 pro max,100000,135000,35000,1,00085,India
418964,2023-03-03,506,monitor,3249,8000,4751,1,00445,India
418964,2023-03-03,505,oven,18490,24000,5510,1,00445,India
418964,2023-03-03,504,iron,449,879,430,1,00445,India
421747,2023-03-03,502,iphone 15 pro max,100000,135000,35000,1,00343,India
421747,2023-03-03,504,iron,449,879,430,1,00343,India
595972,2023-03-03,505,oven,18490,24000,5510,1,00229,India
595972,2023-03-03,506,monitor,3249,8000,4751,1,00229,India
167146,2023-03-03,505,oven,18490,24000,5510,1,00135,India
167146,2023-03-03,507,washing machine,6990,16490,9500,1,00135,India
167146,2023-03-03,506,monitor,3249,8000,4751,1,00135,India
167146,2023-03-03,502,iphone 15 pro max,100000,135000,35000,1,00135,India
587990,2023-03-03,503,mixer,1349,3249,1900,1,00298,India
587990,2023-03-03,504,iron,449,879,430,1,00298,India
587990,2023-03-03,506,monitor,3249,8000,4751,1,00298,India
587990,2023-03-03,507,washing machine,6990,16490,9500,1,00298,India
702633,2023-03-03,501,iphone 15,60000,80000,20000,1,00027,India
702633,2023-03-03,507,washing machine,6990,16490,9500,1,00027,India
186709,2023-03-03,502,iphone 15 pro max,100000,135000,35000,1,00239,India
186709,2023-03-03,504,iron,449,879,430,1,00239,India
186709,2023-03-03,507,washing machine,6990,16490,9500,1,00239,India
186709,2023-03-03,501,iphone 15,60000,80000,20000,1,00239,India
466604,2023-03-03,501,iphone 15,60000,80000,20000,1,00175,India
618029,2023-03-03,501,iphone 15,60000,80000,20000,1,00332,India
618029,2023-03-03,503,mixer,1349,3249,1900,1,00332,India
618029,2023-03-03,502,iphone 15 pro max,100000,135000,35000,1,00332,India
618029,2023-03-03,505,oven,18490,24000,5510,1,00332,India
806759,2023-03-03,503,mixer,1349,3249,1900,1,00380,India
806759,2023-03-03,505,oven,18490,24000,5510,1,00380,India
604442,2023-03-03,502,iphone 15 pro max,100000,135000,35000,1,00269,India
604442,2023-03-03,505,oven,18490,24000,5510,1,00269,India
604442,2023-03-03,501,iphone 15,60000,80000,20000,1,00269,India
604442,2023-03-03,507,washing machine,6990,16490,9500,1,00269,India
157806,2023-03-03,505,oven,18490,24000,5510,1,00119,India
157806,2023-03-03,502,iphone 15 pro max,100000,135000,35000,1,00119,India
157806,2023-03-03,503,mixer,1349,3249,1900,1,00119,India
157806,2023-03-03,506,monitor,3249,8000,4751,1,00119,India
157806,2023-03-03,507,washing machine,6990,16490,9500,1,00119,India
206561,2023-03-03,504,iron,449,879,430,1,00209,India
206561,2023-03-03,501,iphone 15,60000,80000,20000,1,00209,India
744711,2023-03-03,501,iphone 15,60000,80000,20000,1,00375,India
744711,2023-03-03,502,iphone 15 pro max,100000,135000,35000,1,00375,India
744711,2023-03-03,504,iron,449,879,430,1,00375,India
392403,2023-03-03,506,monitor,3249,8000,4751,1,00410,India
392403,2023-03-03,504,iron,449,879,430,1,00410,India
903247,2023-03-03,504,iron,449,879,430,1,00046,India
903247,2023-03-03,501,iphone 15,60000,80000,20000,1,00046,India
903247,2023-03-03,503,mixer,1349,3249,1900,1,00046,India
903247,2023-03-03,507,washing machine,6990,16490,9500,1,00046,India
967098,2023-03-03,503,mixer,1349,3249,1900,1,00155,India
967098,2023-03-03,506,monitor,3249,8000,4751,1,00155,India
967098,2023-03-03,502,iphone 15 pro max,100000,135000,35000,1,00155,India
302663,2023-03-03,502,iphone 15 pro max,100000,135000,35000,1,00135,India
302663,2023-03-03,501,iphone 15,60000,80000,20000,1,00135,India
938214,2023-03-03,502,iphone 15 pro max,100000,135000,35000,1,00287,India
979330,2023-03-03,507,washing machine,6990,16490,9500,1,00326,India
779202,2023-03-03,503,mixer,1349,3249,1900,1,00485,India
779202,2023-03-03,506,monitor,3249,8000,4751,1,00485,India
779202,2023-03-03,502,iphone 15 pro max,100000,135000,35000,1,00485,India
779202,2023-03-03,507,washing machine,6990,16490,9500,1,00485,India
779202,2023-03-03,505,oven,18490,24000,5510,1,00485,India
237147,2023-03-03,506,monitor,3249,8000,4751,1,00106,India
237147,2023-03-03,507,washing machine,6990,16490,9500,1,00106,India
237147,2023-03-03,502,iphone 15 pro max,100000,135000,35000,1,00106,India
237147,2023-03-03,504,iron,449,879,430,1,00106,India
153946,2023-03-03,505,oven,18490,24000,5510,1,00459,India
153946,2023-03-03,504,iron,449,879,430,1,00459,India
153946,2023-03-03,501,iphone 15,60000,80000,20000,1,00459,India
193970,2023-03-03,507,washing machine,6990,16490,9500,1,00126,India
335205,2023-03-03,506,monitor,3249,8000,4751,1,00046,India
821976,2023-03-03,503,mixer,1349,3249,1900,1,00127,India
824022,2023-03-03,506,monitor,3249,8000,4751,1,00296,India
410142,2023-03-03,506,monitor,3249,8000,4751,1,00067,India
410142,2023-03-03,507,washing machine,6990,16490,9500,1,00067,India
882552,2023-03-03,501,iphone 15,60000,80000,20000,1,00065,India
882552,2023-03-03,504,iron,449,879,430,1,00065,India
508588,2023-03-03,501,iphone 15,60000,80000,20000,1,00060,India
508588,2023-03-03,504,iron,449,879,430,1,00060,India
508588,2023-03-03,507,washing machine,6990,16490,9500,1,00060,India
508588,2023-03-03,503,mixer,1349,3249,1900,1,00060,India
177836,2023-03-03,501,iphone 15,60000,80000,20000,1,00150,India
177836,2023-03-03,505,oven,18490,24000,5510,1,00150,India
177836,2023-03-03,502,iphone 15 pro max,100000,135000,35000,1,00150,India
394795,2023-03-03,507,washing machine,6990,16490,9500,1,00411,India
394795,2023-03-03,502,iphone 15 pro max,100000,135000,35000,1,00411,India
660898,2023-03-03,503,mixer,1349,3249,1900,1,00132,India
660898,2023-03-03,506,monitor,3249,8000,4751,1,00132,India
660898,2023-03-03,504,iron,449,879,430,1,00132,India
504860,2023-03-03,502,iphone 15 pro max,100000,135000,35000,1,00145,India
504860,2023-03-03,503,mixer,1349,3249,1900,1,00145,India
504860,2023-03-03,501,iphone 15,60000,80000,20000,1,00145,India
752931,2023-03-03,504,iron,449,879,430,1,00081,India
752931,2023-03-03,505,oven,18490,24000,5510,1,00081,India
752931,2023-03-03,507,washing machine,6990,16490,9500,1,00081,India
752931,2023-03-03,503,mixer,1349,3249,1900,1,00081,India
752931,2023-03-03,506,monitor,3249,8000,4751,1,00081,India
571811,2023-03-03,504,iron,449,879,430,1,00348,India
571811,2023-03-03,503,mixer,1349,3249,1900,1,00348,India
571811,2023-03-03,501,iphone 15,60000,80000,20000,1,00348,India
670557,2023-03-03,506,monitor,3249,8000,4751,1,00222,India
670557,2023-03-03,503,mixer,1349,3249,1900,1,00222,India
670557,2023-03-03,505,oven,18490,24000,5510,1,00222,India
670557,2023-03-03,504,iron,449,879,430,1,00222,India
641729,2023-03-03,505,oven,18490,24000,5510,1,00431,India
230494,2023-03-03,502,iphone 15 pro max,100000,135000,35000,1,00404,India
230494,2023-03-03,503,mixer,1349,3249,1900,1,00404,India
230494,2023-03-03,505,oven,18490,24000,5510,1,00404,India
530208,2023-03-03,506,monitor,3249,8000,4751,1,00085,India
530208,2023-03-03,507,washing machine,6990,16490,9500,1,00085,India
530208,2023-03-03,504,iron,449,879,430,1,00085,India
318025,2023-03-03,504,iron,449,879,430,1,00482,India
318025,2023-03-03,505,oven,18490,24000,5510,1,00482,India
318025,2023-03-03,502,iphone 15 pro max,100000,135000,35000,1,00482,India
257172,2023-03-03,503,mixer,1349,3249,1900,1,00340,India
257172,2023-03-03,506,monitor,3249,8000,4751,1,00340,India
197860,2023-03-03,501,iphone 15,60000,80000,20000,1,00360,India
197860,2023-03-03,507,washing machine,6990,16490,9500,1,00360,India
962015,2023-03-03,503,mixer,1349,3249,1900,1,00160,India
962015,2023-03-03,502,iphone 15 pro max,100000,135000,35000,1,00160,India
113580,2023-03-03,502,iphone 15 pro max,100000,135000,35000,1,00062,India
113580,2023-03-03,505,oven,18490,24000,5510,1,00062,India
113580,2023-03-03,504,iron,449,879,430,1,00062,India
219560,2023-03-03,502,iphone 15 pro max,100000,135000,35000,1,00492,India
219560,2023-03-03,506,monitor,3249,8000,4751,1,00492,India
219560,2023-03-03,501,iphone 15,60000,80000,20000,1,00492,India
219560,2023-03-03,507,washing machine,6990,16490,9500,1,00492,India
607643,2023-03-03,507,washing machine,6990,16490,9500,1,00313,India
607643,2023-03-03,504,iron,449,879,430,1,00313,India
607643,2023-03-03,501,iphone 15,60000,80000,20000,1,00313,India
340868,2023-03-03,501,iphone 15,60000,80000,20000,1,00025,India
340868,2023-03-03,504,iron,449,879,430,1,00025,India
843510,2023-03-03,503,mixer,1349,3249,1900,1,00287,India
880422,2023-03-03,507,washing machine,6990,16490,9500,1,00367,India
880422,2023-03-03,504,iron,449,879,430,1,00367,India
880422,2023-03-03,501,iphone 15,60000,80000,20000,1,00367,India
959357,2023-03-03,502,iphone 15 pro max,100000,135000,35000,1,00027,India
641771,2023-03-03,507,washing machine,6990,16490,9500,1,00145,India
641771,2023-03-03,506,monitor,3249,8000,4751,1,00145,India
271040,2023-03-03,507,washing machine,6990,16490,9500,1,00033,India
915570,2023-03-03,505,oven,18490,24000,5510,1,00294,India
644973,2023-03-03,503,mixer,1349,3249,1900,1,00158,India
644973,2023-03-03,504,iron,449,879,430,1,00158,India
903005,2023-03-03,503,mixer,1349,3249,1900,1,00038,India
903005,2023-03-03,507,washing machine,6990,16490,9500,1,00038,India
426722,2023-03-03,501,iphone 15,60000,80000,20000,1,00210,India
426722,2023-03-03,507,washing machine,6990,16490,9500,1,00210,India
426722,2023-03-03,506,monitor,3249,8000,4751,1,00210,India
597159,2023-03-03,501,iphone 15,60000,80000,20000,1,00260,India
597159,2023-03-03,505,oven,18490,24000,5510,1,00260,India
597159,2023-03-03,507,washing machine,6990,16490,9500,1,00260,India
597159,2023-03-03,504,iron,449,879,430,1,00260,India
655684,2023-03-03,501,iphone 15,60000,80000,20000,1,00035,India
182456,2023-03-03,501,iphone 15,60000,80000,20000,1,00287,India
182456,2023-03-03,505,oven,18490,24000,5510,1,00287,India
182456,2023-03-03,507,washing machine,6990,16490,9500,1,00287,India
351366,2023-03-03,504,iron,449,879,430,1,00077,India
596096,2023-03-03,504,iron,449,879,430,1,00324,India
302837,2023-03-03,507,washing machine,6990,16490,9500,1,00403,India
302837,2023-03-03,504,iron,449,879,430,1,00403,India
389032,2023-03-03,501,iphone 15,60000,80000,20000,1,00147,India
389032,2023-03-03,507,washing machine,6990,16490,9500,1,00147,India
389032,2023-03-03,505,oven,18490,24000,5510,1,00147,India
389032,2023-03-03,503,mixer,1349,3249,1900,1,00147,India
412048,2023-03-03,506,monitor,3249,8000,4751,1,00400,India
641303,2023-03-03,506,monitor,3249,8000,4751,1,00311,India
641303,2023-03-03,502,iphone 15 pro max,100000,135000,35000,1,00311,India
641303,2023-03-03,504,iron,449,879,430,1,00311,India
147368,2023-03-03,506,monitor,3249,8000,4751,1,00141,India
147368,2023-03-03,501,iphone 15,60000,80000,20000,1,00141,India
147368,2023-03-03,503,mixer,1349,3249,1900,1,00141,India
253145,2023-03-03,505,oven,18490,24000,5510,1,00109,India
253145,2023-03-03,504,iron,449,879,430,1,00109,India
891663,2023-03-03,502,iphone 15 pro max,100000,135000,35000,1,00487,India
123850,2023-03-03,503,mixer,1349,3249,1900,1,00074,India
123850,2023-03-03,505,oven,18490,24000,5510,1,00074,India
123850,2023-03-03,502,iphone 15 pro max,100000,135000,35000,1,00074,India
123850,2023-03-03,506,monitor,3249,8000,4751,1,00074,India
170881,2023-03-03,504,iron,449,879,430,1,00199,India
170881,2023-03-03,502,iphone 15 pro max,100000,135000,35000,1,00199,India
170881,2023-03-03,506,monitor,3249,8000,4751,1,00199,India
844377,2023-03-03,501,iphone 15,60000,80000,20000,1,00373,India
844377,2023-03-03,505,oven,18490,24000,5510,1,00373,India
236002,2023-03-03,504,iron,449,879,430,1,00500,India
236002,2023-03-03,502,iphone 15 pro max,100000,135000,35000,1,00500,India
236002,2023-03-03,501,iphone 15,60000,80000,20000,1,00500,India
236002,2023-03-03,506,monitor,3249,8000,4751,1,00500,India
741232,2023-03-03,504,iron,449,879,430,1,00369,India
741232,2023-03-03,501,iphone 15,60000,80000,20000,1,00369,India
741232,2023-03-03,505,oven,18490,24000,5510,1,00369,India
741232,2023-03-03,506,monitor,3249,8000,4751,1,00369,India
741232,2023-03-03,502,iphone 15 pro max,100000,135000,35000,1,00369,India
330727,2023-03-03,502,iphone 15 pro max,100000,135000,35000,1,00224,India
330727,2023-03-03,503,mixer,1349,3249,1900,1,00224,India
275396,2023-03-03,501,iphone 15,60000,80000,20000,1,00129,India
275396,2023-03-03,505,oven,18490,24000,5510,1,00129,India
275396,2023-03-03,504,iron,449,879,430,1,00129,India
275396,2023-03-03,503,mixer,1349,3249,1900,1,00129,India
303206,2023-03-03,505,oven,18490,24000,5510,1,00226,India
303206,2023-03-03,504,iron,449,879,430,1,00226,India
303206,2023-03-03,503,mixer,1349,3249,1900,1,00226,India
303206,2023-03-03,506,monitor,3249,8000,4751,1,00226,India
400161,2023-03-03,504,iron,449,879,430,1,00492,India
400161,2023-03-03,506,monitor,3249,8000,4751,1,00492,India
251947,2023-03-03,502,iphone 15 pro max,100000,135000,35000,1,00034,India
368884,2023-03-03,504,iron,449,879,430,1,00133,India
726160,2023-03-03,506,monitor,3249,8000,4751,1,00298,India
726160,2023-03-03,502,iphone 15 pro max,100000,135000,35000,1,00298,India
726160,2023-03-03,505,oven,18490,24000,5510,1,00298,India
444014,2023-03-03,504,iron,449,879,430,1,00265,India
444014,2023-03-03,505,oven,18490,24000,5510,1,00265,India
444014,2023-03-03,503,mixer,1349,3249,1900,1,00265,India
534646,2023-03-03,501,iphone 15,60000,80000,20000,1,00199,India
534646,2023-03-03,502,iphone 15 pro max,100000,135000,35000,1,00199,India
434184,2023-03-03,505,oven,18490,24000,5510,1,00030,India
434184,2023-03-03,507,washing machine,6990,16490,9500,1,00030,India
434184,2023-03-03,504,iron,449,879,430,1,00030,India
100931,2023-03-03,505,oven,18490,24000,5510,1,00203,India
104185,2023-03-03,506,monitor,3249,8000,4751,1,00057,India
104185,2023-03-03,502,iphone 15 pro max,100000,135000,35000,1,00057,India
104185,2023-03-03,501,iphone 15,60000,80000,20000,1,00057,India
104185,2023-03-03,504,iron,449,879,430,1,00057,India
561548,2023-03-03,501,iphone 15,60000,80000,20000,1,00187,India
218316,2023-03-03,505,oven,18490,24000,5510,1,00154,India
218316,2023-03-03,502,iphone 15 pro max,100000,135000,35000,1,00154,India
218316,2023-03-03,504,iron,449,879,430,1,00154,India
195973,2023-03-03,502,iphone 15 pro max,100000,135000,35000,1,00442,India
195973,2023-03-03,504,iron,449,879,430,1,00442,India
696510,2023-03-03,501,iphone 15,60000,80000,20000,1,00075,India
696510,2023-03-03,503,mixer,1349,3249,1900,1,00075,India
696510,2023-03-03,505,oven,18490,24000,5510,1,00075,India
696510,2023-03-03,504,iron,449,879,430,1,00075,India
114304,2023-03-03,503,mixer,1349,3249,1900,1,00181,India
114304,2023-03-03,507,washing machine,6990,16490,9500,1,00181,India
114304,2023-03-03,501,iphone 15,60000,80000,20000,1,00181,India
114304,2023-03-03,506,monitor,3249,8000,4751,1,00181,India
687104,2023-03-03,506,monitor,3249,8000,4751,1,00340,India
687104,2023-03-03,507,washing machine,6990,16490,9500,1,00340,India
687104,2023-03-03,503,mixer,1349,3249,1900,1,00340,India
470642,2023-03-03,507,washing machine,6990,16490,9500,1,00095,India
470642,2023-03-03,501,iphone 15,60000,80000,20000,1,00095,India
470642,2023-03-03,505,oven,18490,24000,5510,1,00095,India
532096,2023-03-04,507,washing machine,6990,16490,9500,1,00278,India
532096,2023-03-04,502,iphone 15 pro max,100000,135000,35000,1,00278,India
532096,2023-03-04,503,mixer,1349,3249,1900,1,00278,India
532096,2023-03-04,506,monitor,3249,8000,4751,1,00278,India
120455,2023-03-04,507,washing machine,6990,16490,9500,1,00500,India
565224,2023-03-04,504,iron,449,879,430,1,00241,India
565224,2023-03-04,503,mixer,1349,3249,1900,1,00241,India
786405,2023-03-04,505,oven,18490,24000,5510,1,00016,India
786405,2023-03-04,501,iphone 15,60000,80000,20000,1,00016,India
786405,2023-03-04,503,mixer,1349,3249,1900,1,00016,India
643742,2023-03-04,501,iphone 15,60000,80000,20000,1,00280,India
643742,2023-03-04,502,iphone 15 pro max,100000,135000,35000,1,00280,India
643742,2023-03-04,504,iron,449,879,430,1,00280,India
224632,2023-03-04,507,washing machine,6990,16490,9500,1,00092,India
224632,2023-03-04,502,iphone 15 pro max,100000,135000,35000,1,00092,India
224632,2023-03-04,506,monitor,3249,8000,4751,1,00092,India
636599,2023-03-04,507,washing machine,6990,16490,9500,1,00067,India
712656,2023-03-04,507,washing machine,6990,16490,9500,1,00181,India
712656,2023-03-04,504,iron,449,879,430,1,00181,India
712656,2023-03-04,503,mixer,1349,3249,1900,1,00181,India
909166,2023-03-04,504,iron,449,879,430,1,00494,India
313975,2023-03-04,504,iron,449,879,430,1,00228,India
313975,2023-03-04,503,mixer,1349,3249,1900,1,00228,India
313975,2023-03-04,502,iphone 15 pro max,100000,135000,35000,1,00228,India
588106,2023-03-04,502,iphone 15 pro max,100000,135000,35000,1,00436,India
588106,2023-03-04,501,iphone 15,60000,80000,20000,1,00436,India
588106,2023-03-04,506,monitor,3249,8000,4751,1,00436,India
588106,2023-03-04,503,mixer,1349,3249,1900,1,00436,India
408675,2023-03-04,506,monitor,3249,8000,4751,1,00443,India
488288,2023-03-04,502,iphone 15 pro max,100000,135000,35000,1,00454,India
742445,2023-03-04,502,iphone 15 pro max,100000,135000,35000,1,00366,India
281399,2023-03-04,501,iphone 15,60000,80000,20000,1,00254,India
595622,2023-03-04,503,mixer,1349,3249,1900,1,00145,India
595622,2023-03-04,504,iron,449,879,430,1,00145,India
595622,2023-03-04,501,iphone 15,60000,80000,20000,1,00145,India
438834,2023-03-04,505,oven,18490,24000,5510,1,00499,India
868819,2023-03-04,505,oven,18490,24000,5510,1,00026,India
868819,2023-03-04,507,washing machine,6990,16490,9500,1,00026,India
868819,2023-03-04,504,iron,449,879,430,1,00026,India
868819,2023-03-04,503,mixer,1349,3249,1900,1,00026,India
462568,2023-03-04,506,monitor,3249,8000,4751,1,00389,India
462568,2023-03-04,501,iphone 15,60000,80000,20000,1,00389,India
462568,2023-03-04,504,iron,449,879,430,1,00389,India
462568,2023-03-04,505,oven,18490,24000,5510,1,00389,India
155918,2023-03-04,505,oven,18490,24000,5510,1,00256,India
155918,2023-03-04,504,iron,449,879,430,1,00256,India
155918,2023-03-04,503,mixer,1349,3249,1900,1,00256,India
895519,2023-03-04,502,iphone 15 pro max,100000,135000,35000,1,00453,India
895519,2023-03-04,506,monitor,3249,8000,4751,1,00453,India
895519,2023-03-04,505,oven,18490,24000,5510,1,00453,India
895519,2023-03-04,504,iron,449,879,430,1,00453,India
208159,2023-03-04,501,iphone 15,60000,80000,20000,1,00314,India
828886,2023-03-04,503,mixer,1349,3249,1900,1,00219,India
441152,2023-03-04,501,iphone 15,60000,80000,20000,1,00474,India
441152,2023-03-04,505,oven,18490,24000,5510,1,00474,India
441152,2023-03-04,504,iron,449,879,430,1,00474,India
441152,2023-03-04,503,mixer,1349,3249,1900,1,00474,India
598377,2023-03-04,506,monitor,3249,8000,4751,1,00098,India
598377,2023-03-04,505,oven,18490,24000,5510,1,00098,India
598377,2023-03-04,504,iron,449,879,430,1,00098,India
683594,2023-03-04,503,mixer,1349,3249,1900,1,00392,India
683594,2023-03-04,505,oven,18490,24000,5510,1,00392,India
683594,2023-03-04,506,monitor,3249,8000,4751,1,00392,India
544388,2023-03-04,502,iphone 15 pro max,100000,135000,35000,1,00331,India
544388,2023-03-04,501,iphone 15,60000,80000,20000,1,00331,India
223537,2023-03-04,504,iron,449,879,430,1,00318,India
223537,2023-03-04,507,washing machine,6990,16490,9500,1,00318,India
223537,2023-03-04,506,monitor,3249,8000,4751,1,00318,India
223537,2023-03-04,502,iphone 15 pro max,100000,135000,35000,1,00318,India
469776,2023-03-04,501,iphone 15,60000,80000,20000,1,00329,India
469776,2023-03-04,503,mixer,1349,3249,1900,1,00329,India
713388,2023-03-04,505,oven,18490,24000,5510,1,00348,India
713388,2023-03-04,502,iphone 15 pro max,100000,135000,35000,1,00348,India
713388,2023-03-04,503,mixer,1349,3249,1900,1,00348,India
713388,2023-03-04,507,washing machine,6990,16490,9500,1,00348,India
292944,2023-03-04,504,iron,449,879,430,1,00417,India
292944,2023-03-04,502,iphone 15 pro max,100000,135000,35000,1,00417,India
504904,2023-03-04,503,mixer,1349,3249,1900,1,00231,India
504904,2023-03-04,505,oven,18490,24000,5510,1,00231,India
237535,2023-03-04,506,monitor,3249,8000,4751,1,00475,India
237535,2023-03-04,503,mixer,1349,3249,1900,1,00475,India
131232,2023-03-04,505,oven,18490,24000,5510,1,00040,India
131232,2023-03-04,504,iron,449,879,430,1,00040,India
131232,2023-03-04,502,iphone 15 pro max,100000,135000,35000,1,00040,India
242422,2023-03-04,501,iphone 15,60000,80000,20000,1,00036,India
242422,2023-03-04,505,oven,18490,24000,5510,1,00036,India
177599,2023-03-04,504,iron,449,879,430,1,00251,India
177599,2023-03-04,505,oven,18490,24000,5510,1,00251,India
177599,2023-03-04,502,iphone 15 pro max,100000,135000,35000,1,00251,India
553797,2023-03-04,507,washing machine,6990,16490,9500,1,00030,India
553797,2023-03-04,503,mixer,1349,3249,1900,1,00030,India
681692,2023-03-04,502,iphone 15 pro max,100000,135000,35000,1,00362,India
806144,2023-03-04,504,iron,449,879,430,1,00084,India
806144,2023-03-04,506,monitor,3249,8000,4751,1,00084,India
464017,2023-03-04,505,oven,18490,24000,5510,1,00207,India
464017,2023-03-04,507,washing machine,6990,16490,9500,1,00207,India
524117,2023-03-04,502,iphone 15 pro max,100000,135000,35000,1,00321,India
563307,2023-03-04,501,iphone 15,60000,80000,20000,1,00396,India
563307,2023-03-04,503,mixer,1349,3249,1900,1,00396,India
426421,2023-03-04,506,monitor,3249,8000,4751,1,00308,India
426421,2023-03-04,507,washing machine,6990,16490,9500,1,00308,India
557619,2023-03-04,507,washing machine,6990,16490,9500,1,00255,India
557619,2023-03-04,504,iron,449,879,430,1,00255,India
328120,2023-03-04,505,oven,18490,24000,5510,1,00496,India
817258,2023-03-04,503,mixer,1349,3249,1900,1,00117,India
358251,2023-03-04,507,washing machine,6990,16490,9500,1,00265,India
358251,2023-03-04,503,mixer,1349,3249,1900,1,00265,India
358251,2023-03-04,504,iron,449,879,430,1,00265,India
358251,2023-03-04,506,monitor,3249,8000,4751,1,00265,India
285394,2023-03-04,503,mixer,1349,3249,1900,1,00224,India
285394,2023-03-04,501,iphone 15,60000,80000,20000,1,00224,India
482267,2023-03-04,506,monitor,3249,8000,4751,1,00310,India
482267,2023-03-04,501,iphone 15,60000,80000,20000,1,00310,India
148935,2023-03-04,503,mixer,1349,3249,1900,1,00409,India
148935,2023-03-04,507,washing machine,6990,16490,9500,1,00409,India
289195,2023-03-04,505,oven,18490,24000,5510,1,00269,India
289195,2023-03-04,502,iphone 15 pro max,100000,135000,35000,1,00269,India
289195,2023-03-04,504,iron,449,879,430,1,00269,India
736269,2023-03-04,506,monitor,3249,8000,4751,1,00052,India
736269,2023-03-04,502,iphone 15 pro max,100000,135000,35000,1,00052,India
736269,2023-03-04,505,oven,18490,24000,5510,1,00052,India
736269,2023-03-04,504,iron,449,879,430,1,00052,India
961883,2023-03-04,507,washing machine,6990,16490,9500,1,00247,India
669293,2023-03-04,505,oven,18490,24000,5510,1,00015,India
669293,2023-03-04,506,monitor,3249,8000,4751,1,00015,India
502610,2023-03-04,502,iphone 15 pro max,100000,135000,35000,1,00113,India
502610,2023-03-04,507,washing machine,6990,16490,9500,1,00113,India
743597,2023-03-04,503,mixer,1349,3249,1900,1,00326,India
743597,2023-03-04,501,iphone 15,60000,80000,20000,1,00326,India
743597,2023-03-04,504,iron,449,879,430,1,00326,India
468337,2023-03-04,503,mixer,1349,3249,1900,1,00483,India
468337,2023-03-04,504,iron,449,879,430,1,00483,India
428061,2023-03-04,505,oven,18490,24000,5510,1,00043,India
428061,2023-03-04,506,monitor,3249,8000,4751,1,00043,India
428061,2023-03-04,507,washing machine,6990,16490,9500,1,00043,India
256494,2023-03-04,501,iphone 15,60000,80000,20000,1,00105,India
135700,2023-03-04,505,oven,18490,24000,5510,1,00352,India
135700,2023-03-04,504,iron,449,879,430,1,00352,India
135700,2023-03-04,503,mixer,1349,3249,1900,1,00352,India
135700,2023-03-04,506,monitor,3249,8000,4751,1,00352,India
135700,2023-03-04,507,washing machine,6990,16490,9500,1,00352,India
380847,2023-03-04,506,monitor,3249,8000,4751,1,00482,India
380847,2023-03-04,502,iphone 15 pro max,100000,135000,35000,1,00482,India
380847,2023-03-04,505,oven,18490,24000,5510,1,00482,India
486169,2023-03-04,506,monitor,3249,8000,4751,1,00483,India
486169,2023-03-04,501,iphone 15,60000,80000,20000,1,00483,India
486169,2023-03-04,504,iron,449,879,430,1,00483,India
850273,2023-03-04,504,iron,449,879,430,1,00281,India
850273,2023-03-04,502,iphone 15 pro max,100000,135000,35000,1,00281,India
850273,2023-03-04,505,oven,18490,24000,5510,1,00281,India
486467,2023-03-04,506,monitor,3249,8000,4751,1,00276,India
486467,2023-03-04,502,iphone 15 pro max,100000,135000,35000,1,00276,India
486467,2023-03-04,501,iphone 15,60000,80000,20000,1,00276,India
486467,2023-03-04,505,oven,18490,24000,5510,1,00276,India
837596,2023-03-04,506,monitor,3249,8000,4751,1,00388,India
294734,2023-03-04,506,monitor,3249,8000,4751,1,00382,India
294734,2023-03-04,505,oven,18490,24000,5510,1,00382,India
489548,2023-03-04,501,iphone 15,60000,80000,20000,1,00482,India
489548,2023-03-04,506,monitor,3249,8000,4751,1,00482,India
408166,2023-03-04,503,mixer,1349,3249,1900,1,00073,India
408166,2023-03-04,506,monitor,3249,8000,4751,1,00073,India
321030,2023-03-04,506,monitor,3249,8000,4751,1,00445,India
321030,2023-03-04,507,washing machine,6990,16490,9500,1,00445,India
321030,2023-03-04,505,oven,18490,24000,5510,1,00445,India
430174,2023-03-04,507,washing machine,6990,16490,9500,1,00147,India
430174,2023-03-04,502,iphone 15 pro max,100000,135000,35000,1,00147,India
430174,2023-03-04,501,iphone 15,60000,80000,20000,1,00147,India
923736,2023-03-04,505,oven,18490,24000,5510,1,00359,India
923736,2023-03-04,504,iron,449,879,430,1,00359,India
923736,2023-03-04,503,mixer,1349,3249,1900,1,00359,India
812963,2023-03-04,503,mixer,1349,3249,1900,1,00430,India
560616,2023-03-04,504,iron,449,879,430,1,00294,India
560616,2023-03-04,501,iphone 15,60000,80000,20000,1,00294,India
560616,2023-03-04,506,monitor,3249,8000,4751,1,00294,India
624006,2023-03-04,501,iphone 15,60000,80000,20000,1,00483,India
624006,2023-03-04,506,monitor,3249,8000,4751,1,00483,India
624006,2023-03-04,507,washing machine,6990,16490,9500,1,00483,India
624006,2023-03-04,503,mixer,1349,3249,1900,1,00483,India
864310,2023-03-05,505,oven,18490,24000,5510,1,00449,India
864310,2023-03-05,504,iron,449,879,430,1,00449,India
291972,2023-03-05,501,iphone 15,60000,80000,20000,1,00395,India
291972,2023-03-05,507,washing machine,6990,16490,9500,1,00395,India
291972,2023-03-05,506,monitor,3249,8000,4751,1,00395,India
291972,2023-03-05,505,oven,18490,24000,5510,1,00395,India
603603,2023-03-05,503,mixer,1349,3249,1900,1,00160,India
603603,2023-03-05,505,oven,18490,24000,5510,1,00160,India
703725,2023-03-05,504,iron,449,879,430,1,00006,India
703725,2023-03-05,507,washing machine,6990,16490,9500,1,00006,India
438986,2023-03-05,502,iphone 15 pro max,100000,135000,35000,1,00014,India
438986,2023-03-05,503,mixer,1349,3249,1900,1,00014,India
438986,2023-03-05,505,oven,18490,24000,5510,1,00014,India
438986,2023-03-05,506,monitor,3249,8000,4751,1,00014,India
438986,2023-03-05,507,washing machine,6990,16490,9500,1,00014,India
634754,2023-03-05,503,mixer,1349,3249,1900,1,00350,India
634754,2023-03-05,504,iron,449,879,430,1,00350,India
634754,2023-03-05,507,washing machine,6990,16490,9500,1,00350,India
395065,2023-03-05,504,iron,449,879,430,1,00064,India
395065,2023-03-05,501,iphone 15,60000,80000,20000,1,00064,India
395065,2023-03-05,506,monitor,3249,8000,4751,1,00064,India
758576,2023-03-05,506,monitor,3249,8000,4751,1,00466,India
610027,2023-03-05,506,monitor,3249,8000,4751,1,00239,India
610027,2023-03-05,501,iphone 15,60000,80000,20000,1,00239,India
610027,2023-03-05,502,iphone 15 pro max,100000,135000,35000,1,00239,India
940277,2023-03-05,504,iron,449,879,430,1,00351,India
940277,2023-03-05,502,iphone 15 pro max,100000,135000,35000,1,00351,India
546358,2023-03-05,504,iron,449,879,430,1,00414,India
546358,2023-03-05,506,monitor,3249,8000,4751,1,00414,India
546358,2023-03-05,503,mixer,1349,3249,1900,1,00414,India
546358,2023-03-05,507,washing machine,6990,16490,9500,1,00414,India
522324,2023-03-05,505,oven,18490,24000,5510,1,00443,India
410733,2023-03-05,506,monitor,3249,8000,4751,1,00211,India
410733,2023-03-05,503,mixer,1349,3249,1900,1,00211,India
281651,2023-03-05,506,monitor,3249,8000,4751,1,00389,India
281651,2023-03-05,502,iphone 15 pro max,100000,135000,35000,1,00389,India
281651,2023-03-05,504,iron,449,879,430,1,00389,India
924233,2023-03-05,505,oven,18490,24000,5510,1,00144,India
737214,2023-03-05,502,iphone 15 pro max,100000,135000,35000,1,00057,India
484601,2023-03-05,502,iphone 15 pro max,100000,135000,35000,1,00472,India
484601,2023-03-05,501,iphone 15,60000,80000,20000,1,00472,India
484601,2023-03-05,503,mixer,1349,3249,1900,1,00472,India
810473,2023-03-05,505,oven,18490,24000,5510,1,00131,India
810473,2023-03-05,504,iron,449,879,430,1,00131,India
810473,2023-03-05,506,monitor,3249,8000,4751,1,00131,India
783062,2023-03-05,503,mixer,1349,3249,1900,1,00355,India
783062,2023-03-05,504,iron,449,879,430,1,00355,India
783062,2023-03-05,505,oven,18490,24000,5510,1,00355,India
783062,2023-03-05,502,iphone 15 pro max,100000,135000,35000,1,00355,India
268782,2023-03-05,505,oven,18490,24000,5510,1,00215,India
940573,2023-03-05,505,oven,18490,24000,5510,1,00336,India
940573,2023-03-05,506,monitor,3249,8000,4751,1,00336,India
940573,2023-03-05,501,iphone 15,60000,80000,20000,1,00336,India
550873,2023-03-05,504,iron,449,879,430,1,00453,India
550873,2023-03-05,505,oven,18490,24000,5510,1,00453,India
550873,2023-03-05,506,monitor,3249,8000,4751,1,00453,India
302686,2023-03-05,507,washing machine,6990,16490,9500,1,00437,India
798728,2023-03-05,506,monitor,3249,8000,4751,1,00392,India
939807,2023-03-05,503,mixer,1349,3249,1900,1,00319,India
939807,2023-03-05,504,iron,449,879,430,1,00319,India
939807,2023-03-05,505,oven,18490,24000,5510,1,00319,India
557391,2023-03-05,504,iron,449,879,430,1,00378,India
419780,2023-03-05,503,mixer,1349,3249,1900,1,00132,India
419780,2023-03-05,504,iron,449,879,430,1,00132,India
419780,2023-03-05,502,iphone 15 pro max,100000,135000,35000,1,00132,India
567277,2023-03-05,507,washing machine,6990,16490,9500,1,00108,India
567277,2023-03-05,501,iphone 15,60000,80000,20000,1,00108,India
567277,2023-03-05,505,oven,18490,24000,5510,1,00108,India
539994,2023-03-05,503,mixer,1349,3249,1900,1,00461,India
631981,2023-03-05,503,mixer,1349,3249,1900,1,00094,India
366088,2023-03-05,507,washing machine,6990,16490,9500,1,00317,India
366088,2023-03-05,505,oven,18490,24000,5510,1,00317,India
366088,2023-03-05,506,monitor,3249,8000,4751,1,00317,India
274098,2023-03-05,503,mixer,1349,3249,1900,1,00204,India
274098,2023-03-05,504,iron,449,879,430,1,00204,India
274098,2023-03-05,507,washing machine,6990,16490,9500,1,00204,India
274098,2023-03-05,501,iphone 15,60000,80000,20000,1,00204,India
633961,2023-03-05,502,iphone 15 pro max,100000,135000,35000,1,00325,India
633961,2023-03-05,507,washing machine,6990,16490,9500,1,00325,India
633961,2023-03-05,503,mixer,1349,3249,1900,1,00325,India
929242,2023-03-05,501,iphone 15,60000,80000,20000,1,00467,India
929242,2023-03-05,503,mixer,1349,3249,1900,1,00467,India
929242,2023-03-05,506,monitor,3249,8000,4751,1,00467,India
929242,2023-03-05,502,iphone 15 pro max,100000,135000,35000,1,00467,India
929242,2023-03-05,505,oven,18490,24000,5510,1,00467,India
790091,2023-03-05,504,iron,449,879,430,1,00348,India
790091,2023-03-05,501,iphone 15,60000,80000,20000,1,00348,India
702534,2023-03-05,505,oven,18490,24000,5510,1,00446,India
702534,2023-03-05,506,monitor,3249,8000,4751,1,00446,India
702534,2023-03-05,507,washing machine,6990,16490,9500,1,00446,India
238658,2023-03-05,502,iphone 15 pro max,100000,135000,35000,1,00186,India
430428,2023-03-05,501,iphone 15,60000,80000,20000,1,00263,India
430428,2023-03-05,504,iron,449,879,430,1,00263,India
430428,2023-03-05,506,monitor,3249,8000,4751,1,00263,India
430428,2023-03-05,507,washing machine,6990,16490,9500,1,00263,India
341373,2023-03-05,505,oven,18490,24000,5510,1,00468,India
341373,2023-03-05,504,iron,449,879,430,1,00468,India
452830,2023-03-05,507,washing machine,6990,16490,9500,1,00421,India
452830,2023-03-05,503,mixer,1349,3249,1900,1,00421,India
452830,2023-03-05,504,iron,449,879,430,1,00421,India
582157,2023-03-05,503,mixer,1349,3249,1900,1,00244,India
582157,2023-03-05,502,iphone 15 pro max,100000,135000,35000,1,00244,India
781665,2023-03-05,504,iron,449,879,430,1,00432,India
781665,2023-03-05,501,iphone 15,60000,80000,20000,1,00432,India
827986,2023-03-05,502,iphone 15 pro max,100000,135000,35000,1,00387,India
827986,2023-03-05,504,iron,449,879,430,1,00387,India
477146,2023-03-05,507,washing machine,6990,16490,9500,1,00384,India
477146,2023-03-05,506,monitor,3249,8000,4751,1,00384,India
477146,2023-03-05,504,iron,449,879,430,1,00384,India
477146,2023-03-05,503,mixer,1349,3249,1900,1,00384,India
477146,2023-03-05,502,iphone 15 pro max,100000,135000,35000,1,00384,India
619880,2023-03-05,501,iphone 15,60000,80000,20000,1,00281,India
619880,2023-03-05,504,iron,449,879,430,1,00281,India
619880,2023-03-05,505,oven,18490,24000,5510,1,00281,India
956632,2023-03-05,507,washing machine,6990,16490,9500,1,00064,India
956632,2023-03-05,505,oven,18490,24000,5510,1,00064,India
956632,2023-03-05,503,mixer,1349,3249,1900,1,00064,India
820555,2023-03-05,507,washing machine,6990,16490,9500,1,00174,India
820555,2023-03-05,501,iphone 15,60000,80000,20000,1,00174,India
288955,2023-03-05,506,monitor,3249,8000,4751,1,00413,India
288955,2023-03-05,504,iron,449,879,430,1,00413,India
662442,2023-03-05,505,oven,18490,24000,5510,1,00494,India
662442,2023-03-05,506,monitor,3249,8000,4751,1,00494,India
888696,2023-03-05,504,iron,449,879,430,1,00126,India
888696,2023-03-05,507,washing machine,6990,16490,9500,1,00126,India
888696,2023-03-05,502,iphone 15 pro max,100000,135000,35000,1,00126,India
888696,2023-03-05,501,iphone 15,60000,80000,20000,1,00126,India
919624,2023-03-05,504,iron,449,879,430,1,00488,India
463892,2023-03-05,502,iphone 15 pro max,100000,135000,35000,1,00157,India
463892,2023-03-05,506,monitor,3249,8000,4751,1,00157,India
463892,2023-03-05,505,oven,18490,24000,5510,1,00157,India
289342,2023-03-05,507,washing machine,6990,16490,9500,1,00084,India
289342,2023-03-05,504,iron,449,879,430,1,00084,India
289342,2023-03-05,501,iphone 15,60000,80000,20000,1,00084,India
159288,2023-03-05,504,iron,449,879,430,1,00391,India
433722,2023-03-05,504,iron,449,879,430,1,00068,India
652380,2023-03-05,501,iphone 15,60000,80000,20000,1,00440,India
652380,2023-03-05,507,washing machine,6990,16490,9500,1,00440,India
667351,2023-03-05,503,mixer,1349,3249,1900,1,00336,India
667351,2023-03-05,507,washing machine,6990,16490,9500,1,00336,India
667351,2023-03-05,505,oven,18490,24000,5510,1,00336,India
409760,2023-03-05,503,mixer,1349,3249,1900,1,00362,India
409760,2023-03-05,507,washing machine,6990,16490,9500,1,00362,India
900267,2023-03-05,506,monitor,3249,8000,4751,1,00417,India
900267,2023-03-05,507,washing machine,6990,16490,9500,1,00417,India
900267,2023-03-05,504,iron,449,879,430,1,00417,India
764139,2023-03-05,505,oven,18490,24000,5510,1,00160,India
764139,2023-03-05,506,monitor,3249,8000,4751,1,00160,India
764139,2023-03-05,501,iphone 15,60000,80000,20000,1,00160,India
764139,2023-03-05,504,iron,449,879,430,1,00160,India
680146,2023-03-06,503,mixer,1349,3249,1900,1,00263,India
680146,2023-03-06,502,iphone 15 pro max,100000,135000,35000,1,00263,India
463710,2023-03-06,507,washing machine,6990,16490,9500,1,00439,India
405160,2023-03-06,501,iphone 15,60000,80000,20000,1,00200,India
405160,2023-03-06,507,washing machine,6990,16490,9500,1,00200,India
635024,2023-03-06,506,monitor,3249,8000,4751,1,00493,India
635024,2023-03-06,505,oven,18490,24000,5510,1,00493,India
635024,2023-03-06,507,washing machine,6990,16490,9500,1,00493,India
195285,2023-03-06,501,iphone 15,60000,80000,20000,1,00048,India
195285,2023-03-06,506,monitor,3249,8000,4751,1,00048,India
118670,2023-03-06,504,iron,449,879,430,1,00433,India
118670,2023-03-06,503,mixer,1349,3249,1900,1,00433,India
118670,2023-03-06,502,iphone 15 pro max,100000,135000,35000,1,00433,India
118670,2023-03-06,507,washing machine,6990,16490,9500,1,00433,India
179180,2023-03-06,506,monitor,3249,8000,4751,1,00419,India
422067,2023-03-06,506,monitor,3249,8000,4751,1,00216,India
422067,2023-03-06,504,iron,449,879,430,1,00216,India
604034,2023-03-06,506,monitor,3249,8000,4751,1,00047,India
389022,2023-03-06,505,oven,18490,24000,5510,1,00196,India
389022,2023-03-06,501,iphone 15,60000,80000,20000,1,00196,India
389022,2023-03-06,506,monitor,3249,8000,4751,1,00196,India
718495,2023-03-06,504,iron,449,879,430,1,00495,India
718495,2023-03-06,507,washing machine,6990,16490,9500,1,00495,India
718495,2023-03-06,502,iphone 15 pro max,100000,135000,35000,1,00495,India
474459,2023-03-06,502,iphone 15 pro max,100000,135000,35000,1,00206,India
474459,2023-03-06,501,iphone 15,60000,80000,20000,1,00206,India
593762,2023-03-06,504,iron,449,879,430,1,00022,India
593762,2023-03-06,505,oven,18490,24000,5510,1,00022,India
593762,2023-03-06,501,iphone 15,60000,80000,20000,1,00022,India
593762,2023-03-06,502,iphone 15 pro max,100000,135000,35000,1,00022,India
467071,2023-03-06,501,iphone 15,60000,80000,20000,1,00281,India
467071,2023-03-06,505,oven,18490,24000,5510,1,00281,India
836352,2023-03-06,503,mixer,1349,3249,1900,1,00489,India
836352,2023-03-06,507,washing machine,6990,16490,9500,1,00489,India
836352,2023-03-06,502,iphone 15 pro max,100000,135000,35000,1,00489,India
836352,2023-03-06,504,iron,449,879,430,1,00489,India
517559,2023-03-06,502,iphone 15 pro max,100000,135000,35000,1,00473,India
517559,2023-03-06,504,iron,449,879,430,1,00473,India
517559,2023-03-06,506,monitor,3249,8000,4751,1,00473,India
517559,2023-03-06,501,iphone 15,60000,80000,20000,1,00473,India
271558,2023-03-06,501,iphone 15,60000,80000,20000,1,00022,India
271558,2023-03-06,503,mixer,1349,3249,1900,1,00022,India
271558,2023-03-06,506,monitor,3249,8000,4751,1,00022,India
271558,2023-03-06,507,washing machine,6990,16490,9500,1,00022,India
375112,2023-03-06,502,iphone 15 pro max,100000,135000,35000,1,00019,India
375112,2023-03-06,503,mixer,1349,3249,1900,1,00019,India
375112,2023-03-06,504,iron,449,879,430,1,00019,India
775739,2023-03-06,506,monitor,3249,8000,4751,1,00263,India
775739,2023-03-06,502,iphone 15 pro max,100000,135000,35000,1,00263,India
935586,2023-03-06,501,iphone 15,60000,80000,20000,1,00235,India
935586,2023-03-06,505,oven,18490,24000,5510,1,00235,India
935586,2023-03-06,507,washing machine,6990,16490,9500,1,00235,India
935586,2023-03-06,504,iron,449,879,430,1,00235,India
370839,2023-03-06,504,iron,449,879,430,1,00376,India
370839,2023-03-06,501,iphone 15,60000,80000,20000,1,00376,India
370839,2023-03-06,505,oven,18490,24000,5510,1,00376,India
643002,2023-03-06,504,iron,449,879,430,1,00396,India
376093,2023-03-06,504,iron,449,879,430,1,00004,India
680606,2023-03-06,504,iron,449,879,430,1,00276,India
680606,2023-03-06,502,iphone 15 pro max,100000,135000,35000,1,00276,India
225442,2023-03-06,502,iphone 15 pro max,100000,135000,35000,1,00136,India
225442,2023-03-06,504,iron,449,879,430,1,00136,India
225442,2023-03-06,507,washing machine,6990,16490,9500,1,00136,India
225442,2023-03-06,506,monitor,3249,8000,4751,1,00136,India
553910,2023-03-06,504,iron,449,879,430,1,00061,India
553910,2023-03-06,503,mixer,1349,3249,1900,1,00061,India
553910,2023-03-06,505,oven,18490,24000,5510,1,00061,India
553910,2023-03-06,501,iphone 15,60000,80000,20000,1,00061,India
600862,2023-03-06,505,oven,18490,24000,5510,1,00039,India
600862,2023-03-06,502,iphone 15 pro max,100000,135000,35000,1,00039,India
600862,2023-03-06,506,monitor,3249,8000,4751,1,00039,India
483877,2023-03-06,505,oven,18490,24000,5510,1,00278,India
483877,2023-03-06,506,monitor,3249,8000,4751,1,00278,India
483877,2023-03-06,503,mixer,1349,3249,1900,1,00278,India
483877,2023-03-06,501,iphone 15,60000,80000,20000,1,00278,India
827448,2023-03-06,501,iphone 15,60000,80000,20000,1,00121,India
827448,2023-03-06,503,mixer,1349,3249,1900,1,00121,India
827448,2023-03-06,504,iron,449,879,430,1,00121,India
684784,2023-03-06,502,iphone 15 pro max,100000,135000,35000,1,00399,India
667920,2023-03-06,505,oven,18490,24000,5510,1,00188,India
667920,2023-03-06,507,washing machine,6990,16490,9500,1,00188,India
667920,2023-03-06,501,iphone 15,60000,80000,20000,1,00188,India
379376,2023-03-06,504,iron,449,879,430,1,00426,India
379376,2023-03-06,502,iphone 15 pro max,100000,135000,35000,1,00426,India
379376,2023-03-06,507,washing machine,6990,16490,9500,1,00426,India
735153,2023-03-06,507,washing machine,6990,16490,9500,1,00132,India
735153,2023-03-06,505,oven,18490,24000,5510,1,00132,India
735153,2023-03-06,504,iron,449,879,430,1,00132,India
106837,2023-03-06,506,monitor,3249,8000,4751,1,00368,India
480893,2023-03-06,506,monitor,3249,8000,4751,1,00069,India
480893,2023-03-06,501,iphone 15,60000,80000,20000,1,00069,India
214083,2023-03-06,504,iron,449,879,430,1,00328,India
214083,2023-03-06,506,monitor,3249,8000,4751,1,00328,India
214083,2023-03-06,507,washing machine,6990,16490,9500,1,00328,India
214083,2023-03-06,505,oven,18490,24000,5510,1,00328,India
214083,2023-03-06,503,mixer,1349,3249,1900,1,00328,India
720726,2023-03-06,506,monitor,3249,8000,4751,1,00487,India
720726,2023-03-06,507,washing machine,6990,16490,9500,1,00487,India
720726,2023-03-06,501,iphone 15,60000,80000,20000,1,00487,India
960331,2023-03-06,501,iphone 15,60000,80000,20000,1,00077,India
960331,2023-03-06,504,iron,449,879,430,1,00077,India
960331,2023-03-06,502,iphone 15 pro max,100000,135000,35000,1,00077,India
960331,2023-03-06,506,monitor,3249,8000,4751,1,00077,India
541665,2023-03-06,503,mixer,1349,3249,1900,1,00316,India
784764,2023-03-06,504,iron,449,879,430,1,00118,India
784764,2023-03-06,502,iphone 15 pro max,100000,135000,35000,1,00118,India
617097,2023-03-06,502,iphone 15 pro max,100000,135000,35000,1,00133,India
519894,2023-03-06,507,washing machine,6990,16490,9500,1,00161,India
519894,2023-03-06,503,mixer,1349,3249,1900,1,00161,India
956934,2023-03-06,507,washing machine,6990,16490,9500,1,00344,India
956934,2023-03-06,504,iron,449,879,430,1,00344,India
956934,2023-03-06,501,iphone 15,60000,80000,20000,1,00344,India
421131,2023-03-06,505,oven,18490,24000,5510,1,00354,India
105694,2023-03-06,503,mixer,1349,3249,1900,1,00455,India
105694,2023-03-06,506,monitor,3249,8000,4751,1,00455,India
105694,2023-03-06,501,iphone 15,60000,80000,20000,1,00455,India
586869,2023-03-06,504,iron,449,879,430,1,00149,India
586869,2023-03-06,503,mixer,1349,3249,1900,1,00149,India
586869,2023-03-06,501,iphone 15,60000,80000,20000,1,00149,India
586869,2023-03-06,506,monitor,3249,8000,4751,1,00149,India
586869,2023-03-06,502,iphone 15 pro max,100000,135000,35000,1,00149,India
686874,2023-03-06,504,iron,449,879,430,1,00303,India
686874,2023-03-06,502,iphone 15 pro max,100000,135000,35000,1,00303,India
370926,2023-03-06,505,oven,18490,24000,5510,1,00398,India
370926,2023-03-06,501,iphone 15,60000,80000,20000,1,00398,India
370926,2023-03-06,507,washing machine,6990,16490,9500,1,00398,India
578187,2023-03-06,506,monitor,3249,8000,4751,1,00092,India
804208,2023-03-06,507,washing machine,6990,16490,9500,1,00144,India
804208,2023-03-06,505,oven,18490,24000,5510,1,00144,India
804208,2023-03-06,506,monitor,3249,8000,4751,1,00144,India
684188,2023-03-06,505,oven,18490,24000,5510,1,00203,India
684188,2023-03-06,502,iphone 15 pro max,100000,135000,35000,1,00203,India
182062,2023-03-06,501,iphone 15,60000,80000,20000,1,00221,India
182062,2023-03-06,507,washing machine,6990,16490,9500,1,00221,India
599954,2023-03-06,504,iron,449,879,430,1,00353,India
590139,2023-03-06,502,iphone 15 pro max,100000,135000,35000,1,00080,India
365681,2023-03-06,503,mixer,1349,3249,1900,1,00241,India
365681,2023-03-06,506,monitor,3249,8000,4751,1,00241,India
287822,2023-03-06,507,washing machine,6990,16490,9500,1,00100,India
287822,2023-03-06,504,iron,449,879,430,1,00100,India
287822,2023-03-06,506,monitor,3249,8000,4751,1,00100,India
951412,2023-03-06,507,washing machine,6990,16490,9500,1,00072,India
996387,2023-03-06,507,washing machine,6990,16490,9500,1,00383,India
996387,2023-03-06,503,mixer,1349,3249,1900,1,00383,India
996387,2023-03-06,504,iron,449,879,430,1,00383,India
996387,2023-03-06,502,iphone 15 pro max,100000,135000,35000,1,00383,India
374171,2023-03-06,503,mixer,1349,3249,1900,1,00199,India
374171,2023-03-06,502,iphone 15 pro max,100000,135000,35000,1,00199,India
374171,2023-03-06,506,monitor,3249,8000,4751,1,00199,India
917202,2023-03-06,506,monitor,3249,8000,4751,1,00473,India
917202,2023-03-06,502,iphone 15 pro max,100000,135000,35000,1,00473,India
948915,2023-03-06,507,washing machine,6990,16490,9500,1,00141,India
715729,2023-03-06,501,iphone 15,60000,80000,20000,1,00030,India
715729,2023-03-06,507,washing machine,6990,16490,9500,1,00030,India
715729,2023-03-06,504,iron,449,879,430,1,00030,India
427195,2023-03-06,505,oven,18490,24000,5510,1,00316,India
427195,2023-03-06,501,iphone 15,60000,80000,20000,1,00316,India
853178,2023-03-06,501,iphone 15,60000,80000,20000,1,00052,India
853178,2023-03-06,506,monitor,3249,8000,4751,1,00052,India
853178,2023-03-06,502,iphone 15 pro max,100000,135000,35000,1,00052,India
477177,2023-03-06,505,oven,18490,24000,5510,1,00441,India
477177,2023-03-06,501,iphone 15,60000,80000,20000,1,00441,India
856076,2023-03-06,506,monitor,3249,8000,4751,1,00232,India
856076,2023-03-06,504,iron,449,879,430,1,00232,India
258567,2023-03-06,504,iron,449,879,430,1,00251,India
258567,2023-03-06,506,monitor,3249,8000,4751,1,00251,India
258567,2023-03-06,507,washing machine,6990,16490,9500,1,00251,India
160043,2023-03-06,501,iphone 15,60000,80000,20000,1,00188,India
160043,2023-03-06,503,mixer,1349,3249,1900,1,00188,India
833020,2023-03-06,507,washing machine,6990,16490,9500,1,00151,India
833020,2023-03-06,501,iphone 15,60000,80000,20000,1,00151,India
833020,2023-03-06,503,mixer,1349,3249,1900,1,00151,India
852816,2023-03-06,504,iron,449,879,430,1,00352,India
837445,2023-03-06,506,monitor,3249,8000,4751,1,00447,India
837445,2023-03-06,507,washing machine,6990,16490,9500,1,00447,India
837445,2023-03-06,502,iphone 15 pro max,100000,135000,35000,1,00447,India
567262,2023-03-06,501,iphone 15,60000,80000,20000,1,00218,India
567262,2023-03-06,506,monitor,3249,8000,4751,1,00218,India
567262,2023-03-06,502,iphone 15 pro max,100000,135000,35000,1,00218,India
567262,2023-03-06,507,washing machine,6990,16490,9500,1,00218,India
567262,2023-03-06,503,mixer,1349,3249,1900,1,00218,India
267284,2023-03-06,505,oven,18490,24000,5510,1,00418,India
965924,2023-03-06,504,iron,449,879,430,1,00342,India
965924,2023-03-06,505,oven,18490,24000,5510,1,00342,India
965924,2023-03-06,501,iphone 15,60000,80000,20000,1,00342,India
102786,2023-03-06,504,iron,449,879,430,1,00122,India
102786,2023-03-06,506,monitor,3249,8000,4751,1,00122,India
102786,2023-03-06,507,washing machine,6990,16490,9500,1,00122,India
508631,2023-03-06,507,washing machine,6990,16490,9500,1,00284,India
508631,2023-03-06,504,iron,449,879,430,1,00284,India
508631,2023-03-06,505,oven,18490,24000,5510,1,00284,India
879519,2023-03-06,503,mixer,1349,3249,1900,1,00200,India
879519,2023-03-06,506,monitor,3249,8000,4751,1,00200,India
879519,2023-03-06,501,iphone 15,60000,80000,20000,1,00200,India
879519,2023-03-06,507,washing machine,6990,16490,9500,1,00200,India
488749,2023-03-06,504,iron,449,879,430,1,00432,India
811706,2023-03-06,501,iphone 15,60000,80000,20000,1,00023,India
811706,2023-03-06,502,iphone 15 pro max,100000,135000,35000,1,00023,India
811706,2023-03-06,507,washing machine,6990,16490,9500,1,00023,India
662633,2023-03-06,506,monitor,3249,8000,4751,1,00043,India
662633,2023-03-06,503,mixer,1349,3249,1900,1,00043,India
662633,2023-03-06,504,iron,449,879,430,1,00043,India
654901,2023-03-06,501,iphone 15,60000,80000,20000,1,00335,India
654901,2023-03-06,507,washing machine,6990,16490,9500,1,00335,India
920306,2023-03-06,507,washing machine,6990,16490,9500,1,00295,India
920306,2023-03-06,505,oven,18490,24000,5510,1,00295,India
254278,2023-03-06,504,iron,449,879,430,1,00181,India
254278,2023-03-06,505,oven,18490,24000,5510,1,00181,India
254278,2023-03-06,501,iphone 15,60000,80000,20000,1,00181,India
254278,2023-03-06,506,monitor,3249,8000,4751,1,00181,India
217539,2023-03-06,506,monitor,3249,8000,4751,1,00283,India
217539,2023-03-06,502,iphone 15 pro max,100000,135000,35000,1,00283,India
884749,2023-03-06,506,monitor,3249,8000,4751,1,00489,India
884749,2023-03-06,507,washing machine,6990,16490,9500,1,00489,India
783111,2023-03-06,502,iphone 15 pro max,100000,135000,35000,1,00330,India
783111,2023-03-06,501,iphone 15,60000,80000,20000,1,00330,India
783111,2023-03-06,506,monitor,3249,8000,4751,1,00330,India
783111,2023-03-06,507,washing machine,6990,16490,9500,1,00330,India
945250,2023-03-06,505,oven,18490,24000,5510,1,00009,India
401421,2023-03-06,502,iphone 15 pro max,100000,135000,35000,1,00148,India
175306,2023-03-06,502,iphone 15 pro max,100000,135000,35000,1,00438,India
622456,2023-03-06,504,iron,449,879,430,1,00455,India
622456,2023-03-06,503,mixer,1349,3249,1900,1,00455,India
837125,2023-03-07,503,mixer,1349,3249,1900,1,00403,India
837125,2023-03-07,507,washing machine,6990,16490,9500,1,00403,India
380244,2023-03-07,503,mixer,1349,3249,1900,1,00342,India
380244,2023-03-07,504,iron,449,879,430,1,00342,India
119835,2023-03-07,502,iphone 15 pro max,100000,135000,35000,1,00315,India
315748,2023-03-07,501,iphone 15,60000,80000,20000,1,00387,India
315748,2023-03-07,503,mixer,1349,3249,1900,1,00387,India
315748,2023-03-07,506,monitor,3249,8000,4751,1,00387,India
315748,2023-03-07,507,washing machine,6990,16490,9500,1,00387,India
292544,2023-03-07,501,iphone 15,60000,80000,20000,1,00140,India
344331,2023-03-07,504,iron,449,879,430,1,00353,India
538609,2023-03-07,503,mixer,1349,3249,1900,1,00363,India
538609,2023-03-07,502,iphone 15 pro max,100000,135000,35000,1,00363,India
538609,2023-03-07,506,monitor,3249,8000,4751,1,00363,India
538609,2023-03-07,504,iron,449,879,430,1,00363,India
538609,2023-03-07,507,washing machine,6990,16490,9500,1,00363,India
319671,2023-03-07,503,mixer,1349,3249,1900,1,00420,India
319671,2023-03-07,501,iphone 15,60000,80000,20000,1,00420,India
110570,2023-03-07,506,monitor,3249,8000,4751,1,00093,India
110570,2023-03-07,507,washing machine,6990,16490,9500,1,00093,India
110570,2023-03-07,501,iphone 15,60000,80000,20000,1,00093,India
110570,2023-03-07,504,iron,449,879,430,1,00093,India
964718,2023-03-07,506,monitor,3249,8000,4751,1,00209,India
964718,2023-03-07,501,iphone 15,60000,80000,20000,1,00209,India
988135,2023-03-07,507,washing machine,6990,16490,9500,1,00282,India
988135,2023-03-07,503,mixer,1349,3249,1900,1,00282,India
988135,2023-03-07,502,iphone 15 pro max,100000,135000,35000,1,00282,India
869963,2023-03-07,501,iphone 15,60000,80000,20000,1,00343,India
869963,2023-03-07,507,washing machine,6990,16490,9500,1,00343,India
869963,2023-03-07,502,iphone 15 pro max,100000,135000,35000,1,00343,India
869963,2023-03-07,506,monitor,3249,8000,4751,1,00343,India
856174,2023-03-07,506,monitor,3249,8000,4751,1,00429,India
856174,2023-03-07,507,washing machine,6990,16490,9500,1,00429,India
985120,2023-03-07,504,iron,449,879,430,1,00389,India
985120,2023-03-07,503,mixer,1349,3249,1900,1,00389,India
985120,2023-03-07,506,monitor,3249,8000,4751,1,00389,India
256351,2023-03-07,502,iphone 15 pro max,100000,135000,35000,1,00290,India
256351,2023-03-07,504,iron,449,879,430,1,00290,India
256351,2023-03-07,503,mixer,1349,3249,1900,1,00290,India
934892,2023-03-07,502,iphone 15 pro max,100000,135000,35000,1,00094,India
934892,2023-03-07,501,iphone 15,60000,80000,20000,1,00094,India
944994,2023-03-07,506,monitor,3249,8000,4751,1,00463,India
944994,2023-03-07,507,washing machine,6990,16490,9500,1,00463,India
944994,2023-03-07,502,iphone 15 pro max,100000,135000,35000,1,00463,India
944994,2023-03-07,505,oven,18490,24000,5510,1,00463,India
975622,2023-03-07,506,monitor,3249,8000,4751,1,00393,India
615430,2023-03-07,501,iphone 15,60000,80000,20000,1,00222,India
128949,2023-03-07,502,iphone 15 pro max,100000,135000,35000,1,00165,India
128949,2023-03-07,507,washing machine,6990,16490,9500,1,00165,India
128949,2023-03-07,505,oven,18490,24000,5510,1,00165,India
189570,2023-03-07,502,iphone 15 pro max,100000,135000,35000,1,00111,India
189570,2023-03-07,506,monitor,3249,8000,4751,1,00111,India
189570,2023-03-07,507,washing machine,6990,16490,9500,1,00111,India
189570,2023-03-07,504,iron,449,879,430,1,00111,India
569511,2023-03-07,506,monitor,3249,8000,4751,1,00236,India
569511,2023-03-07,507,washing machine,6990,16490,9500,1,00236,India
569511,2023-03-07,503,mixer,1349,3249,1900,1,00236,India
569511,2023-03-07,505,oven,18490,24000,5510,1,00236,India
921263,2023-03-07,502,iphone 15 pro max,100000,135000,35000,1,00309,India
921263,2023-03-07,506,monitor,3249,8000,4751,1,00309,India
921263,2023-03-07,504,iron,449,879,430,1,00309,India
921263,2023-03-07,501,iphone 15,60000,80000,20000,1,00309,India
161873,2023-03-07,507,washing machine,6990,16490,9500,1,00338,India
361850,2023-03-07,505,oven,18490,24000,5510,1,00410,India
361850,2023-03-07,506,monitor,3249,8000,4751,1,00410,India
361850,2023-03-07,507,washing machine,6990,16490,9500,1,00410,India
343310,2023-03-07,504,iron,449,879,430,1,00029,India
343310,2023-03-07,507,washing machine,6990,16490,9500,1,00029,India
484396,2023-03-07,506,monitor,3249,8000,4751,1,00318,India
877122,2023-03-07,507,washing machine,6990,16490,9500,1,00072,India
877122,2023-03-07,501,iphone 15,60000,80000,20000,1,00072,India
877122,2023-03-07,502,iphone 15 pro max,100000,135000,35000,1,00072,India
721857,2023-03-07,507,washing machine,6990,16490,9500,1,00280,India
278813,2023-03-07,506,monitor,3249,8000,4751,1,00270,India
278813,2023-03-07,501,iphone 15,60000,80000,20000,1,00270,India
285475,2023-03-07,506,monitor,3249,8000,4751,1,00102,India
129509,2023-03-07,505,oven,18490,24000,5510,1,00165,India
129509,2023-03-07,507,washing machine,6990,16490,9500,1,00165,India
129509,2023-03-07,503,mixer,1349,3249,1900,1,00165,India
462302,2023-03-07,504,iron,449,879,430,1,00064,India
462302,2023-03-07,501,iphone 15,60000,80000,20000,1,00064,India
588378,2023-03-07,505,oven,18490,24000,5510,1,00466,India
588378,2023-03-07,504,iron,449,879,430,1,00466,India
588378,2023-03-07,503,mixer,1349,3249,1900,1,00466,India
588378,2023-03-07,507,washing machine,6990,16490,9500,1,00466,India
138376,2023-03-07,505,oven,18490,24000,5510,1,00149,India
138376,2023-03-07,507,washing machine,6990,16490,9500,1,00149,India
111947,2023-03-07,507,washing machine,6990,16490,9500,1,00185,India
111947,2023-03-07,504,iron,449,879,430,1,00185,India
574107,2023-03-07,503,mixer,1349,3249,1900,1,00466,India
574107,2023-03-07,501,iphone 15,60000,80000,20000,1,00466,India
574107,2023-03-07,507,washing machine,6990,16490,9500,1,00466,India
637156,2023-03-07,501,iphone 15,60000,80000,20000,1,00225,India
637156,2023-03-07,504,iron,449,879,430,1,00225,India
553654,2023-03-07,505,oven,18490,24000,5510,1,00364,India
553654,2023-03-07,507,washing machine,6990,16490,9500,1,00364,India
553654,2023-03-07,502,iphone 15 pro max,100000,135000,35000,1,00364,India
553654,2023-03-07,503,mixer,1349,3249,1900,1,00364,India
505188,2023-03-07,505,oven,18490,24000,5510,1,00067,India
505188,2023-03-07,503,mixer,1349,3249,1900,1,00067,India
505188,2023-03-07,502,iphone 15 pro max,100000,135000,35000,1,00067,India
505188,2023-03-07,507,washing machine,6990,16490,9500,1,00067,India
813880,2023-03-07,504,iron,449,879,430,1,00010,India
813880,2023-03-07,501,iphone 15,60000,80000,20000,1,00010,India
582122,2023-03-07,507,washing machine,6990,16490,9500,1,00340,India
582122,2023-03-07,504,iron,449,879,430,1,00340,India
415433,2023-03-07,504,iron,449,879,430,1,00318,India
415433,2023-03-07,503,mixer,1349,3249,1900,1,00318,India
160292,2023-03-07,506,monitor,3249,8000,4751,1,00361,India
654688,2023-03-07,502,iphone 15 pro max,100000,135000,35000,1,00242,India
654688,2023-03-07,503,mixer,1349,3249,1900,1,00242,India
654688,2023-03-07,504,iron,449,879,430,1,00242,India
654688,2023-03-07,506,monitor,3249,8000,4751,1,00242,India
954136,2023-03-07,502,iphone 15 pro max,100000,135000,35000,1,00060,India
954136,2023-03-07,505,oven,18490,24000,5510,1,00060,India
954136,2023-03-07,501,iphone 15,60000,80000,20000,1,00060,India
286147,2023-03-07,501,iphone 15,60000,80000,20000,1,00214,India
286147,2023-03-07,506,monitor,3249,8000,4751,1,00214,India
286147,2023-03-07,504,iron,449,879,430,1,00214,India
286147,2023-03-07,503,mixer,1349,3249,1900,1,00214,India
420226,2023-03-07,504,iron,449,879,430,1,00175,India
420226,2023-03-07,505,oven,18490,24000,5510,1,00175,India
420226,2023-03-07,506,monitor,3249,8000,4751,1,00175,India
988116,2023-03-07,507,washing machine,6990,16490,9500,1,00321,India
556509,2023-03-07,507,washing machine,6990,16490,9500,1,00442,India
556509,2023-03-07,504,iron,449,879,430,1,00442,India
225494,2023-03-07,505,oven,18490,24000,5510,1,00058,India
225494,2023-03-07,501,iphone 15,60000,80000,20000,1,00058,India
264835,2023-03-07,507,washing machine,6990,16490,9500,1,00288,India
407434,2023-03-07,505,oven,18490,24000,5510,1,00351,India
407434,2023-03-07,506,monitor,3249,8000,4751,1,00351,India
407434,2023-03-07,504,iron,449,879,430,1,00351,India
407434,2023-03-07,503,mixer,1349,3249,1900,1,00351,India
808740,2023-03-07,506,monitor,3249,8000,4751,1,00288,India
808740,2023-03-07,504,iron,449,879,430,1,00288,India
808740,2023-03-07,501,iphone 15,60000,80000,20000,1,00288,India
808740,2023-03-07,502,iphone 15 pro max,100000,135000,35000,1,00288,India
708445,2023-03-07,503,mixer,1349,3249,1900,1,00441,India
708445,2023-03-07,504,iron,449,879,430,1,00441,India
708445,2023-03-07,506,monitor,3249,8000,4751,1,00441,India
874942,2023-03-07,507,washing machine,6990,16490,9500,1,00160,India
874942,2023-03-07,501,iphone 15,60000,80000,20000,1,00160,India
874942,2023-03-07,502,iphone 15 pro max,100000,135000,35000,1,00160,India
874942,2023-03-07,506,monitor,3249,8000,4751,1,00160,India
204995,2023-03-07,501,iphone 15,60000,80000,20000,1,00006,India
792509,2023-03-07,507,washing machine,6990,16490,9500,1,00116,India
422235,2023-03-07,503,mixer,1349,3249,1900,1,00145,India
422235,2023-03-07,504,iron,449,879,430,1,00145,India
422235,2023-03-07,505,oven,18490,24000,5510,1,00145,India
422235,2023-03-07,506,monitor,3249,8000,4751,1,00145,India
103764,2023-03-07,506,monitor,3249,8000,4751,1,00170,India
103764,2023-03-07,502,iphone 15 pro max,100000,135000,35000,1,00170,India
749963,2023-03-07,505,oven,18490,24000,5510,1,00097,India
749963,2023-03-07,501,iphone 15,60000,80000,20000,1,00097,India
749963,2023-03-07,502,iphone 15 pro max,100000,135000,35000,1,00097,India
683431,2023-03-07,501,iphone 15,60000,80000,20000,1,00426,India
683431,2023-03-07,507,washing machine,6990,16490,9500,1,00426,India
111925,2023-03-07,503,mixer,1349,3249,1900,1,00188,India
111925,2023-03-07,507,washing machine,6990,16490,9500,1,00188,India
111925,2023-03-07,505,oven,18490,24000,5510,1,00188,India
111925,2023-03-07,502,iphone 15 pro max,100000,135000,35000,1,00188,India
228837,2023-03-07,507,washing machine,6990,16490,9500,1,00090,India
228837,2023-03-07,501,iphone 15,60000,80000,20000,1,00090,India
228837,2023-03-07,504,iron,449,879,430,1,00090,India
228837,2023-03-07,505,oven,18490,24000,5510,1,00090,India
842397,2023-03-07,507,washing machine,6990,16490,9500,1,00171,India
842397,2023-03-07,501,iphone 15,60000,80000,20000,1,00171,India
842397,2023-03-07,502,iphone 15 pro max,100000,135000,35000,1,00171,India
225108,2023-03-07,503,mixer,1349,3249,1900,1,00037,India
341745,2023-03-07,506,monitor,3249,8000,4751,1,00482,India
341745,2023-03-07,507,washing machine,6990,16490,9500,1,00482,India
310492,2023-03-07,502,iphone 15 pro max,100000,135000,35000,1,00415,India
870326,2023-03-07,507,washing machine,6990,16490,9500,1,00093,India
870326,2023-03-07,504,iron,449,879,430,1,00093,India
870326,2023-03-07,503,mixer,1349,3249,1900,1,00093,India
870326,2023-03-07,505,oven,18490,24000,5510,1,00093,India
614898,2023-03-07,502,iphone 15 pro max,100000,135000,35000,1,00385,India
614898,2023-03-07,501,iphone 15,60000,80000,20000,1,00385,India
614898,2023-03-07,504,iron,449,879,430,1,00385,India
828551,2023-03-07,502,iphone 15 pro max,100000,135000,35000,1,00207,India
828551,2023-03-07,506,monitor,3249,8000,4751,1,00207,India
468513,2023-03-07,503,mixer,1349,3249,1900,1,00301,India
574282,2023-03-07,501,iphone 15,60000,80000,20000,1,00500,India
574282,2023-03-07,506,monitor,3249,8000,4751,1,00500,India
127318,2023-03-07,507,washing machine,6990,16490,9500,1,00355,India
127318,2023-03-07,501,iphone 15,60000,80000,20000,1,00355,India
148061,2023-03-07,501,iphone 15,60000,80000,20000,1,00187,India
148061,2023-03-07,505,oven,18490,24000,5510,1,00187,India
148061,2023-03-07,504,iron,449,879,430,1,00187,India
919892,2023-03-07,505,oven,18490,24000,5510,1,00358,India
831955,2023-03-07,501,iphone 15,60000,80000,20000,1,00444,India
831955,2023-03-07,502,iphone 15 pro max,100000,135000,35000,1,00444,India
825072,2023-03-07,504,iron,449,879,430,1,00422,India
825072,2023-03-07,503,mixer,1349,3249,1900,1,00422,India
825072,2023-03-07,505,oven,18490,24000,5510,1,00422,India
873452,2023-03-07,506,monitor,3249,8000,4751,1,00281,India
873452,2023-03-07,504,iron,449,879,430,1,00281,India
962994,2023-03-07,502,iphone 15 pro max,100000,135000,35000,1,00460,India
962994,2023-03-07,507,washing machine,6990,16490,9500,1,00460,India
538093,2023-03-07,506,monitor,3249,8000,4751,1,00256,India
538093,2023-03-07,507,washing machine,6990,16490,9500,1,00256,India
538093,2023-03-07,501,iphone 15,60000,80000,20000,1,00256,India
538093,2023-03-07,502,iphone 15 pro max,100000,135000,35000,1,00256,India
183459,2023-03-07,504,iron,449,879,430,1,00064,India
183459,2023-03-07,505,oven,18490,24000,5510,1,00064,India
183459,2023-03-07,502,iphone 15 pro max,100000,135000,35000,1,00064,India
150382,2023-03-07,505,oven,18490,24000,5510,1,00188,India
150382,2023-03-07,501,iphone 15,60000,80000,20000,1,00188,India
933490,2023-03-07,505,oven,18490,24000,5510,1,00444,India
933490,2023-03-07,503,mixer,1349,3249,1900,1,00444,India
578310,2023-03-07,502,iphone 15 pro max,100000,135000,35000,1,00132,India
578310,2023-03-07,501,iphone 15,60000,80000,20000,1,00132,India
578310,2023-03-07,507,washing machine,6990,16490,9500,1,00132,India
525704,2023-03-07,507,washing machine,6990,16490,9500,1,00060,India
525704,2023-03-07,502,iphone 15 pro max,100000,135000,35000,1,00060,India
525704,2023-03-07,506,monitor,3249,8000,4751,1,00060,India
390858,2023-03-07,503,mixer,1349,3249,1900,1,00130,India
390858,2023-03-07,502,iphone 15 pro max,100000,135000,35000,1,00130,India
390858,2023-03-07,506,monitor,3249,8000,4751,1,00130,India
796577,2023-03-07,505,oven,18490,24000,5510,1,00148,India
796577,2023-03-07,501,iphone 15,60000,80000,20000,1,00148,India
796577,2023-03-07,504,iron,449,879,430,1,00148,India
727589,2023-03-07,504,iron,449,879,430,1,00235,India
727589,2023-03-07,507,washing machine,6990,16490,9500,1,00235,India
439562,2023-03-07,504,iron,449,879,430,1,00042,India
439562,2023-03-07,505,oven,18490,24000,5510,1,00042,India
439562,2023-03-07,503,mixer,1349,3249,1900,1,00042,India
439562,2023-03-07,502,iphone 15 pro max,100000,135000,35000,1,00042,India
941697,2023-03-07,501,iphone 15,60000,80000,20000,1,00261,India
941697,2023-03-07,507,washing machine,6990,16490,9500,1,00261,India
941697,2023-03-07,503,mixer,1349,3249,1900,1,00261,India
941697,2023-03-07,502,iphone 15 pro max,100000,135000,35000,1,00261,India
367963,2023-03-07,502,iphone 15 pro max,100000,135000,35000,1,00407,India
367963,2023-03-07,507,washing machine,6990,16490,9500,1,00407,India
367963,2023-03-07,506,monitor,3249,8000,4751,1,00407,India
519161,2023-03-07,504,iron,449,879,430,1,00040,India
519161,2023-03-07,506,monitor,3249,8000,4751,1,00040,India
519161,2023-03-07,502,iphone 15 pro max,100000,135000,35000,1,00040,India
880250,2023-03-07,505,oven,18490,24000,5510,1,00044,India
880250,2023-03-07,501,iphone 15,60000,80000,20000,1,00044,India
880250,2023-03-07,506,monitor,3249,8000,4751,1,00044,India
540397,2023-03-07,501,iphone 15,60000,80000,20000,1,00015,India
540397,2023-03-07,506,monitor,3249,8000,4751,1,00015,India
540397,2023-03-07,502,iphone 15 pro max,100000,135000,35000,1,00015,India
537785,2023-03-07,504,iron,449,879,430,1,00295,India
537785,2023-03-07,503,mixer,1349,3249,1900,1,00295,India
537785,2023-03-07,502,iphone 15 pro max,100000,135000,35000,1,00295,India
537785,2023-03-07,505,oven,18490,24000,5510,1,00295,India
186177,2023-03-07,504,iron,449,879,430,1,00381,India
186177,2023-03-07,507,washing machine,6990,16490,9500,1,00381,India
186177,2023-03-07,503,mixer,1349,3249,1900,1,00381,India
186177,2023-03-07,501,iphone 15,60000,80000,20000,1,00381,India
692443,2023-03-07,503,mixer,1349,3249,1900,1,00403,India
350776,2023-03-07,507,washing machine,6990,16490,9500,1,00253,India
350776,2023-03-07,504,iron,449,879,430,1,00253,India
350776,2023-03-07,501,iphone 15,60000,80000,20000,1,00253,India
986706,2023-03-08,503,mixer,1349,3249,1900,1,00420,India
647546,2023-03-08,502,iphone 15 pro max,100000,135000,35000,1,00472,India
647546,2023-03-08,506,monitor,3249,8000,4751,1,00472,India
790172,2023-03-08,506,monitor,3249,8000,4751,1,00135,India
790172,2023-03-08,503,mixer,1349,3249,1900,1,00135,India
790172,2023-03-08,505,oven,18490,24000,5510,1,00135,India
549781,2023-03-08,504,iron,449,879,430,1,00162,India
549781,2023-03-08,506,monitor,3249,8000,4751,1,00162,India
549781,2023-03-08,505,oven,18490,24000,5510,1,00162,India
422094,2023-03-08,507,washing machine,6990,16490,9500,1,00264,India
422094,2023-03-08,506,monitor,3249,8000,4751,1,00264,India
507271,2023-03-08,502,iphone 15 pro max,100000,135000,35000,1,00083,India
942511,2023-03-08,502,iphone 15 pro max,100000,135000,35000,1,00315,India
942511,2023-03-08,506,monitor,3249,8000,4751,1,00315,India
942511,2023-03-08,504,iron,449,879,430,1,00315,India
981893,2023-03-08,503,mixer,1349,3249,1900,1,00168,India
140486,2023-03-08,504,iron,449,879,430,1,00464,India
140486,2023-03-08,503,mixer,1349,3249,1900,1,00464,India
140486,2023-03-08,501,iphone 15,60000,80000,20000,1,00464,India
140486,2023-03-08,506,monitor,3249,8000,4751,1,00464,India
289156,2023-03-08,504,iron,449,879,430,1,00001,India
289156,2023-03-08,506,monitor,3249,8000,4751,1,00001,India
245787,2023-03-08,503,mixer,1349,3249,1900,1,00017,India
245787,2023-03-08,506,monitor,3249,8000,4751,1,00017,India
245787,2023-03-08,502,iphone 15 pro max,100000,135000,35000,1,00017,India
687817,2023-03-08,502,iphone 15 pro max,100000,135000,35000,1,00496,India
687817,2023-03-08,501,iphone 15,60000,80000,20000,1,00496,India
687817,2023-03-08,505,oven,18490,24000,5510,1,00496,India
296003,2023-03-08,501,iphone 15,60000,80000,20000,1,00466,India
296003,2023-03-08,505,oven,18490,24000,5510,1,00466,India
296003,2023-03-08,504,iron,449,879,430,1,00466,India
296003,2023-03-08,503,mixer,1349,3249,1900,1,00466,India
726129,2023-03-08,504,iron,449,879,430,1,00075,India
726129,2023-03-08,503,mixer,1349,3249,1900,1,00075,India
726129,2023-03-08,507,washing machine,6990,16490,9500,1,00075,India
535754,2023-03-08,507,washing machine,6990,16490,9500,1,00409,India
535754,2023-03-08,506,monitor,3249,8000,4751,1,00409,India
118123,2023-03-08,501,iphone 15,60000,80000,20000,1,00184,India
176259,2023-03-08,503,mixer,1349,3249,1900,1,00390,India
176259,2023-03-08,507,washing machine,6990,16490,9500,1,00390,India
176259,2023-03-08,504,iron,449,879,430,1,00390,India
176259,2023-03-08,505,oven,18490,24000,5510,1,00390,India
547508,2023-03-08,504,iron,449,879,430,1,00442,India
547508,2023-03-08,505,oven,18490,24000,5510,1,00442,India
547508,2023-03-08,503,mixer,1349,3249,1900,1,00442,India
547508,2023-03-08,502,iphone 15 pro max,100000,135000,35000,1,00442,India
880100,2023-03-08,507,washing machine,6990,16490,9500,1,00488,India
115140,2023-03-08,507,washing machine,6990,16490,9500,1,00471,India
663657,2023-03-08,503,mixer,1349,3249,1900,1,00403,India
663657,2023-03-08,504,iron,449,879,430,1,00403,India
663657,2023-03-08,506,monitor,3249,8000,4751,1,00403,India
459207,2023-03-08,502,iphone 15 pro max,100000,135000,35000,1,00412,India
459207,2023-03-08,504,iron,449,879,430,1,00412,India
141323,2023-03-08,503,mixer,1349,3249,1900,1,00367,India
484629,2023-03-08,501,iphone 15,60000,80000,20000,1,00363,India
484629,2023-03-08,505,oven,18490,24000,5510,1,00363,India
207880,2023-03-08,506,monitor,3249,8000,4751,1,00068,India
207880,2023-03-08,502,iphone 15 pro max,100000,135000,35000,1,00068,India
207880,2023-03-08,505,oven,18490,24000,5510,1,00068,India
490615,2023-03-08,507,washing machine,6990,16490,9500,1,00052,India
490615,2023-03-08,504,iron,449,879,430,1,00052,India
490615,2023-03-08,503,mixer,1349,3249,1900,1,00052,India
891340,2023-03-08,506,monitor,3249,8000,4751,1,00131,India
891340,2023-03-08,501,iphone 15,60000,80000,20000,1,00131,India
891340,2023-03-08,504,iron,449,879,430,1,00131,India
263596,2023-03-08,505,oven,18490,24000,5510,1,00318,India
787604,2023-03-08,507,washing machine,6990,16490,9500,1,00452,India
787604,2023-03-08,505,oven,18490,24000,5510,1,00452,India
787604,2023-03-08,503,mixer,1349,3249,1900,1,00452,India
130655,2023-03-08,503,mixer,1349,3249,1900,1,00099,India
130655,2023-03-08,502,iphone 15 pro max,100000,135000,35000,1,00099,India
637118,2023-03-08,501,iphone 15,60000,80000,20000,1,00294,India
637118,2023-03-08,506,monitor,3249,8000,4751,1,00294,India
133760,2023-03-08,507,washing machine,6990,16490,9500,1,00039,India
133760,2023-03-08,504,iron,449,879,430,1,00039,India
133760,2023-03-08,501,iphone 15,60000,80000,20000,1,00039,India
574444,2023-03-08,507,washing machine,6990,16490,9500,1,00001,India
574444,2023-03-08,505,oven,18490,24000,5510,1,00001,India
824754,2023-03-08,502,iphone 15 pro max,100000,135000,35000,1,00444,India
994159,2023-03-08,501,iphone 15,60000,80000,20000,1,00198,India
686122,2023-03-08,504,iron,449,879,430,1,00063,India
686122,2023-03-08,502,iphone 15 pro max,100000,135000,35000,1,00063,India
686122,2023-03-08,501,iphone 15,60000,80000,20000,1,00063,India
587147,2023-03-08,507,washing machine,6990,16490,9500,1,00305,India
587147,2023-03-08,504,iron,449,879,430,1,00305,India
587147,2023-03-08,503,mixer,1349,3249,1900,1,00305,India
926517,2023-03-08,505,oven,18490,24000,5510,1,00479,India
926517,2023-03-08,501,iphone 15,60000,80000,20000,1,00479,India
905981,2023-03-08,505,oven,18490,24000,5510,1,00187,India
905981,2023-03-08,506,monitor,3249,8000,4751,1,00187,India
336514,2023-03-08,504,iron,449,879,430,1,00403,India
336514,2023-03-08,502,iphone 15 pro max,100000,135000,35000,1,00403,India
336514,2023-03-08,501,iphone 15,60000,80000,20000,1,00403,India
380577,2023-03-08,501,iphone 15,60000,80000,20000,1,00099,India
407289,2023-03-08,504,iron,449,879,430,1,00497,India
819367,2023-03-08,502,iphone 15 pro max,100000,135000,35000,1,00049,India
819367,2023-03-08,506,monitor,3249,8000,4751,1,00049,India
496033,2023-03-08,504,iron,449,879,430,1,00335,India
496033,2023-03-08,506,monitor,3249,8000,4751,1,00335,India
496033,2023-03-08,507,washing machine,6990,16490,9500,1,00335,India
496033,2023-03-08,503,mixer,1349,3249,1900,1,00335,India
503298,2023-03-08,507,washing machine,6990,16490,9500,1,00123,India
503298,2023-03-08,501,iphone 15,60000,80000,20000,1,00123,India
503298,2023-03-08,505,oven,18490,24000,5510,1,00123,India
503298,2023-03-08,504,iron,449,879,430,1,00123,India
999720,2023-03-08,501,iphone 15,60000,80000,20000,1,00031,India
999720,2023-03-08,502,iphone 15 pro max,100000,135000,35000,1,00031,India
999720,2023-03-08,507,washing machine,6990,16490,9500,1,00031,India
176974,2023-03-08,506,monitor,3249,8000,4751,1,00239,India
176974,2023-03-08,502,iphone 15 pro max,100000,135000,35000,1,00239,India
920848,2023-03-08,507,washing machine,6990,16490,9500,1,00017,India
920848,2023-03-08,504,iron,449,879,430,1,00017,India
920848,2023-03-08,502,iphone 15 pro max,100000,135000,35000,1,00017,India
401928,2023-03-08,501,iphone 15,60000,80000,20000,1,00497,India
401928,2023-03-08,507,washing machine,6990,16490,9500,1,00497,India
401928,2023-03-08,505,oven,18490,24000,5510,1,00497,India
321182,2023-03-08,507,washing machine,6990,16490,9500,1,00063,India
321182,2023-03-08,502,iphone 15 pro max,100000,135000,35000,1,00063,India
321182,2023-03-08,501,iphone 15,60000,80000,20000,1,00063,India
442532,2023-03-08,507,washing machine,6990,16490,9500,1,00014,India
442532,2023-03-08,503,mixer,1349,3249,1900,1,00014,India
442532,2023-03-08,506,monitor,3249,8000,4751,1,00014,India
906455,2023-03-08,501,iphone 15,60000,80000,20000,1,00091,India
118980,2023-03-08,503,mixer,1349,3249,1900,1,00076,India
926745,2023-03-08,504,iron,449,879,430,1,00228,India
926745,2023-03-08,502,iphone 15 pro max,100000,135000,35000,1,00228,India
926745,2023-03-08,505,oven,18490,24000,5510,1,00228,India
618687,2023-03-08,502,iphone 15 pro max,100000,135000,35000,1,00066,India
618687,2023-03-08,506,monitor,3249,8000,4751,1,00066,India
618687,2023-03-08,501,iphone 15,60000,80000,20000,1,00066,India
597579,2023-03-08,506,monitor,3249,8000,4751,1,00455,India
597579,2023-03-08,503,mixer,1349,3249,1900,1,00455,India
703152,2023-03-08,503,mixer,1349,3249,1900,1,00204,India
703152,2023-03-08,502,iphone 15 pro max,100000,135000,35000,1,00204,India
374059,2023-03-08,506,monitor,3249,8000,4751,1,00043,India
374059,2023-03-08,504,iron,449,879,430,1,00043,India
374059,2023-03-08,505,oven,18490,24000,5510,1,00043,India
374059,2023-03-08,502,iphone 15 pro max,100000,135000,35000,1,00043,India
559021,2023-03-08,504,iron,449,879,430,1,00306,India
559021,2023-03-08,506,monitor,3249,8000,4751,1,00306,India
559021,2023-03-08,502,iphone 15 pro max,100000,135000,35000,1,00306,India
559021,2023-03-08,503,mixer,1349,3249,1900,1,00306,India
327421,2023-03-08,506,monitor,3249,8000,4751,1,00072,India
327421,2023-03-08,503,mixer,1349,3249,1900,1,00072,India
327421,2023-03-08,505,oven,18490,24000,5510,1,00072,India
851291,2023-03-08,505,oven,18490,24000,5510,1,00058,India
851291,2023-03-08,504,iron,449,879,430,1,00058,India
851291,2023-03-08,501,iphone 15,60000,80000,20000,1,00058,India
851291,2023-03-08,503,mixer,1349,3249,1900,1,00058,India
540970,2023-03-08,506,monitor,3249,8000,4751,1,00315,India
498363,2023-03-09,507,washing machine,6990,16490,9500,1,00414,India
448585,2023-03-09,503,mixer,1349,3249,1900,1,00312,India
448585,2023-03-09,501,iphone 15,60000,80000,20000,1,00312,India
994339,2023-03-09,507,washing machine,6990,16490,9500,1,00251,India
314354,2023-03-09,503,mixer,1349,3249,1900,1,00171,India
822782,2023-03-09,502,iphone 15 pro max,100000,135000,35000,1,00431,India
822782,2023-03-09,506,monitor,3249,8000,4751,1,00431,India
578093,2023-03-09,507,washing machine,6990,16490,9500,1,00356,India
578093,2023-03-09,502,iphone 15 pro max,100000,135000,35000,1,00356,India
578093,2023-03-09,505,oven,18490,24000,5510,1,00356,India
240095,2023-03-09,506,monitor,3249,8000,4751,1,00215,India
240095,2023-03-09,501,iphone 15,60000,80000,20000,1,00215,India
240095,2023-03-09,502,iphone 15 pro max,100000,135000,35000,1,00215,India
900176,2023-03-09,504,iron,449,879,430,1,00363,India
861209,2023-03-09,507,washing machine,6990,16490,9500,1,00232,India
329411,2023-03-09,506,monitor,3249,8000,4751,1,00260,India
329411,2023-03-09,504,iron,449,879,430,1,00260,India
329411,2023-03-09,507,washing machine,6990,16490,9500,1,00260,India
329411,2023-03-09,503,mixer,1349,3249,1900,1,00260,India
685143,2023-03-09,506,monitor,3249,8000,4751,1,00196,India
247369,2023-03-09,502,iphone 15 pro max,100000,135000,35000,1,00409,India
247369,2023-03-09,501,iphone 15,60000,80000,20000,1,00409,India
247369,2023-03-09,503,mixer,1349,3249,1900,1,00409,India
247369,2023-03-09,507,washing machine,6990,16490,9500,1,00409,India
327510,2023-03-09,507,washing machine,6990,16490,9500,1,00250,India
276243,2023-03-09,506,monitor,3249,8000,4751,1,00420,India
276243,2023-03-09,505,oven,18490,24000,5510,1,00420,India
276243,2023-03-09,507,washing machine,6990,16490,9500,1,00420,India
276243,2023-03-09,504,iron,449,879,430,1,00420,India
276243,2023-03-09,502,iphone 15 pro max,100000,135000,35000,1,00420,India
198584,2023-03-09,506,monitor,3249,8000,4751,1,00099,India
104562,2023-03-09,504,iron,449,879,430,1,00144,India
104562,2023-03-09,505,oven,18490,24000,5510,1,00144,India
359045,2023-03-09,507,washing machine,6990,16490,9500,1,00160,India
359045,2023-03-09,503,mixer,1349,3249,1900,1,00160,India
301686,2023-03-09,506,monitor,3249,8000,4751,1,00035,India
671987,2023-03-09,503,mixer,1349,3249,1900,1,00410,India
671987,2023-03-09,501,iphone 15,60000,80000,20000,1,00410,India
391664,2023-03-09,505,oven,18490,24000,5510,1,00013,India
391664,2023-03-09,506,monitor,3249,8000,4751,1,00013,India
391664,2023-03-09,502,iphone 15 pro max,100000,135000,35000,1,00013,India
391664,2023-03-09,504,iron,449,879,430,1,00013,India
945435,2023-03-09,506,monitor,3249,8000,4751,1,00115,India
945435,2023-03-09,505,oven,18490,24000,5510,1,00115,India
945435,2023-03-09,503,mixer,1349,3249,1900,1,00115,India
945435,2023-03-09,504,iron,449,879,430,1,00115,India
421515,2023-03-09,501,iphone 15,60000,80000,20000,1,00069,India
738081,2023-03-09,504,iron,449,879,430,1,00243,India
970541,2023-03-09,505,oven,18490,24000,5510,1,00438,India
595379,2023-03-09,506,monitor,3249,8000,4751,1,00351,India
595379,2023-03-09,507,washing machine,6990,16490,9500,1,00351,India
595379,2023-03-09,505,oven,18490,24000,5510,1,00351,India
376524,2023-03-09,507,washing machine,6990,16490,9500,1,00076,India
376524,2023-03-09,503,mixer,1349,3249,1900,1,00076,India
408162,2023-03-09,501,iphone 15,60000,80000,20000,1,00415,India
408162,2023-03-09,504,iron,449,879,430,1,00415,India
408162,2023-03-09,505,oven,18490,24000,5510,1,00415,India
408162,2023-03-09,506,monitor,3249,8000,4751,1,00415,India
313294,2023-03-09,501,iphone 15,60000,80000,20000,1,00019,India
313294,2023-03-09,502,iphone 15 pro max,100000,135000,35000,1,00019,India
313294,2023-03-09,504,iron,449,879,430,1,00019,India
831373,2023-03-09,506,monitor,3249,8000,4751,1,00322,India
831373,2023-03-09,503,mixer,1349,3249,1900,1,00322,India
831373,2023-03-09,504,iron,449,879,430,1,00322,India
831373,2023-03-09,502,iphone 15 pro max,100000,135000,35000,1,00322,India
205697,2023-03-09,505,oven,18490,24000,5510,1,00253,India
205697,2023-03-09,503,mixer,1349,3249,1900,1,00253,India
472685,2023-03-09,507,washing machine,6990,16490,9500,1,00256,India
783033,2023-03-09,507,washing machine,6990,16490,9500,1,00375,India
783033,2023-03-09,501,iphone 15,60000,80000,20000,1,00375,India
813337,2023-03-09,505,oven,18490,24000,5510,1,00304,India
813337,2023-03-09,503,mixer,1349,3249,1900,1,00304,India
813337,2023-03-09,502,iphone 15 pro max,100000,135000,35000,1,00304,India
784454,2023-03-09,507,washing machine,6990,16490,9500,1,00120,India
784454,2023-03-09,502,iphone 15 pro max,100000,135000,35000,1,00120,India
784454,2023-03-09,506,monitor,3249,8000,4751,1,00120,India
263372,2023-03-09,503,mixer,1349,3249,1900,1,00467,India
263372,2023-03-09,505,oven,18490,24000,5510,1,00467,India
263372,2023-03-09,506,monitor,3249,8000,4751,1,00467,India
263372,2023-03-09,501,iphone 15,60000,80000,20000,1,00467,India
371822,2023-03-09,503,mixer,1349,3249,1900,1,00139,India
371822,2023-03-09,507,washing machine,6990,16490,9500,1,00139,India
371822,2023-03-09,501,iphone 15,60000,80000,20000,1,00139,India
799517,2023-03-09,502,iphone 15 pro max,100000,135000,35000,1,00264,India
799517,2023-03-09,507,washing machine,6990,16490,9500,1,00264,India
799517,2023-03-09,503,mixer,1349,3249,1900,1,00264,India
799517,2023-03-09,504,iron,449,879,430,1,00264,India
734413,2023-03-09,505,oven,18490,24000,5510,1,00271,India
734413,2023-03-09,504,iron,449,879,430,1,00271,India
734413,2023-03-09,503,mixer,1349,3249,1900,1,00271,India
734413,2023-03-09,507,washing machine,6990,16490,9500,1,00271,India
596785,2023-03-09,501,iphone 15,60000,80000,20000,1,00428,India
596785,2023-03-09,503,mixer,1349,3249,1900,1,00428,India
596785,2023-03-09,505,oven,18490,24000,5510,1,00428,India
596785,2023-03-09,506,monitor,3249,8000,4751,1,00428,India
429544,2023-03-09,504,iron,449,879,430,1,00297,India
429544,2023-03-09,502,iphone 15 pro max,100000,135000,35000,1,00297,India
429544,2023-03-09,503,mixer,1349,3249,1900,1,00297,India
390854,2023-03-09,507,washing machine,6990,16490,9500,1,00190,India
390854,2023-03-09,501,iphone 15,60000,80000,20000,1,00190,India
390854,2023-03-09,502,iphone 15 pro max,100000,135000,35000,1,00190,India
390854,2023-03-09,506,monitor,3249,8000,4751,1,00190,India
412930,2023-03-09,502,iphone 15 pro max,100000,135000,35000,1,00430,India
412930,2023-03-09,507,washing machine,6990,16490,9500,1,00430,India
412930,2023-03-09,501,iphone 15,60000,80000,20000,1,00430,India
170221,2023-03-09,501,iphone 15,60000,80000,20000,1,00217,India
170221,2023-03-09,504,iron,449,879,430,1,00217,India
893150,2023-03-09,504,iron,449,879,430,1,00132,India
893150,2023-03-09,501,iphone 15,60000,80000,20000,1,00132,India
310599,2023-03-09,501,iphone 15,60000,80000,20000,1,00041,India
310599,2023-03-09,507,washing machine,6990,16490,9500,1,00041,India
310599,2023-03-09,502,iphone 15 pro max,100000,135000,35000,1,00041,India
162860,2023-03-09,505,oven,18490,24000,5510,1,00130,India
220817,2023-03-09,506,monitor,3249,8000,4751,1,00250,India
220817,2023-03-09,505,oven,18490,24000,5510,1,00250,India
220817,2023-03-09,501,iphone 15,60000,80000,20000,1,00250,India
741922,2023-03-09,501,iphone 15,60000,80000,20000,1,00493,India
741922,2023-03-09,505,oven,18490,24000,5510,1,00493,India
741922,2023-03-09,507,washing machine,6990,16490,9500,1,00493,India
595258,2023-03-09,504,iron,449,879,430,1,00481,India
595258,2023-03-09,506,monitor,3249,8000,4751,1,00481,India
595258,2023-03-09,505,oven,18490,24000,5510,1,00481,India
721209,2023-03-09,502,iphone 15 pro max,100000,135000,35000,1,00109,India
721209,2023-03-09,506,monitor,3249,8000,4751,1,00109,India
721209,2023-03-09,505,oven,18490,24000,5510,1,00109,India
721209,2023-03-09,501,iphone 15,60000,80000,20000,1,00109,India
233921,2023-03-09,507,washing machine,6990,16490,9500,1,00220,India
233921,2023-03-09,501,iphone 15,60000,80000,20000,1,00220,India
233921,2023-03-09,505,oven,18490,24000,5510,1,00220,India
112871,2023-03-09,501,iphone 15,60000,80000,20000,1,00182,India
280198,2023-03-09,506,monitor,3249,8000,4751,1,00112,India
280198,2023-03-09,502,iphone 15 pro max,100000,135000,35000,1,00112,India
613144,2023-03-09,506,monitor,3249,8000,4751,1,00083,India
613144,2023-03-09,505,oven,18490,24000,5510,1,00083,India
265044,2023-03-09,507,washing machine,6990,16490,9500,1,00454,India
265044,2023-03-09,503,mixer,1349,3249,1900,1,00454,India
265044,2023-03-09,501,iphone 15,60000,80000,20000,1,00454,India
541825,2023-03-09,502,iphone 15 pro max,100000,135000,35000,1,00472,India
541825,2023-03-09,501,iphone 15,60000,80000,20000,1,00472,India
541825,2023-03-09,505,oven,18490,24000,5510,1,00472,India
182347,2023-03-09,504,iron,449,879,430,1,00321,India
402092,2023-03-09,503,mixer,1349,3249,1900,1,00329,India
402092,2023-03-09,502,iphone 15 pro max,100000,135000,35000,1,00329,India
402092,2023-03-09,505,oven,18490,24000,5510,1,00329,India
402092,2023-03-09,504,iron,449,879,430,1,00329,India
402092,2023-03-09,501,iphone 15,60000,80000,20000,1,00329,India
949600,2023-03-09,504,iron,449,879,430,1,00397,India
226055,2023-03-09,506,monitor,3249,8000,4751,1,00391,India
226055,2023-03-09,503,mixer,1349,3249,1900,1,00391,India
226055,2023-03-09,507,washing machine,6990,16490,9500,1,00391,India
226055,2023-03-09,502,iphone 15 pro max,100000,135000,35000,1,00391,India
226055,2023-03-09,505,oven,18490,24000,5510,1,00391,India
386894,2023-03-09,506,monitor,3249,8000,4751,1,00114,India
386894,2023-03-09,501,iphone 15,60000,80000,20000,1,00114,India
386894,2023-03-09,505,oven,18490,24000,5510,1,00114,India
276519,2023-03-09,505,oven,18490,24000,5510,1,00464,India
479442,2023-03-09,502,iphone 15 pro max,100000,135000,35000,1,00478,India
479442,2023-03-09,503,mixer,1349,3249,1900,1,00478,India
479442,2023-03-09,506,monitor,3249,8000,4751,1,00478,India
479442,2023-03-09,504,iron,449,879,430,1,00478,India
479442,2023-03-09,505,oven,18490,24000,5510,1,00478,India
210561,2023-03-09,503,mixer,1349,3249,1900,1,00354,India
210561,2023-03-09,501,iphone 15,60000,80000,20000,1,00354,India
210561,2023-03-09,506,monitor,3249,8000,4751,1,00354,India
920616,2023-03-09,501,iphone 15,60000,80000,20000,1,00372,India
920616,2023-03-09,502,iphone 15 pro max,100000,135000,35000,1,00372,India
920616,2023-03-09,503,mixer,1349,3249,1900,1,00372,India
920616,2023-03-09,504,iron,449,879,430,1,00372,India
531726,2023-03-09,501,iphone 15,60000,80000,20000,1,00194,India
819897,2023-03-09,505,oven,18490,24000,5510,1,00090,India
619405,2023-03-09,504,iron,449,879,430,1,00284,India
619405,2023-03-09,502,iphone 15 pro max,100000,135000,35000,1,00284,India
619405,2023-03-09,505,oven,18490,24000,5510,1,00284,India
496300,2023-03-09,502,iphone 15 pro max,100000,135000,35000,1,00406,India
921724,2023-03-09,506,monitor,3249,8000,4751,1,00361,India
921724,2023-03-09,503,mixer,1349,3249,1900,1,00361,India
921724,2023-03-09,502,iphone 15 pro max,100000,135000,35000,1,00361,India
110924,2023-03-09,503,mixer,1349,3249,1900,1,00306,India
110924,2023-03-09,506,monitor,3249,8000,4751,1,00306,India
110924,2023-03-09,502,iphone 15 pro max,100000,135000,35000,1,00306,India
358573,2023-03-09,501,iphone 15,60000,80000,20000,1,00375,India
358573,2023-03-09,502,iphone 15 pro max,100000,135000,35000,1,00375,India
963819,2023-03-09,507,washing machine,6990,16490,9500,1,00009,India
737902,2023-03-09,503,mixer,1349,3249,1900,1,00365,India
737902,2023-03-09,504,iron,449,879,430,1,00365,India
659734,2023-03-09,501,iphone 15,60000,80000,20000,1,00218,India
659734,2023-03-09,503,mixer,1349,3249,1900,1,00218,India
646656,2023-03-09,507,washing machine,6990,16490,9500,1,00250,India
646656,2023-03-09,505,oven,18490,24000,5510,1,00250,India
979134,2023-03-09,502,iphone 15 pro max,100000,135000,35000,1,00137,India
979134,2023-03-09,506,monitor,3249,8000,4751,1,00137,India
979134,2023-03-09,505,oven,18490,24000,5510,1,00137,India
979134,2023-03-09,501,iphone 15,60000,80000,20000,1,00137,India
453009,2023-03-09,505,oven,18490,24000,5510,1,00307,India
453009,2023-03-09,502,iphone 15 pro max,100000,135000,35000,1,00307,India
453009,2023-03-09,501,iphone 15,60000,80000,20000,1,00307,India
453009,2023-03-09,506,monitor,3249,8000,4751,1,00307,India
453009,2023-03-09,504,iron,449,879,430,1,00307,India
141472,2023-03-09,507,washing machine,6990,16490,9500,1,00229,India
141472,2023-03-09,503,mixer,1349,3249,1900,1,00229,India
122181,2023-03-09,506,monitor,3249,8000,4751,1,00249,India
122181,2023-03-09,505,oven,18490,24000,5510,1,00249,India
582435,2023-03-09,506,monitor,3249,8000,4751,1,00161,India
582435,2023-03-09,501,iphone 15,60000,80000,20000,1,00161,India
582435,2023-03-09,503,mixer,1349,3249,1900,1,00161,India
582435,2023-03-09,505,oven,18490,24000,5510,1,00161,India
292239,2023-03-09,504,iron,449,879,430,1,00482,India
292239,2023-03-09,506,monitor,3249,8000,4751,1,00482,India
292239,2023-03-09,501,iphone 15,60000,80000,20000,1,00482,India
292239,2023-03-09,503,mixer,1349,3249,1900,1,00482,India
438410,2023-03-09,501,iphone 15,60000,80000,20000,1,00382,India
438410,2023-03-09,503,mixer,1349,3249,1900,1,00382,India
383118,2023-03-09,506,monitor,3249,8000,4751,1,00314,India
954035,2023-03-09,507,washing machine,6990,16490,9500,1,00355,India
520945,2023-03-09,506,monitor,3249,8000,4751,1,00340,India
262416,2023-03-10,504,iron,449,879,430,1,00229,India
262416,2023-03-10,507,washing machine,6990,16490,9500,1,00229,India
262416,2023-03-10,505,oven,18490,24000,5510,1,00229,India
294295,2023-03-10,506,monitor,3249,8000,4751,1,00227,India
455921,2023-03-10,501,iphone 15,60000,80000,20000,1,00276,India
455921,2023-03-10,503,mixer,1349,3249,1900,1,00276,India
384999,2023-03-10,505,oven,18490,24000,5510,1,00279,India
575244,2023-03-10,505,oven,18490,24000,5510,1,00061,India
424315,2023-03-10,507,washing machine,6990,16490,9500,1,00116,India
424315,2023-03-10,506,monitor,3249,8000,4751,1,00116,India
424315,2023-03-10,501,iphone 15,60000,80000,20000,1,00116,India
108447,2023-03-10,503,mixer,1349,3249,1900,1,00459,India
108447,2023-03-10,507,washing machine,6990,16490,9500,1,00459,India
162384,2023-03-10,505,oven,18490,24000,5510,1,00073,India
162384,2023-03-10,504,iron,449,879,430,1,00073,India
162384,2023-03-10,501,iphone 15,60000,80000,20000,1,00073,India
700331,2023-03-10,503,mixer,1349,3249,1900,1,00422,India
700331,2023-03-10,507,washing machine,6990,16490,9500,1,00422,India
700331,2023-03-10,502,iphone 15 pro max,100000,135000,35000,1,00422,India
251279,2023-03-10,502,iphone 15 pro max,100000,135000,35000,1,00034,India
251279,2023-03-10,501,iphone 15,60000,80000,20000,1,00034,India
268504,2023-03-10,504,iron,449,879,430,1,00100,India
268504,2023-03-10,505,oven,18490,24000,5510,1,00100,India
268504,2023-03-10,503,mixer,1349,3249,1900,1,00100,India
124067,2023-03-10,503,mixer,1349,3249,1900,1,00188,India
124067,2023-03-10,505,oven,18490,24000,5510,1,00188,India
124067,2023-03-10,501,iphone 15,60000,80000,20000,1,00188,India
124067,2023-03-10,506,monitor,3249,8000,4751,1,00188,India
928551,2023-03-10,501,iphone 15,60000,80000,20000,1,00293,India
928551,2023-03-10,502,iphone 15 pro max,100000,135000,35000,1,00293,India
928551,2023-03-10,504,iron,449,879,430,1,00293,India
956922,2023-03-10,502,iphone 15 pro max,100000,135000,35000,1,00494,India
956922,2023-03-10,501,iphone 15,60000,80000,20000,1,00494,India
956922,2023-03-10,506,monitor,3249,8000,4751,1,00494,India
958475,2023-03-10,501,iphone 15,60000,80000,20000,1,00472,India
958475,2023-03-10,507,washing machine,6990,16490,9500,1,00472,India
607010,2023-03-10,506,monitor,3249,8000,4751,1,00366,India
607010,2023-03-10,501,iphone 15,60000,80000,20000,1,00366,India
771629,2023-03-10,507,washing machine,6990,16490,9500,1,00202,India
771629,2023-03-10,505,oven,18490,24000,5510,1,00202,India
771629,2023-03-10,502,iphone 15 pro max,100000,135000,35000,1,00202,India
771629,2023-03-10,503,mixer,1349,3249,1900,1,00202,India
158337,2023-03-10,504,iron,449,879,430,1,00493,India
158337,2023-03-10,506,monitor,3249,8000,4751,1,00493,India
158337,2023-03-10,505,oven,18490,24000,5510,1,00493,India
493743,2023-03-10,501,iphone 15,60000,80000,20000,1,00313,India
493743,2023-03-10,502,iphone 15 pro max,100000,135000,35000,1,00313,India
708221,2023-03-10,506,monitor,3249,8000,4751,1,00211,India
665235,2023-03-10,507,washing machine,6990,16490,9500,1,00043,India
649073,2023-03-10,504,iron,449,879,430,1,00456,India
649073,2023-03-10,507,washing machine,6990,16490,9500,1,00456,India
649073,2023-03-10,501,iphone 15,60000,80000,20000,1,00456,India
649073,2023-03-10,503,mixer,1349,3249,1900,1,00456,India
110286,2023-03-10,506,monitor,3249,8000,4751,1,00452,India
359255,2023-03-10,504,iron,449,879,430,1,00246,India
359255,2023-03-10,502,iphone 15 pro max,100000,135000,35000,1,00246,India
731287,2023-03-10,503,mixer,1349,3249,1900,1,00094,India
731287,2023-03-10,502,iphone 15 pro max,100000,135000,35000,1,00094,India
594714,2023-03-10,503,mixer,1349,3249,1900,1,00086,India
783058,2023-03-10,507,washing machine,6990,16490,9500,1,00375,India
783058,2023-03-10,503,mixer,1349,3249,1900,1,00375,India
873535,2023-03-10,505,oven,18490,24000,5510,1,00110,India
873535,2023-03-10,501,iphone 15,60000,80000,20000,1,00110,India
629386,2023-03-10,505,oven,18490,24000,5510,1,00300,India
629386,2023-03-10,501,iphone 15,60000,80000,20000,1,00300,India
629386,2023-03-10,502,iphone 15 pro max,100000,135000,35000,1,00300,India
730183,2023-03-10,507,washing machine,6990,16490,9500,1,00007,India
730183,2023-03-10,501,iphone 15,60000,80000,20000,1,00007,India
730183,2023-03-10,505,oven,18490,24000,5510,1,00007,India
269767,2023-03-10,506,monitor,3249,8000,4751,1,00426,India
269767,2023-03-10,503,mixer,1349,3249,1900,1,00426,India
269767,2023-03-10,507,washing machine,6990,16490,9500,1,00426,India
269767,2023-03-10,505,oven,18490,24000,5510,1,00426,India
559864,2023-03-10,501,iphone 15,60000,80000,20000,1,00189,India
559454,2023-03-10,504,iron,449,879,430,1,00348,India
559454,2023-03-10,501,iphone 15,60000,80000,20000,1,00348,India
559454,2023-03-10,503,mixer,1349,3249,1900,1,00348,India
890910,2023-03-10,505,oven,18490,24000,5510,1,00412,India
890910,2023-03-10,501,iphone 15,60000,80000,20000,1,00412,India
904123,2023-03-10,501,iphone 15,60000,80000,20000,1,00329,India
168992,2023-03-10,506,monitor,3249,8000,4751,1,00112,India
737481,2023-03-10,501,iphone 15,60000,80000,20000,1,00448,India
737481,2023-03-10,506,monitor,3249,8000,4751,1,00448,India
737481,2023-03-10,505,oven,18490,24000,5510,1,00448,India
737481,2023-03-10,502,iphone 15 pro max,100000,135000,35000,1,00448,India
649157,2023-03-10,501,iphone 15,60000,80000,20000,1,00453,India
649157,2023-03-10,502,iphone 15 pro max,100000,135000,35000,1,00453,India
649157,2023-03-10,504,iron,449,879,430,1,00453,India
169648,2023-03-10,504,iron,449,879,430,1,00142,India
169648,2023-03-10,501,iphone 15,60000,80000,20000,1,00142,India
169648,2023-03-10,506,monitor,3249,8000,4751,1,00142,India
916541,2023-03-10,506,monitor,3249,8000,4751,1,00145,India
916541,2023-03-10,505,oven,18490,24000,5510,1,00145,India
106927,2023-03-10,505,oven,18490,24000,5510,1,00441,India
106927,2023-03-10,502,iphone 15 pro max,100000,135000,35000,1,00441,India
106927,2023-03-10,504,iron,449,879,430,1,00441,India
839881,2023-03-10,501,iphone 15,60000,80000,20000,1,00255,India
839881,2023-03-10,506,monitor,3249,8000,4751,1,00255,India
991799,2023-03-10,507,washing machine,6990,16490,9500,1,00048,India
991799,2023-03-10,506,monitor,3249,8000,4751,1,00048,India
991799,2023-03-10,502,iphone 15 pro max,100000,135000,35000,1,00048,India
991799,2023-03-10,504,iron,449,879,430,1,00048,India
830268,2023-03-10,507,washing machine,6990,16490,9500,1,00359,India
830268,2023-03-10,501,iphone 15,60000,80000,20000,1,00359,India
830268,2023-03-10,503,mixer,1349,3249,1900,1,00359,India
830268,2023-03-10,502,iphone 15 pro max,100000,135000,35000,1,00359,India
924274,2023-03-10,504,iron,449,879,430,1,00400,India
924274,2023-03-10,502,iphone 15 pro max,100000,135000,35000,1,00400,India
924274,2023-03-10,506,monitor,3249,8000,4751,1,00400,India
480979,2023-03-10,503,mixer,1349,3249,1900,1,00379,India
480979,2023-03-10,506,monitor,3249,8000,4751,1,00379,India
480979,2023-03-10,507,washing machine,6990,16490,9500,1,00379,India
480979,2023-03-10,504,iron,449,879,430,1,00379,India
480796,2023-03-10,503,mixer,1349,3249,1900,1,00184,India
480796,2023-03-10,506,monitor,3249,8000,4751,1,00184,India
480796,2023-03-10,504,iron,449,879,430,1,00184,India
980680,2023-03-10,505,oven,18490,24000,5510,1,00412,India
980680,2023-03-10,501,iphone 15,60000,80000,20000,1,00412,India
430973,2023-03-10,501,iphone 15,60000,80000,20000,1,00274,India
430973,2023-03-10,503,mixer,1349,3249,1900,1,00274,India
430973,2023-03-10,504,iron,449,879,430,1,00274,India
327874,2023-03-10,507,washing machine,6990,16490,9500,1,00128,India
327874,2023-03-10,504,iron,449,879,430,1,00128,India
327874,2023-03-10,505,oven,18490,24000,5510,1,00128,India
240797,2023-03-10,506,monitor,3249,8000,4751,1,00371,India
240797,2023-03-10,502,iphone 15 pro max,100000,135000,35000,1,00371,India
240797,2023-03-10,507,washing machine,6990,16490,9500,1,00371,India
282940,2023-03-10,503,mixer,1349,3249,1900,1,00342,India
282940,2023-03-10,507,washing machine,6990,16490,9500,1,00342,India
282940,2023-03-10,504,iron,449,879,430,1,00342,India
193221,2023-03-10,505,oven,18490,24000,5510,1,00061,India
193221,2023-03-10,506,monitor,3249,8000,4751,1,00061,India
401053,2023-03-10,506,monitor,3249,8000,4751,1,00333,India
401053,2023-03-10,507,washing machine,6990,16490,9500,1,00333,India
401053,2023-03-10,504,iron,449,879,430,1,00333,India
401053,2023-03-10,502,iphone 15 pro max,100000,135000,35000,1,00333,India
496297,2023-03-10,502,iphone 15 pro max,100000,135000,35000,1,00261,India
496297,2023-03-10,504,iron,449,879,430,1,00261,India
496297,2023-03-10,506,monitor,3249,8000,4751,1,00261,India
508737,2023-03-10,503,mixer,1349,3249,1900,1,00260,India
508737,2023-03-10,505,oven,18490,24000,5510,1,00260,India
615432,2023-03-11,502,iphone 15 pro max,100000,135000,35000,1,00109,India
615432,2023-03-11,505,oven,18490,24000,5510,1,00109,India
615432,2023-03-11,504,iron,449,879,430,1,00109,India
459359,2023-03-11,503,mixer,1349,3249,1900,1,00114,India
459359,2023-03-11,505,oven,18490,24000,5510,1,00114,India
512239,2023-03-11,503,mixer,1349,3249,1900,1,00289,India
512239,2023-03-11,502,iphone 15 pro max,100000,135000,35000,1,00289,India
512239,2023-03-11,501,iphone 15,60000,80000,20000,1,00289,India
606566,2023-03-11,505,oven,18490,24000,5510,1,00352,India
606566,2023-03-11,502,iphone 15 pro max,100000,135000,35000,1,00352,India
346371,2023-03-11,505,oven,18490,24000,5510,1,00280,India
346371,2023-03-11,504,iron,449,879,430,1,00280,India
346371,2023-03-11,501,iphone 15,60000,80000,20000,1,00280,India
493520,2023-03-11,502,iphone 15 pro max,100000,135000,35000,1,00046,India
493520,2023-03-11,505,oven,18490,24000,5510,1,00046,India
297517,2023-03-11,504,iron,449,879,430,1,00134,India
644954,2023-03-11,507,washing machine,6990,16490,9500,1,00430,India
644954,2023-03-11,505,oven,18490,24000,5510,1,00430,India
644954,2023-03-11,506,monitor,3249,8000,4751,1,00430,India
644954,2023-03-11,504,iron,449,879,430,1,00430,India
509306,2023-03-11,504,iron,449,879,430,1,00378,India
509306,2023-03-11,501,iphone 15,60000,80000,20000,1,00378,India
509306,2023-03-11,506,monitor,3249,8000,4751,1,00378,India
509306,2023-03-11,502,iphone 15 pro max,100000,135000,35000,1,00378,India
791150,2023-03-11,506,monitor,3249,8000,4751,1,00457,India
791150,2023-03-11,502,iphone 15 pro max,100000,135000,35000,1,00457,India
791150,2023-03-11,507,washing machine,6990,16490,9500,1,00457,India
180962,2023-03-11,503,mixer,1349,3249,1900,1,00471,India
676729,2023-03-11,504,iron,449,879,430,1,00111,India
676729,2023-03-11,507,washing machine,6990,16490,9500,1,00111,India
131041,2023-03-11,507,washing machine,6990,16490,9500,1,00047,India
485635,2023-03-11,505,oven,18490,24000,5510,1,00216,India
485635,2023-03-11,504,iron,449,879,430,1,00216,India
610249,2023-03-11,504,iron,449,879,430,1,00393,India
610249,2023-03-11,502,iphone 15 pro max,100000,135000,35000,1,00393,India
610249,2023-03-11,505,oven,18490,24000,5510,1,00393,India
549824,2023-03-11,501,iphone 15,60000,80000,20000,1,00392,India
549824,2023-03-11,506,monitor,3249,8000,4751,1,00392,India
135763,2023-03-11,503,mixer,1349,3249,1900,1,00400,India
342412,2023-03-11,503,mixer,1349,3249,1900,1,00467,India
342412,2023-03-11,505,oven,18490,24000,5510,1,00467,India
342412,2023-03-11,506,monitor,3249,8000,4751,1,00467,India
881097,2023-03-11,507,washing machine,6990,16490,9500,1,00215,India
881097,2023-03-11,504,iron,449,879,430,1,00215,India
881097,2023-03-11,506,monitor,3249,8000,4751,1,00215,India
881097,2023-03-11,505,oven,18490,24000,5510,1,00215,India
881097,2023-03-11,501,iphone 15,60000,80000,20000,1,00215,India
930549,2023-03-11,501,iphone 15,60000,80000,20000,1,00229,India
930549,2023-03-11,507,washing machine,6990,16490,9500,1,00229,India
930549,2023-03-11,503,mixer,1349,3249,1900,1,00229,India
883251,2023-03-11,502,iphone 15 pro max,100000,135000,35000,1,00443,India
583401,2023-03-11,505,oven,18490,24000,5510,1,00413,India
583401,2023-03-11,504,iron,449,879,430,1,00413,India
151273,2023-03-11,507,washing machine,6990,16490,9500,1,00420,India
151273,2023-03-11,505,oven,18490,24000,5510,1,00420,India
151273,2023-03-11,501,iphone 15,60000,80000,20000,1,00420,India
990897,2023-03-11,504,iron,449,879,430,1,00433,India
990897,2023-03-11,505,oven,18490,24000,5510,1,00433,India
503966,2023-03-11,504,iron,449,879,430,1,00396,India
503966,2023-03-11,502,iphone 15 pro max,100000,135000,35000,1,00396,India
503966,2023-03-11,506,monitor,3249,8000,4751,1,00396,India
503966,2023-03-11,503,mixer,1349,3249,1900,1,00396,India
995507,2023-03-11,501,iphone 15,60000,80000,20000,1,00476,India
995507,2023-03-11,507,washing machine,6990,16490,9500,1,00476,India
995507,2023-03-11,503,mixer,1349,3249,1900,1,00476,India
138435,2023-03-11,503,mixer,1349,3249,1900,1,00294,India
508740,2023-03-11,505,oven,18490,24000,5510,1,00434,India
346585,2023-03-11,504,iron,449,879,430,1,00409,India
346585,2023-03-11,507,washing machine,6990,16490,9500,1,00409,India
492143,2023-03-11,502,iphone 15 pro max,100000,135000,35000,1,00451,India
492143,2023-03-11,505,oven,18490,24000,5510,1,00451,India
492143,2023-03-11,507,washing machine,6990,16490,9500,1,00451,India
425815,2023-03-11,506,monitor,3249,8000,4751,1,00489,India
425815,2023-03-11,507,washing machine,6990,16490,9500,1,00489,India
425815,2023-03-11,503,mixer,1349,3249,1900,1,00489,India
662564,2023-03-11,504,iron,449,879,430,1,00271,India
528320,2023-03-11,507,washing machine,6990,16490,9500,1,00335,India
322720,2023-03-11,507,washing machine,6990,16490,9500,1,00303,India
322720,2023-03-11,502,iphone 15 pro max,100000,135000,35000,1,00303,India
891964,2023-03-11,507,washing machine,6990,16490,9500,1,00180,India
891964,2023-03-11,506,monitor,3249,8000,4751,1,00180,India
891964,2023-03-11,504,iron,449,879,430,1,00180,India
891964,2023-03-11,505,oven,18490,24000,5510,1,00180,India
844534,2023-03-11,501,iphone 15,60000,80000,20000,1,00463,India
844534,2023-03-11,505,oven,18490,24000,5510,1,00463,India
844534,2023-03-11,507,washing machine,6990,16490,9500,1,00463,India
927909,2023-03-11,502,iphone 15 pro max,100000,135000,35000,1,00094,India
927909,2023-03-11,507,washing machine,6990,16490,9500,1,00094,India
248567,2023-03-11,501,iphone 15,60000,80000,20000,1,00343,India
248567,2023-03-11,503,mixer,1349,3249,1900,1,00343,India
248567,2023-03-11,507,washing machine,6990,16490,9500,1,00343,India
248567,2023-03-11,505,oven,18490,24000,5510,1,00343,India
871065,2023-03-11,506,monitor,3249,8000,4751,1,00264,India
871065,2023-03-11,504,iron,449,879,430,1,00264,India
661405,2023-03-11,505,oven,18490,24000,5510,1,00418,India
616300,2023-03-11,505,oven,18490,24000,5510,1,00015,India
616300,2023-03-11,504,iron,449,879,430,1,00015,India
968780,2023-03-11,504,iron,449,879,430,1,00486,India
968780,2023-03-11,505,oven,18490,24000,5510,1,00486,India
968780,2023-03-11,503,mixer,1349,3249,1900,1,00486,India
848938,2023-03-11,502,iphone 15 pro max,100000,135000,35000,1,00320,India
848938,2023-03-11,501,iphone 15,60000,80000,20000,1,00320,India
848938,2023-03-11,504,iron,449,879,430,1,00320,India
194878,2023-03-11,506,monitor,3249,8000,4751,1,00411,India
194878,2023-03-11,507,washing machine,6990,16490,9500,1,00411,India
194878,2023-03-11,505,oven,18490,24000,5510,1,00411,India
194878,2023-03-11,503,mixer,1349,3249,1900,1,00411,India
403824,2023-03-11,507,washing machine,6990,16490,9500,1,00402,India
403824,2023-03-11,501,iphone 15,60000,80000,20000,1,00402,India
208144,2023-03-11,502,iphone 15 pro max,100000,135000,35000,1,00294,India
208144,2023-03-11,506,monitor,3249,8000,4751,1,00294,India
216913,2023-03-11,504,iron,449,879,430,1,00465,India
541558,2023-03-11,503,mixer,1349,3249,1900,1,00097,India
541558,2023-03-11,504,iron,449,879,430,1,00097,India
541558,2023-03-11,506,monitor,3249,8000,4751,1,00097,India
541558,2023-03-11,502,iphone 15 pro max,100000,135000,35000,1,00097,India
204416,2023-03-11,503,mixer,1349,3249,1900,1,00226,India
204416,2023-03-11,507,washing machine,6990,16490,9500,1,00226,India
204416,2023-03-11,502,iphone 15 pro max,100000,135000,35000,1,00226,India
204416,2023-03-11,501,iphone 15,60000,80000,20000,1,00226,India
530283,2023-03-11,505,oven,18490,24000,5510,1,00142,India
730143,2023-03-11,504,iron,449,879,430,1,00213,India
520705,2023-03-11,501,iphone 15,60000,80000,20000,1,00093,India
412778,2023-03-11,507,washing machine,6990,16490,9500,1,00135,India
925844,2023-03-11,504,iron,449,879,430,1,00141,India
925844,2023-03-11,506,monitor,3249,8000,4751,1,00141,India
201708,2023-03-11,501,iphone 15,60000,80000,20000,1,00352,India
201708,2023-03-11,506,monitor,3249,8000,4751,1,00352,India
201708,2023-03-11,505,oven,18490,24000,5510,1,00352,India
770690,2023-03-11,506,monitor,3249,8000,4751,1,00375,India
770690,2023-03-11,504,iron,449,879,430,1,00375,India
770690,2023-03-11,502,iphone 15 pro max,100000,135000,35000,1,00375,India
854895,2023-03-11,502,iphone 15 pro max,100000,135000,35000,1,00191,India
854895,2023-03-11,505,oven,18490,24000,5510,1,00191,India
277656,2023-03-11,505,oven,18490,24000,5510,1,00095,India
277656,2023-03-11,504,iron,449,879,430,1,00095,India
277656,2023-03-11,502,iphone 15 pro max,100000,135000,35000,1,00095,India
277656,2023-03-11,506,monitor,3249,8000,4751,1,00095,India
132723,2023-03-11,501,iphone 15,60000,80000,20000,1,00131,India
132723,2023-03-11,504,iron,449,879,430,1,00131,India
132723,2023-03-11,505,oven,18490,24000,5510,1,00131,India
132723,2023-03-11,503,mixer,1349,3249,1900,1,00131,India
517663,2023-03-11,505,oven,18490,24000,5510,1,00274,India
517663,2023-03-11,504,iron,449,879,430,1,00274,India
406818,2023-03-11,501,iphone 15,60000,80000,20000,1,00048,India
406818,2023-03-11,504,iron,449,879,430,1,00048,India
444265,2023-03-11,503,mixer,1349,3249,1900,1,00065,India
444265,2023-03-11,502,iphone 15 pro max,100000,135000,35000,1,00065,India
444265,2023-03-11,507,washing machine,6990,16490,9500,1,00065,India
424124,2023-03-11,506,monitor,3249,8000,4751,1,00240,India
424124,2023-03-11,504,iron,449,879,430,1,00240,India
424124,2023-03-11,503,mixer,1349,3249,1900,1,00240,India
280376,2023-03-11,503,mixer,1349,3249,1900,1,00077,India
280376,2023-03-11,507,washing machine,6990,16490,9500,1,00077,India
280376,2023-03-11,501,iphone 15,60000,80000,20000,1,00077,India
811903,2023-03-11,505,oven,18490,24000,5510,1,00097,India
544074,2023-03-11,507,washing machine,6990,16490,9500,1,00132,India
544074,2023-03-11,501,iphone 15,60000,80000,20000,1,00132,India
544074,2023-03-11,505,oven,18490,24000,5510,1,00132,India
544074,2023-03-11,506,monitor,3249,8000,4751,1,00132,India
101926,2023-03-11,503,mixer,1349,3249,1900,1,00147,India
101926,2023-03-11,504,iron,449,879,430,1,00147,India
520320,2023-03-11,505,oven,18490,24000,5510,1,00175,India
520320,2023-03-11,507,washing machine,6990,16490,9500,1,00175,India
293867,2023-03-11,505,oven,18490,24000,5510,1,00166,India
293867,2023-03-11,504,iron,449,879,430,1,00166,India
293867,2023-03-11,502,iphone 15 pro max,100000,135000,35000,1,00166,India
894789,2023-03-11,502,iphone 15 pro max,100000,135000,35000,1,00140,India
894789,2023-03-11,504,iron,449,879,430,1,00140,India
894789,2023-03-11,503,mixer,1349,3249,1900,1,00140,India
894789,2023-03-11,506,monitor,3249,8000,4751,1,00140,India
894789,2023-03-11,507,washing machine,6990,16490,9500,1,00140,India
523946,2023-03-11,504,iron,449,879,430,1,00018,India
523946,2023-03-11,502,iphone 15 pro max,100000,135000,35000,1,00018,India
523946,2023-03-11,507,washing machine,6990,16490,9500,1,00018,India
523946,2023-03-11,503,mixer,1349,3249,1900,1,00018,India
773812,2023-03-11,501,iphone 15,60000,80000,20000,1,00429,India
773812,2023-03-11,503,mixer,1349,3249,1900,1,00429,India
773812,2023-03-11,502,iphone 15 pro max,100000,135000,35000,1,00429,India
729869,2023-03-11,507,washing machine,6990,16490,9500,1,00296,India
522395,2023-03-11,507,washing machine,6990,16490,9500,1,00199,India
106176,2023-03-11,502,iphone 15 pro max,100000,135000,35000,1,00230,India
106176,2023-03-11,507,washing machine,6990,16490,9500,1,00230,India
440166,2023-03-11,506,monitor,3249,8000,4751,1,00150,India
517163,2023-03-11,503,mixer,1349,3249,1900,1,00043,India
517163,2023-03-11,505,oven,18490,24000,5510,1,00043,India
517163,2023-03-11,507,washing machine,6990,16490,9500,1,00043,India
661018,2023-03-11,504,iron,449,879,430,1,00319,India
661018,2023-03-11,503,mixer,1349,3249,1900,1,00319,India
661018,2023-03-11,505,oven,18490,24000,5510,1,00319,India
529189,2023-03-11,506,monitor,3249,8000,4751,1,00335,India
529189,2023-03-11,504,iron,449,879,430,1,00335,India
476968,2023-03-11,503,mixer,1349,3249,1900,1,00237,India
875516,2023-03-11,503,mixer,1349,3249,1900,1,00056,India
875516,2023-03-11,506,monitor,3249,8000,4751,1,00056,India
993717,2023-03-11,501,iphone 15,60000,80000,20000,1,00417,India
993717,2023-03-11,502,iphone 15 pro max,100000,135000,35000,1,00417,India
149859,2023-03-11,504,iron,449,879,430,1,00028,India
149859,2023-03-11,507,washing machine,6990,16490,9500,1,00028,India
159405,2023-03-11,507,washing machine,6990,16490,9500,1,00276,India
159405,2023-03-11,505,oven,18490,24000,5510,1,00276,India
159405,2023-03-11,502,iphone 15 pro max,100000,135000,35000,1,00276,India
159405,2023-03-11,503,mixer,1349,3249,1900,1,00276,India
285593,2023-03-11,506,monitor,3249,8000,4751,1,00441,India
285593,2023-03-11,504,iron,449,879,430,1,00441,India
396271,2023-03-11,506,monitor,3249,8000,4751,1,00099,India
396271,2023-03-11,502,iphone 15 pro max,100000,135000,35000,1,00099,India
736633,2023-03-11,502,iphone 15 pro max,100000,135000,35000,1,00306,India
373739,2023-03-11,503,mixer,1349,3249,1900,1,00294,India
343316,2023-03-11,504,iron,449,879,430,1,00230,India
343316,2023-03-11,506,monitor,3249,8000,4751,1,00230,India
343316,2023-03-11,507,washing machine,6990,16490,9500,1,00230,India
894253,2023-03-11,505,oven,18490,24000,5510,1,00464,India
894253,2023-03-11,506,monitor,3249,8000,4751,1,00464,India
894253,2023-03-11,501,iphone 15,60000,80000,20000,1,00464,India
478759,2023-03-11,505,oven,18490,24000,5510,1,00250,India
233912,2023-03-11,505,oven,18490,24000,5510,1,00231,India
233912,2023-03-11,503,mixer,1349,3249,1900,1,00231,India
752900,2023-03-11,505,oven,18490,24000,5510,1,00177,India
752900,2023-03-11,504,iron,449,879,430,1,00177,India
572083,2023-03-11,506,monitor,3249,8000,4751,1,00182,India
572083,2023-03-11,501,iphone 15,60000,80000,20000,1,00182,India
513410,2023-03-11,506,monitor,3249,8000,4751,1,00055,India
947341,2023-03-12,503,mixer,1349,3249,1900,1,00493,India
947341,2023-03-12,505,oven,18490,24000,5510,1,00493,India
947341,2023-03-12,502,iphone 15 pro max,100000,135000,35000,1,00493,India
294747,2023-03-12,502,iphone 15 pro max,100000,135000,35000,1,00245,India
898539,2023-03-12,501,iphone 15,60000,80000,20000,1,00223,India
898539,2023-03-12,503,mixer,1349,3249,1900,1,00223,India
898539,2023-03-12,505,oven,18490,24000,5510,1,00223,India
898539,2023-03-12,506,monitor,3249,8000,4751,1,00223,India
892721,2023-03-12,507,washing machine,6990,16490,9500,1,00026,India
892721,2023-03-12,506,monitor,3249,8000,4751,1,00026,India
351922,2023-03-12,507,washing machine,6990,16490,9500,1,00123,India
351922,2023-03-12,505,oven,18490,24000,5510,1,00123,India
351922,2023-03-12,506,monitor,3249,8000,4751,1,00123,India
351922,2023-03-12,504,iron,449,879,430,1,00123,India
411348,2023-03-12,502,iphone 15 pro max,100000,135000,35000,1,00025,India
411348,2023-03-12,501,iphone 15,60000,80000,20000,1,00025,India
990267,2023-03-12,501,iphone 15,60000,80000,20000,1,00226,India
990267,2023-03-12,507,washing machine,6990,16490,9500,1,00226,India
990267,2023-03-12,502,iphone 15 pro max,100000,135000,35000,1,00226,India
911991,2023-03-12,501,iphone 15,60000,80000,20000,1,00398,India
911991,2023-03-12,507,washing machine,6990,16490,9500,1,00398,India
343621,2023-03-12,502,iphone 15 pro max,100000,135000,35000,1,00364,India
343621,2023-03-12,504,iron,449,879,430,1,00364,India
343621,2023-03-12,507,washing machine,6990,16490,9500,1,00364,India
343621,2023-03-12,506,monitor,3249,8000,4751,1,00364,India
744141,2023-03-12,502,iphone 15 pro max,100000,135000,35000,1,00496,India
744141,2023-03-12,504,iron,449,879,430,1,00496,India
745000,2023-03-12,501,iphone 15,60000,80000,20000,1,00288,India
745000,2023-03-12,506,monitor,3249,8000,4751,1,00288,India
745000,2023-03-12,505,oven,18490,24000,5510,1,00288,India
931009,2023-03-12,504,iron,449,879,430,1,00047,India
931009,2023-03-12,506,monitor,3249,8000,4751,1,00047,India
783387,2023-03-12,505,oven,18490,24000,5510,1,00157,India
783387,2023-03-12,501,iphone 15,60000,80000,20000,1,00157,India
156712,2023-03-12,504,iron,449,879,430,1,00033,India
156712,2023-03-12,505,oven,18490,24000,5510,1,00033,India
513584,2023-03-12,507,washing machine,6990,16490,9500,1,00321,India
513584,2023-03-12,506,monitor,3249,8000,4751,1,00321,India
513584,2023-03-12,505,oven,18490,24000,5510,1,00321,India
450274,2023-03-12,506,monitor,3249,8000,4751,1,00189,India
450274,2023-03-12,504,iron,449,879,430,1,00189,India
904431,2023-03-12,507,washing machine,6990,16490,9500,1,00337,India
904431,2023-03-12,501,iphone 15,60000,80000,20000,1,00337,India
904431,2023-03-12,502,iphone 15 pro max,100000,135000,35000,1,00337,India
182220,2023-03-12,502,iphone 15 pro max,100000,135000,35000,1,00385,India
308293,2023-03-12,503,mixer,1349,3249,1900,1,00373,India
308293,2023-03-12,504,iron,449,879,430,1,00373,India
351922,2023-03-12,501,iphone 15,60000,80000,20000,1,00123,India
351922,2023-03-12,502,iphone 15 pro max,100000,135000,35000,1,00123,India
777173,2023-03-12,504,iron,449,879,430,1,00312,India
777173,2023-03-12,501,iphone 15,60000,80000,20000,1,00312,India
777173,2023-03-12,507,washing machine,6990,16490,9500,1,00312,India
904947,2023-03-12,501,iphone 15,60000,80000,20000,1,00374,India
963526,2023-03-12,502,iphone 15 pro max,100000,135000,35000,1,00230,India
963526,2023-03-12,507,washing machine,6990,16490,9500,1,00230,India
963526,2023-03-12,506,monitor,3249,8000,4751,1,00230,India
963526,2023-03-12,505,oven,18490,24000,5510,1,00230,India
206839,2023-03-12,504,iron,449,879,430,1,00226,India
206839,2023-03-12,501,iphone 15,60000,80000,20000,1,00226,India
207758,2023-03-12,505,oven,18490,24000,5510,1,00407,India
207758,2023-03-12,507,washing machine,6990,16490,9500,1,00407,India
207758,2023-03-12,503,mixer,1349,3249,1900,1,00407,India
725250,2023-03-12,502,iphone 15 pro max,100000,135000,35000,1,00417,India
670134,2023-03-12,506,monitor,3249,8000,4751,1,00328,India
670134,2023-03-12,507,washing machine,6990,16490,9500,1,00328,India
670134,2023-03-12,504,iron,449,879,430,1,00328,India
474264,2023-03-12,502,iphone 15 pro max,100000,135000,35000,1,00229,India
474264,2023-03-12,503,mixer,1349,3249,1900,1,00229,India
540681,2023-03-12,504,iron,449,879,430,1,00209,India
540681,2023-03-12,506,monitor,3249,8000,4751,1,00209,India
540681,2023-03-12,505,oven,18490,24000,5510,1,00209,India
179545,2023-03-12,504,iron,449,879,430,1,00439,India
179545,2023-03-12,505,oven,18490,24000,5510,1,00439,India
179545,2023-03-12,506,monitor,3249,8000,4751,1,00439,India
179545,2023-03-12,501,iphone 15,60000,80000,20000,1,00439,India
110786,2023-03-12,501,iphone 15,60000,80000,20000,1,00035,India
383937,2023-03-12,502,iphone 15 pro max,100000,135000,35000,1,00318,India
383937,2023-03-12,504,iron,449,879,430,1,00318,India
383937,2023-03-12,505,oven,18490,24000,5510,1,00318,India
404673,2023-03-12,504,iron,449,879,430,1,00315,India
404673,2023-03-12,502,iphone 15 pro max,100000,135000,35000,1,00315,India
404673,2023-03-12,505,oven,18490,24000,5510,1,00315,India
404673,2023-03-12,501,iphone 15,60000,80000,20000,1,00315,India
904772,2023-03-12,506,monitor,3249,8000,4751,1,00059,India
904772,2023-03-12,504,iron,449,879,430,1,00059,India
904772,2023-03-12,503,mixer,1349,3249,1900,1,00059,India
116636,2023-03-12,502,iphone 15 pro max,100000,135000,35000,1,00003,India
116636,2023-03-12,505,oven,18490,24000,5510,1,00003,India
116636,2023-03-12,506,monitor,3249,8000,4751,1,00003,India
486941,2023-03-12,502,iphone 15 pro max,100000,135000,35000,1,00464,India
486941,2023-03-12,504,iron,449,879,430,1,00464,India
486941,2023-03-12,503,mixer,1349,3249,1900,1,00464,India
200763,2023-03-12,504,iron,449,879,430,1,00319,India
200763,2023-03-12,503,mixer,1349,3249,1900,1,00319,India
200763,2023-03-12,502,iphone 15 pro max,100000,135000,35000,1,00319,India
625292,2023-03-12,501,iphone 15,60000,80000,20000,1,00398,India
625292,2023-03-12,506,monitor,3249,8000,4751,1,00398,India
625292,2023-03-12,504,iron,449,879,430,1,00398,India
339376,2023-03-12,502,iphone 15 pro max,100000,135000,35000,1,00163,India
771506,2023-03-12,502,iphone 15 pro max,100000,135000,35000,1,00253,India
771506,2023-03-12,501,iphone 15,60000,80000,20000,1,00253,India
319830,2023-03-12,502,iphone 15 pro max,100000,135000,35000,1,00353,India
319830,2023-03-12,504,iron,449,879,430,1,00353,India
319830,2023-03-12,501,iphone 15,60000,80000,20000,1,00353,India
319830,2023-03-12,503,mixer,1349,3249,1900,1,00353,India
774740,2023-03-12,503,mixer,1349,3249,1900,1,00315,India
889756,2023-03-12,507,washing machine,6990,16490,9500,1,00358,India
889756,2023-03-12,505,oven,18490,24000,5510,1,00358,India
889756,2023-03-12,506,monitor,3249,8000,4751,1,00358,India
995055,2023-03-12,504,iron,449,879,430,1,00089,India
995055,2023-03-12,503,mixer,1349,3249,1900,1,00089,India
262531,2023-03-12,502,iphone 15 pro max,100000,135000,35000,1,00173,India
262531,2023-03-12,506,monitor,3249,8000,4751,1,00173,India
612642,2023-03-12,501,iphone 15,60000,80000,20000,1,00425,India
612642,2023-03-12,507,washing machine,6990,16490,9500,1,00425,India
612642,2023-03-12,504,iron,449,879,430,1,00425,India
626680,2023-03-12,507,washing machine,6990,16490,9500,1,00214,India
729625,2023-03-12,505,oven,18490,24000,5510,1,00065,India
729625,2023-03-12,506,monitor,3249,8000,4751,1,00065,India
729625,2023-03-12,503,mixer,1349,3249,1900,1,00065,India
422392,2023-03-12,502,iphone 15 pro max,100000,135000,35000,1,00220,India
501258,2023-03-12,505,oven,18490,24000,5510,1,00236,India
501258,2023-03-12,501,iphone 15,60000,80000,20000,1,00236,India
501258,2023-03-12,506,monitor,3249,8000,4751,1,00236,India
501258,2023-03-12,504,iron,449,879,430,1,00236,India
149482,2023-03-12,506,monitor,3249,8000,4751,1,00014,India
786856,2023-03-12,506,monitor,3249,8000,4751,1,00245,India
786856,2023-03-12,507,washing machine,6990,16490,9500,1,00245,India
786856,2023-03-12,504,iron,449,879,430,1,00245,India
840243,2023-03-12,502,iphone 15 pro max,100000,135000,35000,1,00302,India
840243,2023-03-12,507,washing machine,6990,16490,9500,1,00302,India
381197,2023-03-12,507,washing machine,6990,16490,9500,1,00212,India
381197,2023-03-12,503,mixer,1349,3249,1900,1,00212,India
381197,2023-03-12,502,iphone 15 pro max,100000,135000,35000,1,00212,India
381197,2023-03-12,504,iron,449,879,430,1,00212,India
860833,2023-03-12,502,iphone 15 pro max,100000,135000,35000,1,00239,India
860833,2023-03-12,504,iron,449,879,430,1,00239,India
860833,2023-03-12,503,mixer,1349,3249,1900,1,00239,India
164508,2023-03-12,501,iphone 15,60000,80000,20000,1,00452,India
164508,2023-03-12,507,washing machine,6990,16490,9500,1,00452,India
399693,2023-03-12,504,iron,449,879,430,1,00087,India
399693,2023-03-12,505,oven,18490,24000,5510,1,00087,India
964531,2023-03-12,505,oven,18490,24000,5510,1,00343,India
453306,2023-03-12,501,iphone 15,60000,80000,20000,1,00491,India
453306,2023-03-12,507,washing machine,6990,16490,9500,1,00491,India
453306,2023-03-12,506,monitor,3249,8000,4751,1,00491,India
276522,2023-03-12,502,iphone 15 pro max,100000,135000,35000,1,00036,India
276522,2023-03-12,506,monitor,3249,8000,4751,1,00036,India
276522,2023-03-12,503,mixer,1349,3249,1900,1,00036,India
276522,2023-03-12,504,iron,449,879,430,1,00036,India
190393,2023-03-12,503,mixer,1349,3249,1900,1,00039,India
190393,2023-03-12,504,iron,449,879,430,1,00039,India
190393,2023-03-12,506,monitor,3249,8000,4751,1,00039,India
190393,2023-03-12,505,oven,18490,24000,5510,1,00039,India
118692,2023-03-12,501,iphone 15,60000,80000,20000,1,00379,India
118692,2023-03-12,506,monitor,3249,8000,4751,1,00379,India
118692,2023-03-12,507,washing machine,6990,16490,9500,1,00379,India
814637,2023-03-12,504,iron,449,879,430,1,00303,India
814637,2023-03-12,503,mixer,1349,3249,1900,1,00303,India
814637,2023-03-12,506,monitor,3249,8000,4751,1,00303,India
814637,2023-03-12,501,iphone 15,60000,80000,20000,1,00303,India
141580,2023-03-12,507,washing machine,6990,16490,9500,1,00245,India
141580,2023-03-12,506,monitor,3249,8000,4751,1,00245,India
141580,2023-03-12,505,oven,18490,24000,5510,1,00245,India
484228,2023-03-12,501,iphone 15,60000,80000,20000,1,00264,India
484228,2023-03-12,506,monitor,3249,8000,4751,1,00264,India
484228,2023-03-12,504,iron,449,879,430,1,00264,India
484228,2023-03-12,502,iphone 15 pro max,100000,135000,35000,1,00264,India
697714,2023-03-12,506,monitor,3249,8000,4751,1,00225,India
697714,2023-03-12,504,iron,449,879,430,1,00225,India
697714,2023-03-12,505,oven,18490,24000,5510,1,00225,India
315609,2023-03-12,504,iron,449,879,430,1,00008,India
315609,2023-03-12,501,iphone 15,60000,80000,20000,1,00008,India
315609,2023-03-12,505,oven,18490,24000,5510,1,00008,India
952436,2023-03-12,503,mixer,1349,3249,1900,1,00342,India
952436,2023-03-12,501,iphone 15,60000,80000,20000,1,00342,India
920109,2023-03-12,501,iphone 15,60000,80000,20000,1,00339,India
920109,2023-03-12,506,monitor,3249,8000,4751,1,00339,India
920109,2023-03-12,505,oven,18490,24000,5510,1,00339,India
920109,2023-03-12,502,iphone 15 pro max,100000,135000,35000,1,00339,India
224208,2023-03-12,502,iphone 15 pro max,100000,135000,35000,1,00303,India
533276,2023-03-12,504,iron,449,879,430,1,00195,India
591252,2023-03-12,505,oven,18490,24000,5510,1,00409,India
591252,2023-03-12,504,iron,449,879,430,1,00409,India
591252,2023-03-12,506,monitor,3249,8000,4751,1,00409,India
538754,2023-03-12,501,iphone 15,60000,80000,20000,1,00092,India
538754,2023-03-12,504,iron,449,879,430,1,00092,India
538754,2023-03-12,505,oven,18490,24000,5510,1,00092,India
538754,2023-03-12,506,monitor,3249,8000,4751,1,00092,India
951968,2023-03-13,502,iphone 15 pro max,100000,135000,35000,1,00223,India
951968,2023-03-13,507,washing machine,6990,16490,9500,1,00223,India
238109,2023-03-13,507,washing machine,6990,16490,9500,1,00403,India
518427,2023-03-13,504,iron,449,879,430,1,00374,India
518427,2023-03-13,502,iphone 15 pro max,100000,135000,35000,1,00374,India
518427,2023-03-13,507,washing machine,6990,16490,9500,1,00374,India
518427,2023-03-13,506,monitor,3249,8000,4751,1,00374,India
421597,2023-03-13,503,mixer,1349,3249,1900,1,00367,India
371663,2023-03-13,502,iphone 15 pro max,100000,135000,35000,1,00108,India
950359,2023-03-13,501,iphone 15,60000,80000,20000,1,00138,India
950359,2023-03-13,505,oven,18490,24000,5510,1,00138,India
188978,2023-03-13,504,iron,449,879,430,1,00217,India
188978,2023-03-13,506,monitor,3249,8000,4751,1,00217,India
257548,2023-03-13,505,oven,18490,24000,5510,1,00247,India
257548,2023-03-13,504,iron,449,879,430,1,00247,India
542429,2023-03-13,501,iphone 15,60000,80000,20000,1,00302,India
386106,2023-03-13,502,iphone 15 pro max,100000,135000,35000,1,00190,India
610163,2023-03-13,505,oven,18490,24000,5510,1,00297,India
610163,2023-03-13,502,iphone 15 pro max,100000,135000,35000,1,00297,India
610163,2023-03-13,504,iron,449,879,430,1,00297,India
610163,2023-03-13,506,monitor,3249,8000,4751,1,00297,India
556994,2023-03-13,507,washing machine,6990,16490,9500,1,00162,India
556994,2023-03-13,505,oven,18490,24000,5510,1,00162,India
556994,2023-03-13,504,iron,449,879,430,1,00162,India
556994,2023-03-13,506,monitor,3249,8000,4751,1,00162,India
593901,2023-03-13,506,monitor,3249,8000,4751,1,00037,India
593901,2023-03-13,507,washing machine,6990,16490,9500,1,00037,India
522517,2023-03-13,505,oven,18490,24000,5510,1,00224,India
522517,2023-03-13,504,iron,449,879,430,1,00224,India
678522,2023-03-13,505,oven,18490,24000,5510,1,00099,India
923108,2023-03-13,505,oven,18490,24000,5510,1,00182,India
923108,2023-03-13,507,washing machine,6990,16490,9500,1,00182,India
923108,2023-03-13,501,iphone 15,60000,80000,20000,1,00182,India
923108,2023-03-13,504,iron,449,879,430,1,00182,India
482358,2023-03-13,505,oven,18490,24000,5510,1,00380,India
482358,2023-03-13,506,monitor,3249,8000,4751,1,00380,India
416693,2023-03-13,506,monitor,3249,8000,4751,1,00264,India
416693,2023-03-13,502,iphone 15 pro max,100000,135000,35000,1,00264,India
416693,2023-03-13,504,iron,449,879,430,1,00264,India
148240,2023-03-13,503,mixer,1349,3249,1900,1,00087,India
148240,2023-03-13,502,iphone 15 pro max,100000,135000,35000,1,00087,India
385852,2023-03-13,504,iron,449,879,430,1,00264,India
385852,2023-03-13,505,oven,18490,24000,5510,1,00264,India
385852,2023-03-13,503,mixer,1349,3249,1900,1,00264,India
385852,2023-03-13,501,iphone 15,60000,80000,20000,1,00264,India
627534,2023-03-13,507,washing machine,6990,16490,9500,1,00296,India
627534,2023-03-13,501,iphone 15,60000,80000,20000,1,00296,India
627534,2023-03-13,504,iron,449,879,430,1,00296,India
128387,2023-03-13,505,oven,18490,24000,5510,1,00485,India
128387,2023-03-13,507,washing machine,6990,16490,9500,1,00485,India
128387,2023-03-13,502,iphone 15 pro max,100000,135000,35000,1,00485,India
128387,2023-03-13,506,monitor,3249,8000,4751,1,00485,India
652022,2023-03-13,504,iron,449,879,430,1,00062,India
652022,2023-03-13,503,mixer,1349,3249,1900,1,00062,India
652022,2023-03-13,507,washing machine,6990,16490,9500,1,00062,India
652022,2023-03-13,506,monitor,3249,8000,4751,1,00062,India
248092,2023-03-13,504,iron,449,879,430,1,00097,India
248092,2023-03-13,503,mixer,1349,3249,1900,1,00097,India
738089,2023-03-13,504,iron,449,879,430,1,00055,India
738089,2023-03-13,501,iphone 15,60000,80000,20000,1,00055,India
738089,2023-03-13,506,monitor,3249,8000,4751,1,00055,India
326352,2023-03-13,505,oven,18490,24000,5510,1,00391,India
326777,2023-03-13,501,iphone 15,60000,80000,20000,1,00250,India
326777,2023-03-13,502,iphone 15 pro max,100000,135000,35000,1,00250,India
401576,2023-03-13,506,monitor,3249,8000,4751,1,00165,India
401576,2023-03-13,503,mixer,1349,3249,1900,1,00165,India
819856,2023-03-13,502,iphone 15 pro max,100000,135000,35000,1,00363,India
819856,2023-03-13,506,monitor,3249,8000,4751,1,00363,India
819856,2023-03-13,505,oven,18490,24000,5510,1,00363,India
819856,2023-03-13,501,iphone 15,60000,80000,20000,1,00363,India
416028,2023-03-13,506,monitor,3249,8000,4751,1,00117,India
416028,2023-03-13,503,mixer,1349,3249,1900,1,00117,India
416028,2023-03-13,505,oven,18490,24000,5510,1,00117,India
416028,2023-03-13,507,washing machine,6990,16490,9500,1,00117,India
599936,2023-03-13,502,iphone 15 pro max,100000,135000,35000,1,00100,India
599936,2023-03-13,501,iphone 15,60000,80000,20000,1,00100,India
457768,2023-03-13,503,mixer,1349,3249,1900,1,00069,India
457768,2023-03-13,507,washing machine,6990,16490,9500,1,00069,India
457768,2023-03-13,502,iphone 15 pro max,100000,135000,35000,1,00069,India
469760,2023-03-13,503,mixer,1349,3249,1900,1,00278,India
973033,2023-03-13,501,iphone 15,60000,80000,20000,1,00214,India
973033,2023-03-13,504,iron,449,879,430,1,00214,India
973033,2023-03-13,502,iphone 15 pro max,100000,135000,35000,1,00214,India
322860,2023-03-13,504,iron,449,879,430,1,00243,India
322860,2023-03-13,505,oven,18490,24000,5510,1,00243,India
322860,2023-03-13,506,monitor,3249,8000,4751,1,00243,India
894909,2023-03-13,504,iron,449,879,430,1,00079,India
894909,2023-03-13,507,washing machine,6990,16490,9500,1,00079,India
480251,2023-03-13,506,monitor,3249,8000,4751,1,00028,India
480251,2023-03-13,505,oven,18490,24000,5510,1,00028,India
480251,2023-03-13,507,washing machine,6990,16490,9500,1,00028,India
480251,2023-03-13,501,iphone 15,60000,80000,20000,1,00028,India
413918,2023-03-13,503,mixer,1349,3249,1900,1,00271,India
413918,2023-03-13,506,monitor,3249,8000,4751,1,00271,India
413918,2023-03-13,501,iphone 15,60000,80000,20000,1,00271,India
798676,2023-03-13,507,washing machine,6990,16490,9500,1,00018,India
798676,2023-03-13,502,iphone 15 pro max,100000,135000,35000,1,00018,India
798676,2023-03-13,503,mixer,1349,3249,1900,1,00018,India
196753,2023-03-13,501,iphone 15,60000,80000,20000,1,00088,India
196753,2023-03-13,502,iphone 15 pro max,100000,135000,35000,1,00088,India
196753,2023-03-13,504,iron,449,879,430,1,00088,India
196753,2023-03-13,507,washing machine,6990,16490,9500,1,00088,India
794570,2023-03-13,502,iphone 15 pro max,100000,135000,35000,1,00472,India
765259,2023-03-13,504,iron,449,879,430,1,00055,India
765259,2023-03-13,505,oven,18490,24000,5510,1,00055,India
765259,2023-03-13,502,iphone 15 pro max,100000,135000,35000,1,00055,India
540045,2023-03-13,505,oven,18490,24000,5510,1,00251,India
600859,2023-03-13,507,washing machine,6990,16490,9500,1,00147,India
600859,2023-03-13,502,iphone 15 pro max,100000,135000,35000,1,00147,India
600859,2023-03-13,504,iron,449,879,430,1,00147,India
600859,2023-03-13,506,monitor,3249,8000,4751,1,00147,India
980072,2023-03-13,505,oven,18490,24000,5510,1,00292,India
980072,2023-03-13,506,monitor,3249,8000,4751,1,00292,India
980072,2023-03-13,504,iron,449,879,430,1,00292,India
173481,2023-03-13,505,oven,18490,24000,5510,1,00372,India
129844,2023-03-13,501,iphone 15,60000,80000,20000,1,00060,India
129844,2023-03-13,506,monitor,3249,8000,4751,1,00060,India
129844,2023-03-13,504,iron,449,879,430,1,00060,India
126295,2023-03-13,505,oven,18490,24000,5510,1,00205,India
126295,2023-03-13,504,iron,449,879,430,1,00205,India
712364,2023-03-13,501,iphone 15,60000,80000,20000,1,00381,India
712364,2023-03-13,505,oven,18490,24000,5510,1,00381,India
659763,2023-03-13,505,oven,18490,24000,5510,1,00130,India
616279,2023-03-13,503,mixer,1349,3249,1900,1,00371,India
616279,2023-03-13,504,iron,449,879,430,1,00371,India
422260,2023-03-13,502,iphone 15 pro max,100000,135000,35000,1,00237,India
422260,2023-03-13,506,monitor,3249,8000,4751,1,00237,India
541385,2023-03-13,506,monitor,3249,8000,4751,1,00392,India
541385,2023-03-13,504,iron,449,879,430,1,00392,India
541385,2023-03-13,505,oven,18490,24000,5510,1,00392,India
541385,2023-03-13,503,mixer,1349,3249,1900,1,00392,India
764708,2023-03-13,507,washing machine,6990,16490,9500,1,00471,India
764708,2023-03-13,504,iron,449,879,430,1,00471,India
764708,2023-03-13,503,mixer,1349,3249,1900,1,00471,India
767072,2023-03-13,504,iron,449,879,430,1,00170,India
767072,2023-03-13,502,iphone 15 pro max,100000,135000,35000,1,00170,India
767072,2023-03-13,507,washing machine,6990,16490,9500,1,00170,India
767072,2023-03-13,506,monitor,3249,8000,4751,1,00170,India
361380,2023-03-13,504,iron,449,879,430,1,00199,India
361380,2023-03-13,503,mixer,1349,3249,1900,1,00199,India
781294,2023-03-13,502,iphone 15 pro max,100000,135000,35000,1,00297,India
781294,2023-03-13,501,iphone 15,60000,80000,20000,1,00297,India
598180,2023-03-13,506,monitor,3249,8000,4751,1,00320,India
598180,2023-03-13,502,iphone 15 pro max,100000,135000,35000,1,00320,India
934233,2023-03-13,504,iron,449,879,430,1,00312,India
110799,2023-03-13,505,oven,18490,24000,5510,1,00082,India
110799,2023-03-13,502,iphone 15 pro max,100000,135000,35000,1,00082,India
110799,2023-03-13,506,monitor,3249,8000,4751,1,00082,India
695291,2023-03-13,506,monitor,3249,8000,4751,1,00211,India
695291,2023-03-13,504,iron,449,879,430,1,00211,India
695291,2023-03-13,507,washing machine,6990,16490,9500,1,00211,India
695291,2023-03-13,501,iphone 15,60000,80000,20000,1,00211,India
782829,2023-03-13,507,washing machine,6990,16490,9500,1,00446,India
782829,2023-03-13,506,monitor,3249,8000,4751,1,00446,India
468196,2023-03-13,506,monitor,3249,8000,4751,1,00143,India
468196,2023-03-13,502,iphone 15 pro max,100000,135000,35000,1,00143,India
468196,2023-03-13,503,mixer,1349,3249,1900,1,00143,India
191007,2023-03-13,505,oven,18490,24000,5510,1,00276,India
191007,2023-03-13,501,iphone 15,60000,80000,20000,1,00276,India
709525,2023-03-13,504,iron,449,879,430,1,00403,India
265258,2023-03-13,507,washing machine,6990,16490,9500,1,00083,India
265258,2023-03-13,505,oven,18490,24000,5510,1,00083,India
354036,2023-03-13,503,mixer,1349,3249,1900,1,00388,India
354036,2023-03-13,505,oven,18490,24000,5510,1,00388,India
354036,2023-03-13,501,iphone 15,60000,80000,20000,1,00388,India
264650,2023-03-13,504,iron,449,879,430,1,00488,India
264650,2023-03-13,502,iphone 15 pro max,100000,135000,35000,1,00488,India
264650,2023-03-13,501,iphone 15,60000,80000,20000,1,00488,India
293126,2023-03-13,506,monitor,3249,8000,4751,1,00399,India
293126,2023-03-13,507,washing machine,6990,16490,9500,1,00399,India
293126,2023-03-13,505,oven,18490,24000,5510,1,00399,India
293126,2023-03-13,502,iphone 15 pro max,100000,135000,35000,1,00399,India
293126,2023-03-13,503,mixer,1349,3249,1900,1,00399,India
386552,2023-03-13,506,monitor,3249,8000,4751,1,00166,India
386552,2023-03-13,504,iron,449,879,430,1,00166,India
386552,2023-03-13,501,iphone 15,60000,80000,20000,1,00166,India
307682,2023-03-13,507,washing machine,6990,16490,9500,1,00387,India
307682,2023-03-13,506,monitor,3249,8000,4751,1,00387,India
307682,2023-03-13,504,iron,449,879,430,1,00387,India
101818,2023-03-13,503,mixer,1349,3249,1900,1,00307,India
622804,2023-03-13,503,mixer,1349,3249,1900,1,00071,India
857259,2023-03-13,504,iron,449,879,430,1,00416,India
631285,2023-03-13,502,iphone 15 pro max,100000,135000,35000,1,00144,India
631285,2023-03-13,501,iphone 15,60000,80000,20000,1,00144,India
579038,2023-03-13,503,mixer,1349,3249,1900,1,00354,India
579038,2023-03-13,505,oven,18490,24000,5510,1,00354,India
146047,2023-03-13,501,iphone 15,60000,80000,20000,1,00006,India
146047,2023-03-13,507,washing machine,6990,16490,9500,1,00006,India
146047,2023-03-13,503,mixer,1349,3249,1900,1,00006,India
122432,2023-03-13,505,oven,18490,24000,5510,1,00195,India
122432,2023-03-13,501,iphone 15,60000,80000,20000,1,00195,India
621102,2023-03-13,501,iphone 15,60000,80000,20000,1,00424,India
621102,2023-03-13,506,monitor,3249,8000,4751,1,00424,India
621102,2023-03-13,502,iphone 15 pro max,100000,135000,35000,1,00424,India
221995,2023-03-13,502,iphone 15 pro max,100000,135000,35000,1,00087,India
221995,2023-03-13,506,monitor,3249,8000,4751,1,00087,India
221995,2023-03-13,504,iron,449,879,430,1,00087,India
642821,2023-03-13,501,iphone 15,60000,80000,20000,1,00200,India
642821,2023-03-13,506,monitor,3249,8000,4751,1,00200,India
642821,2023-03-13,507,washing machine,6990,16490,9500,1,00200,India
370552,2023-03-13,501,iphone 15,60000,80000,20000,1,00490,India
370552,2023-03-13,505,oven,18490,24000,5510,1,00490,India
370552,2023-03-13,506,monitor,3249,8000,4751,1,00490,India
370552,2023-03-13,504,iron,449,879,430,1,00490,India
623006,2023-03-13,504,iron,449,879,430,1,00018,India
604879,2023-03-13,507,washing machine,6990,16490,9500,1,00109,India
323656,2023-03-13,506,monitor,3249,8000,4751,1,00152,India
323656,2023-03-13,503,mixer,1349,3249,1900,1,00152,India
323656,2023-03-13,507,washing machine,6990,16490,9500,1,00152,India
167809,2023-03-13,507,washing machine,6990,16490,9500,1,00252,India
167809,2023-03-13,505,oven,18490,24000,5510,1,00252,India
984858,2023-03-13,503,mixer,1349,3249,1900,1,00069,India
984858,2023-03-13,504,iron,449,879,430,1,00069,India
984858,2023-03-13,505,oven,18490,24000,5510,1,00069,India
394639,2023-03-13,505,oven,18490,24000,5510,1,00193,India
394639,2023-03-13,501,iphone 15,60000,80000,20000,1,00193,India
394639,2023-03-13,502,iphone 15 pro max,100000,135000,35000,1,00193,India
442129,2023-03-13,501,iphone 15,60000,80000,20000,1,00291,India
442129,2023-03-13,502,iphone 15 pro max,100000,135000,35000,1,00291,India
442129,2023-03-13,503,mixer,1349,3249,1900,1,00291,India
547361,2023-03-13,501,iphone 15,60000,80000,20000,1,00177,India
547361,2023-03-13,507,washing machine,6990,16490,9500,1,00177,India
204991,2023-03-13,507,washing machine,6990,16490,9500,1,00281,India
705084,2023-03-13,503,mixer,1349,3249,1900,1,00443,India
705084,2023-03-13,501,iphone 15,60000,80000,20000,1,00443,India
705084,2023-03-13,506,monitor,3249,8000,4751,1,00443,India
705084,2023-03-13,502,iphone 15 pro max,100000,135000,35000,1,00443,India
705084,2023-03-13,504,iron,449,879,430,1,00443,India
268562,2023-03-13,505,oven,18490,24000,5510,1,00380,India
268562,2023-03-13,502,iphone 15 pro max,100000,135000,35000,1,00380,India
268562,2023-03-13,501,iphone 15,60000,80000,20000,1,00380,India
268562,2023-03-13,503,mixer,1349,3249,1900,1,00380,India
499553,2023-03-13,505,oven,18490,24000,5510,1,00192,India
499553,2023-03-13,504,iron,449,879,430,1,00192,India
499553,2023-03-13,507,washing machine,6990,16490,9500,1,00192,India
499553,2023-03-13,503,mixer,1349,3249,1900,1,00192,India
499553,2023-03-13,506,monitor,3249,8000,4751,1,00192,India
173773,2023-03-13,504,iron,449,879,430,1,00175,India
916378,2023-03-13,504,iron,449,879,430,1,00329,India
916378,2023-03-13,503,mixer,1349,3249,1900,1,00329,India
916378,2023-03-13,507,washing machine,6990,16490,9500,1,00329,India
114434,2023-03-13,503,mixer,1349,3249,1900,1,00406,India
114434,2023-03-13,507,washing machine,6990,16490,9500,1,00406,India
114434,2023-03-13,502,iphone 15 pro max,100000,135000,35000,1,00406,India
491949,2023-03-13,503,mixer,1349,3249,1900,1,00011,India
599615,2023-03-14,503,mixer,1349,3249,1900,1,00444,India
599615,2023-03-14,505,oven,18490,24000,5510,1,00444,India
599615,2023-03-14,501,iphone 15,60000,80000,20000,1,00444,India
599615,2023-03-14,507,washing machine,6990,16490,9500,1,00444,India
392042,2023-03-14,504,iron,449,879,430,1,00336,India
392042,2023-03-14,507,washing machine,6990,16490,9500,1,00336,India
453450,2023-03-14,506,monitor,3249,8000,4751,1,00184,India
585888,2023-03-14,506,monitor,3249,8000,4751,1,00114,India
585888,2023-03-14,501,iphone 15,60000,80000,20000,1,00114,India
585888,2023-03-14,505,oven,18490,24000,5510,1,00114,India
585888,2023-03-14,502,iphone 15 pro max,100000,135000,35000,1,00114,India
411542,2023-03-14,504,iron,449,879,430,1,00067,India
411542,2023-03-14,502,iphone 15 pro max,100000,135000,35000,1,00067,India
515498,2023-03-14,505,oven,18490,24000,5510,1,00416,India
515498,2023-03-14,501,iphone 15,60000,80000,20000,1,00416,India
515498,2023-03-14,506,monitor,3249,8000,4751,1,00416,India
515498,2023-03-14,504,iron,449,879,430,1,00416,India
190464,2023-03-14,502,iphone 15 pro max,100000,135000,35000,1,00201,India
190464,2023-03-14,501,iphone 15,60000,80000,20000,1,00201,India
794449,2023-03-14,505,oven,18490,24000,5510,1,00031,India
794449,2023-03-14,502,iphone 15 pro max,100000,135000,35000,1,00031,India
794449,2023-03-14,504,iron,449,879,430,1,00031,India
370406,2023-03-14,504,iron,449,879,430,1,00493,India
370406,2023-03-14,506,monitor,3249,8000,4751,1,00493,India
370406,2023-03-14,501,iphone 15,60000,80000,20000,1,00493,India
278373,2023-03-14,502,iphone 15 pro max,100000,135000,35000,1,00113,India
278373,2023-03-14,506,monitor,3249,8000,4751,1,00113,India
278373,2023-03-14,501,iphone 15,60000,80000,20000,1,00113,India
264394,2023-03-14,501,iphone 15,60000,80000,20000,1,00192,India
264394,2023-03-14,505,oven,18490,24000,5510,1,00192,India
264394,2023-03-14,503,mixer,1349,3249,1900,1,00192,India
264394,2023-03-14,502,iphone 15 pro max,100000,135000,35000,1,00192,India
596632,2023-03-14,503,mixer,1349,3249,1900,1,00127,India
596632,2023-03-14,502,iphone 15 pro max,100000,135000,35000,1,00127,India
596632,2023-03-14,506,monitor,3249,8000,4751,1,00127,India
596632,2023-03-14,505,oven,18490,24000,5510,1,00127,India
585452,2023-03-14,503,mixer,1349,3249,1900,1,00451,India
585452,2023-03-14,501,iphone 15,60000,80000,20000,1,00451,India
585452,2023-03-14,502,iphone 15 pro max,100000,135000,35000,1,00451,India
719402,2023-03-14,505,oven,18490,24000,5510,1,00219,India
241487,2023-03-14,506,monitor,3249,8000,4751,1,00119,India
812015,2023-03-14,502,iphone 15 pro max,100000,135000,35000,1,00013,India
812015,2023-03-14,506,monitor,3249,8000,4751,1,00013,India
812015,2023-03-14,501,iphone 15,60000,80000,20000,1,00013,India
812015,2023-03-14,504,iron,449,879,430,1,00013,India
868786,2023-03-14,507,washing machine,6990,16490,9500,1,00292,India
872949,2023-03-14,507,washing machine,6990,16490,9500,1,00122,India
872949,2023-03-14,501,iphone 15,60000,80000,20000,1,00122,India
872949,2023-03-14,506,monitor,3249,8000,4751,1,00122,India
578412,2023-03-14,502,iphone 15 pro max,100000,135000,35000,1,00330,India
578412,2023-03-14,503,mixer,1349,3249,1900,1,00330,India
578412,2023-03-14,504,iron,449,879,430,1,00330,India
845699,2023-03-14,506,monitor,3249,8000,4751,1,00152,India
845699,2023-03-14,507,washing machine,6990,16490,9500,1,00152,India
845699,2023-03-14,502,iphone 15 pro max,100000,135000,35000,1,00152,India
963270,2023-03-14,506,monitor,3249,8000,4751,1,00261,India
963270,2023-03-14,502,iphone 15 pro max,100000,135000,35000,1,00261,India
766862,2023-03-14,507,washing machine,6990,16490,9500,1,00470,India
766862,2023-03-14,502,iphone 15 pro max,100000,135000,35000,1,00470,India
405825,2023-03-14,502,iphone 15 pro max,100000,135000,35000,1,00477,India
405825,2023-03-14,501,iphone 15,60000,80000,20000,1,00477,India
291101,2023-03-14,503,mixer,1349,3249,1900,1,00454,India
291101,2023-03-14,507,washing machine,6990,16490,9500,1,00454,India
291101,2023-03-14,502,iphone 15 pro max,100000,135000,35000,1,00454,India
291101,2023-03-14,505,oven,18490,24000,5510,1,00454,India
600138,2023-03-14,503,mixer,1349,3249,1900,1,00150,India
600138,2023-03-14,501,iphone 15,60000,80000,20000,1,00150,India
720232,2023-03-14,505,oven,18490,24000,5510,1,00096,India
720232,2023-03-14,506,monitor,3249,8000,4751,1,00096,India
720232,2023-03-14,507,washing machine,6990,16490,9500,1,00096,India
533370,2023-03-14,504,iron,449,879,430,1,00488,India
851100,2023-03-14,502,iphone 15 pro max,100000,135000,35000,1,00336,India
851100,2023-03-14,503,mixer,1349,3249,1900,1,00336,India
851100,2023-03-14,505,oven,18490,24000,5510,1,00336,India
273380,2023-03-14,502,iphone 15 pro max,100000,135000,35000,1,00074,India
273380,2023-03-14,505,oven,18490,24000,5510,1,00074,India
246160,2023-03-14,506,monitor,3249,8000,4751,1,00114,India
380756,2023-03-14,503,mixer,1349,3249,1900,1,00314,India
380756,2023-03-14,501,iphone 15,60000,80000,20000,1,00314,India
380756,2023-03-14,504,iron,449,879,430,1,00314,India
683013,2023-03-14,502,iphone 15 pro max,100000,135000,35000,1,00216,India
683013,2023-03-14,504,iron,449,879,430,1,00216,India
132809,2023-03-14,501,iphone 15,60000,80000,20000,1,00341,India
132809,2023-03-14,507,washing machine,6990,16490,9500,1,00341,India
132809,2023-03-14,503,mixer,1349,3249,1900,1,00341,India
232365,2023-03-14,506,monitor,3249,8000,4751,1,00032,India
232365,2023-03-14,505,oven,18490,24000,5510,1,00032,India
968780,2023-03-14,506,monitor,3249,8000,4751,1,00486,India
968780,2023-03-14,502,iphone 15 pro max,100000,135000,35000,1,00486,India
619122,2023-03-14,506,monitor,3249,8000,4751,1,00276,India
619122,2023-03-14,501,iphone 15,60000,80000,20000,1,00276,India
754515,2023-03-14,504,iron,449,879,430,1,00143,India
754515,2023-03-14,501,iphone 15,60000,80000,20000,1,00143,India
226940,2023-03-14,505,oven,18490,24000,5510,1,00156,India
226940,2023-03-14,507,washing machine,6990,16490,9500,1,00156,India
435139,2023-03-14,507,washing machine,6990,16490,9500,1,00467,India
435139,2023-03-14,501,iphone 15,60000,80000,20000,1,00467,India
435139,2023-03-14,502,iphone 15 pro max,100000,135000,35000,1,00467,India
220120,2023-03-14,503,mixer,1349,3249,1900,1,00226,India
220120,2023-03-14,507,washing machine,6990,16490,9500,1,00226,India
152077,2023-03-14,501,iphone 15,60000,80000,20000,1,00042,India
152077,2023-03-14,502,iphone 15 pro max,100000,135000,35000,1,00042,India
215723,2023-03-14,505,oven,18490,24000,5510,1,00334,India
515998,2023-03-14,507,washing machine,6990,16490,9500,1,00381,India
515998,2023-03-14,506,monitor,3249,8000,4751,1,00381,India
515998,2023-03-14,504,iron,449,879,430,1,00381,India
828985,2023-03-14,504,iron,449,879,430,1,00334,India
828985,2023-03-14,503,mixer,1349,3249,1900,1,00334,India
828985,2023-03-14,506,monitor,3249,8000,4751,1,00334,India
204884,2023-03-14,503,mixer,1349,3249,1900,1,00093,India
754734,2023-03-14,504,iron,449,879,430,1,00380,India
754734,2023-03-14,507,washing machine,6990,16490,9500,1,00380,India
754734,2023-03-14,505,oven,18490,24000,5510,1,00380,India
754734,2023-03-14,506,monitor,3249,8000,4751,1,00380,India
417514,2023-03-14,506,monitor,3249,8000,4751,1,00232,India
238221,2023-03-14,507,washing machine,6990,16490,9500,1,00275,India
264565,2023-03-14,502,iphone 15 pro max,100000,135000,35000,1,00017,India
264565,2023-03-14,505,oven,18490,24000,5510,1,00017,India
659952,2023-03-14,505,oven,18490,24000,5510,1,00431,India
659952,2023-03-14,504,iron,449,879,430,1,00431,India
659952,2023-03-14,501,iphone 15,60000,80000,20000,1,00431,India
807694,2023-03-14,501,iphone 15,60000,80000,20000,1,00180,India
807694,2023-03-14,505,oven,18490,24000,5510,1,00180,India
479010,2023-03-14,502,iphone 15 pro max,100000,135000,35000,1,00383,India
479010,2023-03-14,503,mixer,1349,3249,1900,1,00383,India
479010,2023-03-14,507,washing machine,6990,16490,9500,1,00383,India
396170,2023-03-14,502,iphone 15 pro max,100000,135000,35000,1,00440,India
396170,2023-03-14,507,washing machine,6990,16490,9500,1,00440,India
168010,2023-03-14,502,iphone 15 pro max,100000,135000,35000,1,00362,India
168010,2023-03-14,504,iron,449,879,430,1,00362,India
168010,2023-03-14,506,monitor,3249,8000,4751,1,00362,India
660253,2023-03-14,507,washing machine,6990,16490,9500,1,00380,India
660253,2023-03-14,503,mixer,1349,3249,1900,1,00380,India
660253,2023-03-14,504,iron,449,879,430,1,00380,India
533884,2023-03-14,501,iphone 15,60000,80000,20000,1,00036,India
533884,2023-03-14,504,iron,449,879,430,1,00036,India
533884,2023-03-14,502,iphone 15 pro max,100000,135000,35000,1,00036,India
533884,2023-03-14,506,monitor,3249,8000,4751,1,00036,India
860973,2023-03-14,504,iron,449,879,430,1,00309,India
161423,2023-03-14,502,iphone 15 pro max,100000,135000,35000,1,00486,India
161423,2023-03-14,503,mixer,1349,3249,1900,1,00486,India
161423,2023-03-14,504,iron,449,879,430,1,00486,India
161423,2023-03-14,505,oven,18490,24000,5510,1,00486,India
564214,2023-03-14,507,washing machine,6990,16490,9500,1,00143,India
564214,2023-03-14,506,monitor,3249,8000,4751,1,00143,India
564214,2023-03-14,505,oven,18490,24000,5510,1,00143,India
179899,2023-03-14,502,iphone 15 pro max,100000,135000,35000,1,00311,India
179899,2023-03-14,505,oven,18490,24000,5510,1,00311,India
179899,2023-03-14,506,monitor,3249,8000,4751,1,00311,India
625425,2023-03-14,501,iphone 15,60000,80000,20000,1,00053,India
625425,2023-03-14,503,mixer,1349,3249,1900,1,00053,India
625425,2023-03-14,502,iphone 15 pro max,100000,135000,35000,1,00053,India
230762,2023-03-14,502,iphone 15 pro max,100000,135000,35000,1,00181,India
230762,2023-03-14,503,mixer,1349,3249,1900,1,00181,India
230762,2023-03-14,501,iphone 15,60000,80000,20000,1,00181,India
230762,2023-03-14,504,iron,449,879,430,1,00181,India
771048,2023-03-14,504,iron,449,879,430,1,00238,India
972800,2023-03-14,507,washing machine,6990,16490,9500,1,00102,India
972800,2023-03-14,501,iphone 15,60000,80000,20000,1,00102,India
972800,2023-03-14,503,mixer,1349,3249,1900,1,00102,India
596566,2023-03-14,505,oven,18490,24000,5510,1,00428,India
596566,2023-03-14,503,mixer,1349,3249,1900,1,00428,India
864464,2023-03-14,507,washing machine,6990,16490,9500,1,00193,India
670292,2023-03-14,507,washing machine,6990,16490,9500,1,00339,India
467572,2023-03-14,505,oven,18490,24000,5510,1,00448,India
997176,2023-03-14,502,iphone 15 pro max,100000,135000,35000,1,00174,India
997176,2023-03-14,503,mixer,1349,3249,1900,1,00174,India
801289,2023-03-14,505,oven,18490,24000,5510,1,00199,India
801289,2023-03-14,501,iphone 15,60000,80000,20000,1,00199,India
801289,2023-03-14,503,mixer,1349,3249,1900,1,00199,India
942584,2023-03-14,504,iron,449,879,430,1,00139,India
942584,2023-03-14,503,mixer,1349,3249,1900,1,00139,India
518501,2023-03-14,505,oven,18490,24000,5510,1,00220,India
518501,2023-03-14,507,washing machine,6990,16490,9500,1,00220,India
518501,2023-03-14,503,mixer,1349,3249,1900,1,00220,India
809744,2023-03-14,501,iphone 15,60000,80000,20000,1,00273,India
809744,2023-03-14,504,iron,449,879,430,1,00273,India
248689,2023-03-14,501,iphone 15,60000,80000,20000,1,00146,India
248689,2023-03-14,504,iron,449,879,430,1,00146,India
248689,2023-03-14,503,mixer,1349,3249,1900,1,00146,India
404555,2023-03-14,504,iron,449,879,430,1,00342,India
122549,2023-03-14,501,iphone 15,60000,80000,20000,1,00033,India
122549,2023-03-14,503,mixer,1349,3249,1900,1,00033,India
122549,2023-03-14,506,monitor,3249,8000,4751,1,00033,India
122549,2023-03-14,502,iphone 15 pro max,100000,135000,35000,1,00033,India
894649,2023-03-14,501,iphone 15,60000,80000,20000,1,00206,India
894649,2023-03-14,504,iron,449,879,430,1,00206,India
894649,2023-03-14,505,oven,18490,24000,5510,1,00206,India
982235,2023-03-14,501,iphone 15,60000,80000,20000,1,00127,India
982235,2023-03-14,502,iphone 15 pro max,100000,135000,35000,1,00127,India
982235,2023-03-14,505,oven,18490,24000,5510,1,00127,India
982235,2023-03-14,506,monitor,3249,8000,4751,1,00127,India
948907,2023-03-14,504,iron,449,879,430,1,00048,India
709616,2023-03-14,504,iron,449,879,430,1,00481,India
709616,2023-03-14,505,oven,18490,24000,5510,1,00481,India
194913,2023-03-14,503,mixer,1349,3249,1900,1,00180,India
194913,2023-03-14,507,washing machine,6990,16490,9500,1,00180,India
194913,2023-03-14,504,iron,449,879,430,1,00180,India
194913,2023-03-14,506,monitor,3249,8000,4751,1,00180,India
428615,2023-03-14,505,oven,18490,24000,5510,1,00286,India
428615,2023-03-14,507,washing machine,6990,16490,9500,1,00286,India
428615,2023-03-14,504,iron,449,879,430,1,00286,India
998239,2023-03-14,504,iron,449,879,430,1,00042,India
112119,2023-03-14,505,oven,18490,24000,5510,1,00002,India
112119,2023-03-14,501,iphone 15,60000,80000,20000,1,00002,India
112119,2023-03-14,503,mixer,1349,3249,1900,1,00002,India
342156,2023-03-15,503,mixer,1349,3249,1900,1,00435,India
342156,2023-03-15,501,iphone 15,60000,80000,20000,1,00435,India
342156,2023-03-15,506,monitor,3249,8000,4751,1,00435,India
602442,2023-03-15,505,oven,18490,24000,5510,1,00076,India
542916,2023-03-15,506,monitor,3249,8000,4751,1,00450,India
542916,2023-03-15,502,iphone 15 pro max,100000,135000,35000,1,00450,India
711406,2023-03-15,503,mixer,1349,3249,1900,1,00278,India
711406,2023-03-15,504,iron,449,879,430,1,00278,India
711406,2023-03-15,501,iphone 15,60000,80000,20000,1,00278,India
550295,2023-03-15,503,mixer,1349,3249,1900,1,00155,India
277838,2023-03-15,507,washing machine,6990,16490,9500,1,00309,India
277838,2023-03-15,501,iphone 15,60000,80000,20000,1,00309,India
277838,2023-03-15,504,iron,449,879,430,1,00309,India
277838,2023-03-15,502,iphone 15 pro max,100000,135000,35000,1,00309,India
130744,2023-03-15,504,iron,449,879,430,1,00100,India
130744,2023-03-15,505,oven,18490,24000,5510,1,00100,India
680981,2023-03-15,506,monitor,3249,8000,4751,1,00151,India
680981,2023-03-15,502,iphone 15 pro max,100000,135000,35000,1,00151,India
680981,2023-03-15,504,iron,449,879,430,1,00151,India
397057,2023-03-15,506,monitor,3249,8000,4751,1,00145,India
397057,2023-03-15,502,iphone 15 pro max,100000,135000,35000,1,00145,India
397057,2023-03-15,505,oven,18490,24000,5510,1,00145,India
397057,2023-03-15,507,washing machine,6990,16490,9500,1,00145,India
416063,2023-03-15,505,oven,18490,24000,5510,1,00069,India
416063,2023-03-15,506,monitor,3249,8000,4751,1,00069,India
416063,2023-03-15,503,mixer,1349,3249,1900,1,00069,India
416063,2023-03-15,507,washing machine,6990,16490,9500,1,00069,India
706474,2023-03-15,501,iphone 15,60000,80000,20000,1,00260,India
513155,2023-03-15,503,mixer,1349,3249,1900,1,00284,India
665664,2023-03-15,502,iphone 15 pro max,100000,135000,35000,1,00422,India
665664,2023-03-15,505,oven,18490,24000,5510,1,00422,India
665664,2023-03-15,501,iphone 15,60000,80000,20000,1,00422,India
561870,2023-03-15,505,oven,18490,24000,5510,1,00282,India
561870,2023-03-15,507,washing machine,6990,16490,9500,1,00282,India
697162,2023-03-15,502,iphone 15 pro max,100000,135000,35000,1,00218,India
697162,2023-03-15,501,iphone 15,60000,80000,20000,1,00218,India
695694,2023-03-15,506,monitor,3249,8000,4751,1,00343,India
695694,2023-03-15,501,iphone 15,60000,80000,20000,1,00343,India
695694,2023-03-15,507,washing machine,6990,16490,9500,1,00343,India
940551,2023-03-15,507,washing machine,6990,16490,9500,1,00217,India
940551,2023-03-15,502,iphone 15 pro max,100000,135000,35000,1,00217,India
940551,2023-03-15,503,mixer,1349,3249,1900,1,00217,India
852954,2023-03-15,501,iphone 15,60000,80000,20000,1,00076,India
852954,2023-03-15,503,mixer,1349,3249,1900,1,00076,India
607166,2023-03-15,504,iron,449,879,430,1,00446,India
716545,2023-03-15,501,iphone 15,60000,80000,20000,1,00025,India
716545,2023-03-15,503,mixer,1349,3249,1900,1,00025,India
716545,2023-03-15,504,iron,449,879,430,1,00025,India
716545,2023-03-15,502,iphone 15 pro max,100000,135000,35000,1,00025,India
169799,2023-03-15,504,iron,449,879,430,1,00293,India
169799,2023-03-15,505,oven,18490,24000,5510,1,00293,India
220090,2023-03-15,505,oven,18490,24000,5510,1,00412,India
220090,2023-03-15,504,iron,449,879,430,1,00412,India
208121,2023-03-15,501,iphone 15,60000,80000,20000,1,00208,India
859585,2023-03-15,504,iron,449,879,430,1,00345,India
859585,2023-03-15,506,monitor,3249,8000,4751,1,00345,India
859585,2023-03-15,501,iphone 15,60000,80000,20000,1,00345,India
515555,2023-03-15,505,oven,18490,24000,5510,1,00399,India
515555,2023-03-15,506,monitor,3249,8000,4751,1,00399,India
515555,2023-03-15,504,iron,449,879,430,1,00399,India
515555,2023-03-15,501,iphone 15,60000,80000,20000,1,00399,India
515555,2023-03-15,507,washing machine,6990,16490,9500,1,00399,India
749517,2023-03-15,503,mixer,1349,3249,1900,1,00229,India
749517,2023-03-15,506,monitor,3249,8000,4751,1,00229,India
749517,2023-03-15,504,iron,449,879,430,1,00229,India
705433,2023-03-15,501,iphone 15,60000,80000,20000,1,00383,India
705433,2023-03-15,503,mixer,1349,3249,1900,1,00383,India
705433,2023-03-15,502,iphone 15 pro max,100000,135000,35000,1,00383,India
705433,2023-03-15,507,washing machine,6990,16490,9500,1,00383,India
705433,2023-03-15,505,oven,18490,24000,5510,1,00383,India
427140,2023-03-15,505,oven,18490,24000,5510,1,00125,India
427140,2023-03-15,501,iphone 15,60000,80000,20000,1,00125,India
946857,2023-03-15,504,iron,449,879,430,1,00008,India
946857,2023-03-15,503,mixer,1349,3249,1900,1,00008,India
946857,2023-03-15,505,oven,18490,24000,5510,1,00008,India
113242,2023-03-15,503,mixer,1349,3249,1900,1,00135,India
113242,2023-03-15,501,iphone 15,60000,80000,20000,1,00135,India
113242,2023-03-15,506,monitor,3249,8000,4751,1,00135,India
113242,2023-03-15,502,iphone 15 pro max,100000,135000,35000,1,00135,India
113242,2023-03-15,505,oven,18490,24000,5510,1,00135,India
623774,2023-03-15,505,oven,18490,24000,5510,1,00186,India
623774,2023-03-15,506,monitor,3249,8000,4751,1,00186,India
623774,2023-03-15,502,iphone 15 pro max,100000,135000,35000,1,00186,India
623774,2023-03-15,504,iron,449,879,430,1,00186,India
623774,2023-03-15,503,mixer,1349,3249,1900,1,00186,India
884305,2023-03-15,507,washing machine,6990,16490,9500,1,00069,India
884305,2023-03-15,505,oven,18490,24000,5510,1,00069,India
884305,2023-03-15,501,iphone 15,60000,80000,20000,1,00069,India
884305,2023-03-15,502,iphone 15 pro max,100000,135000,35000,1,00069,India
462760,2023-03-15,502,iphone 15 pro max,100000,135000,35000,1,00166,India
462760,2023-03-15,505,oven,18490,24000,5510,1,00166,India
462760,2023-03-15,506,monitor,3249,8000,4751,1,00166,India
368473,2023-03-15,507,washing machine,6990,16490,9500,1,00452,India
368473,2023-03-15,503,mixer,1349,3249,1900,1,00452,India
368473,2023-03-15,506,monitor,3249,8000,4751,1,00452,India
223775,2023-03-15,505,oven,18490,24000,5510,1,00081,India
223775,2023-03-15,504,iron,449,879,430,1,00081,India
223775,2023-03-15,501,iphone 15,60000,80000,20000,1,00081,India
626269,2023-03-15,501,iphone 15,60000,80000,20000,1,00189,India
626269,2023-03-15,506,monitor,3249,8000,4751,1,00189,India
626269,2023-03-15,505,oven,18490,24000,5510,1,00189,India
626269,2023-03-15,507,washing machine,6990,16490,9500,1,00189,India
951137,2023-03-15,507,washing machine,6990,16490,9500,1,00428,India
951137,2023-03-15,503,mixer,1349,3249,1900,1,00428,India
295165,2023-03-15,504,iron,449,879,430,1,00197,India
295165,2023-03-15,506,monitor,3249,8000,4751,1,00197,India
483779,2023-03-15,507,washing machine,6990,16490,9500,1,00213,India
483779,2023-03-15,501,iphone 15,60000,80000,20000,1,00213,India
814644,2023-03-15,504,iron,449,879,430,1,00385,India
814644,2023-03-15,507,washing machine,6990,16490,9500,1,00385,India
814644,2023-03-15,505,oven,18490,24000,5510,1,00385,India
664403,2023-03-15,506,monitor,3249,8000,4751,1,00373,India
664403,2023-03-15,505,oven,18490,24000,5510,1,00373,India
664403,2023-03-15,502,iphone 15 pro max,100000,135000,35000,1,00373,India
664403,2023-03-15,503,mixer,1349,3249,1900,1,00373,India
233019,2023-03-15,505,oven,18490,24000,5510,1,00198,India
233019,2023-03-15,502,iphone 15 pro max,100000,135000,35000,1,00198,India
233019,2023-03-15,501,iphone 15,60000,80000,20000,1,00198,India
570782,2023-03-15,504,iron,449,879,430,1,00366,India
570782,2023-03-15,503,mixer,1349,3249,1900,1,00366,India
589840,2023-03-15,504,iron,449,879,430,1,00177,India
589840,2023-03-15,501,iphone 15,60000,80000,20000,1,00177,India
753065,2023-03-15,502,iphone 15 pro max,100000,135000,35000,1,00495,India
970897,2023-03-15,506,monitor,3249,8000,4751,1,00075,India
236161,2023-03-15,506,monitor,3249,8000,4751,1,00052,India
236161,2023-03-15,502,iphone 15 pro max,100000,135000,35000,1,00052,India
236161,2023-03-15,503,mixer,1349,3249,1900,1,00052,India
201296,2023-03-15,504,iron,449,879,430,1,00443,India
201296,2023-03-15,507,washing machine,6990,16490,9500,1,00443,India
201296,2023-03-15,505,oven,18490,24000,5510,1,00443,India
128116,2023-03-15,505,oven,18490,24000,5510,1,00258,India
128116,2023-03-15,503,mixer,1349,3249,1900,1,00258,India
622705,2023-03-15,507,washing machine,6990,16490,9500,1,00166,India
622705,2023-03-15,505,oven,18490,24000,5510,1,00166,India
622705,2023-03-15,501,iphone 15,60000,80000,20000,1,00166,India
622705,2023-03-15,504,iron,449,879,430,1,00166,India
297729,2023-03-15,503,mixer,1349,3249,1900,1,00325,India
764994,2023-03-15,505,oven,18490,24000,5510,1,00172,India
764994,2023-03-15,502,iphone 15 pro max,100000,135000,35000,1,00172,India
764994,2023-03-15,506,monitor,3249,8000,4751,1,00172,India
166171,2023-03-15,507,washing machine,6990,16490,9500,1,00030,India
166171,2023-03-15,506,monitor,3249,8000,4751,1,00030,India
166171,2023-03-15,501,iphone 15,60000,80000,20000,1,00030,India
161286,2023-03-15,506,monitor,3249,8000,4751,1,00116,India
161286,2023-03-15,503,mixer,1349,3249,1900,1,00116,India
609892,2023-03-15,505,oven,18490,24000,5510,1,00051,India
609892,2023-03-15,502,iphone 15 pro max,100000,135000,35000,1,00051,India
609892,2023-03-15,504,iron,449,879,430,1,00051,India
689621,2023-03-15,504,iron,449,879,430,1,00165,India
689621,2023-03-15,502,iphone 15 pro max,100000,135000,35000,1,00165,India
844474,2023-03-15,502,iphone 15 pro max,100000,135000,35000,1,00259,India
844474,2023-03-15,504,iron,449,879,430,1,00259,India
844474,2023-03-15,503,mixer,1349,3249,1900,1,00259,India
215047,2023-03-15,502,iphone 15 pro max,100000,135000,35000,1,00119,India
215047,2023-03-15,507,washing machine,6990,16490,9500,1,00119,India
215047,2023-03-15,505,oven,18490,24000,5510,1,00119,India
215047,2023-03-15,503,mixer,1349,3249,1900,1,00119,India
421048,2023-03-15,504,iron,449,879,430,1,00242,India
421048,2023-03-15,503,mixer,1349,3249,1900,1,00242,India
640243,2023-03-15,507,washing machine,6990,16490,9500,1,00447,India
640243,2023-03-15,503,mixer,1349,3249,1900,1,00447,India
640243,2023-03-15,506,monitor,3249,8000,4751,1,00447,India
640243,2023-03-15,502,iphone 15 pro max,100000,135000,35000,1,00447,India
731187,2023-03-15,505,oven,18490,24000,5510,1,00229,India
731187,2023-03-15,501,iphone 15,60000,80000,20000,1,00229,India
731187,2023-03-15,503,mixer,1349,3249,1900,1,00229,India
134258,2023-03-15,501,iphone 15,60000,80000,20000,1,00020,India
134258,2023-03-15,504,iron,449,879,430,1,00020,India
425239,2023-03-15,507,washing machine,6990,16490,9500,1,00252,India
463230,2023-03-15,504,iron,449,879,430,1,00216,India
463230,2023-03-15,505,oven,18490,24000,5510,1,00216,India
463230,2023-03-15,502,iphone 15 pro max,100000,135000,35000,1,00216,India
449312,2023-03-16,504,iron,449,879,430,1,00322,India
449312,2023-03-16,507,washing machine,6990,16490,9500,1,00322,India
449312,2023-03-16,501,iphone 15,60000,80000,20000,1,00322,India
876097,2023-03-16,504,iron,449,879,430,1,00437,India
853634,2023-03-16,502,iphone 15 pro max,100000,135000,35000,1,00390,India
853634,2023-03-16,504,iron,449,879,430,1,00390,India
291347,2023-03-16,504,iron,449,879,430,1,00313,India
291347,2023-03-16,505,oven,18490,24000,5510,1,00313,India
291347,2023-03-16,506,monitor,3249,8000,4751,1,00313,India
133051,2023-03-16,504,iron,449,879,430,1,00413,India
133051,2023-03-16,507,washing machine,6990,16490,9500,1,00413,India
133051,2023-03-16,505,oven,18490,24000,5510,1,00413,India
133051,2023-03-16,503,mixer,1349,3249,1900,1,00413,India
776074,2023-03-16,504,iron,449,879,430,1,00086,India
776074,2023-03-16,503,mixer,1349,3249,1900,1,00086,India
776074,2023-03-16,507,washing machine,6990,16490,9500,1,00086,India
776074,2023-03-16,502,iphone 15 pro max,100000,135000,35000,1,00086,India
776074,2023-03-16,501,iphone 15,60000,80000,20000,1,00086,India
613767,2023-03-16,501,iphone 15,60000,80000,20000,1,00397,India
613767,2023-03-16,507,washing machine,6990,16490,9500,1,00397,India
613767,2023-03-16,504,iron,449,879,430,1,00397,India
456631,2023-03-16,504,iron,449,879,430,1,00188,India
456631,2023-03-16,503,mixer,1349,3249,1900,1,00188,India
456631,2023-03-16,507,washing machine,6990,16490,9500,1,00188,India
456631,2023-03-16,501,iphone 15,60000,80000,20000,1,00188,India
456631,2023-03-16,505,oven,18490,24000,5510,1,00188,India
195737,2023-03-16,506,monitor,3249,8000,4751,1,00328,India
195737,2023-03-16,505,oven,18490,24000,5510,1,00328,India
195737,2023-03-16,504,iron,449,879,430,1,00328,India
280928,2023-03-16,504,iron,449,879,430,1,00340,India
280928,2023-03-16,505,oven,18490,24000,5510,1,00340,India
280928,2023-03-16,507,washing machine,6990,16490,9500,1,00340,India
836579,2023-03-16,505,oven,18490,24000,5510,1,00438,India
836579,2023-03-16,504,iron,449,879,430,1,00438,India
775580,2023-03-16,502,iphone 15 pro max,100000,135000,35000,1,00002,India
754825,2023-03-16,504,iron,449,879,430,1,00095,India
754825,2023-03-16,501,iphone 15,60000,80000,20000,1,00095,India
754825,2023-03-16,506,monitor,3249,8000,4751,1,00095,India
754825,2023-03-16,505,oven,18490,24000,5510,1,00095,India
920926,2023-03-16,502,iphone 15 pro max,100000,135000,35000,1,00331,India
920926,2023-03-16,506,monitor,3249,8000,4751,1,00331,India
920926,2023-03-16,507,washing machine,6990,16490,9500,1,00331,India
759562,2023-03-16,505,oven,18490,24000,5510,1,00459,India
731784,2023-03-16,502,iphone 15 pro max,100000,135000,35000,1,00319,India
731784,2023-03-16,507,washing machine,6990,16490,9500,1,00319,India
731784,2023-03-16,503,mixer,1349,3249,1900,1,00319,India
731784,2023-03-16,506,monitor,3249,8000,4751,1,00319,India
579772,2023-03-16,501,iphone 15,60000,80000,20000,1,00310,India
579772,2023-03-16,507,washing machine,6990,16490,9500,1,00310,India
579772,2023-03-16,506,monitor,3249,8000,4751,1,00310,India
579772,2023-03-16,503,mixer,1349,3249,1900,1,00310,India
579772,2023-03-16,505,oven,18490,24000,5510,1,00310,India
788661,2023-03-16,506,monitor,3249,8000,4751,1,00360,India
788661,2023-03-16,503,mixer,1349,3249,1900,1,00360,India
194822,2023-03-16,506,monitor,3249,8000,4751,1,00075,India
194822,2023-03-16,504,iron,449,879,430,1,00075,India
194822,2023-03-16,502,iphone 15 pro max,100000,135000,35000,1,00075,India
786723,2023-03-16,505,oven,18490,24000,5510,1,00138,India
786723,2023-03-16,506,monitor,3249,8000,4751,1,00138,India
786723,2023-03-16,503,mixer,1349,3249,1900,1,00138,India
786723,2023-03-16,502,iphone 15 pro max,100000,135000,35000,1,00138,India
930560,2023-03-16,504,iron,449,879,430,1,00412,India
930560,2023-03-16,502,iphone 15 pro max,100000,135000,35000,1,00412,India
930560,2023-03-16,503,mixer,1349,3249,1900,1,00412,India
930560,2023-03-16,507,washing machine,6990,16490,9500,1,00412,India
782575,2023-03-16,504,iron,449,879,430,1,00257,India
782575,2023-03-16,501,iphone 15,60000,80000,20000,1,00257,India
782575,2023-03-16,505,oven,18490,24000,5510,1,00257,India
782575,2023-03-16,507,washing machine,6990,16490,9500,1,00257,India
772489,2023-03-16,504,iron,449,879,430,1,00131,India
772489,2023-03-16,506,monitor,3249,8000,4751,1,00131,India
772489,2023-03-16,501,iphone 15,60000,80000,20000,1,00131,India
772489,2023-03-16,503,mixer,1349,3249,1900,1,00131,India
725721,2023-03-16,504,iron,449,879,430,1,00381,India
725721,2023-03-16,502,iphone 15 pro max,100000,135000,35000,1,00381,India
725721,2023-03-16,507,washing machine,6990,16490,9500,1,00381,India
335101,2023-03-16,503,mixer,1349,3249,1900,1,00038,India
335101,2023-03-16,505,oven,18490,24000,5510,1,00038,India
335101,2023-03-16,506,monitor,3249,8000,4751,1,00038,India
834187,2023-03-16,507,washing machine,6990,16490,9500,1,00010,India
834187,2023-03-16,506,monitor,3249,8000,4751,1,00010,India
114396,2023-03-16,504,iron,449,879,430,1,00394,India
114396,2023-03-16,506,monitor,3249,8000,4751,1,00394,India
114396,2023-03-16,505,oven,18490,24000,5510,1,00394,India
728487,2023-03-16,502,iphone 15 pro max,100000,135000,35000,1,00091,India
728487,2023-03-16,506,monitor,3249,8000,4751,1,00091,India
728487,2023-03-16,505,oven,18490,24000,5510,1,00091,India
180623,2023-03-16,503,mixer,1349,3249,1900,1,00153,India
651441,2023-03-16,507,washing machine,6990,16490,9500,1,00168,India
651441,2023-03-16,502,iphone 15 pro max,100000,135000,35000,1,00168,India
651441,2023-03-16,506,monitor,3249,8000,4751,1,00168,India
651441,2023-03-16,504,iron,449,879,430,1,00168,India
698052,2023-03-16,502,iphone 15 pro max,100000,135000,35000,1,00471,India
698052,2023-03-16,505,oven,18490,24000,5510,1,00471,India
592406,2023-03-16,504,iron,449,879,430,1,00435,India
592406,2023-03-16,502,iphone 15 pro max,100000,135000,35000,1,00435,India
592406,2023-03-16,506,monitor,3249,8000,4751,1,00435,India
810696,2023-03-16,507,washing machine,6990,16490,9500,1,00398,India
810696,2023-03-16,502,iphone 15 pro max,100000,135000,35000,1,00398,India
810696,2023-03-16,503,mixer,1349,3249,1900,1,00398,India
412937,2023-03-16,501,iphone 15,60000,80000,20000,1,00152,India
412937,2023-03-16,503,mixer,1349,3249,1900,1,00152,India
412937,2023-03-16,505,oven,18490,24000,5510,1,00152,India
951338,2023-03-16,506,monitor,3249,8000,4751,1,00258,India
951338,2023-03-16,502,iphone 15 pro max,100000,135000,35000,1,00258,India
951338,2023-03-16,503,mixer,1349,3249,1900,1,00258,India
319413,2023-03-16,506,monitor,3249,8000,4751,1,00289,India
319413,2023-03-16,504,iron,449,879,430,1,00289,India
523703,2023-03-16,502,iphone 15 pro max,100000,135000,35000,1,00161,India
523703,2023-03-16,505,oven,18490,24000,5510,1,00161,India
523703,2023-03-16,507,washing machine,6990,16490,9500,1,00161,India
523703,2023-03-16,501,iphone 15,60000,80000,20000,1,00161,India
976946,2023-03-16,503,mixer,1349,3249,1900,1,00426,India
976946,2023-03-16,507,washing machine,6990,16490,9500,1,00426,India
976946,2023-03-16,501,iphone 15,60000,80000,20000,1,00426,India
976946,2023-03-16,505,oven,18490,24000,5510,1,00426,India
445334,2023-03-16,502,iphone 15 pro max,100000,135000,35000,1,00001,India
445334,2023-03-16,503,mixer,1349,3249,1900,1,00001,India
806696,2023-03-16,506,monitor,3249,8000,4751,1,00280,India
806696,2023-03-16,507,washing machine,6990,16490,9500,1,00280,India
806696,2023-03-16,502,iphone 15 pro max,100000,135000,35000,1,00280,India
806696,2023-03-16,505,oven,18490,24000,5510,1,00280,India
806696,2023-03-16,504,iron,449,879,430,1,00280,India
126844,2023-03-16,503,mixer,1349,3249,1900,1,00259,India
126844,2023-03-16,507,washing machine,6990,16490,9500,1,00259,India
126844,2023-03-16,502,iphone 15 pro max,100000,135000,35000,1,00259,India
126844,2023-03-16,504,iron,449,879,430,1,00259,India
972486,2023-03-16,502,iphone 15 pro max,100000,135000,35000,1,00106,India
972486,2023-03-16,505,oven,18490,24000,5510,1,00106,India
972486,2023-03-16,501,iphone 15,60000,80000,20000,1,00106,India
111570,2023-03-16,503,mixer,1349,3249,1900,1,00200,India
111570,2023-03-16,506,monitor,3249,8000,4751,1,00200,India
345869,2023-03-16,504,iron,449,879,430,1,00046,India
807446,2023-03-16,507,washing machine,6990,16490,9500,1,00278,India
807446,2023-03-16,503,mixer,1349,3249,1900,1,00278,India
807446,2023-03-16,505,oven,18490,24000,5510,1,00278,India
223081,2023-03-16,505,oven,18490,24000,5510,1,00228,India
214581,2023-03-16,503,mixer,1349,3249,1900,1,00283,India
214581,2023-03-16,504,iron,449,879,430,1,00283,India
214581,2023-03-16,502,iphone 15 pro max,100000,135000,35000,1,00283,India
684127,2023-03-16,501,iphone 15,60000,80000,20000,1,00207,India
684127,2023-03-16,503,mixer,1349,3249,1900,1,00207,India
798749,2023-03-16,502,iphone 15 pro max,100000,135000,35000,1,00113,India
141544,2023-03-16,506,monitor,3249,8000,4751,1,00064,India
141544,2023-03-16,504,iron,449,879,430,1,00064,India
141544,2023-03-16,503,mixer,1349,3249,1900,1,00064,India
141544,2023-03-16,505,oven,18490,24000,5510,1,00064,India
141544,2023-03-16,507,washing machine,6990,16490,9500,1,00064,India
835344,2023-03-16,503,mixer,1349,3249,1900,1,00217,India
835344,2023-03-16,505,oven,18490,24000,5510,1,00217,India
835344,2023-03-16,502,iphone 15 pro max,100000,135000,35000,1,00217,India
835344,2023-03-16,504,iron,449,879,430,1,00217,India
711199,2023-03-16,504,iron,449,879,430,1,00151,India
711199,2023-03-16,502,iphone 15 pro max,100000,135000,35000,1,00151,India
197990,2023-03-16,504,iron,449,879,430,1,00306,India
197990,2023-03-16,507,washing machine,6990,16490,9500,1,00306,India
972850,2023-03-16,503,mixer,1349,3249,1900,1,00227,India
972850,2023-03-16,501,iphone 15,60000,80000,20000,1,00227,India
476191,2023-03-16,503,mixer,1349,3249,1900,1,00056,India
476191,2023-03-16,506,monitor,3249,8000,4751,1,00056,India
476191,2023-03-16,507,washing machine,6990,16490,9500,1,00056,India
710844,2023-03-16,507,washing machine,6990,16490,9500,1,00401,India
710844,2023-03-16,503,mixer,1349,3249,1900,1,00401,India
710844,2023-03-16,504,iron,449,879,430,1,00401,India
710844,2023-03-16,505,oven,18490,24000,5510,1,00401,India
710844,2023-03-16,502,iphone 15 pro max,100000,135000,35000,1,00401,India
469880,2023-03-16,503,mixer,1349,3249,1900,1,00138,India
496566,2023-03-16,503,mixer,1349,3249,1900,1,00112,India
496566,2023-03-16,501,iphone 15,60000,80000,20000,1,00112,India
496566,2023-03-16,507,washing machine,6990,16490,9500,1,00112,India
496566,2023-03-16,502,iphone 15 pro max,100000,135000,35000,1,00112,India
496566,2023-03-16,505,oven,18490,24000,5510,1,00112,India
947279,2023-03-16,506,monitor,3249,8000,4751,1,00408,India
947279,2023-03-16,501,iphone 15,60000,80000,20000,1,00408,India
947279,2023-03-16,503,mixer,1349,3249,1900,1,00408,India
947279,2023-03-16,502,iphone 15 pro max,100000,135000,35000,1,00408,India
322050,2023-03-16,504,iron,449,879,430,1,00323,India
322050,2023-03-16,501,iphone 15,60000,80000,20000,1,00323,India
150460,2023-03-16,501,iphone 15,60000,80000,20000,1,00006,India
150460,2023-03-16,505,oven,18490,24000,5510,1,00006,India
150460,2023-03-16,502,iphone 15 pro max,100000,135000,35000,1,00006,India
150460,2023-03-16,507,washing machine,6990,16490,9500,1,00006,India
917805,2023-03-16,506,monitor,3249,8000,4751,1,00264,India
460988,2023-03-16,503,mixer,1349,3249,1900,1,00114,India
555755,2023-03-16,504,iron,449,879,430,1,00312,India
248128,2023-03-16,504,iron,449,879,430,1,00118,India
248128,2023-03-16,502,iphone 15 pro max,100000,135000,35000,1,00118,India
961671,2023-03-16,503,mixer,1349,3249,1900,1,00030,India
961671,2023-03-16,501,iphone 15,60000,80000,20000,1,00030,India
961671,2023-03-16,502,iphone 15 pro max,100000,135000,35000,1,00030,India
961671,2023-03-16,507,washing machine,6990,16490,9500,1,00030,India
966308,2023-03-16,507,washing machine,6990,16490,9500,1,00474,India
966308,2023-03-16,505,oven,18490,24000,5510,1,00474,India
162472,2023-03-16,505,oven,18490,24000,5510,1,00456,India
162472,2023-03-16,501,iphone 15,60000,80000,20000,1,00456,India
162472,2023-03-16,507,washing machine,6990,16490,9500,1,00456,India
562511,2023-03-16,501,iphone 15,60000,80000,20000,1,00004,India
562511,2023-03-16,504,iron,449,879,430,1,00004,India
562511,2023-03-16,503,mixer,1349,3249,1900,1,00004,India
784527,2023-03-16,506,monitor,3249,8000,4751,1,00299,India
590827,2023-03-17,504,iron,449,879,430,1,00240,India
590827,2023-03-17,507,washing machine,6990,16490,9500,1,00240,India
590827,2023-03-17,502,iphone 15 pro max,100000,135000,35000,1,00240,India
325464,2023-03-17,502,iphone 15 pro max,100000,135000,35000,1,00127,India
325464,2023-03-17,503,mixer,1349,3249,1900,1,00127,India
325464,2023-03-17,507,washing machine,6990,16490,9500,1,00127,India
994844,2023-03-17,503,mixer,1349,3249,1900,1,00210,India
774278,2023-03-17,501,iphone 15,60000,80000,20000,1,00187,India
128579,2023-03-17,504,iron,449,879,430,1,00152,India
128579,2023-03-17,507,washing machine,6990,16490,9500,1,00152,India
128579,2023-03-17,506,monitor,3249,8000,4751,1,00152,India
941942,2023-03-17,503,mixer,1349,3249,1900,1,00497,India
412858,2023-03-17,507,washing machine,6990,16490,9500,1,00289,India
412858,2023-03-17,506,monitor,3249,8000,4751,1,00289,India
664565,2023-03-17,503,mixer,1349,3249,1900,1,00449,India
138266,2023-03-17,506,monitor,3249,8000,4751,1,00041,India
138266,2023-03-17,507,washing machine,6990,16490,9500,1,00041,India
138266,2023-03-17,503,mixer,1349,3249,1900,1,00041,India
138266,2023-03-17,502,iphone 15 pro max,100000,135000,35000,1,00041,India
705883,2023-03-17,507,washing machine,6990,16490,9500,1,00463,India
585427,2023-03-17,504,iron,449,879,430,1,00199,India
585427,2023-03-17,503,mixer,1349,3249,1900,1,00199,India
585427,2023-03-17,502,iphone 15 pro max,100000,135000,35000,1,00199,India
950549,2023-03-17,507,washing machine,6990,16490,9500,1,00044,India
950549,2023-03-17,501,iphone 15,60000,80000,20000,1,00044,India
911323,2023-03-17,504,iron,449,879,430,1,00487,India
911323,2023-03-17,506,monitor,3249,8000,4751,1,00487,India
911323,2023-03-17,502,iphone 15 pro max,100000,135000,35000,1,00487,India
938610,2023-03-17,501,iphone 15,60000,80000,20000,1,00310,India
967531,2023-03-17,502,iphone 15 pro max,100000,135000,35000,1,00251,India
967531,2023-03-17,507,washing machine,6990,16490,9500,1,00251,India
372480,2023-03-17,503,mixer,1349,3249,1900,1,00328,India
372480,2023-03-17,507,washing machine,6990,16490,9500,1,00328,India
372480,2023-03-17,506,monitor,3249,8000,4751,1,00328,India
273937,2023-03-17,503,mixer,1349,3249,1900,1,00387,India
273937,2023-03-17,504,iron,449,879,430,1,00387,India
750505,2023-03-17,502,iphone 15 pro max,100000,135000,35000,1,00121,India
750505,2023-03-17,505,oven,18490,24000,5510,1,00121,India
750505,2023-03-17,504,iron,449,879,430,1,00121,India
357383,2023-03-17,502,iphone 15 pro max,100000,135000,35000,1,00176,India
357383,2023-03-17,506,monitor,3249,8000,4751,1,00176,India
357383,2023-03-17,501,iphone 15,60000,80000,20000,1,00176,India
357383,2023-03-17,505,oven,18490,24000,5510,1,00176,India
223259,2023-03-17,503,mixer,1349,3249,1900,1,00299,India
902333,2023-03-17,501,iphone 15,60000,80000,20000,1,00126,India
480384,2023-03-17,501,iphone 15,60000,80000,20000,1,00020,India
145327,2023-03-17,507,washing machine,6990,16490,9500,1,00114,India
145327,2023-03-17,502,iphone 15 pro max,100000,135000,35000,1,00114,India
145327,2023-03-17,504,iron,449,879,430,1,00114,India
677232,2023-03-17,506,monitor,3249,8000,4751,1,00428,India
677232,2023-03-17,502,iphone 15 pro max,100000,135000,35000,1,00428,India
791753,2023-03-17,502,iphone 15 pro max,100000,135000,35000,1,00045,India
453731,2023-03-17,502,iphone 15 pro max,100000,135000,35000,1,00495,India
453731,2023-03-17,506,monitor,3249,8000,4751,1,00495,India
453731,2023-03-17,503,mixer,1349,3249,1900,1,00495,India
174529,2023-03-17,506,monitor,3249,8000,4751,1,00306,India
174529,2023-03-17,504,iron,449,879,430,1,00306,India
174529,2023-03-17,507,washing machine,6990,16490,9500,1,00306,India
947620,2023-03-17,506,monitor,3249,8000,4751,1,00055,India
647948,2023-03-17,504,iron,449,879,430,1,00294,India
165358,2023-03-17,505,oven,18490,24000,5510,1,00448,India
590311,2023-03-17,501,iphone 15,60000,80000,20000,1,00482,India
447769,2023-03-17,507,washing machine,6990,16490,9500,1,00351,India
447769,2023-03-17,502,iphone 15 pro max,100000,135000,35000,1,00351,India
447769,2023-03-17,501,iphone 15,60000,80000,20000,1,00351,India
233426,2023-03-17,506,monitor,3249,8000,4751,1,00414,India
233426,2023-03-17,501,iphone 15,60000,80000,20000,1,00414,India
233426,2023-03-17,503,mixer,1349,3249,1900,1,00414,India
384854,2023-03-17,503,mixer,1349,3249,1900,1,00064,India
384854,2023-03-17,501,iphone 15,60000,80000,20000,1,00064,India
384854,2023-03-17,505,oven,18490,24000,5510,1,00064,India
384854,2023-03-17,507,washing machine,6990,16490,9500,1,00064,India
558995,2023-03-17,503,mixer,1349,3249,1900,1,00039,India
558995,2023-03-17,507,washing machine,6990,16490,9500,1,00039,India
135433,2023-03-17,502,iphone 15 pro max,100000,135000,35000,1,00086,India
135433,2023-03-17,504,iron,449,879,430,1,00086,India
135433,2023-03-17,503,mixer,1349,3249,1900,1,00086,India
135433,2023-03-17,507,washing machine,6990,16490,9500,1,00086,India
607986,2023-03-17,501,iphone 15,60000,80000,20000,1,00466,India
607986,2023-03-17,504,iron,449,879,430,1,00466,India
607986,2023-03-17,505,oven,18490,24000,5510,1,00466,India
232386,2023-03-17,507,washing machine,6990,16490,9500,1,00132,India
232386,2023-03-17,503,mixer,1349,3249,1900,1,00132,India
232386,2023-03-17,506,monitor,3249,8000,4751,1,00132,India
413411,2023-03-17,501,iphone 15,60000,80000,20000,1,00307,India
413411,2023-03-17,506,monitor,3249,8000,4751,1,00307,India
974068,2023-03-17,503,mixer,1349,3249,1900,1,00291,India
974068,2023-03-17,507,washing machine,6990,16490,9500,1,00291,India
974068,2023-03-17,502,iphone 15 pro max,100000,135000,35000,1,00291,India
974068,2023-03-17,504,iron,449,879,430,1,00291,India
148049,2023-03-17,501,iphone 15,60000,80000,20000,1,00064,India
148049,2023-03-17,503,mixer,1349,3249,1900,1,00064,India
128680,2023-03-17,502,iphone 15 pro max,100000,135000,35000,1,00138,India
128680,2023-03-17,504,iron,449,879,430,1,00138,India
128680,2023-03-17,503,mixer,1349,3249,1900,1,00138,India
128680,2023-03-17,501,iphone 15,60000,80000,20000,1,00138,India
971416,2023-03-17,504,iron,449,879,430,1,00179,India
971416,2023-03-17,501,iphone 15,60000,80000,20000,1,00179,India
971416,2023-03-17,502,iphone 15 pro max,100000,135000,35000,1,00179,India
971416,2023-03-17,503,mixer,1349,3249,1900,1,00179,India
971416,2023-03-17,505,oven,18490,24000,5510,1,00179,India
998228,2023-03-17,506,monitor,3249,8000,4751,1,00156,India
998228,2023-03-17,504,iron,449,879,430,1,00156,India
998228,2023-03-17,507,washing machine,6990,16490,9500,1,00156,India
998228,2023-03-17,501,iphone 15,60000,80000,20000,1,00156,India
365447,2023-03-17,503,mixer,1349,3249,1900,1,00397,India
365447,2023-03-17,501,iphone 15,60000,80000,20000,1,00397,India
205742,2023-03-17,506,monitor,3249,8000,4751,1,00218,India
597929,2023-03-17,504,iron,449,879,430,1,00113,India
597929,2023-03-17,506,monitor,3249,8000,4751,1,00113,India
597929,2023-03-17,501,iphone 15,60000,80000,20000,1,00113,India
597929,2023-03-17,503,mixer,1349,3249,1900,1,00113,India
239478,2023-03-17,501,iphone 15,60000,80000,20000,1,00207,India
239478,2023-03-17,505,oven,18490,24000,5510,1,00207,India
239478,2023-03-17,504,iron,449,879,430,1,00207,India
711605,2023-03-17,501,iphone 15,60000,80000,20000,1,00139,India
711605,2023-03-17,504,iron,449,879,430,1,00139,India
711605,2023-03-17,507,washing machine,6990,16490,9500,1,00139,India
633395,2023-03-17,502,iphone 15 pro max,100000,135000,35000,1,00271,India
676579,2023-03-17,504,iron,449,879,430,1,00382,India
131580,2023-03-17,505,oven,18490,24000,5510,1,00240,India
131580,2023-03-17,506,monitor,3249,8000,4751,1,00240,India
131580,2023-03-17,507,washing machine,6990,16490,9500,1,00240,India
131580,2023-03-17,502,iphone 15 pro max,100000,135000,35000,1,00240,India
472995,2023-03-17,503,mixer,1349,3249,1900,1,00069,India
472995,2023-03-17,501,iphone 15,60000,80000,20000,1,00069,India
472995,2023-03-17,505,oven,18490,24000,5510,1,00069,India
697022,2023-03-17,503,mixer,1349,3249,1900,1,00164,India
697022,2023-03-17,504,iron,449,879,430,1,00164,India
926072,2023-03-17,506,monitor,3249,8000,4751,1,00126,India
926072,2023-03-17,503,mixer,1349,3249,1900,1,00126,India
926072,2023-03-17,507,washing machine,6990,16490,9500,1,00126,India
613429,2023-03-17,502,iphone 15 pro max,100000,135000,35000,1,00136,India
613429,2023-03-17,506,monitor,3249,8000,4751,1,00136,India
613429,2023-03-17,504,iron,449,879,430,1,00136,India
613429,2023-03-17,503,mixer,1349,3249,1900,1,00136,India
106563,2023-03-17,505,oven,18490,24000,5510,1,00444,India
106563,2023-03-17,501,iphone 15,60000,80000,20000,1,00444,India
860703,2023-03-17,501,iphone 15,60000,80000,20000,1,00312,India
860703,2023-03-17,502,iphone 15 pro max,100000,135000,35000,1,00312,India
837468,2023-03-17,505,oven,18490,24000,5510,1,00492,India
837468,2023-03-17,504,iron,449,879,430,1,00492,India
665517,2023-03-17,502,iphone 15 pro max,100000,135000,35000,1,00460,India
665517,2023-03-17,505,oven,18490,24000,5510,1,00460,India
665517,2023-03-17,504,iron,449,879,430,1,00460,India
803296,2023-03-17,506,monitor,3249,8000,4751,1,00228,India
803296,2023-03-17,504,iron,449,879,430,1,00228,India
803296,2023-03-17,507,washing machine,6990,16490,9500,1,00228,India
205665,2023-03-17,504,iron,449,879,430,1,00206,India
205665,2023-03-17,505,oven,18490,24000,5510,1,00206,India
302517,2023-03-17,502,iphone 15 pro max,100000,135000,35000,1,00086,India
857900,2023-03-17,505,oven,18490,24000,5510,1,00070,India
991755,2023-03-17,502,iphone 15 pro max,100000,135000,35000,1,00093,India
991755,2023-03-17,507,washing machine,6990,16490,9500,1,00093,India
564186,2023-03-17,506,monitor,3249,8000,4751,1,00350,India
564186,2023-03-17,502,iphone 15 pro max,100000,135000,35000,1,00350,India
945729,2023-03-17,501,iphone 15,60000,80000,20000,1,00457,India
945729,2023-03-17,505,oven,18490,24000,5510,1,00457,India
514777,2023-03-17,503,mixer,1349,3249,1900,1,00165,India
276077,2023-03-18,504,iron,449,879,430,1,00228,India
276077,2023-03-18,505,oven,18490,24000,5510,1,00228,India
276077,2023-03-18,501,iphone 15,60000,80000,20000,1,00228,India
375396,2023-03-18,506,monitor,3249,8000,4751,1,00215,India
375396,2023-03-18,505,oven,18490,24000,5510,1,00215,India
319737,2023-03-18,505,oven,18490,24000,5510,1,00191,India
319737,2023-03-18,506,monitor,3249,8000,4751,1,00191,India
319737,2023-03-18,503,mixer,1349,3249,1900,1,00191,India
111628,2023-03-18,504,iron,449,879,430,1,00418,India
111628,2023-03-18,502,iphone 15 pro max,100000,135000,35000,1,00418,India
111628,2023-03-18,506,monitor,3249,8000,4751,1,00418,India
478763,2023-03-18,504,iron,449,879,430,1,00446,India
478763,2023-03-18,506,monitor,3249,8000,4751,1,00446,India
478763,2023-03-18,507,washing machine,6990,16490,9500,1,00446,India
155812,2023-03-18,507,washing machine,6990,16490,9500,1,00303,India
155812,2023-03-18,504,iron,449,879,430,1,00303,India
488261,2023-03-18,502,iphone 15 pro max,100000,135000,35000,1,00236,India
488261,2023-03-18,507,washing machine,6990,16490,9500,1,00236,India
927091,2023-03-18,505,oven,18490,24000,5510,1,00013,India
927091,2023-03-18,504,iron,449,879,430,1,00013,India
419322,2023-03-18,501,iphone 15,60000,80000,20000,1,00264,India
419322,2023-03-18,507,washing machine,6990,16490,9500,1,00264,India
419322,2023-03-18,503,mixer,1349,3249,1900,1,00264,India
851225,2023-03-18,502,iphone 15 pro max,100000,135000,35000,1,00032,India
851225,2023-03-18,501,iphone 15,60000,80000,20000,1,00032,India
851225,2023-03-18,504,iron,449,879,430,1,00032,India
851225,2023-03-18,507,washing machine,6990,16490,9500,1,00032,India
851225,2023-03-18,505,oven,18490,24000,5510,1,00032,India
749093,2023-03-18,503,mixer,1349,3249,1900,1,00493,India
749093,2023-03-18,506,monitor,3249,8000,4751,1,00493,India
749093,2023-03-18,505,oven,18490,24000,5510,1,00493,India
845748,2023-03-18,505,oven,18490,24000,5510,1,00426,India
845748,2023-03-18,503,mixer,1349,3249,1900,1,00426,India
845748,2023-03-18,502,iphone 15 pro max,100000,135000,35000,1,00426,India
569331,2023-03-18,506,monitor,3249,8000,4751,1,00147,India
569331,2023-03-18,502,iphone 15 pro max,100000,135000,35000,1,00147,India
569331,2023-03-18,501,iphone 15,60000,80000,20000,1,00147,India
401280,2023-03-18,501,iphone 15,60000,80000,20000,1,00193,India
401280,2023-03-18,506,monitor,3249,8000,4751,1,00193,India
221859,2023-03-18,505,oven,18490,24000,5510,1,00062,India
661399,2023-03-18,505,oven,18490,24000,5510,1,00034,India
661399,2023-03-18,502,iphone 15 pro max,100000,135000,35000,1,00034,India
661399,2023-03-18,506,monitor,3249,8000,4751,1,00034,India
661399,2023-03-18,501,iphone 15,60000,80000,20000,1,00034,India
918244,2023-03-18,501,iphone 15,60000,80000,20000,1,00394,India
918244,2023-03-18,503,mixer,1349,3249,1900,1,00394,India
513159,2023-03-18,506,monitor,3249,8000,4751,1,00116,India
513159,2023-03-18,504,iron,449,879,430,1,00116,India
513159,2023-03-18,501,iphone 15,60000,80000,20000,1,00116,India
413289,2023-03-18,501,iphone 15,60000,80000,20000,1,00422,India
415317,2023-03-18,506,monitor,3249,8000,4751,1,00459,India
865158,2023-03-18,501,iphone 15,60000,80000,20000,1,00346,India
865158,2023-03-18,507,washing machine,6990,16490,9500,1,00346,India
865158,2023-03-18,504,iron,449,879,430,1,00346,India
865158,2023-03-18,503,mixer,1349,3249,1900,1,00346,India
214497,2023-03-18,507,washing machine,6990,16490,9500,1,00237,India
214497,2023-03-18,506,monitor,3249,8000,4751,1,00237,India
214497,2023-03-18,504,iron,449,879,430,1,00237,India
469434,2023-03-18,503,mixer,1349,3249,1900,1,00018,India
469434,2023-03-18,502,iphone 15 pro max,100000,135000,35000,1,00018,India
469434,2023-03-18,505,oven,18490,24000,5510,1,00018,India
209750,2023-03-18,503,mixer,1349,3249,1900,1,00023,India
209750,2023-03-18,501,iphone 15,60000,80000,20000,1,00023,India
209750,2023-03-18,505,oven,18490,24000,5510,1,00023,India
267117,2023-03-18,503,mixer,1349,3249,1900,1,00326,India
267117,2023-03-18,504,iron,449,879,430,1,00326,India
267117,2023-03-18,505,oven,18490,24000,5510,1,00326,India
954812,2023-03-18,505,oven,18490,24000,5510,1,00351,India
954812,2023-03-18,506,monitor,3249,8000,4751,1,00351,India
954812,2023-03-18,503,mixer,1349,3249,1900,1,00351,India
954812,2023-03-18,501,iphone 15,60000,80000,20000,1,00351,India
890988,2023-03-18,506,monitor,3249,8000,4751,1,00047,India
555529,2023-03-18,506,monitor,3249,8000,4751,1,00357,India
374221,2023-03-18,504,iron,449,879,430,1,00079,India
374221,2023-03-18,502,iphone 15 pro max,100000,135000,35000,1,00079,India
374221,2023-03-18,505,oven,18490,24000,5510,1,00079,India
618688,2023-03-18,503,mixer,1349,3249,1900,1,00312,India
618688,2023-03-18,507,washing machine,6990,16490,9500,1,00312,India
618688,2023-03-18,504,iron,449,879,430,1,00312,India
978729,2023-03-18,504,iron,449,879,430,1,00020,India
978729,2023-03-18,503,mixer,1349,3249,1900,1,00020,India
978729,2023-03-18,502,iphone 15 pro max,100000,135000,35000,1,00020,India
978729,2023-03-18,507,washing machine,6990,16490,9500,1,00020,India
897763,2023-03-18,507,washing machine,6990,16490,9500,1,00309,India
897763,2023-03-18,504,iron,449,879,430,1,00309,India
921126,2023-03-18,505,oven,18490,24000,5510,1,00384,India
921126,2023-03-18,506,monitor,3249,8000,4751,1,00384,India
921126,2023-03-18,502,iphone 15 pro max,100000,135000,35000,1,00384,India
830537,2023-03-18,501,iphone 15,60000,80000,20000,1,00293,India
830537,2023-03-18,502,iphone 15 pro max,100000,135000,35000,1,00293,India
604880,2023-03-18,502,iphone 15 pro max,100000,135000,35000,1,00309,India
604880,2023-03-18,506,monitor,3249,8000,4751,1,00309,India
940304,2023-03-18,503,mixer,1349,3249,1900,1,00227,India
596736,2023-03-18,507,washing machine,6990,16490,9500,1,00006,India
804996,2023-03-18,502,iphone 15 pro max,100000,135000,35000,1,00497,India
804996,2023-03-18,507,washing machine,6990,16490,9500,1,00497,India
804996,2023-03-18,503,mixer,1349,3249,1900,1,00497,India
406025,2023-03-18,502,iphone 15 pro max,100000,135000,35000,1,00220,India
406025,2023-03-18,507,washing machine,6990,16490,9500,1,00220,India
406025,2023-03-18,503,mixer,1349,3249,1900,1,00220,India
406025,2023-03-18,504,iron,449,879,430,1,00220,India
904171,2023-03-18,502,iphone 15 pro max,100000,135000,35000,1,00245,India
904171,2023-03-18,505,oven,18490,24000,5510,1,00245,India
904171,2023-03-18,507,washing machine,6990,16490,9500,1,00245,India
262683,2023-03-18,502,iphone 15 pro max,100000,135000,35000,1,00030,India
262683,2023-03-18,503,mixer,1349,3249,1900,1,00030,India
262683,2023-03-18,505,oven,18490,24000,5510,1,00030,India
262683,2023-03-18,501,iphone 15,60000,80000,20000,1,00030,India
827771,2023-03-18,505,oven,18490,24000,5510,1,00228,India
827771,2023-03-18,506,monitor,3249,8000,4751,1,00228,India
827771,2023-03-18,507,washing machine,6990,16490,9500,1,00228,India
827771,2023-03-18,502,iphone 15 pro max,100000,135000,35000,1,00228,India
827771,2023-03-18,501,iphone 15,60000,80000,20000,1,00228,India
228568,2023-03-18,507,washing machine,6990,16490,9500,1,00133,India
413868,2023-03-18,502,iphone 15 pro max,100000,135000,35000,1,00363,India
413868,2023-03-18,503,mixer,1349,3249,1900,1,00363,India
413868,2023-03-18,507,washing machine,6990,16490,9500,1,00363,India
413868,2023-03-18,506,monitor,3249,8000,4751,1,00363,India
399351,2023-03-18,501,iphone 15,60000,80000,20000,1,00392,India
399351,2023-03-18,504,iron,449,879,430,1,00392,India
399351,2023-03-18,506,monitor,3249,8000,4751,1,00392,India
557663,2023-03-18,505,oven,18490,24000,5510,1,00470,India
557663,2023-03-18,507,washing machine,6990,16490,9500,1,00470,India
557663,2023-03-18,502,iphone 15 pro max,100000,135000,35000,1,00470,India
744653,2023-03-18,502,iphone 15 pro max,100000,135000,35000,1,00064,India
744653,2023-03-18,506,monitor,3249,8000,4751,1,00064,India
744653,2023-03-18,503,mixer,1349,3249,1900,1,00064,India
331456,2023-03-18,502,iphone 15 pro max,100000,135000,35000,1,00265,India
865191,2023-03-18,501,iphone 15,60000,80000,20000,1,00448,India
865191,2023-03-18,504,iron,449,879,430,1,00448,India
865191,2023-03-18,507,washing machine,6990,16490,9500,1,00448,India
740915,2023-03-18,502,iphone 15 pro max,100000,135000,35000,1,00165,India
740915,2023-03-18,505,oven,18490,24000,5510,1,00165,India
740915,2023-03-18,506,monitor,3249,8000,4751,1,00165,India
740915,2023-03-18,503,mixer,1349,3249,1900,1,00165,India
740915,2023-03-18,507,washing machine,6990,16490,9500,1,00165,India
654011,2023-03-18,504,iron,449,879,430,1,00039,India
654011,2023-03-18,507,washing machine,6990,16490,9500,1,00039,India
654011,2023-03-18,506,monitor,3249,8000,4751,1,00039,India
728241,2023-03-18,504,iron,449,879,430,1,00127,India
728241,2023-03-18,505,oven,18490,24000,5510,1,00127,India
728241,2023-03-18,503,mixer,1349,3249,1900,1,00127,India
973760,2023-03-19,502,iphone 15 pro max,100000,135000,35000,1,00146,India
973760,2023-03-19,504,iron,449,879,430,1,00146,India
721654,2023-03-19,503,mixer,1349,3249,1900,1,00107,India
721654,2023-03-19,501,iphone 15,60000,80000,20000,1,00107,India
174727,2023-03-19,505,oven,18490,24000,5510,1,00150,India
174727,2023-03-19,503,mixer,1349,3249,1900,1,00150,India
174727,2023-03-19,506,monitor,3249,8000,4751,1,00150,India
715834,2023-03-19,506,monitor,3249,8000,4751,1,00277,India
715834,2023-03-19,503,mixer,1349,3249,1900,1,00277,India
715834,2023-03-19,502,iphone 15 pro max,100000,135000,35000,1,00277,India
715834,2023-03-19,504,iron,449,879,430,1,00277,India
319744,2023-03-19,505,oven,18490,24000,5510,1,00272,India
618597,2023-03-19,501,iphone 15,60000,80000,20000,1,00058,India
618597,2023-03-19,507,washing machine,6990,16490,9500,1,00058,India
618597,2023-03-19,506,monitor,3249,8000,4751,1,00058,India
183105,2023-03-19,501,iphone 15,60000,80000,20000,1,00069,India
173479,2023-03-19,503,mixer,1349,3249,1900,1,00074,India
375083,2023-03-19,502,iphone 15 pro max,100000,135000,35000,1,00305,India
375083,2023-03-19,507,washing machine,6990,16490,9500,1,00305,India
996215,2023-03-19,503,mixer,1349,3249,1900,1,00082,India
996215,2023-03-19,507,washing machine,6990,16490,9500,1,00082,India
996215,2023-03-19,502,iphone 15 pro max,100000,135000,35000,1,00082,India
996215,2023-03-19,504,iron,449,879,430,1,00082,India
689603,2023-03-19,506,monitor,3249,8000,4751,1,00232,India
689603,2023-03-19,504,iron,449,879,430,1,00232,India
525294,2023-03-19,503,mixer,1349,3249,1900,1,00424,India
525294,2023-03-19,506,monitor,3249,8000,4751,1,00424,India
525294,2023-03-19,502,iphone 15 pro max,100000,135000,35000,1,00424,India
525294,2023-03-19,504,iron,449,879,430,1,00424,India
597315,2023-03-19,503,mixer,1349,3249,1900,1,00321,India
597315,2023-03-19,507,washing machine,6990,16490,9500,1,00321,India
304203,2023-03-19,506,monitor,3249,8000,4751,1,00474,India
304203,2023-03-19,507,washing machine,6990,16490,9500,1,00474,India
304203,2023-03-19,503,mixer,1349,3249,1900,1,00474,India
304203,2023-03-19,504,iron,449,879,430,1,00474,India
304203,2023-03-19,505,oven,18490,24000,5510,1,00474,India
717920,2023-03-19,501,iphone 15,60000,80000,20000,1,00113,India
717920,2023-03-19,505,oven,18490,24000,5510,1,00113,India
717920,2023-03-19,507,washing machine,6990,16490,9500,1,00113,India
717920,2023-03-19,504,iron,449,879,430,1,00113,India
193709,2023-03-19,506,monitor,3249,8000,4751,1,00348,India
966489,2023-03-19,501,iphone 15,60000,80000,20000,1,00302,India
966489,2023-03-19,502,iphone 15 pro max,100000,135000,35000,1,00302,India
966489,2023-03-19,507,washing machine,6990,16490,9500,1,00302,India
966489,2023-03-19,503,mixer,1349,3249,1900,1,00302,India
425128,2023-03-19,505,oven,18490,24000,5510,1,00003,India
425128,2023-03-19,502,iphone 15 pro max,100000,135000,35000,1,00003,India
425128,2023-03-19,503,mixer,1349,3249,1900,1,00003,India
425128,2023-03-19,507,washing machine,6990,16490,9500,1,00003,India
632839,2023-03-19,503,mixer,1349,3249,1900,1,00250,India
632839,2023-03-19,502,iphone 15 pro max,100000,135000,35000,1,00250,India
632839,2023-03-19,506,monitor,3249,8000,4751,1,00250,India
505634,2023-03-19,505,oven,18490,24000,5510,1,00071,India
505634,2023-03-19,503,mixer,1349,3249,1900,1,00071,India
505634,2023-03-19,504,iron,449,879,430,1,00071,India
505634,2023-03-19,502,iphone 15 pro max,100000,135000,35000,1,00071,India
244193,2023-03-19,502,iphone 15 pro max,100000,135000,35000,1,00182,India
491277,2023-03-19,503,mixer,1349,3249,1900,1,00348,India
491277,2023-03-19,504,iron,449,879,430,1,00348,India
491277,2023-03-19,507,washing machine,6990,16490,9500,1,00348,India
491277,2023-03-19,506,monitor,3249,8000,4751,1,00348,India
743634,2023-03-19,504,iron,449,879,430,1,00471,India
743634,2023-03-19,502,iphone 15 pro max,100000,135000,35000,1,00471,India
743634,2023-03-19,501,iphone 15,60000,80000,20000,1,00471,India
743634,2023-03-19,506,monitor,3249,8000,4751,1,00471,India
435753,2023-03-19,501,iphone 15,60000,80000,20000,1,00023,India
435753,2023-03-19,503,mixer,1349,3249,1900,1,00023,India
435753,2023-03-19,507,washing machine,6990,16490,9500,1,00023,India
435753,2023-03-19,502,iphone 15 pro max,100000,135000,35000,1,00023,India
666885,2023-03-19,507,washing machine,6990,16490,9500,1,00457,India
666885,2023-03-19,505,oven,18490,24000,5510,1,00457,India
626864,2023-03-19,501,iphone 15,60000,80000,20000,1,00064,India
626864,2023-03-19,505,oven,18490,24000,5510,1,00064,India
626864,2023-03-19,503,mixer,1349,3249,1900,1,00064,India
248742,2023-03-19,502,iphone 15 pro max,100000,135000,35000,1,00407,India
248742,2023-03-19,505,oven,18490,24000,5510,1,00407,India
248742,2023-03-19,504,iron,449,879,430,1,00407,India
162003,2023-03-19,502,iphone 15 pro max,100000,135000,35000,1,00483,India
162003,2023-03-19,501,iphone 15,60000,80000,20000,1,00483,India
334858,2023-03-19,506,monitor,3249,8000,4751,1,00408,India
334858,2023-03-19,504,iron,449,879,430,1,00408,India
334858,2023-03-19,505,oven,18490,24000,5510,1,00408,India
923752,2023-03-19,507,washing machine,6990,16490,9500,1,00168,India
707840,2023-03-19,506,monitor,3249,8000,4751,1,00020,India
707840,2023-03-19,501,iphone 15,60000,80000,20000,1,00020,India
707840,2023-03-19,504,iron,449,879,430,1,00020,India
249891,2023-03-19,503,mixer,1349,3249,1900,1,00085,India
249891,2023-03-19,504,iron,449,879,430,1,00085,India
144468,2023-03-19,504,iron,449,879,430,1,00113,India
144468,2023-03-19,507,washing machine,6990,16490,9500,1,00113,India
144468,2023-03-19,506,monitor,3249,8000,4751,1,00113,India
144468,2023-03-19,502,iphone 15 pro max,100000,135000,35000,1,00113,India
394417,2023-03-19,507,washing machine,6990,16490,9500,1,00361,India
394417,2023-03-19,502,iphone 15 pro max,100000,135000,35000,1,00361,India
337913,2023-03-19,505,oven,18490,24000,5510,1,00244,India
711488,2023-03-19,504,iron,449,879,430,1,00484,India
711488,2023-03-19,505,oven,18490,24000,5510,1,00484,India
244852,2023-03-19,501,iphone 15,60000,80000,20000,1,00093,India
244852,2023-03-19,504,iron,449,879,430,1,00093,India
444994,2023-03-19,501,iphone 15,60000,80000,20000,1,00437,India
161426,2023-03-19,504,iron,449,879,430,1,00333,India
513891,2023-03-19,504,iron,449,879,430,1,00380,India
513891,2023-03-19,502,iphone 15 pro max,100000,135000,35000,1,00380,India
513891,2023-03-19,507,washing machine,6990,16490,9500,1,00380,India
789246,2023-03-19,506,monitor,3249,8000,4751,1,00387,India
789246,2023-03-19,507,washing machine,6990,16490,9500,1,00387,India
789246,2023-03-19,501,iphone 15,60000,80000,20000,1,00387,India
789246,2023-03-19,505,oven,18490,24000,5510,1,00387,India
819107,2023-03-19,502,iphone 15 pro max,100000,135000,35000,1,00010,India
819107,2023-03-19,506,monitor,3249,8000,4751,1,00010,India
819107,2023-03-19,504,iron,449,879,430,1,00010,India
819107,2023-03-19,505,oven,18490,24000,5510,1,00010,India
819107,2023-03-19,503,mixer,1349,3249,1900,1,00010,India
340930,2023-03-19,507,washing machine,6990,16490,9500,1,00360,India
340930,2023-03-19,504,iron,449,879,430,1,00360,India
340930,2023-03-19,506,monitor,3249,8000,4751,1,00360,India
340930,2023-03-19,503,mixer,1349,3249,1900,1,00360,India
941704,2023-03-19,504,iron,449,879,430,1,00166,India
911788,2023-03-19,501,iphone 15,60000,80000,20000,1,00021,India
911788,2023-03-19,505,oven,18490,24000,5510,1,00021,India
602090,2023-03-19,503,mixer,1349,3249,1900,1,00242,India
602090,2023-03-19,506,monitor,3249,8000,4751,1,00242,India
602090,2023-03-19,502,iphone 15 pro max,100000,135000,35000,1,00242,India
602090,2023-03-19,505,oven,18490,24000,5510,1,00242,India
212419,2023-03-19,503,mixer,1349,3249,1900,1,00402,India
212419,2023-03-19,507,washing machine,6990,16490,9500,1,00402,India
212419,2023-03-19,502,iphone 15 pro max,100000,135000,35000,1,00402,India
481053,2023-03-19,505,oven,18490,24000,5510,1,00268,India
245276,2023-03-19,507,washing machine,6990,16490,9500,1,00273,India
245276,2023-03-19,506,monitor,3249,8000,4751,1,00273,India
245276,2023-03-19,505,oven,18490,24000,5510,1,00273,India
685385,2023-03-19,506,monitor,3249,8000,4751,1,00392,India
685385,2023-03-19,501,iphone 15,60000,80000,20000,1,00392,India
685385,2023-03-19,502,iphone 15 pro max,100000,135000,35000,1,00392,India
685385,2023-03-19,505,oven,18490,24000,5510,1,00392,India
430339,2023-03-19,506,monitor,3249,8000,4751,1,00292,India
430339,2023-03-19,502,iphone 15 pro max,100000,135000,35000,1,00292,India
430339,2023-03-19,507,washing machine,6990,16490,9500,1,00292,India
430339,2023-03-19,505,oven,18490,24000,5510,1,00292,India
954943,2023-03-19,501,iphone 15,60000,80000,20000,1,00335,India
954943,2023-03-19,502,iphone 15 pro max,100000,135000,35000,1,00335,India
954943,2023-03-19,506,monitor,3249,8000,4751,1,00335,India
938783,2023-03-19,502,iphone 15 pro max,100000,135000,35000,1,00186,India
938783,2023-03-19,503,mixer,1349,3249,1900,1,00186,India
938783,2023-03-19,505,oven,18490,24000,5510,1,00186,India
988165,2023-03-19,504,iron,449,879,430,1,00393,India
988165,2023-03-19,503,mixer,1349,3249,1900,1,00393,India
988165,2023-03-19,501,iphone 15,60000,80000,20000,1,00393,India
988165,2023-03-19,507,washing machine,6990,16490,9500,1,00393,India
252148,2023-03-19,504,iron,449,879,430,1,00344,India
836238,2023-03-19,507,washing machine,6990,16490,9500,1,00187,India
285990,2023-03-19,504,iron,449,879,430,1,00427,India
709117,2023-03-19,504,iron,449,879,430,1,00134,India
388164,2023-03-19,507,washing machine,6990,16490,9500,1,00147,India
152778,2023-03-19,502,iphone 15 pro max,100000,135000,35000,1,00413,India
152778,2023-03-19,507,washing machine,6990,16490,9500,1,00413,India
152778,2023-03-19,503,mixer,1349,3249,1900,1,00413,India
510810,2023-03-19,505,oven,18490,24000,5510,1,00105,India
510810,2023-03-19,506,monitor,3249,8000,4751,1,00105,India
510810,2023-03-19,502,iphone 15 pro max,100000,135000,35000,1,00105,India
483906,2023-03-19,504,iron,449,879,430,1,00457,India
483906,2023-03-19,503,mixer,1349,3249,1900,1,00457,India
483906,2023-03-19,501,iphone 15,60000,80000,20000,1,00457,India
983517,2023-03-19,507,washing machine,6990,16490,9500,1,00106,India
983517,2023-03-19,504,iron,449,879,430,1,00106,India
706814,2023-03-19,504,iron,449,879,430,1,00385,India
706814,2023-03-19,505,oven,18490,24000,5510,1,00385,India
706814,2023-03-19,503,mixer,1349,3249,1900,1,00385,India
237703,2023-03-19,507,washing machine,6990,16490,9500,1,00199,India
847802,2023-03-19,505,oven,18490,24000,5510,1,00405,India
847802,2023-03-19,506,monitor,3249,8000,4751,1,00405,India
794401,2023-03-19,505,oven,18490,24000,5510,1,00418,India
794401,2023-03-19,506,monitor,3249,8000,4751,1,00418,India
118489,2023-03-20,505,oven,18490,24000,5510,1,00049,India
732044,2023-03-20,501,iphone 15,60000,80000,20000,1,00485,India
732044,2023-03-20,504,iron,449,879,430,1,00485,India
103760,2023-03-20,505,oven,18490,24000,5510,1,00199,India
103760,2023-03-20,504,iron,449,879,430,1,00199,India
103760,2023-03-20,507,washing machine,6990,16490,9500,1,00199,India
263460,2023-03-20,503,mixer,1349,3249,1900,1,00174,India
263460,2023-03-20,504,iron,449,879,430,1,00174,India
357452,2023-03-20,505,oven,18490,24000,5510,1,00332,India
357452,2023-03-20,502,iphone 15 pro max,100000,135000,35000,1,00332,India
357452,2023-03-20,501,iphone 15,60000,80000,20000,1,00332,India
136096,2023-03-20,503,mixer,1349,3249,1900,1,00210,India
136096,2023-03-20,504,iron,449,879,430,1,00210,India
275811,2023-03-20,507,washing machine,6990,16490,9500,1,00011,India
275811,2023-03-20,502,iphone 15 pro max,100000,135000,35000,1,00011,India
859830,2023-03-20,504,iron,449,879,430,1,00332,India
859830,2023-03-20,505,oven,18490,24000,5510,1,00332,India
984545,2023-03-20,506,monitor,3249,8000,4751,1,00218,India
984545,2023-03-20,504,iron,449,879,430,1,00218,India
984545,2023-03-20,507,washing machine,6990,16490,9500,1,00218,India
984545,2023-03-20,503,mixer,1349,3249,1900,1,00218,India
554999,2023-03-20,505,oven,18490,24000,5510,1,00277,India
554999,2023-03-20,506,monitor,3249,8000,4751,1,00277,India
187686,2023-03-20,501,iphone 15,60000,80000,20000,1,00470,India
546205,2023-03-20,501,iphone 15,60000,80000,20000,1,00418,India
546205,2023-03-20,504,iron,449,879,430,1,00418,India
399715,2023-03-20,507,washing machine,6990,16490,9500,1,00004,India
399715,2023-03-20,505,oven,18490,24000,5510,1,00004,India
237482,2023-03-20,507,washing machine,6990,16490,9500,1,00485,India
237482,2023-03-20,503,mixer,1349,3249,1900,1,00485,India
851228,2023-03-20,504,iron,449,879,430,1,00031,India
624142,2023-03-20,503,mixer,1349,3249,1900,1,00404,India
624142,2023-03-20,504,iron,449,879,430,1,00404,India
624142,2023-03-20,502,iphone 15 pro max,100000,135000,35000,1,00404,India
624142,2023-03-20,507,washing machine,6990,16490,9500,1,00404,India
333075,2023-03-20,503,mixer,1349,3249,1900,1,00235,India
333075,2023-03-20,501,iphone 15,60000,80000,20000,1,00235,India
333075,2023-03-20,502,iphone 15 pro max,100000,135000,35000,1,00235,India
847774,2023-03-20,501,iphone 15,60000,80000,20000,1,00469,India
847774,2023-03-20,505,oven,18490,24000,5510,1,00469,India
644010,2023-03-20,504,iron,449,879,430,1,00073,India
644010,2023-03-20,506,monitor,3249,8000,4751,1,00073,India
644010,2023-03-20,501,iphone 15,60000,80000,20000,1,00073,India
644010,2023-03-20,507,washing machine,6990,16490,9500,1,00073,India
968034,2023-03-20,505,oven,18490,24000,5510,1,00252,India
267002,2023-03-20,502,iphone 15 pro max,100000,135000,35000,1,00033,India
267002,2023-03-20,504,iron,449,879,430,1,00033,India
267002,2023-03-20,505,oven,18490,24000,5510,1,00033,India
324646,2023-03-20,505,oven,18490,24000,5510,1,00171,India
324646,2023-03-20,504,iron,449,879,430,1,00171,India
324646,2023-03-20,503,mixer,1349,3249,1900,1,00171,India
303164,2023-03-20,505,oven,18490,24000,5510,1,00293,India
303164,2023-03-20,503,mixer,1349,3249,1900,1,00293,India
288060,2023-03-20,504,iron,449,879,430,1,00278,India
288060,2023-03-20,505,oven,18490,24000,5510,1,00278,India
568081,2023-03-20,505,oven,18490,24000,5510,1,00023,India
568081,2023-03-20,501,iphone 15,60000,80000,20000,1,00023,India
568081,2023-03-20,504,iron,449,879,430,1,00023,India
568081,2023-03-20,502,iphone 15 pro max,100000,135000,35000,1,00023,India
736389,2023-03-20,506,monitor,3249,8000,4751,1,00002,India
736389,2023-03-20,505,oven,18490,24000,5510,1,00002,India
773647,2023-03-20,501,iphone 15,60000,80000,20000,1,00311,India
773647,2023-03-20,502,iphone 15 pro max,100000,135000,35000,1,00311,India
773647,2023-03-20,504,iron,449,879,430,1,00311,India
773647,2023-03-20,506,monitor,3249,8000,4751,1,00311,India
397480,2023-03-20,505,oven,18490,24000,5510,1,00395,India
397480,2023-03-20,504,iron,449,879,430,1,00395,India
397480,2023-03-20,502,iphone 15 pro max,100000,135000,35000,1,00395,India
397480,2023-03-20,506,monitor,3249,8000,4751,1,00395,India
343172,2023-03-20,502,iphone 15 pro max,100000,135000,35000,1,00106,India
343172,2023-03-20,504,iron,449,879,430,1,00106,India
343172,2023-03-20,506,monitor,3249,8000,4751,1,00106,India
787785,2023-03-20,501,iphone 15,60000,80000,20000,1,00139,India
787785,2023-03-20,506,monitor,3249,8000,4751,1,00139,India
787785,2023-03-20,502,iphone 15 pro max,100000,135000,35000,1,00139,India
787785,2023-03-20,507,washing machine,6990,16490,9500,1,00139,India
759074,2023-03-20,507,washing machine,6990,16490,9500,1,00368,India
759074,2023-03-20,506,monitor,3249,8000,4751,1,00368,India
759074,2023-03-20,504,iron,449,879,430,1,00368,India
728888,2023-03-20,504,iron,449,879,430,1,00150,India
369850,2023-03-20,502,iphone 15 pro max,100000,135000,35000,1,00186,India
369850,2023-03-20,501,iphone 15,60000,80000,20000,1,00186,India
369850,2023-03-20,506,monitor,3249,8000,4751,1,00186,India
974819,2023-03-20,501,iphone 15,60000,80000,20000,1,00243,India
264584,2023-03-20,505,oven,18490,24000,5510,1,00353,India
560763,2023-03-20,505,oven,18490,24000,5510,1,00373,India
560763,2023-03-20,501,iphone 15,60000,80000,20000,1,00373,India
560763,2023-03-20,504,iron,449,879,430,1,00373,India
449436,2023-03-20,506,monitor,3249,8000,4751,1,00444,India
449436,2023-03-20,504,iron,449,879,430,1,00444,India
449436,2023-03-20,507,washing machine,6990,16490,9500,1,00444,India
499506,2023-03-20,506,monitor,3249,8000,4751,1,00207,India
499506,2023-03-20,505,oven,18490,24000,5510,1,00207,India
499506,2023-03-20,504,iron,449,879,430,1,00207,India
499506,2023-03-20,501,iphone 15,60000,80000,20000,1,00207,India
127312,2023-03-20,503,mixer,1349,3249,1900,1,00188,India
478143,2023-03-20,501,iphone 15,60000,80000,20000,1,00341,India
478143,2023-03-20,507,washing machine,6990,16490,9500,1,00341,India
478143,2023-03-20,506,monitor,3249,8000,4751,1,00341,India
478143,2023-03-20,502,iphone 15 pro max,100000,135000,35000,1,00341,India
696590,2023-03-20,504,iron,449,879,430,1,00203,India
696590,2023-03-20,507,washing machine,6990,16490,9500,1,00203,India
696590,2023-03-20,506,monitor,3249,8000,4751,1,00203,India
696590,2023-03-20,501,iphone 15,60000,80000,20000,1,00203,India
696590,2023-03-20,502,iphone 15 pro max,100000,135000,35000,1,00203,India
932700,2023-03-20,504,iron,449,879,430,1,00290,India
932700,2023-03-20,505,oven,18490,24000,5510,1,00290,India
932700,2023-03-20,503,mixer,1349,3249,1900,1,00290,India
932700,2023-03-20,507,washing machine,6990,16490,9500,1,00290,India
695074,2023-03-20,506,monitor,3249,8000,4751,1,00304,India
919767,2023-03-20,501,iphone 15,60000,80000,20000,1,00175,India
919767,2023-03-20,504,iron,449,879,430,1,00175,India
919767,2023-03-20,502,iphone 15 pro max,100000,135000,35000,1,00175,India
919767,2023-03-20,503,mixer,1349,3249,1900,1,00175,India
352014,2023-03-20,502,iphone 15 pro max,100000,135000,35000,1,00229,India
352014,2023-03-20,504,iron,449,879,430,1,00229,India
555432,2023-03-20,506,monitor,3249,8000,4751,1,00010,India
555432,2023-03-20,502,iphone 15 pro max,100000,135000,35000,1,00010,India
952174,2023-03-20,506,monitor,3249,8000,4751,1,00248,India
539731,2023-03-20,503,mixer,1349,3249,1900,1,00227,India
539731,2023-03-20,501,iphone 15,60000,80000,20000,1,00227,India
861152,2023-03-20,503,mixer,1349,3249,1900,1,00256,India
861152,2023-03-20,502,iphone 15 pro max,100000,135000,35000,1,00256,India
861152,2023-03-20,504,iron,449,879,430,1,00256,India
861152,2023-03-20,507,washing machine,6990,16490,9500,1,00256,India
503780,2023-03-20,505,oven,18490,24000,5510,1,00090,India
382074,2023-03-20,505,oven,18490,24000,5510,1,00054,India
382074,2023-03-20,502,iphone 15 pro max,100000,135000,35000,1,00054,India
382074,2023-03-20,507,washing machine,6990,16490,9500,1,00054,India
767751,2023-03-20,504,iron,449,879,430,1,00376,India
767751,2023-03-20,502,iphone 15 pro max,100000,135000,35000,1,00376,India
767751,2023-03-20,507,washing machine,6990,16490,9500,1,00376,India
767751,2023-03-20,505,oven,18490,24000,5510,1,00376,India
996935,2023-03-20,507,washing machine,6990,16490,9500,1,00294,India
792704,2023-03-20,506,monitor,3249,8000,4751,1,00449,India
792704,2023-03-20,501,iphone 15,60000,80000,20000,1,00449,India
792704,2023-03-20,505,oven,18490,24000,5510,1,00449,India
792704,2023-03-20,503,mixer,1349,3249,1900,1,00449,India
871231,2023-03-20,503,mixer,1349,3249,1900,1,00216,India
961950,2023-03-20,503,mixer,1349,3249,1900,1,00412,India
961950,2023-03-20,506,monitor,3249,8000,4751,1,00412,India
961950,2023-03-20,507,washing machine,6990,16490,9500,1,00412,India
961950,2023-03-20,505,oven,18490,24000,5510,1,00412,India
786518,2023-03-20,505,oven,18490,24000,5510,1,00158,India
266645,2023-03-20,503,mixer,1349,3249,1900,1,00411,India
266645,2023-03-20,501,iphone 15,60000,80000,20000,1,00411,India
266645,2023-03-20,505,oven,18490,24000,5510,1,00411,India
318059,2023-03-20,502,iphone 15 pro max,100000,135000,35000,1,00236,India
318059,2023-03-20,504,iron,449,879,430,1,00236,India
318059,2023-03-20,507,washing machine,6990,16490,9500,1,00236,India
758719,2023-03-20,501,iphone 15,60000,80000,20000,1,00187,India
758719,2023-03-20,506,monitor,3249,8000,4751,1,00187,India
913662,2023-03-21,504,iron,449,879,430,1,00067,India
913662,2023-03-21,506,monitor,3249,8000,4751,1,00067,India
913662,2023-03-21,502,iphone 15 pro max,100000,135000,35000,1,00067,India
522276,2023-03-21,503,mixer,1349,3249,1900,1,00045,India
522276,2023-03-21,501,iphone 15,60000,80000,20000,1,00045,India
179621,2023-03-21,505,oven,18490,24000,5510,1,00009,India
179621,2023-03-21,502,iphone 15 pro max,100000,135000,35000,1,00009,India
179621,2023-03-21,504,iron,449,879,430,1,00009,India
416831,2023-03-21,503,mixer,1349,3249,1900,1,00417,India
416831,2023-03-21,506,monitor,3249,8000,4751,1,00417,India
940194,2023-03-21,506,monitor,3249,8000,4751,1,00275,India
104180,2023-03-21,502,iphone 15 pro max,100000,135000,35000,1,00365,India
313300,2023-03-21,507,washing machine,6990,16490,9500,1,00400,India
313300,2023-03-21,505,oven,18490,24000,5510,1,00400,India
313300,2023-03-21,506,monitor,3249,8000,4751,1,00400,India
358797,2023-03-21,502,iphone 15 pro max,100000,135000,35000,1,00295,India
358797,2023-03-21,506,monitor,3249,8000,4751,1,00295,India
358797,2023-03-21,504,iron,449,879,430,1,00295,India
358797,2023-03-21,507,washing machine,6990,16490,9500,1,00295,India
681342,2023-03-21,506,monitor,3249,8000,4751,1,00448,India
681342,2023-03-21,505,oven,18490,24000,5510,1,00448,India
681342,2023-03-21,507,washing machine,6990,16490,9500,1,00448,India
681342,2023-03-21,504,iron,449,879,430,1,00448,India
681342,2023-03-21,501,iphone 15,60000,80000,20000,1,00448,India
241437,2023-03-21,503,mixer,1349,3249,1900,1,00287,India
241437,2023-03-21,506,monitor,3249,8000,4751,1,00287,India
241437,2023-03-21,501,iphone 15,60000,80000,20000,1,00287,India
406613,2023-03-21,503,mixer,1349,3249,1900,1,00246,India
406613,2023-03-21,505,oven,18490,24000,5510,1,00246,India
406613,2023-03-21,502,iphone 15 pro max,100000,135000,35000,1,00246,India
743757,2023-03-21,507,washing machine,6990,16490,9500,1,00052,India
743757,2023-03-21,504,iron,449,879,430,1,00052,India
743757,2023-03-21,501,iphone 15,60000,80000,20000,1,00052,India
978188,2023-03-21,501,iphone 15,60000,80000,20000,1,00315,India
978188,2023-03-21,507,washing machine,6990,16490,9500,1,00315,India
978188,2023-03-21,504,iron,449,879,430,1,00315,India
440844,2023-03-21,507,washing machine,6990,16490,9500,1,00478,India
440844,2023-03-21,505,oven,18490,24000,5510,1,00478,India
756401,2023-03-21,507,washing machine,6990,16490,9500,1,00135,India
756401,2023-03-21,503,mixer,1349,3249,1900,1,00135,India
756401,2023-03-21,502,iphone 15 pro max,100000,135000,35000,1,00135,India
312953,2023-03-21,502,iphone 15 pro max,100000,135000,35000,1,00491,India
381625,2023-03-21,502,iphone 15 pro max,100000,135000,35000,1,00155,India
381625,2023-03-21,501,iphone 15,60000,80000,20000,1,00155,India
483782,2023-03-21,507,washing machine,6990,16490,9500,1,00120,India
483782,2023-03-21,501,iphone 15,60000,80000,20000,1,00120,India
483782,2023-03-21,504,iron,449,879,430,1,00120,India
483782,2023-03-21,505,oven,18490,24000,5510,1,00120,India
471739,2023-03-21,507,washing machine,6990,16490,9500,1,00446,India
897579,2023-03-21,504,iron,449,879,430,1,00464,India
897579,2023-03-21,505,oven,18490,24000,5510,1,00464,India
897579,2023-03-21,503,mixer,1349,3249,1900,1,00464,India
961666,2023-03-21,506,monitor,3249,8000,4751,1,00468,India
961666,2023-03-21,503,mixer,1349,3249,1900,1,00468,India
591779,2023-03-21,502,iphone 15 pro max,100000,135000,35000,1,00043,India
591779,2023-03-21,506,monitor,3249,8000,4751,1,00043,India
591779,2023-03-21,505,oven,18490,24000,5510,1,00043,India
591779,2023-03-21,501,iphone 15,60000,80000,20000,1,00043,India
751444,2023-03-21,503,mixer,1349,3249,1900,1,00172,India
751444,2023-03-21,505,oven,18490,24000,5510,1,00172,India
751444,2023-03-21,501,iphone 15,60000,80000,20000,1,00172,India
751444,2023-03-21,506,monitor,3249,8000,4751,1,00172,India
907031,2023-03-21,505,oven,18490,24000,5510,1,00474,India
942415,2023-03-21,504,iron,449,879,430,1,00185,India
942415,2023-03-21,501,iphone 15,60000,80000,20000,1,00185,India
942415,2023-03-21,507,washing machine,6990,16490,9500,1,00185,India
985030,2023-03-21,506,monitor,3249,8000,4751,1,00057,India
985030,2023-03-21,501,iphone 15,60000,80000,20000,1,00057,India
173425,2023-03-21,501,iphone 15,60000,80000,20000,1,00028,India
718169,2023-03-21,501,iphone 15,60000,80000,20000,1,00281,India
718169,2023-03-21,503,mixer,1349,3249,1900,1,00281,India
718169,2023-03-21,505,oven,18490,24000,5510,1,00281,India
339001,2023-03-21,501,iphone 15,60000,80000,20000,1,00437,India
339001,2023-03-21,504,iron,449,879,430,1,00437,India
339001,2023-03-21,507,washing machine,6990,16490,9500,1,00437,India
372177,2023-03-21,501,iphone 15,60000,80000,20000,1,00359,India
372177,2023-03-21,506,monitor,3249,8000,4751,1,00359,India
372177,2023-03-21,502,iphone 15 pro max,100000,135000,35000,1,00359,India
741576,2023-03-21,502,iphone 15 pro max,100000,135000,35000,1,00103,India
741576,2023-03-21,504,iron,449,879,430,1,00103,India
741576,2023-03-21,505,oven,18490,24000,5510,1,00103,India
940785,2023-03-21,504,iron,449,879,430,1,00054,India
940785,2023-03-21,507,washing machine,6990,16490,9500,1,00054,India
940785,2023-03-21,501,iphone 15,60000,80000,20000,1,00054,India
326180,2023-03-21,502,iphone 15 pro max,100000,135000,35000,1,00471,India
326180,2023-03-21,503,mixer,1349,3249,1900,1,00471,India
192425,2023-03-21,506,monitor,3249,8000,4751,1,00095,India
192425,2023-03-21,504,iron,449,879,430,1,00095,India
192425,2023-03-21,507,washing machine,6990,16490,9500,1,00095,India
322687,2023-03-21,501,iphone 15,60000,80000,20000,1,00310,India
727552,2023-03-21,502,iphone 15 pro max,100000,135000,35000,1,00223,India
727552,2023-03-21,503,mixer,1349,3249,1900,1,00223,India
727552,2023-03-21,505,oven,18490,24000,5510,1,00223,India
285304,2023-03-21,504,iron,449,879,430,1,00065,India
285304,2023-03-21,507,washing machine,6990,16490,9500,1,00065,India
444343,2023-03-21,504,iron,449,879,430,1,00189,India
444343,2023-03-21,503,mixer,1349,3249,1900,1,00189,India
364500,2023-03-21,504,iron,449,879,430,1,00483,India
364500,2023-03-21,502,iphone 15 pro max,100000,135000,35000,1,00483,India
364500,2023-03-21,507,washing machine,6990,16490,9500,1,00483,India
797571,2023-03-21,504,iron,449,879,430,1,00321,India
107128,2023-03-21,504,iron,449,879,430,1,00304,India
707030,2023-03-21,506,monitor,3249,8000,4751,1,00217,India
707030,2023-03-21,507,washing machine,6990,16490,9500,1,00217,India
484911,2023-03-21,507,washing machine,6990,16490,9500,1,00042,India
484911,2023-03-21,505,oven,18490,24000,5510,1,00042,India
484911,2023-03-21,504,iron,449,879,430,1,00042,India
484911,2023-03-21,506,monitor,3249,8000,4751,1,00042,India
994751,2023-03-21,501,iphone 15,60000,80000,20000,1,00214,India
994751,2023-03-21,507,washing machine,6990,16490,9500,1,00214,India
994751,2023-03-21,505,oven,18490,24000,5510,1,00214,India
994751,2023-03-21,504,iron,449,879,430,1,00214,India
307346,2023-03-21,502,iphone 15 pro max,100000,135000,35000,1,00114,India
307346,2023-03-21,504,iron,449,879,430,1,00114,India
307346,2023-03-21,501,iphone 15,60000,80000,20000,1,00114,India
484815,2023-03-21,505,oven,18490,24000,5510,1,00461,India
746359,2023-03-21,506,monitor,3249,8000,4751,1,00312,India
746359,2023-03-21,507,washing machine,6990,16490,9500,1,00312,India
691671,2023-03-21,503,mixer,1349,3249,1900,1,00264,India
691671,2023-03-21,501,iphone 15,60000,80000,20000,1,00264,India
691671,2023-03-21,504,iron,449,879,430,1,00264,India
590341,2023-03-21,504,iron,449,879,430,1,00213,India
236200,2023-03-21,501,iphone 15,60000,80000,20000,1,00175,India
236200,2023-03-21,507,washing machine,6990,16490,9500,1,00175,India
199626,2023-03-21,503,mixer,1349,3249,1900,1,00455,India
199626,2023-03-21,507,washing machine,6990,16490,9500,1,00455,India
414049,2023-03-21,504,iron,449,879,430,1,00398,India
414049,2023-03-21,501,iphone 15,60000,80000,20000,1,00398,India
414049,2023-03-21,507,washing machine,6990,16490,9500,1,00398,India
414049,2023-03-21,502,iphone 15 pro max,100000,135000,35000,1,00398,India
160902,2023-03-21,504,iron,449,879,430,1,00456,India
881573,2023-03-21,507,washing machine,6990,16490,9500,1,00274,India
881573,2023-03-21,506,monitor,3249,8000,4751,1,00274,India
881573,2023-03-21,503,mixer,1349,3249,1900,1,00274,India
881573,2023-03-21,504,iron,449,879,430,1,00274,India
824451,2023-03-21,503,mixer,1349,3249,1900,1,00338,India
761457,2023-03-21,504,iron,449,879,430,1,00187,India
761457,2023-03-21,506,monitor,3249,8000,4751,1,00187,India
761457,2023-03-21,505,oven,18490,24000,5510,1,00187,India
761457,2023-03-21,501,iphone 15,60000,80000,20000,1,00187,India
318532,2023-03-21,503,mixer,1349,3249,1900,1,00239,India
318532,2023-03-21,502,iphone 15 pro max,100000,135000,35000,1,00239,India
318532,2023-03-21,501,iphone 15,60000,80000,20000,1,00239,India
101994,2023-03-21,502,iphone 15 pro max,100000,135000,35000,1,00034,India
101994,2023-03-21,506,monitor,3249,8000,4751,1,00034,India
104784,2023-03-21,503,mixer,1349,3249,1900,1,00489,India
104784,2023-03-21,506,monitor,3249,8000,4751,1,00489,India
104784,2023-03-21,504,iron,449,879,430,1,00489,India
207142,2023-03-21,505,oven,18490,24000,5510,1,00093,India
207142,2023-03-21,507,washing machine,6990,16490,9500,1,00093,India
207142,2023-03-21,503,mixer,1349,3249,1900,1,00093,India
207142,2023-03-21,504,iron,449,879,430,1,00093,India
354426,2023-03-21,507,washing machine,6990,16490,9500,1,00112,India
354426,2023-03-21,502,iphone 15 pro max,100000,135000,35000,1,00112,India
354426,2023-03-21,504,iron,449,879,430,1,00112,India
709657,2023-03-21,502,iphone 15 pro max,100000,135000,35000,1,00272,India
709657,2023-03-21,501,iphone 15,60000,80000,20000,1,00272,India
709657,2023-03-21,503,mixer,1349,3249,1900,1,00272,India
709657,2023-03-21,507,washing machine,6990,16490,9500,1,00272,India
582290,2023-03-21,501,iphone 15,60000,80000,20000,1,00484,India
599821,2023-03-21,501,iphone 15,60000,80000,20000,1,00419,India
939185,2023-03-21,505,oven,18490,24000,5510,1,00123,India
745173,2023-03-21,502,iphone 15 pro max,100000,135000,35000,1,00330,India
745173,2023-03-21,505,oven,18490,24000,5510,1,00330,India
106289,2023-03-21,503,mixer,1349,3249,1900,1,00444,India
106289,2023-03-21,507,washing machine,6990,16490,9500,1,00444,India
971031,2023-03-21,504,iron,449,879,430,1,00439,India
862527,2023-03-21,504,iron,449,879,430,1,00121,India
862527,2023-03-21,502,iphone 15 pro max,100000,135000,35000,1,00121,India
862527,2023-03-21,505,oven,18490,24000,5510,1,00121,India
862527,2023-03-21,507,washing machine,6990,16490,9500,1,00121,India
676430,2023-03-21,501,iphone 15,60000,80000,20000,1,00069,India
676430,2023-03-21,503,mixer,1349,3249,1900,1,00069,India
784060,2023-03-21,505,oven,18490,24000,5510,1,00330,India
784060,2023-03-21,504,iron,449,879,430,1,00330,India
784060,2023-03-21,501,iphone 15,60000,80000,20000,1,00330,India
784060,2023-03-21,502,iphone 15 pro max,100000,135000,35000,1,00330,India
237413,2023-03-21,502,iphone 15 pro max,100000,135000,35000,1,00061,India
818073,2023-03-21,507,washing machine,6990,16490,9500,1,00244,India
818073,2023-03-21,506,monitor,3249,8000,4751,1,00244,India
818073,2023-03-21,502,iphone 15 pro max,100000,135000,35000,1,00244,India
818073,2023-03-21,504,iron,449,879,430,1,00244,India
860241,2023-03-21,505,oven,18490,24000,5510,1,00476,India
993415,2023-03-21,507,washing machine,6990,16490,9500,1,00382,India
514674,2023-03-21,502,iphone 15 pro max,100000,135000,35000,1,00319,India
514674,2023-03-21,507,washing machine,6990,16490,9500,1,00319,India
514674,2023-03-21,503,mixer,1349,3249,1900,1,00319,India
514674,2023-03-21,506,monitor,3249,8000,4751,1,00319,India
174299,2023-03-21,505,oven,18490,24000,5510,1,00041,India
174299,2023-03-21,503,mixer,1349,3249,1900,1,00041,India
840488,2023-03-21,503,mixer,1349,3249,1900,1,00494,India
840488,2023-03-21,504,iron,449,879,430,1,00494,India
840488,2023-03-21,502,iphone 15 pro max,100000,135000,35000,1,00494,India
598134,2023-03-21,507,washing machine,6990,16490,9500,1,00319,India
598134,2023-03-21,504,iron,449,879,430,1,00319,India
611554,2023-03-21,501,iphone 15,60000,80000,20000,1,00086,India
611554,2023-03-21,507,washing machine,6990,16490,9500,1,00086,India
611554,2023-03-21,506,monitor,3249,8000,4751,1,00086,India
553080,2023-03-21,506,monitor,3249,8000,4751,1,00059,India
813408,2023-03-21,504,iron,449,879,430,1,00213,India
269639,2023-03-21,503,mixer,1349,3249,1900,1,00170,India
407241,2023-03-21,503,mixer,1349,3249,1900,1,00442,India
407241,2023-03-21,502,iphone 15 pro max,100000,135000,35000,1,00442,India
642508,2023-03-22,506,monitor,3249,8000,4751,1,00401,India
608653,2023-03-22,507,washing machine,6990,16490,9500,1,00187,India
337294,2023-03-22,503,mixer,1349,3249,1900,1,00409,India
337294,2023-03-22,501,iphone 15,60000,80000,20000,1,00409,India
337294,2023-03-22,505,oven,18490,24000,5510,1,00409,India
843057,2023-03-22,507,washing machine,6990,16490,9500,1,00149,India
843057,2023-03-22,506,monitor,3249,8000,4751,1,00149,India
843057,2023-03-22,504,iron,449,879,430,1,00149,India
843057,2023-03-22,501,iphone 15,60000,80000,20000,1,00149,India
299449,2023-03-22,502,iphone 15 pro max,100000,135000,35000,1,00157,India
299449,2023-03-22,505,oven,18490,24000,5510,1,00157,India
299449,2023-03-22,504,iron,449,879,430,1,00157,India
487933,2023-03-22,505,oven,18490,24000,5510,1,00463,India
545711,2023-03-22,506,monitor,3249,8000,4751,1,00047,India
545044,2023-03-22,507,washing machine,6990,16490,9500,1,00083,India
545044,2023-03-22,503,mixer,1349,3249,1900,1,00083,India
545044,2023-03-22,502,iphone 15 pro max,100000,135000,35000,1,00083,India
470938,2023-03-22,507,washing machine,6990,16490,9500,1,00155,India
470938,2023-03-22,503,mixer,1349,3249,1900,1,00155,India
565958,2023-03-22,505,oven,18490,24000,5510,1,00020,India
565958,2023-03-22,501,iphone 15,60000,80000,20000,1,00020,India
565958,2023-03-22,504,iron,449,879,430,1,00020,India
188774,2023-03-22,502,iphone 15 pro max,100000,135000,35000,1,00081,India
188774,2023-03-22,505,oven,18490,24000,5510,1,00081,India
188774,2023-03-22,501,iphone 15,60000,80000,20000,1,00081,India
188774,2023-03-22,504,iron,449,879,430,1,00081,India
961325,2023-03-22,505,oven,18490,24000,5510,1,00117,India
961325,2023-03-22,503,mixer,1349,3249,1900,1,00117,India
961325,2023-03-22,507,washing machine,6990,16490,9500,1,00117,India
622322,2023-03-22,501,iphone 15,60000,80000,20000,1,00091,India
622322,2023-03-22,503,mixer,1349,3249,1900,1,00091,India
959099,2023-03-22,501,iphone 15,60000,80000,20000,1,00258,India
959099,2023-03-22,507,washing machine,6990,16490,9500,1,00258,India
967069,2023-03-22,507,washing machine,6990,16490,9500,1,00130,India
967069,2023-03-22,506,monitor,3249,8000,4751,1,00130,India
967069,2023-03-22,505,oven,18490,24000,5510,1,00130,India
720706,2023-03-22,502,iphone 15 pro max,100000,135000,35000,1,00266,India
720706,2023-03-22,504,iron,449,879,430,1,00266,India
720706,2023-03-22,507,washing machine,6990,16490,9500,1,00266,India
111734,2023-03-22,502,iphone 15 pro max,100000,135000,35000,1,00365,India
111734,2023-03-22,504,iron,449,879,430,1,00365,India
834846,2023-03-22,504,iron,449,879,430,1,00061,India
834846,2023-03-22,506,monitor,3249,8000,4751,1,00061,India
834846,2023-03-22,501,iphone 15,60000,80000,20000,1,00061,India
348288,2023-03-22,506,monitor,3249,8000,4751,1,00481,India
231110,2023-03-22,505,oven,18490,24000,5510,1,00204,India
231110,2023-03-22,502,iphone 15 pro max,100000,135000,35000,1,00204,India
231110,2023-03-22,506,monitor,3249,8000,4751,1,00204,India
309534,2023-03-22,502,iphone 15 pro max,100000,135000,35000,1,00023,India
309534,2023-03-22,505,oven,18490,24000,5510,1,00023,India
309534,2023-03-22,506,monitor,3249,8000,4751,1,00023,India
727025,2023-03-22,507,washing machine,6990,16490,9500,1,00396,India
727025,2023-03-22,503,mixer,1349,3249,1900,1,00396,India
727025,2023-03-22,501,iphone 15,60000,80000,20000,1,00396,India
727025,2023-03-22,502,iphone 15 pro max,100000,135000,35000,1,00396,India
632417,2023-03-22,502,iphone 15 pro max,100000,135000,35000,1,00209,India
632417,2023-03-22,503,mixer,1349,3249,1900,1,00209,India
631043,2023-03-22,503,mixer,1349,3249,1900,1,00421,India
164112,2023-03-22,507,washing machine,6990,16490,9500,1,00475,India
164112,2023-03-22,502,iphone 15 pro max,100000,135000,35000,1,00475,India
164112,2023-03-22,505,oven,18490,24000,5510,1,00475,India
873021,2023-03-22,505,oven,18490,24000,5510,1,00449,India
572675,2023-03-22,506,monitor,3249,8000,4751,1,00177,India
572675,2023-03-22,503,mixer,1349,3249,1900,1,00177,India
805576,2023-03-22,501,iphone 15,60000,80000,20000,1,00330,India
805576,2023-03-22,506,monitor,3249,8000,4751,1,00330,India
805576,2023-03-22,505,oven,18490,24000,5510,1,00330,India
500102,2023-03-22,507,washing machine,6990,16490,9500,1,00215,India
500102,2023-03-22,503,mixer,1349,3249,1900,1,00215,India
214860,2023-03-22,505,oven,18490,24000,5510,1,00016,India
228623,2023-03-22,506,monitor,3249,8000,4751,1,00137,India
228623,2023-03-22,502,iphone 15 pro max,100000,135000,35000,1,00137,India
228623,2023-03-22,501,iphone 15,60000,80000,20000,1,00137,India
640691,2023-03-22,503,mixer,1349,3249,1900,1,00225,India
640691,2023-03-22,505,oven,18490,24000,5510,1,00225,India
234462,2023-03-22,506,monitor,3249,8000,4751,1,00055,India
584881,2023-03-22,502,iphone 15 pro max,100000,135000,35000,1,00021,India
584881,2023-03-22,507,washing machine,6990,16490,9500,1,00021,India
688103,2023-03-22,507,washing machine,6990,16490,9500,1,00015,India
688103,2023-03-22,501,iphone 15,60000,80000,20000,1,00015,India
452081,2023-03-22,501,iphone 15,60000,80000,20000,1,00386,India
452081,2023-03-22,507,washing machine,6990,16490,9500,1,00386,India
452081,2023-03-22,505,oven,18490,24000,5510,1,00386,India
452081,2023-03-22,506,monitor,3249,8000,4751,1,00386,India
676981,2023-03-22,505,oven,18490,24000,5510,1,00471,India
676981,2023-03-22,503,mixer,1349,3249,1900,1,00471,India
242635,2023-03-22,505,oven,18490,24000,5510,1,00161,India
242635,2023-03-22,503,mixer,1349,3249,1900,1,00161,India
242635,2023-03-22,501,iphone 15,60000,80000,20000,1,00161,India
748564,2023-03-22,507,washing machine,6990,16490,9500,1,00032,India
748564,2023-03-22,504,iron,449,879,430,1,00032,India
748564,2023-03-22,501,iphone 15,60000,80000,20000,1,00032,India
587296,2023-03-22,503,mixer,1349,3249,1900,1,00106,India
484565,2023-03-22,505,oven,18490,24000,5510,1,00095,India
484565,2023-03-22,503,mixer,1349,3249,1900,1,00095,India
484565,2023-03-22,501,iphone 15,60000,80000,20000,1,00095,India
484565,2023-03-22,504,iron,449,879,430,1,00095,India
484565,2023-03-22,502,iphone 15 pro max,100000,135000,35000,1,00095,India
917268,2023-03-22,501,iphone 15,60000,80000,20000,1,00091,India
917268,2023-03-22,507,washing machine,6990,16490,9500,1,00091,India
917268,2023-03-22,503,mixer,1349,3249,1900,1,00091,India
845034,2023-03-22,503,mixer,1349,3249,1900,1,00319,India
845034,2023-03-22,505,oven,18490,24000,5510,1,00319,India
845034,2023-03-22,506,monitor,3249,8000,4751,1,00319,India
845034,2023-03-22,502,iphone 15 pro max,100000,135000,35000,1,00319,India
343376,2023-03-22,504,iron,449,879,430,1,00398,India
318921,2023-03-22,504,iron,449,879,430,1,00104,India
811870,2023-03-22,505,oven,18490,24000,5510,1,00414,India
811870,2023-03-22,502,iphone 15 pro max,100000,135000,35000,1,00414,India
811870,2023-03-22,507,washing machine,6990,16490,9500,1,00414,India
811870,2023-03-22,501,iphone 15,60000,80000,20000,1,00414,India
941265,2023-03-22,506,monitor,3249,8000,4751,1,00389,India
941265,2023-03-22,504,iron,449,879,430,1,00389,India
941265,2023-03-22,501,iphone 15,60000,80000,20000,1,00389,India
941265,2023-03-22,505,oven,18490,24000,5510,1,00389,India
904679,2023-03-22,502,iphone 15 pro max,100000,135000,35000,1,00010,India
904679,2023-03-22,501,iphone 15,60000,80000,20000,1,00010,India
904679,2023-03-22,506,monitor,3249,8000,4751,1,00010,India
941805,2023-03-22,503,mixer,1349,3249,1900,1,00441,India
941805,2023-03-22,501,iphone 15,60000,80000,20000,1,00441,India
941805,2023-03-22,506,monitor,3249,8000,4751,1,00441,India
245454,2023-03-22,506,monitor,3249,8000,4751,1,00188,India
245454,2023-03-22,505,oven,18490,24000,5510,1,00188,India
245454,2023-03-22,507,washing machine,6990,16490,9500,1,00188,India
245454,2023-03-22,504,iron,449,879,430,1,00188,India
654482,2023-03-22,502,iphone 15 pro max,100000,135000,35000,1,00347,India
466722,2023-03-22,506,monitor,3249,8000,4751,1,00075,India
466722,2023-03-22,502,iphone 15 pro max,100000,135000,35000,1,00075,India
109391,2023-03-22,504,iron,449,879,430,1,00479,India
109391,2023-03-22,503,mixer,1349,3249,1900,1,00479,India
109391,2023-03-22,501,iphone 15,60000,80000,20000,1,00479,India
423800,2023-03-22,502,iphone 15 pro max,100000,135000,35000,1,00483,India
423800,2023-03-22,506,monitor,3249,8000,4751,1,00483,India
423800,2023-03-22,507,washing machine,6990,16490,9500,1,00483,India
423800,2023-03-22,503,mixer,1349,3249,1900,1,00483,India
789108,2023-03-22,505,oven,18490,24000,5510,1,00178,India
789108,2023-03-22,506,monitor,3249,8000,4751,1,00178,India
805398,2023-03-22,501,iphone 15,60000,80000,20000,1,00114,India
381704,2023-03-22,504,iron,449,879,430,1,00094,India
261958,2023-03-22,505,oven,18490,24000,5510,1,00453,India
301930,2023-03-23,506,monitor,3249,8000,4751,1,00135,India
431024,2023-03-23,506,monitor,3249,8000,4751,1,00329,India
788907,2023-03-23,502,iphone 15 pro max,100000,135000,35000,1,00201,India
788907,2023-03-23,505,oven,18490,24000,5510,1,00201,India
423349,2023-03-23,504,iron,449,879,430,1,00006,India
423349,2023-03-23,505,oven,18490,24000,5510,1,00006,India
522623,2023-03-23,504,iron,449,879,430,1,00455,India
522623,2023-03-23,507,washing machine,6990,16490,9500,1,00455,India
968320,2023-03-23,503,mixer,1349,3249,1900,1,00228,India
968320,2023-03-23,505,oven,18490,24000,5510,1,00228,India
968320,2023-03-23,501,iphone 15,60000,80000,20000,1,00228,India
968320,2023-03-23,502,iphone 15 pro max,100000,135000,35000,1,00228,India
968320,2023-03-23,507,washing machine,6990,16490,9500,1,00228,India
387979,2023-03-23,504,iron,449,879,430,1,00222,India
356058,2023-03-23,503,mixer,1349,3249,1900,1,00176,India
919245,2023-03-23,502,iphone 15 pro max,100000,135000,35000,1,00010,India
919245,2023-03-23,507,washing machine,6990,16490,9500,1,00010,India
919245,2023-03-23,503,mixer,1349,3249,1900,1,00010,India
442053,2023-03-23,502,iphone 15 pro max,100000,135000,35000,1,00355,India
442053,2023-03-23,503,mixer,1349,3249,1900,1,00355,India
356822,2023-03-23,507,washing machine,6990,16490,9500,1,00169,India
356822,2023-03-23,501,iphone 15,60000,80000,20000,1,00169,India
290573,2023-03-23,501,iphone 15,60000,80000,20000,1,00442,India
326236,2023-03-23,504,iron,449,879,430,1,00449,India
506129,2023-03-23,506,monitor,3249,8000,4751,1,00482,India
506129,2023-03-23,501,iphone 15,60000,80000,20000,1,00482,India
506129,2023-03-23,502,iphone 15 pro max,100000,135000,35000,1,00482,India
506129,2023-03-23,507,washing machine,6990,16490,9500,1,00482,India
512999,2023-03-23,503,mixer,1349,3249,1900,1,00094,India
512999,2023-03-23,505,oven,18490,24000,5510,1,00094,India
195059,2023-03-23,504,iron,449,879,430,1,00087,India
300028,2023-03-23,504,iron,449,879,430,1,00033,India
300028,2023-03-23,506,monitor,3249,8000,4751,1,00033,India
300028,2023-03-23,507,washing machine,6990,16490,9500,1,00033,India
625466,2023-03-23,504,iron,449,879,430,1,00047,India
625466,2023-03-23,506,monitor,3249,8000,4751,1,00047,India
625466,2023-03-23,502,iphone 15 pro max,100000,135000,35000,1,00047,India
791881,2023-03-23,506,monitor,3249,8000,4751,1,00062,India
770633,2023-03-23,504,iron,449,879,430,1,00197,India
770633,2023-03-23,502,iphone 15 pro max,100000,135000,35000,1,00197,India
896371,2023-03-23,504,iron,449,879,430,1,00010,India
896371,2023-03-23,505,oven,18490,24000,5510,1,00010,India
896371,2023-03-23,502,iphone 15 pro max,100000,135000,35000,1,00010,India
896371,2023-03-23,507,washing machine,6990,16490,9500,1,00010,India
806783,2023-03-23,505,oven,18490,24000,5510,1,00245,India
235754,2023-03-23,502,iphone 15 pro max,100000,135000,35000,1,00068,India
235754,2023-03-23,507,washing machine,6990,16490,9500,1,00068,India
235754,2023-03-23,503,mixer,1349,3249,1900,1,00068,India
235754,2023-03-23,501,iphone 15,60000,80000,20000,1,00068,India
235754,2023-03-23,506,monitor,3249,8000,4751,1,00068,India
563999,2023-03-23,502,iphone 15 pro max,100000,135000,35000,1,00481,India
563999,2023-03-23,503,mixer,1349,3249,1900,1,00481,India
678421,2023-03-23,504,iron,449,879,430,1,00284,India
678421,2023-03-23,505,oven,18490,24000,5510,1,00284,India
678421,2023-03-23,502,iphone 15 pro max,100000,135000,35000,1,00284,India
678421,2023-03-23,506,monitor,3249,8000,4751,1,00284,India
542637,2023-03-23,501,iphone 15,60000,80000,20000,1,00352,India
938543,2023-03-23,507,washing machine,6990,16490,9500,1,00099,India
337941,2023-03-23,501,iphone 15,60000,80000,20000,1,00350,India
670160,2023-03-23,505,oven,18490,24000,5510,1,00430,India
670160,2023-03-23,506,monitor,3249,8000,4751,1,00430,India
670160,2023-03-23,503,mixer,1349,3249,1900,1,00430,India
670160,2023-03-23,501,iphone 15,60000,80000,20000,1,00430,India
562484,2023-03-23,504,iron,449,879,430,1,00343,India
562484,2023-03-23,503,mixer,1349,3249,1900,1,00343,India
562484,2023-03-23,507,washing machine,6990,16490,9500,1,00343,India
808818,2023-03-23,501,iphone 15,60000,80000,20000,1,00027,India
808818,2023-03-23,505,oven,18490,24000,5510,1,00027,India
756133,2023-03-23,503,mixer,1349,3249,1900,1,00008,India
756133,2023-03-23,505,oven,18490,24000,5510,1,00008,India
756133,2023-03-23,502,iphone 15 pro max,100000,135000,35000,1,00008,India
569447,2023-03-23,501,iphone 15,60000,80000,20000,1,00377,India
569447,2023-03-23,507,washing machine,6990,16490,9500,1,00377,India
569447,2023-03-23,505,oven,18490,24000,5510,1,00377,India
569447,2023-03-23,503,mixer,1349,3249,1900,1,00377,India
569447,2023-03-23,502,iphone 15 pro max,100000,135000,35000,1,00377,India
611077,2023-03-23,505,oven,18490,24000,5510,1,00425,India
611077,2023-03-23,506,monitor,3249,8000,4751,1,00425,India
611077,2023-03-23,502,iphone 15 pro max,100000,135000,35000,1,00425,India
724382,2023-03-23,505,oven,18490,24000,5510,1,00051,India
724382,2023-03-23,501,iphone 15,60000,80000,20000,1,00051,India
567091,2023-03-23,503,mixer,1349,3249,1900,1,00341,India
567091,2023-03-23,505,oven,18490,24000,5510,1,00341,India
574912,2023-03-23,501,iphone 15,60000,80000,20000,1,00500,India
696871,2023-03-23,503,mixer,1349,3249,1900,1,00247,India
696871,2023-03-23,507,washing machine,6990,16490,9500,1,00247,India
696871,2023-03-23,502,iphone 15 pro max,100000,135000,35000,1,00247,India
696871,2023-03-23,506,monitor,3249,8000,4751,1,00247,India
667913,2023-03-23,502,iphone 15 pro max,100000,135000,35000,1,00120,India
667913,2023-03-23,504,iron,449,879,430,1,00120,India
667913,2023-03-23,501,iphone 15,60000,80000,20000,1,00120,India
401828,2023-03-23,505,oven,18490,24000,5510,1,00056,India
401828,2023-03-23,503,mixer,1349,3249,1900,1,00056,India
401828,2023-03-23,501,iphone 15,60000,80000,20000,1,00056,India
401828,2023-03-23,507,washing machine,6990,16490,9500,1,00056,India
713225,2023-03-23,503,mixer,1349,3249,1900,1,00467,India
713225,2023-03-23,504,iron,449,879,430,1,00467,India
713225,2023-03-23,507,washing machine,6990,16490,9500,1,00467,India
713225,2023-03-23,502,iphone 15 pro max,100000,135000,35000,1,00467,India
713225,2023-03-23,505,oven,18490,24000,5510,1,00467,India
392099,2023-03-23,507,washing machine,6990,16490,9500,1,00272,India
771974,2023-03-23,501,iphone 15,60000,80000,20000,1,00196,India
771974,2023-03-23,507,washing machine,6990,16490,9500,1,00196,India
771974,2023-03-23,502,iphone 15 pro max,100000,135000,35000,1,00196,India
909312,2023-03-23,504,iron,449,879,430,1,00309,India
909312,2023-03-23,505,oven,18490,24000,5510,1,00309,India
916394,2023-03-23,502,iphone 15 pro max,100000,135000,35000,1,00385,India
916394,2023-03-23,506,monitor,3249,8000,4751,1,00385,India
355881,2023-03-23,502,iphone 15 pro max,100000,135000,35000,1,00400,India
355881,2023-03-23,504,iron,449,879,430,1,00400,India
958538,2023-03-23,501,iphone 15,60000,80000,20000,1,00024,India
958538,2023-03-23,502,iphone 15 pro max,100000,135000,35000,1,00024,India
958538,2023-03-23,505,oven,18490,24000,5510,1,00024,India
636351,2023-03-23,503,mixer,1349,3249,1900,1,00499,India
330677,2023-03-23,507,washing machine,6990,16490,9500,1,00316,India
833272,2023-03-23,505,oven,18490,24000,5510,1,00327,India
833272,2023-03-23,501,iphone 15,60000,80000,20000,1,00327,India
833272,2023-03-23,506,monitor,3249,8000,4751,1,00327,India
243195,2023-03-23,501,iphone 15,60000,80000,20000,1,00318,India
243195,2023-03-23,507,washing machine,6990,16490,9500,1,00318,India
243195,2023-03-23,505,oven,18490,24000,5510,1,00318,India
285292,2023-03-23,502,iphone 15 pro max,100000,135000,35000,1,00412,India
285292,2023-03-23,503,mixer,1349,3249,1900,1,00412,India
253996,2023-03-23,504,iron,449,879,430,1,00352,India
253996,2023-03-23,506,monitor,3249,8000,4751,1,00352,India
253996,2023-03-23,502,iphone 15 pro max,100000,135000,35000,1,00352,India
312772,2023-03-23,502,iphone 15 pro max,100000,135000,35000,1,00085,India
312772,2023-03-23,507,washing machine,6990,16490,9500,1,00085,India
312772,2023-03-23,501,iphone 15,60000,80000,20000,1,00085,India
312772,2023-03-23,503,mixer,1349,3249,1900,1,00085,India
528489,2023-03-23,507,washing machine,6990,16490,9500,1,00188,India
158026,2023-03-23,506,monitor,3249,8000,4751,1,00426,India
158026,2023-03-23,501,iphone 15,60000,80000,20000,1,00426,India
158026,2023-03-23,503,mixer,1349,3249,1900,1,00426,India
651095,2023-03-23,504,iron,449,879,430,1,00441,India
651095,2023-03-23,501,iphone 15,60000,80000,20000,1,00441,India
651095,2023-03-23,505,oven,18490,24000,5510,1,00441,India
946093,2023-03-23,503,mixer,1349,3249,1900,1,00301,India
122006,2023-03-23,504,iron,449,879,430,1,00263,India
122006,2023-03-23,507,washing machine,6990,16490,9500,1,00263,India
122006,2023-03-23,503,mixer,1349,3249,1900,1,00263,India
767341,2023-03-23,505,oven,18490,24000,5510,1,00349,India
312647,2023-03-23,506,monitor,3249,8000,4751,1,00204,India
881169,2023-03-23,501,iphone 15,60000,80000,20000,1,00320,India
881169,2023-03-23,505,oven,18490,24000,5510,1,00320,India
658316,2023-03-23,501,iphone 15,60000,80000,20000,1,00164,India
658316,2023-03-23,502,iphone 15 pro max,100000,135000,35000,1,00164,India
658316,2023-03-23,505,oven,18490,24000,5510,1,00164,India
804831,2023-03-23,502,iphone 15 pro max,100000,135000,35000,1,00207,India
804831,2023-03-23,507,washing machine,6990,16490,9500,1,00207,India
804831,2023-03-23,505,oven,18490,24000,5510,1,00207,India
804831,2023-03-23,506,monitor,3249,8000,4751,1,00207,India
886889,2023-03-23,502,iphone 15 pro max,100000,135000,35000,1,00016,India
886889,2023-03-23,505,oven,18490,24000,5510,1,00016,India
792702,2023-03-23,504,iron,449,879,430,1,00154,India
792702,2023-03-23,502,iphone 15 pro max,100000,135000,35000,1,00154,India
792702,2023-03-23,507,washing machine,6990,16490,9500,1,00154,India
248432,2023-03-23,506,monitor,3249,8000,4751,1,00179,India
248432,2023-03-23,502,iphone 15 pro max,100000,135000,35000,1,00179,India
248432,2023-03-23,501,iphone 15,60000,80000,20000,1,00179,India
238633,2023-03-23,506,monitor,3249,8000,4751,1,00261,India
238633,2023-03-23,507,washing machine,6990,16490,9500,1,00261,India
930292,2023-03-23,507,washing machine,6990,16490,9500,1,00132,India
930292,2023-03-23,504,iron,449,879,430,1,00132,India
930292,2023-03-23,506,monitor,3249,8000,4751,1,00132,India
930292,2023-03-23,501,iphone 15,60000,80000,20000,1,00132,India
867370,2023-03-23,507,washing machine,6990,16490,9500,1,00206,India
867370,2023-03-23,506,monitor,3249,8000,4751,1,00206,India
864371,2023-03-23,501,iphone 15,60000,80000,20000,1,00378,India
602241,2023-03-23,504,iron,449,879,430,1,00280,India
548935,2023-03-23,503,mixer,1349,3249,1900,1,00450,India
548935,2023-03-23,504,iron,449,879,430,1,00450,India
548935,2023-03-23,501,iphone 15,60000,80000,20000,1,00450,India
242227,2023-03-23,506,monitor,3249,8000,4751,1,00436,India
832905,2023-03-23,501,iphone 15,60000,80000,20000,1,00066,India
832905,2023-03-23,503,mixer,1349,3249,1900,1,00066,India
832905,2023-03-23,505,oven,18490,24000,5510,1,00066,India
243570,2023-03-23,504,iron,449,879,430,1,00316,India
243570,2023-03-23,503,mixer,1349,3249,1900,1,00316,India
143603,2023-03-23,501,iphone 15,60000,80000,20000,1,00483,India
143603,2023-03-23,505,oven,18490,24000,5510,1,00483,India
143603,2023-03-23,506,monitor,3249,8000,4751,1,00483,India
411562,2023-03-23,504,iron,449,879,430,1,00178,India
821305,2023-03-23,503,mixer,1349,3249,1900,1,00279,India
821305,2023-03-23,501,iphone 15,60000,80000,20000,1,00279,India
821305,2023-03-23,502,iphone 15 pro max,100000,135000,35000,1,00279,India
821305,2023-03-23,507,washing machine,6990,16490,9500,1,00279,India
959487,2023-03-23,501,iphone 15,60000,80000,20000,1,00347,India
959487,2023-03-23,504,iron,449,879,430,1,00347,India
959487,2023-03-23,506,monitor,3249,8000,4751,1,00347,India
959487,2023-03-23,503,mixer,1349,3249,1900,1,00347,India
562868,2023-03-23,507,washing machine,6990,16490,9500,1,00441,India
562868,2023-03-23,505,oven,18490,24000,5510,1,00441,India
562868,2023-03-23,502,iphone 15 pro max,100000,135000,35000,1,00441,India
553186,2023-03-23,507,washing machine,6990,16490,9500,1,00026,India
553186,2023-03-23,506,monitor,3249,8000,4751,1,00026,India
661094,2023-03-23,505,oven,18490,24000,5510,1,00031,India
661094,2023-03-23,503,mixer,1349,3249,1900,1,00031,India
661094,2023-03-23,507,washing machine,6990,16490,9500,1,00031,India
661094,2023-03-23,506,monitor,3249,8000,4751,1,00031,India
412404,2023-03-23,501,iphone 15,60000,80000,20000,1,00047,India
412404,2023-03-23,506,monitor,3249,8000,4751,1,00047,India
381437,2023-03-23,506,monitor,3249,8000,4751,1,00119,India
381437,2023-03-23,503,mixer,1349,3249,1900,1,00119,India
731918,2023-03-23,506,monitor,3249,8000,4751,1,00028,India
731918,2023-03-23,507,washing machine,6990,16490,9500,1,00028,India
731918,2023-03-23,505,oven,18490,24000,5510,1,00028,India
731918,2023-03-23,503,mixer,1349,3249,1900,1,00028,India
385622,2023-03-23,505,oven,18490,24000,5510,1,00098,India
828600,2023-03-23,504,iron,449,879,430,1,00105,India
828600,2023-03-23,507,washing machine,6990,16490,9500,1,00105,India
796564,2023-03-23,503,mixer,1349,3249,1900,1,00302,India
330579,2023-03-23,507,washing machine,6990,16490,9500,1,00459,India
330579,2023-03-23,502,iphone 15 pro max,100000,135000,35000,1,00459,India
271722,2023-03-23,502,iphone 15 pro max,100000,135000,35000,1,00297,India
271722,2023-03-23,506,monitor,3249,8000,4751,1,00297,India
269911,2023-03-23,501,iphone 15,60000,80000,20000,1,00127,India
607279,2023-03-23,503,mixer,1349,3249,1900,1,00221,India
607279,2023-03-23,507,washing machine,6990,16490,9500,1,00221,India
607279,2023-03-23,501,iphone 15,60000,80000,20000,1,00221,India
607279,2023-03-23,504,iron,449,879,430,1,00221,India
236268,2023-03-23,506,monitor,3249,8000,4751,1,00191,India
852318,2023-03-23,503,mixer,1349,3249,1900,1,00247,India
540757,2023-03-24,501,iphone 15,60000,80000,20000,1,00449,India
540757,2023-03-24,505,oven,18490,24000,5510,1,00449,India
403305,2023-03-24,504,iron,449,879,430,1,00445,India
403305,2023-03-24,501,iphone 15,60000,80000,20000,1,00445,India
291752,2023-03-24,506,monitor,3249,8000,4751,1,00138,India
291752,2023-03-24,505,oven,18490,24000,5510,1,00138,India
291752,2023-03-24,502,iphone 15 pro max,100000,135000,35000,1,00138,India
291752,2023-03-24,501,iphone 15,60000,80000,20000,1,00138,India
280366,2023-03-24,505,oven,18490,24000,5510,1,00221,India
280366,2023-03-24,506,monitor,3249,8000,4751,1,00221,India
459563,2023-03-24,501,iphone 15,60000,80000,20000,1,00167,India
459563,2023-03-24,503,mixer,1349,3249,1900,1,00167,India
459563,2023-03-24,507,washing machine,6990,16490,9500,1,00167,India
459563,2023-03-24,502,iphone 15 pro max,100000,135000,35000,1,00167,India
982186,2023-03-24,502,iphone 15 pro max,100000,135000,35000,1,00393,India
817515,2023-03-24,504,iron,449,879,430,1,00433,India
650935,2023-03-24,506,monitor,3249,8000,4751,1,00361,India
650935,2023-03-24,502,iphone 15 pro max,100000,135000,35000,1,00361,India
650935,2023-03-24,504,iron,449,879,430,1,00361,India
388869,2023-03-24,502,iphone 15 pro max,100000,135000,35000,1,00431,India
388869,2023-03-24,506,monitor,3249,8000,4751,1,00431,India
100201,2023-03-24,504,iron,449,879,430,1,00170,India
997439,2023-03-24,507,washing machine,6990,16490,9500,1,00495,India
997439,2023-03-24,503,mixer,1349,3249,1900,1,00495,India
255808,2023-03-24,502,iphone 15 pro max,100000,135000,35000,1,00222,India
255808,2023-03-24,507,washing machine,6990,16490,9500,1,00222,India
255808,2023-03-24,501,iphone 15,60000,80000,20000,1,00222,India
143785,2023-03-24,502,iphone 15 pro max,100000,135000,35000,1,00244,India
143785,2023-03-24,501,iphone 15,60000,80000,20000,1,00244,India
143785,2023-03-24,506,monitor,3249,8000,4751,1,00244,India
203532,2023-03-24,502,iphone 15 pro max,100000,135000,35000,1,00448,India
203532,2023-03-24,504,iron,449,879,430,1,00448,India
203532,2023-03-24,507,washing machine,6990,16490,9500,1,00448,India
856451,2023-03-24,503,mixer,1349,3249,1900,1,00170,India
856451,2023-03-24,506,monitor,3249,8000,4751,1,00170,India
856451,2023-03-24,501,iphone 15,60000,80000,20000,1,00170,India
856451,2023-03-24,502,iphone 15 pro max,100000,135000,35000,1,00170,India
510809,2023-03-24,502,iphone 15 pro max,100000,135000,35000,1,00483,India
510809,2023-03-24,503,mixer,1349,3249,1900,1,00483,India
510809,2023-03-24,505,oven,18490,24000,5510,1,00483,India
510809,2023-03-24,501,iphone 15,60000,80000,20000,1,00483,India
569200,2023-03-24,502,iphone 15 pro max,100000,135000,35000,1,00152,India
569200,2023-03-24,506,monitor,3249,8000,4751,1,00152,India
797611,2023-03-24,505,oven,18490,24000,5510,1,00317,India
797611,2023-03-24,501,iphone 15,60000,80000,20000,1,00317,India
797611,2023-03-24,503,mixer,1349,3249,1900,1,00317,India
108275,2023-03-24,501,iphone 15,60000,80000,20000,1,00464,India
615497,2023-03-24,506,monitor,3249,8000,4751,1,00022,India
615497,2023-03-24,507,washing machine,6990,16490,9500,1,00022,India
615497,2023-03-24,503,mixer,1349,3249,1900,1,00022,India
615497,2023-03-24,501,iphone 15,60000,80000,20000,1,00022,India
421547,2023-03-24,506,monitor,3249,8000,4751,1,00246,India
421547,2023-03-24,505,oven,18490,24000,5510,1,00246,India
661539,2023-03-24,506,monitor,3249,8000,4751,1,00467,India
661539,2023-03-24,502,iphone 15 pro max,100000,135000,35000,1,00467,India
661539,2023-03-24,505,oven,18490,24000,5510,1,00467,India
661539,2023-03-24,504,iron,449,879,430,1,00467,India
661539,2023-03-24,507,washing machine,6990,16490,9500,1,00467,India
566029,2023-03-24,504,iron,449,879,430,1,00028,India
566029,2023-03-24,506,monitor,3249,8000,4751,1,00028,India
531253,2023-03-24,507,washing machine,6990,16490,9500,1,00005,India
531253,2023-03-24,506,monitor,3249,8000,4751,1,00005,India
531253,2023-03-24,505,oven,18490,24000,5510,1,00005,India
531253,2023-03-24,503,mixer,1349,3249,1900,1,00005,India
294274,2023-03-24,503,mixer,1349,3249,1900,1,00364,India
294274,2023-03-24,501,iphone 15,60000,80000,20000,1,00364,India
294274,2023-03-24,506,monitor,3249,8000,4751,1,00364,India
294274,2023-03-24,507,washing machine,6990,16490,9500,1,00364,India
859302,2023-03-24,503,mixer,1349,3249,1900,1,00312,India
859302,2023-03-24,504,iron,449,879,430,1,00312,India
859302,2023-03-24,507,washing machine,6990,16490,9500,1,00312,India
859302,2023-03-24,505,oven,18490,24000,5510,1,00312,India
859302,2023-03-24,506,monitor,3249,8000,4751,1,00312,India
451953,2023-03-24,501,iphone 15,60000,80000,20000,1,00068,India
451953,2023-03-24,506,monitor,3249,8000,4751,1,00068,India
464638,2023-03-24,507,washing machine,6990,16490,9500,1,00082,India
464638,2023-03-24,502,iphone 15 pro max,100000,135000,35000,1,00082,India
464638,2023-03-24,503,mixer,1349,3249,1900,1,00082,India
766393,2023-03-24,503,mixer,1349,3249,1900,1,00255,India
766393,2023-03-24,502,iphone 15 pro max,100000,135000,35000,1,00255,India
766393,2023-03-24,504,iron,449,879,430,1,00255,India
766393,2023-03-24,506,monitor,3249,8000,4751,1,00255,India
813808,2023-03-24,503,mixer,1349,3249,1900,1,00217,India
185728,2023-03-24,505,oven,18490,24000,5510,1,00343,India
185728,2023-03-24,507,washing machine,6990,16490,9500,1,00343,India
530503,2023-03-24,503,mixer,1349,3249,1900,1,00069,India
488839,2023-03-24,507,washing machine,6990,16490,9500,1,00467,India
136657,2023-03-24,505,oven,18490,24000,5510,1,00223,India
136657,2023-03-24,503,mixer,1349,3249,1900,1,00223,India
136657,2023-03-24,501,iphone 15,60000,80000,20000,1,00223,India
348342,2023-03-24,506,monitor,3249,8000,4751,1,00002,India
284845,2023-03-24,506,monitor,3249,8000,4751,1,00250,India
284845,2023-03-24,503,mixer,1349,3249,1900,1,00250,India
284845,2023-03-24,505,oven,18490,24000,5510,1,00250,India
140268,2023-03-24,507,washing machine,6990,16490,9500,1,00222,India
755939,2023-03-24,504,iron,449,879,430,1,00361,India
755939,2023-03-24,507,washing machine,6990,16490,9500,1,00361,India
755939,2023-03-24,502,iphone 15 pro max,100000,135000,35000,1,00361,India
755939,2023-03-24,501,iphone 15,60000,80000,20000,1,00361,India
755939,2023-03-24,506,monitor,3249,8000,4751,1,00361,India
180299,2023-03-24,503,mixer,1349,3249,1900,1,00211,India
180299,2023-03-24,502,iphone 15 pro max,100000,135000,35000,1,00211,India
180299,2023-03-24,501,iphone 15,60000,80000,20000,1,00211,India
430888,2023-03-24,505,oven,18490,24000,5510,1,00233,India
430888,2023-03-24,504,iron,449,879,430,1,00233,India
430888,2023-03-24,501,iphone 15,60000,80000,20000,1,00233,India
699666,2023-03-24,501,iphone 15,60000,80000,20000,1,00193,India
487507,2023-03-24,502,iphone 15 pro max,100000,135000,35000,1,00184,India
487507,2023-03-24,507,washing machine,6990,16490,9500,1,00184,India
487507,2023-03-24,506,monitor,3249,8000,4751,1,00184,India
421235,2023-03-24,504,iron,449,879,430,1,00489,India
421235,2023-03-24,503,mixer,1349,3249,1900,1,00489,India
106006,2023-03-24,502,iphone 15 pro max,100000,135000,35000,1,00302,India
298569,2023-03-24,505,oven,18490,24000,5510,1,00204,India
298569,2023-03-24,506,monitor,3249,8000,4751,1,00204,India
298569,2023-03-24,504,iron,449,879,430,1,00204,India
298569,2023-03-24,502,iphone 15 pro max,100000,135000,35000,1,00204,India
887088,2023-03-24,504,iron,449,879,430,1,00269,India
371714,2023-03-24,501,iphone 15,60000,80000,20000,1,00404,India
260153,2023-03-24,507,washing machine,6990,16490,9500,1,00178,India
260153,2023-03-24,504,iron,449,879,430,1,00178,India
260153,2023-03-24,506,monitor,3249,8000,4751,1,00178,India
260153,2023-03-24,505,oven,18490,24000,5510,1,00178,India
260153,2023-03-24,501,iphone 15,60000,80000,20000,1,00178,India
295568,2023-03-24,506,monitor,3249,8000,4751,1,00176,India
295568,2023-03-24,507,washing machine,6990,16490,9500,1,00176,India
295568,2023-03-24,503,mixer,1349,3249,1900,1,00176,India
334078,2023-03-24,507,washing machine,6990,16490,9500,1,00147,India
265688,2023-03-24,505,oven,18490,24000,5510,1,00099,India
265688,2023-03-24,507,washing machine,6990,16490,9500,1,00099,India
265688,2023-03-24,504,iron,449,879,430,1,00099,India
265688,2023-03-24,506,monitor,3249,8000,4751,1,00099,India
819403,2023-03-24,501,iphone 15,60000,80000,20000,1,00045,India
819403,2023-03-24,505,oven,18490,24000,5510,1,00045,India
819403,2023-03-24,502,iphone 15 pro max,100000,135000,35000,1,00045,India
489720,2023-03-25,503,mixer,1349,3249,1900,1,00184,India
489720,2023-03-25,502,iphone 15 pro max,100000,135000,35000,1,00184,India
489720,2023-03-25,507,washing machine,6990,16490,9500,1,00184,India
108365,2023-03-25,501,iphone 15,60000,80000,20000,1,00121,India
108365,2023-03-25,504,iron,449,879,430,1,00121,India
563482,2023-03-25,506,monitor,3249,8000,4751,1,00044,India
563482,2023-03-25,505,oven,18490,24000,5510,1,00044,India
563482,2023-03-25,504,iron,449,879,430,1,00044,India
625876,2023-03-25,501,iphone 15,60000,80000,20000,1,00288,India
625876,2023-03-25,502,iphone 15 pro max,100000,135000,35000,1,00288,India
530048,2023-03-25,501,iphone 15,60000,80000,20000,1,00341,India
987132,2023-03-25,506,monitor,3249,8000,4751,1,00275,India
987132,2023-03-25,504,iron,449,879,430,1,00275,India
987132,2023-03-25,502,iphone 15 pro max,100000,135000,35000,1,00275,India
433099,2023-03-25,501,iphone 15,60000,80000,20000,1,00039,India
433099,2023-03-25,507,washing machine,6990,16490,9500,1,00039,India
433099,2023-03-25,502,iphone 15 pro max,100000,135000,35000,1,00039,India
826772,2023-03-25,503,mixer,1349,3249,1900,1,00263,India
826772,2023-03-25,507,washing machine,6990,16490,9500,1,00263,India
829382,2023-03-25,503,mixer,1349,3249,1900,1,00298,India
829382,2023-03-25,505,oven,18490,24000,5510,1,00298,India
829382,2023-03-25,504,iron,449,879,430,1,00298,India
829382,2023-03-25,502,iphone 15 pro max,100000,135000,35000,1,00298,India
386937,2023-03-25,504,iron,449,879,430,1,00363,India
386937,2023-03-25,501,iphone 15,60000,80000,20000,1,00363,India
386937,2023-03-25,503,mixer,1349,3249,1900,1,00363,India
386937,2023-03-25,506,monitor,3249,8000,4751,1,00363,India
904369,2023-03-25,501,iphone 15,60000,80000,20000,1,00398,India
904369,2023-03-25,503,mixer,1349,3249,1900,1,00398,India
356646,2023-03-25,505,oven,18490,24000,5510,1,00258,India
356646,2023-03-25,507,washing machine,6990,16490,9500,1,00258,India
283832,2023-03-25,505,oven,18490,24000,5510,1,00006,India
283832,2023-03-25,507,washing machine,6990,16490,9500,1,00006,India
283832,2023-03-25,501,iphone 15,60000,80000,20000,1,00006,India
688145,2023-03-25,502,iphone 15 pro max,100000,135000,35000,1,00151,India
200303,2023-03-25,503,mixer,1349,3249,1900,1,00004,India
680599,2023-03-25,505,oven,18490,24000,5510,1,00178,India
680599,2023-03-25,504,iron,449,879,430,1,00178,India
680599,2023-03-25,503,mixer,1349,3249,1900,1,00178,India
987025,2023-03-25,503,mixer,1349,3249,1900,1,00077,India
812147,2023-03-25,506,monitor,3249,8000,4751,1,00339,India
812147,2023-03-25,503,mixer,1349,3249,1900,1,00339,India
812147,2023-03-25,507,washing machine,6990,16490,9500,1,00339,India
267242,2023-03-25,502,iphone 15 pro max,100000,135000,35000,1,00413,India
267242,2023-03-25,504,iron,449,879,430,1,00413,India
267242,2023-03-25,503,mixer,1349,3249,1900,1,00413,India
267242,2023-03-25,505,oven,18490,24000,5510,1,00413,India
437287,2023-03-25,502,iphone 15 pro max,100000,135000,35000,1,00484,India
437287,2023-03-25,506,monitor,3249,8000,4751,1,00484,India
437287,2023-03-25,507,washing machine,6990,16490,9500,1,00484,India
437287,2023-03-25,501,iphone 15,60000,80000,20000,1,00484,India
720614,2023-03-25,504,iron,449,879,430,1,00355,India
720614,2023-03-25,502,iphone 15 pro max,100000,135000,35000,1,00355,India
548249,2023-03-25,507,washing machine,6990,16490,9500,1,00243,India
548249,2023-03-25,502,iphone 15 pro max,100000,135000,35000,1,00243,India
655253,2023-03-25,502,iphone 15 pro max,100000,135000,35000,1,00057,India
655253,2023-03-25,504,iron,449,879,430,1,00057,India
572354,2023-03-25,507,washing machine,6990,16490,9500,1,00458,India
572354,2023-03-25,503,mixer,1349,3249,1900,1,00458,India
444857,2023-03-25,503,mixer,1349,3249,1900,1,00141,India
444857,2023-03-25,506,monitor,3249,8000,4751,1,00141,India
444857,2023-03-25,502,iphone 15 pro max,100000,135000,35000,1,00141,India
603398,2023-03-25,507,washing machine,6990,16490,9500,1,00346,India
603398,2023-03-25,505,oven,18490,24000,5510,1,00346,India
603398,2023-03-25,502,iphone 15 pro max,100000,135000,35000,1,00346,India
892398,2023-03-25,507,washing machine,6990,16490,9500,1,00041,India
892398,2023-03-25,502,iphone 15 pro max,100000,135000,35000,1,00041,India
892398,2023-03-25,503,mixer,1349,3249,1900,1,00041,India
437718,2023-03-25,505,oven,18490,24000,5510,1,00097,India
437718,2023-03-25,504,iron,449,879,430,1,00097,India
437718,2023-03-25,506,monitor,3249,8000,4751,1,00097,India
437718,2023-03-25,507,washing machine,6990,16490,9500,1,00097,India
512297,2023-03-25,505,oven,18490,24000,5510,1,00233,India
512297,2023-03-25,501,iphone 15,60000,80000,20000,1,00233,India
620901,2023-03-25,506,monitor,3249,8000,4751,1,00279,India
620901,2023-03-25,504,iron,449,879,430,1,00279,India
620901,2023-03-25,505,oven,18490,24000,5510,1,00279,India
620901,2023-03-25,503,mixer,1349,3249,1900,1,00279,India
620901,2023-03-25,507,washing machine,6990,16490,9500,1,00279,India
358781,2023-03-25,503,mixer,1349,3249,1900,1,00068,India
358781,2023-03-25,507,washing machine,6990,16490,9500,1,00068,India
410928,2023-03-25,501,iphone 15,60000,80000,20000,1,00441,India
410928,2023-03-25,507,washing machine,6990,16490,9500,1,00441,India
165208,2023-03-25,503,mixer,1349,3249,1900,1,00371,India
165208,2023-03-25,507,washing machine,6990,16490,9500,1,00371,India
661253,2023-03-25,503,mixer,1349,3249,1900,1,00446,India
661253,2023-03-25,502,iphone 15 pro max,100000,135000,35000,1,00446,India
661253,2023-03-25,501,iphone 15,60000,80000,20000,1,00446,India
899045,2023-03-25,503,mixer,1349,3249,1900,1,00412,India
899045,2023-03-25,501,iphone 15,60000,80000,20000,1,00412,India
899045,2023-03-25,502,iphone 15 pro max,100000,135000,35000,1,00412,India
899045,2023-03-25,505,oven,18490,24000,5510,1,00412,India
494514,2023-03-25,507,washing machine,6990,16490,9500,1,00171,India
494514,2023-03-25,505,oven,18490,24000,5510,1,00171,India
494514,2023-03-25,503,mixer,1349,3249,1900,1,00171,India
494514,2023-03-25,501,iphone 15,60000,80000,20000,1,00171,India
346694,2023-03-25,501,iphone 15,60000,80000,20000,1,00249,India
346694,2023-03-25,503,mixer,1349,3249,1900,1,00249,India
346694,2023-03-25,506,monitor,3249,8000,4751,1,00249,India
346694,2023-03-25,507,washing machine,6990,16490,9500,1,00249,India
406515,2023-03-25,503,mixer,1349,3249,1900,1,00061,India
139629,2023-03-25,501,iphone 15,60000,80000,20000,1,00338,India
139629,2023-03-25,506,monitor,3249,8000,4751,1,00338,India
139629,2023-03-25,504,iron,449,879,430,1,00338,India
873243,2023-03-25,503,mixer,1349,3249,1900,1,00477,India
873243,2023-03-25,506,monitor,3249,8000,4751,1,00477,India
620669,2023-03-25,502,iphone 15 pro max,100000,135000,35000,1,00452,India
620669,2023-03-25,505,oven,18490,24000,5510,1,00452,India
143852,2023-03-25,502,iphone 15 pro max,100000,135000,35000,1,00392,India
143852,2023-03-25,501,iphone 15,60000,80000,20000,1,00392,India
143852,2023-03-25,507,washing machine,6990,16490,9500,1,00392,India
143852,2023-03-25,503,mixer,1349,3249,1900,1,00392,India
277324,2023-03-25,502,iphone 15 pro max,100000,135000,35000,1,00391,India
277324,2023-03-25,503,mixer,1349,3249,1900,1,00391,India
277324,2023-03-25,507,washing machine,6990,16490,9500,1,00391,India
659067,2023-03-25,504,iron,449,879,430,1,00157,India
659067,2023-03-25,507,washing machine,6990,16490,9500,1,00157,India
124963,2023-03-25,505,oven,18490,24000,5510,1,00091,India
124963,2023-03-25,503,mixer,1349,3249,1900,1,00091,India
124963,2023-03-25,507,washing machine,6990,16490,9500,1,00091,India
124963,2023-03-25,504,iron,449,879,430,1,00091,India
457874,2023-03-25,506,monitor,3249,8000,4751,1,00426,India
762349,2023-03-25,503,mixer,1349,3249,1900,1,00257,India
762349,2023-03-25,502,iphone 15 pro max,100000,135000,35000,1,00257,India
762349,2023-03-25,506,monitor,3249,8000,4751,1,00257,India
193897,2023-03-25,503,mixer,1349,3249,1900,1,00174,India
193897,2023-03-25,506,monitor,3249,8000,4751,1,00174,India
915107,2023-03-25,507,washing machine,6990,16490,9500,1,00351,India
915107,2023-03-25,502,iphone 15 pro max,100000,135000,35000,1,00351,India
630216,2023-03-25,506,monitor,3249,8000,4751,1,00045,India
630216,2023-03-25,501,iphone 15,60000,80000,20000,1,00045,India
603590,2023-03-25,505,oven,18490,24000,5510,1,00378,India
603590,2023-03-25,506,monitor,3249,8000,4751,1,00378,India
603590,2023-03-25,501,iphone 15,60000,80000,20000,1,00378,India
117482,2023-03-25,507,washing machine,6990,16490,9500,1,00051,India
346841,2023-03-25,504,iron,449,879,430,1,00334,India
346841,2023-03-25,506,monitor,3249,8000,4751,1,00334,India
686753,2023-03-25,506,monitor,3249,8000,4751,1,00419,India
686753,2023-03-25,502,iphone 15 pro max,100000,135000,35000,1,00419,India
836898,2023-03-25,502,iphone 15 pro max,100000,135000,35000,1,00443,India
836898,2023-03-25,505,oven,18490,24000,5510,1,00443,India
263784,2023-03-25,502,iphone 15 pro max,100000,135000,35000,1,00081,India
263784,2023-03-25,503,mixer,1349,3249,1900,1,00081,India
263784,2023-03-25,501,iphone 15,60000,80000,20000,1,00081,India
263784,2023-03-25,505,oven,18490,24000,5510,1,00081,India
289317,2023-03-25,502,iphone 15 pro max,100000,135000,35000,1,00377,India
289317,2023-03-25,504,iron,449,879,430,1,00377,India
289317,2023-03-25,507,washing machine,6990,16490,9500,1,00377,India
535242,2023-03-25,503,mixer,1349,3249,1900,1,00469,India
535242,2023-03-25,504,iron,449,879,430,1,00469,India
535242,2023-03-25,507,washing machine,6990,16490,9500,1,00469,India
535242,2023-03-25,501,iphone 15,60000,80000,20000,1,00469,India
131807,2023-03-25,507,washing machine,6990,16490,9500,1,00498,India
131807,2023-03-25,501,iphone 15,60000,80000,20000,1,00498,India
131807,2023-03-25,503,mixer,1349,3249,1900,1,00498,India
131807,2023-03-25,504,iron,449,879,430,1,00498,India
491947,2023-03-25,506,monitor,3249,8000,4751,1,00099,India
703899,2023-03-25,504,iron,449,879,430,1,00352,India
703899,2023-03-25,507,washing machine,6990,16490,9500,1,00352,India
703899,2023-03-25,503,mixer,1349,3249,1900,1,00352,India
703899,2023-03-25,501,iphone 15,60000,80000,20000,1,00352,India
703899,2023-03-25,506,monitor,3249,8000,4751,1,00352,India
908432,2023-03-25,503,mixer,1349,3249,1900,1,00409,India
834457,2023-03-25,504,iron,449,879,430,1,00378,India
834457,2023-03-25,503,mixer,1349,3249,1900,1,00378,India
903102,2023-03-25,507,washing machine,6990,16490,9500,1,00490,India
903102,2023-03-25,505,oven,18490,24000,5510,1,00490,India
903102,2023-03-25,502,iphone 15 pro max,100000,135000,35000,1,00490,India
329154,2023-03-25,503,mixer,1349,3249,1900,1,00186,India
329154,2023-03-25,505,oven,18490,24000,5510,1,00186,India
329154,2023-03-25,504,iron,449,879,430,1,00186,India
329154,2023-03-25,501,iphone 15,60000,80000,20000,1,00186,India
329154,2023-03-25,507,washing machine,6990,16490,9500,1,00186,India
891594,2023-03-25,507,washing machine,6990,16490,9500,1,00160,India
891594,2023-03-25,503,mixer,1349,3249,1900,1,00160,India
942929,2023-03-25,505,oven,18490,24000,5510,1,00461,India
439493,2023-03-25,501,iphone 15,60000,80000,20000,1,00328,India
522836,2023-03-25,501,iphone 15,60000,80000,20000,1,00116,India
522836,2023-03-25,502,iphone 15 pro max,100000,135000,35000,1,00116,India
827484,2023-03-25,502,iphone 15 pro max,100000,135000,35000,1,00348,India
827484,2023-03-25,505,oven,18490,24000,5510,1,00348,India
912046,2023-03-25,502,iphone 15 pro max,100000,135000,35000,1,00285,India
912046,2023-03-25,504,iron,449,879,430,1,00285,India
912046,2023-03-25,505,oven,18490,24000,5510,1,00285,India
814750,2023-03-25,507,washing machine,6990,16490,9500,1,00428,India
814750,2023-03-25,501,iphone 15,60000,80000,20000,1,00428,India
755755,2023-03-25,506,monitor,3249,8000,4751,1,00111,India
584411,2023-03-25,502,iphone 15 pro max,100000,135000,35000,1,00004,India
584411,2023-03-25,506,monitor,3249,8000,4751,1,00004,India
584411,2023-03-25,507,washing machine,6990,16490,9500,1,00004,India
425983,2023-03-25,504,iron,449,879,430,1,00073,India
425983,2023-03-25,502,iphone 15 pro max,100000,135000,35000,1,00073,India
425983,2023-03-25,503,mixer,1349,3249,1900,1,00073,India
425983,2023-03-25,507,washing machine,6990,16490,9500,1,00073,India
933991,2023-03-25,503,mixer,1349,3249,1900,1,00091,India
527652,2023-03-25,502,iphone 15 pro max,100000,135000,35000,1,00380,India
353467,2023-03-25,506,monitor,3249,8000,4751,1,00415,India
353467,2023-03-25,503,mixer,1349,3249,1900,1,00415,India
449992,2023-03-25,504,iron,449,879,430,1,00184,India
449992,2023-03-25,501,iphone 15,60000,80000,20000,1,00184,India
449992,2023-03-25,507,washing machine,6990,16490,9500,1,00184,India
449992,2023-03-25,506,monitor,3249,8000,4751,1,00184,India
392908,2023-03-25,507,washing machine,6990,16490,9500,1,00426,India
392908,2023-03-25,505,oven,18490,24000,5510,1,00426,India
392908,2023-03-25,506,monitor,3249,8000,4751,1,00426,India
392908,2023-03-25,504,iron,449,879,430,1,00426,India
127932,2023-03-25,507,washing machine,6990,16490,9500,1,00356,India
391037,2023-03-25,506,monitor,3249,8000,4751,1,00117,India
391037,2023-03-25,503,mixer,1349,3249,1900,1,00117,India
391037,2023-03-25,505,oven,18490,24000,5510,1,00117,India
741693,2023-03-25,507,washing machine,6990,16490,9500,1,00425,India
741693,2023-03-25,503,mixer,1349,3249,1900,1,00425,India
741693,2023-03-25,504,iron,449,879,430,1,00425,India
820306,2023-03-25,507,washing machine,6990,16490,9500,1,00256,India
820306,2023-03-25,502,iphone 15 pro max,100000,135000,35000,1,00256,India
320753,2023-03-25,505,oven,18490,24000,5510,1,00018,India
320753,2023-03-25,507,washing machine,6990,16490,9500,1,00018,India
320753,2023-03-25,506,monitor,3249,8000,4751,1,00018,India
600860,2023-03-25,507,washing machine,6990,16490,9500,1,00085,India
600860,2023-03-25,501,iphone 15,60000,80000,20000,1,00085,India
515867,2023-03-25,501,iphone 15,60000,80000,20000,1,00374,India
515867,2023-03-25,507,washing machine,6990,16490,9500,1,00374,India
515867,2023-03-25,502,iphone 15 pro max,100000,135000,35000,1,00374,India
799679,2023-03-25,504,iron,449,879,430,1,00460,India
799679,2023-03-25,501,iphone 15,60000,80000,20000,1,00460,India
799679,2023-03-25,506,monitor,3249,8000,4751,1,00460,India
932852,2023-03-25,503,mixer,1349,3249,1900,1,00352,India
420440,2023-03-25,507,washing machine,6990,16490,9500,1,00201,India
420440,2023-03-25,505,oven,18490,24000,5510,1,00201,India
420440,2023-03-25,502,iphone 15 pro max,100000,135000,35000,1,00201,India
420440,2023-03-25,501,iphone 15,60000,80000,20000,1,00201,India
838273,2023-03-25,501,iphone 15,60000,80000,20000,1,00293,India
838273,2023-03-25,507,washing machine,6990,16490,9500,1,00293,India
838273,2023-03-25,504,iron,449,879,430,1,00293,India
838273,2023-03-25,506,monitor,3249,8000,4751,1,00293,India
137176,2023-03-25,504,iron,449,879,430,1,00068,India
137176,2023-03-25,506,monitor,3249,8000,4751,1,00068,India
137176,2023-03-25,502,iphone 15 pro max,100000,135000,35000,1,00068,India
137176,2023-03-25,505,oven,18490,24000,5510,1,00068,India
708294,2023-03-25,507,washing machine,6990,16490,9500,1,00446,India
628980,2023-03-26,507,washing machine,6990,16490,9500,1,00024,India
628980,2023-03-26,506,monitor,3249,8000,4751,1,00024,India
628980,2023-03-26,504,iron,449,879,430,1,00024,India
188019,2023-03-26,503,mixer,1349,3249,1900,1,00365,India
864898,2023-03-26,501,iphone 15,60000,80000,20000,1,00378,India
864898,2023-03-26,506,monitor,3249,8000,4751,1,00378,India
864898,2023-03-26,503,mixer,1349,3249,1900,1,00378,India
864898,2023-03-26,502,iphone 15 pro max,100000,135000,35000,1,00378,India
377419,2023-03-26,502,iphone 15 pro max,100000,135000,35000,1,00272,India
377419,2023-03-26,501,iphone 15,60000,80000,20000,1,00272,India
377419,2023-03-26,506,monitor,3249,8000,4751,1,00272,India
377419,2023-03-26,503,mixer,1349,3249,1900,1,00272,India
686506,2023-03-26,505,oven,18490,24000,5510,1,00378,India
686506,2023-03-26,502,iphone 15 pro max,100000,135000,35000,1,00378,India
686506,2023-03-26,504,iron,449,879,430,1,00378,India
151351,2023-03-26,503,mixer,1349,3249,1900,1,00472,India
151351,2023-03-26,505,oven,18490,24000,5510,1,00472,India
106687,2023-03-26,504,iron,449,879,430,1,00366,India
106687,2023-03-26,506,monitor,3249,8000,4751,1,00366,India
346863,2023-03-26,504,iron,449,879,430,1,00138,India
346863,2023-03-26,503,mixer,1349,3249,1900,1,00138,India
715007,2023-03-26,505,oven,18490,24000,5510,1,00409,India
304961,2023-03-26,503,mixer,1349,3249,1900,1,00097,India
304961,2023-03-26,501,iphone 15,60000,80000,20000,1,00097,India
889250,2023-03-26,507,washing machine,6990,16490,9500,1,00161,India
889250,2023-03-26,503,mixer,1349,3249,1900,1,00161,India
949454,2023-03-26,505,oven,18490,24000,5510,1,00013,India
949454,2023-03-26,502,iphone 15 pro max,100000,135000,35000,1,00013,India
938827,2023-03-26,504,iron,449,879,430,1,00009,India
938827,2023-03-26,503,mixer,1349,3249,1900,1,00009,India
938827,2023-03-26,502,iphone 15 pro max,100000,135000,35000,1,00009,India
468759,2023-03-26,502,iphone 15 pro max,100000,135000,35000,1,00219,India
468759,2023-03-26,505,oven,18490,24000,5510,1,00219,India
468759,2023-03-26,506,monitor,3249,8000,4751,1,00219,India
468759,2023-03-26,501,iphone 15,60000,80000,20000,1,00219,India
271892,2023-03-26,503,mixer,1349,3249,1900,1,00271,India
271892,2023-03-26,505,oven,18490,24000,5510,1,00271,India
271892,2023-03-26,507,washing machine,6990,16490,9500,1,00271,India
356286,2023-03-26,503,mixer,1349,3249,1900,1,00337,India
356286,2023-03-26,507,washing machine,6990,16490,9500,1,00337,India
356286,2023-03-26,506,monitor,3249,8000,4751,1,00337,India
356286,2023-03-26,505,oven,18490,24000,5510,1,00337,India
356732,2023-03-26,502,iphone 15 pro max,100000,135000,35000,1,00377,India
356732,2023-03-26,505,oven,18490,24000,5510,1,00377,India
833843,2023-03-26,505,oven,18490,24000,5510,1,00379,India
833843,2023-03-26,501,iphone 15,60000,80000,20000,1,00379,India
278730,2023-03-26,502,iphone 15 pro max,100000,135000,35000,1,00437,India
910369,2023-03-26,503,mixer,1349,3249,1900,1,00276,India
910369,2023-03-26,505,oven,18490,24000,5510,1,00276,India
342426,2023-03-26,502,iphone 15 pro max,100000,135000,35000,1,00199,India
175414,2023-03-26,501,iphone 15,60000,80000,20000,1,00114,India
175414,2023-03-26,503,mixer,1349,3249,1900,1,00114,India
175414,2023-03-26,502,iphone 15 pro max,100000,135000,35000,1,00114,India
542126,2023-03-26,507,washing machine,6990,16490,9500,1,00371,India
542126,2023-03-26,506,monitor,3249,8000,4751,1,00371,India
542126,2023-03-26,501,iphone 15,60000,80000,20000,1,00371,India
493468,2023-03-26,503,mixer,1349,3249,1900,1,00184,India
493468,2023-03-26,507,washing machine,6990,16490,9500,1,00184,India
493468,2023-03-26,502,iphone 15 pro max,100000,135000,35000,1,00184,India
313516,2023-03-26,506,monitor,3249,8000,4751,1,00217,India
313516,2023-03-26,501,iphone 15,60000,80000,20000,1,00217,India
902064,2023-03-26,504,iron,449,879,430,1,00112,India
902064,2023-03-26,502,iphone 15 pro max,100000,135000,35000,1,00112,India
991499,2023-03-26,503,mixer,1349,3249,1900,1,00373,India
991499,2023-03-26,501,iphone 15,60000,80000,20000,1,00373,India
991499,2023-03-26,502,iphone 15 pro max,100000,135000,35000,1,00373,India
991499,2023-03-26,506,monitor,3249,8000,4751,1,00373,India
148233,2023-03-26,502,iphone 15 pro max,100000,135000,35000,1,00307,India
148233,2023-03-26,506,monitor,3249,8000,4751,1,00307,India
148233,2023-03-26,501,iphone 15,60000,80000,20000,1,00307,India
148233,2023-03-26,507,washing machine,6990,16490,9500,1,00307,India
718108,2023-03-26,507,washing machine,6990,16490,9500,1,00098,India
646257,2023-03-26,501,iphone 15,60000,80000,20000,1,00252,India
522370,2023-03-26,507,washing machine,6990,16490,9500,1,00005,India
522370,2023-03-26,502,iphone 15 pro max,100000,135000,35000,1,00005,India
993454,2023-03-26,505,oven,18490,24000,5510,1,00370,India
804081,2023-03-26,504,iron,449,879,430,1,00445,India
804081,2023-03-26,507,washing machine,6990,16490,9500,1,00445,India
804081,2023-03-26,502,iphone 15 pro max,100000,135000,35000,1,00445,India
882225,2023-03-26,507,washing machine,6990,16490,9500,1,00377,India
882225,2023-03-26,506,monitor,3249,8000,4751,1,00377,India
896612,2023-03-26,505,oven,18490,24000,5510,1,00415,India
434789,2023-03-26,503,mixer,1349,3249,1900,1,00154,India
434789,2023-03-26,507,washing machine,6990,16490,9500,1,00154,India
188057,2023-03-26,503,mixer,1349,3249,1900,1,00144,India
188057,2023-03-26,501,iphone 15,60000,80000,20000,1,00144,India
188057,2023-03-26,502,iphone 15 pro max,100000,135000,35000,1,00144,India
188057,2023-03-26,507,washing machine,6990,16490,9500,1,00144,India
188057,2023-03-26,504,iron,449,879,430,1,00144,India
393752,2023-03-26,504,iron,449,879,430,1,00306,India
712512,2023-03-26,503,mixer,1349,3249,1900,1,00243,India
712512,2023-03-26,505,oven,18490,24000,5510,1,00243,India
824079,2023-03-26,506,monitor,3249,8000,4751,1,00014,India
824079,2023-03-26,502,iphone 15 pro max,100000,135000,35000,1,00014,India
433660,2023-03-26,502,iphone 15 pro max,100000,135000,35000,1,00013,India
433660,2023-03-26,507,washing machine,6990,16490,9500,1,00013,India
433660,2023-03-26,506,monitor,3249,8000,4751,1,00013,India
604847,2023-03-26,501,iphone 15,60000,80000,20000,1,00354,India
817679,2023-03-26,506,monitor,3249,8000,4751,1,00408,India
620557,2023-03-26,503,mixer,1349,3249,1900,1,00470,India
620557,2023-03-26,507,washing machine,6990,16490,9500,1,00470,India
620557,2023-03-26,506,monitor,3249,8000,4751,1,00470,India
926387,2023-03-26,501,iphone 15,60000,80000,20000,1,00158,India
222507,2023-03-26,503,mixer,1349,3249,1900,1,00334,India
222507,2023-03-26,501,iphone 15,60000,80000,20000,1,00334,India
497183,2023-03-26,506,monitor,3249,8000,4751,1,00163,India
497183,2023-03-26,501,iphone 15,60000,80000,20000,1,00163,India
497183,2023-03-26,503,mixer,1349,3249,1900,1,00163,India
497183,2023-03-26,504,iron,449,879,430,1,00163,India
159748,2023-03-26,503,mixer,1349,3249,1900,1,00318,India
159748,2023-03-26,507,washing machine,6990,16490,9500,1,00318,India
159748,2023-03-26,506,monitor,3249,8000,4751,1,00318,India
159748,2023-03-26,501,iphone 15,60000,80000,20000,1,00318,India
862306,2023-03-26,505,oven,18490,24000,5510,1,00106,India
862306,2023-03-26,502,iphone 15 pro max,100000,135000,35000,1,00106,India
862306,2023-03-26,503,mixer,1349,3249,1900,1,00106,India
376992,2023-03-26,501,iphone 15,60000,80000,20000,1,00458,India
376992,2023-03-26,506,monitor,3249,8000,4751,1,00458,India
376992,2023-03-26,504,iron,449,879,430,1,00458,India
513163,2023-03-26,507,washing machine,6990,16490,9500,1,00046,India
513163,2023-03-26,503,mixer,1349,3249,1900,1,00046,India
598116,2023-03-26,504,iron,449,879,430,1,00396,India
598116,2023-03-26,502,iphone 15 pro max,100000,135000,35000,1,00396,India
598116,2023-03-26,503,mixer,1349,3249,1900,1,00396,India
598116,2023-03-26,501,iphone 15,60000,80000,20000,1,00396,India
131044,2023-03-26,504,iron,449,879,430,1,00424,India
131044,2023-03-26,505,oven,18490,24000,5510,1,00424,India
540455,2023-03-26,507,washing machine,6990,16490,9500,1,00039,India
540455,2023-03-26,505,oven,18490,24000,5510,1,00039,India
540455,2023-03-26,501,iphone 15,60000,80000,20000,1,00039,India
603367,2023-03-26,501,iphone 15,60000,80000,20000,1,00275,India
603367,2023-03-26,502,iphone 15 pro max,100000,135000,35000,1,00275,India
501601,2023-03-26,507,washing machine,6990,16490,9500,1,00089,India
501601,2023-03-26,504,iron,449,879,430,1,00089,India
875659,2023-03-26,501,iphone 15,60000,80000,20000,1,00234,India
642380,2023-03-26,502,iphone 15 pro max,100000,135000,35000,1,00284,India
642380,2023-03-26,506,monitor,3249,8000,4751,1,00284,India
642380,2023-03-26,504,iron,449,879,430,1,00284,India
166401,2023-03-26,504,iron,449,879,430,1,00282,India
166401,2023-03-26,506,monitor,3249,8000,4751,1,00282,India
291405,2023-03-26,504,iron,449,879,430,1,00211,India
406010,2023-03-26,503,mixer,1349,3249,1900,1,00067,India
406010,2023-03-26,504,iron,449,879,430,1,00067,India
406010,2023-03-26,502,iphone 15 pro max,100000,135000,35000,1,00067,India
406010,2023-03-26,501,iphone 15,60000,80000,20000,1,00067,India
721106,2023-03-26,502,iphone 15 pro max,100000,135000,35000,1,00415,India
721106,2023-03-26,507,washing machine,6990,16490,9500,1,00415,India
931050,2023-03-26,505,oven,18490,24000,5510,1,00128,India
931050,2023-03-26,506,monitor,3249,8000,4751,1,00128,India
931050,2023-03-26,503,mixer,1349,3249,1900,1,00128,India
510058,2023-03-27,503,mixer,1349,3249,1900,1,00367,India
510058,2023-03-27,502,iphone 15 pro max,100000,135000,35000,1,00367,India
510058,2023-03-27,506,monitor,3249,8000,4751,1,00367,India
510058,2023-03-27,501,iphone 15,60000,80000,20000,1,00367,India
941030,2023-03-27,504,iron,449,879,430,1,00410,India
315183,2023-03-27,501,iphone 15,60000,80000,20000,1,00247,India
315183,2023-03-27,505,oven,18490,24000,5510,1,00247,India
315183,2023-03-27,506,monitor,3249,8000,4751,1,00247,India
572446,2023-03-27,507,washing machine,6990,16490,9500,1,00436,India
572446,2023-03-27,506,monitor,3249,8000,4751,1,00436,India
687824,2023-03-27,502,iphone 15 pro max,100000,135000,35000,1,00262,India
687824,2023-03-27,506,monitor,3249,8000,4751,1,00262,India
687824,2023-03-27,501,iphone 15,60000,80000,20000,1,00262,India
298478,2023-03-27,505,oven,18490,24000,5510,1,00109,India
298478,2023-03-27,506,monitor,3249,8000,4751,1,00109,India
298478,2023-03-27,507,washing machine,6990,16490,9500,1,00109,India
514466,2023-03-27,503,mixer,1349,3249,1900,1,00238,India
514466,2023-03-27,502,iphone 15 pro max,100000,135000,35000,1,00238,India
514466,2023-03-27,504,iron,449,879,430,1,00238,India
514466,2023-03-27,506,monitor,3249,8000,4751,1,00238,India
514466,2023-03-27,501,iphone 15,60000,80000,20000,1,00238,India
448094,2023-03-27,501,iphone 15,60000,80000,20000,1,00159,India
448094,2023-03-27,503,mixer,1349,3249,1900,1,00159,India
448094,2023-03-27,504,iron,449,879,430,1,00159,India
923216,2023-03-27,507,washing machine,6990,16490,9500,1,00082,India
923216,2023-03-27,506,monitor,3249,8000,4751,1,00082,India
258199,2023-03-27,503,mixer,1349,3249,1900,1,00343,India
542802,2023-03-27,505,oven,18490,24000,5510,1,00099,India
542802,2023-03-27,502,iphone 15 pro max,100000,135000,35000,1,00099,India
542802,2023-03-27,504,iron,449,879,430,1,00099,India
503701,2023-03-27,504,iron,449,879,430,1,00277,India
503701,2023-03-27,507,washing machine,6990,16490,9500,1,00277,India
503701,2023-03-27,503,mixer,1349,3249,1900,1,00277,India
275897,2023-03-27,507,washing machine,6990,16490,9500,1,00053,India
275897,2023-03-27,502,iphone 15 pro max,100000,135000,35000,1,00053,India
275897,2023-03-27,504,iron,449,879,430,1,00053,India
681624,2023-03-27,506,monitor,3249,8000,4751,1,00251,India
681624,2023-03-27,505,oven,18490,24000,5510,1,00251,India
681624,2023-03-27,504,iron,449,879,430,1,00251,India
422487,2023-03-27,503,mixer,1349,3249,1900,1,00109,India
422487,2023-03-27,506,monitor,3249,8000,4751,1,00109,India
422487,2023-03-27,501,iphone 15,60000,80000,20000,1,00109,India
109001,2023-03-27,503,mixer,1349,3249,1900,1,00036,India
109001,2023-03-27,505,oven,18490,24000,5510,1,00036,India
173662,2023-03-27,503,mixer,1349,3249,1900,1,00315,India
110170,2023-03-27,504,iron,449,879,430,1,00044,India
110170,2023-03-27,503,mixer,1349,3249,1900,1,00044,India
110170,2023-03-27,502,iphone 15 pro max,100000,135000,35000,1,00044,India
110170,2023-03-27,507,washing machine,6990,16490,9500,1,00044,India
110170,2023-03-27,501,iphone 15,60000,80000,20000,1,00044,India
616556,2023-03-27,502,iphone 15 pro max,100000,135000,35000,1,00017,India
616556,2023-03-27,505,oven,18490,24000,5510,1,00017,India
753831,2023-03-27,504,iron,449,879,430,1,00234,India
753831,2023-03-27,505,oven,18490,24000,5510,1,00234,India
753831,2023-03-27,502,iphone 15 pro max,100000,135000,35000,1,00234,India
753831,2023-03-27,506,monitor,3249,8000,4751,1,00234,India
488649,2023-03-27,501,iphone 15,60000,80000,20000,1,00174,India
488649,2023-03-27,504,iron,449,879,430,1,00174,India
305066,2023-03-27,506,monitor,3249,8000,4751,1,00481,India
305066,2023-03-27,502,iphone 15 pro max,100000,135000,35000,1,00481,India
345187,2023-03-27,503,mixer,1349,3249,1900,1,00391,India
345187,2023-03-27,504,iron,449,879,430,1,00391,India
345187,2023-03-27,506,monitor,3249,8000,4751,1,00391,India
498916,2023-03-27,506,monitor,3249,8000,4751,1,00172,India
498916,2023-03-27,505,oven,18490,24000,5510,1,00172,India
498916,2023-03-27,501,iphone 15,60000,80000,20000,1,00172,India
160557,2023-03-27,501,iphone 15,60000,80000,20000,1,00214,India
160557,2023-03-27,506,monitor,3249,8000,4751,1,00214,India
160557,2023-03-27,503,mixer,1349,3249,1900,1,00214,India
160557,2023-03-27,504,iron,449,879,430,1,00214,India
299098,2023-03-27,502,iphone 15 pro max,100000,135000,35000,1,00013,India
299098,2023-03-27,504,iron,449,879,430,1,00013,India
235464,2023-03-27,505,oven,18490,24000,5510,1,00298,India
235464,2023-03-27,504,iron,449,879,430,1,00298,India
399435,2023-03-27,507,washing machine,6990,16490,9500,1,00378,India
399435,2023-03-27,506,monitor,3249,8000,4751,1,00378,India
399435,2023-03-27,505,oven,18490,24000,5510,1,00378,India
399435,2023-03-27,504,iron,449,879,430,1,00378,India
558575,2023-03-27,504,iron,449,879,430,1,00416,India
558575,2023-03-27,501,iphone 15,60000,80000,20000,1,00416,India
773174,2023-03-27,505,oven,18490,24000,5510,1,00495,India
773174,2023-03-27,502,iphone 15 pro max,100000,135000,35000,1,00495,India
773174,2023-03-27,506,monitor,3249,8000,4751,1,00495,India
100656,2023-03-27,502,iphone 15 pro max,100000,135000,35000,1,00048,India
100656,2023-03-27,501,iphone 15,60000,80000,20000,1,00048,India
137630,2023-03-27,503,mixer,1349,3249,1900,1,00299,India
297254,2023-03-27,505,oven,18490,24000,5510,1,00204,India
297254,2023-03-27,502,iphone 15 pro max,100000,135000,35000,1,00204,India
234240,2023-03-27,503,mixer,1349,3249,1900,1,00268,India
998415,2023-03-27,504,iron,449,879,430,1,00283,India
998415,2023-03-27,503,mixer,1349,3249,1900,1,00283,India
833955,2023-03-27,502,iphone 15 pro max,100000,135000,35000,1,00488,India
833955,2023-03-27,504,iron,449,879,430,1,00488,India
747056,2023-03-27,502,iphone 15 pro max,100000,135000,35000,1,00310,India
747056,2023-03-27,505,oven,18490,24000,5510,1,00310,India
747056,2023-03-27,501,iphone 15,60000,80000,20000,1,00310,India
722321,2023-03-27,504,iron,449,879,430,1,00400,India
722321,2023-03-27,505,oven,18490,24000,5510,1,00400,India
548761,2023-03-27,506,monitor,3249,8000,4751,1,00446,India
548761,2023-03-27,501,iphone 15,60000,80000,20000,1,00446,India
548761,2023-03-27,504,iron,449,879,430,1,00446,India
548761,2023-03-27,507,washing machine,6990,16490,9500,1,00446,India
553887,2023-03-27,506,monitor,3249,8000,4751,1,00244,India
553887,2023-03-27,503,mixer,1349,3249,1900,1,00244,India
553887,2023-03-27,501,iphone 15,60000,80000,20000,1,00244,India
900590,2023-03-27,504,iron,449,879,430,1,00470,India
900590,2023-03-27,502,iphone 15 pro max,100000,135000,35000,1,00470,India
974349,2023-03-27,501,iphone 15,60000,80000,20000,1,00147,India
974349,2023-03-27,505,oven,18490,24000,5510,1,00147,India
974349,2023-03-27,506,monitor,3249,8000,4751,1,00147,India
974349,2023-03-27,507,washing machine,6990,16490,9500,1,00147,India
875616,2023-03-27,503,mixer,1349,3249,1900,1,00140,India
403952,2023-03-27,506,monitor,3249,8000,4751,1,00433,India
403952,2023-03-27,501,iphone 15,60000,80000,20000,1,00433,India
403952,2023-03-27,503,mixer,1349,3249,1900,1,00433,India
827797,2023-03-27,507,washing machine,6990,16490,9500,1,00062,India
827797,2023-03-27,504,iron,449,879,430,1,00062,India
161300,2023-03-27,503,mixer,1349,3249,1900,1,00185,India
176185,2023-03-27,506,monitor,3249,8000,4751,1,00073,India
176185,2023-03-27,507,washing machine,6990,16490,9500,1,00073,India
176185,2023-03-27,502,iphone 15 pro max,100000,135000,35000,1,00073,India
176185,2023-03-27,505,oven,18490,24000,5510,1,00073,India
176185,2023-03-27,503,mixer,1349,3249,1900,1,00073,India
358766,2023-03-27,503,mixer,1349,3249,1900,1,00283,India
358766,2023-03-27,504,iron,449,879,430,1,00283,India
358766,2023-03-27,506,monitor,3249,8000,4751,1,00283,India
109978,2023-03-27,502,iphone 15 pro max,100000,135000,35000,1,00402,India
949070,2023-03-27,506,monitor,3249,8000,4751,1,00397,India
949070,2023-03-27,502,iphone 15 pro max,100000,135000,35000,1,00397,India
949070,2023-03-27,504,iron,449,879,430,1,00397,India
949070,2023-03-27,507,washing machine,6990,16490,9500,1,00397,India
378843,2023-03-27,504,iron,449,879,430,1,00439,India
378843,2023-03-27,506,monitor,3249,8000,4751,1,00439,India
378843,2023-03-27,502,iphone 15 pro max,100000,135000,35000,1,00439,India
378843,2023-03-27,505,oven,18490,24000,5510,1,00439,India
714379,2023-03-27,503,mixer,1349,3249,1900,1,00195,India
714379,2023-03-27,502,iphone 15 pro max,100000,135000,35000,1,00195,India
403461,2023-03-27,502,iphone 15 pro max,100000,135000,35000,1,00269,India
403461,2023-03-27,503,mixer,1349,3249,1900,1,00269,India
403461,2023-03-27,507,washing machine,6990,16490,9500,1,00269,India
450700,2023-03-27,504,iron,449,879,430,1,00115,India
450700,2023-03-27,501,iphone 15,60000,80000,20000,1,00115,India
572891,2023-03-27,504,iron,449,879,430,1,00068,India
572891,2023-03-27,501,iphone 15,60000,80000,20000,1,00068,India
572891,2023-03-27,506,monitor,3249,8000,4751,1,00068,India
709674,2023-03-27,504,iron,449,879,430,1,00324,India
659210,2023-03-27,506,monitor,3249,8000,4751,1,00087,India
659210,2023-03-27,501,iphone 15,60000,80000,20000,1,00087,India
659210,2023-03-27,507,washing machine,6990,16490,9500,1,00087,India
654935,2023-03-27,504,iron,449,879,430,1,00310,India
557226,2023-03-27,502,iphone 15 pro max,100000,135000,35000,1,00206,India
557226,2023-03-27,507,washing machine,6990,16490,9500,1,00206,India
418847,2023-03-27,507,washing machine,6990,16490,9500,1,00408,India
418847,2023-03-27,503,mixer,1349,3249,1900,1,00408,India
418847,2023-03-27,506,monitor,3249,8000,4751,1,00408,India
418847,2023-03-27,501,iphone 15,60000,80000,20000,1,00408,India
783663,2023-03-27,501,iphone 15,60000,80000,20000,1,00110,India
783663,2023-03-27,503,mixer,1349,3249,1900,1,00110,India
783663,2023-03-27,507,washing machine,6990,16490,9500,1,00110,India
402403,2023-03-27,507,washing machine,6990,16490,9500,1,00211,India
402403,2023-03-27,506,monitor,3249,8000,4751,1,00211,India
402403,2023-03-27,502,iphone 15 pro max,100000,135000,35000,1,00211,India
630835,2023-03-27,501,iphone 15,60000,80000,20000,1,00390,India
630835,2023-03-27,502,iphone 15 pro max,100000,135000,35000,1,00390,India
800834,2023-03-27,501,iphone 15,60000,80000,20000,1,00140,India
800834,2023-03-27,507,washing machine,6990,16490,9500,1,00140,India
259863,2023-03-27,503,mixer,1349,3249,1900,1,00090,India
259863,2023-03-27,504,iron,449,879,430,1,00090,India
271231,2023-03-27,504,iron,449,879,430,1,00083,India
271231,2023-03-27,506,monitor,3249,8000,4751,1,00083,India
887892,2023-03-27,506,monitor,3249,8000,4751,1,00176,India
887892,2023-03-27,502,iphone 15 pro max,100000,135000,35000,1,00176,India
887892,2023-03-27,504,iron,449,879,430,1,00176,India
887892,2023-03-27,503,mixer,1349,3249,1900,1,00176,India
464209,2023-03-27,506,monitor,3249,8000,4751,1,00490,India
464209,2023-03-27,502,iphone 15 pro max,100000,135000,35000,1,00490,India
464209,2023-03-27,501,iphone 15,60000,80000,20000,1,00490,India
501386,2023-03-27,501,iphone 15,60000,80000,20000,1,00365,India
501386,2023-03-27,506,monitor,3249,8000,4751,1,00365,India
501386,2023-03-27,504,iron,449,879,430,1,00365,India
501386,2023-03-27,505,oven,18490,24000,5510,1,00365,India
964206,2023-03-27,501,iphone 15,60000,80000,20000,1,00197,India
964206,2023-03-27,503,mixer,1349,3249,1900,1,00197,India
542466,2023-03-27,501,iphone 15,60000,80000,20000,1,00457,India
542466,2023-03-27,502,iphone 15 pro max,100000,135000,35000,1,00457,India
542466,2023-03-27,505,oven,18490,24000,5510,1,00457,India
542466,2023-03-27,504,iron,449,879,430,1,00457,India
693894,2023-03-27,504,iron,449,879,430,1,00253,India
693894,2023-03-27,503,mixer,1349,3249,1900,1,00253,India
693894,2023-03-27,501,iphone 15,60000,80000,20000,1,00253,India
693894,2023-03-27,507,washing machine,6990,16490,9500,1,00253,India
813245,2023-03-27,507,washing machine,6990,16490,9500,1,00295,India
813245,2023-03-27,502,iphone 15 pro max,100000,135000,35000,1,00295,India
813245,2023-03-27,506,monitor,3249,8000,4751,1,00295,India
813245,2023-03-27,503,mixer,1349,3249,1900,1,00295,India
793251,2023-03-27,507,washing machine,6990,16490,9500,1,00069,India
718848,2023-03-27,507,washing machine,6990,16490,9500,1,00267,India
718848,2023-03-27,504,iron,449,879,430,1,00267,India
718848,2023-03-27,505,oven,18490,24000,5510,1,00267,India
122584,2023-03-27,501,iphone 15,60000,80000,20000,1,00300,India
122584,2023-03-27,504,iron,449,879,430,1,00300,India
122584,2023-03-27,503,mixer,1349,3249,1900,1,00300,India
122584,2023-03-27,506,monitor,3249,8000,4751,1,00300,India
122584,2023-03-27,507,washing machine,6990,16490,9500,1,00300,India
762963,2023-03-27,507,washing machine,6990,16490,9500,1,00327,India
762963,2023-03-27,504,iron,449,879,430,1,00327,India
409838,2023-03-28,505,oven,18490,24000,5510,1,00329,India
409838,2023-03-28,504,iron,449,879,430,1,00329,India
409838,2023-03-28,502,iphone 15 pro max,100000,135000,35000,1,00329,India
409838,2023-03-28,503,mixer,1349,3249,1900,1,00329,India
441594,2023-03-28,502,iphone 15 pro max,100000,135000,35000,1,00254,India
630951,2023-03-28,504,iron,449,879,430,1,00418,India
630951,2023-03-28,503,mixer,1349,3249,1900,1,00418,India
662943,2023-03-28,505,oven,18490,24000,5510,1,00053,India
497704,2023-03-28,505,oven,18490,24000,5510,1,00038,India
497704,2023-03-28,504,iron,449,879,430,1,00038,India
497704,2023-03-28,506,monitor,3249,8000,4751,1,00038,India
492671,2023-03-28,505,oven,18490,24000,5510,1,00230,India
358345,2023-03-28,504,iron,449,879,430,1,00242,India
358345,2023-03-28,503,mixer,1349,3249,1900,1,00242,India
358345,2023-03-28,501,iphone 15,60000,80000,20000,1,00242,India
358345,2023-03-28,506,monitor,3249,8000,4751,1,00242,India
185951,2023-03-28,502,iphone 15 pro max,100000,135000,35000,1,00109,India
185951,2023-03-28,507,washing machine,6990,16490,9500,1,00109,India
185951,2023-03-28,505,oven,18490,24000,5510,1,00109,India
891687,2023-03-28,504,iron,449,879,430,1,00187,India
891687,2023-03-28,503,mixer,1349,3249,1900,1,00187,India
291114,2023-03-28,505,oven,18490,24000,5510,1,00313,India
291114,2023-03-28,507,washing machine,6990,16490,9500,1,00313,India
291114,2023-03-28,503,mixer,1349,3249,1900,1,00313,India
522825,2023-03-28,505,oven,18490,24000,5510,1,00437,India
522825,2023-03-28,507,washing machine,6990,16490,9500,1,00437,India
565770,2023-03-28,503,mixer,1349,3249,1900,1,00468,India
565770,2023-03-28,505,oven,18490,24000,5510,1,00468,India
651894,2023-03-28,503,mixer,1349,3249,1900,1,00297,India
273130,2023-03-28,504,iron,449,879,430,1,00449,India
273130,2023-03-28,502,iphone 15 pro max,100000,135000,35000,1,00449,India
816059,2023-03-28,504,iron,449,879,430,1,00293,India
816059,2023-03-28,501,iphone 15,60000,80000,20000,1,00293,India
353560,2023-03-28,502,iphone 15 pro max,100000,135000,35000,1,00500,India
353560,2023-03-28,501,iphone 15,60000,80000,20000,1,00500,India
661243,2023-03-28,502,iphone 15 pro max,100000,135000,35000,1,00161,India
661243,2023-03-28,504,iron,449,879,430,1,00161,India
661243,2023-03-28,501,iphone 15,60000,80000,20000,1,00161,India
661243,2023-03-28,503,mixer,1349,3249,1900,1,00161,India
146200,2023-03-28,502,iphone 15 pro max,100000,135000,35000,1,00227,India
146200,2023-03-28,501,iphone 15,60000,80000,20000,1,00227,India
146200,2023-03-28,503,mixer,1349,3249,1900,1,00227,India
146200,2023-03-28,504,iron,449,879,430,1,00227,India
468645,2023-03-28,501,iphone 15,60000,80000,20000,1,00491,India
468645,2023-03-28,502,iphone 15 pro max,100000,135000,35000,1,00491,India
468645,2023-03-28,503,mixer,1349,3249,1900,1,00491,India
468645,2023-03-28,507,washing machine,6990,16490,9500,1,00491,India
678625,2023-03-28,504,iron,449,879,430,1,00423,India
876796,2023-03-28,505,oven,18490,24000,5510,1,00392,India
876796,2023-03-28,504,iron,449,879,430,1,00392,India
876796,2023-03-28,503,mixer,1349,3249,1900,1,00392,India
286181,2023-03-28,506,monitor,3249,8000,4751,1,00313,India
286181,2023-03-28,504,iron,449,879,430,1,00313,India
286181,2023-03-28,503,mixer,1349,3249,1900,1,00313,India
823691,2023-03-28,505,oven,18490,24000,5510,1,00475,India
823691,2023-03-28,502,iphone 15 pro max,100000,135000,35000,1,00475,India
823691,2023-03-28,503,mixer,1349,3249,1900,1,00475,India
537875,2023-03-28,507,washing machine,6990,16490,9500,1,00146,India
917769,2023-03-28,506,monitor,3249,8000,4751,1,00017,India
917769,2023-03-28,504,iron,449,879,430,1,00017,India
581159,2023-03-28,504,iron,449,879,430,1,00273,India
581159,2023-03-28,506,monitor,3249,8000,4751,1,00273,India
303606,2023-03-28,507,washing machine,6990,16490,9500,1,00357,India
303606,2023-03-28,503,mixer,1349,3249,1900,1,00357,India
303606,2023-03-28,504,iron,449,879,430,1,00357,India
303606,2023-03-28,501,iphone 15,60000,80000,20000,1,00357,India
303606,2023-03-28,506,monitor,3249,8000,4751,1,00357,India
204790,2023-03-28,504,iron,449,879,430,1,00478,India
204790,2023-03-28,505,oven,18490,24000,5510,1,00478,India
204790,2023-03-28,503,mixer,1349,3249,1900,1,00478,India
204790,2023-03-28,501,iphone 15,60000,80000,20000,1,00478,India
375804,2023-03-28,503,mixer,1349,3249,1900,1,00007,India
375804,2023-03-28,505,oven,18490,24000,5510,1,00007,India
375804,2023-03-28,502,iphone 15 pro max,100000,135000,35000,1,00007,India
375804,2023-03-28,501,iphone 15,60000,80000,20000,1,00007,India
440205,2023-03-28,506,monitor,3249,8000,4751,1,00157,India
440205,2023-03-28,503,mixer,1349,3249,1900,1,00157,India
440205,2023-03-28,502,iphone 15 pro max,100000,135000,35000,1,00157,India
641059,2023-03-28,507,washing machine,6990,16490,9500,1,00064,India
555369,2023-03-28,507,washing machine,6990,16490,9500,1,00139,India
555369,2023-03-28,506,monitor,3249,8000,4751,1,00139,India
555369,2023-03-28,503,mixer,1349,3249,1900,1,00139,India
555369,2023-03-28,505,oven,18490,24000,5510,1,00139,India
744298,2023-03-28,502,iphone 15 pro max,100000,135000,35000,1,00082,India
635561,2023-03-28,505,oven,18490,24000,5510,1,00485,India
635561,2023-03-28,504,iron,449,879,430,1,00485,India
335450,2023-03-28,504,iron,449,879,430,1,00338,India
335450,2023-03-28,503,mixer,1349,3249,1900,1,00338,India
631571,2023-03-28,505,oven,18490,24000,5510,1,00329,India
631571,2023-03-28,502,iphone 15 pro max,100000,135000,35000,1,00329,India
631571,2023-03-28,503,mixer,1349,3249,1900,1,00329,India
115909,2023-03-28,503,mixer,1349,3249,1900,1,00141,India
599571,2023-03-28,503,mixer,1349,3249,1900,1,00396,India
599571,2023-03-28,505,oven,18490,24000,5510,1,00396,India
599571,2023-03-28,502,iphone 15 pro max,100000,135000,35000,1,00396,India
599571,2023-03-28,504,iron,449,879,430,1,00396,India
409353,2023-03-28,504,iron,449,879,430,1,00375,India
409353,2023-03-28,501,iphone 15,60000,80000,20000,1,00375,India
409353,2023-03-28,507,washing machine,6990,16490,9500,1,00375,India
502247,2023-03-28,502,iphone 15 pro max,100000,135000,35000,1,00086,India
502247,2023-03-28,501,iphone 15,60000,80000,20000,1,00086,India
502247,2023-03-28,505,oven,18490,24000,5510,1,00086,India
451959,2023-03-28,506,monitor,3249,8000,4751,1,00155,India
451959,2023-03-28,503,mixer,1349,3249,1900,1,00155,India
872628,2023-03-28,502,iphone 15 pro max,100000,135000,35000,1,00120,India
872628,2023-03-28,503,mixer,1349,3249,1900,1,00120,India
872628,2023-03-28,501,iphone 15,60000,80000,20000,1,00120,India
440420,2023-03-28,507,washing machine,6990,16490,9500,1,00408,India
440420,2023-03-28,502,iphone 15 pro max,100000,135000,35000,1,00408,India
440420,2023-03-28,504,iron,449,879,430,1,00408,India
440420,2023-03-28,505,oven,18490,24000,5510,1,00408,India
786902,2023-03-28,503,mixer,1349,3249,1900,1,00274,India
868020,2023-03-28,501,iphone 15,60000,80000,20000,1,00016,India
868020,2023-03-28,507,washing machine,6990,16490,9500,1,00016,India
868020,2023-03-28,505,oven,18490,24000,5510,1,00016,India
868020,2023-03-28,502,iphone 15 pro max,100000,135000,35000,1,00016,India
868020,2023-03-28,506,monitor,3249,8000,4751,1,00016,India
488702,2023-03-28,505,oven,18490,24000,5510,1,00083,India
488702,2023-03-28,506,monitor,3249,8000,4751,1,00083,India
705242,2023-03-28,504,iron,449,879,430,1,00331,India
705242,2023-03-28,503,mixer,1349,3249,1900,1,00331,India
705242,2023-03-28,506,monitor,3249,8000,4751,1,00331,India
808586,2023-03-28,504,iron,449,879,430,1,00228,India
119094,2023-03-28,504,iron,449,879,430,1,00060,India
119094,2023-03-28,505,oven,18490,24000,5510,1,00060,India
404247,2023-03-28,507,washing machine,6990,16490,9500,1,00295,India
757503,2023-03-28,503,mixer,1349,3249,1900,1,00042,India
757503,2023-03-28,504,iron,449,879,430,1,00042,India
757503,2023-03-28,507,washing machine,6990,16490,9500,1,00042,India
292190,2023-03-28,505,oven,18490,24000,5510,1,00432,India
292190,2023-03-28,503,mixer,1349,3249,1900,1,00432,India
292190,2023-03-28,501,iphone 15,60000,80000,20000,1,00432,India
292190,2023-03-28,507,washing machine,6990,16490,9500,1,00432,India
142912,2023-03-28,504,iron,449,879,430,1,00377,India
142912,2023-03-28,501,iphone 15,60000,80000,20000,1,00377,India
142912,2023-03-28,503,mixer,1349,3249,1900,1,00377,India
139191,2023-03-28,506,monitor,3249,8000,4751,1,00040,India
139191,2023-03-28,503,mixer,1349,3249,1900,1,00040,India
499382,2023-03-29,507,washing machine,6990,16490,9500,1,00489,India
499382,2023-03-29,505,oven,18490,24000,5510,1,00489,India
181255,2023-03-29,503,mixer,1349,3249,1900,1,00450,India
858439,2023-03-29,507,washing machine,6990,16490,9500,1,00194,India
858439,2023-03-29,505,oven,18490,24000,5510,1,00194,India
858439,2023-03-29,504,iron,449,879,430,1,00194,India
341986,2023-03-29,505,oven,18490,24000,5510,1,00422,India
341986,2023-03-29,507,washing machine,6990,16490,9500,1,00422,India
341986,2023-03-29,502,iphone 15 pro max,100000,135000,35000,1,00422,India
341986,2023-03-29,504,iron,449,879,430,1,00422,India
341986,2023-03-29,503,mixer,1349,3249,1900,1,00422,India
986293,2023-03-29,504,iron,449,879,430,1,00159,India
629719,2023-03-29,501,iphone 15,60000,80000,20000,1,00434,India
629719,2023-03-29,504,iron,449,879,430,1,00434,India
629719,2023-03-29,503,mixer,1349,3249,1900,1,00434,India
740811,2023-03-29,505,oven,18490,24000,5510,1,00216,India
740811,2023-03-29,501,iphone 15,60000,80000,20000,1,00216,India
740811,2023-03-29,504,iron,449,879,430,1,00216,India
899070,2023-03-29,505,oven,18490,24000,5510,1,00258,India
821069,2023-03-29,505,oven,18490,24000,5510,1,00368,India
370891,2023-03-29,504,iron,449,879,430,1,00196,India
370891,2023-03-29,506,monitor,3249,8000,4751,1,00196,India
370891,2023-03-29,501,iphone 15,60000,80000,20000,1,00196,India
370891,2023-03-29,502,iphone 15 pro max,100000,135000,35000,1,00196,India
894269,2023-03-29,507,washing machine,6990,16490,9500,1,00230,India
894269,2023-03-29,506,monitor,3249,8000,4751,1,00230,India
410583,2023-03-29,503,mixer,1349,3249,1900,1,00498,India
410583,2023-03-29,505,oven,18490,24000,5510,1,00498,India
410583,2023-03-29,507,washing machine,6990,16490,9500,1,00498,India
738837,2023-03-29,507,washing machine,6990,16490,9500,1,00231,India
100617,2023-03-29,504,iron,449,879,430,1,00399,India
100617,2023-03-29,502,iphone 15 pro max,100000,135000,35000,1,00399,India
585273,2023-03-29,506,monitor,3249,8000,4751,1,00204,India
585273,2023-03-29,501,iphone 15,60000,80000,20000,1,00204,India
281518,2023-03-29,506,monitor,3249,8000,4751,1,00376,India
281518,2023-03-29,507,washing machine,6990,16490,9500,1,00376,India
281518,2023-03-29,504,iron,449,879,430,1,00376,India
477107,2023-03-29,507,washing machine,6990,16490,9500,1,00388,India
477107,2023-03-29,504,iron,449,879,430,1,00388,India
477107,2023-03-29,501,iphone 15,60000,80000,20000,1,00388,India
696310,2023-03-29,507,washing machine,6990,16490,9500,1,00005,India
545123,2023-03-29,507,washing machine,6990,16490,9500,1,00185,India
545123,2023-03-29,502,iphone 15 pro max,100000,135000,35000,1,00185,India
545123,2023-03-29,501,iphone 15,60000,80000,20000,1,00185,India
913462,2023-03-29,505,oven,18490,24000,5510,1,00378,India
776072,2023-03-29,501,iphone 15,60000,80000,20000,1,00143,India
776072,2023-03-29,503,mixer,1349,3249,1900,1,00143,India
614366,2023-03-29,506,monitor,3249,8000,4751,1,00300,India
614366,2023-03-29,507,washing machine,6990,16490,9500,1,00300,India
140603,2023-03-29,501,iphone 15,60000,80000,20000,1,00130,India
140603,2023-03-29,507,washing machine,6990,16490,9500,1,00130,India
140603,2023-03-29,503,mixer,1349,3249,1900,1,00130,India
848477,2023-03-29,505,oven,18490,24000,5510,1,00484,India
848477,2023-03-29,501,iphone 15,60000,80000,20000,1,00484,India
848477,2023-03-29,506,monitor,3249,8000,4751,1,00484,India
848477,2023-03-29,504,iron,449,879,430,1,00484,India
342168,2023-03-29,507,washing machine,6990,16490,9500,1,00096,India
342168,2023-03-29,501,iphone 15,60000,80000,20000,1,00096,India
720682,2023-03-29,502,iphone 15 pro max,100000,135000,35000,1,00388,India
720682,2023-03-29,505,oven,18490,24000,5510,1,00388,India
948151,2023-03-29,507,washing machine,6990,16490,9500,1,00329,India
948151,2023-03-29,504,iron,449,879,430,1,00329,India
948151,2023-03-29,505,oven,18490,24000,5510,1,00329,India
911588,2023-03-29,507,washing machine,6990,16490,9500,1,00490,India
911588,2023-03-29,506,monitor,3249,8000,4751,1,00490,India
911588,2023-03-29,503,mixer,1349,3249,1900,1,00490,India
191931,2023-03-29,505,oven,18490,24000,5510,1,00237,India
191931,2023-03-29,504,iron,449,879,430,1,00237,India
603171,2023-03-29,502,iphone 15 pro max,100000,135000,35000,1,00466,India
603171,2023-03-29,506,monitor,3249,8000,4751,1,00466,India
603171,2023-03-29,505,oven,18490,24000,5510,1,00466,India
603171,2023-03-29,507,washing machine,6990,16490,9500,1,00466,India
498467,2023-03-29,507,washing machine,6990,16490,9500,1,00426,India
498467,2023-03-29,503,mixer,1349,3249,1900,1,00426,India
498467,2023-03-29,504,iron,449,879,430,1,00426,India
498467,2023-03-29,505,oven,18490,24000,5510,1,00426,India
795698,2023-03-29,503,mixer,1349,3249,1900,1,00018,India
795698,2023-03-29,506,monitor,3249,8000,4751,1,00018,India
329208,2023-03-29,502,iphone 15 pro max,100000,135000,35000,1,00076,India
329208,2023-03-29,501,iphone 15,60000,80000,20000,1,00076,India
884652,2023-03-29,501,iphone 15,60000,80000,20000,1,00481,India
884652,2023-03-29,502,iphone 15 pro max,100000,135000,35000,1,00481,India
884652,2023-03-29,504,iron,449,879,430,1,00481,India
898249,2023-03-29,507,washing machine,6990,16490,9500,1,00481,India
898249,2023-03-29,506,monitor,3249,8000,4751,1,00481,India
490742,2023-03-29,506,monitor,3249,8000,4751,1,00012,India
490742,2023-03-29,502,iphone 15 pro max,100000,135000,35000,1,00012,India
544743,2023-03-29,507,washing machine,6990,16490,9500,1,00194,India
544743,2023-03-29,501,iphone 15,60000,80000,20000,1,00194,India
544743,2023-03-29,502,iphone 15 pro max,100000,135000,35000,1,00194,India
361473,2023-03-29,504,iron,449,879,430,1,00495,India
361473,2023-03-29,506,monitor,3249,8000,4751,1,00495,India
103603,2023-03-29,506,monitor,3249,8000,4751,1,00456,India
103603,2023-03-29,501,iphone 15,60000,80000,20000,1,00456,India
407423,2023-03-29,501,iphone 15,60000,80000,20000,1,00361,India
719512,2023-03-29,502,iphone 15 pro max,100000,135000,35000,1,00055,India
719512,2023-03-29,505,oven,18490,24000,5510,1,00055,India
450757,2023-03-29,502,iphone 15 pro max,100000,135000,35000,1,00362,India
450757,2023-03-29,505,oven,18490,24000,5510,1,00362,India
450757,2023-03-29,503,mixer,1349,3249,1900,1,00362,India
829497,2023-03-29,502,iphone 15 pro max,100000,135000,35000,1,00141,India
829497,2023-03-29,507,washing machine,6990,16490,9500,1,00141,India
829497,2023-03-29,504,iron,449,879,430,1,00141,India
829497,2023-03-29,503,mixer,1349,3249,1900,1,00141,India
829497,2023-03-29,505,oven,18490,24000,5510,1,00141,India
391607,2023-03-29,503,mixer,1349,3249,1900,1,00258,India
391607,2023-03-29,504,iron,449,879,430,1,00258,India
391607,2023-03-29,505,oven,18490,24000,5510,1,00258,India
465778,2023-03-29,502,iphone 15 pro max,100000,135000,35000,1,00420,India
465778,2023-03-29,505,oven,18490,24000,5510,1,00420,India
465778,2023-03-29,504,iron,449,879,430,1,00420,India
273855,2023-03-29,507,washing machine,6990,16490,9500,1,00483,India
273855,2023-03-29,501,iphone 15,60000,80000,20000,1,00483,India
273855,2023-03-29,504,iron,449,879,430,1,00483,India
726699,2023-03-29,507,washing machine,6990,16490,9500,1,00423,India
726699,2023-03-29,504,iron,449,879,430,1,00423,India
726699,2023-03-29,501,iphone 15,60000,80000,20000,1,00423,India
726699,2023-03-29,502,iphone 15 pro max,100000,135000,35000,1,00423,India
939595,2023-03-29,505,oven,18490,24000,5510,1,00216,India
713452,2023-03-29,504,iron,449,879,430,1,00017,India
713452,2023-03-29,501,iphone 15,60000,80000,20000,1,00017,India
713452,2023-03-29,507,washing machine,6990,16490,9500,1,00017,India
713452,2023-03-29,506,monitor,3249,8000,4751,1,00017,India
772950,2023-03-29,504,iron,449,879,430,1,00398,India
772950,2023-03-29,506,monitor,3249,8000,4751,1,00398,India
772950,2023-03-29,507,washing machine,6990,16490,9500,1,00398,India
194433,2023-03-29,504,iron,449,879,430,1,00092,India
797816,2023-03-29,507,washing machine,6990,16490,9500,1,00349,India
797816,2023-03-29,506,monitor,3249,8000,4751,1,00349,India
712078,2023-03-29,507,washing machine,6990,16490,9500,1,00131,India
712078,2023-03-29,504,iron,449,879,430,1,00131,India
712078,2023-03-29,505,oven,18490,24000,5510,1,00131,India
656847,2023-03-29,505,oven,18490,24000,5510,1,00494,India
656847,2023-03-29,504,iron,449,879,430,1,00494,India
656847,2023-03-29,502,iphone 15 pro max,100000,135000,35000,1,00494,India
656847,2023-03-29,503,mixer,1349,3249,1900,1,00494,India
505198,2023-03-29,506,monitor,3249,8000,4751,1,00219,India
505198,2023-03-29,501,iphone 15,60000,80000,20000,1,00219,India
668345,2023-03-29,504,iron,449,879,430,1,00143,India
668345,2023-03-29,501,iphone 15,60000,80000,20000,1,00143,India
888201,2023-03-29,501,iphone 15,60000,80000,20000,1,00207,India
888201,2023-03-29,507,washing machine,6990,16490,9500,1,00207,India
888201,2023-03-29,506,monitor,3249,8000,4751,1,00207,India
667439,2023-03-29,504,iron,449,879,430,1,00308,India
667439,2023-03-29,501,iphone 15,60000,80000,20000,1,00308,India
667439,2023-03-29,502,iphone 15 pro max,100000,135000,35000,1,00308,India
667439,2023-03-29,506,monitor,3249,8000,4751,1,00308,India
122728,2023-03-29,505,oven,18490,24000,5510,1,00289,India
455790,2023-03-29,502,iphone 15 pro max,100000,135000,35000,1,00299,India
455790,2023-03-29,506,monitor,3249,8000,4751,1,00299,India
751802,2023-03-29,502,iphone 15 pro max,100000,135000,35000,1,00444,India
751802,2023-03-29,504,iron,449,879,430,1,00444,India
317487,2023-03-29,501,iphone 15,60000,80000,20000,1,00374,India
317487,2023-03-29,504,iron,449,879,430,1,00374,India
425582,2023-03-29,502,iphone 15 pro max,100000,135000,35000,1,00495,India
425582,2023-03-29,504,iron,449,879,430,1,00495,India
662481,2023-03-29,506,monitor,3249,8000,4751,1,00178,India
662481,2023-03-29,503,mixer,1349,3249,1900,1,00178,India
662481,2023-03-29,501,iphone 15,60000,80000,20000,1,00178,India
517617,2023-03-29,504,iron,449,879,430,1,00249,India
517617,2023-03-29,507,washing machine,6990,16490,9500,1,00249,India
390922,2023-03-29,507,washing machine,6990,16490,9500,1,00472,India
390922,2023-03-29,506,monitor,3249,8000,4751,1,00472,India
390922,2023-03-29,505,oven,18490,24000,5510,1,00472,India
458803,2023-03-29,504,iron,449,879,430,1,00369,India
458803,2023-03-29,501,iphone 15,60000,80000,20000,1,00369,India
948420,2023-03-29,507,washing machine,6990,16490,9500,1,00292,India
596656,2023-03-29,504,iron,449,879,430,1,00309,India
596656,2023-03-29,507,washing machine,6990,16490,9500,1,00309,India
598080,2023-03-29,504,iron,449,879,430,1,00114,India
598080,2023-03-29,501,iphone 15,60000,80000,20000,1,00114,India
598080,2023-03-29,505,oven,18490,24000,5510,1,00114,India
460217,2023-03-29,502,iphone 15 pro max,100000,135000,35000,1,00145,India
204412,2023-03-29,507,washing machine,6990,16490,9500,1,00118,India
204412,2023-03-29,504,iron,449,879,430,1,00118,India
204412,2023-03-29,503,mixer,1349,3249,1900,1,00118,India
204412,2023-03-29,502,iphone 15 pro max,100000,135000,35000,1,00118,India
204412,2023-03-29,506,monitor,3249,8000,4751,1,00118,India
100455,2023-03-29,505,oven,18490,24000,5510,1,00229,India
100455,2023-03-29,507,washing machine,6990,16490,9500,1,00229,India
406027,2023-03-29,502,iphone 15 pro max,100000,135000,35000,1,00494,India
665359,2023-03-29,501,iphone 15,60000,80000,20000,1,00155,India
733795,2023-03-29,503,mixer,1349,3249,1900,1,00131,India
733795,2023-03-29,505,oven,18490,24000,5510,1,00131,India
972406,2023-03-29,502,iphone 15 pro max,100000,135000,35000,1,00115,India
972406,2023-03-29,507,washing machine,6990,16490,9500,1,00115,India
972406,2023-03-29,506,monitor,3249,8000,4751,1,00115,India
972406,2023-03-29,505,oven,18490,24000,5510,1,00115,India
660559,2023-03-29,502,iphone 15 pro max,100000,135000,35000,1,00064,India
660559,2023-03-29,503,mixer,1349,3249,1900,1,00064,India
660559,2023-03-29,506,monitor,3249,8000,4751,1,00064,India
660559,2023-03-29,501,iphone 15,60000,80000,20000,1,00064,India
830625,2023-03-29,503,mixer,1349,3249,1900,1,00242,India
830625,2023-03-29,507,washing machine,6990,16490,9500,1,00242,India
830625,2023-03-29,504,iron,449,879,430,1,00242,India
168281,2023-03-29,506,monitor,3249,8000,4751,1,00303,India
168281,2023-03-29,507,washing machine,6990,16490,9500,1,00303,India
168281,2023-03-29,505,oven,18490,24000,5510,1,00303,India
633797,2023-03-30,504,iron,449,879,430,1,00382,India
759786,2023-03-30,506,monitor,3249,8000,4751,1,00136,India
759786,2023-03-30,504,iron,449,879,430,1,00136,India
759786,2023-03-30,505,oven,18490,24000,5510,1,00136,India
876879,2023-03-30,503,mixer,1349,3249,1900,1,00125,India
876879,2023-03-30,505,oven,18490,24000,5510,1,00125,India
876879,2023-03-30,506,monitor,3249,8000,4751,1,00125,India
387420,2023-03-30,501,iphone 15,60000,80000,20000,1,00129,India
387420,2023-03-30,502,iphone 15 pro max,100000,135000,35000,1,00129,India
940390,2023-03-30,504,iron,449,879,430,1,00211,India
940390,2023-03-30,503,mixer,1349,3249,1900,1,00211,India
940390,2023-03-30,507,washing machine,6990,16490,9500,1,00211,India
940390,2023-03-30,505,oven,18490,24000,5510,1,00211,India
451563,2023-03-30,503,mixer,1349,3249,1900,1,00480,India
451563,2023-03-30,505,oven,18490,24000,5510,1,00480,India
185830,2023-03-30,502,iphone 15 pro max,100000,135000,35000,1,00236,India
185830,2023-03-30,504,iron,449,879,430,1,00236,India
185830,2023-03-30,501,iphone 15,60000,80000,20000,1,00236,India
185830,2023-03-30,507,washing machine,6990,16490,9500,1,00236,India
674588,2023-03-30,501,iphone 15,60000,80000,20000,1,00326,India
674588,2023-03-30,507,washing machine,6990,16490,9500,1,00326,India
674588,2023-03-30,506,monitor,3249,8000,4751,1,00326,India
674588,2023-03-30,503,mixer,1349,3249,1900,1,00326,India
252935,2023-03-30,506,monitor,3249,8000,4751,1,00168,India
930906,2023-03-30,503,mixer,1349,3249,1900,1,00126,India
183607,2023-03-30,502,iphone 15 pro max,100000,135000,35000,1,00158,India
183607,2023-03-30,503,mixer,1349,3249,1900,1,00158,India
183607,2023-03-30,507,washing machine,6990,16490,9500,1,00158,India
183607,2023-03-30,504,iron,449,879,430,1,00158,India
870479,2023-03-30,503,mixer,1349,3249,1900,1,00186,India
870479,2023-03-30,502,iphone 15 pro max,100000,135000,35000,1,00186,India
870479,2023-03-30,506,monitor,3249,8000,4751,1,00186,India
283203,2023-03-30,503,mixer,1349,3249,1900,1,00483,India
283203,2023-03-30,505,oven,18490,24000,5510,1,00483,India
476145,2023-03-30,507,washing machine,6990,16490,9500,1,00395,India
987340,2023-03-30,505,oven,18490,24000,5510,1,00071,India
830126,2023-03-30,503,mixer,1349,3249,1900,1,00106,India
986747,2023-03-30,504,iron,449,879,430,1,00021,India
986747,2023-03-30,502,iphone 15 pro max,100000,135000,35000,1,00021,India
986747,2023-03-30,507,washing machine,6990,16490,9500,1,00021,India
364974,2023-03-30,504,iron,449,879,430,1,00147,India
364974,2023-03-30,503,mixer,1349,3249,1900,1,00147,India
838806,2023-03-30,503,mixer,1349,3249,1900,1,00277,India
361241,2023-03-30,506,monitor,3249,8000,4751,1,00083,India
361241,2023-03-30,504,iron,449,879,430,1,00083,India
361241,2023-03-30,503,mixer,1349,3249,1900,1,00083,India
669454,2023-03-30,505,oven,18490,24000,5510,1,00040,India
649868,2023-03-30,505,oven,18490,24000,5510,1,00394,India
649868,2023-03-30,501,iphone 15,60000,80000,20000,1,00394,India
649868,2023-03-30,506,monitor,3249,8000,4751,1,00394,India
649868,2023-03-30,503,mixer,1349,3249,1900,1,00394,India
141390,2023-03-30,504,iron,449,879,430,1,00272,India
141390,2023-03-30,502,iphone 15 pro max,100000,135000,35000,1,00272,India
141390,2023-03-30,503,mixer,1349,3249,1900,1,00272,India
141390,2023-03-30,501,iphone 15,60000,80000,20000,1,00272,India
921103,2023-03-30,505,oven,18490,24000,5510,1,00345,India
921103,2023-03-30,507,washing machine,6990,16490,9500,1,00345,India
921103,2023-03-30,503,mixer,1349,3249,1900,1,00345,India
745160,2023-03-30,507,washing machine,6990,16490,9500,1,00173,India
745160,2023-03-30,504,iron,449,879,430,1,00173,India
745160,2023-03-30,503,mixer,1349,3249,1900,1,00173,India
745160,2023-03-30,502,iphone 15 pro max,100000,135000,35000,1,00173,India
532963,2023-03-30,505,oven,18490,24000,5510,1,00267,India
631272,2023-03-30,503,mixer,1349,3249,1900,1,00213,India
631272,2023-03-30,504,iron,449,879,430,1,00213,India
631272,2023-03-30,501,iphone 15,60000,80000,20000,1,00213,India
326132,2023-03-30,502,iphone 15 pro max,100000,135000,35000,1,00208,India
989473,2023-03-30,507,washing machine,6990,16490,9500,1,00069,India
989473,2023-03-30,501,iphone 15,60000,80000,20000,1,00069,India
826162,2023-03-30,504,iron,449,879,430,1,00252,India
976983,2023-03-30,502,iphone 15 pro max,100000,135000,35000,1,00007,India
436258,2023-03-30,502,iphone 15 pro max,100000,135000,35000,1,00261,India
350398,2023-03-30,505,oven,18490,24000,5510,1,00183,India
350398,2023-03-30,501,iphone 15,60000,80000,20000,1,00183,India
350398,2023-03-30,507,washing machine,6990,16490,9500,1,00183,India
598784,2023-03-30,507,washing machine,6990,16490,9500,1,00204,India
598784,2023-03-30,506,monitor,3249,8000,4751,1,00204,India
598784,2023-03-30,503,mixer,1349,3249,1900,1,00204,India
435648,2023-03-30,501,iphone 15,60000,80000,20000,1,00417,India
435648,2023-03-30,507,washing machine,6990,16490,9500,1,00417,India
435648,2023-03-30,504,iron,449,879,430,1,00417,India
435648,2023-03-30,506,monitor,3249,8000,4751,1,00417,India
720136,2023-03-30,502,iphone 15 pro max,100000,135000,35000,1,00339,India
720136,2023-03-30,504,iron,449,879,430,1,00339,India
720136,2023-03-30,506,monitor,3249,8000,4751,1,00339,India
720136,2023-03-30,501,iphone 15,60000,80000,20000,1,00339,India
640669,2023-03-30,505,oven,18490,24000,5510,1,00233,India
124064,2023-03-30,507,washing machine,6990,16490,9500,1,00124,India
264236,2023-03-30,502,iphone 15 pro max,100000,135000,35000,1,00263,India
264236,2023-03-30,501,iphone 15,60000,80000,20000,1,00263,India
264236,2023-03-30,506,monitor,3249,8000,4751,1,00263,India
932550,2023-03-30,501,iphone 15,60000,80000,20000,1,00099,India
932550,2023-03-30,506,monitor,3249,8000,4751,1,00099,India
331180,2023-03-30,503,mixer,1349,3249,1900,1,00500,India
331180,2023-03-30,507,washing machine,6990,16490,9500,1,00500,India
331180,2023-03-30,501,iphone 15,60000,80000,20000,1,00500,India
331180,2023-03-30,502,iphone 15 pro max,100000,135000,35000,1,00500,India
607386,2023-03-30,507,washing machine,6990,16490,9500,1,00477,India
607386,2023-03-30,502,iphone 15 pro max,100000,135000,35000,1,00477,India
607386,2023-03-30,503,mixer,1349,3249,1900,1,00477,India
979225,2023-03-30,503,mixer,1349,3249,1900,1,00146,India
979225,2023-03-30,502,iphone 15 pro max,100000,135000,35000,1,00146,India
979225,2023-03-30,506,monitor,3249,8000,4751,1,00146,India
617659,2023-03-30,502,iphone 15 pro max,100000,135000,35000,1,00434,India
617659,2023-03-30,501,iphone 15,60000,80000,20000,1,00434,India
617659,2023-03-30,503,mixer,1349,3249,1900,1,00434,India
617659,2023-03-30,505,oven,18490,24000,5510,1,00434,India
594823,2023-03-30,503,mixer,1349,3249,1900,1,00123,India
594823,2023-03-30,505,oven,18490,24000,5510,1,00123,India
581128,2023-03-30,504,iron,449,879,430,1,00074,India
581128,2023-03-30,506,monitor,3249,8000,4751,1,00074,India
581128,2023-03-30,507,washing machine,6990,16490,9500,1,00074,India
426143,2023-03-30,504,iron,449,879,430,1,00400,India
426143,2023-03-30,505,oven,18490,24000,5510,1,00400,India
379237,2023-03-30,505,oven,18490,24000,5510,1,00152,India
379237,2023-03-30,507,washing machine,6990,16490,9500,1,00152,India
639499,2023-03-30,507,washing machine,6990,16490,9500,1,00299,India
639499,2023-03-30,501,iphone 15,60000,80000,20000,1,00299,India
639499,2023-03-30,505,oven,18490,24000,5510,1,00299,India
699146,2023-03-30,503,mixer,1349,3249,1900,1,00184,India
256930,2023-03-30,504,iron,449,879,430,1,00210,India
256930,2023-03-30,506,monitor,3249,8000,4751,1,00210,India
256930,2023-03-30,501,iphone 15,60000,80000,20000,1,00210,India
256930,2023-03-30,502,iphone 15 pro max,100000,135000,35000,1,00210,India
858868,2023-03-30,503,mixer,1349,3249,1900,1,00381,India
858868,2023-03-30,502,iphone 15 pro max,100000,135000,35000,1,00381,India
858868,2023-03-30,507,washing machine,6990,16490,9500,1,00381,India
858868,2023-03-30,501,iphone 15,60000,80000,20000,1,00381,India
344524,2023-03-30,506,monitor,3249,8000,4751,1,00296,India
322840,2023-03-30,502,iphone 15 pro max,100000,135000,35000,1,00454,India
973141,2023-03-30,501,iphone 15,60000,80000,20000,1,00200,India
553403,2023-03-30,504,iron,449,879,430,1,00492,India
553403,2023-03-30,506,monitor,3249,8000,4751,1,00492,India
553403,2023-03-30,502,iphone 15 pro max,100000,135000,35000,1,00492,India
532271,2023-03-30,503,mixer,1349,3249,1900,1,00309,India
532271,2023-03-30,505,oven,18490,24000,5510,1,00309,India
532271,2023-03-30,506,monitor,3249,8000,4751,1,00309,India
125122,2023-03-30,507,washing machine,6990,16490,9500,1,00379,India
125122,2023-03-30,504,iron,449,879,430,1,00379,India
125122,2023-03-30,501,iphone 15,60000,80000,20000,1,00379,India
125122,2023-03-30,506,monitor,3249,8000,4751,1,00379,India
762205,2023-03-30,506,monitor,3249,8000,4751,1,00386,India
762205,2023-03-30,504,iron,449,879,430,1,00386,India
762205,2023-03-30,507,washing machine,6990,16490,9500,1,00386,India
762205,2023-03-30,502,iphone 15 pro max,100000,135000,35000,1,00386,India
569889,2023-03-30,503,mixer,1349,3249,1900,1,00261,India
569889,2023-03-30,506,monitor,3249,8000,4751,1,00261,India
199733,2023-03-30,507,washing machine,6990,16490,9500,1,00015,India
199733,2023-03-30,501,iphone 15,60000,80000,20000,1,00015,India
199733,2023-03-30,506,monitor,3249,8000,4751,1,00015,India
199733,2023-03-30,503,mixer,1349,3249,1900,1,00015,India
283379,2023-03-30,504,iron,449,879,430,1,00414,India
283379,2023-03-30,501,iphone 15,60000,80000,20000,1,00414,India
283379,2023-03-30,506,monitor,3249,8000,4751,1,00414,India
283379,2023-03-30,505,oven,18490,24000,5510,1,00414,India
166384,2023-03-30,503,mixer,1349,3249,1900,1,00062,India
166384,2023-03-30,505,oven,18490,24000,5510,1,00062,India
166384,2023-03-30,502,iphone 15 pro max,100000,135000,35000,1,00062,India
974048,2023-03-30,502,iphone 15 pro max,100000,135000,35000,1,00017,India
935657,2023-03-30,501,iphone 15,60000,80000,20000,1,00400,India
935657,2023-03-30,507,washing machine,6990,16490,9500,1,00400,India
898846,2023-03-30,504,iron,449,879,430,1,00427,India
268934,2023-03-30,501,iphone 15,60000,80000,20000,1,00068,India
888004,2023-03-31,505,oven,18490,24000,5510,1,00324,India
888004,2023-03-31,501,iphone 15,60000,80000,20000,1,00324,India
888004,2023-03-31,502,iphone 15 pro max,100000,135000,35000,1,00324,India
888004,2023-03-31,507,washing machine,6990,16490,9500,1,00324,India
954323,2023-03-31,505,oven,18490,24000,5510,1,00102,India
954323,2023-03-31,503,mixer,1349,3249,1900,1,00102,India
954323,2023-03-31,507,washing machine,6990,16490,9500,1,00102,India
954323,2023-03-31,501,iphone 15,60000,80000,20000,1,00102,India
996101,2023-03-31,506,monitor,3249,8000,4751,1,00316,India
208587,2023-03-31,501,iphone 15,60000,80000,20000,1,00258,India
208587,2023-03-31,506,monitor,3249,8000,4751,1,00258,India
208587,2023-03-31,505,oven,18490,24000,5510,1,00258,India
256057,2023-03-31,501,iphone 15,60000,80000,20000,1,00309,India
256057,2023-03-31,502,iphone 15 pro max,100000,135000,35000,1,00309,India
256057,2023-03-31,503,mixer,1349,3249,1900,1,00309,India
733568,2023-03-31,502,iphone 15 pro max,100000,135000,35000,1,00428,India
521113,2023-03-31,501,iphone 15,60000,80000,20000,1,00251,India
521113,2023-03-31,506,monitor,3249,8000,4751,1,00251,India
521113,2023-03-31,507,washing machine,6990,16490,9500,1,00251,India
521113,2023-03-31,504,iron,449,879,430,1,00251,India
168826,2023-03-31,507,washing machine,6990,16490,9500,1,00464,India
168826,2023-03-31,506,monitor,3249,8000,4751,1,00464,India
168826,2023-03-31,503,mixer,1349,3249,1900,1,00464,India
842516,2023-03-31,504,iron,449,879,430,1,00417,India
842516,2023-03-31,503,mixer,1349,3249,1900,1,00417,India
842516,2023-03-31,501,iphone 15,60000,80000,20000,1,00417,India
223659,2023-03-31,505,oven,18490,24000,5510,1,00303,India
223659,2023-03-31,507,washing machine,6990,16490,9500,1,00303,India
223659,2023-03-31,503,mixer,1349,3249,1900,1,00303,India
367898,2023-03-31,505,oven,18490,24000,5510,1,00054,India
367898,2023-03-31,503,mixer,1349,3249,1900,1,00054,India
904948,2023-03-31,506,monitor,3249,8000,4751,1,00492,India
904948,2023-03-31,502,iphone 15 pro max,100000,135000,35000,1,00492,India
904948,2023-03-31,504,iron,449,879,430,1,00492,India
405975,2023-03-31,504,iron,449,879,430,1,00258,India
405975,2023-03-31,503,mixer,1349,3249,1900,1,00258,India
484647,2023-03-31,503,mixer,1349,3249,1900,1,00264,India
116584,2023-03-31,507,washing machine,6990,16490,9500,1,00435,India
116584,2023-03-31,503,mixer,1349,3249,1900,1,00435,India
116584,2023-03-31,502,iphone 15 pro max,100000,135000,35000,1,00435,India
171715,2023-03-31,504,iron,449,879,430,1,00013,India
233252,2023-03-31,503,mixer,1349,3249,1900,1,00394,India
233252,2023-03-31,506,monitor,3249,8000,4751,1,00394,India
233252,2023-03-31,502,iphone 15 pro max,100000,135000,35000,1,00394,India
535984,2023-03-31,505,oven,18490,24000,5510,1,00295,India
535984,2023-03-31,507,washing machine,6990,16490,9500,1,00295,India
364543,2023-03-31,506,monitor,3249,8000,4751,1,00037,India
364543,2023-03-31,501,iphone 15,60000,80000,20000,1,00037,India
364543,2023-03-31,502,iphone 15 pro max,100000,135000,35000,1,00037,India
393124,2023-03-31,506,monitor,3249,8000,4751,1,00088,India
538918,2023-03-31,507,washing machine,6990,16490,9500,1,00138,India
538918,2023-03-31,505,oven,18490,24000,5510,1,00138,India
157035,2023-03-31,506,monitor,3249,8000,4751,1,00096,India
537201,2023-03-31,506,monitor,3249,8000,4751,1,00389,India
537201,2023-03-31,503,mixer,1349,3249,1900,1,00389,India
258748,2023-03-31,504,iron,449,879,430,1,00485,India
857432,2023-03-31,501,iphone 15,60000,80000,20000,1,00429,India
655941,2023-03-31,504,iron,449,879,430,1,00200,India
655941,2023-03-31,506,monitor,3249,8000,4751,1,00200,India
655941,2023-03-31,503,mixer,1349,3249,1900,1,00200,India
655941,2023-03-31,501,iphone 15,60000,80000,20000,1,00200,India
655941,2023-03-31,507,washing machine,6990,16490,9500,1,00200,India
755410,2023-03-31,501,iphone 15,60000,80000,20000,1,00168,India
755410,2023-03-31,502,iphone 15 pro max,100000,135000,35000,1,00168,India
994355,2023-03-31,505,oven,18490,24000,5510,1,00271,India
994355,2023-03-31,507,washing machine,6990,16490,9500,1,00271,India
994355,2023-03-31,506,monitor,3249,8000,4751,1,00271,India
977872,2023-03-31,507,washing machine,6990,16490,9500,1,00189,India
977872,2023-03-31,502,iphone 15 pro max,100000,135000,35000,1,00189,India
725679,2023-03-31,507,washing machine,6990,16490,9500,1,00322,India
725679,2023-03-31,505,oven,18490,24000,5510,1,00322,India
180018,2023-03-31,501,iphone 15,60000,80000,20000,1,00489,India
684383,2023-03-31,505,oven,18490,24000,5510,1,00323,India
640175,2023-03-31,506,monitor,3249,8000,4751,1,00240,India
640175,2023-03-31,505,oven,18490,24000,5510,1,00240,India
640175,2023-03-31,504,iron,449,879,430,1,00240,India
640175,2023-03-31,501,iphone 15,60000,80000,20000,1,00240,India
306813,2023-03-31,505,oven,18490,24000,5510,1,00134,India
154342,2023-03-31,505,oven,18490,24000,5510,1,00230,India
154342,2023-03-31,504,iron,449,879,430,1,00230,India
154342,2023-03-31,503,mixer,1349,3249,1900,1,00230,India
510867,2023-03-31,504,iron,449,879,430,1,00397,India
159990,2023-03-31,502,iphone 15 pro max,100000,135000,35000,1,00164,India
159990,2023-03-31,504,iron,449,879,430,1,00164,India
159990,2023-03-31,506,monitor,3249,8000,4751,1,00164,India
159990,2023-03-31,503,mixer,1349,3249,1900,1,00164,India
592376,2023-03-31,503,mixer,1349,3249,1900,1,00256,India
666734,2023-03-31,507,washing machine,6990,16490,9500,1,00491,India
666734,2023-03-31,502,iphone 15 pro max,100000,135000,35000,1,00491,India
666734,2023-03-31,501,iphone 15,60000,80000,20000,1,00491,India
416783,2023-03-31,506,monitor,3249,8000,4751,1,00497,India
954047,2023-03-31,503,mixer,1349,3249,1900,1,00093,India
954047,2023-03-31,507,washing machine,6990,16490,9500,1,00093,India
954047,2023-03-31,501,iphone 15,60000,80000,20000,1,00093,India
954047,2023-03-31,505,oven,18490,24000,5510,1,00093,India
375897,2023-03-31,502,iphone 15 pro max,100000,135000,35000,1,00103,India
624191,2023-03-31,503,mixer,1349,3249,1900,1,00359,India
624191,2023-03-31,506,monitor,3249,8000,4751,1,00359,India
894817,2023-03-31,505,oven,18490,24000,5510,1,00214,India
894817,2023-03-31,503,mixer,1349,3249,1900,1,00214,India
429005,2023-03-31,507,washing machine,6990,16490,9500,1,00095,India
429005,2023-03-31,503,mixer,1349,3249,1900,1,00095,India
429005,2023-03-31,506,monitor,3249,8000,4751,1,00095,India
157775,2023-03-31,501,iphone 15,60000,80000,20000,1,00177,India
157775,2023-03-31,507,washing machine,6990,16490,9500,1,00177,India
157775,2023-03-31,506,monitor,3249,8000,4751,1,00177,India
543258,2023-03-31,502,iphone 15 pro max,100000,135000,35000,1,00437,India
543258,2023-03-31,505,oven,18490,24000,5510,1,00437,India
543258,2023-03-31,504,iron,449,879,430,1,00437,India
543258,2023-03-31,506,monitor,3249,8000,4751,1,00437,India
971330,2023-03-31,507,washing machine,6990,16490,9500,1,00361,India
971330,2023-03-31,505,oven,18490,24000,5510,1,00361,India
778396,2023-03-31,503,mixer,1349,3249,1900,1,00018,India
905158,2023-03-31,503,mixer,1349,3249,1900,1,00368,India
905158,2023-03-31,506,monitor,3249,8000,4751,1,00368,India
905158,2023-03-31,507,washing machine,6990,16490,9500,1,00368,India
185990,2023-03-31,502,iphone 15 pro max,100000,135000,35000,1,00062,India
185990,2023-03-31,506,monitor,3249,8000,4751,1,00062,India
185990,2023-03-31,501,iphone 15,60000,80000,20000,1,00062,India
185990,2023-03-31,505,oven,18490,24000,5510,1,00062,India
975595,2023-03-31,502,iphone 15 pro max,100000,135000,35000,1,00435,India
975595,2023-03-31,503,mixer,1349,3249,1900,1,00435,India
190243,2023-03-31,502,iphone 15 pro max,100000,135000,35000,1,00140,India
190243,2023-03-31,506,monitor,3249,8000,4751,1,00140,India
190243,2023-03-31,507,washing machine,6990,16490,9500,1,00140,India
390140,2023-03-31,505,oven,18490,24000,5510,1,00450,India
305786,2023-03-31,505,oven,18490,24000,5510,1,00364,India
825883,2023-03-31,502,iphone 15 pro max,100000,135000,35000,1,00114,India
825883,2023-03-31,506,monitor,3249,8000,4751,1,00114,India
825883,2023-03-31,505,oven,18490,24000,5510,1,00114,India
558503,2023-03-31,506,monitor,3249,8000,4751,1,00171,India
558503,2023-03-31,502,iphone 15 pro max,100000,135000,35000,1,00171,India
558503,2023-03-31,504,iron,449,879,430,1,00171,India
558503,2023-03-31,501,iphone 15,60000,80000,20000,1,00171,India
870567,2023-03-31,501,iphone 15,60000,80000,20000,1,00053,India
870567,2023-03-31,506,monitor,3249,8000,4751,1,00053,India
134900,2023-03-31,503,mixer,1349,3249,1900,1,00225,India
134900,2023-03-31,507,washing machine,6990,16490,9500,1,00225,India
134900,2023-03-31,502,iphone 15 pro max,100000,135000,35000,1,00225,India
134900,2023-03-31,501,iphone 15,60000,80000,20000,1,00225,India
882174,2023-03-31,502,iphone 15 pro max,100000,135000,35000,1,00110,India
882174,2023-03-31,504,iron,449,879,430,1,00110,India
357752,2023-03-31,502,iphone 15 pro max,100000,135000,35000,1,00062,India
357752,2023-03-31,507,washing machine,6990,16490,9500,1,00062,India
372602,2023-03-31,501,iphone 15,60000,80000,20000,1,00265,India
372602,2023-03-31,506,monitor,3249,8000,4751,1,00265,India
349205,2023-03-31,502,iphone 15 pro max,100000,135000,35000,1,00215,India
349205,2023-03-31,503,mixer,1349,3249,1900,1,00215,India
919091,2023-03-31,502,iphone 15 pro max,100000,135000,35000,1,00026,India
919091,2023-03-31,507,washing machine,6990,16490,9500,1,00026,India
919091,2023-03-31,506,monitor,3249,8000,4751,1,00026,India
323965,2023-03-31,504,iron,449,879,430,1,00161,India
323965,2023-03-31,501,iphone 15,60000,80000,20000,1,00161,India
726300,2023-03-31,503,mixer,1349,3249,1900,1,00128,India
726300,2023-03-31,504,iron,449,879,430,1,00128,India
726300,2023-03-31,506,monitor,3249,8000,4751,1,00128,India
992806,2023-03-31,506,monitor,3249,8000,4751,1,00197,India
992806,2023-03-31,507,washing machine,6990,16490,9500,1,00197,India
223361,2023-03-31,502,iphone 15 pro max,100000,135000,35000,1,00451,India
427259,2023-03-31,506,monitor,3249,8000,4751,1,00423,India
581302,2023-03-31,505,oven,18490,24000,5510,1,00064,India
581302,2023-03-31,506,monitor,3249,8000,4751,1,00064,India
555230,2023-03-31,502,iphone 15 pro max,100000,135000,35000,1,00488,India
785772,2023-03-31,505,oven,18490,24000,5510,1,00335,India
785772,2023-03-31,502,iphone 15 pro max,100000,135000,35000,1,00335,India
785772,2023-03-31,501,iphone 15,60000,80000,20000,1,00335,India
194313,2023-03-31,507,washing machine,6990,16490,9500,1,00139,India
194313,2023-03-31,502,iphone 15 pro max,100000,135000,35000,1,00139,India
194313,2023-03-31,506,monitor,3249,8000,4751,1,00139,India
194313,2023-03-31,503,mixer,1349,3249,1900,1,00139,India
851057,2023-03-31,502,iphone 15 pro max,100000,135000,35000,1,00125,India
851057,2023-03-31,501,iphone 15,60000,80000,20000,1,00125,India
851057,2023-03-31,507,washing machine,6990,16490,9500,1,00125,India
183657,2023-03-31,505,oven,18490,24000,5510,1,00268,India
183657,2023-03-31,502,iphone 15 pro max,100000,135000,35000,1,00268,India
183657,2023-03-31,504,iron,449,879,430,1,00268,India
183657,2023-03-31,507,washing machine,6990,16490,9500,1,00268,India
630063,2023-03-31,501,iphone 15,60000,80000,20000,1,00201,India
630063,2023-03-31,507,washing machine,6990,16490,9500,1,00201,India
292962,2023-03-31,504,iron,449,879,430,1,00134,India
292962,2023-03-31,501,iphone 15,60000,80000,20000,1,00134,India
292962,2023-03-31,505,oven,18490,24000,5510,1,00134,India
392011,2023-03-31,506,monitor,3249,8000,4751,1,00047,India
392011,2023-03-31,507,washing machine,6990,16490,9500,1,00047,India
392011,2023-03-31,501,iphone 15,60000,80000,20000,1,00047,India
428237,2023-03-31,503,mixer,1349,3249,1900,1,00075,India
428237,2023-03-31,505,oven,18490,24000,5510,1,00075,India
546408,2023-03-31,505,oven,18490,24000,5510,1,00367,India
546408,2023-03-31,502,iphone 15 pro max,100000,135000,35000,1,00367,India
546408,2023-03-31,507,washing machine,6990,16490,9500,1,00367,India
546408,2023-03-31,506,monitor,3249,8000,4751,1,00367,India
587194,2023-03-31,505,oven,18490,24000,5510,1,00277,India
587194,2023-03-31,502,iphone 15 pro max,100000,135000,35000,1,00277,India
564874,2023-03-31,505,oven,18490,24000,5510,1,00485,India
564874,2023-03-31,502,iphone 15 pro max,100000,135000,35000,1,00485,India
564874,2023-03-31,501,iphone 15,60000,80000,20000,1,00485,India
564874,2023-03-31,506,monitor,3249,8000,4751,1,00485,India
303732,2023-03-31,507,washing machine,6990,16490,9500,1,00078,India
303732,2023-03-31,505,oven,18490,24000,5510,1,00078,India
824869,2023-03-31,504,iron,449,879,430,1,00182,India
322455,2023-03-31,501,iphone 15,60000,80000,20000,1,00123,India
322455,2023-03-31,505,oven,18490,24000,5510,1,00123,India
322455,2023-03-31,502,iphone 15 pro max,100000,135000,35000,1,00123,India
130798,2023-03-31,506,monitor,3249,8000,4751,1,00072,India
130798,2023-03-31,504,iron,449,879,430,1,00072,India
776706,2023-03-31,502,iphone 15 pro max,100000,135000,35000,1,00319,India
776706,2023-03-31,506,monitor,3249,8000,4751,1,00319,India
210488,2023-03-31,506,monitor,3249,8000,4751,1,00445,India
210488,2023-03-31,502,iphone 15 pro max,100000,135000,35000,1,00445,India
683671,2023-03-31,505,oven,18490,24000,5510,1,00220,India
683671,2023-03-31,503,mixer,1349,3249,1900,1,00220,India
683671,2023-03-31,504,iron,449,879,430,1,00220,India
911079,2023-03-31,504,iron,449,879,430,1,00498,India
911079,2023-03-31,507,washing machine,6990,16490,9500,1,00498,India
989900,2023-03-31,504,iron,449,879,430,1,00072,India
784345,2023-03-31,504,iron,449,879,430,1,00278,India
784345,2023-03-31,506,monitor,3249,8000,4751,1,00278,India
784345,2023-03-31,507,washing machine,6990,16490,9500,1,00278,India
640833,2023-03-31,505,oven,18490,24000,5510,1,00154,India
640833,2023-03-31,504,iron,449,879,430,1,00154,India
250133,2023-03-31,503,mixer,1349,3249,1900,1,00295,India
945514,2023-03-31,505,oven,18490,24000,5510,1,00230,India
945514,2023-03-31,507,washing machine,6990,16490,9500,1,00230,India
945514,2023-03-31,503,mixer,1349,3249,1900,1,00230,India
945514,2023-03-31,506,monitor,3249,8000,4751,1,00230,India
744732,2023-03-31,504,iron,449,879,430,1,00377,India
744732,2023-03-31,505,oven,18490,24000,5510,1,00377,India
641076,2023-03-31,506,monitor,3249,8000,4751,1,00494,India
702708,2023-03-31,506,monitor,3249,8000,4751,1,00075,India
702708,2023-03-31,504,iron,449,879,430,1,00075,India
294145,2023-04-01,502,iphone 15 pro max,100000,135000,35000,1,00189,India
534881,2023-04-01,504,iron,449,879,430,1,00094,India
534881,2023-04-01,501,iphone 15,60000,80000,20000,1,00094,India
534881,2023-04-01,507,washing machine,6990,16490,9500,1,00094,India
119186,2023-04-01,505,oven,18490,24000,5510,1,00461,India
119186,2023-04-01,504,iron,449,879,430,1,00461,India
119186,2023-04-01,501,iphone 15,60000,80000,20000,1,00461,India
519244,2023-04-01,503,mixer,1349,3249,1900,1,00135,India
519244,2023-04-01,505,oven,18490,24000,5510,1,00135,India
668963,2023-04-01,506,monitor,3249,8000,4751,1,00285,India
668963,2023-04-01,505,oven,18490,24000,5510,1,00285,India
668963,2023-04-01,504,iron,449,879,430,1,00285,India
668963,2023-04-01,502,iphone 15 pro max,100000,135000,35000,1,00285,India
461826,2023-04-01,504,iron,449,879,430,1,00478,India
461826,2023-04-01,507,washing machine,6990,16490,9500,1,00478,India
461826,2023-04-01,506,monitor,3249,8000,4751,1,00478,India
197587,2023-04-01,506,monitor,3249,8000,4751,1,00034,India
731566,2023-04-01,504,iron,449,879,430,1,00037,India
951189,2023-04-01,505,oven,18490,24000,5510,1,00065,India
951189,2023-04-01,507,washing machine,6990,16490,9500,1,00065,India
951189,2023-04-01,503,mixer,1349,3249,1900,1,00065,India
186040,2023-04-01,501,iphone 15,60000,80000,20000,1,00178,India
663601,2023-04-01,506,monitor,3249,8000,4751,1,00404,India
653095,2023-04-01,503,mixer,1349,3249,1900,1,00465,India
653095,2023-04-01,506,monitor,3249,8000,4751,1,00465,India
869635,2023-04-01,506,monitor,3249,8000,4751,1,00491,India
869635,2023-04-01,502,iphone 15 pro max,100000,135000,35000,1,00491,India
869635,2023-04-01,501,iphone 15,60000,80000,20000,1,00491,India
528259,2023-04-01,505,oven,18490,24000,5510,1,00339,India
528259,2023-04-01,507,washing machine,6990,16490,9500,1,00339,India
528259,2023-04-01,506,monitor,3249,8000,4751,1,00339,India
809595,2023-04-01,507,washing machine,6990,16490,9500,1,00337,India
809595,2023-04-01,505,oven,18490,24000,5510,1,00337,India
781203,2023-04-01,501,iphone 15,60000,80000,20000,1,00272,India
781203,2023-04-01,504,iron,449,879,430,1,00272,India
615373,2023-04-01,504,iron,449,879,430,1,00434,India
615373,2023-04-01,503,mixer,1349,3249,1900,1,00434,India
615373,2023-04-01,507,washing machine,6990,16490,9500,1,00434,India
615373,2023-04-01,505,oven,18490,24000,5510,1,00434,India
450519,2023-04-01,503,mixer,1349,3249,1900,1,00222,India
450519,2023-04-01,505,oven,18490,24000,5510,1,00222,India
450519,2023-04-01,506,monitor,3249,8000,4751,1,00222,India
450519,2023-04-01,502,iphone 15 pro max,100000,135000,35000,1,00222,India
634348,2023-04-01,503,mixer,1349,3249,1900,1,00187,India
634348,2023-04-01,501,iphone 15,60000,80000,20000,1,00187,India
634348,2023-04-01,506,monitor,3249,8000,4751,1,00187,India
376901,2023-04-01,506,monitor,3249,8000,4751,1,00367,India
376901,2023-04-01,501,iphone 15,60000,80000,20000,1,00367,India
376901,2023-04-01,505,oven,18490,24000,5510,1,00367,India
563718,2023-04-01,507,washing machine,6990,16490,9500,1,00188,India
563718,2023-04-01,502,iphone 15 pro max,100000,135000,35000,1,00188,India
891517,2023-04-01,502,iphone 15 pro max,100000,135000,35000,1,00006,India
891517,2023-04-01,506,monitor,3249,8000,4751,1,00006,India
891517,2023-04-01,507,washing machine,6990,16490,9500,1,00006,India
504906,2023-04-01,504,iron,449,879,430,1,00309,India
504906,2023-04-01,503,mixer,1349,3249,1900,1,00309,India
504906,2023-04-01,507,washing machine,6990,16490,9500,1,00309,India
504906,2023-04-01,502,iphone 15 pro max,100000,135000,35000,1,00309,India
862989,2023-04-01,503,mixer,1349,3249,1900,1,00410,India
862989,2023-04-01,506,monitor,3249,8000,4751,1,00410,India
393805,2023-04-01,505,oven,18490,24000,5510,1,00484,India
393805,2023-04-01,501,iphone 15,60000,80000,20000,1,00484,India
393805,2023-04-01,503,mixer,1349,3249,1900,1,00484,India
862572,2023-04-01,506,monitor,3249,8000,4751,1,00445,India
862572,2023-04-01,503,mixer,1349,3249,1900,1,00445,India
687934,2023-04-01,507,washing machine,6990,16490,9500,1,00195,India
687934,2023-04-01,503,mixer,1349,3249,1900,1,00195,India
429549,2023-04-01,503,mixer,1349,3249,1900,1,00285,India
429549,2023-04-01,507,washing machine,6990,16490,9500,1,00285,India
429549,2023-04-01,501,iphone 15,60000,80000,20000,1,00285,India
889665,2023-04-01,507,washing machine,6990,16490,9500,1,00371,India
889665,2023-04-01,506,monitor,3249,8000,4751,1,00371,India
889665,2023-04-01,505,oven,18490,24000,5510,1,00371,India
889665,2023-04-01,503,mixer,1349,3249,1900,1,00371,India
949373,2023-04-01,501,iphone 15,60000,80000,20000,1,00183,India
830286,2023-04-01,506,monitor,3249,8000,4751,1,00067,India
830286,2023-04-01,507,washing machine,6990,16490,9500,1,00067,India
563214,2023-04-01,507,washing machine,6990,16490,9500,1,00472,India
563214,2023-04-01,502,iphone 15 pro max,100000,135000,35000,1,00472,India
563214,2023-04-01,501,iphone 15,60000,80000,20000,1,00472,India
563214,2023-04-01,505,oven,18490,24000,5510,1,00472,India
482513,2023-04-01,501,iphone 15,60000,80000,20000,1,00075,India
482513,2023-04-01,506,monitor,3249,8000,4751,1,00075,India
482513,2023-04-01,505,oven,18490,24000,5510,1,00075,India
390344,2023-04-01,501,iphone 15,60000,80000,20000,1,00043,India
338586,2023-04-01,504,iron,449,879,430,1,00352,India
338586,2023-04-01,501,iphone 15,60000,80000,20000,1,00352,India
338586,2023-04-01,506,monitor,3249,8000,4751,1,00352,India
338586,2023-04-01,503,mixer,1349,3249,1900,1,00352,India
338586,2023-04-01,505,oven,18490,24000,5510,1,00352,India
639850,2023-04-01,505,oven,18490,24000,5510,1,00066,India
639850,2023-04-01,507,washing machine,6990,16490,9500,1,00066,India
115170,2023-04-01,503,mixer,1349,3249,1900,1,00475,India
115170,2023-04-01,501,iphone 15,60000,80000,20000,1,00475,India
115170,2023-04-01,502,iphone 15 pro max,100000,135000,35000,1,00475,India
433193,2023-04-01,505,oven,18490,24000,5510,1,00441,India
433193,2023-04-01,507,washing machine,6990,16490,9500,1,00441,India
433193,2023-04-01,504,iron,449,879,430,1,00441,India
819475,2023-04-01,507,washing machine,6990,16490,9500,1,00420,India
427491,2023-04-01,501,iphone 15,60000,80000,20000,1,00213,India
427491,2023-04-01,503,mixer,1349,3249,1900,1,00213,India
427491,2023-04-01,506,monitor,3249,8000,4751,1,00213,India
427491,2023-04-01,502,iphone 15 pro max,100000,135000,35000,1,00213,India
577357,2023-04-01,501,iphone 15,60000,80000,20000,1,00216,India
577357,2023-04-01,506,monitor,3249,8000,4751,1,00216,India
577357,2023-04-01,502,iphone 15 pro max,100000,135000,35000,1,00216,India
577357,2023-04-01,504,iron,449,879,430,1,00216,India
215167,2023-04-01,506,monitor,3249,8000,4751,1,00264,India
215167,2023-04-01,503,mixer,1349,3249,1900,1,00264,India
328174,2023-04-01,505,oven,18490,24000,5510,1,00233,India
782486,2023-04-01,501,iphone 15,60000,80000,20000,1,00246,India
782486,2023-04-01,505,oven,18490,24000,5510,1,00246,India
782486,2023-04-01,503,mixer,1349,3249,1900,1,00246,India
782486,2023-04-01,502,iphone 15 pro max,100000,135000,35000,1,00246,India
630518,2023-04-01,506,monitor,3249,8000,4751,1,00477,India
630518,2023-04-01,504,iron,449,879,430,1,00477,India
630518,2023-04-01,501,iphone 15,60000,80000,20000,1,00477,India
363798,2023-04-01,502,iphone 15 pro max,100000,135000,35000,1,00497,India
566867,2023-04-01,506,monitor,3249,8000,4751,1,00198,India
566867,2023-04-01,505,oven,18490,24000,5510,1,00198,India
349817,2023-04-01,503,mixer,1349,3249,1900,1,00134,India
349817,2023-04-01,504,iron,449,879,430,1,00134,India
349817,2023-04-01,506,monitor,3249,8000,4751,1,00134,India
888684,2023-04-01,503,mixer,1349,3249,1900,1,00191,India
888684,2023-04-01,507,washing machine,6990,16490,9500,1,00191,India
815579,2023-04-01,501,iphone 15,60000,80000,20000,1,00442,India
580780,2023-04-01,504,iron,449,879,430,1,00287,India
580780,2023-04-01,507,washing machine,6990,16490,9500,1,00287,India
956352,2023-04-01,501,iphone 15,60000,80000,20000,1,00194,India
956352,2023-04-01,505,oven,18490,24000,5510,1,00194,India
956352,2023-04-01,507,washing machine,6990,16490,9500,1,00194,India
243546,2023-04-01,505,oven,18490,24000,5510,1,00350,India
243546,2023-04-01,503,mixer,1349,3249,1900,1,00350,India
243546,2023-04-01,501,iphone 15,60000,80000,20000,1,00350,India
243546,2023-04-01,507,washing machine,6990,16490,9500,1,00350,India
491464,2023-04-01,506,monitor,3249,8000,4751,1,00468,India
491464,2023-04-01,504,iron,449,879,430,1,00468,India
358758,2023-04-01,507,washing machine,6990,16490,9500,1,00027,India
358758,2023-04-01,503,mixer,1349,3249,1900,1,00027,India
358758,2023-04-01,506,monitor,3249,8000,4751,1,00027,India
687523,2023-04-01,503,mixer,1349,3249,1900,1,00270,India
687523,2023-04-01,502,iphone 15 pro max,100000,135000,35000,1,00270,India
810827,2023-04-01,505,oven,18490,24000,5510,1,00242,India
653725,2023-04-02,502,iphone 15 pro max,100000,135000,35000,1,00084,India
644748,2023-04-02,507,washing machine,6990,16490,9500,1,00284,India
644748,2023-04-02,506,monitor,3249,8000,4751,1,00284,India
234220,2023-04-02,502,iphone 15 pro max,100000,135000,35000,1,00464,India
234220,2023-04-02,507,washing machine,6990,16490,9500,1,00464,India
549976,2023-04-02,505,oven,18490,24000,5510,1,00278,India
549976,2023-04-02,501,iphone 15,60000,80000,20000,1,00278,India
549976,2023-04-02,504,iron,449,879,430,1,00278,India
775744,2023-04-02,503,mixer,1349,3249,1900,1,00161,India
775744,2023-04-02,506,monitor,3249,8000,4751,1,00161,India
848070,2023-04-02,505,oven,18490,24000,5510,1,00449,India
255177,2023-04-02,501,iphone 15,60000,80000,20000,1,00028,India
255177,2023-04-02,502,iphone 15 pro max,100000,135000,35000,1,00028,India
255177,2023-04-02,506,monitor,3249,8000,4751,1,00028,India
255177,2023-04-02,505,oven,18490,24000,5510,1,00028,India
762251,2023-04-02,505,oven,18490,24000,5510,1,00003,India
762251,2023-04-02,501,iphone 15,60000,80000,20000,1,00003,India
661179,2023-04-02,503,mixer,1349,3249,1900,1,00433,India
661179,2023-04-02,501,iphone 15,60000,80000,20000,1,00433,India
426601,2023-04-02,501,iphone 15,60000,80000,20000,1,00403,India
401308,2023-04-02,505,oven,18490,24000,5510,1,00320,India
401308,2023-04-02,503,mixer,1349,3249,1900,1,00320,India
552121,2023-04-02,504,iron,449,879,430,1,00061,India
552121,2023-04-02,506,monitor,3249,8000,4751,1,00061,India
552121,2023-04-02,502,iphone 15 pro max,100000,135000,35000,1,00061,India
552121,2023-04-02,507,washing machine,6990,16490,9500,1,00061,India
393351,2023-04-02,507,washing machine,6990,16490,9500,1,00134,India
393351,2023-04-02,505,oven,18490,24000,5510,1,00134,India
393351,2023-04-02,501,iphone 15,60000,80000,20000,1,00134,India
393351,2023-04-02,506,monitor,3249,8000,4751,1,00134,India
350842,2023-04-02,502,iphone 15 pro max,100000,135000,35000,1,00192,India
549380,2023-04-02,505,oven,18490,24000,5510,1,00430,India
549380,2023-04-02,504,iron,449,879,430,1,00430,India
266152,2023-04-02,501,iphone 15,60000,80000,20000,1,00423,India
266152,2023-04-02,506,monitor,3249,8000,4751,1,00423,India
266152,2023-04-02,503,mixer,1349,3249,1900,1,00423,India
662878,2023-04-02,501,iphone 15,60000,80000,20000,1,00401,India
662878,2023-04-02,504,iron,449,879,430,1,00401,India
408013,2023-04-02,507,washing machine,6990,16490,9500,1,00274,India
408013,2023-04-02,505,oven,18490,24000,5510,1,00274,India
408013,2023-04-02,504,iron,449,879,430,1,00274,India
633726,2023-04-02,501,iphone 15,60000,80000,20000,1,00183,India
633726,2023-04-02,506,monitor,3249,8000,4751,1,00183,India
633726,2023-04-02,507,washing machine,6990,16490,9500,1,00183,India
633726,2023-04-02,504,iron,449,879,430,1,00183,India
161848,2023-04-02,505,oven,18490,24000,5510,1,00313,India
161848,2023-04-02,506,monitor,3249,8000,4751,1,00313,India
161848,2023-04-02,503,mixer,1349,3249,1900,1,00313,India
729469,2023-04-02,501,iphone 15,60000,80000,20000,1,00089,India
391669,2023-04-02,507,washing machine,6990,16490,9500,1,00089,India
391669,2023-04-02,502,iphone 15 pro max,100000,135000,35000,1,00089,India
391669,2023-04-02,503,mixer,1349,3249,1900,1,00089,India
744426,2023-04-02,504,iron,449,879,430,1,00477,India
435250,2023-04-02,504,iron,449,879,430,1,00088,India
896768,2023-04-02,506,monitor,3249,8000,4751,1,00084,India
833887,2023-04-02,502,iphone 15 pro max,100000,135000,35000,1,00147,India
833887,2023-04-02,503,mixer,1349,3249,1900,1,00147,India
833887,2023-04-02,501,iphone 15,60000,80000,20000,1,00147,India
833887,2023-04-02,506,monitor,3249,8000,4751,1,00147,India
833887,2023-04-02,504,iron,449,879,430,1,00147,India
867982,2023-04-02,505,oven,18490,24000,5510,1,00032,India
867982,2023-04-02,507,washing machine,6990,16490,9500,1,00032,India
867982,2023-04-02,502,iphone 15 pro max,100000,135000,35000,1,00032,India
867982,2023-04-02,506,monitor,3249,8000,4751,1,00032,India
867982,2023-04-02,503,mixer,1349,3249,1900,1,00032,India
807786,2023-04-02,502,iphone 15 pro max,100000,135000,35000,1,00247,India
807786,2023-04-02,506,monitor,3249,8000,4751,1,00247,India
807786,2023-04-02,505,oven,18490,24000,5510,1,00247,India
807786,2023-04-02,504,iron,449,879,430,1,00247,India
307585,2023-04-02,505,oven,18490,24000,5510,1,00360,India
782870,2023-04-02,507,washing machine,6990,16490,9500,1,00231,India
782870,2023-04-02,502,iphone 15 pro max,100000,135000,35000,1,00231,India
782870,2023-04-02,501,iphone 15,60000,80000,20000,1,00231,India
782870,2023-04-02,504,iron,449,879,430,1,00231,India
795512,2023-04-02,504,iron,449,879,430,1,00357,India
795512,2023-04-02,507,washing machine,6990,16490,9500,1,00357,India
279113,2023-04-02,501,iphone 15,60000,80000,20000,1,00091,India
279113,2023-04-02,503,mixer,1349,3249,1900,1,00091,India
279113,2023-04-02,504,iron,449,879,430,1,00091,India
472768,2023-04-02,503,mixer,1349,3249,1900,1,00204,India
616992,2023-04-02,501,iphone 15,60000,80000,20000,1,00437,India
616992,2023-04-02,505,oven,18490,24000,5510,1,00437,India
616992,2023-04-02,506,monitor,3249,8000,4751,1,00437,India
729959,2023-04-02,507,washing machine,6990,16490,9500,1,00397,India
729959,2023-04-02,502,iphone 15 pro max,100000,135000,35000,1,00397,India
671521,2023-04-02,503,mixer,1349,3249,1900,1,00487,India
671521,2023-04-02,506,monitor,3249,8000,4751,1,00487,India
671521,2023-04-02,507,washing machine,6990,16490,9500,1,00487,India
386959,2023-04-02,506,monitor,3249,8000,4751,1,00046,India
386959,2023-04-02,504,iron,449,879,430,1,00046,India
882287,2023-04-02,506,monitor,3249,8000,4751,1,00206,India
882287,2023-04-02,507,washing machine,6990,16490,9500,1,00206,India
882287,2023-04-02,505,oven,18490,24000,5510,1,00206,India
223945,2023-04-02,504,iron,449,879,430,1,00472,India
223945,2023-04-02,503,mixer,1349,3249,1900,1,00472,India
223945,2023-04-02,506,monitor,3249,8000,4751,1,00472,India
404200,2023-04-02,505,oven,18490,24000,5510,1,00075,India
632994,2023-04-02,506,monitor,3249,8000,4751,1,00312,India
632994,2023-04-02,504,iron,449,879,430,1,00312,India
632994,2023-04-02,501,iphone 15,60000,80000,20000,1,00312,India
632994,2023-04-02,507,washing machine,6990,16490,9500,1,00312,India
826733,2023-04-02,503,mixer,1349,3249,1900,1,00055,India
826733,2023-04-02,504,iron,449,879,430,1,00055,India
826733,2023-04-02,507,washing machine,6990,16490,9500,1,00055,India
826733,2023-04-02,506,monitor,3249,8000,4751,1,00055,India
849485,2023-04-02,502,iphone 15 pro max,100000,135000,35000,1,00145,India
849485,2023-04-02,506,monitor,3249,8000,4751,1,00145,India
849485,2023-04-02,503,mixer,1349,3249,1900,1,00145,India
505966,2023-04-02,501,iphone 15,60000,80000,20000,1,00119,India
505966,2023-04-02,504,iron,449,879,430,1,00119,India
281418,2023-04-02,501,iphone 15,60000,80000,20000,1,00182,India
281418,2023-04-02,505,oven,18490,24000,5510,1,00182,India
978742,2023-04-02,507,washing machine,6990,16490,9500,1,00205,India
978742,2023-04-02,502,iphone 15 pro max,100000,135000,35000,1,00205,India
978742,2023-04-02,506,monitor,3249,8000,4751,1,00205,India
427261,2023-04-02,502,iphone 15 pro max,100000,135000,35000,1,00316,India
581164,2023-04-02,506,monitor,3249,8000,4751,1,00311,India
581164,2023-04-02,503,mixer,1349,3249,1900,1,00311,India
581164,2023-04-02,502,iphone 15 pro max,100000,135000,35000,1,00311,India
581164,2023-04-02,505,oven,18490,24000,5510,1,00311,India
516151,2023-04-02,502,iphone 15 pro max,100000,135000,35000,1,00130,India
516151,2023-04-02,506,monitor,3249,8000,4751,1,00130,India
516151,2023-04-02,503,mixer,1349,3249,1900,1,00130,India
516151,2023-04-02,504,iron,449,879,430,1,00130,India
456801,2023-04-02,506,monitor,3249,8000,4751,1,00051,India
456801,2023-04-02,507,washing machine,6990,16490,9500,1,00051,India
456801,2023-04-02,504,iron,449,879,430,1,00051,India
456801,2023-04-02,501,iphone 15,60000,80000,20000,1,00051,India
720038,2023-04-02,505,oven,18490,24000,5510,1,00174,India
720038,2023-04-02,507,washing machine,6990,16490,9500,1,00174,India
720038,2023-04-02,503,mixer,1349,3249,1900,1,00174,India
935549,2023-04-02,504,iron,449,879,430,1,00330,India
382050,2023-04-02,506,monitor,3249,8000,4751,1,00221,India
382050,2023-04-02,503,mixer,1349,3249,1900,1,00221,India
382050,2023-04-02,505,oven,18490,24000,5510,1,00221,India
382050,2023-04-02,507,washing machine,6990,16490,9500,1,00221,India
382050,2023-04-02,504,iron,449,879,430,1,00221,India
985644,2023-04-02,506,monitor,3249,8000,4751,1,00429,India
985644,2023-04-02,507,washing machine,6990,16490,9500,1,00429,India
985644,2023-04-02,502,iphone 15 pro max,100000,135000,35000,1,00429,India
892087,2023-04-02,506,monitor,3249,8000,4751,1,00316,India
892087,2023-04-02,504,iron,449,879,430,1,00316,India
892087,2023-04-02,502,iphone 15 pro max,100000,135000,35000,1,00316,India
278053,2023-04-02,506,monitor,3249,8000,4751,1,00486,India
278053,2023-04-02,504,iron,449,879,430,1,00486,India
278053,2023-04-02,505,oven,18490,24000,5510,1,00486,India
278053,2023-04-02,503,mixer,1349,3249,1900,1,00486,India
767401,2023-04-02,507,washing machine,6990,16490,9500,1,00270,India
767401,2023-04-02,501,iphone 15,60000,80000,20000,1,00270,India
767401,2023-04-02,502,iphone 15 pro max,100000,135000,35000,1,00270,India
817499,2023-04-02,507,washing machine,6990,16490,9500,1,00240,India
817499,2023-04-02,501,iphone 15,60000,80000,20000,1,00240,India
817499,2023-04-02,504,iron,449,879,430,1,00240,India
320879,2023-04-02,506,monitor,3249,8000,4751,1,00424,India
320879,2023-04-02,505,oven,18490,24000,5510,1,00424,India
320879,2023-04-02,504,iron,449,879,430,1,00424,India
843309,2023-04-03,501,iphone 15,60000,80000,20000,1,00246,India
843309,2023-04-03,502,iphone 15 pro max,100000,135000,35000,1,00246,India
843309,2023-04-03,503,mixer,1349,3249,1900,1,00246,India
843309,2023-04-03,504,iron,449,879,430,1,00246,India
714670,2023-04-03,504,iron,449,879,430,1,00017,India
714670,2023-04-03,503,mixer,1349,3249,1900,1,00017,India
714670,2023-04-03,505,oven,18490,24000,5510,1,00017,India
714670,2023-04-03,501,iphone 15,60000,80000,20000,1,00017,India
662089,2023-04-03,501,iphone 15,60000,80000,20000,1,00082,India
662089,2023-04-03,504,iron,449,879,430,1,00082,India
662089,2023-04-03,506,monitor,3249,8000,4751,1,00082,India
534607,2023-04-03,503,mixer,1349,3249,1900,1,00264,India
534607,2023-04-03,501,iphone 15,60000,80000,20000,1,00264,India
319384,2023-04-03,503,mixer,1349,3249,1900,1,00372,India
376245,2023-04-03,505,oven,18490,24000,5510,1,00297,India
376245,2023-04-03,504,iron,449,879,430,1,00297,India
376245,2023-04-03,502,iphone 15 pro max,100000,135000,35000,1,00297,India
775557,2023-04-03,501,iphone 15,60000,80000,20000,1,00033,India
775557,2023-04-03,504,iron,449,879,430,1,00033,India
775557,2023-04-03,503,mixer,1349,3249,1900,1,00033,India
669517,2023-04-03,504,iron,449,879,430,1,00116,India
428859,2023-04-03,501,iphone 15,60000,80000,20000,1,00156,India
428859,2023-04-03,506,monitor,3249,8000,4751,1,00156,India
428859,2023-04-03,502,iphone 15 pro max,100000,135000,35000,1,00156,India
820880,2023-04-03,502,iphone 15 pro max,100000,135000,35000,1,00341,India
820880,2023-04-03,501,iphone 15,60000,80000,20000,1,00341,India
820880,2023-04-03,507,washing machine,6990,16490,9500,1,00341,India
950115,2023-04-03,503,mixer,1349,3249,1900,1,00118,India
950115,2023-04-03,504,iron,449,879,430,1,00118,India
950115,2023-04-03,507,washing machine,6990,16490,9500,1,00118,India
104061,2023-04-03,504,iron,449,879,430,1,00015,India
554982,2023-04-03,502,iphone 15 pro max,100000,135000,35000,1,00095,India
554982,2023-04-03,507,washing machine,6990,16490,9500,1,00095,India
554982,2023-04-03,505,oven,18490,24000,5510,1,00095,India
314278,2023-04-03,504,iron,449,879,430,1,00008,India
314278,2023-04-03,502,iphone 15 pro max,100000,135000,35000,1,00008,India
314278,2023-04-03,507,washing machine,6990,16490,9500,1,00008,India
314278,2023-04-03,501,iphone 15,60000,80000,20000,1,00008,India
320759,2023-04-03,504,iron,449,879,430,1,00490,India
320759,2023-04-03,506,monitor,3249,8000,4751,1,00490,India
331895,2023-04-03,503,mixer,1349,3249,1900,1,00104,India
331895,2023-04-03,506,monitor,3249,8000,4751,1,00104,India
927211,2023-04-03,503,mixer,1349,3249,1900,1,00495,India
282483,2023-04-03,501,iphone 15,60000,80000,20000,1,00423,India
450849,2023-04-03,501,iphone 15,60000,80000,20000,1,00464,India
450849,2023-04-03,506,monitor,3249,8000,4751,1,00464,India
450849,2023-04-03,503,mixer,1349,3249,1900,1,00464,India
450849,2023-04-03,502,iphone 15 pro max,100000,135000,35000,1,00464,India
848239,2023-04-03,507,washing machine,6990,16490,9500,1,00499,India
848239,2023-04-03,501,iphone 15,60000,80000,20000,1,00499,India
848239,2023-04-03,505,oven,18490,24000,5510,1,00499,India
623929,2023-04-03,507,washing machine,6990,16490,9500,1,00323,India
623929,2023-04-03,502,iphone 15 pro max,100000,135000,35000,1,00323,India
623929,2023-04-03,505,oven,18490,24000,5510,1,00323,India
623929,2023-04-03,503,mixer,1349,3249,1900,1,00323,India
623929,2023-04-03,501,iphone 15,60000,80000,20000,1,00323,India
892854,2023-04-03,503,mixer,1349,3249,1900,1,00332,India
892854,2023-04-03,501,iphone 15,60000,80000,20000,1,00332,India
892854,2023-04-03,504,iron,449,879,430,1,00332,India
892854,2023-04-03,502,iphone 15 pro max,100000,135000,35000,1,00332,India
968842,2023-04-03,502,iphone 15 pro max,100000,135000,35000,1,00054,India
968842,2023-04-03,504,iron,449,879,430,1,00054,India
968842,2023-04-03,506,monitor,3249,8000,4751,1,00054,India
968842,2023-04-03,507,washing machine,6990,16490,9500,1,00054,India
386946,2023-04-03,505,oven,18490,24000,5510,1,00142,India
386946,2023-04-03,507,washing machine,6990,16490,9500,1,00142,India
386946,2023-04-03,501,iphone 15,60000,80000,20000,1,00142,India
353151,2023-04-03,502,iphone 15 pro max,100000,135000,35000,1,00190,India
353151,2023-04-03,505,oven,18490,24000,5510,1,00190,India
315212,2023-04-03,504,iron,449,879,430,1,00296,India
315212,2023-04-03,502,iphone 15 pro max,100000,135000,35000,1,00296,India
426388,2023-04-03,503,mixer,1349,3249,1900,1,00037,India
426388,2023-04-03,501,iphone 15,60000,80000,20000,1,00037,India
180089,2023-04-03,503,mixer,1349,3249,1900,1,00232,India
180089,2023-04-03,507,washing machine,6990,16490,9500,1,00232,India
763061,2023-04-03,507,washing machine,6990,16490,9500,1,00071,India
763061,2023-04-03,501,iphone 15,60000,80000,20000,1,00071,India
444104,2023-04-03,504,iron,449,879,430,1,00202,India
444104,2023-04-03,502,iphone 15 pro max,100000,135000,35000,1,00202,India
101206,2023-04-03,502,iphone 15 pro max,100000,135000,35000,1,00208,India
618866,2023-04-03,507,washing machine,6990,16490,9500,1,00461,India
457878,2023-04-03,504,iron,449,879,430,1,00250,India
457878,2023-04-03,506,monitor,3249,8000,4751,1,00250,India
457878,2023-04-03,502,iphone 15 pro max,100000,135000,35000,1,00250,India
193158,2023-04-03,506,monitor,3249,8000,4751,1,00452,India
193158,2023-04-03,507,washing machine,6990,16490,9500,1,00452,India
193158,2023-04-03,505,oven,18490,24000,5510,1,00452,India
193158,2023-04-03,501,iphone 15,60000,80000,20000,1,00452,India
193158,2023-04-03,503,mixer,1349,3249,1900,1,00452,India
152484,2023-04-03,501,iphone 15,60000,80000,20000,1,00261,India
152484,2023-04-03,504,iron,449,879,430,1,00261,India
532614,2023-04-03,506,monitor,3249,8000,4751,1,00390,India
532614,2023-04-03,502,iphone 15 pro max,100000,135000,35000,1,00390,India
532614,2023-04-03,505,oven,18490,24000,5510,1,00390,India
532614,2023-04-03,501,iphone 15,60000,80000,20000,1,00390,India
658650,2023-04-03,504,iron,449,879,430,1,00495,India
658650,2023-04-03,506,monitor,3249,8000,4751,1,00495,India
821866,2023-04-03,507,washing machine,6990,16490,9500,1,00292,India
704896,2023-04-03,506,monitor,3249,8000,4751,1,00458,India
704896,2023-04-03,501,iphone 15,60000,80000,20000,1,00458,India
704896,2023-04-03,505,oven,18490,24000,5510,1,00458,India
651349,2023-04-03,502,iphone 15 pro max,100000,135000,35000,1,00098,India
651349,2023-04-03,507,washing machine,6990,16490,9500,1,00098,India
720939,2023-04-03,505,oven,18490,24000,5510,1,00007,India
227348,2023-04-03,505,oven,18490,24000,5510,1,00460,India
412600,2023-04-03,501,iphone 15,60000,80000,20000,1,00165,India
412600,2023-04-03,503,mixer,1349,3249,1900,1,00165,India
281315,2023-04-03,503,mixer,1349,3249,1900,1,00488,India
197605,2023-04-03,506,monitor,3249,8000,4751,1,00415,India
197605,2023-04-03,502,iphone 15 pro max,100000,135000,35000,1,00415,India
152539,2023-04-03,504,iron,449,879,430,1,00251,India
152539,2023-04-03,507,washing machine,6990,16490,9500,1,00251,India
152539,2023-04-03,501,iphone 15,60000,80000,20000,1,00251,India
970053,2023-04-03,505,oven,18490,24000,5510,1,00468,India
970053,2023-04-03,507,washing machine,6990,16490,9500,1,00468,India
970053,2023-04-03,502,iphone 15 pro max,100000,135000,35000,1,00468,India
970053,2023-04-03,503,mixer,1349,3249,1900,1,00468,India
561102,2023-04-03,503,mixer,1349,3249,1900,1,00254,India
561102,2023-04-03,506,monitor,3249,8000,4751,1,00254,India
561102,2023-04-03,505,oven,18490,24000,5510,1,00254,India
561102,2023-04-03,502,iphone 15 pro max,100000,135000,35000,1,00254,India
246620,2023-04-03,504,iron,449,879,430,1,00123,India
144325,2023-04-03,506,monitor,3249,8000,4751,1,00200,India
654479,2023-04-03,505,oven,18490,24000,5510,1,00038,India
654479,2023-04-03,506,monitor,3249,8000,4751,1,00038,India
292681,2023-04-03,502,iphone 15 pro max,100000,135000,35000,1,00035,India
292681,2023-04-03,504,iron,449,879,430,1,00035,India
292681,2023-04-03,503,mixer,1349,3249,1900,1,00035,India
925489,2023-04-03,506,monitor,3249,8000,4751,1,00325,India
925489,2023-04-03,507,washing machine,6990,16490,9500,1,00325,India
925489,2023-04-03,505,oven,18490,24000,5510,1,00325,India
363635,2023-04-03,502,iphone 15 pro max,100000,135000,35000,1,00311,India
363635,2023-04-03,503,mixer,1349,3249,1900,1,00311,India
664630,2023-04-03,504,iron,449,879,430,1,00344,India
664630,2023-04-03,507,washing machine,6990,16490,9500,1,00344,India
650784,2023-04-03,502,iphone 15 pro max,100000,135000,35000,1,00253,India
818419,2023-04-03,501,iphone 15,60000,80000,20000,1,00067,India
288384,2023-04-03,505,oven,18490,24000,5510,1,00124,India
818763,2023-04-03,501,iphone 15,60000,80000,20000,1,00390,India
935839,2023-04-03,507,washing machine,6990,16490,9500,1,00365,India
935839,2023-04-03,501,iphone 15,60000,80000,20000,1,00365,India
935839,2023-04-03,503,mixer,1349,3249,1900,1,00365,India
341853,2023-04-03,503,mixer,1349,3249,1900,1,00145,India
963353,2023-04-03,505,oven,18490,24000,5510,1,00148,India
963353,2023-04-03,501,iphone 15,60000,80000,20000,1,00148,India
963353,2023-04-03,506,monitor,3249,8000,4751,1,00148,India
921292,2023-04-03,504,iron,449,879,430,1,00313,India
656576,2023-04-03,505,oven,18490,24000,5510,1,00329,India
656576,2023-04-03,506,monitor,3249,8000,4751,1,00329,India
656576,2023-04-03,507,washing machine,6990,16490,9500,1,00329,India
858816,2023-04-03,502,iphone 15 pro max,100000,135000,35000,1,00246,India
858816,2023-04-03,506,monitor,3249,8000,4751,1,00246,India
904990,2023-04-03,501,iphone 15,60000,80000,20000,1,00013,India
904990,2023-04-03,507,washing machine,6990,16490,9500,1,00013,India
916765,2023-04-03,501,iphone 15,60000,80000,20000,1,00140,India
916765,2023-04-03,507,washing machine,6990,16490,9500,1,00140,India
378008,2023-04-04,507,washing machine,6990,16490,9500,1,00330,India
378008,2023-04-04,502,iphone 15 pro max,100000,135000,35000,1,00330,India
378008,2023-04-04,506,monitor,3249,8000,4751,1,00330,India
457138,2023-04-04,501,iphone 15,60000,80000,20000,1,00426,India
457138,2023-04-04,507,washing machine,6990,16490,9500,1,00426,India
457138,2023-04-04,504,iron,449,879,430,1,00426,India
998461,2023-04-04,506,monitor,3249,8000,4751,1,00252,India
998461,2023-04-04,505,oven,18490,24000,5510,1,00252,India
998461,2023-04-04,501,iphone 15,60000,80000,20000,1,00252,India
281908,2023-04-04,505,oven,18490,24000,5510,1,00472,India
281908,2023-04-04,506,monitor,3249,8000,4751,1,00472,India
866405,2023-04-04,506,monitor,3249,8000,4751,1,00016,India
866405,2023-04-04,502,iphone 15 pro max,100000,135000,35000,1,00016,India
866405,2023-04-04,503,mixer,1349,3249,1900,1,00016,India
866405,2023-04-04,505,oven,18490,24000,5510,1,00016,India
361984,2023-04-04,502,iphone 15 pro max,100000,135000,35000,1,00042,India
361984,2023-04-04,506,monitor,3249,8000,4751,1,00042,India
361984,2023-04-04,501,iphone 15,60000,80000,20000,1,00042,India
361984,2023-04-04,503,mixer,1349,3249,1900,1,00042,India
361984,2023-04-04,504,iron,449,879,430,1,00042,India
666651,2023-04-04,507,washing machine,6990,16490,9500,1,00434,India
666651,2023-04-04,503,mixer,1349,3249,1900,1,00434,India
246180,2023-04-04,506,monitor,3249,8000,4751,1,00279,India
246180,2023-04-04,503,mixer,1349,3249,1900,1,00279,India
246180,2023-04-04,504,iron,449,879,430,1,00279,India
584933,2023-04-04,505,oven,18490,24000,5510,1,00085,India
584933,2023-04-04,501,iphone 15,60000,80000,20000,1,00085,India
584933,2023-04-04,503,mixer,1349,3249,1900,1,00085,India
561005,2023-04-04,507,washing machine,6990,16490,9500,1,00395,India
561005,2023-04-04,505,oven,18490,24000,5510,1,00395,India
154418,2023-04-04,502,iphone 15 pro max,100000,135000,35000,1,00004,India
760642,2023-04-04,505,oven,18490,24000,5510,1,00228,India
760642,2023-04-04,507,washing machine,6990,16490,9500,1,00228,India
597390,2023-04-04,507,washing machine,6990,16490,9500,1,00302,India
597390,2023-04-04,503,mixer,1349,3249,1900,1,00302,India
196617,2023-04-04,504,iron,449,879,430,1,00230,India
196617,2023-04-04,501,iphone 15,60000,80000,20000,1,00230,India
196617,2023-04-04,507,washing machine,6990,16490,9500,1,00230,India
504470,2023-04-04,503,mixer,1349,3249,1900,1,00235,India
504470,2023-04-04,506,monitor,3249,8000,4751,1,00235,India
391983,2023-04-04,503,mixer,1349,3249,1900,1,00079,India
391983,2023-04-04,507,washing machine,6990,16490,9500,1,00079,India
391983,2023-04-04,504,iron,449,879,430,1,00079,India
657510,2023-04-04,507,washing machine,6990,16490,9500,1,00280,India
657510,2023-04-04,506,monitor,3249,8000,4751,1,00280,India
657510,2023-04-04,501,iphone 15,60000,80000,20000,1,00280,India
417884,2023-04-04,502,iphone 15 pro max,100000,135000,35000,1,00396,India
417884,2023-04-04,507,washing machine,6990,16490,9500,1,00396,India
829298,2023-04-04,506,monitor,3249,8000,4751,1,00050,India
829298,2023-04-04,507,washing machine,6990,16490,9500,1,00050,India
829298,2023-04-04,505,oven,18490,24000,5510,1,00050,India
829298,2023-04-04,503,mixer,1349,3249,1900,1,00050,India
829298,2023-04-04,504,iron,449,879,430,1,00050,India
981063,2023-04-04,507,washing machine,6990,16490,9500,1,00065,India
981063,2023-04-04,505,oven,18490,24000,5510,1,00065,India
981063,2023-04-04,506,monitor,3249,8000,4751,1,00065,India
626271,2023-04-04,504,iron,449,879,430,1,00110,India
626271,2023-04-04,507,washing machine,6990,16490,9500,1,00110,India
626271,2023-04-04,506,monitor,3249,8000,4751,1,00110,India
626271,2023-04-04,503,mixer,1349,3249,1900,1,00110,India
430747,2023-04-04,504,iron,449,879,430,1,00059,India
430747,2023-04-04,507,washing machine,6990,16490,9500,1,00059,India
430747,2023-04-04,502,iphone 15 pro max,100000,135000,35000,1,00059,India
974563,2023-04-04,501,iphone 15,60000,80000,20000,1,00089,India
474259,2023-04-04,507,washing machine,6990,16490,9500,1,00440,India
474259,2023-04-04,506,monitor,3249,8000,4751,1,00440,India
155477,2023-04-04,502,iphone 15 pro max,100000,135000,35000,1,00232,India
155477,2023-04-04,507,washing machine,6990,16490,9500,1,00232,India
155477,2023-04-04,503,mixer,1349,3249,1900,1,00232,India
659863,2023-04-04,504,iron,449,879,430,1,00151,India
659863,2023-04-04,501,iphone 15,60000,80000,20000,1,00151,India
659863,2023-04-04,507,washing machine,6990,16490,9500,1,00151,India
201135,2023-04-04,507,washing machine,6990,16490,9500,1,00076,India
201135,2023-04-04,503,mixer,1349,3249,1900,1,00076,India
109763,2023-04-04,506,monitor,3249,8000,4751,1,00127,India
109763,2023-04-04,501,iphone 15,60000,80000,20000,1,00127,India
694234,2023-04-04,506,monitor,3249,8000,4751,1,00071,India
694234,2023-04-04,505,oven,18490,24000,5510,1,00071,India
129813,2023-04-04,502,iphone 15 pro max,100000,135000,35000,1,00453,India
129813,2023-04-04,501,iphone 15,60000,80000,20000,1,00453,India
129813,2023-04-04,503,mixer,1349,3249,1900,1,00453,India
674416,2023-04-04,502,iphone 15 pro max,100000,135000,35000,1,00430,India
674416,2023-04-04,505,oven,18490,24000,5510,1,00430,India
674416,2023-04-04,507,washing machine,6990,16490,9500,1,00430,India
674416,2023-04-04,506,monitor,3249,8000,4751,1,00430,India
657139,2023-04-04,505,oven,18490,24000,5510,1,00459,India
657139,2023-04-04,501,iphone 15,60000,80000,20000,1,00459,India
657139,2023-04-04,503,mixer,1349,3249,1900,1,00459,India
657139,2023-04-04,504,iron,449,879,430,1,00459,India
690963,2023-04-04,503,mixer,1349,3249,1900,1,00489,India
690963,2023-04-04,502,iphone 15 pro max,100000,135000,35000,1,00489,India
690963,2023-04-04,506,monitor,3249,8000,4751,1,00489,India
787515,2023-04-04,506,monitor,3249,8000,4751,1,00033,India
787515,2023-04-04,503,mixer,1349,3249,1900,1,00033,India
787515,2023-04-04,504,iron,449,879,430,1,00033,India
617115,2023-04-04,502,iphone 15 pro max,100000,135000,35000,1,00425,India
617115,2023-04-04,505,oven,18490,24000,5510,1,00425,India
617115,2023-04-04,501,iphone 15,60000,80000,20000,1,00425,India
617115,2023-04-04,506,monitor,3249,8000,4751,1,00425,India
582976,2023-04-04,507,washing machine,6990,16490,9500,1,00079,India
582976,2023-04-04,505,oven,18490,24000,5510,1,00079,India
582976,2023-04-04,502,iphone 15 pro max,100000,135000,35000,1,00079,India
582976,2023-04-04,503,mixer,1349,3249,1900,1,00079,India
582976,2023-04-04,501,iphone 15,60000,80000,20000,1,00079,India
806167,2023-04-04,507,washing machine,6990,16490,9500,1,00474,India
806167,2023-04-04,502,iphone 15 pro max,100000,135000,35000,1,00474,India
806167,2023-04-04,506,monitor,3249,8000,4751,1,00474,India
415149,2023-04-04,504,iron,449,879,430,1,00173,India
415149,2023-04-04,506,monitor,3249,8000,4751,1,00173,India
415149,2023-04-04,503,mixer,1349,3249,1900,1,00173,India
415149,2023-04-04,507,washing machine,6990,16490,9500,1,00173,India
503577,2023-04-04,503,mixer,1349,3249,1900,1,00270,India
503577,2023-04-04,505,oven,18490,24000,5510,1,00270,India
447300,2023-04-04,501,iphone 15,60000,80000,20000,1,00218,India
447300,2023-04-04,504,iron,449,879,430,1,00218,India
447300,2023-04-04,502,iphone 15 pro max,100000,135000,35000,1,00218,India
284253,2023-04-04,505,oven,18490,24000,5510,1,00132,India
284253,2023-04-04,502,iphone 15 pro max,100000,135000,35000,1,00132,India
284253,2023-04-04,504,iron,449,879,430,1,00132,India
299236,2023-04-04,504,iron,449,879,430,1,00360,India
299236,2023-04-04,502,iphone 15 pro max,100000,135000,35000,1,00360,India
299236,2023-04-04,507,washing machine,6990,16490,9500,1,00360,India
853208,2023-04-04,506,monitor,3249,8000,4751,1,00140,India
853208,2023-04-04,504,iron,449,879,430,1,00140,India
853208,2023-04-04,503,mixer,1349,3249,1900,1,00140,India
853208,2023-04-04,507,washing machine,6990,16490,9500,1,00140,India
231473,2023-04-04,504,iron,449,879,430,1,00068,India
231473,2023-04-04,502,iphone 15 pro max,100000,135000,35000,1,00068,India
824853,2023-04-04,506,monitor,3249,8000,4751,1,00017,India
686344,2023-04-04,505,oven,18490,24000,5510,1,00068,India
686344,2023-04-04,507,washing machine,6990,16490,9500,1,00068,India
151450,2023-04-04,503,mixer,1349,3249,1900,1,00265,India
151450,2023-04-04,504,iron,449,879,430,1,00265,India
151450,2023-04-04,507,washing machine,6990,16490,9500,1,00265,India
151450,2023-04-04,506,monitor,3249,8000,4751,1,00265,India
482192,2023-04-04,501,iphone 15,60000,80000,20000,1,00329,India
482192,2023-04-04,507,washing machine,6990,16490,9500,1,00329,India
482192,2023-04-04,506,monitor,3249,8000,4751,1,00329,India
867969,2023-04-04,505,oven,18490,24000,5510,1,00245,India
867969,2023-04-04,502,iphone 15 pro max,100000,135000,35000,1,00245,India
867969,2023-04-04,501,iphone 15,60000,80000,20000,1,00245,India
131790,2023-04-04,502,iphone 15 pro max,100000,135000,35000,1,00301,India
131790,2023-04-04,507,washing machine,6990,16490,9500,1,00301,India
131790,2023-04-04,501,iphone 15,60000,80000,20000,1,00301,India
172448,2023-04-04,504,iron,449,879,430,1,00340,India
172448,2023-04-04,503,mixer,1349,3249,1900,1,00340,India
653446,2023-04-04,502,iphone 15 pro max,100000,135000,35000,1,00350,India
653446,2023-04-04,503,mixer,1349,3249,1900,1,00350,India
653446,2023-04-04,501,iphone 15,60000,80000,20000,1,00350,India
653446,2023-04-04,507,washing machine,6990,16490,9500,1,00350,India
207695,2023-04-04,507,washing machine,6990,16490,9500,1,00362,India
207695,2023-04-04,506,monitor,3249,8000,4751,1,00362,India
207695,2023-04-04,501,iphone 15,60000,80000,20000,1,00362,India
165393,2023-04-04,501,iphone 15,60000,80000,20000,1,00207,India
970961,2023-04-04,503,mixer,1349,3249,1900,1,00429,India
501053,2023-04-04,502,iphone 15 pro max,100000,135000,35000,1,00325,India
501053,2023-04-04,505,oven,18490,24000,5510,1,00325,India
501053,2023-04-04,503,mixer,1349,3249,1900,1,00325,India
501053,2023-04-04,507,washing machine,6990,16490,9500,1,00325,India
696349,2023-04-04,504,iron,449,879,430,1,00408,India
130147,2023-04-04,501,iphone 15,60000,80000,20000,1,00273,India
130147,2023-04-04,504,iron,449,879,430,1,00273,India
130147,2023-04-04,506,monitor,3249,8000,4751,1,00273,India
800430,2023-04-04,507,washing machine,6990,16490,9500,1,00279,India
800430,2023-04-04,501,iphone 15,60000,80000,20000,1,00279,India
300893,2023-04-04,505,oven,18490,24000,5510,1,00174,India
300893,2023-04-04,502,iphone 15 pro max,100000,135000,35000,1,00174,India
300893,2023-04-04,501,iphone 15,60000,80000,20000,1,00174,India
180914,2023-04-04,501,iphone 15,60000,80000,20000,1,00064,India
180914,2023-04-04,503,mixer,1349,3249,1900,1,00064,India
966424,2023-04-04,503,mixer,1349,3249,1900,1,00416,India
966424,2023-04-04,505,oven,18490,24000,5510,1,00416,India
966424,2023-04-04,502,iphone 15 pro max,100000,135000,35000,1,00416,India
709130,2023-04-04,507,washing machine,6990,16490,9500,1,00093,India
709130,2023-04-04,505,oven,18490,24000,5510,1,00093,India
282311,2023-04-04,502,iphone 15 pro max,100000,135000,35000,1,00440,India
282311,2023-04-04,505,oven,18490,24000,5510,1,00440,India
282311,2023-04-04,507,washing machine,6990,16490,9500,1,00440,India
382661,2023-04-04,507,washing machine,6990,16490,9500,1,00166,India
382661,2023-04-04,505,oven,18490,24000,5510,1,00166,India
382661,2023-04-04,506,monitor,3249,8000,4751,1,00166,India
576470,2023-04-04,506,monitor,3249,8000,4751,1,00480,India
576470,2023-04-04,503,mixer,1349,3249,1900,1,00480,India
478434,2023-04-04,507,washing machine,6990,16490,9500,1,00451,India
478434,2023-04-04,504,iron,449,879,430,1,00451,India
478434,2023-04-04,501,iphone 15,60000,80000,20000,1,00451,India
544744,2023-04-04,504,iron,449,879,430,1,00323,India
544744,2023-04-04,501,iphone 15,60000,80000,20000,1,00323,India
437835,2023-04-04,504,iron,449,879,430,1,00123,India
437835,2023-04-04,507,washing machine,6990,16490,9500,1,00123,India
437835,2023-04-04,506,monitor,3249,8000,4751,1,00123,India
437835,2023-04-04,505,oven,18490,24000,5510,1,00123,India
148034,2023-04-04,502,iphone 15 pro max,100000,135000,35000,1,00290,India
148034,2023-04-04,505,oven,18490,24000,5510,1,00290,India
148034,2023-04-04,506,monitor,3249,8000,4751,1,00290,India
148034,2023-04-04,504,iron,449,879,430,1,00290,India
372213,2023-04-04,506,monitor,3249,8000,4751,1,00295,India
372213,2023-04-04,505,oven,18490,24000,5510,1,00295,India
472563,2023-04-04,505,oven,18490,24000,5510,1,00321,India
472563,2023-04-04,507,washing machine,6990,16490,9500,1,00321,India
472563,2023-04-04,503,mixer,1349,3249,1900,1,00321,India
321736,2023-04-04,502,iphone 15 pro max,100000,135000,35000,1,00106,India
123171,2023-04-04,502,iphone 15 pro max,100000,135000,35000,1,00443,India
123171,2023-04-04,504,iron,449,879,430,1,00443,India
455727,2023-04-04,501,iphone 15,60000,80000,20000,1,00320,India
455727,2023-04-04,502,iphone 15 pro max,100000,135000,35000,1,00320,India
252522,2023-04-04,504,iron,449,879,430,1,00476,India
252522,2023-04-04,502,iphone 15 pro max,100000,135000,35000,1,00476,India
505667,2023-04-04,503,mixer,1349,3249,1900,1,00014,India
505667,2023-04-04,504,iron,449,879,430,1,00014,India
505667,2023-04-04,502,iphone 15 pro max,100000,135000,35000,1,00014,India
256151,2023-04-04,507,washing machine,6990,16490,9500,1,00369,India
256151,2023-04-04,503,mixer,1349,3249,1900,1,00369,India
383247,2023-04-04,501,iphone 15,60000,80000,20000,1,00076,India
383247,2023-04-04,505,oven,18490,24000,5510,1,00076,India
383247,2023-04-04,507,washing machine,6990,16490,9500,1,00076,India
383247,2023-04-04,504,iron,449,879,430,1,00076,India
702571,2023-04-05,506,monitor,3249,8000,4751,1,00016,India
702571,2023-04-05,507,washing machine,6990,16490,9500,1,00016,India
376898,2023-04-05,506,monitor,3249,8000,4751,1,00104,India
376898,2023-04-05,505,oven,18490,24000,5510,1,00104,India
376898,2023-04-05,502,iphone 15 pro max,100000,135000,35000,1,00104,India
376898,2023-04-05,503,mixer,1349,3249,1900,1,00104,India
310856,2023-04-05,507,washing machine,6990,16490,9500,1,00388,India
310856,2023-04-05,505,oven,18490,24000,5510,1,00388,India
310856,2023-04-05,504,iron,449,879,430,1,00388,India
310856,2023-04-05,501,iphone 15,60000,80000,20000,1,00388,India
124988,2023-04-05,502,iphone 15 pro max,100000,135000,35000,1,00069,India
124988,2023-04-05,504,iron,449,879,430,1,00069,India
316383,2023-04-05,505,oven,18490,24000,5510,1,00100,India
316383,2023-04-05,501,iphone 15,60000,80000,20000,1,00100,India
771102,2023-04-05,501,iphone 15,60000,80000,20000,1,00156,India
248598,2023-04-05,503,mixer,1349,3249,1900,1,00058,India
248598,2023-04-05,501,iphone 15,60000,80000,20000,1,00058,India
248598,2023-04-05,507,washing machine,6990,16490,9500,1,00058,India
209550,2023-04-05,503,mixer,1349,3249,1900,1,00256,India
209550,2023-04-05,506,monitor,3249,8000,4751,1,00256,India
209550,2023-04-05,507,washing machine,6990,16490,9500,1,00256,India
209550,2023-04-05,504,iron,449,879,430,1,00256,India
905987,2023-04-05,503,mixer,1349,3249,1900,1,00471,India
905987,2023-04-05,502,iphone 15 pro max,100000,135000,35000,1,00471,India
905987,2023-04-05,507,washing machine,6990,16490,9500,1,00471,India
214240,2023-04-05,502,iphone 15 pro max,100000,135000,35000,1,00344,India
214240,2023-04-05,506,monitor,3249,8000,4751,1,00344,India
746787,2023-04-05,506,monitor,3249,8000,4751,1,00013,India
746787,2023-04-05,505,oven,18490,24000,5510,1,00013,India
746787,2023-04-05,502,iphone 15 pro max,100000,135000,35000,1,00013,India
746787,2023-04-05,501,iphone 15,60000,80000,20000,1,00013,India
225236,2023-04-05,504,iron,449,879,430,1,00092,India
225236,2023-04-05,507,washing machine,6990,16490,9500,1,00092,India
225236,2023-04-05,503,mixer,1349,3249,1900,1,00092,India
868995,2023-04-05,505,oven,18490,24000,5510,1,00477,India
868995,2023-04-05,502,iphone 15 pro max,100000,135000,35000,1,00477,India
436324,2023-04-05,505,oven,18490,24000,5510,1,00259,India
436324,2023-04-05,506,monitor,3249,8000,4751,1,00259,India
278026,2023-04-05,503,mixer,1349,3249,1900,1,00109,India
150499,2023-04-05,505,oven,18490,24000,5510,1,00437,India
150499,2023-04-05,501,iphone 15,60000,80000,20000,1,00437,India
150499,2023-04-05,506,monitor,3249,8000,4751,1,00437,India
150499,2023-04-05,503,mixer,1349,3249,1900,1,00437,India
384821,2023-04-05,501,iphone 15,60000,80000,20000,1,00258,India
384821,2023-04-05,505,oven,18490,24000,5510,1,00258,India
384821,2023-04-05,507,washing machine,6990,16490,9500,1,00258,India
384821,2023-04-05,504,iron,449,879,430,1,00258,India
844185,2023-04-05,501,iphone 15,60000,80000,20000,1,00500,India
429214,2023-04-05,506,monitor,3249,8000,4751,1,00258,India
429214,2023-04-05,507,washing machine,6990,16490,9500,1,00258,India
429214,2023-04-05,503,mixer,1349,3249,1900,1,00258,India
322515,2023-04-05,506,monitor,3249,8000,4751,1,00331,India
322515,2023-04-05,503,mixer,1349,3249,1900,1,00331,India
920576,2023-04-05,506,monitor,3249,8000,4751,1,00338,India
920576,2023-04-05,505,oven,18490,24000,5510,1,00338,India
920576,2023-04-05,504,iron,449,879,430,1,00338,India
920576,2023-04-05,507,washing machine,6990,16490,9500,1,00338,India
573792,2023-04-05,507,washing machine,6990,16490,9500,1,00482,India
573792,2023-04-05,506,monitor,3249,8000,4751,1,00482,India
573792,2023-04-05,501,iphone 15,60000,80000,20000,1,00482,India
573792,2023-04-05,505,oven,18490,24000,5510,1,00482,India
541726,2023-04-05,504,iron,449,879,430,1,00494,India
541726,2023-04-05,501,iphone 15,60000,80000,20000,1,00494,India
541726,2023-04-05,502,iphone 15 pro max,100000,135000,35000,1,00494,India
571774,2023-04-05,504,iron,449,879,430,1,00439,India
571774,2023-04-05,506,monitor,3249,8000,4751,1,00439,India
571774,2023-04-05,502,iphone 15 pro max,100000,135000,35000,1,00439,India
959916,2023-04-05,501,iphone 15,60000,80000,20000,1,00491,India
959916,2023-04-05,504,iron,449,879,430,1,00491,India
971171,2023-04-05,501,iphone 15,60000,80000,20000,1,00144,India
971171,2023-04-05,502,iphone 15 pro max,100000,135000,35000,1,00144,India
235021,2023-04-05,505,oven,18490,24000,5510,1,00313,India
235021,2023-04-05,501,iphone 15,60000,80000,20000,1,00313,India
883370,2023-04-05,505,oven,18490,24000,5510,1,00213,India
354720,2023-04-05,501,iphone 15,60000,80000,20000,1,00044,India
354720,2023-04-05,507,washing machine,6990,16490,9500,1,00044,India
833094,2023-04-05,507,washing machine,6990,16490,9500,1,00380,India
295179,2023-04-05,504,iron,449,879,430,1,00183,India
295179,2023-04-05,502,iphone 15 pro max,100000,135000,35000,1,00183,India
295179,2023-04-05,501,iphone 15,60000,80000,20000,1,00183,India
279043,2023-04-05,503,mixer,1349,3249,1900,1,00181,India
279043,2023-04-05,505,oven,18490,24000,5510,1,00181,India
514892,2023-04-05,506,monitor,3249,8000,4751,1,00347,India
514892,2023-04-05,502,iphone 15 pro max,100000,135000,35000,1,00347,India
514892,2023-04-05,503,mixer,1349,3249,1900,1,00347,India
543635,2023-04-05,506,monitor,3249,8000,4751,1,00088,India
543635,2023-04-05,501,iphone 15,60000,80000,20000,1,00088,India
543635,2023-04-05,505,oven,18490,24000,5510,1,00088,India
543635,2023-04-05,503,mixer,1349,3249,1900,1,00088,India
252869,2023-04-05,503,mixer,1349,3249,1900,1,00135,India
252869,2023-04-05,502,iphone 15 pro max,100000,135000,35000,1,00135,India
252869,2023-04-05,501,iphone 15,60000,80000,20000,1,00135,India
613942,2023-04-05,504,iron,449,879,430,1,00005,India
613942,2023-04-05,507,washing machine,6990,16490,9500,1,00005,India
613942,2023-04-05,502,iphone 15 pro max,100000,135000,35000,1,00005,India
127476,2023-04-05,507,washing machine,6990,16490,9500,1,00290,India
127476,2023-04-05,504,iron,449,879,430,1,00290,India
605964,2023-04-05,501,iphone 15,60000,80000,20000,1,00468,India
605964,2023-04-05,504,iron,449,879,430,1,00468,India
605964,2023-04-05,502,iphone 15 pro max,100000,135000,35000,1,00468,India
605964,2023-04-05,503,mixer,1349,3249,1900,1,00468,India
797907,2023-04-05,502,iphone 15 pro max,100000,135000,35000,1,00499,India
797907,2023-04-05,506,monitor,3249,8000,4751,1,00499,India
797907,2023-04-05,507,washing machine,6990,16490,9500,1,00499,India
797907,2023-04-05,504,iron,449,879,430,1,00499,India
744308,2023-04-05,505,oven,18490,24000,5510,1,00118,India
814013,2023-04-05,502,iphone 15 pro max,100000,135000,35000,1,00407,India
814013,2023-04-05,501,iphone 15,60000,80000,20000,1,00407,India
814013,2023-04-05,503,mixer,1349,3249,1900,1,00407,India
412227,2023-04-05,501,iphone 15,60000,80000,20000,1,00362,India
412227,2023-04-05,502,iphone 15 pro max,100000,135000,35000,1,00362,India
477077,2023-04-05,503,mixer,1349,3249,1900,1,00270,India
477077,2023-04-05,507,washing machine,6990,16490,9500,1,00270,India
477077,2023-04-05,502,iphone 15 pro max,100000,135000,35000,1,00270,India
913164,2023-04-05,507,washing machine,6990,16490,9500,1,00379,India
913164,2023-04-05,506,monitor,3249,8000,4751,1,00379,India
913164,2023-04-05,502,iphone 15 pro max,100000,135000,35000,1,00379,India
913164,2023-04-05,504,iron,449,879,430,1,00379,India
308395,2023-04-05,506,monitor,3249,8000,4751,1,00279,India
308395,2023-04-05,502,iphone 15 pro max,100000,135000,35000,1,00279,India
308395,2023-04-05,507,washing machine,6990,16490,9500,1,00279,India
911166,2023-04-05,502,iphone 15 pro max,100000,135000,35000,1,00112,India
522473,2023-04-05,501,iphone 15,60000,80000,20000,1,00280,India
902138,2023-04-05,505,oven,18490,24000,5510,1,00286,India
902138,2023-04-05,507,washing machine,6990,16490,9500,1,00286,India
345472,2023-04-05,502,iphone 15 pro max,100000,135000,35000,1,00269,India
345472,2023-04-05,506,monitor,3249,8000,4751,1,00269,India
345472,2023-04-05,505,oven,18490,24000,5510,1,00269,India
345472,2023-04-05,507,washing machine,6990,16490,9500,1,00269,India
345472,2023-04-05,504,iron,449,879,430,1,00269,India
730557,2023-04-05,502,iphone 15 pro max,100000,135000,35000,1,00342,India
730557,2023-04-05,507,washing machine,6990,16490,9500,1,00342,India
730557,2023-04-05,503,mixer,1349,3249,1900,1,00342,India
545139,2023-04-05,502,iphone 15 pro max,100000,135000,35000,1,00181,India
545139,2023-04-05,504,iron,449,879,430,1,00181,India
545139,2023-04-05,505,oven,18490,24000,5510,1,00181,India
118175,2023-04-05,507,washing machine,6990,16490,9500,1,00104,India
118175,2023-04-05,505,oven,18490,24000,5510,1,00104,India
118175,2023-04-05,502,iphone 15 pro max,100000,135000,35000,1,00104,India
240473,2023-04-05,506,monitor,3249,8000,4751,1,00137,India
240473,2023-04-05,505,oven,18490,24000,5510,1,00137,India
240473,2023-04-05,503,mixer,1349,3249,1900,1,00137,India
180976,2023-04-05,501,iphone 15,60000,80000,20000,1,00361,India
180976,2023-04-05,502,iphone 15 pro max,100000,135000,35000,1,00361,India
332267,2023-04-05,505,oven,18490,24000,5510,1,00431,India
332267,2023-04-05,501,iphone 15,60000,80000,20000,1,00431,India
332267,2023-04-05,504,iron,449,879,430,1,00431,India
666043,2023-04-05,503,mixer,1349,3249,1900,1,00010,India
205210,2023-04-05,505,oven,18490,24000,5510,1,00042,India
205210,2023-04-05,504,iron,449,879,430,1,00042,India
244832,2023-04-05,506,monitor,3249,8000,4751,1,00218,India
244832,2023-04-05,504,iron,449,879,430,1,00218,India
244832,2023-04-05,507,washing machine,6990,16490,9500,1,00218,India
440024,2023-04-05,507,washing machine,6990,16490,9500,1,00297,India
587369,2023-04-05,507,washing machine,6990,16490,9500,1,00207,India
587369,2023-04-05,504,iron,449,879,430,1,00207,India
539746,2023-04-05,504,iron,449,879,430,1,00042,India
539746,2023-04-05,505,oven,18490,24000,5510,1,00042,India
539746,2023-04-05,506,monitor,3249,8000,4751,1,00042,India
826201,2023-04-06,507,washing machine,6990,16490,9500,1,00258,India
826201,2023-04-06,503,mixer,1349,3249,1900,1,00258,India
663699,2023-04-06,504,iron,449,879,430,1,00287,India
931773,2023-04-06,507,washing machine,6990,16490,9500,1,00480,India
931773,2023-04-06,506,monitor,3249,8000,4751,1,00480,India
878881,2023-04-06,503,mixer,1349,3249,1900,1,00144,India
878881,2023-04-06,505,oven,18490,24000,5510,1,00144,India
462410,2023-04-06,501,iphone 15,60000,80000,20000,1,00198,India
462410,2023-04-06,503,mixer,1349,3249,1900,1,00198,India
462410,2023-04-06,504,iron,449,879,430,1,00198,India
462410,2023-04-06,502,iphone 15 pro max,100000,135000,35000,1,00198,India
146395,2023-04-06,504,iron,449,879,430,1,00109,India
146395,2023-04-06,505,oven,18490,24000,5510,1,00109,India
415312,2023-04-06,506,monitor,3249,8000,4751,1,00368,India
415312,2023-04-06,502,iphone 15 pro max,100000,135000,35000,1,00368,India
415312,2023-04-06,507,washing machine,6990,16490,9500,1,00368,India
259784,2023-04-06,505,oven,18490,24000,5510,1,00277,India
332560,2023-04-06,507,washing machine,6990,16490,9500,1,00346,India
332560,2023-04-06,505,oven,18490,24000,5510,1,00346,India
810066,2023-04-06,502,iphone 15 pro max,100000,135000,35000,1,00438,India
810066,2023-04-06,507,washing machine,6990,16490,9500,1,00438,India
267504,2023-04-06,501,iphone 15,60000,80000,20000,1,00488,India
267504,2023-04-06,503,mixer,1349,3249,1900,1,00488,India
267504,2023-04-06,507,washing machine,6990,16490,9500,1,00488,India
372166,2023-04-06,505,oven,18490,24000,5510,1,00312,India
272482,2023-04-06,501,iphone 15,60000,80000,20000,1,00214,India
833412,2023-04-06,504,iron,449,879,430,1,00045,India
358453,2023-04-06,507,washing machine,6990,16490,9500,1,00042,India
358453,2023-04-06,501,iphone 15,60000,80000,20000,1,00042,India
358453,2023-04-06,503,mixer,1349,3249,1900,1,00042,India
994347,2023-04-06,505,oven,18490,24000,5510,1,00237,India
994347,2023-04-06,501,iphone 15,60000,80000,20000,1,00237,India
994347,2023-04-06,507,washing machine,6990,16490,9500,1,00237,India
994347,2023-04-06,503,mixer,1349,3249,1900,1,00237,India
585837,2023-04-06,504,iron,449,879,430,1,00493,India
585837,2023-04-06,502,iphone 15 pro max,100000,135000,35000,1,00493,India
585837,2023-04-06,505,oven,18490,24000,5510,1,00493,India
585837,2023-04-06,501,iphone 15,60000,80000,20000,1,00493,India
272103,2023-04-06,507,washing machine,6990,16490,9500,1,00319,India
272103,2023-04-06,501,iphone 15,60000,80000,20000,1,00319,India
705275,2023-04-06,505,oven,18490,24000,5510,1,00296,India
705275,2023-04-06,504,iron,449,879,430,1,00296,India
854826,2023-04-06,503,mixer,1349,3249,1900,1,00139,India
854826,2023-04-06,505,oven,18490,24000,5510,1,00139,India
854826,2023-04-06,501,iphone 15,60000,80000,20000,1,00139,India
842678,2023-04-06,506,monitor,3249,8000,4751,1,00010,India
842678,2023-04-06,501,iphone 15,60000,80000,20000,1,00010,India
842678,2023-04-06,505,oven,18490,24000,5510,1,00010,India
584860,2023-04-06,504,iron,449,879,430,1,00459,India
584860,2023-04-06,505,oven,18490,24000,5510,1,00459,India
459052,2023-04-06,506,monitor,3249,8000,4751,1,00402,India
676634,2023-04-06,507,washing machine,6990,16490,9500,1,00343,India
547094,2023-04-06,505,oven,18490,24000,5510,1,00424,India
988755,2023-04-06,505,oven,18490,24000,5510,1,00387,India
988755,2023-04-06,502,iphone 15 pro max,100000,135000,35000,1,00387,India
988755,2023-04-06,504,iron,449,879,430,1,00387,India
567894,2023-04-06,504,iron,449,879,430,1,00412,India
567894,2023-04-06,505,oven,18490,24000,5510,1,00412,India
567894,2023-04-06,506,monitor,3249,8000,4751,1,00412,India
225881,2023-04-06,507,washing machine,6990,16490,9500,1,00320,India
225881,2023-04-06,504,iron,449,879,430,1,00320,India
263077,2023-04-06,502,iphone 15 pro max,100000,135000,35000,1,00113,India
497279,2023-04-06,502,iphone 15 pro max,100000,135000,35000,1,00092,India
497279,2023-04-06,505,oven,18490,24000,5510,1,00092,India
497279,2023-04-06,501,iphone 15,60000,80000,20000,1,00092,India
497279,2023-04-06,507,washing machine,6990,16490,9500,1,00092,India
990785,2023-04-06,501,iphone 15,60000,80000,20000,1,00180,India
990785,2023-04-06,505,oven,18490,24000,5510,1,00180,India
990785,2023-04-06,503,mixer,1349,3249,1900,1,00180,India
882072,2023-04-06,507,washing machine,6990,16490,9500,1,00137,India
725060,2023-04-06,502,iphone 15 pro max,100000,135000,35000,1,00010,India
290473,2023-04-06,507,washing machine,6990,16490,9500,1,00331,India
290473,2023-04-06,501,iphone 15,60000,80000,20000,1,00331,India
290473,2023-04-06,503,mixer,1349,3249,1900,1,00331,India
629576,2023-04-06,503,mixer,1349,3249,1900,1,00079,India
629576,2023-04-06,502,iphone 15 pro max,100000,135000,35000,1,00079,India
629576,2023-04-06,505,oven,18490,24000,5510,1,00079,India
270492,2023-04-06,504,iron,449,879,430,1,00336,India
270492,2023-04-06,501,iphone 15,60000,80000,20000,1,00336,India
270492,2023-04-06,507,washing machine,6990,16490,9500,1,00336,India
640287,2023-04-06,501,iphone 15,60000,80000,20000,1,00292,India
640287,2023-04-06,503,mixer,1349,3249,1900,1,00292,India
640287,2023-04-06,504,iron,449,879,430,1,00292,India
687123,2023-04-06,506,monitor,3249,8000,4751,1,00073,India
766974,2023-04-06,506,monitor,3249,8000,4751,1,00306,India
766974,2023-04-06,502,iphone 15 pro max,100000,135000,35000,1,00306,India
766974,2023-04-06,504,iron,449,879,430,1,00306,India
116011,2023-04-06,504,iron,449,879,430,1,00058,India
116011,2023-04-06,501,iphone 15,60000,80000,20000,1,00058,India
116011,2023-04-06,502,iphone 15 pro max,100000,135000,35000,1,00058,India
424237,2023-04-06,507,washing machine,6990,16490,9500,1,00006,India
845506,2023-04-06,506,monitor,3249,8000,4751,1,00353,India
845506,2023-04-06,505,oven,18490,24000,5510,1,00353,India
202404,2023-04-06,504,iron,449,879,430,1,00186,India
202404,2023-04-06,502,iphone 15 pro max,100000,135000,35000,1,00186,India
202404,2023-04-06,506,monitor,3249,8000,4751,1,00186,India
202404,2023-04-06,505,oven,18490,24000,5510,1,00186,India
479964,2023-04-06,501,iphone 15,60000,80000,20000,1,00439,India
479964,2023-04-06,503,mixer,1349,3249,1900,1,00439,India
479964,2023-04-06,506,monitor,3249,8000,4751,1,00439,India
232072,2023-04-06,502,iphone 15 pro max,100000,135000,35000,1,00375,India
232072,2023-04-06,503,mixer,1349,3249,1900,1,00375,India
131314,2023-04-06,501,iphone 15,60000,80000,20000,1,00060,India
742122,2023-04-06,506,monitor,3249,8000,4751,1,00429,India
754062,2023-04-06,507,washing machine,6990,16490,9500,1,00430,India
754062,2023-04-06,505,oven,18490,24000,5510,1,00430,India
131694,2023-04-06,501,iphone 15,60000,80000,20000,1,00328,India
131694,2023-04-06,505,oven,18490,24000,5510,1,00328,India
131694,2023-04-06,507,washing machine,6990,16490,9500,1,00328,India
697087,2023-04-06,501,iphone 15,60000,80000,20000,1,00346,India
697087,2023-04-06,505,oven,18490,24000,5510,1,00346,India
481184,2023-04-06,501,iphone 15,60000,80000,20000,1,00393,India
481184,2023-04-06,507,washing machine,6990,16490,9500,1,00393,India
919579,2023-04-06,504,iron,449,879,430,1,00026,India
919579,2023-04-06,506,monitor,3249,8000,4751,1,00026,India
152927,2023-04-06,502,iphone 15 pro max,100000,135000,35000,1,00001,India
152927,2023-04-06,505,oven,18490,24000,5510,1,00001,India
152927,2023-04-06,507,washing machine,6990,16490,9500,1,00001,India
152927,2023-04-06,506,monitor,3249,8000,4751,1,00001,India
497854,2023-04-06,506,monitor,3249,8000,4751,1,00299,India
497854,2023-04-06,503,mixer,1349,3249,1900,1,00299,India
497854,2023-04-06,504,iron,449,879,430,1,00299,India
211771,2023-04-06,503,mixer,1349,3249,1900,1,00131,India
929259,2023-04-06,501,iphone 15,60000,80000,20000,1,00445,India
929259,2023-04-06,505,oven,18490,24000,5510,1,00445,India
929259,2023-04-06,504,iron,449,879,430,1,00445,India
929259,2023-04-06,502,iphone 15 pro max,100000,135000,35000,1,00445,India
805588,2023-04-06,505,oven,18490,24000,5510,1,00203,India
805588,2023-04-06,501,iphone 15,60000,80000,20000,1,00203,India
805588,2023-04-06,507,washing machine,6990,16490,9500,1,00203,India
990557,2023-04-06,507,washing machine,6990,16490,9500,1,00263,India
990557,2023-04-06,501,iphone 15,60000,80000,20000,1,00263,India
682981,2023-04-06,503,mixer,1349,3249,1900,1,00224,India
682981,2023-04-06,507,washing machine,6990,16490,9500,1,00224,India
322025,2023-04-06,504,iron,449,879,430,1,00435,India
322025,2023-04-06,505,oven,18490,24000,5510,1,00435,India
322025,2023-04-06,506,monitor,3249,8000,4751,1,00435,India
322025,2023-04-06,502,iphone 15 pro max,100000,135000,35000,1,00435,India
322025,2023-04-06,507,washing machine,6990,16490,9500,1,00435,India
185948,2023-04-06,504,iron,449,879,430,1,00273,India
185948,2023-04-06,506,monitor,3249,8000,4751,1,00273,India
475104,2023-04-06,503,mixer,1349,3249,1900,1,00275,India
475104,2023-04-06,505,oven,18490,24000,5510,1,00275,India
475104,2023-04-06,504,iron,449,879,430,1,00275,India
475104,2023-04-06,501,iphone 15,60000,80000,20000,1,00275,India
967216,2023-04-06,507,washing machine,6990,16490,9500,1,00149,India
967216,2023-04-06,506,monitor,3249,8000,4751,1,00149,India
800873,2023-04-06,505,oven,18490,24000,5510,1,00348,India
800873,2023-04-06,504,iron,449,879,430,1,00348,India
800873,2023-04-06,506,monitor,3249,8000,4751,1,00348,India
800873,2023-04-06,503,mixer,1349,3249,1900,1,00348,India
333720,2023-04-06,506,monitor,3249,8000,4751,1,00287,India
333720,2023-04-06,503,mixer,1349,3249,1900,1,00287,India
333720,2023-04-06,501,iphone 15,60000,80000,20000,1,00287,India
333720,2023-04-06,504,iron,449,879,430,1,00287,India
229791,2023-04-06,504,iron,449,879,430,1,00476,India
227221,2023-04-06,502,iphone 15 pro max,100000,135000,35000,1,00110,India
227221,2023-04-06,507,washing machine,6990,16490,9500,1,00110,India
227221,2023-04-06,503,mixer,1349,3249,1900,1,00110,India
227221,2023-04-06,506,monitor,3249,8000,4751,1,00110,India
438588,2023-04-06,505,oven,18490,24000,5510,1,00455,India
438588,2023-04-06,501,iphone 15,60000,80000,20000,1,00455,India
438588,2023-04-06,506,monitor,3249,8000,4751,1,00455,India
829450,2023-04-06,507,washing machine,6990,16490,9500,1,00206,India
829450,2023-04-06,505,oven,18490,24000,5510,1,00206,India
829450,2023-04-06,506,monitor,3249,8000,4751,1,00206,India
829450,2023-04-06,501,iphone 15,60000,80000,20000,1,00206,India
260378,2023-04-06,505,oven,18490,24000,5510,1,00452,India
434970,2023-04-06,504,iron,449,879,430,1,00004,India
434970,2023-04-06,502,iphone 15 pro max,100000,135000,35000,1,00004,India
434970,2023-04-06,503,mixer,1349,3249,1900,1,00004,India
418612,2023-04-06,507,washing machine,6990,16490,9500,1,00039,India
848453,2023-04-06,501,iphone 15,60000,80000,20000,1,00284,India
518743,2023-04-06,502,iphone 15 pro max,100000,135000,35000,1,00122,India
518743,2023-04-06,504,iron,449,879,430,1,00122,India
518743,2023-04-06,506,monitor,3249,8000,4751,1,00122,India
518743,2023-04-06,501,iphone 15,60000,80000,20000,1,00122,India
792578,2023-04-06,504,iron,449,879,430,1,00349,India
638839,2023-04-06,507,washing machine,6990,16490,9500,1,00406,India
638839,2023-04-06,506,monitor,3249,8000,4751,1,00406,India
638839,2023-04-06,503,mixer,1349,3249,1900,1,00406,India
441591,2023-04-06,505,oven,18490,24000,5510,1,00310,India
441591,2023-04-06,504,iron,449,879,430,1,00310,India
441591,2023-04-06,506,monitor,3249,8000,4751,1,00310,India
416430,2023-04-06,504,iron,449,879,430,1,00106,India
248771,2023-04-06,502,iphone 15 pro max,100000,135000,35000,1,00026,India
248771,2023-04-06,506,monitor,3249,8000,4751,1,00026,India
330446,2023-04-06,504,iron,449,879,430,1,00496,India
330446,2023-04-06,505,oven,18490,24000,5510,1,00496,India
330446,2023-04-06,506,monitor,3249,8000,4751,1,00496,India
616508,2023-04-06,503,mixer,1349,3249,1900,1,00224,India
616508,2023-04-06,506,monitor,3249,8000,4751,1,00224,India
616508,2023-04-06,502,iphone 15 pro max,100000,135000,35000,1,00224,India
753648,2023-04-06,503,mixer,1349,3249,1900,1,00213,India
753648,2023-04-06,505,oven,18490,24000,5510,1,00213,India
753648,2023-04-06,506,monitor,3249,8000,4751,1,00213,India
335598,2023-04-06,507,washing machine,6990,16490,9500,1,00498,India
335598,2023-04-06,504,iron,449,879,430,1,00498,India
335598,2023-04-06,501,iphone 15,60000,80000,20000,1,00498,India
944157,2023-04-06,507,washing machine,6990,16490,9500,1,00385,India
944157,2023-04-06,502,iphone 15 pro max,100000,135000,35000,1,00385,India
944157,2023-04-06,501,iphone 15,60000,80000,20000,1,00385,India
944157,2023-04-06,506,monitor,3249,8000,4751,1,00385,India
375842,2023-04-06,505,oven,18490,24000,5510,1,00475,India
375842,2023-04-06,504,iron,449,879,430,1,00475,India
375842,2023-04-06,501,iphone 15,60000,80000,20000,1,00475,India
182693,2023-04-06,503,mixer,1349,3249,1900,1,00427,India
182693,2023-04-06,506,monitor,3249,8000,4751,1,00427,India
617104,2023-04-06,502,iphone 15 pro max,100000,135000,35000,1,00303,India
617104,2023-04-06,503,mixer,1349,3249,1900,1,00303,India
617104,2023-04-06,505,oven,18490,24000,5510,1,00303,India
576043,2023-04-06,502,iphone 15 pro max,100000,135000,35000,1,00361,India
576043,2023-04-06,503,mixer,1349,3249,1900,1,00361,India
374253,2023-04-06,501,iphone 15,60000,80000,20000,1,00407,India
525266,2023-04-06,501,iphone 15,60000,80000,20000,1,00116,India
525266,2023-04-06,506,monitor,3249,8000,4751,1,00116,India
525266,2023-04-06,505,oven,18490,24000,5510,1,00116,India
623487,2023-04-07,505,oven,18490,24000,5510,1,00124,India
623487,2023-04-07,502,iphone 15 pro max,100000,135000,35000,1,00124,India
228928,2023-04-07,505,oven,18490,24000,5510,1,00082,India
228928,2023-04-07,506,monitor,3249,8000,4751,1,00082,India
228928,2023-04-07,502,iphone 15 pro max,100000,135000,35000,1,00082,India
436491,2023-04-07,504,iron,449,879,430,1,00278,India
677708,2023-04-07,502,iphone 15 pro max,100000,135000,35000,1,00259,India
677708,2023-04-07,506,monitor,3249,8000,4751,1,00259,India
677708,2023-04-07,505,oven,18490,24000,5510,1,00259,India
659468,2023-04-07,501,iphone 15,60000,80000,20000,1,00034,India
659468,2023-04-07,507,washing machine,6990,16490,9500,1,00034,India
659468,2023-04-07,503,mixer,1349,3249,1900,1,00034,India
644099,2023-04-07,501,iphone 15,60000,80000,20000,1,00490,India
438329,2023-04-07,505,oven,18490,24000,5510,1,00083,India
438569,2023-04-07,501,iphone 15,60000,80000,20000,1,00432,India
438569,2023-04-07,502,iphone 15 pro max,100000,135000,35000,1,00432,India
438569,2023-04-07,505,oven,18490,24000,5510,1,00432,India
285325,2023-04-07,503,mixer,1349,3249,1900,1,00348,India
285325,2023-04-07,504,iron,449,879,430,1,00348,India
285325,2023-04-07,506,monitor,3249,8000,4751,1,00348,India
285325,2023-04-07,502,iphone 15 pro max,100000,135000,35000,1,00348,India
948233,2023-04-07,504,iron,449,879,430,1,00167,India
852184,2023-04-07,501,iphone 15,60000,80000,20000,1,00270,India
852184,2023-04-07,503,mixer,1349,3249,1900,1,00270,India
852184,2023-04-07,504,iron,449,879,430,1,00270,India
698687,2023-04-07,504,iron,449,879,430,1,00015,India
698687,2023-04-07,505,oven,18490,24000,5510,1,00015,India
346882,2023-04-07,502,iphone 15 pro max,100000,135000,35000,1,00172,India
346882,2023-04-07,507,washing machine,6990,16490,9500,1,00172,India
643691,2023-04-07,506,monitor,3249,8000,4751,1,00006,India
207557,2023-04-07,502,iphone 15 pro max,100000,135000,35000,1,00177,India
207557,2023-04-07,507,washing machine,6990,16490,9500,1,00177,India
207557,2023-04-07,503,mixer,1349,3249,1900,1,00177,India
207557,2023-04-07,504,iron,449,879,430,1,00177,India
301002,2023-04-07,505,oven,18490,24000,5510,1,00463,India
301002,2023-04-07,507,washing machine,6990,16490,9500,1,00463,India
301002,2023-04-07,502,iphone 15 pro max,100000,135000,35000,1,00463,India
301002,2023-04-07,504,iron,449,879,430,1,00463,India
983380,2023-04-07,505,oven,18490,24000,5510,1,00138,India
138983,2023-04-07,505,oven,18490,24000,5510,1,00372,India
378622,2023-04-07,503,mixer,1349,3249,1900,1,00051,India
378622,2023-04-07,505,oven,18490,24000,5510,1,00051,India
378622,2023-04-07,504,iron,449,879,430,1,00051,India
902628,2023-04-07,503,mixer,1349,3249,1900,1,00074,India
902628,2023-04-07,501,iphone 15,60000,80000,20000,1,00074,India
902628,2023-04-07,505,oven,18490,24000,5510,1,00074,India
399730,2023-04-07,501,iphone 15,60000,80000,20000,1,00249,India
399730,2023-04-07,502,iphone 15 pro max,100000,135000,35000,1,00249,India
594402,2023-04-07,501,iphone 15,60000,80000,20000,1,00053,India
594402,2023-04-07,506,monitor,3249,8000,4751,1,00053,India
927300,2023-04-07,506,monitor,3249,8000,4751,1,00491,India
927300,2023-04-07,503,mixer,1349,3249,1900,1,00491,India
927300,2023-04-07,501,iphone 15,60000,80000,20000,1,00491,India
927300,2023-04-07,505,oven,18490,24000,5510,1,00491,India
968258,2023-04-07,505,oven,18490,24000,5510,1,00276,India
968258,2023-04-07,502,iphone 15 pro max,100000,135000,35000,1,00276,India
968258,2023-04-07,507,washing machine,6990,16490,9500,1,00276,India
968258,2023-04-07,501,iphone 15,60000,80000,20000,1,00276,India
841958,2023-04-07,501,iphone 15,60000,80000,20000,1,00405,India
841958,2023-04-07,502,iphone 15 pro max,100000,135000,35000,1,00405,India
571547,2023-04-07,506,monitor,3249,8000,4751,1,00452,India
605298,2023-04-07,504,iron,449,879,430,1,00165,India
605298,2023-04-07,501,iphone 15,60000,80000,20000,1,00165,India
605298,2023-04-07,507,washing machine,6990,16490,9500,1,00165,India
183077,2023-04-07,506,monitor,3249,8000,4751,1,00375,India
183077,2023-04-07,507,washing machine,6990,16490,9500,1,00375,India
702999,2023-04-07,506,monitor,3249,8000,4751,1,00014,India
702999,2023-04-07,507,washing machine,6990,16490,9500,1,00014,India
702999,2023-04-07,504,iron,449,879,430,1,00014,India
702999,2023-04-07,505,oven,18490,24000,5510,1,00014,India
663819,2023-04-07,506,monitor,3249,8000,4751,1,00366,India
663819,2023-04-07,503,mixer,1349,3249,1900,1,00366,India
847502,2023-04-07,506,monitor,3249,8000,4751,1,00217,India
847502,2023-04-07,501,iphone 15,60000,80000,20000,1,00217,India
715082,2023-04-07,501,iphone 15,60000,80000,20000,1,00036,India
368356,2023-04-07,506,monitor,3249,8000,4751,1,00001,India
368356,2023-04-07,501,iphone 15,60000,80000,20000,1,00001,India
368356,2023-04-07,502,iphone 15 pro max,100000,135000,35000,1,00001,India
405046,2023-04-07,501,iphone 15,60000,80000,20000,1,00043,India
405046,2023-04-07,507,washing machine,6990,16490,9500,1,00043,India
686571,2023-04-07,502,iphone 15 pro max,100000,135000,35000,1,00004,India
490480,2023-04-07,507,washing machine,6990,16490,9500,1,00161,India
490480,2023-04-07,501,iphone 15,60000,80000,20000,1,00161,India
928639,2023-04-07,505,oven,18490,24000,5510,1,00273,India
928639,2023-04-07,502,iphone 15 pro max,100000,135000,35000,1,00273,India
837407,2023-04-07,504,iron,449,879,430,1,00187,India
837407,2023-04-07,502,iphone 15 pro max,100000,135000,35000,1,00187,India
837407,2023-04-07,503,mixer,1349,3249,1900,1,00187,India
837407,2023-04-07,507,washing machine,6990,16490,9500,1,00187,India
642251,2023-04-07,502,iphone 15 pro max,100000,135000,35000,1,00459,India
820953,2023-04-07,505,oven,18490,24000,5510,1,00230,India
820953,2023-04-07,507,washing machine,6990,16490,9500,1,00230,India
820953,2023-04-07,502,iphone 15 pro max,100000,135000,35000,1,00230,India
820953,2023-04-07,504,iron,449,879,430,1,00230,India
810744,2023-04-07,506,monitor,3249,8000,4751,1,00489,India
810744,2023-04-07,501,iphone 15,60000,80000,20000,1,00489,India
620725,2023-04-07,505,oven,18490,24000,5510,1,00042,India
341042,2023-04-07,507,washing machine,6990,16490,9500,1,00030,India
341042,2023-04-07,503,mixer,1349,3249,1900,1,00030,India
341042,2023-04-07,502,iphone 15 pro max,100000,135000,35000,1,00030,India
341042,2023-04-07,505,oven,18490,24000,5510,1,00030,India
341042,2023-04-07,506,monitor,3249,8000,4751,1,00030,India
304735,2023-04-07,504,iron,449,879,430,1,00017,India
304735,2023-04-07,501,iphone 15,60000,80000,20000,1,00017,India
304735,2023-04-07,506,monitor,3249,8000,4751,1,00017,India
390587,2023-04-07,502,iphone 15 pro max,100000,135000,35000,1,00068,India
390587,2023-04-07,504,iron,449,879,430,1,00068,India
571201,2023-04-07,507,washing machine,6990,16490,9500,1,00133,India
571201,2023-04-07,506,monitor,3249,8000,4751,1,00133,India
237710,2023-04-07,504,iron,449,879,430,1,00287,India
237710,2023-04-07,503,mixer,1349,3249,1900,1,00287,India
237710,2023-04-07,502,iphone 15 pro max,100000,135000,35000,1,00287,India
785186,2023-04-07,502,iphone 15 pro max,100000,135000,35000,1,00073,India
785186,2023-04-07,501,iphone 15,60000,80000,20000,1,00073,India
785186,2023-04-07,505,oven,18490,24000,5510,1,00073,India
785186,2023-04-07,503,mixer,1349,3249,1900,1,00073,India
163374,2023-04-07,504,iron,449,879,430,1,00258,India
163374,2023-04-07,503,mixer,1349,3249,1900,1,00258,India
163374,2023-04-07,506,monitor,3249,8000,4751,1,00258,India
444134,2023-04-07,506,monitor,3249,8000,4751,1,00101,India
369000,2023-04-07,505,oven,18490,24000,5510,1,00162,India
369000,2023-04-07,506,monitor,3249,8000,4751,1,00162,India
369000,2023-04-07,504,iron,449,879,430,1,00162,India
861188,2023-04-07,501,iphone 15,60000,80000,20000,1,00074,India
861188,2023-04-07,506,monitor,3249,8000,4751,1,00074,India
861188,2023-04-07,502,iphone 15 pro max,100000,135000,35000,1,00074,India
395214,2023-04-07,502,iphone 15 pro max,100000,135000,35000,1,00202,India
395214,2023-04-07,504,iron,449,879,430,1,00202,India
395214,2023-04-07,501,iphone 15,60000,80000,20000,1,00202,India
528500,2023-04-07,503,mixer,1349,3249,1900,1,00085,India
528500,2023-04-07,501,iphone 15,60000,80000,20000,1,00085,India
528500,2023-04-07,507,washing machine,6990,16490,9500,1,00085,India
470456,2023-04-07,501,iphone 15,60000,80000,20000,1,00006,India
470456,2023-04-07,505,oven,18490,24000,5510,1,00006,India
454251,2023-04-07,507,washing machine,6990,16490,9500,1,00379,India
454251,2023-04-07,505,oven,18490,24000,5510,1,00379,India
454251,2023-04-07,503,mixer,1349,3249,1900,1,00379,India
454251,2023-04-07,504,iron,449,879,430,1,00379,India
173445,2023-04-07,501,iphone 15,60000,80000,20000,1,00253,India
173445,2023-04-07,505,oven,18490,24000,5510,1,00253,India
851115,2023-04-07,503,mixer,1349,3249,1900,1,00445,India
851115,2023-04-07,505,oven,18490,24000,5510,1,00445,India
851115,2023-04-07,502,iphone 15 pro max,100000,135000,35000,1,00445,India
851115,2023-04-07,507,washing machine,6990,16490,9500,1,00445,India
721834,2023-04-07,501,iphone 15,60000,80000,20000,1,00188,India
721834,2023-04-07,507,washing machine,6990,16490,9500,1,00188,India
393841,2023-04-07,502,iphone 15 pro max,100000,135000,35000,1,00213,India
393841,2023-04-07,505,oven,18490,24000,5510,1,00213,India
393841,2023-04-07,507,washing machine,6990,16490,9500,1,00213,India
393841,2023-04-07,504,iron,449,879,430,1,00213,India
841577,2023-04-07,504,iron,449,879,430,1,00432,India
841577,2023-04-07,506,monitor,3249,8000,4751,1,00432,India
841577,2023-04-07,505,oven,18490,24000,5510,1,00432,India
841577,2023-04-07,507,washing machine,6990,16490,9500,1,00432,India
679951,2023-04-07,507,washing machine,6990,16490,9500,1,00219,India
420723,2023-04-07,504,iron,449,879,430,1,00063,India
420723,2023-04-07,507,washing machine,6990,16490,9500,1,00063,India
775970,2023-04-07,506,monitor,3249,8000,4751,1,00010,India
961926,2023-04-07,507,washing machine,6990,16490,9500,1,00144,India
961926,2023-04-07,505,oven,18490,24000,5510,1,00144,India
961926,2023-04-07,502,iphone 15 pro max,100000,135000,35000,1,00144,India
936613,2023-04-07,505,oven,18490,24000,5510,1,00415,India
936613,2023-04-07,507,washing machine,6990,16490,9500,1,00415,India
936613,2023-04-07,504,iron,449,879,430,1,00415,India
854078,2023-04-07,507,washing machine,6990,16490,9500,1,00479,India
882153,2023-04-07,501,iphone 15,60000,80000,20000,1,00015,India
231295,2023-04-07,504,iron,449,879,430,1,00481,India
231295,2023-04-07,501,iphone 15,60000,80000,20000,1,00481,India
231295,2023-04-07,502,iphone 15 pro max,100000,135000,35000,1,00481,India
231295,2023-04-07,506,monitor,3249,8000,4751,1,00481,India
124849,2023-04-07,504,iron,449,879,430,1,00164,India
124849,2023-04-07,506,monitor,3249,8000,4751,1,00164,India
124849,2023-04-07,507,washing machine,6990,16490,9500,1,00164,India
124849,2023-04-07,503,mixer,1349,3249,1900,1,00164,India
877289,2023-04-07,505,oven,18490,24000,5510,1,00229,India
877289,2023-04-07,507,washing machine,6990,16490,9500,1,00229,India
877289,2023-04-07,502,iphone 15 pro max,100000,135000,35000,1,00229,India
356457,2023-04-07,504,iron,449,879,430,1,00392,India
356457,2023-04-07,506,monitor,3249,8000,4751,1,00392,India
996472,2023-04-07,505,oven,18490,24000,5510,1,00194,India
996472,2023-04-07,502,iphone 15 pro max,100000,135000,35000,1,00194,India
996472,2023-04-07,501,iphone 15,60000,80000,20000,1,00194,India
452943,2023-04-08,505,oven,18490,24000,5510,1,00174,India
452943,2023-04-08,501,iphone 15,60000,80000,20000,1,00174,India
452943,2023-04-08,507,washing machine,6990,16490,9500,1,00174,India
809409,2023-04-08,504,iron,449,879,430,1,00122,India
809409,2023-04-08,501,iphone 15,60000,80000,20000,1,00122,India
809409,2023-04-08,506,monitor,3249,8000,4751,1,00122,India
966881,2023-04-08,503,mixer,1349,3249,1900,1,00228,India
966881,2023-04-08,507,washing machine,6990,16490,9500,1,00228,India
966881,2023-04-08,505,oven,18490,24000,5510,1,00228,India
990857,2023-04-08,502,iphone 15 pro max,100000,135000,35000,1,00051,India
990857,2023-04-08,507,washing machine,6990,16490,9500,1,00051,India
586012,2023-04-08,505,oven,18490,24000,5510,1,00120,India
586012,2023-04-08,502,iphone 15 pro max,100000,135000,35000,1,00120,India
586012,2023-04-08,507,washing machine,6990,16490,9500,1,00120,India
334644,2023-04-08,502,iphone 15 pro max,100000,135000,35000,1,00250,India
334644,2023-04-08,506,monitor,3249,8000,4751,1,00250,India
914922,2023-04-08,504,iron,449,879,430,1,00407,India
914922,2023-04-08,502,iphone 15 pro max,100000,135000,35000,1,00407,India
914922,2023-04-08,506,monitor,3249,8000,4751,1,00407,India
595469,2023-04-08,505,oven,18490,24000,5510,1,00348,India
858556,2023-04-08,506,monitor,3249,8000,4751,1,00111,India
858556,2023-04-08,503,mixer,1349,3249,1900,1,00111,India
825699,2023-04-08,502,iphone 15 pro max,100000,135000,35000,1,00017,India
825699,2023-04-08,501,iphone 15,60000,80000,20000,1,00017,India
825699,2023-04-08,503,mixer,1349,3249,1900,1,00017,India
825699,2023-04-08,505,oven,18490,24000,5510,1,00017,India
825699,2023-04-08,506,monitor,3249,8000,4751,1,00017,India
933289,2023-04-08,502,iphone 15 pro max,100000,135000,35000,1,00023,India
386961,2023-04-08,503,mixer,1349,3249,1900,1,00131,India
386961,2023-04-08,505,oven,18490,24000,5510,1,00131,India
718029,2023-04-08,507,washing machine,6990,16490,9500,1,00140,India
808290,2023-04-08,506,monitor,3249,8000,4751,1,00314,India
808290,2023-04-08,504,iron,449,879,430,1,00314,India
500272,2023-04-08,502,iphone 15 pro max,100000,135000,35000,1,00348,India
500272,2023-04-08,501,iphone 15,60000,80000,20000,1,00348,India
351930,2023-04-08,503,mixer,1349,3249,1900,1,00450,India
982319,2023-04-08,501,iphone 15,60000,80000,20000,1,00271,India
307585,2023-04-08,504,iron,449,879,430,1,00360,India
307585,2023-04-08,505,oven,18490,24000,5510,1,00360,India
307585,2023-04-08,507,washing machine,6990,16490,9500,1,00360,India
307585,2023-04-08,501,iphone 15,60000,80000,20000,1,00360,India
118163,2023-04-08,506,monitor,3249,8000,4751,1,00217,India
118163,2023-04-08,505,oven,18490,24000,5510,1,00217,India
707405,2023-04-08,505,oven,18490,24000,5510,1,00394,India
707405,2023-04-08,504,iron,449,879,430,1,00394,India
707405,2023-04-08,507,washing machine,6990,16490,9500,1,00394,India
675860,2023-04-08,503,mixer,1349,3249,1900,1,00327,India
675860,2023-04-08,507,washing machine,6990,16490,9500,1,00327,India
748469,2023-04-08,501,iphone 15,60000,80000,20000,1,00014,India
748469,2023-04-08,506,monitor,3249,8000,4751,1,00014,India
393357,2023-04-08,502,iphone 15 pro max,100000,135000,35000,1,00100,India
393357,2023-04-08,503,mixer,1349,3249,1900,1,00100,India
170567,2023-04-08,503,mixer,1349,3249,1900,1,00429,India
170567,2023-04-08,505,oven,18490,24000,5510,1,00429,India
718719,2023-04-08,501,iphone 15,60000,80000,20000,1,00212,India
513736,2023-04-08,503,mixer,1349,3249,1900,1,00304,India
513736,2023-04-08,502,iphone 15 pro max,100000,135000,35000,1,00304,India
513736,2023-04-08,506,monitor,3249,8000,4751,1,00304,India
945966,2023-04-08,507,washing machine,6990,16490,9500,1,00289,India
945966,2023-04-08,505,oven,18490,24000,5510,1,00289,India
350239,2023-04-08,501,iphone 15,60000,80000,20000,1,00337,India
350239,2023-04-08,507,washing machine,6990,16490,9500,1,00337,India
311529,2023-04-08,502,iphone 15 pro max,100000,135000,35000,1,00255,India
311529,2023-04-08,507,washing machine,6990,16490,9500,1,00255,India
311529,2023-04-08,503,mixer,1349,3249,1900,1,00255,India
311529,2023-04-08,504,iron,449,879,430,1,00255,India
979211,2023-04-08,503,mixer,1349,3249,1900,1,00428,India
979211,2023-04-08,502,iphone 15 pro max,100000,135000,35000,1,00428,India
979211,2023-04-08,506,monitor,3249,8000,4751,1,00428,India
979211,2023-04-08,504,iron,449,879,430,1,00428,India
435028,2023-04-08,501,iphone 15,60000,80000,20000,1,00411,India
435028,2023-04-08,506,monitor,3249,8000,4751,1,00411,India
435028,2023-04-08,505,oven,18490,24000,5510,1,00411,India
352079,2023-04-08,505,oven,18490,24000,5510,1,00252,India
352079,2023-04-08,503,mixer,1349,3249,1900,1,00252,India
352079,2023-04-08,507,washing machine,6990,16490,9500,1,00252,India
352079,2023-04-08,506,monitor,3249,8000,4751,1,00252,India
978794,2023-04-08,501,iphone 15,60000,80000,20000,1,00032,India
978794,2023-04-08,502,iphone 15 pro max,100000,135000,35000,1,00032,India
777506,2023-04-08,502,iphone 15 pro max,100000,135000,35000,1,00194,India
256245,2023-04-08,501,iphone 15,60000,80000,20000,1,00376,India
289411,2023-04-08,507,washing machine,6990,16490,9500,1,00092,India
779541,2023-04-08,504,iron,449,879,430,1,00030,India
779541,2023-04-08,507,washing machine,6990,16490,9500,1,00030,India
779541,2023-04-08,501,iphone 15,60000,80000,20000,1,00030,India
779541,2023-04-08,503,mixer,1349,3249,1900,1,00030,India
667849,2023-04-08,501,iphone 15,60000,80000,20000,1,00183,India
338768,2023-04-08,502,iphone 15 pro max,100000,135000,35000,1,00070,India
338768,2023-04-08,506,monitor,3249,8000,4751,1,00070,India
338768,2023-04-08,501,iphone 15,60000,80000,20000,1,00070,India
338768,2023-04-08,503,mixer,1349,3249,1900,1,00070,India
197761,2023-04-08,506,monitor,3249,8000,4751,1,00334,India
197761,2023-04-08,501,iphone 15,60000,80000,20000,1,00334,India
197761,2023-04-08,507,washing machine,6990,16490,9500,1,00334,India
936735,2023-04-08,501,iphone 15,60000,80000,20000,1,00134,India
936735,2023-04-08,502,iphone 15 pro max,100000,135000,35000,1,00134,India
436034,2023-04-08,507,washing machine,6990,16490,9500,1,00182,India
436034,2023-04-08,504,iron,449,879,430,1,00182,India
317658,2023-04-08,504,iron,449,879,430,1,00149,India
317658,2023-04-08,501,iphone 15,60000,80000,20000,1,00149,India
317658,2023-04-08,502,iphone 15 pro max,100000,135000,35000,1,00149,India
897218,2023-04-08,503,mixer,1349,3249,1900,1,00043,India
465488,2023-04-08,501,iphone 15,60000,80000,20000,1,00214,India
465488,2023-04-08,502,iphone 15 pro max,100000,135000,35000,1,00214,India
465488,2023-04-08,506,monitor,3249,8000,4751,1,00214,India
465488,2023-04-08,503,mixer,1349,3249,1900,1,00214,India
465488,2023-04-08,507,washing machine,6990,16490,9500,1,00214,India
185226,2023-04-08,503,mixer,1349,3249,1900,1,00432,India
185226,2023-04-08,507,washing machine,6990,16490,9500,1,00432,India
576202,2023-04-08,503,mixer,1349,3249,1900,1,00460,India
576202,2023-04-08,504,iron,449,879,430,1,00460,India
576202,2023-04-08,502,iphone 15 pro max,100000,135000,35000,1,00460,India
284614,2023-04-08,503,mixer,1349,3249,1900,1,00199,India
284614,2023-04-08,504,iron,449,879,430,1,00199,India
918825,2023-04-08,503,mixer,1349,3249,1900,1,00199,India
918825,2023-04-08,501,iphone 15,60000,80000,20000,1,00199,India
918825,2023-04-08,507,washing machine,6990,16490,9500,1,00199,India
952311,2023-04-08,505,oven,18490,24000,5510,1,00423,India
952311,2023-04-08,503,mixer,1349,3249,1900,1,00423,India
952311,2023-04-08,501,iphone 15,60000,80000,20000,1,00423,India
135372,2023-04-08,503,mixer,1349,3249,1900,1,00024,India
135372,2023-04-08,506,monitor,3249,8000,4751,1,00024,India
135372,2023-04-08,505,oven,18490,24000,5510,1,00024,India
777597,2023-04-08,503,mixer,1349,3249,1900,1,00022,India
777597,2023-04-08,505,oven,18490,24000,5510,1,00022,India
777597,2023-04-08,504,iron,449,879,430,1,00022,India
777597,2023-04-08,501,iphone 15,60000,80000,20000,1,00022,India
774239,2023-04-08,506,monitor,3249,8000,4751,1,00199,India
774239,2023-04-08,502,iphone 15 pro max,100000,135000,35000,1,00199,India
774239,2023-04-08,504,iron,449,879,430,1,00199,India
605059,2023-04-08,505,oven,18490,24000,5510,1,00259,India
605059,2023-04-08,502,iphone 15 pro max,100000,135000,35000,1,00259,India
213785,2023-04-08,507,washing machine,6990,16490,9500,1,00191,India
213785,2023-04-08,505,oven,18490,24000,5510,1,00191,India
213785,2023-04-08,501,iphone 15,60000,80000,20000,1,00191,India
213785,2023-04-08,504,iron,449,879,430,1,00191,India
560455,2023-04-08,506,monitor,3249,8000,4751,1,00110,India
560455,2023-04-08,504,iron,449,879,430,1,00110,India
560455,2023-04-08,501,iphone 15,60000,80000,20000,1,00110,India
560455,2023-04-08,502,iphone 15 pro max,100000,135000,35000,1,00110,India
140192,2023-04-08,504,iron,449,879,430,1,00417,India
140192,2023-04-08,506,monitor,3249,8000,4751,1,00417,India
977316,2023-04-08,501,iphone 15,60000,80000,20000,1,00112,India
938408,2023-04-08,501,iphone 15,60000,80000,20000,1,00088,India
938408,2023-04-08,503,mixer,1349,3249,1900,1,00088,India
938408,2023-04-08,502,iphone 15 pro max,100000,135000,35000,1,00088,India
186780,2023-04-08,501,iphone 15,60000,80000,20000,1,00349,India
186780,2023-04-08,503,mixer,1349,3249,1900,1,00349,India
186780,2023-04-08,506,monitor,3249,8000,4751,1,00349,India
513137,2023-04-08,501,iphone 15,60000,80000,20000,1,00436,India
513137,2023-04-08,503,mixer,1349,3249,1900,1,00436,India
513137,2023-04-08,507,washing machine,6990,16490,9500,1,00436,India
649288,2023-04-08,504,iron,449,879,430,1,00367,India
649288,2023-04-08,506,monitor,3249,8000,4751,1,00367,India
649288,2023-04-08,503,mixer,1349,3249,1900,1,00367,India
649288,2023-04-08,502,iphone 15 pro max,100000,135000,35000,1,00367,India
282916,2023-04-08,501,iphone 15,60000,80000,20000,1,00371,India
282916,2023-04-08,502,iphone 15 pro max,100000,135000,35000,1,00371,India
282916,2023-04-08,505,oven,18490,24000,5510,1,00371,India
995637,2023-04-08,504,iron,449,879,430,1,00489,India
995637,2023-04-08,503,mixer,1349,3249,1900,1,00489,India
995637,2023-04-08,507,washing machine,6990,16490,9500,1,00489,India
995637,2023-04-08,506,monitor,3249,8000,4751,1,00489,India
149233,2023-04-08,504,iron,449,879,430,1,00340,India
149233,2023-04-08,507,washing machine,6990,16490,9500,1,00340,India
149233,2023-04-08,505,oven,18490,24000,5510,1,00340,India
149233,2023-04-08,506,monitor,3249,8000,4751,1,00340,India
986873,2023-04-08,507,washing machine,6990,16490,9500,1,00084,India
338866,2023-04-08,505,oven,18490,24000,5510,1,00368,India
403944,2023-04-08,504,iron,449,879,430,1,00046,India
403944,2023-04-08,507,washing machine,6990,16490,9500,1,00046,India
483118,2023-04-08,507,washing machine,6990,16490,9500,1,00292,India
887878,2023-04-08,506,monitor,3249,8000,4751,1,00215,India
887878,2023-04-08,503,mixer,1349,3249,1900,1,00215,India
887878,2023-04-08,501,iphone 15,60000,80000,20000,1,00215,India
509156,2023-04-08,501,iphone 15,60000,80000,20000,1,00080,India
808502,2023-04-08,504,iron,449,879,430,1,00111,India
283860,2023-04-08,507,washing machine,6990,16490,9500,1,00029,India
283860,2023-04-08,506,monitor,3249,8000,4751,1,00029,India
283860,2023-04-08,505,oven,18490,24000,5510,1,00029,India
988061,2023-04-08,505,oven,18490,24000,5510,1,00471,India
988061,2023-04-08,507,washing machine,6990,16490,9500,1,00471,India
584427,2023-04-08,503,mixer,1349,3249,1900,1,00126,India
584427,2023-04-08,507,washing machine,6990,16490,9500,1,00126,India
584427,2023-04-08,502,iphone 15 pro max,100000,135000,35000,1,00126,India
676317,2023-04-08,506,monitor,3249,8000,4751,1,00199,India
676317,2023-04-08,501,iphone 15,60000,80000,20000,1,00199,India
676317,2023-04-08,503,mixer,1349,3249,1900,1,00199,India
676317,2023-04-08,504,iron,449,879,430,1,00199,India
260740,2023-04-08,501,iphone 15,60000,80000,20000,1,00104,India
179316,2023-04-08,506,monitor,3249,8000,4751,1,00140,India
179316,2023-04-08,503,mixer,1349,3249,1900,1,00140,India
179316,2023-04-08,505,oven,18490,24000,5510,1,00140,India
388885,2023-04-08,503,mixer,1349,3249,1900,1,00277,India
388885,2023-04-08,506,monitor,3249,8000,4751,1,00277,India
388885,2023-04-08,501,iphone 15,60000,80000,20000,1,00277,India
207818,2023-04-08,503,mixer,1349,3249,1900,1,00317,India
207818,2023-04-08,505,oven,18490,24000,5510,1,00317,India
207818,2023-04-08,507,washing machine,6990,16490,9500,1,00317,India
207818,2023-04-08,506,monitor,3249,8000,4751,1,00317,India
473828,2023-04-08,506,monitor,3249,8000,4751,1,00439,India
473828,2023-04-08,502,iphone 15 pro max,100000,135000,35000,1,00439,India
888088,2023-04-08,501,iphone 15,60000,80000,20000,1,00433,India
105987,2023-04-08,505,oven,18490,24000,5510,1,00076,India
105987,2023-04-08,501,iphone 15,60000,80000,20000,1,00076,India
105987,2023-04-08,503,mixer,1349,3249,1900,1,00076,India
895032,2023-04-08,507,washing machine,6990,16490,9500,1,00355,India
895032,2023-04-08,506,monitor,3249,8000,4751,1,00355,India
895032,2023-04-08,502,iphone 15 pro max,100000,135000,35000,1,00355,India
327951,2023-04-08,502,iphone 15 pro max,100000,135000,35000,1,00190,India
165992,2023-04-08,505,oven,18490,24000,5510,1,00252,India
165992,2023-04-08,503,mixer,1349,3249,1900,1,00252,India
165992,2023-04-08,504,iron,449,879,430,1,00252,India
165992,2023-04-08,502,iphone 15 pro max,100000,135000,35000,1,00252,India
514270,2023-04-08,501,iphone 15,60000,80000,20000,1,00480,India
208719,2023-04-08,507,washing machine,6990,16490,9500,1,00498,India
208719,2023-04-08,506,monitor,3249,8000,4751,1,00498,India
441001,2023-04-08,504,iron,449,879,430,1,00210,India
441001,2023-04-08,501,iphone 15,60000,80000,20000,1,00210,India
925681,2023-04-08,501,iphone 15,60000,80000,20000,1,00307,India
925681,2023-04-08,502,iphone 15 pro max,100000,135000,35000,1,00307,India
925681,2023-04-08,507,washing machine,6990,16490,9500,1,00307,India
925681,2023-04-08,505,oven,18490,24000,5510,1,00307,India
925681,2023-04-08,504,iron,449,879,430,1,00307,India
759460,2023-04-08,507,washing machine,6990,16490,9500,1,00129,India
759460,2023-04-08,505,oven,18490,24000,5510,1,00129,India
759460,2023-04-08,503,mixer,1349,3249,1900,1,00129,India
759460,2023-04-08,502,iphone 15 pro max,100000,135000,35000,1,00129,India
662871,2023-04-08,505,oven,18490,24000,5510,1,00058,India
450721,2023-04-08,501,iphone 15,60000,80000,20000,1,00052,India
450721,2023-04-08,507,washing machine,6990,16490,9500,1,00052,India
450721,2023-04-08,503,mixer,1349,3249,1900,1,00052,India
450721,2023-04-08,502,iphone 15 pro max,100000,135000,35000,1,00052,India
993877,2023-04-08,505,oven,18490,24000,5510,1,00051,India
725979,2023-04-08,504,iron,449,879,430,1,00197,India
725979,2023-04-08,506,monitor,3249,8000,4751,1,00197,India
725979,2023-04-08,505,oven,18490,24000,5510,1,00197,India
725979,2023-04-08,501,iphone 15,60000,80000,20000,1,00197,India
725979,2023-04-08,503,mixer,1349,3249,1900,1,00197,India
381989,2023-04-08,507,washing machine,6990,16490,9500,1,00038,India
381989,2023-04-08,503,mixer,1349,3249,1900,1,00038,India
377634,2023-04-08,506,monitor,3249,8000,4751,1,00335,India
377634,2023-04-08,507,washing machine,6990,16490,9500,1,00335,India
377634,2023-04-08,504,iron,449,879,430,1,00335,India
377634,2023-04-08,502,iphone 15 pro max,100000,135000,35000,1,00335,India
841108,2023-04-09,503,mixer,1349,3249,1900,1,00490,India
841108,2023-04-09,504,iron,449,879,430,1,00490,India
926352,2023-04-09,506,monitor,3249,8000,4751,1,00412,India
188857,2023-04-09,502,iphone 15 pro max,100000,135000,35000,1,00385,India
188857,2023-04-09,506,monitor,3249,8000,4751,1,00385,India
188857,2023-04-09,504,iron,449,879,430,1,00385,India
641149,2023-04-09,504,iron,449,879,430,1,00245,India
641149,2023-04-09,502,iphone 15 pro max,100000,135000,35000,1,00245,India
641149,2023-04-09,505,oven,18490,24000,5510,1,00245,India
446640,2023-04-09,507,washing machine,6990,16490,9500,1,00157,India
446640,2023-04-09,504,iron,449,879,430,1,00157,India
446640,2023-04-09,503,mixer,1349,3249,1900,1,00157,India
446640,2023-04-09,501,iphone 15,60000,80000,20000,1,00157,India
987246,2023-04-09,505,oven,18490,24000,5510,1,00400,India
987246,2023-04-09,506,monitor,3249,8000,4751,1,00400,India
987246,2023-04-09,504,iron,449,879,430,1,00400,India
400433,2023-04-09,501,iphone 15,60000,80000,20000,1,00147,India
400433,2023-04-09,502,iphone 15 pro max,100000,135000,35000,1,00147,India
400433,2023-04-09,507,washing machine,6990,16490,9500,1,00147,India
121742,2023-04-09,506,monitor,3249,8000,4751,1,00078,India
121742,2023-04-09,504,iron,449,879,430,1,00078,India
121742,2023-04-09,503,mixer,1349,3249,1900,1,00078,India
121742,2023-04-09,502,iphone 15 pro max,100000,135000,35000,1,00078,India
738949,2023-04-09,506,monitor,3249,8000,4751,1,00473,India
738949,2023-04-09,503,mixer,1349,3249,1900,1,00473,India
738949,2023-04-09,507,washing machine,6990,16490,9500,1,00473,India
738949,2023-04-09,505,oven,18490,24000,5510,1,00473,India
310517,2023-04-09,505,oven,18490,24000,5510,1,00190,India
310517,2023-04-09,507,washing machine,6990,16490,9500,1,00190,India
310517,2023-04-09,501,iphone 15,60000,80000,20000,1,00190,India
310517,2023-04-09,504,iron,449,879,430,1,00190,India
148511,2023-04-09,503,mixer,1349,3249,1900,1,00333,India
148511,2023-04-09,506,monitor,3249,8000,4751,1,00333,India
401186,2023-04-09,504,iron,449,879,430,1,00176,India
401186,2023-04-09,501,iphone 15,60000,80000,20000,1,00176,India
919518,2023-04-09,506,monitor,3249,8000,4751,1,00171,India
919518,2023-04-09,507,washing machine,6990,16490,9500,1,00171,India
408942,2023-04-09,505,oven,18490,24000,5510,1,00105,India
408942,2023-04-09,503,mixer,1349,3249,1900,1,00105,India
408942,2023-04-09,501,iphone 15,60000,80000,20000,1,00105,India
410538,2023-04-09,505,oven,18490,24000,5510,1,00476,India
410538,2023-04-09,507,washing machine,6990,16490,9500,1,00476,India
410538,2023-04-09,502,iphone 15 pro max,100000,135000,35000,1,00476,India
673288,2023-04-09,505,oven,18490,24000,5510,1,00108,India
673288,2023-04-09,506,monitor,3249,8000,4751,1,00108,India
673288,2023-04-09,504,iron,449,879,430,1,00108,India
385591,2023-04-09,502,iphone 15 pro max,100000,135000,35000,1,00468,India
385591,2023-04-09,503,mixer,1349,3249,1900,1,00468,India
385591,2023-04-09,504,iron,449,879,430,1,00468,India
456731,2023-04-09,503,mixer,1349,3249,1900,1,00040,India
456731,2023-04-09,504,iron,449,879,430,1,00040,India
897401,2023-04-09,504,iron,449,879,430,1,00482,India
897401,2023-04-09,503,mixer,1349,3249,1900,1,00482,India
897401,2023-04-09,502,iphone 15 pro max,100000,135000,35000,1,00482,India
593769,2023-04-09,506,monitor,3249,8000,4751,1,00382,India
593769,2023-04-09,507,washing machine,6990,16490,9500,1,00382,India
593769,2023-04-09,502,iphone 15 pro max,100000,135000,35000,1,00382,India
593769,2023-04-09,504,iron,449,879,430,1,00382,India
631076,2023-04-09,503,mixer,1349,3249,1900,1,00163,India
631076,2023-04-09,505,oven,18490,24000,5510,1,00163,India
209030,2023-04-09,504,iron,449,879,430,1,00158,India
209030,2023-04-09,505,oven,18490,24000,5510,1,00158,India
209030,2023-04-09,506,monitor,3249,8000,4751,1,00158,India
209030,2023-04-09,501,iphone 15,60000,80000,20000,1,00158,India
856092,2023-04-09,506,monitor,3249,8000,4751,1,00105,India
856092,2023-04-09,505,oven,18490,24000,5510,1,00105,India
856092,2023-04-09,504,iron,449,879,430,1,00105,India
856092,2023-04-09,507,washing machine,6990,16490,9500,1,00105,India
856092,2023-04-09,502,iphone 15 pro max,100000,135000,35000,1,00105,India
112712,2023-04-09,507,washing machine,6990,16490,9500,1,00181,India
112712,2023-04-09,505,oven,18490,24000,5510,1,00181,India
112712,2023-04-09,504,iron,449,879,430,1,00181,India
682379,2023-04-09,506,monitor,3249,8000,4751,1,00320,India
682379,2023-04-09,502,iphone 15 pro max,100000,135000,35000,1,00320,India
435919,2023-04-09,501,iphone 15,60000,80000,20000,1,00392,India
435919,2023-04-09,506,monitor,3249,8000,4751,1,00392,India
435919,2023-04-09,503,mixer,1349,3249,1900,1,00392,India
744901,2023-04-09,506,monitor,3249,8000,4751,1,00418,India
241827,2023-04-09,504,iron,449,879,430,1,00091,India
885830,2023-04-09,503,mixer,1349,3249,1900,1,00204,India
885830,2023-04-09,505,oven,18490,24000,5510,1,00204,India
885830,2023-04-09,504,iron,449,879,430,1,00204,India
885830,2023-04-09,502,iphone 15 pro max,100000,135000,35000,1,00204,India
887259,2023-04-09,507,washing machine,6990,16490,9500,1,00459,India
887259,2023-04-09,502,iphone 15 pro max,100000,135000,35000,1,00459,India
552705,2023-04-09,506,monitor,3249,8000,4751,1,00395,India
552705,2023-04-09,504,iron,449,879,430,1,00395,India
552705,2023-04-09,502,iphone 15 pro max,100000,135000,35000,1,00395,India
925743,2023-04-09,505,oven,18490,24000,5510,1,00068,India
925743,2023-04-09,506,monitor,3249,8000,4751,1,00068,India
925743,2023-04-09,503,mixer,1349,3249,1900,1,00068,India
699419,2023-04-09,501,iphone 15,60000,80000,20000,1,00038,India
666933,2023-04-09,504,iron,449,879,430,1,00309,India
666933,2023-04-09,506,monitor,3249,8000,4751,1,00309,India
666933,2023-04-09,507,washing machine,6990,16490,9500,1,00309,India
549284,2023-04-09,503,mixer,1349,3249,1900,1,00100,India
549284,2023-04-09,504,iron,449,879,430,1,00100,India
549284,2023-04-09,505,oven,18490,24000,5510,1,00100,India
148699,2023-04-09,504,iron,449,879,430,1,00079,India
148699,2023-04-09,506,monitor,3249,8000,4751,1,00079,India
219532,2023-04-09,502,iphone 15 pro max,100000,135000,35000,1,00192,India
247502,2023-04-09,505,oven,18490,24000,5510,1,00382,India
247502,2023-04-09,506,monitor,3249,8000,4751,1,00382,India
247502,2023-04-09,503,mixer,1349,3249,1900,1,00382,India
867668,2023-04-09,504,iron,449,879,430,1,00332,India
310468,2023-04-09,502,iphone 15 pro max,100000,135000,35000,1,00183,India
310468,2023-04-09,504,iron,449,879,430,1,00183,India
310468,2023-04-09,506,monitor,3249,8000,4751,1,00183,India
188415,2023-04-09,507,washing machine,6990,16490,9500,1,00271,India
188415,2023-04-09,502,iphone 15 pro max,100000,135000,35000,1,00271,India
188415,2023-04-09,503,mixer,1349,3249,1900,1,00271,India
335315,2023-04-09,501,iphone 15,60000,80000,20000,1,00324,India
595511,2023-04-09,502,iphone 15 pro max,100000,135000,35000,1,00388,India
595511,2023-04-09,507,washing machine,6990,16490,9500,1,00388,India
595511,2023-04-09,503,mixer,1349,3249,1900,1,00388,India
595511,2023-04-09,504,iron,449,879,430,1,00388,India
847175,2023-04-09,504,iron,449,879,430,1,00157,India
847175,2023-04-09,501,iphone 15,60000,80000,20000,1,00157,India
847175,2023-04-09,502,iphone 15 pro max,100000,135000,35000,1,00157,India
847175,2023-04-09,507,washing machine,6990,16490,9500,1,00157,India
960031,2023-04-09,503,mixer,1349,3249,1900,1,00325,India
960031,2023-04-09,504,iron,449,879,430,1,00325,India
960031,2023-04-09,506,monitor,3249,8000,4751,1,00325,India
960031,2023-04-09,507,washing machine,6990,16490,9500,1,00325,India
844357,2023-04-09,505,oven,18490,24000,5510,1,00125,India
844357,2023-04-09,502,iphone 15 pro max,100000,135000,35000,1,00125,India
844357,2023-04-09,507,washing machine,6990,16490,9500,1,00125,India
451842,2023-04-09,507,washing machine,6990,16490,9500,1,00495,India
691910,2023-04-09,505,oven,18490,24000,5510,1,00052,India
691910,2023-04-09,501,iphone 15,60000,80000,20000,1,00052,India
691910,2023-04-09,504,iron,449,879,430,1,00052,India
405225,2023-04-09,504,iron,449,879,430,1,00398,India
389888,2023-04-09,507,washing machine,6990,16490,9500,1,00173,India
389888,2023-04-09,504,iron,449,879,430,1,00173,India
973272,2023-04-09,507,washing machine,6990,16490,9500,1,00185,India
973272,2023-04-09,501,iphone 15,60000,80000,20000,1,00185,India
973272,2023-04-09,506,monitor,3249,8000,4751,1,00185,India
938456,2023-04-09,501,iphone 15,60000,80000,20000,1,00431,India
938456,2023-04-09,506,monitor,3249,8000,4751,1,00431,India
112302,2023-04-09,502,iphone 15 pro max,100000,135000,35000,1,00368,India
112302,2023-04-09,506,monitor,3249,8000,4751,1,00368,India
385921,2023-04-09,507,washing machine,6990,16490,9500,1,00006,India
243037,2023-04-09,504,iron,449,879,430,1,00360,India
243037,2023-04-09,507,washing machine,6990,16490,9500,1,00360,India
243037,2023-04-09,503,mixer,1349,3249,1900,1,00360,India
141573,2023-04-09,502,iphone 15 pro max,100000,135000,35000,1,00391,India
141573,2023-04-09,505,oven,18490,24000,5510,1,00391,India
715009,2023-04-09,501,iphone 15,60000,80000,20000,1,00179,India
186555,2023-04-09,501,iphone 15,60000,80000,20000,1,00099,India
186555,2023-04-09,506,monitor,3249,8000,4751,1,00099,India
186555,2023-04-09,505,oven,18490,24000,5510,1,00099,India
186555,2023-04-09,504,iron,449,879,430,1,00099,India
186555,2023-04-09,503,mixer,1349,3249,1900,1,00099,India
684632,2023-04-09,507,washing machine,6990,16490,9500,1,00257,India
684632,2023-04-09,501,iphone 15,60000,80000,20000,1,00257,India
684632,2023-04-09,503,mixer,1349,3249,1900,1,00257,India
684632,2023-04-09,502,iphone 15 pro max,100000,135000,35000,1,00257,India
194223,2023-04-09,507,washing machine,6990,16490,9500,1,00016,India
194223,2023-04-09,504,iron,449,879,430,1,00016,India
194223,2023-04-09,502,iphone 15 pro max,100000,135000,35000,1,00016,India
194223,2023-04-09,506,monitor,3249,8000,4751,1,00016,India
487825,2023-04-09,503,mixer,1349,3249,1900,1,00493,India
487825,2023-04-09,506,monitor,3249,8000,4751,1,00493,India
487825,2023-04-09,505,oven,18490,24000,5510,1,00493,India
927234,2023-04-09,504,iron,449,879,430,1,00001,India
927234,2023-04-09,502,iphone 15 pro max,100000,135000,35000,1,00001,India
161747,2023-04-09,502,iphone 15 pro max,100000,135000,35000,1,00028,India
632272,2023-04-09,503,mixer,1349,3249,1900,1,00462,India
857999,2023-04-09,507,washing machine,6990,16490,9500,1,00064,India
857999,2023-04-09,501,iphone 15,60000,80000,20000,1,00064,India
197172,2023-04-09,501,iphone 15,60000,80000,20000,1,00325,India
197172,2023-04-09,507,washing machine,6990,16490,9500,1,00325,India
197172,2023-04-09,505,oven,18490,24000,5510,1,00325,India
565287,2023-04-09,504,iron,449,879,430,1,00437,India
565287,2023-04-09,501,iphone 15,60000,80000,20000,1,00437,India
565287,2023-04-09,506,monitor,3249,8000,4751,1,00437,India
565287,2023-04-09,502,iphone 15 pro max,100000,135000,35000,1,00437,India
565287,2023-04-09,503,mixer,1349,3249,1900,1,00437,India
985965,2023-04-09,507,washing machine,6990,16490,9500,1,00408,India
985965,2023-04-09,506,monitor,3249,8000,4751,1,00408,India
985965,2023-04-09,504,iron,449,879,430,1,00408,India
985965,2023-04-09,501,iphone 15,60000,80000,20000,1,00408,India
245554,2023-04-09,504,iron,449,879,430,1,00163,India
245554,2023-04-09,507,washing machine,6990,16490,9500,1,00163,India
245554,2023-04-09,501,iphone 15,60000,80000,20000,1,00163,India
624050,2023-04-09,501,iphone 15,60000,80000,20000,1,00163,India
597570,2023-04-09,507,washing machine,6990,16490,9500,1,00121,India
597570,2023-04-09,502,iphone 15 pro max,100000,135000,35000,1,00121,India
250287,2023-04-09,506,monitor,3249,8000,4751,1,00249,India
116091,2023-04-09,504,iron,449,879,430,1,00421,India
116091,2023-04-09,505,oven,18490,24000,5510,1,00421,India
951271,2023-04-09,506,monitor,3249,8000,4751,1,00040,India
951271,2023-04-09,502,iphone 15 pro max,100000,135000,35000,1,00040,India
548432,2023-04-09,504,iron,449,879,430,1,00395,India
548432,2023-04-09,507,washing machine,6990,16490,9500,1,00395,India
936165,2023-04-09,501,iphone 15,60000,80000,20000,1,00171,India
936165,2023-04-09,507,washing machine,6990,16490,9500,1,00171,India
936165,2023-04-09,506,monitor,3249,8000,4751,1,00171,India
936165,2023-04-09,503,mixer,1349,3249,1900,1,00171,India
936165,2023-04-09,502,iphone 15 pro max,100000,135000,35000,1,00171,India
701473,2023-04-09,501,iphone 15,60000,80000,20000,1,00077,India
384430,2023-04-09,505,oven,18490,24000,5510,1,00213,India
384430,2023-04-09,502,iphone 15 pro max,100000,135000,35000,1,00213,India
412823,2023-04-09,506,monitor,3249,8000,4751,1,00233,India
412823,2023-04-09,502,iphone 15 pro max,100000,135000,35000,1,00233,India
921147,2023-04-09,506,monitor,3249,8000,4751,1,00361,India
515435,2023-04-09,505,oven,18490,24000,5510,1,00143,India
904657,2023-04-09,503,mixer,1349,3249,1900,1,00186,India
904657,2023-04-09,506,monitor,3249,8000,4751,1,00186,India
904657,2023-04-09,505,oven,18490,24000,5510,1,00186,India
904657,2023-04-09,502,iphone 15 pro max,100000,135000,35000,1,00186,India
406278,2023-04-09,501,iphone 15,60000,80000,20000,1,00298,India
378863,2023-04-09,507,washing machine,6990,16490,9500,1,00148,India
378863,2023-04-09,501,iphone 15,60000,80000,20000,1,00148,India
124581,2023-04-09,507,washing machine,6990,16490,9500,1,00055,India
124581,2023-04-09,501,iphone 15,60000,80000,20000,1,00055,India
877400,2023-04-09,506,monitor,3249,8000,4751,1,00182,India
877400,2023-04-09,505,oven,18490,24000,5510,1,00182,India
877400,2023-04-09,501,iphone 15,60000,80000,20000,1,00182,India
307466,2023-04-09,503,mixer,1349,3249,1900,1,00461,India
307466,2023-04-09,502,iphone 15 pro max,100000,135000,35000,1,00461,India
307466,2023-04-09,507,washing machine,6990,16490,9500,1,00461,India
151566,2023-04-09,502,iphone 15 pro max,100000,135000,35000,1,00227,India
151566,2023-04-09,503,mixer,1349,3249,1900,1,00227,India
151566,2023-04-09,501,iphone 15,60000,80000,20000,1,00227,India
151566,2023-04-09,505,oven,18490,24000,5510,1,00227,India
808985,2023-04-09,501,iphone 15,60000,80000,20000,1,00203,India
808985,2023-04-09,506,monitor,3249,8000,4751,1,00203,India
808985,2023-04-09,502,iphone 15 pro max,100000,135000,35000,1,00203,India
808985,2023-04-09,503,mixer,1349,3249,1900,1,00203,India
344094,2023-04-09,501,iphone 15,60000,80000,20000,1,00153,India
816836,2023-04-10,507,washing machine,6990,16490,9500,1,00176,India
343580,2023-04-10,502,iphone 15 pro max,100000,135000,35000,1,00166,India
343580,2023-04-10,501,iphone 15,60000,80000,20000,1,00166,India
797762,2023-04-10,502,iphone 15 pro max,100000,135000,35000,1,00412,India
797762,2023-04-10,507,washing machine,6990,16490,9500,1,00412,India
926811,2023-04-10,504,iron,449,879,430,1,00470,India
926811,2023-04-10,503,mixer,1349,3249,1900,1,00470,India
926811,2023-04-10,507,washing machine,6990,16490,9500,1,00470,India
388864,2023-04-10,502,iphone 15 pro max,100000,135000,35000,1,00334,India
388864,2023-04-10,501,iphone 15,60000,80000,20000,1,00334,India
483668,2023-04-10,505,oven,18490,24000,5510,1,00186,India
251313,2023-04-10,504,iron,449,879,430,1,00464,India
200814,2023-04-10,507,washing machine,6990,16490,9500,1,00173,India
200814,2023-04-10,503,mixer,1349,3249,1900,1,00173,India
200814,2023-04-10,506,monitor,3249,8000,4751,1,00173,India
200814,2023-04-10,504,iron,449,879,430,1,00173,India
200814,2023-04-10,501,iphone 15,60000,80000,20000,1,00173,India
938527,2023-04-10,504,iron,449,879,430,1,00369,India
938527,2023-04-10,503,mixer,1349,3249,1900,1,00369,India
938527,2023-04-10,506,monitor,3249,8000,4751,1,00369,India
196158,2023-04-10,502,iphone 15 pro max,100000,135000,35000,1,00471,India
196158,2023-04-10,503,mixer,1349,3249,1900,1,00471,India
835334,2023-04-10,506,monitor,3249,8000,4751,1,00003,India
835334,2023-04-10,504,iron,449,879,430,1,00003,India
835334,2023-04-10,503,mixer,1349,3249,1900,1,00003,India
182645,2023-04-10,506,monitor,3249,8000,4751,1,00467,India
182645,2023-04-10,503,mixer,1349,3249,1900,1,00467,India
182645,2023-04-10,504,iron,449,879,430,1,00467,India
893750,2023-04-10,501,iphone 15,60000,80000,20000,1,00164,India
893750,2023-04-10,502,iphone 15 pro max,100000,135000,35000,1,00164,India
547800,2023-04-10,506,monitor,3249,8000,4751,1,00479,India
547800,2023-04-10,503,mixer,1349,3249,1900,1,00479,India
547800,2023-04-10,504,iron,449,879,430,1,00479,India
547800,2023-04-10,502,iphone 15 pro max,100000,135000,35000,1,00479,India
476297,2023-04-10,503,mixer,1349,3249,1900,1,00064,India
476297,2023-04-10,502,iphone 15 pro max,100000,135000,35000,1,00064,India
290887,2023-04-10,507,washing machine,6990,16490,9500,1,00365,India
693687,2023-04-10,501,iphone 15,60000,80000,20000,1,00015,India
693687,2023-04-10,502,iphone 15 pro max,100000,135000,35000,1,00015,India
636912,2023-04-10,502,iphone 15 pro max,100000,135000,35000,1,00283,India
636912,2023-04-10,505,oven,18490,24000,5510,1,00283,India
636912,2023-04-10,507,washing machine,6990,16490,9500,1,00283,India
151437,2023-04-10,501,iphone 15,60000,80000,20000,1,00260,India
151437,2023-04-10,502,iphone 15 pro max,100000,135000,35000,1,00260,India
989853,2023-04-10,502,iphone 15 pro max,100000,135000,35000,1,00475,India
989853,2023-04-10,506,monitor,3249,8000,4751,1,00475,India
989853,2023-04-10,505,oven,18490,24000,5510,1,00475,India
907157,2023-04-10,507,washing machine,6990,16490,9500,1,00326,India
907157,2023-04-10,506,monitor,3249,8000,4751,1,00326,India
907157,2023-04-10,505,oven,18490,24000,5510,1,00326,India
907157,2023-04-10,503,mixer,1349,3249,1900,1,00326,India
360725,2023-04-10,502,iphone 15 pro max,100000,135000,35000,1,00319,India
360725,2023-04-10,504,iron,449,879,430,1,00319,India
360725,2023-04-10,501,iphone 15,60000,80000,20000,1,00319,India
360725,2023-04-10,505,oven,18490,24000,5510,1,00319,India
918809,2023-04-10,502,iphone 15 pro max,100000,135000,35000,1,00351,India
918809,2023-04-10,504,iron,449,879,430,1,00351,India
918809,2023-04-10,507,washing machine,6990,16490,9500,1,00351,India
918809,2023-04-10,503,mixer,1349,3249,1900,1,00351,India
560490,2023-04-10,504,iron,449,879,430,1,00485,India
560490,2023-04-10,506,monitor,3249,8000,4751,1,00485,India
599421,2023-04-10,507,washing machine,6990,16490,9500,1,00157,India
599421,2023-04-10,506,monitor,3249,8000,4751,1,00157,India
599421,2023-04-10,501,iphone 15,60000,80000,20000,1,00157,India
767456,2023-04-10,506,monitor,3249,8000,4751,1,00324,India
767456,2023-04-10,504,iron,449,879,430,1,00324,India
767456,2023-04-10,502,iphone 15 pro max,100000,135000,35000,1,00324,India
348706,2023-04-10,505,oven,18490,24000,5510,1,00062,India
348706,2023-04-10,502,iphone 15 pro max,100000,135000,35000,1,00062,India
348706,2023-04-10,507,washing machine,6990,16490,9500,1,00062,India
525357,2023-04-10,507,washing machine,6990,16490,9500,1,00385,India
525357,2023-04-10,501,iphone 15,60000,80000,20000,1,00385,India
525357,2023-04-10,504,iron,449,879,430,1,00385,India
151700,2023-04-10,503,mixer,1349,3249,1900,1,00064,India
151700,2023-04-10,507,washing machine,6990,16490,9500,1,00064,India
151700,2023-04-10,504,iron,449,879,430,1,00064,India
151700,2023-04-10,505,oven,18490,24000,5510,1,00064,India
788541,2023-04-10,504,iron,449,879,430,1,00206,India
788541,2023-04-10,506,monitor,3249,8000,4751,1,00206,India
788541,2023-04-10,501,iphone 15,60000,80000,20000,1,00206,India
347047,2023-04-10,503,mixer,1349,3249,1900,1,00391,India
328186,2023-04-10,503,mixer,1349,3249,1900,1,00272,India
681340,2023-04-10,502,iphone 15 pro max,100000,135000,35000,1,00153,India
681340,2023-04-10,504,iron,449,879,430,1,00153,India
681340,2023-04-10,501,iphone 15,60000,80000,20000,1,00153,India
500737,2023-04-10,507,washing machine,6990,16490,9500,1,00221,India
500737,2023-04-10,501,iphone 15,60000,80000,20000,1,00221,India
500737,2023-04-10,504,iron,449,879,430,1,00221,India
689540,2023-04-10,506,monitor,3249,8000,4751,1,00416,India
689540,2023-04-10,502,iphone 15 pro max,100000,135000,35000,1,00416,India
807170,2023-04-10,503,mixer,1349,3249,1900,1,00020,India
807170,2023-04-10,507,washing machine,6990,16490,9500,1,00020,India
807170,2023-04-10,505,oven,18490,24000,5510,1,00020,India
807170,2023-04-10,506,monitor,3249,8000,4751,1,00020,India
883725,2023-04-10,501,iphone 15,60000,80000,20000,1,00252,India
883725,2023-04-10,504,iron,449,879,430,1,00252,India
883725,2023-04-10,506,monitor,3249,8000,4751,1,00252,India
883725,2023-04-10,502,iphone 15 pro max,100000,135000,35000,1,00252,India
102165,2023-04-10,501,iphone 15,60000,80000,20000,1,00393,India
102165,2023-04-10,503,mixer,1349,3249,1900,1,00393,India
102165,2023-04-10,507,washing machine,6990,16490,9500,1,00393,India
102165,2023-04-10,506,monitor,3249,8000,4751,1,00393,India
786168,2023-04-10,507,washing machine,6990,16490,9500,1,00156,India
786168,2023-04-10,503,mixer,1349,3249,1900,1,00156,India
786168,2023-04-10,506,monitor,3249,8000,4751,1,00156,India
292379,2023-04-10,506,monitor,3249,8000,4751,1,00190,India
292379,2023-04-10,504,iron,449,879,430,1,00190,India
292379,2023-04-10,503,mixer,1349,3249,1900,1,00190,India
116820,2023-04-10,504,iron,449,879,430,1,00104,India
116820,2023-04-10,503,mixer,1349,3249,1900,1,00104,India
792122,2023-04-10,503,mixer,1349,3249,1900,1,00116,India
792122,2023-04-10,504,iron,449,879,430,1,00116,India
792122,2023-04-10,505,oven,18490,24000,5510,1,00116,India
792122,2023-04-10,507,washing machine,6990,16490,9500,1,00116,India
745364,2023-04-10,507,washing machine,6990,16490,9500,1,00066,India
745364,2023-04-10,504,iron,449,879,430,1,00066,India
745364,2023-04-10,505,oven,18490,24000,5510,1,00066,India
964976,2023-04-10,506,monitor,3249,8000,4751,1,00341,India
964976,2023-04-10,507,washing machine,6990,16490,9500,1,00341,India
624181,2023-04-10,507,washing machine,6990,16490,9500,1,00351,India
624181,2023-04-10,501,iphone 15,60000,80000,20000,1,00351,India
624181,2023-04-10,502,iphone 15 pro max,100000,135000,35000,1,00351,India
911771,2023-04-10,507,washing machine,6990,16490,9500,1,00113,India
911771,2023-04-10,502,iphone 15 pro max,100000,135000,35000,1,00113,India
506602,2023-04-10,504,iron,449,879,430,1,00478,India
506602,2023-04-10,502,iphone 15 pro max,100000,135000,35000,1,00478,India
884989,2023-04-10,505,oven,18490,24000,5510,1,00125,India
884989,2023-04-10,506,monitor,3249,8000,4751,1,00125,India
884989,2023-04-10,501,iphone 15,60000,80000,20000,1,00125,India
884989,2023-04-10,503,mixer,1349,3249,1900,1,00125,India
937778,2023-04-10,503,mixer,1349,3249,1900,1,00352,India
937778,2023-04-10,502,iphone 15 pro max,100000,135000,35000,1,00352,India
937778,2023-04-10,507,washing machine,6990,16490,9500,1,00352,India
436091,2023-04-10,506,monitor,3249,8000,4751,1,00104,India
436091,2023-04-10,501,iphone 15,60000,80000,20000,1,00104,India
436091,2023-04-10,504,iron,449,879,430,1,00104,India
436091,2023-04-10,502,iphone 15 pro max,100000,135000,35000,1,00104,India
794839,2023-04-10,501,iphone 15,60000,80000,20000,1,00463,India
794839,2023-04-10,507,washing machine,6990,16490,9500,1,00463,India
541436,2023-04-10,503,mixer,1349,3249,1900,1,00419,India
531694,2023-04-10,502,iphone 15 pro max,100000,135000,35000,1,00356,India
531694,2023-04-10,505,oven,18490,24000,5510,1,00356,India
531694,2023-04-10,501,iphone 15,60000,80000,20000,1,00356,India
531694,2023-04-10,507,washing machine,6990,16490,9500,1,00356,India
117201,2023-04-10,507,washing machine,6990,16490,9500,1,00128,India
117201,2023-04-10,506,monitor,3249,8000,4751,1,00128,India
117201,2023-04-10,504,iron,449,879,430,1,00128,India
117201,2023-04-10,502,iphone 15 pro max,100000,135000,35000,1,00128,India
533407,2023-04-10,505,oven,18490,24000,5510,1,00433,India
533407,2023-04-10,506,monitor,3249,8000,4751,1,00433,India
533407,2023-04-10,503,mixer,1349,3249,1900,1,00433,India
758154,2023-04-10,501,iphone 15,60000,80000,20000,1,00151,India
758154,2023-04-10,504,iron,449,879,430,1,00151,India
758154,2023-04-10,502,iphone 15 pro max,100000,135000,35000,1,00151,India
758154,2023-04-10,503,mixer,1349,3249,1900,1,00151,India
783665,2023-04-10,502,iphone 15 pro max,100000,135000,35000,1,00176,India
783665,2023-04-10,504,iron,449,879,430,1,00176,India
682616,2023-04-10,506,monitor,3249,8000,4751,1,00454,India
682616,2023-04-10,503,mixer,1349,3249,1900,1,00454,India
682616,2023-04-10,504,iron,449,879,430,1,00454,India
682616,2023-04-10,502,iphone 15 pro max,100000,135000,35000,1,00454,India
221916,2023-04-10,502,iphone 15 pro max,100000,135000,35000,1,00033,India
221916,2023-04-10,505,oven,18490,24000,5510,1,00033,India
221916,2023-04-10,501,iphone 15,60000,80000,20000,1,00033,India
948831,2023-04-10,504,iron,449,879,430,1,00449,India
948831,2023-04-10,505,oven,18490,24000,5510,1,00449,India
948831,2023-04-10,506,monitor,3249,8000,4751,1,00449,India
929480,2023-04-10,501,iphone 15,60000,80000,20000,1,00265,India
945973,2023-04-10,502,iphone 15 pro max,100000,135000,35000,1,00368,India
945973,2023-04-10,506,monitor,3249,8000,4751,1,00368,India
235058,2023-04-10,502,iphone 15 pro max,100000,135000,35000,1,00006,India
322009,2023-04-10,505,oven,18490,24000,5510,1,00192,India
942207,2023-04-10,505,oven,18490,24000,5510,1,00255,India
942207,2023-04-10,507,washing machine,6990,16490,9500,1,00255,India
942207,2023-04-10,506,monitor,3249,8000,4751,1,00255,India
942207,2023-04-10,502,iphone 15 pro max,100000,135000,35000,1,00255,India
127399,2023-04-10,505,oven,18490,24000,5510,1,00420,India
127399,2023-04-10,507,washing machine,6990,16490,9500,1,00420,India
403462,2023-04-10,502,iphone 15 pro max,100000,135000,35000,1,00290,India
403462,2023-04-10,503,mixer,1349,3249,1900,1,00290,India
266961,2023-04-10,504,iron,449,879,430,1,00199,India
266961,2023-04-10,506,monitor,3249,8000,4751,1,00199,India
246662,2023-04-10,504,iron,449,879,430,1,00019,India
246662,2023-04-10,501,iphone 15,60000,80000,20000,1,00019,India
246662,2023-04-10,506,monitor,3249,8000,4751,1,00019,India
494039,2023-04-10,502,iphone 15 pro max,100000,135000,35000,1,00292,India
494039,2023-04-10,505,oven,18490,24000,5510,1,00292,India
494039,2023-04-10,501,iphone 15,60000,80000,20000,1,00292,India
386031,2023-04-10,503,mixer,1349,3249,1900,1,00087,India
897104,2023-04-10,502,iphone 15 pro max,100000,135000,35000,1,00134,India
897104,2023-04-10,501,iphone 15,60000,80000,20000,1,00134,India
897104,2023-04-10,505,oven,18490,24000,5510,1,00134,India
599873,2023-04-10,507,washing machine,6990,16490,9500,1,00306,India
599873,2023-04-10,505,oven,18490,24000,5510,1,00306,India
599873,2023-04-10,506,monitor,3249,8000,4751,1,00306,India
511831,2023-04-10,506,monitor,3249,8000,4751,1,00007,India
308211,2023-04-10,507,washing machine,6990,16490,9500,1,00184,India
308211,2023-04-10,503,mixer,1349,3249,1900,1,00184,India
308211,2023-04-10,506,monitor,3249,8000,4751,1,00184,India
308211,2023-04-10,504,iron,449,879,430,1,00184,India
151478,2023-04-10,507,washing machine,6990,16490,9500,1,00230,India
151478,2023-04-10,501,iphone 15,60000,80000,20000,1,00230,India
151478,2023-04-10,505,oven,18490,24000,5510,1,00230,India
341346,2023-04-10,506,monitor,3249,8000,4751,1,00145,India
341346,2023-04-10,501,iphone 15,60000,80000,20000,1,00145,India
674366,2023-04-10,503,mixer,1349,3249,1900,1,00070,India
674366,2023-04-10,507,washing machine,6990,16490,9500,1,00070,India
674366,2023-04-10,504,iron,449,879,430,1,00070,India
449995,2023-04-10,505,oven,18490,24000,5510,1,00226,India
834461,2023-04-10,506,monitor,3249,8000,4751,1,00064,India
968269,2023-04-10,501,iphone 15,60000,80000,20000,1,00415,India
773935,2023-04-10,506,monitor,3249,8000,4751,1,00199,India
773935,2023-04-10,507,washing machine,6990,16490,9500,1,00199,India
773935,2023-04-10,503,mixer,1349,3249,1900,1,00199,India
418603,2023-04-10,503,mixer,1349,3249,1900,1,00427,India
418603,2023-04-10,502,iphone 15 pro max,100000,135000,35000,1,00427,India
418603,2023-04-10,504,iron,449,879,430,1,00427,India
130540,2023-04-10,506,monitor,3249,8000,4751,1,00434,India
130540,2023-04-10,505,oven,18490,24000,5510,1,00434,India
787283,2023-04-10,505,oven,18490,24000,5510,1,00063,India
787283,2023-04-10,503,mixer,1349,3249,1900,1,00063,India
787283,2023-04-10,502,iphone 15 pro max,100000,135000,35000,1,00063,India
787283,2023-04-10,504,iron,449,879,430,1,00063,India
787283,2023-04-10,507,washing machine,6990,16490,9500,1,00063,India
346518,2023-04-10,505,oven,18490,24000,5510,1,00076,India
346518,2023-04-10,506,monitor,3249,8000,4751,1,00076,India
346518,2023-04-10,502,iphone 15 pro max,100000,135000,35000,1,00076,India
346518,2023-04-10,504,iron,449,879,430,1,00076,India
158445,2023-04-10,502,iphone 15 pro max,100000,135000,35000,1,00376,India
158445,2023-04-10,503,mixer,1349,3249,1900,1,00376,India
158445,2023-04-10,505,oven,18490,24000,5510,1,00376,India
158445,2023-04-10,506,monitor,3249,8000,4751,1,00376,India
824002,2023-04-10,504,iron,449,879,430,1,00216,India
824002,2023-04-10,503,mixer,1349,3249,1900,1,00216,India
824002,2023-04-10,505,oven,18490,24000,5510,1,00216,India
422830,2023-04-11,504,iron,449,879,430,1,00394,India
422830,2023-04-11,502,iphone 15 pro max,100000,135000,35000,1,00394,India
422830,2023-04-11,505,oven,18490,24000,5510,1,00394,India
422830,2023-04-11,506,monitor,3249,8000,4751,1,00394,India
711964,2023-04-11,505,oven,18490,24000,5510,1,00335,India
711964,2023-04-11,503,mixer,1349,3249,1900,1,00335,India
711964,2023-04-11,506,monitor,3249,8000,4751,1,00335,India
711964,2023-04-11,507,washing machine,6990,16490,9500,1,00335,India
730066,2023-04-11,502,iphone 15 pro max,100000,135000,35000,1,00084,India
730066,2023-04-11,501,iphone 15,60000,80000,20000,1,00084,India
905924,2023-04-11,506,monitor,3249,8000,4751,1,00013,India
399596,2023-04-11,504,iron,449,879,430,1,00098,India
399596,2023-04-11,503,mixer,1349,3249,1900,1,00098,India
399596,2023-04-11,507,washing machine,6990,16490,9500,1,00098,India
351416,2023-04-11,501,iphone 15,60000,80000,20000,1,00163,India
351416,2023-04-11,503,mixer,1349,3249,1900,1,00163,India
351416,2023-04-11,504,iron,449,879,430,1,00163,India
351416,2023-04-11,506,monitor,3249,8000,4751,1,00163,India
723816,2023-04-11,506,monitor,3249,8000,4751,1,00473,India
957624,2023-04-11,501,iphone 15,60000,80000,20000,1,00119,India
447729,2023-04-11,504,iron,449,879,430,1,00182,India
447729,2023-04-11,507,washing machine,6990,16490,9500,1,00182,India
447729,2023-04-11,502,iphone 15 pro max,100000,135000,35000,1,00182,India
846777,2023-04-11,505,oven,18490,24000,5510,1,00065,India
846777,2023-04-11,502,iphone 15 pro max,100000,135000,35000,1,00065,India
196453,2023-04-11,505,oven,18490,24000,5510,1,00139,India
196453,2023-04-11,507,washing machine,6990,16490,9500,1,00139,India
196453,2023-04-11,504,iron,449,879,430,1,00139,India
379410,2023-04-11,507,washing machine,6990,16490,9500,1,00128,India
379410,2023-04-11,504,iron,449,879,430,1,00128,India
379410,2023-04-11,502,iphone 15 pro max,100000,135000,35000,1,00128,India
379410,2023-04-11,505,oven,18490,24000,5510,1,00128,India
143808,2023-04-11,502,iphone 15 pro max,100000,135000,35000,1,00114,India
143808,2023-04-11,501,iphone 15,60000,80000,20000,1,00114,India
143808,2023-04-11,507,washing machine,6990,16490,9500,1,00114,India
143808,2023-04-11,504,iron,449,879,430,1,00114,India
341400,2023-04-11,503,mixer,1349,3249,1900,1,00173,India
341400,2023-04-11,507,washing machine,6990,16490,9500,1,00173,India
341400,2023-04-11,506,monitor,3249,8000,4751,1,00173,India
821579,2023-04-11,503,mixer,1349,3249,1900,1,00416,India
821579,2023-04-11,505,oven,18490,24000,5510,1,00416,India
814991,2023-04-11,506,monitor,3249,8000,4751,1,00209,India
814991,2023-04-11,504,iron,449,879,430,1,00209,India
814991,2023-04-11,502,iphone 15 pro max,100000,135000,35000,1,00209,India
272050,2023-04-11,501,iphone 15,60000,80000,20000,1,00179,India
533940,2023-04-11,507,washing machine,6990,16490,9500,1,00146,India
533940,2023-04-11,505,oven,18490,24000,5510,1,00146,India
911292,2023-04-11,507,washing machine,6990,16490,9500,1,00024,India
911292,2023-04-11,502,iphone 15 pro max,100000,135000,35000,1,00024,India
463676,2023-04-11,502,iphone 15 pro max,100000,135000,35000,1,00437,India
463676,2023-04-11,503,mixer,1349,3249,1900,1,00437,India
463676,2023-04-11,505,oven,18490,24000,5510,1,00437,India
369540,2023-04-11,501,iphone 15,60000,80000,20000,1,00319,India
103542,2023-04-11,501,iphone 15,60000,80000,20000,1,00257,India
903003,2023-04-11,502,iphone 15 pro max,100000,135000,35000,1,00103,India
903003,2023-04-11,501,iphone 15,60000,80000,20000,1,00103,India
677770,2023-04-11,505,oven,18490,24000,5510,1,00136,India
677770,2023-04-11,503,mixer,1349,3249,1900,1,00136,India
432889,2023-04-11,502,iphone 15 pro max,100000,135000,35000,1,00419,India
432889,2023-04-11,501,iphone 15,60000,80000,20000,1,00419,India
432889,2023-04-11,504,iron,449,879,430,1,00419,India
432889,2023-04-11,505,oven,18490,24000,5510,1,00419,India
432889,2023-04-11,507,washing machine,6990,16490,9500,1,00419,India
410893,2023-04-11,504,iron,449,879,430,1,00277,India
410893,2023-04-11,506,monitor,3249,8000,4751,1,00277,India
410893,2023-04-11,502,iphone 15 pro max,100000,135000,35000,1,00277,India
811695,2023-04-11,503,mixer,1349,3249,1900,1,00279,India
811695,2023-04-11,506,monitor,3249,8000,4751,1,00279,India
811695,2023-04-11,502,iphone 15 pro max,100000,135000,35000,1,00279,India
906857,2023-04-11,502,iphone 15 pro max,100000,135000,35000,1,00333,India
906857,2023-04-11,504,iron,449,879,430,1,00333,India
505025,2023-04-11,501,iphone 15,60000,80000,20000,1,00446,India
505025,2023-04-11,503,mixer,1349,3249,1900,1,00446,India
862916,2023-04-11,505,oven,18490,24000,5510,1,00279,India
862916,2023-04-11,503,mixer,1349,3249,1900,1,00279,India
438818,2023-04-11,505,oven,18490,24000,5510,1,00254,India
438818,2023-04-11,506,monitor,3249,8000,4751,1,00254,India
438818,2023-04-11,501,iphone 15,60000,80000,20000,1,00254,India
377137,2023-04-11,504,iron,449,879,430,1,00255,India
377137,2023-04-11,502,iphone 15 pro max,100000,135000,35000,1,00255,India
377137,2023-04-11,501,iphone 15,60000,80000,20000,1,00255,India
951305,2023-04-11,506,monitor,3249,8000,4751,1,00233,India
951305,2023-04-11,502,iphone 15 pro max,100000,135000,35000,1,00233,India
951305,2023-04-11,501,iphone 15,60000,80000,20000,1,00233,India
778264,2023-04-11,505,oven,18490,24000,5510,1,00293,India
778264,2023-04-11,507,washing machine,6990,16490,9500,1,00293,India
778264,2023-04-11,501,iphone 15,60000,80000,20000,1,00293,India
778264,2023-04-11,504,iron,449,879,430,1,00293,India
778264,2023-04-11,503,mixer,1349,3249,1900,1,00293,India
995482,2023-04-11,503,mixer,1349,3249,1900,1,00450,India
995482,2023-04-11,507,washing machine,6990,16490,9500,1,00450,India
995482,2023-04-11,506,monitor,3249,8000,4751,1,00450,India
624655,2023-04-11,507,washing machine,6990,16490,9500,1,00441,India
522141,2023-04-11,501,iphone 15,60000,80000,20000,1,00046,India
522141,2023-04-11,504,iron,449,879,430,1,00046,India
522141,2023-04-11,503,mixer,1349,3249,1900,1,00046,India
784448,2023-04-11,501,iphone 15,60000,80000,20000,1,00400,India
211636,2023-04-11,502,iphone 15 pro max,100000,135000,35000,1,00171,India
211636,2023-04-11,501,iphone 15,60000,80000,20000,1,00171,India
667030,2023-04-11,505,oven,18490,24000,5510,1,00380,India
569797,2023-04-11,501,iphone 15,60000,80000,20000,1,00440,India
569797,2023-04-11,504,iron,449,879,430,1,00440,India
904526,2023-04-11,502,iphone 15 pro max,100000,135000,35000,1,00244,India
534155,2023-04-11,506,monitor,3249,8000,4751,1,00212,India
534155,2023-04-11,505,oven,18490,24000,5510,1,00212,India
534155,2023-04-11,504,iron,449,879,430,1,00212,India
922021,2023-04-11,502,iphone 15 pro max,100000,135000,35000,1,00105,India
215091,2023-04-11,501,iphone 15,60000,80000,20000,1,00139,India
215091,2023-04-11,507,washing machine,6990,16490,9500,1,00139,India
215091,2023-04-11,502,iphone 15 pro max,100000,135000,35000,1,00139,India
215091,2023-04-11,506,monitor,3249,8000,4751,1,00139,India
211213,2023-04-11,504,iron,449,879,430,1,00252,India
211213,2023-04-11,507,washing machine,6990,16490,9500,1,00252,India
211213,2023-04-11,502,iphone 15 pro max,100000,135000,35000,1,00252,India
211213,2023-04-11,501,iphone 15,60000,80000,20000,1,00252,India
246828,2023-04-11,506,monitor,3249,8000,4751,1,00114,India
657309,2023-04-11,504,iron,449,879,430,1,00066,India
657309,2023-04-11,503,mixer,1349,3249,1900,1,00066,India
746814,2023-04-11,504,iron,449,879,430,1,00327,India
746814,2023-04-11,506,monitor,3249,8000,4751,1,00327,India
746814,2023-04-11,507,washing machine,6990,16490,9500,1,00327,India
746814,2023-04-11,503,mixer,1349,3249,1900,1,00327,India
798605,2023-04-11,505,oven,18490,24000,5510,1,00071,India
798605,2023-04-11,506,monitor,3249,8000,4751,1,00071,India
798605,2023-04-11,503,mixer,1349,3249,1900,1,00071,India
845909,2023-04-11,503,mixer,1349,3249,1900,1,00118,India
601915,2023-04-11,507,washing machine,6990,16490,9500,1,00242,India
601915,2023-04-11,504,iron,449,879,430,1,00242,India
301382,2023-04-11,507,washing machine,6990,16490,9500,1,00085,India
301382,2023-04-11,503,mixer,1349,3249,1900,1,00085,India
301382,2023-04-11,502,iphone 15 pro max,100000,135000,35000,1,00085,India
301382,2023-04-11,506,monitor,3249,8000,4751,1,00085,India
301382,2023-04-11,501,iphone 15,60000,80000,20000,1,00085,India
460975,2023-04-11,501,iphone 15,60000,80000,20000,1,00133,India
460975,2023-04-11,507,washing machine,6990,16490,9500,1,00133,India
460975,2023-04-11,503,mixer,1349,3249,1900,1,00133,India
460975,2023-04-11,504,iron,449,879,430,1,00133,India
500153,2023-04-11,503,mixer,1349,3249,1900,1,00254,India
441160,2023-04-11,503,mixer,1349,3249,1900,1,00122,India
441160,2023-04-11,504,iron,449,879,430,1,00122,India
481928,2023-04-11,507,washing machine,6990,16490,9500,1,00267,India
481928,2023-04-11,504,iron,449,879,430,1,00267,India
481928,2023-04-11,505,oven,18490,24000,5510,1,00267,India
917313,2023-04-11,503,mixer,1349,3249,1900,1,00116,India
917313,2023-04-11,502,iphone 15 pro max,100000,135000,35000,1,00116,India
800164,2023-04-11,501,iphone 15,60000,80000,20000,1,00232,India
800164,2023-04-11,503,mixer,1349,3249,1900,1,00232,India
800164,2023-04-11,505,oven,18490,24000,5510,1,00232,India
615187,2023-04-11,506,monitor,3249,8000,4751,1,00182,India
762971,2023-04-11,504,iron,449,879,430,1,00282,India
762971,2023-04-11,505,oven,18490,24000,5510,1,00282,India
762971,2023-04-11,503,mixer,1349,3249,1900,1,00282,India
307900,2023-04-11,506,monitor,3249,8000,4751,1,00272,India
307900,2023-04-11,503,mixer,1349,3249,1900,1,00272,India
307900,2023-04-11,507,washing machine,6990,16490,9500,1,00272,India
597691,2023-04-11,506,monitor,3249,8000,4751,1,00349,India
597691,2023-04-11,501,iphone 15,60000,80000,20000,1,00349,India
597691,2023-04-11,505,oven,18490,24000,5510,1,00349,India
815156,2023-04-11,507,washing machine,6990,16490,9500,1,00262,India
534037,2023-04-11,504,iron,449,879,430,1,00246,India
534037,2023-04-11,503,mixer,1349,3249,1900,1,00246,India
534037,2023-04-11,505,oven,18490,24000,5510,1,00246,India
106208,2023-04-11,502,iphone 15 pro max,100000,135000,35000,1,00070,India
106208,2023-04-11,503,mixer,1349,3249,1900,1,00070,India
106208,2023-04-11,501,iphone 15,60000,80000,20000,1,00070,India
123111,2023-04-11,507,washing machine,6990,16490,9500,1,00021,India
123111,2023-04-11,506,monitor,3249,8000,4751,1,00021,India
123111,2023-04-11,503,mixer,1349,3249,1900,1,00021,India
919147,2023-04-11,505,oven,18490,24000,5510,1,00138,India
919147,2023-04-11,501,iphone 15,60000,80000,20000,1,00138,India
619231,2023-04-11,507,washing machine,6990,16490,9500,1,00163,India
619231,2023-04-11,503,mixer,1349,3249,1900,1,00163,India
619231,2023-04-11,504,iron,449,879,430,1,00163,India
870620,2023-04-11,502,iphone 15 pro max,100000,135000,35000,1,00310,India
125292,2023-04-11,507,washing machine,6990,16490,9500,1,00482,India
125292,2023-04-11,503,mixer,1349,3249,1900,1,00482,India
125292,2023-04-11,502,iphone 15 pro max,100000,135000,35000,1,00482,India
122201,2023-04-12,504,iron,449,879,430,1,00411,India
122201,2023-04-12,503,mixer,1349,3249,1900,1,00411,India
937602,2023-04-12,506,monitor,3249,8000,4751,1,00216,India
937602,2023-04-12,502,iphone 15 pro max,100000,135000,35000,1,00216,India
937602,2023-04-12,504,iron,449,879,430,1,00216,India
253764,2023-04-12,504,iron,449,879,430,1,00137,India
253764,2023-04-12,502,iphone 15 pro max,100000,135000,35000,1,00137,India
253764,2023-04-12,501,iphone 15,60000,80000,20000,1,00137,India
230836,2023-04-12,503,mixer,1349,3249,1900,1,00159,India
230836,2023-04-12,504,iron,449,879,430,1,00159,India
366361,2023-04-12,506,monitor,3249,8000,4751,1,00454,India
366361,2023-04-12,504,iron,449,879,430,1,00454,India
366361,2023-04-12,507,washing machine,6990,16490,9500,1,00454,India
366361,2023-04-12,501,iphone 15,60000,80000,20000,1,00454,India
553755,2023-04-12,506,monitor,3249,8000,4751,1,00179,India
341539,2023-04-12,507,washing machine,6990,16490,9500,1,00009,India
121354,2023-04-12,501,iphone 15,60000,80000,20000,1,00102,India
121354,2023-04-12,505,oven,18490,24000,5510,1,00102,India
121354,2023-04-12,507,washing machine,6990,16490,9500,1,00102,India
664660,2023-04-12,507,washing machine,6990,16490,9500,1,00197,India
664660,2023-04-12,505,oven,18490,24000,5510,1,00197,India
750490,2023-04-12,506,monitor,3249,8000,4751,1,00424,India
750490,2023-04-12,505,oven,18490,24000,5510,1,00424,India
750490,2023-04-12,507,washing machine,6990,16490,9500,1,00424,India
578093,2023-04-12,506,monitor,3249,8000,4751,1,00356,India
578093,2023-04-12,501,iphone 15,60000,80000,20000,1,00356,India
578093,2023-04-12,507,washing machine,6990,16490,9500,1,00356,India
578093,2023-04-12,504,iron,449,879,430,1,00356,India
637584,2023-04-12,505,oven,18490,24000,5510,1,00394,India
398998,2023-04-12,504,iron,449,879,430,1,00414,India
398998,2023-04-12,506,monitor,3249,8000,4751,1,00414,India
879868,2023-04-12,507,washing machine,6990,16490,9500,1,00003,India
879868,2023-04-12,506,monitor,3249,8000,4751,1,00003,India
879868,2023-04-12,504,iron,449,879,430,1,00003,India
879868,2023-04-12,505,oven,18490,24000,5510,1,00003,India
953306,2023-04-12,505,oven,18490,24000,5510,1,00033,India
953306,2023-04-12,507,washing machine,6990,16490,9500,1,00033,India
953306,2023-04-12,502,iphone 15 pro max,100000,135000,35000,1,00033,India
953306,2023-04-12,504,iron,449,879,430,1,00033,India
442954,2023-04-12,507,washing machine,6990,16490,9500,1,00176,India
795272,2023-04-12,502,iphone 15 pro max,100000,135000,35000,1,00429,India
467209,2023-04-12,501,iphone 15,60000,80000,20000,1,00428,India
467209,2023-04-12,504,iron,449,879,430,1,00428,India
467209,2023-04-12,502,iphone 15 pro max,100000,135000,35000,1,00428,India
670976,2023-04-12,507,washing machine,6990,16490,9500,1,00028,India
670976,2023-04-12,501,iphone 15,60000,80000,20000,1,00028,India
670976,2023-04-12,502,iphone 15 pro max,100000,135000,35000,1,00028,India
822067,2023-04-12,503,mixer,1349,3249,1900,1,00289,India
822067,2023-04-12,501,iphone 15,60000,80000,20000,1,00289,India
861594,2023-04-12,503,mixer,1349,3249,1900,1,00465,India
861594,2023-04-12,504,iron,449,879,430,1,00465,India
861594,2023-04-12,501,iphone 15,60000,80000,20000,1,00465,India
468093,2023-04-12,501,iphone 15,60000,80000,20000,1,00103,India
468093,2023-04-12,502,iphone 15 pro max,100000,135000,35000,1,00103,India
468093,2023-04-12,505,oven,18490,24000,5510,1,00103,India
980891,2023-04-12,507,washing machine,6990,16490,9500,1,00104,India
980891,2023-04-12,506,monitor,3249,8000,4751,1,00104,India
980891,2023-04-12,503,mixer,1349,3249,1900,1,00104,India
544364,2023-04-12,505,oven,18490,24000,5510,1,00007,India
544364,2023-04-12,506,monitor,3249,8000,4751,1,00007,India
544364,2023-04-12,501,iphone 15,60000,80000,20000,1,00007,India
203583,2023-04-12,505,oven,18490,24000,5510,1,00130,India
203583,2023-04-12,503,mixer,1349,3249,1900,1,00130,India
203583,2023-04-12,506,monitor,3249,8000,4751,1,00130,India
203583,2023-04-12,501,iphone 15,60000,80000,20000,1,00130,India
909283,2023-04-12,503,mixer,1349,3249,1900,1,00238,India
909283,2023-04-12,506,monitor,3249,8000,4751,1,00238,India
909283,2023-04-12,507,washing machine,6990,16490,9500,1,00238,India
221625,2023-04-12,505,oven,18490,24000,5510,1,00474,India
221625,2023-04-12,502,iphone 15 pro max,100000,135000,35000,1,00474,India
221625,2023-04-12,506,monitor,3249,8000,4751,1,00474,India
159038,2023-04-12,502,iphone 15 pro max,100000,135000,35000,1,00378,India
159038,2023-04-12,504,iron,449,879,430,1,00378,India
159038,2023-04-12,506,monitor,3249,8000,4751,1,00378,India
949477,2023-04-12,503,mixer,1349,3249,1900,1,00467,India
949477,2023-04-12,501,iphone 15,60000,80000,20000,1,00467,India
949477,2023-04-12,505,oven,18490,24000,5510,1,00467,India
338832,2023-04-12,505,oven,18490,24000,5510,1,00150,India
338832,2023-04-12,507,washing machine,6990,16490,9500,1,00150,India
338832,2023-04-12,503,mixer,1349,3249,1900,1,00150,India
338832,2023-04-12,506,monitor,3249,8000,4751,1,00150,India
959593,2023-04-12,507,washing machine,6990,16490,9500,1,00187,India
959593,2023-04-12,503,mixer,1349,3249,1900,1,00187,India
168635,2023-04-12,505,oven,18490,24000,5510,1,00113,India
168635,2023-04-12,501,iphone 15,60000,80000,20000,1,00113,India
400398,2023-04-12,504,iron,449,879,430,1,00450,India
400398,2023-04-12,505,oven,18490,24000,5510,1,00450,India
873966,2023-04-12,503,mixer,1349,3249,1900,1,00341,India
873966,2023-04-12,505,oven,18490,24000,5510,1,00341,India
873966,2023-04-12,504,iron,449,879,430,1,00341,India
667629,2023-04-12,504,iron,449,879,430,1,00159,India
667629,2023-04-12,502,iphone 15 pro max,100000,135000,35000,1,00159,India
130887,2023-04-12,505,oven,18490,24000,5510,1,00459,India
130887,2023-04-12,501,iphone 15,60000,80000,20000,1,00459,India
130887,2023-04-12,503,mixer,1349,3249,1900,1,00459,India
130887,2023-04-12,507,washing machine,6990,16490,9500,1,00459,India
968774,2023-04-12,507,washing machine,6990,16490,9500,1,00359,India
210479,2023-04-12,506,monitor,3249,8000,4751,1,00265,India
210479,2023-04-12,505,oven,18490,24000,5510,1,00265,India
788284,2023-04-12,502,iphone 15 pro max,100000,135000,35000,1,00159,India
788284,2023-04-12,506,monitor,3249,8000,4751,1,00159,India
788284,2023-04-12,504,iron,449,879,430,1,00159,India
788284,2023-04-12,505,oven,18490,24000,5510,1,00159,India
310674,2023-04-12,506,monitor,3249,8000,4751,1,00251,India
212148,2023-04-12,506,monitor,3249,8000,4751,1,00144,India
212148,2023-04-12,504,iron,449,879,430,1,00144,India
212148,2023-04-12,505,oven,18490,24000,5510,1,00144,India
212148,2023-04-12,502,iphone 15 pro max,100000,135000,35000,1,00144,India
802243,2023-04-12,502,iphone 15 pro max,100000,135000,35000,1,00163,India
802243,2023-04-12,506,monitor,3249,8000,4751,1,00163,India
802243,2023-04-12,507,washing machine,6990,16490,9500,1,00163,India
802243,2023-04-12,501,iphone 15,60000,80000,20000,1,00163,India
430813,2023-04-12,502,iphone 15 pro max,100000,135000,35000,1,00088,India
444824,2023-04-12,506,monitor,3249,8000,4751,1,00424,India
444824,2023-04-12,502,iphone 15 pro max,100000,135000,35000,1,00424,India
359156,2023-04-12,506,monitor,3249,8000,4751,1,00369,India
359156,2023-04-12,505,oven,18490,24000,5510,1,00369,India
359156,2023-04-12,503,mixer,1349,3249,1900,1,00369,India
545867,2023-04-12,501,iphone 15,60000,80000,20000,1,00075,India
545867,2023-04-12,502,iphone 15 pro max,100000,135000,35000,1,00075,India
545867,2023-04-12,507,washing machine,6990,16490,9500,1,00075,India
545867,2023-04-12,503,mixer,1349,3249,1900,1,00075,India
645327,2023-04-12,503,mixer,1349,3249,1900,1,00399,India
812417,2023-04-12,506,monitor,3249,8000,4751,1,00384,India
827942,2023-04-12,501,iphone 15,60000,80000,20000,1,00038,India
827942,2023-04-12,507,washing machine,6990,16490,9500,1,00038,India
827942,2023-04-12,504,iron,449,879,430,1,00038,India
827942,2023-04-12,506,monitor,3249,8000,4751,1,00038,India
109196,2023-04-12,502,iphone 15 pro max,100000,135000,35000,1,00180,India
109196,2023-04-12,507,washing machine,6990,16490,9500,1,00180,India
368673,2023-04-12,504,iron,449,879,430,1,00305,India
801369,2023-04-12,507,washing machine,6990,16490,9500,1,00036,India
801369,2023-04-12,503,mixer,1349,3249,1900,1,00036,India
801369,2023-04-12,501,iphone 15,60000,80000,20000,1,00036,India
801369,2023-04-12,502,iphone 15 pro max,100000,135000,35000,1,00036,India
810820,2023-04-12,506,monitor,3249,8000,4751,1,00165,India
810820,2023-04-12,504,iron,449,879,430,1,00165,India
736914,2023-04-12,505,oven,18490,24000,5510,1,00204,India
736914,2023-04-12,503,mixer,1349,3249,1900,1,00204,India
411908,2023-04-12,505,oven,18490,24000,5510,1,00066,India
411908,2023-04-12,501,iphone 15,60000,80000,20000,1,00066,India
682907,2023-04-12,504,iron,449,879,430,1,00212,India
682907,2023-04-12,501,iphone 15,60000,80000,20000,1,00212,India
682907,2023-04-12,507,washing machine,6990,16490,9500,1,00212,India
513046,2023-04-12,503,mixer,1349,3249,1900,1,00489,India
342241,2023-04-12,501,iphone 15,60000,80000,20000,1,00222,India
342241,2023-04-12,507,washing machine,6990,16490,9500,1,00222,India
342241,2023-04-12,504,iron,449,879,430,1,00222,India
342241,2023-04-12,505,oven,18490,24000,5510,1,00222,India
335869,2023-04-12,505,oven,18490,24000,5510,1,00125,India
146106,2023-04-12,504,iron,449,879,430,1,00134,India
146106,2023-04-12,505,oven,18490,24000,5510,1,00134,India
146106,2023-04-12,507,washing machine,6990,16490,9500,1,00134,India
990128,2023-04-12,505,oven,18490,24000,5510,1,00226,India
990128,2023-04-12,503,mixer,1349,3249,1900,1,00226,India
990128,2023-04-12,504,iron,449,879,430,1,00226,India
859990,2023-04-13,506,monitor,3249,8000,4751,1,00033,India
197206,2023-04-13,507,washing machine,6990,16490,9500,1,00324,India
424796,2023-04-13,506,monitor,3249,8000,4751,1,00268,India
837015,2023-04-13,501,iphone 15,60000,80000,20000,1,00182,India
837015,2023-04-13,503,mixer,1349,3249,1900,1,00182,India
837015,2023-04-13,502,iphone 15 pro max,100000,135000,35000,1,00182,India
126704,2023-04-13,505,oven,18490,24000,5510,1,00480,India
126704,2023-04-13,504,iron,449,879,430,1,00480,India
126704,2023-04-13,502,iphone 15 pro max,100000,135000,35000,1,00480,India
304184,2023-04-13,506,monitor,3249,8000,4751,1,00200,India
499772,2023-04-13,505,oven,18490,24000,5510,1,00101,India
499772,2023-04-13,504,iron,449,879,430,1,00101,India
499772,2023-04-13,506,monitor,3249,8000,4751,1,00101,India
662177,2023-04-13,504,iron,449,879,430,1,00460,India
662177,2023-04-13,506,monitor,3249,8000,4751,1,00460,India
662177,2023-04-13,507,washing machine,6990,16490,9500,1,00460,India
662177,2023-04-13,502,iphone 15 pro max,100000,135000,35000,1,00460,India
285897,2023-04-13,501,iphone 15,60000,80000,20000,1,00305,India
285897,2023-04-13,502,iphone 15 pro max,100000,135000,35000,1,00305,India
250190,2023-04-13,504,iron,449,879,430,1,00123,India
250190,2023-04-13,501,iphone 15,60000,80000,20000,1,00123,India
250190,2023-04-13,505,oven,18490,24000,5510,1,00123,India
708238,2023-04-13,503,mixer,1349,3249,1900,1,00230,India
708238,2023-04-13,504,iron,449,879,430,1,00230,India
708238,2023-04-13,507,washing machine,6990,16490,9500,1,00230,India
597676,2023-04-13,503,mixer,1349,3249,1900,1,00025,India
597676,2023-04-13,505,oven,18490,24000,5510,1,00025,India
597676,2023-04-13,507,washing machine,6990,16490,9500,1,00025,India
571438,2023-04-13,502,iphone 15 pro max,100000,135000,35000,1,00126,India
504153,2023-04-13,506,monitor,3249,8000,4751,1,00100,India
257457,2023-04-13,503,mixer,1349,3249,1900,1,00292,India
286497,2023-04-13,506,monitor,3249,8000,4751,1,00022,India
286497,2023-04-13,504,iron,449,879,430,1,00022,India
286497,2023-04-13,505,oven,18490,24000,5510,1,00022,India
514495,2023-04-13,507,washing machine,6990,16490,9500,1,00101,India
514495,2023-04-13,502,iphone 15 pro max,100000,135000,35000,1,00101,India
514495,2023-04-13,501,iphone 15,60000,80000,20000,1,00101,India
514495,2023-04-13,504,iron,449,879,430,1,00101,India
587577,2023-04-13,507,washing machine,6990,16490,9500,1,00399,India
587577,2023-04-13,505,oven,18490,24000,5510,1,00399,India
587577,2023-04-13,501,iphone 15,60000,80000,20000,1,00399,India
659778,2023-04-13,506,monitor,3249,8000,4751,1,00226,India
659778,2023-04-13,502,iphone 15 pro max,100000,135000,35000,1,00226,India
243905,2023-04-13,507,washing machine,6990,16490,9500,1,00421,India
243905,2023-04-13,505,oven,18490,24000,5510,1,00421,India
169979,2023-04-13,503,mixer,1349,3249,1900,1,00276,India
169979,2023-04-13,504,iron,449,879,430,1,00276,India
169979,2023-04-13,502,iphone 15 pro max,100000,135000,35000,1,00276,India
169979,2023-04-13,507,washing machine,6990,16490,9500,1,00276,India
169979,2023-04-13,506,monitor,3249,8000,4751,1,00276,India
534091,2023-04-13,502,iphone 15 pro max,100000,135000,35000,1,00219,India
534091,2023-04-13,504,iron,449,879,430,1,00219,India
424599,2023-04-13,505,oven,18490,24000,5510,1,00328,India
424599,2023-04-13,506,monitor,3249,8000,4751,1,00328,India
424599,2023-04-13,502,iphone 15 pro max,100000,135000,35000,1,00328,India
554273,2023-04-13,502,iphone 15 pro max,100000,135000,35000,1,00053,India
554273,2023-04-13,507,washing machine,6990,16490,9500,1,00053,India
371026,2023-04-13,504,iron,449,879,430,1,00419,India
371026,2023-04-13,507,washing machine,6990,16490,9500,1,00419,India
371026,2023-04-13,502,iphone 15 pro max,100000,135000,35000,1,00419,India
131808,2023-04-13,503,mixer,1349,3249,1900,1,00367,India
779127,2023-04-13,503,mixer,1349,3249,1900,1,00481,India
779127,2023-04-13,505,oven,18490,24000,5510,1,00481,India
383229,2023-04-13,504,iron,449,879,430,1,00164,India
383229,2023-04-13,501,iphone 15,60000,80000,20000,1,00164,India
635382,2023-04-13,507,washing machine,6990,16490,9500,1,00460,India
966750,2023-04-13,501,iphone 15,60000,80000,20000,1,00306,India
966750,2023-04-13,505,oven,18490,24000,5510,1,00306,India
130459,2023-04-13,502,iphone 15 pro max,100000,135000,35000,1,00109,India
130459,2023-04-13,501,iphone 15,60000,80000,20000,1,00109,India
130459,2023-04-13,503,mixer,1349,3249,1900,1,00109,India
130459,2023-04-13,505,oven,18490,24000,5510,1,00109,India
590304,2023-04-13,501,iphone 15,60000,80000,20000,1,00480,India
590304,2023-04-13,507,washing machine,6990,16490,9500,1,00480,India
590304,2023-04-13,506,monitor,3249,8000,4751,1,00480,India
376269,2023-04-13,505,oven,18490,24000,5510,1,00396,India
266335,2023-04-13,503,mixer,1349,3249,1900,1,00315,India
266335,2023-04-13,504,iron,449,879,430,1,00315,India
882291,2023-04-13,501,iphone 15,60000,80000,20000,1,00245,India
882291,2023-04-13,504,iron,449,879,430,1,00245,India
882291,2023-04-13,502,iphone 15 pro max,100000,135000,35000,1,00245,India
742750,2023-04-13,504,iron,449,879,430,1,00027,India
742750,2023-04-13,502,iphone 15 pro max,100000,135000,35000,1,00027,India
419966,2023-04-13,503,mixer,1349,3249,1900,1,00037,India
419966,2023-04-13,505,oven,18490,24000,5510,1,00037,India
541344,2023-04-13,504,iron,449,879,430,1,00005,India
541344,2023-04-13,505,oven,18490,24000,5510,1,00005,India
410967,2023-04-13,502,iphone 15 pro max,100000,135000,35000,1,00046,India
410967,2023-04-13,501,iphone 15,60000,80000,20000,1,00046,India
410967,2023-04-13,505,oven,18490,24000,5510,1,00046,India
410967,2023-04-13,503,mixer,1349,3249,1900,1,00046,India
397308,2023-04-13,503,mixer,1349,3249,1900,1,00177,India
397308,2023-04-13,505,oven,18490,24000,5510,1,00177,India
397308,2023-04-13,502,iphone 15 pro max,100000,135000,35000,1,00177,India
229323,2023-04-13,507,washing machine,6990,16490,9500,1,00305,India
229323,2023-04-13,506,monitor,3249,8000,4751,1,00305,India
229323,2023-04-13,501,iphone 15,60000,80000,20000,1,00305,India
666635,2023-04-13,507,washing machine,6990,16490,9500,1,00455,India
666635,2023-04-13,502,iphone 15 pro max,100000,135000,35000,1,00455,India
666635,2023-04-13,503,mixer,1349,3249,1900,1,00455,India
144357,2023-04-13,501,iphone 15,60000,80000,20000,1,00221,India
144357,2023-04-13,507,washing machine,6990,16490,9500,1,00221,India
214398,2023-04-13,501,iphone 15,60000,80000,20000,1,00057,India
214398,2023-04-13,507,washing machine,6990,16490,9500,1,00057,India
214398,2023-04-13,502,iphone 15 pro max,100000,135000,35000,1,00057,India
987010,2023-04-13,504,iron,449,879,430,1,00056,India
987010,2023-04-13,505,oven,18490,24000,5510,1,00056,India
987010,2023-04-13,501,iphone 15,60000,80000,20000,1,00056,India
987010,2023-04-13,506,monitor,3249,8000,4751,1,00056,India
767459,2023-04-13,504,iron,449,879,430,1,00343,India
767459,2023-04-13,505,oven,18490,24000,5510,1,00343,India
517412,2023-04-13,507,washing machine,6990,16490,9500,1,00346,India
262971,2023-04-13,502,iphone 15 pro max,100000,135000,35000,1,00057,India
262971,2023-04-13,507,washing machine,6990,16490,9500,1,00057,India
262971,2023-04-13,501,iphone 15,60000,80000,20000,1,00057,India
262971,2023-04-13,503,mixer,1349,3249,1900,1,00057,India
951201,2023-04-13,502,iphone 15 pro max,100000,135000,35000,1,00371,India
951201,2023-04-13,501,iphone 15,60000,80000,20000,1,00371,India
315263,2023-04-13,505,oven,18490,24000,5510,1,00273,India
953541,2023-04-13,507,washing machine,6990,16490,9500,1,00247,India
953541,2023-04-13,505,oven,18490,24000,5510,1,00247,India
953541,2023-04-13,502,iphone 15 pro max,100000,135000,35000,1,00247,India
756519,2023-04-13,502,iphone 15 pro max,100000,135000,35000,1,00228,India
756519,2023-04-13,504,iron,449,879,430,1,00228,India
640057,2023-04-13,506,monitor,3249,8000,4751,1,00229,India
443113,2023-04-13,505,oven,18490,24000,5510,1,00431,India
443113,2023-04-13,507,washing machine,6990,16490,9500,1,00431,India
262349,2023-04-13,503,mixer,1349,3249,1900,1,00027,India
262349,2023-04-13,506,monitor,3249,8000,4751,1,00027,India
917929,2023-04-13,507,washing machine,6990,16490,9500,1,00084,India
917929,2023-04-13,504,iron,449,879,430,1,00084,India
917929,2023-04-13,501,iphone 15,60000,80000,20000,1,00084,India
439663,2023-04-13,501,iphone 15,60000,80000,20000,1,00234,India
439663,2023-04-13,504,iron,449,879,430,1,00234,India
439663,2023-04-13,503,mixer,1349,3249,1900,1,00234,India
302742,2023-04-13,502,iphone 15 pro max,100000,135000,35000,1,00077,India
302742,2023-04-13,504,iron,449,879,430,1,00077,India
302742,2023-04-13,503,mixer,1349,3249,1900,1,00077,India
599734,2023-04-13,506,monitor,3249,8000,4751,1,00181,India
599734,2023-04-13,502,iphone 15 pro max,100000,135000,35000,1,00181,India
599734,2023-04-13,507,washing machine,6990,16490,9500,1,00181,India
599734,2023-04-13,503,mixer,1349,3249,1900,1,00181,India
510555,2023-04-13,504,iron,449,879,430,1,00284,India
510555,2023-04-13,505,oven,18490,24000,5510,1,00284,India
510555,2023-04-13,503,mixer,1349,3249,1900,1,00284,India
510555,2023-04-13,502,iphone 15 pro max,100000,135000,35000,1,00284,India
323829,2023-04-13,503,mixer,1349,3249,1900,1,00355,India
120089,2023-04-13,503,mixer,1349,3249,1900,1,00154,India
120089,2023-04-13,506,monitor,3249,8000,4751,1,00154,India
716501,2023-04-13,502,iphone 15 pro max,100000,135000,35000,1,00061,India
716501,2023-04-13,504,iron,449,879,430,1,00061,India
716501,2023-04-13,501,iphone 15,60000,80000,20000,1,00061,India
716501,2023-04-13,503,mixer,1349,3249,1900,1,00061,India
646699,2023-04-13,506,monitor,3249,8000,4751,1,00390,India
646699,2023-04-13,501,iphone 15,60000,80000,20000,1,00390,India
362586,2023-04-13,507,washing machine,6990,16490,9500,1,00142,India
362586,2023-04-13,502,iphone 15 pro max,100000,135000,35000,1,00142,India
823575,2023-04-13,505,oven,18490,24000,5510,1,00127,India
823575,2023-04-13,503,mixer,1349,3249,1900,1,00127,India
836342,2023-04-13,506,monitor,3249,8000,4751,1,00495,India
836342,2023-04-13,505,oven,18490,24000,5510,1,00495,India
836342,2023-04-13,507,washing machine,6990,16490,9500,1,00495,India
836342,2023-04-13,502,iphone 15 pro max,100000,135000,35000,1,00495,India
387360,2023-04-13,501,iphone 15,60000,80000,20000,1,00288,India
387360,2023-04-13,507,washing machine,6990,16490,9500,1,00288,India
387360,2023-04-13,502,iphone 15 pro max,100000,135000,35000,1,00288,India
598525,2023-04-13,503,mixer,1349,3249,1900,1,00202,India
505217,2023-04-13,506,monitor,3249,8000,4751,1,00284,India
505217,2023-04-13,501,iphone 15,60000,80000,20000,1,00284,India
454085,2023-04-13,505,oven,18490,24000,5510,1,00467,India
454085,2023-04-13,506,monitor,3249,8000,4751,1,00467,India
929229,2023-04-13,502,iphone 15 pro max,100000,135000,35000,1,00066,India
929229,2023-04-13,501,iphone 15,60000,80000,20000,1,00066,India
929229,2023-04-13,507,washing machine,6990,16490,9500,1,00066,India
738809,2023-04-13,507,washing machine,6990,16490,9500,1,00399,India
289515,2023-04-13,505,oven,18490,24000,5510,1,00490,India
289515,2023-04-13,507,washing machine,6990,16490,9500,1,00490,India
289515,2023-04-13,504,iron,449,879,430,1,00490,India
878721,2023-04-13,504,iron,449,879,430,1,00185,India
746455,2023-04-13,506,monitor,3249,8000,4751,1,00475,India
681943,2023-04-13,505,oven,18490,24000,5510,1,00122,India
360288,2023-04-13,507,washing machine,6990,16490,9500,1,00480,India
360288,2023-04-13,504,iron,449,879,430,1,00480,India
360288,2023-04-13,502,iphone 15 pro max,100000,135000,35000,1,00480,India
360288,2023-04-13,505,oven,18490,24000,5510,1,00480,India
267185,2023-04-13,507,washing machine,6990,16490,9500,1,00483,India
267185,2023-04-13,503,mixer,1349,3249,1900,1,00483,India
547451,2023-04-14,504,iron,449,879,430,1,00369,India
547451,2023-04-14,506,monitor,3249,8000,4751,1,00369,India
547451,2023-04-14,501,iphone 15,60000,80000,20000,1,00369,India
625643,2023-04-14,507,washing machine,6990,16490,9500,1,00187,India
625643,2023-04-14,505,oven,18490,24000,5510,1,00187,India
877669,2023-04-14,502,iphone 15 pro max,100000,135000,35000,1,00159,India
747924,2023-04-14,504,iron,449,879,430,1,00035,India
747924,2023-04-14,505,oven,18490,24000,5510,1,00035,India
576146,2023-04-14,504,iron,449,879,430,1,00380,India
576146,2023-04-14,505,oven,18490,24000,5510,1,00380,India
432888,2023-04-14,501,iphone 15,60000,80000,20000,1,00416,India
432888,2023-04-14,502,iphone 15 pro max,100000,135000,35000,1,00416,India
731607,2023-04-14,506,monitor,3249,8000,4751,1,00256,India
731607,2023-04-14,503,mixer,1349,3249,1900,1,00256,India
731607,2023-04-14,502,iphone 15 pro max,100000,135000,35000,1,00256,India
980010,2023-04-14,502,iphone 15 pro max,100000,135000,35000,1,00136,India
951324,2023-04-14,504,iron,449,879,430,1,00173,India
993365,2023-04-14,506,monitor,3249,8000,4751,1,00471,India
993365,2023-04-14,501,iphone 15,60000,80000,20000,1,00471,India
732594,2023-04-14,503,mixer,1349,3249,1900,1,00162,India
732594,2023-04-14,507,washing machine,6990,16490,9500,1,00162,India
732594,2023-04-14,502,iphone 15 pro max,100000,135000,35000,1,00162,India
162131,2023-04-14,502,iphone 15 pro max,100000,135000,35000,1,00034,India
508347,2023-04-14,507,washing machine,6990,16490,9500,1,00112,India
845428,2023-04-14,501,iphone 15,60000,80000,20000,1,00224,India
845428,2023-04-14,507,washing machine,6990,16490,9500,1,00224,India
845428,2023-04-14,505,oven,18490,24000,5510,1,00224,India
845428,2023-04-14,506,monitor,3249,8000,4751,1,00224,India
718788,2023-04-14,505,oven,18490,24000,5510,1,00252,India
718788,2023-04-14,503,mixer,1349,3249,1900,1,00252,India
653672,2023-04-14,503,mixer,1349,3249,1900,1,00416,India
653672,2023-04-14,506,monitor,3249,8000,4751,1,00416,India
653672,2023-04-14,504,iron,449,879,430,1,00416,India
653672,2023-04-14,502,iphone 15 pro max,100000,135000,35000,1,00416,India
653456,2023-04-14,505,oven,18490,24000,5510,1,00128,India
653456,2023-04-14,504,iron,449,879,430,1,00128,India
914031,2023-04-14,502,iphone 15 pro max,100000,135000,35000,1,00008,India
914031,2023-04-14,503,mixer,1349,3249,1900,1,00008,India
463334,2023-04-14,502,iphone 15 pro max,100000,135000,35000,1,00109,India
463334,2023-04-14,503,mixer,1349,3249,1900,1,00109,India
463334,2023-04-14,507,washing machine,6990,16490,9500,1,00109,India
884011,2023-04-14,502,iphone 15 pro max,100000,135000,35000,1,00171,India
884011,2023-04-14,504,iron,449,879,430,1,00171,India
736186,2023-04-14,507,washing machine,6990,16490,9500,1,00005,India
736186,2023-04-14,506,monitor,3249,8000,4751,1,00005,India
736186,2023-04-14,501,iphone 15,60000,80000,20000,1,00005,India
736186,2023-04-14,504,iron,449,879,430,1,00005,India
736186,2023-04-14,502,iphone 15 pro max,100000,135000,35000,1,00005,India
973943,2023-04-14,507,washing machine,6990,16490,9500,1,00282,India
973943,2023-04-14,505,oven,18490,24000,5510,1,00282,India
973943,2023-04-14,504,iron,449,879,430,1,00282,India
973943,2023-04-14,503,mixer,1349,3249,1900,1,00282,India
624455,2023-04-14,501,iphone 15,60000,80000,20000,1,00325,India
624455,2023-04-14,503,mixer,1349,3249,1900,1,00325,India
567930,2023-04-14,507,washing machine,6990,16490,9500,1,00413,India
567930,2023-04-14,502,iphone 15 pro max,100000,135000,35000,1,00413,India
567930,2023-04-14,505,oven,18490,24000,5510,1,00413,India
567930,2023-04-14,503,mixer,1349,3249,1900,1,00413,India
670744,2023-04-14,504,iron,449,879,430,1,00499,India
150601,2023-04-14,503,mixer,1349,3249,1900,1,00481,India
150601,2023-04-14,506,monitor,3249,8000,4751,1,00481,India
294810,2023-04-14,504,iron,449,879,430,1,00250,India
294810,2023-04-14,505,oven,18490,24000,5510,1,00250,India
294810,2023-04-14,502,iphone 15 pro max,100000,135000,35000,1,00250,India
673422,2023-04-14,507,washing machine,6990,16490,9500,1,00489,India
673422,2023-04-14,505,oven,18490,24000,5510,1,00489,India
473778,2023-04-14,506,monitor,3249,8000,4751,1,00039,India
473778,2023-04-14,503,mixer,1349,3249,1900,1,00039,India
828888,2023-04-14,501,iphone 15,60000,80000,20000,1,00327,India
828888,2023-04-14,504,iron,449,879,430,1,00327,India
378148,2023-04-14,507,washing machine,6990,16490,9500,1,00371,India
378148,2023-04-14,501,iphone 15,60000,80000,20000,1,00371,India
378148,2023-04-14,503,mixer,1349,3249,1900,1,00371,India
696653,2023-04-14,502,iphone 15 pro max,100000,135000,35000,1,00386,India
696653,2023-04-14,505,oven,18490,24000,5510,1,00386,India
696653,2023-04-14,504,iron,449,879,430,1,00386,India
696653,2023-04-14,507,washing machine,6990,16490,9500,1,00386,India
575097,2023-04-14,505,oven,18490,24000,5510,1,00008,India
575097,2023-04-14,503,mixer,1349,3249,1900,1,00008,India
575097,2023-04-14,501,iphone 15,60000,80000,20000,1,00008,India
575097,2023-04-14,506,monitor,3249,8000,4751,1,00008,India
453246,2023-04-14,504,iron,449,879,430,1,00176,India
453246,2023-04-14,505,oven,18490,24000,5510,1,00176,India
453246,2023-04-14,506,monitor,3249,8000,4751,1,00176,India
453246,2023-04-14,507,washing machine,6990,16490,9500,1,00176,India
453246,2023-04-14,501,iphone 15,60000,80000,20000,1,00176,India
513774,2023-04-14,507,washing machine,6990,16490,9500,1,00424,India
890381,2023-04-14,505,oven,18490,24000,5510,1,00499,India
427168,2023-04-14,501,iphone 15,60000,80000,20000,1,00035,India
427168,2023-04-14,507,washing machine,6990,16490,9500,1,00035,India
427168,2023-04-14,505,oven,18490,24000,5510,1,00035,India
248805,2023-04-14,503,mixer,1349,3249,1900,1,00107,India
248805,2023-04-14,507,washing machine,6990,16490,9500,1,00107,India
248805,2023-04-14,505,oven,18490,24000,5510,1,00107,India
248805,2023-04-14,504,iron,449,879,430,1,00107,India
370844,2023-04-14,502,iphone 15 pro max,100000,135000,35000,1,00011,India
370844,2023-04-14,506,monitor,3249,8000,4751,1,00011,India
370844,2023-04-14,501,iphone 15,60000,80000,20000,1,00011,India
370844,2023-04-14,503,mixer,1349,3249,1900,1,00011,India
323085,2023-04-14,507,washing machine,6990,16490,9500,1,00402,India
323085,2023-04-14,505,oven,18490,24000,5510,1,00402,India
323085,2023-04-14,506,monitor,3249,8000,4751,1,00402,India
806275,2023-04-14,504,iron,449,879,430,1,00298,India
806275,2023-04-14,505,oven,18490,24000,5510,1,00298,India
729537,2023-04-14,501,iphone 15,60000,80000,20000,1,00055,India
861999,2023-04-14,505,oven,18490,24000,5510,1,00164,India
861999,2023-04-14,503,mixer,1349,3249,1900,1,00164,India
861999,2023-04-14,506,monitor,3249,8000,4751,1,00164,India
861999,2023-04-14,501,iphone 15,60000,80000,20000,1,00164,India
742093,2023-04-14,505,oven,18490,24000,5510,1,00075,India
742093,2023-04-14,503,mixer,1349,3249,1900,1,00075,India
742093,2023-04-14,506,monitor,3249,8000,4751,1,00075,India
742093,2023-04-14,502,iphone 15 pro max,100000,135000,35000,1,00075,India
742093,2023-04-14,507,washing machine,6990,16490,9500,1,00075,India
730512,2023-04-14,501,iphone 15,60000,80000,20000,1,00460,India
730512,2023-04-14,505,oven,18490,24000,5510,1,00460,India
145174,2023-04-14,507,washing machine,6990,16490,9500,1,00074,India
145174,2023-04-14,504,iron,449,879,430,1,00074,India
145174,2023-04-14,503,mixer,1349,3249,1900,1,00074,India
330679,2023-04-14,505,oven,18490,24000,5510,1,00412,India
330679,2023-04-14,506,monitor,3249,8000,4751,1,00412,India
330679,2023-04-14,507,washing machine,6990,16490,9500,1,00412,India
203517,2023-04-14,501,iphone 15,60000,80000,20000,1,00213,India
203517,2023-04-14,506,monitor,3249,8000,4751,1,00213,India
203517,2023-04-14,502,iphone 15 pro max,100000,135000,35000,1,00213,India
203517,2023-04-14,505,oven,18490,24000,5510,1,00213,India
203517,2023-04-14,507,washing machine,6990,16490,9500,1,00213,India
976370,2023-04-14,502,iphone 15 pro max,100000,135000,35000,1,00439,India
976370,2023-04-14,504,iron,449,879,430,1,00439,India
193066,2023-04-14,501,iphone 15,60000,80000,20000,1,00230,India
193066,2023-04-14,504,iron,449,879,430,1,00230,India
193066,2023-04-14,502,iphone 15 pro max,100000,135000,35000,1,00230,India
207539,2023-04-14,503,mixer,1349,3249,1900,1,00467,India
207539,2023-04-14,502,iphone 15 pro max,100000,135000,35000,1,00467,India
207539,2023-04-14,505,oven,18490,24000,5510,1,00467,India
635778,2023-04-14,502,iphone 15 pro max,100000,135000,35000,1,00397,India
952344,2023-04-14,504,iron,449,879,430,1,00127,India
952344,2023-04-14,506,monitor,3249,8000,4751,1,00127,India
952344,2023-04-14,501,iphone 15,60000,80000,20000,1,00127,India
952344,2023-04-14,502,iphone 15 pro max,100000,135000,35000,1,00127,India
567206,2023-04-14,501,iphone 15,60000,80000,20000,1,00449,India
567206,2023-04-14,503,mixer,1349,3249,1900,1,00449,India
674812,2023-04-14,507,washing machine,6990,16490,9500,1,00446,India
674812,2023-04-14,502,iphone 15 pro max,100000,135000,35000,1,00446,India
941312,2023-04-14,504,iron,449,879,430,1,00022,India
478700,2023-04-14,507,washing machine,6990,16490,9500,1,00050,India
478700,2023-04-14,505,oven,18490,24000,5510,1,00050,India
478700,2023-04-14,502,iphone 15 pro max,100000,135000,35000,1,00050,India
478700,2023-04-14,503,mixer,1349,3249,1900,1,00050,India
297516,2023-04-14,501,iphone 15,60000,80000,20000,1,00065,India
341866,2023-04-14,504,iron,449,879,430,1,00478,India
341866,2023-04-14,505,oven,18490,24000,5510,1,00478,India
341866,2023-04-14,501,iphone 15,60000,80000,20000,1,00478,India
148469,2023-04-14,502,iphone 15 pro max,100000,135000,35000,1,00431,India
148469,2023-04-14,503,mixer,1349,3249,1900,1,00431,India
148469,2023-04-14,507,washing machine,6990,16490,9500,1,00431,India
148469,2023-04-14,504,iron,449,879,430,1,00431,India
896180,2023-04-14,502,iphone 15 pro max,100000,135000,35000,1,00334,India
896180,2023-04-14,504,iron,449,879,430,1,00334,India
483188,2023-04-14,506,monitor,3249,8000,4751,1,00264,India
483188,2023-04-14,507,washing machine,6990,16490,9500,1,00264,India
483188,2023-04-14,504,iron,449,879,430,1,00264,India
363288,2023-04-14,505,oven,18490,24000,5510,1,00182,India
363288,2023-04-14,501,iphone 15,60000,80000,20000,1,00182,India
797937,2023-04-14,507,washing machine,6990,16490,9500,1,00219,India
797937,2023-04-14,503,mixer,1349,3249,1900,1,00219,India
514382,2023-04-14,504,iron,449,879,430,1,00195,India
514382,2023-04-14,502,iphone 15 pro max,100000,135000,35000,1,00195,India
514382,2023-04-14,503,mixer,1349,3249,1900,1,00195,India
749887,2023-04-14,501,iphone 15,60000,80000,20000,1,00421,India
431994,2023-04-14,502,iphone 15 pro max,100000,135000,35000,1,00128,India
988073,2023-04-14,506,monitor,3249,8000,4751,1,00410,India
988073,2023-04-14,507,washing machine,6990,16490,9500,1,00410,India
988073,2023-04-14,504,iron,449,879,430,1,00410,India
988073,2023-04-14,503,mixer,1349,3249,1900,1,00410,India
913997,2023-04-14,504,iron,449,879,430,1,00217,India
913997,2023-04-14,503,mixer,1349,3249,1900,1,00217,India
913997,2023-04-14,507,washing machine,6990,16490,9500,1,00217,India
913997,2023-04-14,505,oven,18490,24000,5510,1,00217,India
909304,2023-04-14,504,iron,449,879,430,1,00056,India
909304,2023-04-14,505,oven,18490,24000,5510,1,00056,India
857054,2023-04-14,503,mixer,1349,3249,1900,1,00405,India
369005,2023-04-14,504,iron,449,879,430,1,00123,India
289029,2023-04-14,502,iphone 15 pro max,100000,135000,35000,1,00492,India
289029,2023-04-14,506,monitor,3249,8000,4751,1,00492,India
802425,2023-04-14,501,iphone 15,60000,80000,20000,1,00050,India
802425,2023-04-14,507,washing machine,6990,16490,9500,1,00050,India
802425,2023-04-14,502,iphone 15 pro max,100000,135000,35000,1,00050,India
813090,2023-04-14,502,iphone 15 pro max,100000,135000,35000,1,00134,India
813090,2023-04-14,507,washing machine,6990,16490,9500,1,00134,India
813090,2023-04-14,505,oven,18490,24000,5510,1,00134,India
561417,2023-04-14,505,oven,18490,24000,5510,1,00481,India
384469,2023-04-14,504,iron,449,879,430,1,00140,India
384469,2023-04-14,501,iphone 15,60000,80000,20000,1,00140,India
570651,2023-04-14,501,iphone 15,60000,80000,20000,1,00002,India
151190,2023-04-14,505,oven,18490,24000,5510,1,00340,India
266500,2023-04-14,503,mixer,1349,3249,1900,1,00100,India
266500,2023-04-14,502,iphone 15 pro max,100000,135000,35000,1,00100,India
266500,2023-04-14,505,oven,18490,24000,5510,1,00100,India
360429,2023-04-14,507,washing machine,6990,16490,9500,1,00322,India
360429,2023-04-14,504,iron,449,879,430,1,00322,India
360429,2023-04-14,505,oven,18490,24000,5510,1,00322,India
360429,2023-04-14,502,iphone 15 pro max,100000,135000,35000,1,00322,India
471352,2023-04-14,506,monitor,3249,8000,4751,1,00217,India
471352,2023-04-14,501,iphone 15,60000,80000,20000,1,00217,India
648173,2023-04-14,506,monitor,3249,8000,4751,1,00404,India
648173,2023-04-14,502,iphone 15 pro max,100000,135000,35000,1,00404,India
867148,2023-04-14,501,iphone 15,60000,80000,20000,1,00042,India
867148,2023-04-14,507,washing machine,6990,16490,9500,1,00042,India
920398,2023-04-14,504,iron,449,879,430,1,00010,India
920398,2023-04-14,505,oven,18490,24000,5510,1,00010,India
920398,2023-04-14,503,mixer,1349,3249,1900,1,00010,India
314363,2023-04-14,501,iphone 15,60000,80000,20000,1,00440,India
314363,2023-04-14,505,oven,18490,24000,5510,1,00440,India
314363,2023-04-14,507,washing machine,6990,16490,9500,1,00440,India
582616,2023-04-14,502,iphone 15 pro max,100000,135000,35000,1,00295,India
582616,2023-04-14,504,iron,449,879,430,1,00295,India
520387,2023-04-14,504,iron,449,879,430,1,00267,India
520387,2023-04-14,503,mixer,1349,3249,1900,1,00267,India
520387,2023-04-14,505,oven,18490,24000,5510,1,00267,India
404966,2023-04-14,507,washing machine,6990,16490,9500,1,00365,India
614104,2023-04-14,504,iron,449,879,430,1,00497,India
614104,2023-04-14,506,monitor,3249,8000,4751,1,00497,India
614104,2023-04-14,505,oven,18490,24000,5510,1,00497,India
503486,2023-04-14,503,mixer,1349,3249,1900,1,00198,India
503486,2023-04-14,502,iphone 15 pro max,100000,135000,35000,1,00198,India
503486,2023-04-14,504,iron,449,879,430,1,00198,India
660228,2023-04-14,504,iron,449,879,430,1,00074,India
660228,2023-04-14,506,monitor,3249,8000,4751,1,00074,India
660228,2023-04-14,501,iphone 15,60000,80000,20000,1,00074,India
660228,2023-04-14,502,iphone 15 pro max,100000,135000,35000,1,00074,India
677997,2023-04-14,502,iphone 15 pro max,100000,135000,35000,1,00049,India
454413,2023-04-14,505,oven,18490,24000,5510,1,00297,India
984449,2023-04-15,504,iron,449,879,430,1,00465,India
984449,2023-04-15,507,washing machine,6990,16490,9500,1,00465,India
875663,2023-04-15,502,iphone 15 pro max,100000,135000,35000,1,00441,India
875663,2023-04-15,501,iphone 15,60000,80000,20000,1,00441,India
871152,2023-04-15,502,iphone 15 pro max,100000,135000,35000,1,00324,India
871152,2023-04-15,504,iron,449,879,430,1,00324,India
827065,2023-04-15,507,washing machine,6990,16490,9500,1,00155,India
319442,2023-04-15,502,iphone 15 pro max,100000,135000,35000,1,00066,India
319442,2023-04-15,507,washing machine,6990,16490,9500,1,00066,India
896959,2023-04-15,502,iphone 15 pro max,100000,135000,35000,1,00101,India
512357,2023-04-15,502,iphone 15 pro max,100000,135000,35000,1,00060,India
512357,2023-04-15,501,iphone 15,60000,80000,20000,1,00060,India
570641,2023-04-15,502,iphone 15 pro max,100000,135000,35000,1,00064,India
570641,2023-04-15,503,mixer,1349,3249,1900,1,00064,India
570641,2023-04-15,506,monitor,3249,8000,4751,1,00064,India
658229,2023-04-15,504,iron,449,879,430,1,00460,India
658229,2023-04-15,501,iphone 15,60000,80000,20000,1,00460,India
658229,2023-04-15,502,iphone 15 pro max,100000,135000,35000,1,00460,India
607448,2023-04-15,501,iphone 15,60000,80000,20000,1,00372,India
607448,2023-04-15,503,mixer,1349,3249,1900,1,00372,India
607448,2023-04-15,505,oven,18490,24000,5510,1,00372,India
607448,2023-04-15,502,iphone 15 pro max,100000,135000,35000,1,00372,India
247553,2023-04-15,503,mixer,1349,3249,1900,1,00070,India
247553,2023-04-15,501,iphone 15,60000,80000,20000,1,00070,India
247553,2023-04-15,506,monitor,3249,8000,4751,1,00070,India
625044,2023-04-15,501,iphone 15,60000,80000,20000,1,00107,India
228664,2023-04-15,501,iphone 15,60000,80000,20000,1,00464,India
228664,2023-04-15,507,washing machine,6990,16490,9500,1,00464,India
228664,2023-04-15,502,iphone 15 pro max,100000,135000,35000,1,00464,India
284728,2023-04-15,503,mixer,1349,3249,1900,1,00043,India
953575,2023-04-15,504,iron,449,879,430,1,00090,India
659285,2023-04-15,503,mixer,1349,3249,1900,1,00456,India
432790,2023-04-15,505,oven,18490,24000,5510,1,00019,India
432790,2023-04-15,503,mixer,1349,3249,1900,1,00019,India
973089,2023-04-15,506,monitor,3249,8000,4751,1,00281,India
973089,2023-04-15,505,oven,18490,24000,5510,1,00281,India
973089,2023-04-15,501,iphone 15,60000,80000,20000,1,00281,India
973089,2023-04-15,502,iphone 15 pro max,100000,135000,35000,1,00281,India
523984,2023-04-15,506,monitor,3249,8000,4751,1,00434,India
523984,2023-04-15,504,iron,449,879,430,1,00434,India
218418,2023-04-15,504,iron,449,879,430,1,00306,India
218418,2023-04-15,502,iphone 15 pro max,100000,135000,35000,1,00306,India
218418,2023-04-15,501,iphone 15,60000,80000,20000,1,00306,India
507962,2023-04-15,504,iron,449,879,430,1,00029,India
457529,2023-04-15,507,washing machine,6990,16490,9500,1,00120,India
814623,2023-04-15,503,mixer,1349,3249,1900,1,00250,India
814623,2023-04-15,506,monitor,3249,8000,4751,1,00250,India
942973,2023-04-15,504,iron,449,879,430,1,00026,India
942973,2023-04-15,507,washing machine,6990,16490,9500,1,00026,India
942973,2023-04-15,502,iphone 15 pro max,100000,135000,35000,1,00026,India
942973,2023-04-15,503,mixer,1349,3249,1900,1,00026,India
765948,2023-04-15,503,mixer,1349,3249,1900,1,00087,India
765948,2023-04-15,501,iphone 15,60000,80000,20000,1,00087,India
765948,2023-04-15,505,oven,18490,24000,5510,1,00087,India
366211,2023-04-15,504,iron,449,879,430,1,00226,India
366211,2023-04-15,505,oven,18490,24000,5510,1,00226,India
795600,2023-04-15,507,washing machine,6990,16490,9500,1,00171,India
795600,2023-04-15,506,monitor,3249,8000,4751,1,00171,India
158871,2023-04-15,504,iron,449,879,430,1,00293,India
158871,2023-04-15,506,monitor,3249,8000,4751,1,00293,India
158871,2023-04-15,503,mixer,1349,3249,1900,1,00293,India
158871,2023-04-15,502,iphone 15 pro max,100000,135000,35000,1,00293,India
804028,2023-04-15,506,monitor,3249,8000,4751,1,00443,India
804028,2023-04-15,504,iron,449,879,430,1,00443,India
804028,2023-04-15,507,washing machine,6990,16490,9500,1,00443,India
558769,2023-04-15,506,monitor,3249,8000,4751,1,00104,India
558769,2023-04-15,503,mixer,1349,3249,1900,1,00104,India
558769,2023-04-15,504,iron,449,879,430,1,00104,India
127273,2023-04-15,505,oven,18490,24000,5510,1,00185,India
127273,2023-04-15,501,iphone 15,60000,80000,20000,1,00185,India
127273,2023-04-15,503,mixer,1349,3249,1900,1,00185,India
961976,2023-04-15,504,iron,449,879,430,1,00411,India
961976,2023-04-15,502,iphone 15 pro max,100000,135000,35000,1,00411,India
961976,2023-04-15,501,iphone 15,60000,80000,20000,1,00411,India
961976,2023-04-15,505,oven,18490,24000,5510,1,00411,India
106809,2023-04-15,503,mixer,1349,3249,1900,1,00146,India
572669,2023-04-15,503,mixer,1349,3249,1900,1,00374,India
572669,2023-04-15,501,iphone 15,60000,80000,20000,1,00374,India
572669,2023-04-15,506,monitor,3249,8000,4751,1,00374,India
535018,2023-04-15,507,washing machine,6990,16490,9500,1,00374,India
357508,2023-04-15,502,iphone 15 pro max,100000,135000,35000,1,00467,India
821094,2023-04-15,506,monitor,3249,8000,4751,1,00029,India
821094,2023-04-15,504,iron,449,879,430,1,00029,India
821094,2023-04-15,505,oven,18490,24000,5510,1,00029,India
383772,2023-04-15,506,monitor,3249,8000,4751,1,00049,India
383772,2023-04-15,503,mixer,1349,3249,1900,1,00049,India
383772,2023-04-15,507,washing machine,6990,16490,9500,1,00049,India
383772,2023-04-15,501,iphone 15,60000,80000,20000,1,00049,India
383772,2023-04-15,505,oven,18490,24000,5510,1,00049,India
920902,2023-04-15,505,oven,18490,24000,5510,1,00056,India
481949,2023-04-15,505,oven,18490,24000,5510,1,00205,India
285962,2023-04-15,503,mixer,1349,3249,1900,1,00019,India
943119,2023-04-15,501,iphone 15,60000,80000,20000,1,00445,India
671262,2023-04-15,502,iphone 15 pro max,100000,135000,35000,1,00401,India
671262,2023-04-15,505,oven,18490,24000,5510,1,00401,India
671262,2023-04-15,501,iphone 15,60000,80000,20000,1,00401,India
890120,2023-04-15,502,iphone 15 pro max,100000,135000,35000,1,00036,India
890120,2023-04-15,504,iron,449,879,430,1,00036,India
890120,2023-04-15,507,washing machine,6990,16490,9500,1,00036,India
890120,2023-04-15,506,monitor,3249,8000,4751,1,00036,India
562105,2023-04-15,503,mixer,1349,3249,1900,1,00280,India
562105,2023-04-15,504,iron,449,879,430,1,00280,India
562105,2023-04-15,501,iphone 15,60000,80000,20000,1,00280,India
972932,2023-04-15,504,iron,449,879,430,1,00024,India
972932,2023-04-15,505,oven,18490,24000,5510,1,00024,India
972932,2023-04-15,503,mixer,1349,3249,1900,1,00024,India
860103,2023-04-15,506,monitor,3249,8000,4751,1,00213,India
860103,2023-04-15,501,iphone 15,60000,80000,20000,1,00213,India
860103,2023-04-15,507,washing machine,6990,16490,9500,1,00213,India
911568,2023-04-15,506,monitor,3249,8000,4751,1,00314,India
911568,2023-04-15,505,oven,18490,24000,5510,1,00314,India
733188,2023-04-15,505,oven,18490,24000,5510,1,00257,India
733188,2023-04-15,507,washing machine,6990,16490,9500,1,00257,India
443818,2023-04-15,507,washing machine,6990,16490,9500,1,00193,India
443818,2023-04-15,504,iron,449,879,430,1,00193,India
443818,2023-04-15,505,oven,18490,24000,5510,1,00193,India
443818,2023-04-15,503,mixer,1349,3249,1900,1,00193,India
443818,2023-04-15,502,iphone 15 pro max,100000,135000,35000,1,00193,India
844686,2023-04-15,501,iphone 15,60000,80000,20000,1,00497,India
406314,2023-04-15,505,oven,18490,24000,5510,1,00273,India
406314,2023-04-15,504,iron,449,879,430,1,00273,India
406314,2023-04-15,501,iphone 15,60000,80000,20000,1,00273,India
406314,2023-04-15,506,monitor,3249,8000,4751,1,00273,India
965521,2023-04-15,501,iphone 15,60000,80000,20000,1,00007,India
965521,2023-04-15,507,washing machine,6990,16490,9500,1,00007,India
965521,2023-04-15,502,iphone 15 pro max,100000,135000,35000,1,00007,India
576249,2023-04-15,506,monitor,3249,8000,4751,1,00345,India
141030,2023-04-15,503,mixer,1349,3249,1900,1,00306,India
141030,2023-04-15,501,iphone 15,60000,80000,20000,1,00306,India
141030,2023-04-15,507,washing machine,6990,16490,9500,1,00306,India
363383,2023-04-15,502,iphone 15 pro max,100000,135000,35000,1,00262,India
363383,2023-04-15,501,iphone 15,60000,80000,20000,1,00262,India
188229,2023-04-15,503,mixer,1349,3249,1900,1,00030,India
188229,2023-04-15,506,monitor,3249,8000,4751,1,00030,India
686803,2023-04-15,501,iphone 15,60000,80000,20000,1,00468,India
686803,2023-04-15,504,iron,449,879,430,1,00468,India
947297,2023-04-15,503,mixer,1349,3249,1900,1,00048,India
947297,2023-04-15,507,washing machine,6990,16490,9500,1,00048,India
891963,2023-04-15,507,washing machine,6990,16490,9500,1,00051,India
891963,2023-04-15,501,iphone 15,60000,80000,20000,1,00051,India
601653,2023-04-15,506,monitor,3249,8000,4751,1,00439,India
905502,2023-04-15,505,oven,18490,24000,5510,1,00463,India
497170,2023-04-15,505,oven,18490,24000,5510,1,00117,India
194713,2023-04-15,507,washing machine,6990,16490,9500,1,00489,India
194713,2023-04-15,506,monitor,3249,8000,4751,1,00489,India
194713,2023-04-15,502,iphone 15 pro max,100000,135000,35000,1,00489,India
194713,2023-04-15,504,iron,449,879,430,1,00489,India
883427,2023-04-15,504,iron,449,879,430,1,00257,India
883427,2023-04-15,507,washing machine,6990,16490,9500,1,00257,India
979829,2023-04-15,501,iphone 15,60000,80000,20000,1,00302,India
979829,2023-04-15,507,washing machine,6990,16490,9500,1,00302,India
389068,2023-04-15,502,iphone 15 pro max,100000,135000,35000,1,00250,India
389068,2023-04-15,507,washing machine,6990,16490,9500,1,00250,India
251253,2023-04-15,507,washing machine,6990,16490,9500,1,00067,India
251253,2023-04-15,506,monitor,3249,8000,4751,1,00067,India
251253,2023-04-15,502,iphone 15 pro max,100000,135000,35000,1,00067,India
346178,2023-04-15,503,mixer,1349,3249,1900,1,00467,India
346178,2023-04-15,506,monitor,3249,8000,4751,1,00467,India
346178,2023-04-15,504,iron,449,879,430,1,00467,India
431781,2023-04-15,506,monitor,3249,8000,4751,1,00291,India
431781,2023-04-15,505,oven,18490,24000,5510,1,00291,India
431781,2023-04-15,501,iphone 15,60000,80000,20000,1,00291,India
597431,2023-04-15,501,iphone 15,60000,80000,20000,1,00169,India
953548,2023-04-15,504,iron,449,879,430,1,00086,India
261796,2023-04-15,501,iphone 15,60000,80000,20000,1,00359,India
261796,2023-04-15,503,mixer,1349,3249,1900,1,00359,India
261796,2023-04-15,504,iron,449,879,430,1,00359,India
559904,2023-04-15,505,oven,18490,24000,5510,1,00422,India
559904,2023-04-15,502,iphone 15 pro max,100000,135000,35000,1,00422,India
387391,2023-04-15,505,oven,18490,24000,5510,1,00486,India
387391,2023-04-15,507,washing machine,6990,16490,9500,1,00486,India
287868,2023-04-15,506,monitor,3249,8000,4751,1,00106,India
287868,2023-04-15,505,oven,18490,24000,5510,1,00106,India
757080,2023-04-15,505,oven,18490,24000,5510,1,00472,India
757080,2023-04-15,507,washing machine,6990,16490,9500,1,00472,India
386373,2023-04-15,505,oven,18490,24000,5510,1,00288,India
386373,2023-04-15,507,washing machine,6990,16490,9500,1,00288,India
386373,2023-04-15,504,iron,449,879,430,1,00288,India
571634,2023-04-15,502,iphone 15 pro max,100000,135000,35000,1,00043,India
472096,2023-04-15,503,mixer,1349,3249,1900,1,00334,India
472096,2023-04-15,506,monitor,3249,8000,4751,1,00334,India
472096,2023-04-15,502,iphone 15 pro max,100000,135000,35000,1,00334,India
472096,2023-04-15,504,iron,449,879,430,1,00334,India
915225,2023-04-15,503,mixer,1349,3249,1900,1,00113,India
915225,2023-04-15,507,washing machine,6990,16490,9500,1,00113,India
915225,2023-04-15,502,iphone 15 pro max,100000,135000,35000,1,00113,India
915225,2023-04-15,506,monitor,3249,8000,4751,1,00113,India
818853,2023-04-15,505,oven,18490,24000,5510,1,00121,India
818853,2023-04-15,504,iron,449,879,430,1,00121,India
818853,2023-04-15,502,iphone 15 pro max,100000,135000,35000,1,00121,India
818853,2023-04-15,501,iphone 15,60000,80000,20000,1,00121,India
872803,2023-04-16,507,washing machine,6990,16490,9500,1,00273,India
872803,2023-04-16,503,mixer,1349,3249,1900,1,00273,India
872803,2023-04-16,501,iphone 15,60000,80000,20000,1,00273,India
594943,2023-04-16,503,mixer,1349,3249,1900,1,00136,India
594943,2023-04-16,505,oven,18490,24000,5510,1,00136,India
594943,2023-04-16,507,washing machine,6990,16490,9500,1,00136,India
594943,2023-04-16,502,iphone 15 pro max,100000,135000,35000,1,00136,India
713872,2023-04-16,505,oven,18490,24000,5510,1,00001,India
728205,2023-04-16,503,mixer,1349,3249,1900,1,00128,India
728205,2023-04-16,504,iron,449,879,430,1,00128,India
844797,2023-04-16,503,mixer,1349,3249,1900,1,00022,India
844797,2023-04-16,501,iphone 15,60000,80000,20000,1,00022,India
844797,2023-04-16,504,iron,449,879,430,1,00022,India
245960,2023-04-16,507,washing machine,6990,16490,9500,1,00114,India
896858,2023-04-16,504,iron,449,879,430,1,00393,India
896858,2023-04-16,505,oven,18490,24000,5510,1,00393,India
896858,2023-04-16,502,iphone 15 pro max,100000,135000,35000,1,00393,India
240223,2023-04-16,504,iron,449,879,430,1,00407,India
240223,2023-04-16,502,iphone 15 pro max,100000,135000,35000,1,00407,India
240223,2023-04-16,503,mixer,1349,3249,1900,1,00407,India
240223,2023-04-16,501,iphone 15,60000,80000,20000,1,00407,India
240223,2023-04-16,507,washing machine,6990,16490,9500,1,00407,India
344838,2023-04-16,503,mixer,1349,3249,1900,1,00426,India
344838,2023-04-16,504,iron,449,879,430,1,00426,India
244613,2023-04-16,504,iron,449,879,430,1,00119,India
746306,2023-04-16,505,oven,18490,24000,5510,1,00414,India
746306,2023-04-16,506,monitor,3249,8000,4751,1,00414,India
746306,2023-04-16,501,iphone 15,60000,80000,20000,1,00414,India
463831,2023-04-16,502,iphone 15 pro max,100000,135000,35000,1,00223,India
425215,2023-04-16,505,oven,18490,24000,5510,1,00082,India
425215,2023-04-16,502,iphone 15 pro max,100000,135000,35000,1,00082,India
425215,2023-04-16,504,iron,449,879,430,1,00082,India
278243,2023-04-16,502,iphone 15 pro max,100000,135000,35000,1,00152,India
731882,2023-04-16,501,iphone 15,60000,80000,20000,1,00203,India
541427,2023-04-16,502,iphone 15 pro max,100000,135000,35000,1,00307,India
490421,2023-04-16,502,iphone 15 pro max,100000,135000,35000,1,00212,India
490421,2023-04-16,506,monitor,3249,8000,4751,1,00212,India
490421,2023-04-16,501,iphone 15,60000,80000,20000,1,00212,India
781277,2023-04-16,506,monitor,3249,8000,4751,1,00257,India
781277,2023-04-16,503,mixer,1349,3249,1900,1,00257,India
781277,2023-04-16,507,washing machine,6990,16490,9500,1,00257,India
932315,2023-04-16,503,mixer,1349,3249,1900,1,00211,India
247017,2023-04-16,502,iphone 15 pro max,100000,135000,35000,1,00400,India
131255,2023-04-16,505,oven,18490,24000,5510,1,00487,India
131255,2023-04-16,503,mixer,1349,3249,1900,1,00487,India
131255,2023-04-16,506,monitor,3249,8000,4751,1,00487,India
131255,2023-04-16,507,washing machine,6990,16490,9500,1,00487,India
693163,2023-04-16,504,iron,449,879,430,1,00140,India
693163,2023-04-16,501,iphone 15,60000,80000,20000,1,00140,India
693163,2023-04-16,502,iphone 15 pro max,100000,135000,35000,1,00140,India
693163,2023-04-16,506,monitor,3249,8000,4751,1,00140,India
813656,2023-04-16,505,oven,18490,24000,5510,1,00192,India
813656,2023-04-16,501,iphone 15,60000,80000,20000,1,00192,India
108890,2023-04-16,502,iphone 15 pro max,100000,135000,35000,1,00285,India
108890,2023-04-16,501,iphone 15,60000,80000,20000,1,00285,India
108890,2023-04-16,507,washing machine,6990,16490,9500,1,00285,India
991617,2023-04-16,507,washing machine,6990,16490,9500,1,00144,India
519799,2023-04-16,506,monitor,3249,8000,4751,1,00377,India
519799,2023-04-16,507,washing machine,6990,16490,9500,1,00377,India
507483,2023-04-16,505,oven,18490,24000,5510,1,00045,India
507483,2023-04-16,506,monitor,3249,8000,4751,1,00045,India
507483,2023-04-16,503,mixer,1349,3249,1900,1,00045,India
507483,2023-04-16,502,iphone 15 pro max,100000,135000,35000,1,00045,India
126077,2023-04-16,507,washing machine,6990,16490,9500,1,00075,India
126077,2023-04-16,506,monitor,3249,8000,4751,1,00075,India
797401,2023-04-16,502,iphone 15 pro max,100000,135000,35000,1,00335,India
508149,2023-04-16,507,washing machine,6990,16490,9500,1,00118,India
508149,2023-04-16,506,monitor,3249,8000,4751,1,00118,India
508149,2023-04-16,504,iron,449,879,430,1,00118,India
508149,2023-04-16,502,iphone 15 pro max,100000,135000,35000,1,00118,India
508149,2023-04-16,501,iphone 15,60000,80000,20000,1,00118,India
460177,2023-04-16,507,washing machine,6990,16490,9500,1,00261,India
380388,2023-04-16,501,iphone 15,60000,80000,20000,1,00083,India
380388,2023-04-16,506,monitor,3249,8000,4751,1,00083,India
380388,2023-04-16,505,oven,18490,24000,5510,1,00083,India
380388,2023-04-16,507,washing machine,6990,16490,9500,1,00083,India
573527,2023-04-16,503,mixer,1349,3249,1900,1,00420,India
573527,2023-04-16,507,washing machine,6990,16490,9500,1,00420,India
917701,2023-04-16,506,monitor,3249,8000,4751,1,00380,India
412251,2023-04-16,505,oven,18490,24000,5510,1,00292,India
412251,2023-04-16,504,iron,449,879,430,1,00292,India
412251,2023-04-16,501,iphone 15,60000,80000,20000,1,00292,India
620927,2023-04-16,502,iphone 15 pro max,100000,135000,35000,1,00473,India
997893,2023-04-16,502,iphone 15 pro max,100000,135000,35000,1,00003,India
997893,2023-04-16,503,mixer,1349,3249,1900,1,00003,India
997893,2023-04-16,505,oven,18490,24000,5510,1,00003,India
997893,2023-04-16,507,washing machine,6990,16490,9500,1,00003,India
589686,2023-04-16,501,iphone 15,60000,80000,20000,1,00038,India
217782,2023-04-16,505,oven,18490,24000,5510,1,00432,India
217782,2023-04-16,501,iphone 15,60000,80000,20000,1,00432,India
217782,2023-04-16,503,mixer,1349,3249,1900,1,00432,India
989462,2023-04-16,506,monitor,3249,8000,4751,1,00038,India
989462,2023-04-16,501,iphone 15,60000,80000,20000,1,00038,India
989462,2023-04-16,507,washing machine,6990,16490,9500,1,00038,India
739564,2023-04-16,503,mixer,1349,3249,1900,1,00107,India
101283,2023-04-16,506,monitor,3249,8000,4751,1,00375,India
101283,2023-04-16,505,oven,18490,24000,5510,1,00375,India
101283,2023-04-16,503,mixer,1349,3249,1900,1,00375,India
159557,2023-04-16,507,washing machine,6990,16490,9500,1,00323,India
342882,2023-04-16,502,iphone 15 pro max,100000,135000,35000,1,00380,India
342882,2023-04-16,504,iron,449,879,430,1,00380,India
342882,2023-04-16,501,iphone 15,60000,80000,20000,1,00380,India
342882,2023-04-16,506,monitor,3249,8000,4751,1,00380,India
368039,2023-04-16,501,iphone 15,60000,80000,20000,1,00109,India
368039,2023-04-16,507,washing machine,6990,16490,9500,1,00109,India
245130,2023-04-16,502,iphone 15 pro max,100000,135000,35000,1,00299,India
245130,2023-04-16,505,oven,18490,24000,5510,1,00299,India
245130,2023-04-16,501,iphone 15,60000,80000,20000,1,00299,India
853899,2023-04-16,507,washing machine,6990,16490,9500,1,00304,India
739805,2023-04-16,501,iphone 15,60000,80000,20000,1,00477,India
739805,2023-04-16,503,mixer,1349,3249,1900,1,00477,India
485339,2023-04-16,504,iron,449,879,430,1,00312,India
485339,2023-04-16,506,monitor,3249,8000,4751,1,00312,India
422417,2023-04-16,505,oven,18490,24000,5510,1,00301,India
894167,2023-04-16,504,iron,449,879,430,1,00073,India
894167,2023-04-16,507,washing machine,6990,16490,9500,1,00073,India
894167,2023-04-16,502,iphone 15 pro max,100000,135000,35000,1,00073,India
894167,2023-04-16,505,oven,18490,24000,5510,1,00073,India
892654,2023-04-16,507,washing machine,6990,16490,9500,1,00458,India
892654,2023-04-16,504,iron,449,879,430,1,00458,India
892654,2023-04-16,501,iphone 15,60000,80000,20000,1,00458,India
994874,2023-04-16,503,mixer,1349,3249,1900,1,00305,India
296830,2023-04-16,504,iron,449,879,430,1,00014,India
156896,2023-04-16,502,iphone 15 pro max,100000,135000,35000,1,00422,India
156896,2023-04-16,504,iron,449,879,430,1,00422,India
303806,2023-04-16,504,iron,449,879,430,1,00018,India
303806,2023-04-16,505,oven,18490,24000,5510,1,00018,India
303806,2023-04-16,501,iphone 15,60000,80000,20000,1,00018,India
344705,2023-04-16,506,monitor,3249,8000,4751,1,00351,India
344705,2023-04-16,507,washing machine,6990,16490,9500,1,00351,India
344705,2023-04-16,503,mixer,1349,3249,1900,1,00351,India
264284,2023-04-16,502,iphone 15 pro max,100000,135000,35000,1,00010,India
264284,2023-04-16,501,iphone 15,60000,80000,20000,1,00010,India
527001,2023-04-16,503,mixer,1349,3249,1900,1,00120,India
766620,2023-04-16,504,iron,449,879,430,1,00200,India
766620,2023-04-16,506,monitor,3249,8000,4751,1,00200,India
766620,2023-04-16,503,mixer,1349,3249,1900,1,00200,India
174225,2023-04-16,505,oven,18490,24000,5510,1,00325,India
174225,2023-04-16,503,mixer,1349,3249,1900,1,00325,India
793310,2023-04-16,506,monitor,3249,8000,4751,1,00411,India
793310,2023-04-16,505,oven,18490,24000,5510,1,00411,India
692944,2023-04-17,504,iron,449,879,430,1,00133,India
692944,2023-04-17,501,iphone 15,60000,80000,20000,1,00133,India
692944,2023-04-17,505,oven,18490,24000,5510,1,00133,India
692944,2023-04-17,507,washing machine,6990,16490,9500,1,00133,India
571788,2023-04-17,505,oven,18490,24000,5510,1,00169,India
571788,2023-04-17,506,monitor,3249,8000,4751,1,00169,India
571788,2023-04-17,502,iphone 15 pro max,100000,135000,35000,1,00169,India
571788,2023-04-17,507,washing machine,6990,16490,9500,1,00169,India
553027,2023-04-17,505,oven,18490,24000,5510,1,00388,India
553027,2023-04-17,507,washing machine,6990,16490,9500,1,00388,India
553027,2023-04-17,506,monitor,3249,8000,4751,1,00388,India
875805,2023-04-17,501,iphone 15,60000,80000,20000,1,00050,India
456281,2023-04-17,507,washing machine,6990,16490,9500,1,00101,India
456281,2023-04-17,503,mixer,1349,3249,1900,1,00101,India
451156,2023-04-17,504,iron,449,879,430,1,00288,India
451156,2023-04-17,506,monitor,3249,8000,4751,1,00288,India
190561,2023-04-17,504,iron,449,879,430,1,00170,India
190561,2023-04-17,507,washing machine,6990,16490,9500,1,00170,India
912123,2023-04-17,506,monitor,3249,8000,4751,1,00010,India
912123,2023-04-17,504,iron,449,879,430,1,00010,India
912123,2023-04-17,501,iphone 15,60000,80000,20000,1,00010,India
181258,2023-04-17,503,mixer,1349,3249,1900,1,00317,India
181258,2023-04-17,506,monitor,3249,8000,4751,1,00317,India
250228,2023-04-17,504,iron,449,879,430,1,00481,India
357486,2023-04-17,502,iphone 15 pro max,100000,135000,35000,1,00206,India
357486,2023-04-17,504,iron,449,879,430,1,00206,India
104313,2023-04-17,503,mixer,1349,3249,1900,1,00482,India
653692,2023-04-17,502,iphone 15 pro max,100000,135000,35000,1,00351,India
602858,2023-04-17,506,monitor,3249,8000,4751,1,00037,India
602858,2023-04-17,507,washing machine,6990,16490,9500,1,00037,India
602858,2023-04-17,504,iron,449,879,430,1,00037,India
602858,2023-04-17,505,oven,18490,24000,5510,1,00037,India
120152,2023-04-17,503,mixer,1349,3249,1900,1,00428,India
139374,2023-04-17,506,monitor,3249,8000,4751,1,00452,India
156103,2023-04-17,503,mixer,1349,3249,1900,1,00496,India
156103,2023-04-17,501,iphone 15,60000,80000,20000,1,00496,India
156103,2023-04-17,505,oven,18490,24000,5510,1,00496,India
703098,2023-04-17,503,mixer,1349,3249,1900,1,00106,India
703098,2023-04-17,501,iphone 15,60000,80000,20000,1,00106,India
703098,2023-04-17,502,iphone 15 pro max,100000,135000,35000,1,00106,India
599264,2023-04-17,505,oven,18490,24000,5510,1,00424,India
599264,2023-04-17,501,iphone 15,60000,80000,20000,1,00424,India
599264,2023-04-17,507,washing machine,6990,16490,9500,1,00424,India
599264,2023-04-17,502,iphone 15 pro max,100000,135000,35000,1,00424,India
308092,2023-04-17,501,iphone 15,60000,80000,20000,1,00012,India
308092,2023-04-17,507,washing machine,6990,16490,9500,1,00012,India
720811,2023-04-17,506,monitor,3249,8000,4751,1,00351,India
344030,2023-04-17,505,oven,18490,24000,5510,1,00350,India
344030,2023-04-17,506,monitor,3249,8000,4751,1,00350,India
583056,2023-04-17,501,iphone 15,60000,80000,20000,1,00474,India
583056,2023-04-17,503,mixer,1349,3249,1900,1,00474,India
583056,2023-04-17,505,oven,18490,24000,5510,1,00474,India
274376,2023-04-17,504,iron,449,879,430,1,00048,India
274376,2023-04-17,507,washing machine,6990,16490,9500,1,00048,India
799816,2023-04-17,502,iphone 15 pro max,100000,135000,35000,1,00291,India
799816,2023-04-17,504,iron,449,879,430,1,00291,India
799816,2023-04-17,501,iphone 15,60000,80000,20000,1,00291,India
371148,2023-04-17,503,mixer,1349,3249,1900,1,00073,India
371148,2023-04-17,502,iphone 15 pro max,100000,135000,35000,1,00073,India
371148,2023-04-17,504,iron,449,879,430,1,00073,India
371148,2023-04-17,507,washing machine,6990,16490,9500,1,00073,India
371148,2023-04-17,506,monitor,3249,8000,4751,1,00073,India
945389,2023-04-17,501,iphone 15,60000,80000,20000,1,00162,India
945389,2023-04-17,504,iron,449,879,430,1,00162,India
612129,2023-04-17,507,washing machine,6990,16490,9500,1,00079,India
612129,2023-04-17,503,mixer,1349,3249,1900,1,00079,India
612129,2023-04-17,502,iphone 15 pro max,100000,135000,35000,1,00079,India
646112,2023-04-17,503,mixer,1349,3249,1900,1,00488,India
646112,2023-04-17,504,iron,449,879,430,1,00488,India
646112,2023-04-17,502,iphone 15 pro max,100000,135000,35000,1,00488,India
977628,2023-04-17,506,monitor,3249,8000,4751,1,00270,India
977628,2023-04-17,501,iphone 15,60000,80000,20000,1,00270,India
977628,2023-04-17,502,iphone 15 pro max,100000,135000,35000,1,00270,India
977628,2023-04-17,503,mixer,1349,3249,1900,1,00270,India
142877,2023-04-17,507,washing machine,6990,16490,9500,1,00342,India
142877,2023-04-17,505,oven,18490,24000,5510,1,00342,India
142877,2023-04-17,503,mixer,1349,3249,1900,1,00342,India
142877,2023-04-17,506,monitor,3249,8000,4751,1,00342,India
901291,2023-04-17,506,monitor,3249,8000,4751,1,00211,India
901291,2023-04-17,507,washing machine,6990,16490,9500,1,00211,India
901291,2023-04-17,501,iphone 15,60000,80000,20000,1,00211,India
901291,2023-04-17,505,oven,18490,24000,5510,1,00211,India
979726,2023-04-17,501,iphone 15,60000,80000,20000,1,00052,India
297483,2023-04-17,502,iphone 15 pro max,100000,135000,35000,1,00233,India
297483,2023-04-17,505,oven,18490,24000,5510,1,00233,India
696546,2023-04-17,505,oven,18490,24000,5510,1,00439,India
696546,2023-04-17,502,iphone 15 pro max,100000,135000,35000,1,00439,India
600381,2023-04-17,506,monitor,3249,8000,4751,1,00042,India
309785,2023-04-17,503,mixer,1349,3249,1900,1,00019,India
309785,2023-04-17,507,washing machine,6990,16490,9500,1,00019,India
309785,2023-04-17,502,iphone 15 pro max,100000,135000,35000,1,00019,India
309785,2023-04-17,506,monitor,3249,8000,4751,1,00019,India
309785,2023-04-17,505,oven,18490,24000,5510,1,00019,India
958336,2023-04-17,503,mixer,1349,3249,1900,1,00457,India
958336,2023-04-17,507,washing machine,6990,16490,9500,1,00457,India
639078,2023-04-17,506,monitor,3249,8000,4751,1,00329,India
639078,2023-04-17,503,mixer,1349,3249,1900,1,00329,India
755360,2023-04-17,502,iphone 15 pro max,100000,135000,35000,1,00442,India
755360,2023-04-17,506,monitor,3249,8000,4751,1,00442,India
755360,2023-04-17,505,oven,18490,24000,5510,1,00442,India
755360,2023-04-17,507,washing machine,6990,16490,9500,1,00442,India
874886,2023-04-17,501,iphone 15,60000,80000,20000,1,00057,India
297634,2023-04-17,505,oven,18490,24000,5510,1,00332,India
529309,2023-04-17,504,iron,449,879,430,1,00021,India
529309,2023-04-17,502,iphone 15 pro max,100000,135000,35000,1,00021,India
529309,2023-04-17,507,washing machine,6990,16490,9500,1,00021,India
529309,2023-04-17,505,oven,18490,24000,5510,1,00021,India
529309,2023-04-17,503,mixer,1349,3249,1900,1,00021,India
516871,2023-04-17,505,oven,18490,24000,5510,1,00300,India
516871,2023-04-17,501,iphone 15,60000,80000,20000,1,00300,India
655186,2023-04-17,506,monitor,3249,8000,4751,1,00335,India
655186,2023-04-17,502,iphone 15 pro max,100000,135000,35000,1,00335,India
100750,2023-04-17,503,mixer,1349,3249,1900,1,00189,India
100750,2023-04-17,504,iron,449,879,430,1,00189,India
100750,2023-04-17,501,iphone 15,60000,80000,20000,1,00189,India
278785,2023-04-17,506,monitor,3249,8000,4751,1,00363,India
463455,2023-04-17,501,iphone 15,60000,80000,20000,1,00210,India
463455,2023-04-17,502,iphone 15 pro max,100000,135000,35000,1,00210,India
360795,2023-04-17,504,iron,449,879,430,1,00337,India
360795,2023-04-17,505,oven,18490,24000,5510,1,00337,India
244223,2023-04-17,502,iphone 15 pro max,100000,135000,35000,1,00058,India
244223,2023-04-17,503,mixer,1349,3249,1900,1,00058,India
977689,2023-04-17,505,oven,18490,24000,5510,1,00248,India
977689,2023-04-17,504,iron,449,879,430,1,00248,India
977689,2023-04-17,507,washing machine,6990,16490,9500,1,00248,India
977689,2023-04-17,506,monitor,3249,8000,4751,1,00248,India
979266,2023-04-17,504,iron,449,879,430,1,00484,India
979266,2023-04-17,502,iphone 15 pro max,100000,135000,35000,1,00484,India
979266,2023-04-17,503,mixer,1349,3249,1900,1,00484,India
120542,2023-04-17,507,washing machine,6990,16490,9500,1,00202,India
120542,2023-04-17,506,monitor,3249,8000,4751,1,00202,India
120542,2023-04-17,505,oven,18490,24000,5510,1,00202,India
826997,2023-04-17,504,iron,449,879,430,1,00221,India
654272,2023-04-17,506,monitor,3249,8000,4751,1,00012,India
363275,2023-04-17,507,washing machine,6990,16490,9500,1,00191,India
363275,2023-04-17,502,iphone 15 pro max,100000,135000,35000,1,00191,India
711320,2023-04-17,503,mixer,1349,3249,1900,1,00445,India
711320,2023-04-17,505,oven,18490,24000,5510,1,00445,India
227563,2023-04-17,504,iron,449,879,430,1,00207,India
227563,2023-04-17,506,monitor,3249,8000,4751,1,00207,India
241464,2023-04-17,507,washing machine,6990,16490,9500,1,00195,India
241464,2023-04-17,505,oven,18490,24000,5510,1,00195,India
241464,2023-04-17,502,iphone 15 pro max,100000,135000,35000,1,00195,India
370585,2023-04-17,506,monitor,3249,8000,4751,1,00397,India
370585,2023-04-17,503,mixer,1349,3249,1900,1,00397,India
370585,2023-04-17,502,iphone 15 pro max,100000,135000,35000,1,00397,India
918149,2023-04-17,504,iron,449,879,430,1,00358,India
918149,2023-04-17,502,iphone 15 pro max,100000,135000,35000,1,00358,India
918149,2023-04-17,506,monitor,3249,8000,4751,1,00358,India
381130,2023-04-17,503,mixer,1349,3249,1900,1,00237,India
381130,2023-04-17,504,iron,449,879,430,1,00237,India
381130,2023-04-17,501,iphone 15,60000,80000,20000,1,00237,India
876340,2023-04-17,506,monitor,3249,8000,4751,1,00491,India
876340,2023-04-17,503,mixer,1349,3249,1900,1,00491,India
876340,2023-04-17,507,washing machine,6990,16490,9500,1,00491,India
876340,2023-04-17,505,oven,18490,24000,5510,1,00491,India
773821,2023-04-17,503,mixer,1349,3249,1900,1,00056,India
773821,2023-04-17,501,iphone 15,60000,80000,20000,1,00056,India
773821,2023-04-17,507,washing machine,6990,16490,9500,1,00056,India
266551,2023-04-17,502,iphone 15 pro max,100000,135000,35000,1,00358,India
266551,2023-04-17,504,iron,449,879,430,1,00358,India
911036,2023-04-17,501,iphone 15,60000,80000,20000,1,00175,India
911036,2023-04-17,504,iron,449,879,430,1,00175,India
757259,2023-04-18,504,iron,449,879,430,1,00317,India
757259,2023-04-18,501,iphone 15,60000,80000,20000,1,00317,India
757259,2023-04-18,505,oven,18490,24000,5510,1,00317,India
757259,2023-04-18,507,washing machine,6990,16490,9500,1,00317,India
611415,2023-04-18,502,iphone 15 pro max,100000,135000,35000,1,00037,India
611415,2023-04-18,503,mixer,1349,3249,1900,1,00037,India
611415,2023-04-18,505,oven,18490,24000,5510,1,00037,India
824143,2023-04-18,507,washing machine,6990,16490,9500,1,00296,India
824143,2023-04-18,505,oven,18490,24000,5510,1,00296,India
931600,2023-04-18,502,iphone 15 pro max,100000,135000,35000,1,00209,India
335760,2023-04-18,505,oven,18490,24000,5510,1,00274,India
483078,2023-04-18,507,washing machine,6990,16490,9500,1,00440,India
483078,2023-04-18,505,oven,18490,24000,5510,1,00440,India
483078,2023-04-18,504,iron,449,879,430,1,00440,India
483078,2023-04-18,503,mixer,1349,3249,1900,1,00440,India
343615,2023-04-18,506,monitor,3249,8000,4751,1,00294,India
140384,2023-04-18,503,mixer,1349,3249,1900,1,00248,India
140384,2023-04-18,501,iphone 15,60000,80000,20000,1,00248,India
140384,2023-04-18,507,washing machine,6990,16490,9500,1,00248,India
961815,2023-04-18,502,iphone 15 pro max,100000,135000,35000,1,00013,India
961815,2023-04-18,503,mixer,1349,3249,1900,1,00013,India
961815,2023-04-18,505,oven,18490,24000,5510,1,00013,India
961815,2023-04-18,504,iron,449,879,430,1,00013,India
961815,2023-04-18,507,washing machine,6990,16490,9500,1,00013,India
101355,2023-04-18,503,mixer,1349,3249,1900,1,00247,India
101355,2023-04-18,506,monitor,3249,8000,4751,1,00247,India
725455,2023-04-18,505,oven,18490,24000,5510,1,00096,India
144766,2023-04-18,504,iron,449,879,430,1,00083,India
341038,2023-04-18,504,iron,449,879,430,1,00031,India
341038,2023-04-18,505,oven,18490,24000,5510,1,00031,India
341038,2023-04-18,501,iphone 15,60000,80000,20000,1,00031,India
703058,2023-04-18,505,oven,18490,24000,5510,1,00428,India
703058,2023-04-18,503,mixer,1349,3249,1900,1,00428,India
351071,2023-04-18,506,monitor,3249,8000,4751,1,00097,India
351071,2023-04-18,502,iphone 15 pro max,100000,135000,35000,1,00097,India
351071,2023-04-18,501,iphone 15,60000,80000,20000,1,00097,India
351071,2023-04-18,507,washing machine,6990,16490,9500,1,00097,India
629486,2023-04-18,502,iphone 15 pro max,100000,135000,35000,1,00379,India
629486,2023-04-18,506,monitor,3249,8000,4751,1,00379,India
629486,2023-04-18,505,oven,18490,24000,5510,1,00379,India
942795,2023-04-18,504,iron,449,879,430,1,00177,India
942795,2023-04-18,502,iphone 15 pro max,100000,135000,35000,1,00177,India
540599,2023-04-18,501,iphone 15,60000,80000,20000,1,00464,India
540599,2023-04-18,504,iron,449,879,430,1,00464,India
540599,2023-04-18,507,washing machine,6990,16490,9500,1,00464,India
540599,2023-04-18,502,iphone 15 pro max,100000,135000,35000,1,00464,India
488046,2023-04-18,505,oven,18490,24000,5510,1,00344,India
801999,2023-04-18,504,iron,449,879,430,1,00381,India
697137,2023-04-18,502,iphone 15 pro max,100000,135000,35000,1,00415,India
697137,2023-04-18,503,mixer,1349,3249,1900,1,00415,India
697137,2023-04-18,506,monitor,3249,8000,4751,1,00415,India
697137,2023-04-18,507,washing machine,6990,16490,9500,1,00415,India
804525,2023-04-18,502,iphone 15 pro max,100000,135000,35000,1,00393,India
804525,2023-04-18,503,mixer,1349,3249,1900,1,00393,India
753492,2023-04-18,507,washing machine,6990,16490,9500,1,00347,India
753492,2023-04-18,503,mixer,1349,3249,1900,1,00347,India
660646,2023-04-18,501,iphone 15,60000,80000,20000,1,00284,India
254954,2023-04-18,501,iphone 15,60000,80000,20000,1,00408,India
254954,2023-04-18,506,monitor,3249,8000,4751,1,00408,India
254954,2023-04-18,502,iphone 15 pro max,100000,135000,35000,1,00408,India
526066,2023-04-18,506,monitor,3249,8000,4751,1,00490,India
458154,2023-04-18,501,iphone 15,60000,80000,20000,1,00176,India
458154,2023-04-18,505,oven,18490,24000,5510,1,00176,India
458154,2023-04-18,506,monitor,3249,8000,4751,1,00176,India
458154,2023-04-18,504,iron,449,879,430,1,00176,India
614300,2023-04-18,506,monitor,3249,8000,4751,1,00482,India
614300,2023-04-18,502,iphone 15 pro max,100000,135000,35000,1,00482,India
614300,2023-04-18,503,mixer,1349,3249,1900,1,00482,India
614300,2023-04-18,504,iron,449,879,430,1,00482,India
614300,2023-04-18,505,oven,18490,24000,5510,1,00482,India
458631,2023-04-18,505,oven,18490,24000,5510,1,00269,India
458631,2023-04-18,503,mixer,1349,3249,1900,1,00269,India
458631,2023-04-18,502,iphone 15 pro max,100000,135000,35000,1,00269,India
458631,2023-04-18,506,monitor,3249,8000,4751,1,00269,India
458631,2023-04-18,501,iphone 15,60000,80000,20000,1,00269,India
847531,2023-04-18,502,iphone 15 pro max,100000,135000,35000,1,00415,India
169879,2023-04-18,504,iron,449,879,430,1,00207,India
169879,2023-04-18,507,washing machine,6990,16490,9500,1,00207,India
263859,2023-04-18,506,monitor,3249,8000,4751,1,00072,India
263859,2023-04-18,501,iphone 15,60000,80000,20000,1,00072,India
263859,2023-04-18,505,oven,18490,24000,5510,1,00072,India
263859,2023-04-18,503,mixer,1349,3249,1900,1,00072,India
263859,2023-04-18,502,iphone 15 pro max,100000,135000,35000,1,00072,India
141867,2023-04-18,503,mixer,1349,3249,1900,1,00137,India
141867,2023-04-18,504,iron,449,879,430,1,00137,India
141867,2023-04-18,505,oven,18490,24000,5510,1,00137,India
893083,2023-04-18,507,washing machine,6990,16490,9500,1,00354,India
893083,2023-04-18,501,iphone 15,60000,80000,20000,1,00354,India
893083,2023-04-18,506,monitor,3249,8000,4751,1,00354,India
848153,2023-04-18,504,iron,449,879,430,1,00143,India
848153,2023-04-18,501,iphone 15,60000,80000,20000,1,00143,India
848153,2023-04-18,502,iphone 15 pro max,100000,135000,35000,1,00143,India
738214,2023-04-18,506,monitor,3249,8000,4751,1,00291,India
738214,2023-04-18,504,iron,449,879,430,1,00291,India
738214,2023-04-18,507,washing machine,6990,16490,9500,1,00291,India
738214,2023-04-18,502,iphone 15 pro max,100000,135000,35000,1,00291,India
322080,2023-04-18,504,iron,449,879,430,1,00108,India
322080,2023-04-18,502,iphone 15 pro max,100000,135000,35000,1,00108,India
303668,2023-04-18,502,iphone 15 pro max,100000,135000,35000,1,00210,India
303668,2023-04-18,501,iphone 15,60000,80000,20000,1,00210,India
303668,2023-04-18,506,monitor,3249,8000,4751,1,00210,India
713749,2023-04-18,506,monitor,3249,8000,4751,1,00402,India
713749,2023-04-18,504,iron,449,879,430,1,00402,India
713749,2023-04-18,501,iphone 15,60000,80000,20000,1,00402,India
437047,2023-04-18,507,washing machine,6990,16490,9500,1,00054,India
729622,2023-04-18,502,iphone 15 pro max,100000,135000,35000,1,00032,India
729622,2023-04-18,507,washing machine,6990,16490,9500,1,00032,India
729622,2023-04-18,506,monitor,3249,8000,4751,1,00032,India
502824,2023-04-18,502,iphone 15 pro max,100000,135000,35000,1,00154,India
383270,2023-04-18,505,oven,18490,24000,5510,1,00331,India
383270,2023-04-18,507,washing machine,6990,16490,9500,1,00331,India
383270,2023-04-18,502,iphone 15 pro max,100000,135000,35000,1,00331,India
210650,2023-04-18,502,iphone 15 pro max,100000,135000,35000,1,00433,India
210650,2023-04-18,505,oven,18490,24000,5510,1,00433,India
210650,2023-04-18,501,iphone 15,60000,80000,20000,1,00433,India
210650,2023-04-18,504,iron,449,879,430,1,00433,India
572240,2023-04-18,505,oven,18490,24000,5510,1,00029,India
572240,2023-04-18,501,iphone 15,60000,80000,20000,1,00029,India
572240,2023-04-18,506,monitor,3249,8000,4751,1,00029,India
965709,2023-04-18,504,iron,449,879,430,1,00390,India
965709,2023-04-18,505,oven,18490,24000,5510,1,00390,India
281730,2023-04-18,507,washing machine,6990,16490,9500,1,00375,India
281730,2023-04-18,501,iphone 15,60000,80000,20000,1,00375,India
281730,2023-04-18,505,oven,18490,24000,5510,1,00375,India
339390,2023-04-18,505,oven,18490,24000,5510,1,00500,India
339390,2023-04-18,502,iphone 15 pro max,100000,135000,35000,1,00500,India
339390,2023-04-18,503,mixer,1349,3249,1900,1,00500,India
339390,2023-04-18,507,washing machine,6990,16490,9500,1,00500,India
943788,2023-04-18,507,washing machine,6990,16490,9500,1,00026,India
489901,2023-04-18,503,mixer,1349,3249,1900,1,00450,India
489901,2023-04-18,501,iphone 15,60000,80000,20000,1,00450,India
489901,2023-04-18,505,oven,18490,24000,5510,1,00450,India
489901,2023-04-18,504,iron,449,879,430,1,00450,India
469498,2023-04-18,502,iphone 15 pro max,100000,135000,35000,1,00367,India
469498,2023-04-18,503,mixer,1349,3249,1900,1,00367,India
540803,2023-04-18,503,mixer,1349,3249,1900,1,00270,India
540803,2023-04-18,506,monitor,3249,8000,4751,1,00270,India
540803,2023-04-18,505,oven,18490,24000,5510,1,00270,India
540803,2023-04-18,501,iphone 15,60000,80000,20000,1,00270,India
915421,2023-04-18,507,washing machine,6990,16490,9500,1,00475,India
915421,2023-04-18,502,iphone 15 pro max,100000,135000,35000,1,00475,India
915421,2023-04-18,506,monitor,3249,8000,4751,1,00475,India
915421,2023-04-18,505,oven,18490,24000,5510,1,00475,India
656341,2023-04-18,501,iphone 15,60000,80000,20000,1,00387,India
656341,2023-04-18,507,washing machine,6990,16490,9500,1,00387,India
100715,2023-04-18,506,monitor,3249,8000,4751,1,00314,India
100715,2023-04-18,503,mixer,1349,3249,1900,1,00314,India
100715,2023-04-18,505,oven,18490,24000,5510,1,00314,India
100715,2023-04-18,501,iphone 15,60000,80000,20000,1,00314,India
632240,2023-04-18,505,oven,18490,24000,5510,1,00149,India
632240,2023-04-18,504,iron,449,879,430,1,00149,India
210819,2023-04-18,505,oven,18490,24000,5510,1,00486,India
210819,2023-04-18,503,mixer,1349,3249,1900,1,00486,India
210819,2023-04-18,507,washing machine,6990,16490,9500,1,00486,India
687066,2023-04-18,506,monitor,3249,8000,4751,1,00375,India
923988,2023-04-18,504,iron,449,879,430,1,00024,India
923988,2023-04-18,503,mixer,1349,3249,1900,1,00024,India
923988,2023-04-18,501,iphone 15,60000,80000,20000,1,00024,India
923988,2023-04-18,505,oven,18490,24000,5510,1,00024,India
618660,2023-04-18,502,iphone 15 pro max,100000,135000,35000,1,00178,India
548389,2023-04-18,507,washing machine,6990,16490,9500,1,00328,India
548389,2023-04-18,506,monitor,3249,8000,4751,1,00328,India
885296,2023-04-18,504,iron,449,879,430,1,00292,India
885296,2023-04-18,502,iphone 15 pro max,100000,135000,35000,1,00292,India
885296,2023-04-18,503,mixer,1349,3249,1900,1,00292,India
389630,2023-04-18,507,washing machine,6990,16490,9500,1,00356,India
225167,2023-04-18,504,iron,449,879,430,1,00361,India
225167,2023-04-18,507,washing machine,6990,16490,9500,1,00361,India
225167,2023-04-18,506,monitor,3249,8000,4751,1,00361,India
540502,2023-04-18,504,iron,449,879,430,1,00121,India
540502,2023-04-18,503,mixer,1349,3249,1900,1,00121,India
540502,2023-04-18,506,monitor,3249,8000,4751,1,00121,India
540502,2023-04-18,505,oven,18490,24000,5510,1,00121,India
495466,2023-04-18,501,iphone 15,60000,80000,20000,1,00115,India
495466,2023-04-18,507,washing machine,6990,16490,9500,1,00115,India
495466,2023-04-18,506,monitor,3249,8000,4751,1,00115,India
720138,2023-04-18,502,iphone 15 pro max,100000,135000,35000,1,00232,India
720138,2023-04-18,507,washing machine,6990,16490,9500,1,00232,India
720138,2023-04-18,506,monitor,3249,8000,4751,1,00232,India
650497,2023-04-18,502,iphone 15 pro max,100000,135000,35000,1,00040,India
650497,2023-04-18,506,monitor,3249,8000,4751,1,00040,India
650497,2023-04-18,507,washing machine,6990,16490,9500,1,00040,India
935655,2023-04-18,502,iphone 15 pro max,100000,135000,35000,1,00107,India
935655,2023-04-18,507,washing machine,6990,16490,9500,1,00107,India
935655,2023-04-18,504,iron,449,879,430,1,00107,India
935655,2023-04-18,505,oven,18490,24000,5510,1,00107,India
773379,2023-04-18,501,iphone 15,60000,80000,20000,1,00216,India
773379,2023-04-18,506,monitor,3249,8000,4751,1,00216,India
773379,2023-04-18,502,iphone 15 pro max,100000,135000,35000,1,00216,India
773379,2023-04-18,503,mixer,1349,3249,1900,1,00216,India
501030,2023-04-18,506,monitor,3249,8000,4751,1,00324,India
501030,2023-04-18,501,iphone 15,60000,80000,20000,1,00324,India
186354,2023-04-18,501,iphone 15,60000,80000,20000,1,00413,India
186354,2023-04-18,503,mixer,1349,3249,1900,1,00413,India
186354,2023-04-18,505,oven,18490,24000,5510,1,00413,India
909114,2023-04-18,503,mixer,1349,3249,1900,1,00055,India
909114,2023-04-18,504,iron,449,879,430,1,00055,India
279564,2023-04-18,506,monitor,3249,8000,4751,1,00350,India
279564,2023-04-18,507,washing machine,6990,16490,9500,1,00350,India
839409,2023-04-18,504,iron,449,879,430,1,00415,India
839409,2023-04-18,505,oven,18490,24000,5510,1,00415,India
839409,2023-04-18,501,iphone 15,60000,80000,20000,1,00415,India
839409,2023-04-18,502,iphone 15 pro max,100000,135000,35000,1,00415,India
975794,2023-04-18,501,iphone 15,60000,80000,20000,1,00409,India
975794,2023-04-18,503,mixer,1349,3249,1900,1,00409,India
975794,2023-04-18,502,iphone 15 pro max,100000,135000,35000,1,00409,India
116004,2023-04-18,504,iron,449,879,430,1,00137,India
185556,2023-04-18,502,iphone 15 pro max,100000,135000,35000,1,00057,India
902522,2023-04-18,503,mixer,1349,3249,1900,1,00276,India
902522,2023-04-18,502,iphone 15 pro max,100000,135000,35000,1,00276,India
902522,2023-04-18,506,monitor,3249,8000,4751,1,00276,India
574673,2023-04-18,501,iphone 15,60000,80000,20000,1,00015,India
574673,2023-04-18,507,washing machine,6990,16490,9500,1,00015,India
574673,2023-04-18,503,mixer,1349,3249,1900,1,00015,India
574673,2023-04-18,502,iphone 15 pro max,100000,135000,35000,1,00015,India
329181,2023-04-18,507,washing machine,6990,16490,9500,1,00061,India
809853,2023-04-18,504,iron,449,879,430,1,00037,India
809853,2023-04-18,506,monitor,3249,8000,4751,1,00037,India
678886,2023-04-18,503,mixer,1349,3249,1900,1,00123,India
678886,2023-04-18,504,iron,449,879,430,1,00123,India
678886,2023-04-18,502,iphone 15 pro max,100000,135000,35000,1,00123,India
116604,2023-04-18,503,mixer,1349,3249,1900,1,00382,India
116604,2023-04-18,504,iron,449,879,430,1,00382,India
116604,2023-04-18,501,iphone 15,60000,80000,20000,1,00382,India
116604,2023-04-18,507,washing machine,6990,16490,9500,1,00382,India
263748,2023-04-18,507,washing machine,6990,16490,9500,1,00206,India
313502,2023-04-18,507,washing machine,6990,16490,9500,1,00341,India
313502,2023-04-18,504,iron,449,879,430,1,00341,India
617538,2023-04-18,507,washing machine,6990,16490,9500,1,00473,India
617538,2023-04-18,502,iphone 15 pro max,100000,135000,35000,1,00473,India
617538,2023-04-18,504,iron,449,879,430,1,00473,India
373219,2023-04-18,502,iphone 15 pro max,100000,135000,35000,1,00235,India
373219,2023-04-18,507,washing machine,6990,16490,9500,1,00235,India
373219,2023-04-18,505,oven,18490,24000,5510,1,00235,India
243048,2023-04-18,505,oven,18490,24000,5510,1,00487,India
637246,2023-04-18,504,iron,449,879,430,1,00491,India
637246,2023-04-18,505,oven,18490,24000,5510,1,00491,India
225510,2023-04-18,502,iphone 15 pro max,100000,135000,35000,1,00334,India
225510,2023-04-18,505,oven,18490,24000,5510,1,00334,India
225510,2023-04-18,504,iron,449,879,430,1,00334,India
192568,2023-04-18,501,iphone 15,60000,80000,20000,1,00350,India
192568,2023-04-18,507,washing machine,6990,16490,9500,1,00350,India
192568,2023-04-18,504,iron,449,879,430,1,00350,India
724110,2023-04-18,503,mixer,1349,3249,1900,1,00047,India
724110,2023-04-18,504,iron,449,879,430,1,00047,India
724110,2023-04-18,502,iphone 15 pro max,100000,135000,35000,1,00047,India
724110,2023-04-18,506,monitor,3249,8000,4751,1,00047,India
708447,2023-04-18,503,mixer,1349,3249,1900,1,00079,India
221644,2023-04-18,505,oven,18490,24000,5510,1,00044,India
357950,2023-04-18,503,mixer,1349,3249,1900,1,00057,India
357950,2023-04-18,502,iphone 15 pro max,100000,135000,35000,1,00057,India
357950,2023-04-18,507,washing machine,6990,16490,9500,1,00057,India
501708,2023-04-18,504,iron,449,879,430,1,00188,India
627216,2023-04-18,502,iphone 15 pro max,100000,135000,35000,1,00028,India
627216,2023-04-18,503,mixer,1349,3249,1900,1,00028,India
627216,2023-04-18,504,iron,449,879,430,1,00028,India
627216,2023-04-18,507,washing machine,6990,16490,9500,1,00028,India
627216,2023-04-18,501,iphone 15,60000,80000,20000,1,00028,India
489554,2023-04-18,501,iphone 15,60000,80000,20000,1,00103,India
426720,2023-04-19,507,washing machine,6990,16490,9500,1,00228,India
298700,2023-04-19,507,washing machine,6990,16490,9500,1,00028,India
298700,2023-04-19,501,iphone 15,60000,80000,20000,1,00028,India
298700,2023-04-19,505,oven,18490,24000,5510,1,00028,India
616982,2023-04-19,503,mixer,1349,3249,1900,1,00146,India
616982,2023-04-19,505,oven,18490,24000,5510,1,00146,India
399145,2023-04-19,502,iphone 15 pro max,100000,135000,35000,1,00414,India
167086,2023-04-19,504,iron,449,879,430,1,00391,India
167086,2023-04-19,505,oven,18490,24000,5510,1,00391,India
167086,2023-04-19,506,monitor,3249,8000,4751,1,00391,India
143898,2023-04-19,506,monitor,3249,8000,4751,1,00019,India
143898,2023-04-19,505,oven,18490,24000,5510,1,00019,India
217303,2023-04-19,506,monitor,3249,8000,4751,1,00232,India
217303,2023-04-19,501,iphone 15,60000,80000,20000,1,00232,India
920916,2023-04-19,501,iphone 15,60000,80000,20000,1,00029,India
920916,2023-04-19,507,washing machine,6990,16490,9500,1,00029,India
920916,2023-04-19,505,oven,18490,24000,5510,1,00029,India
559855,2023-04-19,505,oven,18490,24000,5510,1,00297,India
559855,2023-04-19,504,iron,449,879,430,1,00297,India
559855,2023-04-19,506,monitor,3249,8000,4751,1,00297,India
485176,2023-04-19,505,oven,18490,24000,5510,1,00469,India
485176,2023-04-19,502,iphone 15 pro max,100000,135000,35000,1,00469,India
485176,2023-04-19,503,mixer,1349,3249,1900,1,00469,India
485176,2023-04-19,507,washing machine,6990,16490,9500,1,00469,India
633164,2023-04-19,505,oven,18490,24000,5510,1,00323,India
633164,2023-04-19,501,iphone 15,60000,80000,20000,1,00323,India
633164,2023-04-19,506,monitor,3249,8000,4751,1,00323,India
582356,2023-04-19,507,washing machine,6990,16490,9500,1,00326,India
582356,2023-04-19,501,iphone 15,60000,80000,20000,1,00326,India
786662,2023-04-19,502,iphone 15 pro max,100000,135000,35000,1,00070,India
786662,2023-04-19,501,iphone 15,60000,80000,20000,1,00070,India
786662,2023-04-19,506,monitor,3249,8000,4751,1,00070,India
786662,2023-04-19,505,oven,18490,24000,5510,1,00070,India
329938,2023-04-19,506,monitor,3249,8000,4751,1,00064,India
329938,2023-04-19,507,washing machine,6990,16490,9500,1,00064,India
329938,2023-04-19,502,iphone 15 pro max,100000,135000,35000,1,00064,India
139257,2023-04-19,506,monitor,3249,8000,4751,1,00369,India
139257,2023-04-19,501,iphone 15,60000,80000,20000,1,00369,India
139257,2023-04-19,507,washing machine,6990,16490,9500,1,00369,India
139257,2023-04-19,504,iron,449,879,430,1,00369,India
647004,2023-04-19,503,mixer,1349,3249,1900,1,00031,India
647004,2023-04-19,504,iron,449,879,430,1,00031,India
741930,2023-04-19,507,washing machine,6990,16490,9500,1,00418,India
741930,2023-04-19,503,mixer,1349,3249,1900,1,00418,India
741930,2023-04-19,505,oven,18490,24000,5510,1,00418,India
253886,2023-04-19,503,mixer,1349,3249,1900,1,00039,India
253886,2023-04-19,504,iron,449,879,430,1,00039,India
253886,2023-04-19,501,iphone 15,60000,80000,20000,1,00039,India
799778,2023-04-19,502,iphone 15 pro max,100000,135000,35000,1,00472,India
799778,2023-04-19,506,monitor,3249,8000,4751,1,00472,India
922511,2023-04-19,502,iphone 15 pro max,100000,135000,35000,1,00284,India
758045,2023-04-19,502,iphone 15 pro max,100000,135000,35000,1,00240,India
758045,2023-04-19,504,iron,449,879,430,1,00240,India
697016,2023-04-19,503,mixer,1349,3249,1900,1,00409,India
697016,2023-04-19,506,monitor,3249,8000,4751,1,00409,India
697016,2023-04-19,502,iphone 15 pro max,100000,135000,35000,1,00409,India
697016,2023-04-19,504,iron,449,879,430,1,00409,India
394162,2023-04-19,503,mixer,1349,3249,1900,1,00203,India
394162,2023-04-19,504,iron,449,879,430,1,00203,India
394162,2023-04-19,505,oven,18490,24000,5510,1,00203,India
394162,2023-04-19,506,monitor,3249,8000,4751,1,00203,India
394162,2023-04-19,507,washing machine,6990,16490,9500,1,00203,India
692313,2023-04-19,501,iphone 15,60000,80000,20000,1,00286,India
692313,2023-04-19,502,iphone 15 pro max,100000,135000,35000,1,00286,India
692313,2023-04-19,503,mixer,1349,3249,1900,1,00286,India
692313,2023-04-19,505,oven,18490,24000,5510,1,00286,India
146061,2023-04-19,505,oven,18490,24000,5510,1,00391,India
146061,2023-04-19,501,iphone 15,60000,80000,20000,1,00391,India
146061,2023-04-19,503,mixer,1349,3249,1900,1,00391,India
146061,2023-04-19,507,washing machine,6990,16490,9500,1,00391,India
934933,2023-04-19,505,oven,18490,24000,5510,1,00341,India
162358,2023-04-19,502,iphone 15 pro max,100000,135000,35000,1,00446,India
162358,2023-04-19,503,mixer,1349,3249,1900,1,00446,India
665938,2023-04-19,505,oven,18490,24000,5510,1,00485,India
665938,2023-04-19,503,mixer,1349,3249,1900,1,00485,India
116743,2023-04-19,506,monitor,3249,8000,4751,1,00166,India
116743,2023-04-19,501,iphone 15,60000,80000,20000,1,00166,India
116743,2023-04-19,507,washing machine,6990,16490,9500,1,00166,India
409900,2023-04-19,507,washing machine,6990,16490,9500,1,00488,India
409900,2023-04-19,506,monitor,3249,8000,4751,1,00488,India
970351,2023-04-19,504,iron,449,879,430,1,00333,India
970351,2023-04-19,501,iphone 15,60000,80000,20000,1,00333,India
155815,2023-04-19,506,monitor,3249,8000,4751,1,00477,India
155815,2023-04-19,502,iphone 15 pro max,100000,135000,35000,1,00477,India
155815,2023-04-19,507,washing machine,6990,16490,9500,1,00477,India
879581,2023-04-19,506,monitor,3249,8000,4751,1,00043,India
879581,2023-04-19,507,washing machine,6990,16490,9500,1,00043,India
879581,2023-04-19,501,iphone 15,60000,80000,20000,1,00043,India
333600,2023-04-19,504,iron,449,879,430,1,00079,India
333600,2023-04-19,501,iphone 15,60000,80000,20000,1,00079,India
333600,2023-04-19,502,iphone 15 pro max,100000,135000,35000,1,00079,India
333600,2023-04-19,503,mixer,1349,3249,1900,1,00079,India
333600,2023-04-19,507,washing machine,6990,16490,9500,1,00079,India
353357,2023-04-19,507,washing machine,6990,16490,9500,1,00331,India
353357,2023-04-19,505,oven,18490,24000,5510,1,00331,India
503709,2023-04-19,505,oven,18490,24000,5510,1,00246,India
503709,2023-04-19,507,washing machine,6990,16490,9500,1,00246,India
303588,2023-04-19,504,iron,449,879,430,1,00389,India
303588,2023-04-19,507,washing machine,6990,16490,9500,1,00389,India
303588,2023-04-19,503,mixer,1349,3249,1900,1,00389,India
303588,2023-04-19,505,oven,18490,24000,5510,1,00389,India
614159,2023-04-19,502,iphone 15 pro max,100000,135000,35000,1,00454,India
614159,2023-04-19,501,iphone 15,60000,80000,20000,1,00454,India
161013,2023-04-19,503,mixer,1349,3249,1900,1,00210,India
161013,2023-04-19,501,iphone 15,60000,80000,20000,1,00210,India
161013,2023-04-19,502,iphone 15 pro max,100000,135000,35000,1,00210,India
850148,2023-04-19,507,washing machine,6990,16490,9500,1,00076,India
850148,2023-04-19,504,iron,449,879,430,1,00076,India
850148,2023-04-19,501,iphone 15,60000,80000,20000,1,00076,India
264428,2023-04-19,505,oven,18490,24000,5510,1,00140,India
264428,2023-04-19,501,iphone 15,60000,80000,20000,1,00140,India
892041,2023-04-19,506,monitor,3249,8000,4751,1,00334,India
892041,2023-04-19,505,oven,18490,24000,5510,1,00334,India
392371,2023-04-19,506,monitor,3249,8000,4751,1,00289,India
392371,2023-04-19,504,iron,449,879,430,1,00289,India
392371,2023-04-19,501,iphone 15,60000,80000,20000,1,00289,India
392371,2023-04-19,505,oven,18490,24000,5510,1,00289,India
693606,2023-04-19,505,oven,18490,24000,5510,1,00408,India
375834,2023-04-19,506,monitor,3249,8000,4751,1,00454,India
375834,2023-04-19,503,mixer,1349,3249,1900,1,00454,India
375834,2023-04-19,501,iphone 15,60000,80000,20000,1,00454,India
375834,2023-04-19,507,washing machine,6990,16490,9500,1,00454,India
899245,2023-04-19,505,oven,18490,24000,5510,1,00324,India
899245,2023-04-19,503,mixer,1349,3249,1900,1,00324,India
899245,2023-04-19,506,monitor,3249,8000,4751,1,00324,India
899245,2023-04-19,504,iron,449,879,430,1,00324,India
598089,2023-04-19,503,mixer,1349,3249,1900,1,00333,India
598089,2023-04-19,504,iron,449,879,430,1,00333,India
598089,2023-04-19,502,iphone 15 pro max,100000,135000,35000,1,00333,India
865993,2023-04-19,502,iphone 15 pro max,100000,135000,35000,1,00110,India
865993,2023-04-19,505,oven,18490,24000,5510,1,00110,India
865993,2023-04-19,504,iron,449,879,430,1,00110,India
698976,2023-04-19,502,iphone 15 pro max,100000,135000,35000,1,00466,India
698976,2023-04-19,501,iphone 15,60000,80000,20000,1,00466,India
698976,2023-04-19,506,monitor,3249,8000,4751,1,00466,India
188310,2023-04-19,507,washing machine,6990,16490,9500,1,00007,India
188310,2023-04-19,503,mixer,1349,3249,1900,1,00007,India
430222,2023-04-19,506,monitor,3249,8000,4751,1,00157,India
430222,2023-04-19,507,washing machine,6990,16490,9500,1,00157,India
430222,2023-04-19,501,iphone 15,60000,80000,20000,1,00157,India
515201,2023-04-19,506,monitor,3249,8000,4751,1,00334,India
515201,2023-04-19,505,oven,18490,24000,5510,1,00334,India
515201,2023-04-19,502,iphone 15 pro max,100000,135000,35000,1,00334,India
712798,2023-04-20,507,washing machine,6990,16490,9500,1,00429,India
471288,2023-04-20,505,oven,18490,24000,5510,1,00103,India
364236,2023-04-20,501,iphone 15,60000,80000,20000,1,00005,India
364236,2023-04-20,502,iphone 15 pro max,100000,135000,35000,1,00005,India
471270,2023-04-20,504,iron,449,879,430,1,00444,India
471270,2023-04-20,503,mixer,1349,3249,1900,1,00444,India
471270,2023-04-20,502,iphone 15 pro max,100000,135000,35000,1,00444,India
471270,2023-04-20,507,washing machine,6990,16490,9500,1,00444,India
148775,2023-04-20,507,washing machine,6990,16490,9500,1,00080,India
148775,2023-04-20,501,iphone 15,60000,80000,20000,1,00080,India
860017,2023-04-20,501,iphone 15,60000,80000,20000,1,00373,India
860017,2023-04-20,505,oven,18490,24000,5510,1,00373,India
608737,2023-04-20,503,mixer,1349,3249,1900,1,00116,India
608737,2023-04-20,501,iphone 15,60000,80000,20000,1,00116,India
608737,2023-04-20,506,monitor,3249,8000,4751,1,00116,India
699406,2023-04-20,507,washing machine,6990,16490,9500,1,00447,India
699406,2023-04-20,505,oven,18490,24000,5510,1,00447,India
699406,2023-04-20,502,iphone 15 pro max,100000,135000,35000,1,00447,India
922278,2023-04-20,505,oven,18490,24000,5510,1,00352,India
922278,2023-04-20,506,monitor,3249,8000,4751,1,00352,India
397588,2023-04-20,506,monitor,3249,8000,4751,1,00001,India
397588,2023-04-20,505,oven,18490,24000,5510,1,00001,India
506890,2023-04-20,501,iphone 15,60000,80000,20000,1,00451,India
506890,2023-04-20,502,iphone 15 pro max,100000,135000,35000,1,00451,India
506890,2023-04-20,505,oven,18490,24000,5510,1,00451,India
285544,2023-04-20,502,iphone 15 pro max,100000,135000,35000,1,00332,India
285544,2023-04-20,506,monitor,3249,8000,4751,1,00332,India
741141,2023-04-20,502,iphone 15 pro max,100000,135000,35000,1,00180,India
741141,2023-04-20,501,iphone 15,60000,80000,20000,1,00180,India
741141,2023-04-20,505,oven,18490,24000,5510,1,00180,India
741141,2023-04-20,504,iron,449,879,430,1,00180,India
332296,2023-04-20,505,oven,18490,24000,5510,1,00135,India
334897,2023-04-20,502,iphone 15 pro max,100000,135000,35000,1,00206,India
334897,2023-04-20,507,washing machine,6990,16490,9500,1,00206,India
334897,2023-04-20,504,iron,449,879,430,1,00206,India
422796,2023-04-20,505,oven,18490,24000,5510,1,00048,India
422796,2023-04-20,506,monitor,3249,8000,4751,1,00048,India
422796,2023-04-20,507,washing machine,6990,16490,9500,1,00048,India
252253,2023-04-20,501,iphone 15,60000,80000,20000,1,00128,India
252253,2023-04-20,505,oven,18490,24000,5510,1,00128,India
252253,2023-04-20,504,iron,449,879,430,1,00128,India
865753,2023-04-20,503,mixer,1349,3249,1900,1,00416,India
865753,2023-04-20,501,iphone 15,60000,80000,20000,1,00416,India
590502,2023-04-20,506,monitor,3249,8000,4751,1,00309,India
590502,2023-04-20,504,iron,449,879,430,1,00309,India
590502,2023-04-20,502,iphone 15 pro max,100000,135000,35000,1,00309,India
590502,2023-04-20,503,mixer,1349,3249,1900,1,00309,India
648980,2023-04-20,505,oven,18490,24000,5510,1,00169,India
648980,2023-04-20,506,monitor,3249,8000,4751,1,00169,India
648980,2023-04-20,502,iphone 15 pro max,100000,135000,35000,1,00169,India
648980,2023-04-20,501,iphone 15,60000,80000,20000,1,00169,India
396241,2023-04-20,505,oven,18490,24000,5510,1,00385,India
396241,2023-04-20,506,monitor,3249,8000,4751,1,00385,India
396241,2023-04-20,507,washing machine,6990,16490,9500,1,00385,India
779580,2023-04-20,506,monitor,3249,8000,4751,1,00045,India
779580,2023-04-20,502,iphone 15 pro max,100000,135000,35000,1,00045,India
779580,2023-04-20,501,iphone 15,60000,80000,20000,1,00045,India
779580,2023-04-20,507,washing machine,6990,16490,9500,1,00045,India
779580,2023-04-20,503,mixer,1349,3249,1900,1,00045,India
154539,2023-04-20,505,oven,18490,24000,5510,1,00478,India
154539,2023-04-20,502,iphone 15 pro max,100000,135000,35000,1,00478,India
154539,2023-04-20,504,iron,449,879,430,1,00478,India
154539,2023-04-20,503,mixer,1349,3249,1900,1,00478,India
570588,2023-04-20,504,iron,449,879,430,1,00175,India
446202,2023-04-20,503,mixer,1349,3249,1900,1,00168,India
874091,2023-04-20,502,iphone 15 pro max,100000,135000,35000,1,00209,India
874091,2023-04-20,506,monitor,3249,8000,4751,1,00209,India
342637,2023-04-20,507,washing machine,6990,16490,9500,1,00242,India
342637,2023-04-20,504,iron,449,879,430,1,00242,India
342637,2023-04-20,506,monitor,3249,8000,4751,1,00242,India
342637,2023-04-20,502,iphone 15 pro max,100000,135000,35000,1,00242,India
567437,2023-04-20,505,oven,18490,24000,5510,1,00282,India
567437,2023-04-20,503,mixer,1349,3249,1900,1,00282,India
567437,2023-04-20,502,iphone 15 pro max,100000,135000,35000,1,00282,India
567437,2023-04-20,506,monitor,3249,8000,4751,1,00282,India
313100,2023-04-20,506,monitor,3249,8000,4751,1,00272,India
313100,2023-04-20,504,iron,449,879,430,1,00272,India
313100,2023-04-20,505,oven,18490,24000,5510,1,00272,India
313100,2023-04-20,501,iphone 15,60000,80000,20000,1,00272,India
962330,2023-04-20,504,iron,449,879,430,1,00406,India
962330,2023-04-20,506,monitor,3249,8000,4751,1,00406,India
356326,2023-04-20,504,iron,449,879,430,1,00371,India
568100,2023-04-20,505,oven,18490,24000,5510,1,00433,India
568100,2023-04-20,506,monitor,3249,8000,4751,1,00433,India
739216,2023-04-20,502,iphone 15 pro max,100000,135000,35000,1,00152,India
739216,2023-04-20,501,iphone 15,60000,80000,20000,1,00152,India
739216,2023-04-20,503,mixer,1349,3249,1900,1,00152,India
739216,2023-04-20,507,washing machine,6990,16490,9500,1,00152,India
896192,2023-04-20,506,monitor,3249,8000,4751,1,00064,India
896192,2023-04-20,504,iron,449,879,430,1,00064,India
896192,2023-04-20,501,iphone 15,60000,80000,20000,1,00064,India
896192,2023-04-20,505,oven,18490,24000,5510,1,00064,India
340712,2023-04-20,505,oven,18490,24000,5510,1,00237,India
182709,2023-04-20,507,washing machine,6990,16490,9500,1,00255,India
182709,2023-04-20,503,mixer,1349,3249,1900,1,00255,India
182709,2023-04-20,504,iron,449,879,430,1,00255,India
182709,2023-04-20,506,monitor,3249,8000,4751,1,00255,India
230922,2023-04-20,501,iphone 15,60000,80000,20000,1,00064,India
230922,2023-04-20,507,washing machine,6990,16490,9500,1,00064,India
230922,2023-04-20,506,monitor,3249,8000,4751,1,00064,India
230922,2023-04-20,505,oven,18490,24000,5510,1,00064,India
893510,2023-04-20,503,mixer,1349,3249,1900,1,00240,India
893510,2023-04-20,502,iphone 15 pro max,100000,135000,35000,1,00240,India
893510,2023-04-20,501,iphone 15,60000,80000,20000,1,00240,India
893510,2023-04-20,506,monitor,3249,8000,4751,1,00240,India
914904,2023-04-20,505,oven,18490,24000,5510,1,00191,India
914904,2023-04-20,507,washing machine,6990,16490,9500,1,00191,India
429503,2023-04-20,505,oven,18490,24000,5510,1,00329,India
429503,2023-04-20,503,mixer,1349,3249,1900,1,00329,India
383345,2023-04-20,504,iron,449,879,430,1,00361,India
383345,2023-04-20,507,washing machine,6990,16490,9500,1,00361,India
383345,2023-04-20,502,iphone 15 pro max,100000,135000,35000,1,00361,India
690937,2023-04-20,505,oven,18490,24000,5510,1,00038,India
690937,2023-04-20,507,washing machine,6990,16490,9500,1,00038,India
690937,2023-04-20,503,mixer,1349,3249,1900,1,00038,India
684613,2023-04-20,506,monitor,3249,8000,4751,1,00017,India
684613,2023-04-20,501,iphone 15,60000,80000,20000,1,00017,India
912550,2023-04-20,505,oven,18490,24000,5510,1,00013,India
745538,2023-04-20,502,iphone 15 pro max,100000,135000,35000,1,00399,India
288571,2023-04-20,504,iron,449,879,430,1,00132,India
881832,2023-04-20,501,iphone 15,60000,80000,20000,1,00208,India
798706,2023-04-20,506,monitor,3249,8000,4751,1,00111,India
798706,2023-04-20,505,oven,18490,24000,5510,1,00111,India
478105,2023-04-20,502,iphone 15 pro max,100000,135000,35000,1,00287,India
478105,2023-04-20,507,washing machine,6990,16490,9500,1,00287,India
478105,2023-04-20,505,oven,18490,24000,5510,1,00287,India
478105,2023-04-20,501,iphone 15,60000,80000,20000,1,00287,India
999651,2023-04-20,502,iphone 15 pro max,100000,135000,35000,1,00207,India
999651,2023-04-20,507,washing machine,6990,16490,9500,1,00207,India
999651,2023-04-20,506,monitor,3249,8000,4751,1,00207,India
201458,2023-04-20,501,iphone 15,60000,80000,20000,1,00240,India
201458,2023-04-20,502,iphone 15 pro max,100000,135000,35000,1,00240,India
201458,2023-04-20,507,washing machine,6990,16490,9500,1,00240,India
201458,2023-04-20,504,iron,449,879,430,1,00240,India
203227,2023-04-20,506,monitor,3249,8000,4751,1,00405,India
203227,2023-04-20,501,iphone 15,60000,80000,20000,1,00405,India
203227,2023-04-20,507,washing machine,6990,16490,9500,1,00405,India
450389,2023-04-20,502,iphone 15 pro max,100000,135000,35000,1,00069,India
450389,2023-04-20,503,mixer,1349,3249,1900,1,00069,India
450389,2023-04-20,506,monitor,3249,8000,4751,1,00069,India
953848,2023-04-20,505,oven,18490,24000,5510,1,00463,India
953848,2023-04-20,502,iphone 15 pro max,100000,135000,35000,1,00463,India
486417,2023-04-20,501,iphone 15,60000,80000,20000,1,00339,India
486417,2023-04-20,503,mixer,1349,3249,1900,1,00339,India
852563,2023-04-20,503,mixer,1349,3249,1900,1,00178,India
852563,2023-04-20,502,iphone 15 pro max,100000,135000,35000,1,00178,India
852563,2023-04-20,507,washing machine,6990,16490,9500,1,00178,India
184975,2023-04-20,506,monitor,3249,8000,4751,1,00258,India
184975,2023-04-20,501,iphone 15,60000,80000,20000,1,00258,India
184975,2023-04-20,502,iphone 15 pro max,100000,135000,35000,1,00258,India
184975,2023-04-20,507,washing machine,6990,16490,9500,1,00258,India
184975,2023-04-20,505,oven,18490,24000,5510,1,00258,India
326781,2023-04-20,507,washing machine,6990,16490,9500,1,00464,India
326781,2023-04-20,504,iron,449,879,430,1,00464,India
129820,2023-04-20,504,iron,449,879,430,1,00342,India
129820,2023-04-20,505,oven,18490,24000,5510,1,00342,India
298851,2023-04-20,501,iphone 15,60000,80000,20000,1,00073,India
298851,2023-04-20,502,iphone 15 pro max,100000,135000,35000,1,00073,India
322239,2023-04-20,507,washing machine,6990,16490,9500,1,00121,India
171043,2023-04-20,501,iphone 15,60000,80000,20000,1,00254,India
171043,2023-04-20,506,monitor,3249,8000,4751,1,00254,India
751789,2023-04-20,505,oven,18490,24000,5510,1,00480,India
751789,2023-04-20,506,monitor,3249,8000,4751,1,00480,India
147618,2023-04-20,503,mixer,1349,3249,1900,1,00344,India
952018,2023-04-20,506,monitor,3249,8000,4751,1,00203,India
952018,2023-04-20,502,iphone 15 pro max,100000,135000,35000,1,00203,India
952018,2023-04-20,503,mixer,1349,3249,1900,1,00203,India
952018,2023-04-20,505,oven,18490,24000,5510,1,00203,India
399351,2023-04-20,506,monitor,3249,8000,4751,1,00392,India
399351,2023-04-20,505,oven,18490,24000,5510,1,00392,India
399351,2023-04-20,503,mixer,1349,3249,1900,1,00392,India
399351,2023-04-20,502,iphone 15 pro max,100000,135000,35000,1,00392,India
408545,2023-04-20,503,mixer,1349,3249,1900,1,00428,India
480637,2023-04-20,504,iron,449,879,430,1,00397,India
484635,2023-04-20,507,washing machine,6990,16490,9500,1,00109,India
484635,2023-04-20,504,iron,449,879,430,1,00109,India
484635,2023-04-20,503,mixer,1349,3249,1900,1,00109,India
754784,2023-04-20,506,monitor,3249,8000,4751,1,00237,India
754784,2023-04-20,504,iron,449,879,430,1,00237,India
754784,2023-04-20,502,iphone 15 pro max,100000,135000,35000,1,00237,India
172748,2023-04-20,501,iphone 15,60000,80000,20000,1,00470,India
172748,2023-04-20,503,mixer,1349,3249,1900,1,00470,India
169262,2023-04-20,505,oven,18490,24000,5510,1,00310,India
169262,2023-04-20,507,washing machine,6990,16490,9500,1,00310,India
169262,2023-04-20,501,iphone 15,60000,80000,20000,1,00310,India
951497,2023-04-20,502,iphone 15 pro max,100000,135000,35000,1,00217,India
564959,2023-04-20,502,iphone 15 pro max,100000,135000,35000,1,00383,India
919277,2023-04-20,506,monitor,3249,8000,4751,1,00023,India
995292,2023-04-20,507,washing machine,6990,16490,9500,1,00202,India
995292,2023-04-20,501,iphone 15,60000,80000,20000,1,00202,India
995292,2023-04-20,503,mixer,1349,3249,1900,1,00202,India
832838,2023-04-20,504,iron,449,879,430,1,00039,India
892349,2023-04-20,502,iphone 15 pro max,100000,135000,35000,1,00351,India
512022,2023-04-20,507,washing machine,6990,16490,9500,1,00372,India
512022,2023-04-20,503,mixer,1349,3249,1900,1,00372,India
512022,2023-04-20,504,iron,449,879,430,1,00372,India
903021,2023-04-20,506,monitor,3249,8000,4751,1,00075,India
903021,2023-04-20,507,washing machine,6990,16490,9500,1,00075,India
953792,2023-04-20,501,iphone 15,60000,80000,20000,1,00388,India
953792,2023-04-20,506,monitor,3249,8000,4751,1,00388,India
953792,2023-04-20,503,mixer,1349,3249,1900,1,00388,India
639048,2023-04-20,502,iphone 15 pro max,100000,135000,35000,1,00372,India
639048,2023-04-20,503,mixer,1349,3249,1900,1,00372,India
639048,2023-04-20,504,iron,449,879,430,1,00372,India
639048,2023-04-20,505,oven,18490,24000,5510,1,00372,India
567646,2023-04-20,504,iron,449,879,430,1,00134,India
567646,2023-04-20,505,oven,18490,24000,5510,1,00134,India
342854,2023-04-20,502,iphone 15 pro max,100000,135000,35000,1,00110,India
342854,2023-04-20,501,iphone 15,60000,80000,20000,1,00110,India
203319,2023-04-20,503,mixer,1349,3249,1900,1,00367,India
203319,2023-04-20,506,monitor,3249,8000,4751,1,00367,India
203319,2023-04-20,501,iphone 15,60000,80000,20000,1,00367,India
110405,2023-04-20,507,washing machine,6990,16490,9500,1,00135,India
110405,2023-04-20,501,iphone 15,60000,80000,20000,1,00135,India
130298,2023-04-20,503,mixer,1349,3249,1900,1,00011,India
130298,2023-04-20,507,washing machine,6990,16490,9500,1,00011,India
114526,2023-04-20,501,iphone 15,60000,80000,20000,1,00129,India
519491,2023-04-20,502,iphone 15 pro max,100000,135000,35000,1,00255,India
519491,2023-04-20,504,iron,449,879,430,1,00255,India
519491,2023-04-20,506,monitor,3249,8000,4751,1,00255,India
864576,2023-04-21,506,monitor,3249,8000,4751,1,00217,India
864576,2023-04-21,503,mixer,1349,3249,1900,1,00217,India
864576,2023-04-21,501,iphone 15,60000,80000,20000,1,00217,India
864576,2023-04-21,502,iphone 15 pro max,100000,135000,35000,1,00217,India
692603,2023-04-21,507,washing machine,6990,16490,9500,1,00195,India
692603,2023-04-21,501,iphone 15,60000,80000,20000,1,00195,India
692603,2023-04-21,504,iron,449,879,430,1,00195,India
147427,2023-04-21,505,oven,18490,24000,5510,1,00486,India
147427,2023-04-21,504,iron,449,879,430,1,00486,India
147427,2023-04-21,507,washing machine,6990,16490,9500,1,00486,India
147427,2023-04-21,506,monitor,3249,8000,4751,1,00486,India
411933,2023-04-21,502,iphone 15 pro max,100000,135000,35000,1,00108,India
590953,2023-04-21,504,iron,449,879,430,1,00359,India
590953,2023-04-21,501,iphone 15,60000,80000,20000,1,00359,India
590953,2023-04-21,507,washing machine,6990,16490,9500,1,00359,India
381856,2023-04-21,507,washing machine,6990,16490,9500,1,00111,India
932508,2023-04-21,502,iphone 15 pro max,100000,135000,35000,1,00318,India
932508,2023-04-21,504,iron,449,879,430,1,00318,India
932508,2023-04-21,507,washing machine,6990,16490,9500,1,00318,India
837305,2023-04-21,507,washing machine,6990,16490,9500,1,00206,India
554201,2023-04-21,501,iphone 15,60000,80000,20000,1,00192,India
721135,2023-04-21,504,iron,449,879,430,1,00076,India
721135,2023-04-21,503,mixer,1349,3249,1900,1,00076,India
712610,2023-04-21,501,iphone 15,60000,80000,20000,1,00211,India
644465,2023-04-21,503,mixer,1349,3249,1900,1,00028,India
644465,2023-04-21,504,iron,449,879,430,1,00028,India
644465,2023-04-21,506,monitor,3249,8000,4751,1,00028,India
644465,2023-04-21,505,oven,18490,24000,5510,1,00028,India
546089,2023-04-21,505,oven,18490,24000,5510,1,00323,India
546089,2023-04-21,507,washing machine,6990,16490,9500,1,00323,India
412105,2023-04-21,504,iron,449,879,430,1,00428,India
412105,2023-04-21,507,washing machine,6990,16490,9500,1,00428,India
412105,2023-04-21,502,iphone 15 pro max,100000,135000,35000,1,00428,India
412105,2023-04-21,503,mixer,1349,3249,1900,1,00428,India
208424,2023-04-21,505,oven,18490,24000,5510,1,00125,India
208424,2023-04-21,503,mixer,1349,3249,1900,1,00125,India
208424,2023-04-21,504,iron,449,879,430,1,00125,India
301583,2023-04-21,506,monitor,3249,8000,4751,1,00180,India
301583,2023-04-21,504,iron,449,879,430,1,00180,India
661629,2023-04-21,505,oven,18490,24000,5510,1,00250,India
661629,2023-04-21,503,mixer,1349,3249,1900,1,00250,India
540928,2023-04-21,505,oven,18490,24000,5510,1,00488,India
883766,2023-04-21,504,iron,449,879,430,1,00161,India
883766,2023-04-21,503,mixer,1349,3249,1900,1,00161,India
883766,2023-04-21,506,monitor,3249,8000,4751,1,00161,India
883766,2023-04-21,502,iphone 15 pro max,100000,135000,35000,1,00161,India
945281,2023-04-21,507,washing machine,6990,16490,9500,1,00293,India
945281,2023-04-21,503,mixer,1349,3249,1900,1,00293,India
950118,2023-04-21,506,monitor,3249,8000,4751,1,00040,India
950118,2023-04-21,505,oven,18490,24000,5510,1,00040,India
950118,2023-04-21,502,iphone 15 pro max,100000,135000,35000,1,00040,India
213746,2023-04-21,501,iphone 15,60000,80000,20000,1,00075,India
154474,2023-04-21,504,iron,449,879,430,1,00370,India
154474,2023-04-21,506,monitor,3249,8000,4751,1,00370,India
154474,2023-04-21,507,washing machine,6990,16490,9500,1,00370,India
154474,2023-04-21,505,oven,18490,24000,5510,1,00370,India
435584,2023-04-21,506,monitor,3249,8000,4751,1,00272,India
761292,2023-04-21,505,oven,18490,24000,5510,1,00020,India
712952,2023-04-21,503,mixer,1349,3249,1900,1,00452,India
712952,2023-04-21,504,iron,449,879,430,1,00452,India
712952,2023-04-21,506,monitor,3249,8000,4751,1,00452,India
463574,2023-04-21,507,washing machine,6990,16490,9500,1,00272,India
463574,2023-04-21,506,monitor,3249,8000,4751,1,00272,India
463574,2023-04-21,502,iphone 15 pro max,100000,135000,35000,1,00272,India
463574,2023-04-21,505,oven,18490,24000,5510,1,00272,India
749799,2023-04-21,504,iron,449,879,430,1,00075,India
749799,2023-04-21,501,iphone 15,60000,80000,20000,1,00075,India
749799,2023-04-21,507,washing machine,6990,16490,9500,1,00075,India
703337,2023-04-21,504,iron,449,879,430,1,00250,India
703337,2023-04-21,506,monitor,3249,8000,4751,1,00250,India
703337,2023-04-21,507,washing machine,6990,16490,9500,1,00250,India
988787,2023-04-21,503,mixer,1349,3249,1900,1,00154,India
988787,2023-04-21,502,iphone 15 pro max,100000,135000,35000,1,00154,India
846719,2023-04-21,504,iron,449,879,430,1,00035,India
846719,2023-04-21,507,washing machine,6990,16490,9500,1,00035,India
138393,2023-04-21,502,iphone 15 pro max,100000,135000,35000,1,00034,India
138393,2023-04-21,505,oven,18490,24000,5510,1,00034,India
138393,2023-04-21,503,mixer,1349,3249,1900,1,00034,India
138393,2023-04-21,504,iron,449,879,430,1,00034,India
502979,2023-04-21,502,iphone 15 pro max,100000,135000,35000,1,00382,India
532347,2023-04-21,502,iphone 15 pro max,100000,135000,35000,1,00469,India
532347,2023-04-21,501,iphone 15,60000,80000,20000,1,00469,India
532347,2023-04-21,503,mixer,1349,3249,1900,1,00469,India
532347,2023-04-21,505,oven,18490,24000,5510,1,00469,India
812569,2023-04-21,502,iphone 15 pro max,100000,135000,35000,1,00119,India
853894,2023-04-21,506,monitor,3249,8000,4751,1,00245,India
853894,2023-04-21,504,iron,449,879,430,1,00245,India
853894,2023-04-21,501,iphone 15,60000,80000,20000,1,00245,India
238837,2023-04-21,503,mixer,1349,3249,1900,1,00442,India
952250,2023-04-21,502,iphone 15 pro max,100000,135000,35000,1,00306,India
952250,2023-04-21,503,mixer,1349,3249,1900,1,00306,India
458711,2023-04-21,504,iron,449,879,430,1,00420,India
458711,2023-04-21,507,washing machine,6990,16490,9500,1,00420,India
458711,2023-04-21,506,monitor,3249,8000,4751,1,00420,India
205413,2023-04-21,506,monitor,3249,8000,4751,1,00413,India
205413,2023-04-21,507,washing machine,6990,16490,9500,1,00413,India
845964,2023-04-21,504,iron,449,879,430,1,00015,India
785509,2023-04-21,501,iphone 15,60000,80000,20000,1,00372,India
785509,2023-04-21,504,iron,449,879,430,1,00372,India
785509,2023-04-21,506,monitor,3249,8000,4751,1,00372,India
971396,2023-04-21,505,oven,18490,24000,5510,1,00208,India
971396,2023-04-21,506,monitor,3249,8000,4751,1,00208,India
366901,2023-04-21,503,mixer,1349,3249,1900,1,00032,India
366901,2023-04-21,504,iron,449,879,430,1,00032,India
366901,2023-04-21,502,iphone 15 pro max,100000,135000,35000,1,00032,India
366901,2023-04-21,501,iphone 15,60000,80000,20000,1,00032,India
366901,2023-04-21,506,monitor,3249,8000,4751,1,00032,India
543486,2023-04-21,507,washing machine,6990,16490,9500,1,00487,India
543486,2023-04-21,505,oven,18490,24000,5510,1,00487,India
543486,2023-04-21,501,iphone 15,60000,80000,20000,1,00487,India
854492,2023-04-21,501,iphone 15,60000,80000,20000,1,00482,India
602184,2023-04-21,502,iphone 15 pro max,100000,135000,35000,1,00414,India
602184,2023-04-21,504,iron,449,879,430,1,00414,India
602184,2023-04-21,505,oven,18490,24000,5510,1,00414,India
602184,2023-04-21,507,washing machine,6990,16490,9500,1,00414,India
851069,2023-04-21,505,oven,18490,24000,5510,1,00246,India
851069,2023-04-21,504,iron,449,879,430,1,00246,India
851069,2023-04-21,501,iphone 15,60000,80000,20000,1,00246,India
851069,2023-04-21,502,iphone 15 pro max,100000,135000,35000,1,00246,India
675011,2023-04-21,504,iron,449,879,430,1,00065,India
377946,2023-04-21,503,mixer,1349,3249,1900,1,00015,India
377946,2023-04-21,502,iphone 15 pro max,100000,135000,35000,1,00015,India
641169,2023-04-21,501,iphone 15,60000,80000,20000,1,00366,India
641169,2023-04-21,507,washing machine,6990,16490,9500,1,00366,India
275581,2023-04-21,506,monitor,3249,8000,4751,1,00009,India
275581,2023-04-21,505,oven,18490,24000,5510,1,00009,India
275581,2023-04-21,502,iphone 15 pro max,100000,135000,35000,1,00009,India
275581,2023-04-21,503,mixer,1349,3249,1900,1,00009,India
316304,2023-04-21,503,mixer,1349,3249,1900,1,00434,India
316304,2023-04-21,504,iron,449,879,430,1,00434,India
316304,2023-04-21,505,oven,18490,24000,5510,1,00434,India
862106,2023-04-21,507,washing machine,6990,16490,9500,1,00278,India
862106,2023-04-21,506,monitor,3249,8000,4751,1,00278,India
862106,2023-04-21,505,oven,18490,24000,5510,1,00278,India
483690,2023-04-21,504,iron,449,879,430,1,00096,India
483690,2023-04-21,501,iphone 15,60000,80000,20000,1,00096,India
483690,2023-04-21,507,washing machine,6990,16490,9500,1,00096,India
483690,2023-04-21,502,iphone 15 pro max,100000,135000,35000,1,00096,India
136693,2023-04-21,501,iphone 15,60000,80000,20000,1,00409,India
146632,2023-04-21,504,iron,449,879,430,1,00043,India
146632,2023-04-21,503,mixer,1349,3249,1900,1,00043,India
146632,2023-04-21,506,monitor,3249,8000,4751,1,00043,India
146632,2023-04-21,501,iphone 15,60000,80000,20000,1,00043,India
146632,2023-04-21,505,oven,18490,24000,5510,1,00043,India
439131,2023-04-21,501,iphone 15,60000,80000,20000,1,00355,India
944628,2023-04-21,506,monitor,3249,8000,4751,1,00269,India
944628,2023-04-21,501,iphone 15,60000,80000,20000,1,00269,India
944628,2023-04-21,503,mixer,1349,3249,1900,1,00269,India
944628,2023-04-21,504,iron,449,879,430,1,00269,India
630257,2023-04-21,504,iron,449,879,430,1,00248,India
630257,2023-04-21,502,iphone 15 pro max,100000,135000,35000,1,00248,India
358509,2023-04-21,504,iron,449,879,430,1,00020,India
907282,2023-04-21,506,monitor,3249,8000,4751,1,00202,India
983623,2023-04-21,505,oven,18490,24000,5510,1,00080,India
983623,2023-04-21,504,iron,449,879,430,1,00080,India
983623,2023-04-21,506,monitor,3249,8000,4751,1,00080,India
983623,2023-04-21,507,washing machine,6990,16490,9500,1,00080,India
564406,2023-04-21,505,oven,18490,24000,5510,1,00106,India
564406,2023-04-21,507,washing machine,6990,16490,9500,1,00106,India
310818,2023-04-21,504,iron,449,879,430,1,00176,India
998165,2023-04-22,507,washing machine,6990,16490,9500,1,00020,India
998165,2023-04-22,502,iphone 15 pro max,100000,135000,35000,1,00020,India
998165,2023-04-22,503,mixer,1349,3249,1900,1,00020,India
295792,2023-04-22,502,iphone 15 pro max,100000,135000,35000,1,00382,India
675590,2023-04-22,503,mixer,1349,3249,1900,1,00374,India
675590,2023-04-22,507,washing machine,6990,16490,9500,1,00374,India
675590,2023-04-22,504,iron,449,879,430,1,00374,India
675590,2023-04-22,506,monitor,3249,8000,4751,1,00374,India
675590,2023-04-22,501,iphone 15,60000,80000,20000,1,00374,India
281487,2023-04-22,505,oven,18490,24000,5510,1,00417,India
281487,2023-04-22,502,iphone 15 pro max,100000,135000,35000,1,00417,India
281487,2023-04-22,506,monitor,3249,8000,4751,1,00417,India
776751,2023-04-22,503,mixer,1349,3249,1900,1,00262,India
776751,2023-04-22,504,iron,449,879,430,1,00262,India
776751,2023-04-22,506,monitor,3249,8000,4751,1,00262,India
848440,2023-04-22,504,iron,449,879,430,1,00177,India
848440,2023-04-22,505,oven,18490,24000,5510,1,00177,India
988501,2023-04-22,501,iphone 15,60000,80000,20000,1,00009,India
572813,2023-04-22,507,washing machine,6990,16490,9500,1,00140,India
572813,2023-04-22,502,iphone 15 pro max,100000,135000,35000,1,00140,India
572813,2023-04-22,504,iron,449,879,430,1,00140,India
238566,2023-04-22,501,iphone 15,60000,80000,20000,1,00262,India
238566,2023-04-22,504,iron,449,879,430,1,00262,India
238566,2023-04-22,506,monitor,3249,8000,4751,1,00262,India
238566,2023-04-22,502,iphone 15 pro max,100000,135000,35000,1,00262,India
434332,2023-04-22,503,mixer,1349,3249,1900,1,00134,India
434332,2023-04-22,502,iphone 15 pro max,100000,135000,35000,1,00134,India
434332,2023-04-22,501,iphone 15,60000,80000,20000,1,00134,India
455138,2023-04-22,501,iphone 15,60000,80000,20000,1,00218,India
455138,2023-04-22,504,iron,449,879,430,1,00218,India
455138,2023-04-22,507,washing machine,6990,16490,9500,1,00218,India
962760,2023-04-22,506,monitor,3249,8000,4751,1,00298,India
962760,2023-04-22,503,mixer,1349,3249,1900,1,00298,India
576487,2023-04-22,503,mixer,1349,3249,1900,1,00239,India
681709,2023-04-22,506,monitor,3249,8000,4751,1,00373,India
681709,2023-04-22,501,iphone 15,60000,80000,20000,1,00373,India
681709,2023-04-22,502,iphone 15 pro max,100000,135000,35000,1,00373,India
162241,2023-04-22,505,oven,18490,24000,5510,1,00326,India
162241,2023-04-22,507,washing machine,6990,16490,9500,1,00326,India
162241,2023-04-22,502,iphone 15 pro max,100000,135000,35000,1,00326,India
136984,2023-04-22,505,oven,18490,24000,5510,1,00163,India
136984,2023-04-22,501,iphone 15,60000,80000,20000,1,00163,India
570757,2023-04-22,501,iphone 15,60000,80000,20000,1,00117,India
570757,2023-04-22,507,washing machine,6990,16490,9500,1,00117,India
570757,2023-04-22,504,iron,449,879,430,1,00117,India
303469,2023-04-22,507,washing machine,6990,16490,9500,1,00071,India
839692,2023-04-22,503,mixer,1349,3249,1900,1,00261,India
839692,2023-04-22,505,oven,18490,24000,5510,1,00261,India
839692,2023-04-22,502,iphone 15 pro max,100000,135000,35000,1,00261,India
839692,2023-04-22,501,iphone 15,60000,80000,20000,1,00261,India
943352,2023-04-22,504,iron,449,879,430,1,00041,India
943352,2023-04-22,503,mixer,1349,3249,1900,1,00041,India
943352,2023-04-22,507,washing machine,6990,16490,9500,1,00041,India
713062,2023-04-22,503,mixer,1349,3249,1900,1,00217,India
713062,2023-04-22,501,iphone 15,60000,80000,20000,1,00217,India
950021,2023-04-22,505,oven,18490,24000,5510,1,00221,India
200242,2023-04-22,502,iphone 15 pro max,100000,135000,35000,1,00104,India
200242,2023-04-22,504,iron,449,879,430,1,00104,India
200242,2023-04-22,501,iphone 15,60000,80000,20000,1,00104,India
904703,2023-04-22,503,mixer,1349,3249,1900,1,00365,India
904703,2023-04-22,504,iron,449,879,430,1,00365,India
904703,2023-04-22,505,oven,18490,24000,5510,1,00365,India
678359,2023-04-22,506,monitor,3249,8000,4751,1,00258,India
678359,2023-04-22,505,oven,18490,24000,5510,1,00258,India
358542,2023-04-22,502,iphone 15 pro max,100000,135000,35000,1,00069,India
358542,2023-04-22,503,mixer,1349,3249,1900,1,00069,India
358542,2023-04-22,504,iron,449,879,430,1,00069,India
791543,2023-04-22,502,iphone 15 pro max,100000,135000,35000,1,00225,India
791543,2023-04-22,504,iron,449,879,430,1,00225,India
661789,2023-04-22,504,iron,449,879,430,1,00352,India
661789,2023-04-22,505,oven,18490,24000,5510,1,00352,India
661789,2023-04-22,503,mixer,1349,3249,1900,1,00352,India
661789,2023-04-22,501,iphone 15,60000,80000,20000,1,00352,India
850138,2023-04-22,503,mixer,1349,3249,1900,1,00198,India
850138,2023-04-22,501,iphone 15,60000,80000,20000,1,00198,India
807064,2023-04-22,501,iphone 15,60000,80000,20000,1,00104,India
807064,2023-04-22,503,mixer,1349,3249,1900,1,00104,India
365785,2023-04-22,504,iron,449,879,430,1,00366,India
365785,2023-04-22,503,mixer,1349,3249,1900,1,00366,India
140009,2023-04-22,507,washing machine,6990,16490,9500,1,00073,India
140009,2023-04-22,503,mixer,1349,3249,1900,1,00073,India
233613,2023-04-22,501,iphone 15,60000,80000,20000,1,00056,India
194329,2023-04-22,503,mixer,1349,3249,1900,1,00147,India
194329,2023-04-22,507,washing machine,6990,16490,9500,1,00147,India
915577,2023-04-22,502,iphone 15 pro max,100000,135000,35000,1,00287,India
915577,2023-04-22,501,iphone 15,60000,80000,20000,1,00287,India
915577,2023-04-22,505,oven,18490,24000,5510,1,00287,India
238252,2023-04-22,504,iron,449,879,430,1,00033,India
238252,2023-04-22,507,washing machine,6990,16490,9500,1,00033,India
238252,2023-04-22,502,iphone 15 pro max,100000,135000,35000,1,00033,India
238252,2023-04-22,501,iphone 15,60000,80000,20000,1,00033,India
706988,2023-04-22,505,oven,18490,24000,5510,1,00172,India
706988,2023-04-22,507,washing machine,6990,16490,9500,1,00172,India
741198,2023-04-22,503,mixer,1349,3249,1900,1,00201,India
166577,2023-04-22,501,iphone 15,60000,80000,20000,1,00388,India
166577,2023-04-22,504,iron,449,879,430,1,00388,India
166577,2023-04-22,506,monitor,3249,8000,4751,1,00388,India
381709,2023-04-22,506,monitor,3249,8000,4751,1,00469,India
381709,2023-04-22,504,iron,449,879,430,1,00469,India
381709,2023-04-22,502,iphone 15 pro max,100000,135000,35000,1,00469,India
759692,2023-04-22,505,oven,18490,24000,5510,1,00285,India
759692,2023-04-22,501,iphone 15,60000,80000,20000,1,00285,India
206263,2023-04-22,504,iron,449,879,430,1,00148,India
206263,2023-04-22,501,iphone 15,60000,80000,20000,1,00148,India
763338,2023-04-22,507,washing machine,6990,16490,9500,1,00208,India
422977,2023-04-22,501,iphone 15,60000,80000,20000,1,00171,India
422977,2023-04-22,502,iphone 15 pro max,100000,135000,35000,1,00171,India
422977,2023-04-22,507,washing machine,6990,16490,9500,1,00171,India
906526,2023-04-22,503,mixer,1349,3249,1900,1,00037,India
373476,2023-04-22,505,oven,18490,24000,5510,1,00275,India
597247,2023-04-22,502,iphone 15 pro max,100000,135000,35000,1,00206,India
597247,2023-04-22,503,mixer,1349,3249,1900,1,00206,India
597247,2023-04-22,506,monitor,3249,8000,4751,1,00206,India
441024,2023-04-22,503,mixer,1349,3249,1900,1,00143,India
441024,2023-04-22,501,iphone 15,60000,80000,20000,1,00143,India
441024,2023-04-22,505,oven,18490,24000,5510,1,00143,India
441024,2023-04-22,506,monitor,3249,8000,4751,1,00143,India
760654,2023-04-22,505,oven,18490,24000,5510,1,00044,India
760654,2023-04-22,506,monitor,3249,8000,4751,1,00044,India
760654,2023-04-22,503,mixer,1349,3249,1900,1,00044,India
204227,2023-04-22,501,iphone 15,60000,80000,20000,1,00438,India
872993,2023-04-22,502,iphone 15 pro max,100000,135000,35000,1,00339,India
872993,2023-04-22,504,iron,449,879,430,1,00339,India
635527,2023-04-22,504,iron,449,879,430,1,00374,India
635527,2023-04-22,507,washing machine,6990,16490,9500,1,00374,India
635527,2023-04-22,501,iphone 15,60000,80000,20000,1,00374,India
248305,2023-04-22,505,oven,18490,24000,5510,1,00430,India
210607,2023-04-22,507,washing machine,6990,16490,9500,1,00290,India
210607,2023-04-22,505,oven,18490,24000,5510,1,00290,India
210607,2023-04-22,502,iphone 15 pro max,100000,135000,35000,1,00290,India
568722,2023-04-22,506,monitor,3249,8000,4751,1,00080,India
568722,2023-04-22,507,washing machine,6990,16490,9500,1,00080,India
546787,2023-04-22,503,mixer,1349,3249,1900,1,00466,India
546787,2023-04-22,504,iron,449,879,430,1,00466,India
546787,2023-04-22,507,washing machine,6990,16490,9500,1,00466,India
546787,2023-04-22,502,iphone 15 pro max,100000,135000,35000,1,00466,India
251066,2023-04-22,502,iphone 15 pro max,100000,135000,35000,1,00279,India
265616,2023-04-22,503,mixer,1349,3249,1900,1,00221,India
265616,2023-04-22,504,iron,449,879,430,1,00221,India
151135,2023-04-22,504,iron,449,879,430,1,00467,India
151135,2023-04-22,505,oven,18490,24000,5510,1,00467,India
103814,2023-04-22,501,iphone 15,60000,80000,20000,1,00019,India
845962,2023-04-22,502,iphone 15 pro max,100000,135000,35000,1,00075,India
744266,2023-04-22,507,washing machine,6990,16490,9500,1,00119,India
744266,2023-04-22,503,mixer,1349,3249,1900,1,00119,India
136102,2023-04-22,502,iphone 15 pro max,100000,135000,35000,1,00374,India
136102,2023-04-22,505,oven,18490,24000,5510,1,00374,India
136102,2023-04-22,501,iphone 15,60000,80000,20000,1,00374,India
136102,2023-04-22,506,monitor,3249,8000,4751,1,00374,India
164987,2023-04-22,505,oven,18490,24000,5510,1,00034,India
164987,2023-04-22,504,iron,449,879,430,1,00034,India
164987,2023-04-22,502,iphone 15 pro max,100000,135000,35000,1,00034,India
164987,2023-04-22,507,washing machine,6990,16490,9500,1,00034,India
944660,2023-04-22,505,oven,18490,24000,5510,1,00271,India
324849,2023-04-22,507,washing machine,6990,16490,9500,1,00309,India
324849,2023-04-22,501,iphone 15,60000,80000,20000,1,00309,India
689926,2023-04-22,506,monitor,3249,8000,4751,1,00078,India
689926,2023-04-22,503,mixer,1349,3249,1900,1,00078,India
689926,2023-04-22,507,washing machine,6990,16490,9500,1,00078,India
689926,2023-04-22,501,iphone 15,60000,80000,20000,1,00078,India
876717,2023-04-22,505,oven,18490,24000,5510,1,00305,India
876717,2023-04-22,501,iphone 15,60000,80000,20000,1,00305,India
876717,2023-04-22,504,iron,449,879,430,1,00305,India
371122,2023-04-22,501,iphone 15,60000,80000,20000,1,00075,India
637944,2023-04-22,504,iron,449,879,430,1,00252,India
393030,2023-04-22,502,iphone 15 pro max,100000,135000,35000,1,00478,India
393030,2023-04-22,506,monitor,3249,8000,4751,1,00478,India
393030,2023-04-22,503,mixer,1349,3249,1900,1,00478,India
393030,2023-04-22,507,washing machine,6990,16490,9500,1,00478,India
670961,2023-04-22,505,oven,18490,24000,5510,1,00093,India
670961,2023-04-22,504,iron,449,879,430,1,00093,India
670961,2023-04-22,503,mixer,1349,3249,1900,1,00093,India
437061,2023-04-22,502,iphone 15 pro max,100000,135000,35000,1,00265,India
437061,2023-04-22,504,iron,449,879,430,1,00265,India
220110,2023-04-22,506,monitor,3249,8000,4751,1,00170,India
220110,2023-04-22,504,iron,449,879,430,1,00170,India
220110,2023-04-22,503,mixer,1349,3249,1900,1,00170,India
833156,2023-04-22,503,mixer,1349,3249,1900,1,00479,India
833156,2023-04-22,504,iron,449,879,430,1,00479,India
833156,2023-04-22,506,monitor,3249,8000,4751,1,00479,India
833156,2023-04-22,505,oven,18490,24000,5510,1,00479,India
275426,2023-04-22,504,iron,449,879,430,1,00139,India
375868,2023-04-22,502,iphone 15 pro max,100000,135000,35000,1,00464,India
375868,2023-04-22,501,iphone 15,60000,80000,20000,1,00464,India
985462,2023-04-22,505,oven,18490,24000,5510,1,00231,India
985462,2023-04-22,506,monitor,3249,8000,4751,1,00231,India
985462,2023-04-22,501,iphone 15,60000,80000,20000,1,00231,India
985462,2023-04-22,503,mixer,1349,3249,1900,1,00231,India
335171,2023-04-22,502,iphone 15 pro max,100000,135000,35000,1,00339,India
877735,2023-04-22,502,iphone 15 pro max,100000,135000,35000,1,00361,India
607111,2023-04-22,504,iron,449,879,430,1,00356,India
607111,2023-04-22,507,washing machine,6990,16490,9500,1,00356,India
607111,2023-04-22,502,iphone 15 pro max,100000,135000,35000,1,00356,India
607111,2023-04-22,501,iphone 15,60000,80000,20000,1,00356,India
909764,2023-04-22,503,mixer,1349,3249,1900,1,00423,India
909764,2023-04-22,506,monitor,3249,8000,4751,1,00423,India
909764,2023-04-22,501,iphone 15,60000,80000,20000,1,00423,India
514451,2023-04-22,505,oven,18490,24000,5510,1,00414,India
514451,2023-04-22,507,washing machine,6990,16490,9500,1,00414,India
514451,2023-04-22,506,monitor,3249,8000,4751,1,00414,India
404542,2023-04-23,503,mixer,1349,3249,1900,1,00335,India
404542,2023-04-23,505,oven,18490,24000,5510,1,00335,India
404542,2023-04-23,507,washing machine,6990,16490,9500,1,00335,India
344687,2023-04-23,506,monitor,3249,8000,4751,1,00041,India
383999,2023-04-23,503,mixer,1349,3249,1900,1,00435,India
622814,2023-04-23,501,iphone 15,60000,80000,20000,1,00120,India
622814,2023-04-23,507,washing machine,6990,16490,9500,1,00120,India
622814,2023-04-23,503,mixer,1349,3249,1900,1,00120,India
622814,2023-04-23,504,iron,449,879,430,1,00120,India
477822,2023-04-23,505,oven,18490,24000,5510,1,00199,India
477822,2023-04-23,501,iphone 15,60000,80000,20000,1,00199,India
477822,2023-04-23,504,iron,449,879,430,1,00199,India
477841,2023-04-23,503,mixer,1349,3249,1900,1,00490,India
477841,2023-04-23,507,washing machine,6990,16490,9500,1,00490,India
477841,2023-04-23,504,iron,449,879,430,1,00490,India
995679,2023-04-23,506,monitor,3249,8000,4751,1,00044,India
995679,2023-04-23,504,iron,449,879,430,1,00044,India
995679,2023-04-23,505,oven,18490,24000,5510,1,00044,India
995679,2023-04-23,503,mixer,1349,3249,1900,1,00044,India
932248,2023-04-23,506,monitor,3249,8000,4751,1,00289,India
329961,2023-04-23,501,iphone 15,60000,80000,20000,1,00408,India
329961,2023-04-23,507,washing machine,6990,16490,9500,1,00408,India
329961,2023-04-23,503,mixer,1349,3249,1900,1,00408,India
741036,2023-04-23,507,washing machine,6990,16490,9500,1,00003,India
741036,2023-04-23,503,mixer,1349,3249,1900,1,00003,India
741036,2023-04-23,504,iron,449,879,430,1,00003,India
770920,2023-04-23,503,mixer,1349,3249,1900,1,00274,India
770920,2023-04-23,502,iphone 15 pro max,100000,135000,35000,1,00274,India
505863,2023-04-23,503,mixer,1349,3249,1900,1,00010,India
955100,2023-04-23,507,washing machine,6990,16490,9500,1,00223,India
955100,2023-04-23,506,monitor,3249,8000,4751,1,00223,India
955100,2023-04-23,501,iphone 15,60000,80000,20000,1,00223,India
191148,2023-04-23,505,oven,18490,24000,5510,1,00290,India
191148,2023-04-23,503,mixer,1349,3249,1900,1,00290,India
191148,2023-04-23,506,monitor,3249,8000,4751,1,00290,India
191148,2023-04-23,507,washing machine,6990,16490,9500,1,00290,India
191148,2023-04-23,501,iphone 15,60000,80000,20000,1,00290,India
340416,2023-04-23,501,iphone 15,60000,80000,20000,1,00038,India
361557,2023-04-23,501,iphone 15,60000,80000,20000,1,00326,India
361557,2023-04-23,504,iron,449,879,430,1,00326,India
615109,2023-04-23,501,iphone 15,60000,80000,20000,1,00414,India
615109,2023-04-23,502,iphone 15 pro max,100000,135000,35000,1,00414,India
615109,2023-04-23,505,oven,18490,24000,5510,1,00414,India
615109,2023-04-23,506,monitor,3249,8000,4751,1,00414,India
637764,2023-04-23,501,iphone 15,60000,80000,20000,1,00437,India
637764,2023-04-23,504,iron,449,879,430,1,00437,India
936804,2023-04-23,502,iphone 15 pro max,100000,135000,35000,1,00363,India
159266,2023-04-23,507,washing machine,6990,16490,9500,1,00310,India
159266,2023-04-23,504,iron,449,879,430,1,00310,India
159266,2023-04-23,501,iphone 15,60000,80000,20000,1,00310,India
159266,2023-04-23,506,monitor,3249,8000,4751,1,00310,India
435424,2023-04-23,501,iphone 15,60000,80000,20000,1,00046,India
435424,2023-04-23,503,mixer,1349,3249,1900,1,00046,India
304415,2023-04-23,507,washing machine,6990,16490,9500,1,00126,India
304415,2023-04-23,503,mixer,1349,3249,1900,1,00126,India
304415,2023-04-23,504,iron,449,879,430,1,00126,India
304415,2023-04-23,502,iphone 15 pro max,100000,135000,35000,1,00126,India
620729,2023-04-23,503,mixer,1349,3249,1900,1,00254,India
413688,2023-04-23,503,mixer,1349,3249,1900,1,00173,India
246202,2023-04-23,504,iron,449,879,430,1,00297,India
246202,2023-04-23,503,mixer,1349,3249,1900,1,00297,India
246202,2023-04-23,507,washing machine,6990,16490,9500,1,00297,India
841025,2023-04-23,501,iphone 15,60000,80000,20000,1,00291,India
759264,2023-04-23,506,monitor,3249,8000,4751,1,00108,India
759264,2023-04-23,507,washing machine,6990,16490,9500,1,00108,India
759264,2023-04-23,501,iphone 15,60000,80000,20000,1,00108,India
118259,2023-04-23,506,monitor,3249,8000,4751,1,00400,India
118259,2023-04-23,502,iphone 15 pro max,100000,135000,35000,1,00400,India
118259,2023-04-23,505,oven,18490,24000,5510,1,00400,India
475132,2023-04-23,504,iron,449,879,430,1,00334,India
277710,2023-04-23,505,oven,18490,24000,5510,1,00176,India
277710,2023-04-23,504,iron,449,879,430,1,00176,India
222666,2023-04-23,506,monitor,3249,8000,4751,1,00454,India
222666,2023-04-23,503,mixer,1349,3249,1900,1,00454,India
222666,2023-04-23,502,iphone 15 pro max,100000,135000,35000,1,00454,India
222666,2023-04-23,501,iphone 15,60000,80000,20000,1,00454,India
427849,2023-04-23,506,monitor,3249,8000,4751,1,00053,India
427849,2023-04-23,505,oven,18490,24000,5510,1,00053,India
427849,2023-04-23,504,iron,449,879,430,1,00053,India
829358,2023-04-23,506,monitor,3249,8000,4751,1,00138,India
829358,2023-04-23,503,mixer,1349,3249,1900,1,00138,India
829358,2023-04-23,504,iron,449,879,430,1,00138,India
354222,2023-04-23,506,monitor,3249,8000,4751,1,00431,India
220830,2023-04-23,506,monitor,3249,8000,4751,1,00185,India
220830,2023-04-23,505,oven,18490,24000,5510,1,00185,India
220830,2023-04-23,501,iphone 15,60000,80000,20000,1,00185,India
220830,2023-04-23,504,iron,449,879,430,1,00185,India
902402,2023-04-23,502,iphone 15 pro max,100000,135000,35000,1,00284,India
902402,2023-04-23,505,oven,18490,24000,5510,1,00284,India
344867,2023-04-23,507,washing machine,6990,16490,9500,1,00198,India
742496,2023-04-23,501,iphone 15,60000,80000,20000,1,00319,India
742496,2023-04-23,504,iron,449,879,430,1,00319,India
742496,2023-04-23,507,washing machine,6990,16490,9500,1,00319,India
867824,2023-04-23,507,washing machine,6990,16490,9500,1,00012,India
597132,2023-04-23,502,iphone 15 pro max,100000,135000,35000,1,00079,India
597132,2023-04-23,507,washing machine,6990,16490,9500,1,00079,India
494626,2023-04-23,506,monitor,3249,8000,4751,1,00056,India
494626,2023-04-23,504,iron,449,879,430,1,00056,India
852999,2023-04-23,505,oven,18490,24000,5510,1,00079,India
852999,2023-04-23,503,mixer,1349,3249,1900,1,00079,India
852999,2023-04-23,502,iphone 15 pro max,100000,135000,35000,1,00079,India
776904,2023-04-23,503,mixer,1349,3249,1900,1,00065,India
776904,2023-04-23,504,iron,449,879,430,1,00065,India
776904,2023-04-23,505,oven,18490,24000,5510,1,00065,India
374635,2023-04-23,506,monitor,3249,8000,4751,1,00204,India
374635,2023-04-23,502,iphone 15 pro max,100000,135000,35000,1,00204,India
374635,2023-04-23,501,iphone 15,60000,80000,20000,1,00204,India
374635,2023-04-23,507,washing machine,6990,16490,9500,1,00204,India
218914,2023-04-23,501,iphone 15,60000,80000,20000,1,00161,India
218914,2023-04-23,506,monitor,3249,8000,4751,1,00161,India
444441,2023-04-23,501,iphone 15,60000,80000,20000,1,00013,India
651338,2023-04-23,501,iphone 15,60000,80000,20000,1,00378,India
216592,2023-04-23,501,iphone 15,60000,80000,20000,1,00319,India
216592,2023-04-23,502,iphone 15 pro max,100000,135000,35000,1,00319,India
216592,2023-04-23,503,mixer,1349,3249,1900,1,00319,India
322965,2023-04-23,504,iron,449,879,430,1,00422,India
445236,2023-04-23,506,monitor,3249,8000,4751,1,00434,India
445236,2023-04-23,501,iphone 15,60000,80000,20000,1,00434,India
445236,2023-04-23,505,oven,18490,24000,5510,1,00434,India
445236,2023-04-23,502,iphone 15 pro max,100000,135000,35000,1,00434,India
725127,2023-04-23,503,mixer,1349,3249,1900,1,00254,India
725127,2023-04-23,504,iron,449,879,430,1,00254,India
725127,2023-04-23,505,oven,18490,24000,5510,1,00254,India
668765,2023-04-23,505,oven,18490,24000,5510,1,00097,India
758891,2023-04-23,506,monitor,3249,8000,4751,1,00173,India
758891,2023-04-23,503,mixer,1349,3249,1900,1,00173,India
758891,2023-04-23,501,iphone 15,60000,80000,20000,1,00173,India
541240,2023-04-23,503,mixer,1349,3249,1900,1,00345,India
541240,2023-04-23,501,iphone 15,60000,80000,20000,1,00345,India
646572,2023-04-23,506,monitor,3249,8000,4751,1,00066,India
646572,2023-04-23,504,iron,449,879,430,1,00066,India
554574,2023-04-23,503,mixer,1349,3249,1900,1,00105,India
554574,2023-04-23,507,washing machine,6990,16490,9500,1,00105,India
554574,2023-04-23,505,oven,18490,24000,5510,1,00105,India
448331,2023-04-23,504,iron,449,879,430,1,00151,India
448331,2023-04-23,507,washing machine,6990,16490,9500,1,00151,India
602324,2023-04-24,501,iphone 15,60000,80000,20000,1,00152,India
901842,2023-04-24,506,monitor,3249,8000,4751,1,00360,India
901842,2023-04-24,504,iron,449,879,430,1,00360,India
901842,2023-04-24,505,oven,18490,24000,5510,1,00360,India
682973,2023-04-24,502,iphone 15 pro max,100000,135000,35000,1,00407,India
682973,2023-04-24,504,iron,449,879,430,1,00407,India
712422,2023-04-24,502,iphone 15 pro max,100000,135000,35000,1,00127,India
712422,2023-04-24,506,monitor,3249,8000,4751,1,00127,India
712422,2023-04-24,507,washing machine,6990,16490,9500,1,00127,India
653346,2023-04-24,501,iphone 15,60000,80000,20000,1,00231,India
653346,2023-04-24,505,oven,18490,24000,5510,1,00231,India
653346,2023-04-24,507,washing machine,6990,16490,9500,1,00231,India
653346,2023-04-24,502,iphone 15 pro max,100000,135000,35000,1,00231,India
249812,2023-04-24,506,monitor,3249,8000,4751,1,00446,India
249812,2023-04-24,502,iphone 15 pro max,100000,135000,35000,1,00446,India
651945,2023-04-24,506,monitor,3249,8000,4751,1,00327,India
590029,2023-04-24,502,iphone 15 pro max,100000,135000,35000,1,00233,India
590029,2023-04-24,504,iron,449,879,430,1,00233,India
962103,2023-04-24,505,oven,18490,24000,5510,1,00182,India
962103,2023-04-24,504,iron,449,879,430,1,00182,India
841346,2023-04-24,501,iphone 15,60000,80000,20000,1,00407,India
841346,2023-04-24,502,iphone 15 pro max,100000,135000,35000,1,00407,India
877545,2023-04-24,507,washing machine,6990,16490,9500,1,00422,India
877545,2023-04-24,506,monitor,3249,8000,4751,1,00422,India
451718,2023-04-24,505,oven,18490,24000,5510,1,00205,India
451718,2023-04-24,502,iphone 15 pro max,100000,135000,35000,1,00205,India
451718,2023-04-24,501,iphone 15,60000,80000,20000,1,00205,India
404217,2023-04-24,502,iphone 15 pro max,100000,135000,35000,1,00475,India
404217,2023-04-24,505,oven,18490,24000,5510,1,00475,India
390467,2023-04-24,507,washing machine,6990,16490,9500,1,00492,India
390467,2023-04-24,504,iron,449,879,430,1,00492,India
209912,2023-04-24,501,iphone 15,60000,80000,20000,1,00151,India
209912,2023-04-24,502,iphone 15 pro max,100000,135000,35000,1,00151,India
209912,2023-04-24,507,washing machine,6990,16490,9500,1,00151,India
844346,2023-04-24,504,iron,449,879,430,1,00223,India
844346,2023-04-24,506,monitor,3249,8000,4751,1,00223,India
218111,2023-04-24,502,iphone 15 pro max,100000,135000,35000,1,00337,India
218111,2023-04-24,501,iphone 15,60000,80000,20000,1,00337,India
218111,2023-04-24,504,iron,449,879,430,1,00337,India
819615,2023-04-24,501,iphone 15,60000,80000,20000,1,00257,India
819615,2023-04-24,506,monitor,3249,8000,4751,1,00257,India
430855,2023-04-24,504,iron,449,879,430,1,00417,India
968445,2023-04-24,506,monitor,3249,8000,4751,1,00148,India
968445,2023-04-24,503,mixer,1349,3249,1900,1,00148,India
968445,2023-04-24,505,oven,18490,24000,5510,1,00148,India
776286,2023-04-24,502,iphone 15 pro max,100000,135000,35000,1,00258,India
776286,2023-04-24,505,oven,18490,24000,5510,1,00258,India
256252,2023-04-24,501,iphone 15,60000,80000,20000,1,00365,India
256252,2023-04-24,503,mixer,1349,3249,1900,1,00365,India
549374,2023-04-24,503,mixer,1349,3249,1900,1,00196,India
549374,2023-04-24,502,iphone 15 pro max,100000,135000,35000,1,00196,India
549374,2023-04-24,507,washing machine,6990,16490,9500,1,00196,India
978116,2023-04-24,505,oven,18490,24000,5510,1,00462,India
978116,2023-04-24,503,mixer,1349,3249,1900,1,00462,India
978116,2023-04-24,506,monitor,3249,8000,4751,1,00462,India
994585,2023-04-24,503,mixer,1349,3249,1900,1,00375,India
121828,2023-04-24,502,iphone 15 pro max,100000,135000,35000,1,00274,India
121828,2023-04-24,501,iphone 15,60000,80000,20000,1,00274,India
121828,2023-04-24,503,mixer,1349,3249,1900,1,00274,India
952648,2023-04-24,507,washing machine,6990,16490,9500,1,00199,India
952648,2023-04-24,504,iron,449,879,430,1,00199,India
952648,2023-04-24,505,oven,18490,24000,5510,1,00199,India
762148,2023-04-24,501,iphone 15,60000,80000,20000,1,00211,India
762148,2023-04-24,504,iron,449,879,430,1,00211,India
762148,2023-04-24,506,monitor,3249,8000,4751,1,00211,India
448683,2023-04-24,501,iphone 15,60000,80000,20000,1,00408,India
448683,2023-04-24,502,iphone 15 pro max,100000,135000,35000,1,00408,India
448683,2023-04-24,504,iron,449,879,430,1,00408,India
693726,2023-04-24,502,iphone 15 pro max,100000,135000,35000,1,00124,India
693726,2023-04-24,501,iphone 15,60000,80000,20000,1,00124,India
693726,2023-04-24,503,mixer,1349,3249,1900,1,00124,India
693726,2023-04-24,507,washing machine,6990,16490,9500,1,00124,India
437164,2023-04-24,502,iphone 15 pro max,100000,135000,35000,1,00176,India
437164,2023-04-24,506,monitor,3249,8000,4751,1,00176,India
437164,2023-04-24,504,iron,449,879,430,1,00176,India
437164,2023-04-24,507,washing machine,6990,16490,9500,1,00176,India
437164,2023-04-24,501,iphone 15,60000,80000,20000,1,00176,India
214609,2023-04-24,506,monitor,3249,8000,4751,1,00120,India
214609,2023-04-24,501,iphone 15,60000,80000,20000,1,00120,India
214609,2023-04-24,504,iron,449,879,430,1,00120,India
214609,2023-04-24,505,oven,18490,24000,5510,1,00120,India
408329,2023-04-24,502,iphone 15 pro max,100000,135000,35000,1,00247,India
408329,2023-04-24,506,monitor,3249,8000,4751,1,00247,India
408329,2023-04-24,507,washing machine,6990,16490,9500,1,00247,India
408329,2023-04-24,505,oven,18490,24000,5510,1,00247,India
510927,2023-04-24,504,iron,449,879,430,1,00138,India
565321,2023-04-24,506,monitor,3249,8000,4751,1,00083,India
534669,2023-04-24,503,mixer,1349,3249,1900,1,00310,India
534669,2023-04-24,504,iron,449,879,430,1,00310,India
534669,2023-04-24,505,oven,18490,24000,5510,1,00310,India
534669,2023-04-24,501,iphone 15,60000,80000,20000,1,00310,India
541237,2023-04-24,502,iphone 15 pro max,100000,135000,35000,1,00056,India
738738,2023-04-24,502,iphone 15 pro max,100000,135000,35000,1,00135,India
738738,2023-04-24,503,mixer,1349,3249,1900,1,00135,India
738738,2023-04-24,501,iphone 15,60000,80000,20000,1,00135,India
738738,2023-04-24,504,iron,449,879,430,1,00135,India
852829,2023-04-24,503,mixer,1349,3249,1900,1,00355,India
767868,2023-04-24,502,iphone 15 pro max,100000,135000,35000,1,00236,India
470765,2023-04-24,502,iphone 15 pro max,100000,135000,35000,1,00012,India
470765,2023-04-24,505,oven,18490,24000,5510,1,00012,India
470765,2023-04-24,501,iphone 15,60000,80000,20000,1,00012,India
879332,2023-04-24,505,oven,18490,24000,5510,1,00080,India
879332,2023-04-24,504,iron,449,879,430,1,00080,India
879332,2023-04-24,501,iphone 15,60000,80000,20000,1,00080,India
879332,2023-04-24,503,mixer,1349,3249,1900,1,00080,India
502703,2023-04-24,505,oven,18490,24000,5510,1,00320,India
480071,2023-04-24,503,mixer,1349,3249,1900,1,00059,India
480071,2023-04-24,502,iphone 15 pro max,100000,135000,35000,1,00059,India
910752,2023-04-24,502,iphone 15 pro max,100000,135000,35000,1,00247,India
411336,2023-04-24,505,oven,18490,24000,5510,1,00238,India
411336,2023-04-24,504,iron,449,879,430,1,00238,India
201948,2023-04-24,506,monitor,3249,8000,4751,1,00072,India
201948,2023-04-24,504,iron,449,879,430,1,00072,India
201948,2023-04-24,503,mixer,1349,3249,1900,1,00072,India
210269,2023-04-24,505,oven,18490,24000,5510,1,00094,India
210269,2023-04-24,507,washing machine,6990,16490,9500,1,00094,India
210269,2023-04-24,504,iron,449,879,430,1,00094,India
210269,2023-04-24,502,iphone 15 pro max,100000,135000,35000,1,00094,India
853676,2023-04-24,503,mixer,1349,3249,1900,1,00417,India
646033,2023-04-24,507,washing machine,6990,16490,9500,1,00423,India
646033,2023-04-24,501,iphone 15,60000,80000,20000,1,00423,India
646033,2023-04-24,506,monitor,3249,8000,4751,1,00423,India
646033,2023-04-24,505,oven,18490,24000,5510,1,00423,India
260999,2023-04-24,503,mixer,1349,3249,1900,1,00103,India
211914,2023-04-24,503,mixer,1349,3249,1900,1,00379,India
292896,2023-04-24,501,iphone 15,60000,80000,20000,1,00148,India
595311,2023-04-24,506,monitor,3249,8000,4751,1,00105,India
595311,2023-04-24,503,mixer,1349,3249,1900,1,00105,India
128720,2023-04-24,501,iphone 15,60000,80000,20000,1,00007,India
128720,2023-04-24,507,washing machine,6990,16490,9500,1,00007,India
128720,2023-04-24,502,iphone 15 pro max,100000,135000,35000,1,00007,India
328852,2023-04-24,506,monitor,3249,8000,4751,1,00416,India
716201,2023-04-24,503,mixer,1349,3249,1900,1,00272,India
716201,2023-04-24,506,monitor,3249,8000,4751,1,00272,India
716201,2023-04-24,502,iphone 15 pro max,100000,135000,35000,1,00272,India
108633,2023-04-24,503,mixer,1349,3249,1900,1,00356,India
821574,2023-04-24,505,oven,18490,24000,5510,1,00319,India
777983,2023-04-24,505,oven,18490,24000,5510,1,00239,India
777983,2023-04-24,507,washing machine,6990,16490,9500,1,00239,India
121043,2023-04-24,505,oven,18490,24000,5510,1,00037,India
121043,2023-04-24,506,monitor,3249,8000,4751,1,00037,India
121043,2023-04-24,507,washing machine,6990,16490,9500,1,00037,India
108451,2023-04-24,504,iron,449,879,430,1,00091,India
108451,2023-04-24,503,mixer,1349,3249,1900,1,00091,India
625260,2023-04-24,503,mixer,1349,3249,1900,1,00336,India
625260,2023-04-24,504,iron,449,879,430,1,00336,India
625260,2023-04-24,507,washing machine,6990,16490,9500,1,00336,India
625260,2023-04-24,506,monitor,3249,8000,4751,1,00336,India
625260,2023-04-24,505,oven,18490,24000,5510,1,00336,India
889317,2023-04-24,504,iron,449,879,430,1,00450,India
889317,2023-04-24,506,monitor,3249,8000,4751,1,00450,India
991894,2023-04-24,505,oven,18490,24000,5510,1,00233,India
991894,2023-04-24,507,washing machine,6990,16490,9500,1,00233,India
666432,2023-04-24,502,iphone 15 pro max,100000,135000,35000,1,00293,India
282581,2023-04-24,507,washing machine,6990,16490,9500,1,00300,India
282581,2023-04-24,505,oven,18490,24000,5510,1,00300,India
282581,2023-04-24,502,iphone 15 pro max,100000,135000,35000,1,00300,India
470960,2023-04-24,506,monitor,3249,8000,4751,1,00201,India
470960,2023-04-24,501,iphone 15,60000,80000,20000,1,00201,India
557274,2023-04-24,506,monitor,3249,8000,4751,1,00138,India
557274,2023-04-24,505,oven,18490,24000,5510,1,00138,India
288019,2023-04-24,504,iron,449,879,430,1,00491,India
563480,2023-04-25,501,iphone 15,60000,80000,20000,1,00238,India
563480,2023-04-25,505,oven,18490,24000,5510,1,00238,India
563480,2023-04-25,502,iphone 15 pro max,100000,135000,35000,1,00238,India
563480,2023-04-25,506,monitor,3249,8000,4751,1,00238,India
593848,2023-04-25,506,monitor,3249,8000,4751,1,00318,India
637802,2023-04-25,507,washing machine,6990,16490,9500,1,00316,India
637802,2023-04-25,504,iron,449,879,430,1,00316,India
637802,2023-04-25,506,monitor,3249,8000,4751,1,00316,India
794740,2023-04-25,504,iron,449,879,430,1,00175,India
778451,2023-04-25,505,oven,18490,24000,5510,1,00008,India
778451,2023-04-25,501,iphone 15,60000,80000,20000,1,00008,India
778451,2023-04-25,504,iron,449,879,430,1,00008,India
778451,2023-04-25,506,monitor,3249,8000,4751,1,00008,India
122779,2023-04-25,503,mixer,1349,3249,1900,1,00457,India
122779,2023-04-25,501,iphone 15,60000,80000,20000,1,00457,India
122779,2023-04-25,505,oven,18490,24000,5510,1,00457,India
435243,2023-04-25,506,monitor,3249,8000,4751,1,00290,India
435243,2023-04-25,504,iron,449,879,430,1,00290,India
435243,2023-04-25,507,washing machine,6990,16490,9500,1,00290,India
347384,2023-04-25,502,iphone 15 pro max,100000,135000,35000,1,00069,India
347384,2023-04-25,501,iphone 15,60000,80000,20000,1,00069,India
347384,2023-04-25,504,iron,449,879,430,1,00069,India
347384,2023-04-25,507,washing machine,6990,16490,9500,1,00069,India
836771,2023-04-25,505,oven,18490,24000,5510,1,00497,India
993405,2023-04-25,506,monitor,3249,8000,4751,1,00300,India
993405,2023-04-25,505,oven,18490,24000,5510,1,00300,India
993405,2023-04-25,507,washing machine,6990,16490,9500,1,00300,India
254660,2023-04-25,503,mixer,1349,3249,1900,1,00484,India
598719,2023-04-25,502,iphone 15 pro max,100000,135000,35000,1,00383,India
692935,2023-04-25,506,monitor,3249,8000,4751,1,00126,India
692935,2023-04-25,501,iphone 15,60000,80000,20000,1,00126,India
692935,2023-04-25,502,iphone 15 pro max,100000,135000,35000,1,00126,India
120259,2023-04-25,503,mixer,1349,3249,1900,1,00028,India
120259,2023-04-25,505,oven,18490,24000,5510,1,00028,India
120259,2023-04-25,502,iphone 15 pro max,100000,135000,35000,1,00028,India
451837,2023-04-25,505,oven,18490,24000,5510,1,00273,India
451837,2023-04-25,506,monitor,3249,8000,4751,1,00273,India
451837,2023-04-25,503,mixer,1349,3249,1900,1,00273,India
451837,2023-04-25,504,iron,449,879,430,1,00273,India
451837,2023-04-25,502,iphone 15 pro max,100000,135000,35000,1,00273,India
500596,2023-04-25,504,iron,449,879,430,1,00104,India
500596,2023-04-25,505,oven,18490,24000,5510,1,00104,India
500596,2023-04-25,502,iphone 15 pro max,100000,135000,35000,1,00104,India
500596,2023-04-25,507,washing machine,6990,16490,9500,1,00104,India
299216,2023-04-25,507,washing machine,6990,16490,9500,1,00418,India
299216,2023-04-25,501,iphone 15,60000,80000,20000,1,00418,India
299216,2023-04-25,505,oven,18490,24000,5510,1,00418,India
831407,2023-04-25,503,mixer,1349,3249,1900,1,00206,India
831407,2023-04-25,502,iphone 15 pro max,100000,135000,35000,1,00206,India
246826,2023-04-25,504,iron,449,879,430,1,00055,India
246826,2023-04-25,501,iphone 15,60000,80000,20000,1,00055,India
246826,2023-04-25,503,mixer,1349,3249,1900,1,00055,India
892805,2023-04-25,505,oven,18490,24000,5510,1,00278,India
892805,2023-04-25,507,washing machine,6990,16490,9500,1,00278,India
143569,2023-04-25,503,mixer,1349,3249,1900,1,00418,India
143569,2023-04-25,502,iphone 15 pro max,100000,135000,35000,1,00418,India
964672,2023-04-25,501,iphone 15,60000,80000,20000,1,00070,India
841284,2023-04-25,504,iron,449,879,430,1,00413,India
105094,2023-04-25,503,mixer,1349,3249,1900,1,00478,India
105094,2023-04-25,507,washing machine,6990,16490,9500,1,00478,India
105094,2023-04-25,505,oven,18490,24000,5510,1,00478,India
371803,2023-04-25,506,monitor,3249,8000,4751,1,00492,India
371803,2023-04-25,504,iron,449,879,430,1,00492,India
371803,2023-04-25,507,washing machine,6990,16490,9500,1,00492,India
621037,2023-04-25,501,iphone 15,60000,80000,20000,1,00449,India
688652,2023-04-25,503,mixer,1349,3249,1900,1,00152,India
688652,2023-04-25,506,monitor,3249,8000,4751,1,00152,India
688652,2023-04-25,502,iphone 15 pro max,100000,135000,35000,1,00152,India
688652,2023-04-25,504,iron,449,879,430,1,00152,India
488284,2023-04-25,506,monitor,3249,8000,4751,1,00363,India
488284,2023-04-25,501,iphone 15,60000,80000,20000,1,00363,India
488284,2023-04-25,504,iron,449,879,430,1,00363,India
619271,2023-04-25,504,iron,449,879,430,1,00122,India
619271,2023-04-25,506,monitor,3249,8000,4751,1,00122,India
619271,2023-04-25,502,iphone 15 pro max,100000,135000,35000,1,00122,India
619271,2023-04-25,503,mixer,1349,3249,1900,1,00122,India
619271,2023-04-25,507,washing machine,6990,16490,9500,1,00122,India
421480,2023-04-25,504,iron,449,879,430,1,00500,India
421480,2023-04-25,506,monitor,3249,8000,4751,1,00500,India
421480,2023-04-25,507,washing machine,6990,16490,9500,1,00500,India
421480,2023-04-25,503,mixer,1349,3249,1900,1,00500,India
324641,2023-04-25,504,iron,449,879,430,1,00484,India
724480,2023-04-25,501,iphone 15,60000,80000,20000,1,00218,India
724480,2023-04-25,503,mixer,1349,3249,1900,1,00218,India
724480,2023-04-25,502,iphone 15 pro max,100000,135000,35000,1,00218,India
129770,2023-04-25,505,oven,18490,24000,5510,1,00320,India
129770,2023-04-25,502,iphone 15 pro max,100000,135000,35000,1,00320,India
608500,2023-04-25,503,mixer,1349,3249,1900,1,00104,India
608500,2023-04-25,501,iphone 15,60000,80000,20000,1,00104,India
608500,2023-04-25,502,iphone 15 pro max,100000,135000,35000,1,00104,India
268435,2023-04-25,505,oven,18490,24000,5510,1,00124,India
268435,2023-04-25,507,washing machine,6990,16490,9500,1,00124,India
243821,2023-04-25,503,mixer,1349,3249,1900,1,00033,India
491896,2023-04-25,502,iphone 15 pro max,100000,135000,35000,1,00374,India
973588,2023-04-25,503,mixer,1349,3249,1900,1,00041,India
973588,2023-04-25,505,oven,18490,24000,5510,1,00041,India
441358,2023-04-25,505,oven,18490,24000,5510,1,00390,India
441358,2023-04-25,504,iron,449,879,430,1,00390,India
441358,2023-04-25,506,monitor,3249,8000,4751,1,00390,India
441358,2023-04-25,502,iphone 15 pro max,100000,135000,35000,1,00390,India
430235,2023-04-25,502,iphone 15 pro max,100000,135000,35000,1,00491,India
388485,2023-04-25,503,mixer,1349,3249,1900,1,00099,India
388485,2023-04-25,501,iphone 15,60000,80000,20000,1,00099,India
388485,2023-04-25,502,iphone 15 pro max,100000,135000,35000,1,00099,India
190881,2023-04-25,504,iron,449,879,430,1,00331,India
190881,2023-04-25,507,washing machine,6990,16490,9500,1,00331,India
190881,2023-04-25,506,monitor,3249,8000,4751,1,00331,India
198969,2023-04-25,504,iron,449,879,430,1,00022,India
214644,2023-04-25,502,iphone 15 pro max,100000,135000,35000,1,00084,India
214644,2023-04-25,503,mixer,1349,3249,1900,1,00084,India
214644,2023-04-25,506,monitor,3249,8000,4751,1,00084,India
214644,2023-04-25,504,iron,449,879,430,1,00084,India
715927,2023-04-25,505,oven,18490,24000,5510,1,00007,India
715927,2023-04-25,507,washing machine,6990,16490,9500,1,00007,India
715927,2023-04-25,506,monitor,3249,8000,4751,1,00007,India
715927,2023-04-25,501,iphone 15,60000,80000,20000,1,00007,India
715927,2023-04-25,503,mixer,1349,3249,1900,1,00007,India
343143,2023-04-25,504,iron,449,879,430,1,00414,India
193077,2023-04-25,502,iphone 15 pro max,100000,135000,35000,1,00476,India
193077,2023-04-25,506,monitor,3249,8000,4751,1,00476,India
193077,2023-04-25,503,mixer,1349,3249,1900,1,00476,India
193077,2023-04-25,504,iron,449,879,430,1,00476,India
473192,2023-04-25,507,washing machine,6990,16490,9500,1,00005,India
473192,2023-04-25,502,iphone 15 pro max,100000,135000,35000,1,00005,India
473192,2023-04-25,505,oven,18490,24000,5510,1,00005,India
473192,2023-04-25,504,iron,449,879,430,1,00005,India
356622,2023-04-25,504,iron,449,879,430,1,00348,India
356622,2023-04-25,503,mixer,1349,3249,1900,1,00348,India
367176,2023-04-25,507,washing machine,6990,16490,9500,1,00411,India
367176,2023-04-25,504,iron,449,879,430,1,00411,India
435163,2023-04-25,504,iron,449,879,430,1,00253,India
435163,2023-04-25,507,washing machine,6990,16490,9500,1,00253,India
435163,2023-04-25,506,monitor,3249,8000,4751,1,00253,India
733575,2023-04-25,505,oven,18490,24000,5510,1,00007,India
733575,2023-04-25,501,iphone 15,60000,80000,20000,1,00007,India
733575,2023-04-25,504,iron,449,879,430,1,00007,India
733575,2023-04-25,506,monitor,3249,8000,4751,1,00007,India
540382,2023-04-25,505,oven,18490,24000,5510,1,00306,India
540382,2023-04-25,504,iron,449,879,430,1,00306,India
540382,2023-04-25,503,mixer,1349,3249,1900,1,00306,India
540382,2023-04-25,501,iphone 15,60000,80000,20000,1,00306,India
480568,2023-04-25,506,monitor,3249,8000,4751,1,00263,India
480568,2023-04-25,501,iphone 15,60000,80000,20000,1,00263,India
480568,2023-04-25,505,oven,18490,24000,5510,1,00263,India
146697,2023-04-25,506,monitor,3249,8000,4751,1,00268,India
146697,2023-04-25,505,oven,18490,24000,5510,1,00268,India
146697,2023-04-25,507,washing machine,6990,16490,9500,1,00268,India
146697,2023-04-25,503,mixer,1349,3249,1900,1,00268,India
655153,2023-04-25,505,oven,18490,24000,5510,1,00210,India
655153,2023-04-25,503,mixer,1349,3249,1900,1,00210,India
854315,2023-04-25,504,iron,449,879,430,1,00215,India
854315,2023-04-25,507,washing machine,6990,16490,9500,1,00215,India
114950,2023-04-25,507,washing machine,6990,16490,9500,1,00118,India
114950,2023-04-25,503,mixer,1349,3249,1900,1,00118,India
613971,2023-04-25,505,oven,18490,24000,5510,1,00071,India
613971,2023-04-25,507,washing machine,6990,16490,9500,1,00071,India
613971,2023-04-25,501,iphone 15,60000,80000,20000,1,00071,India
628341,2023-04-25,505,oven,18490,24000,5510,1,00416,India
628341,2023-04-25,502,iphone 15 pro max,100000,135000,35000,1,00416,India
628341,2023-04-25,503,mixer,1349,3249,1900,1,00416,India
628341,2023-04-25,504,iron,449,879,430,1,00416,India
628341,2023-04-25,501,iphone 15,60000,80000,20000,1,00416,India
256232,2023-04-25,503,mixer,1349,3249,1900,1,00093,India
925369,2023-04-25,506,monitor,3249,8000,4751,1,00002,India
925369,2023-04-25,501,iphone 15,60000,80000,20000,1,00002,India
741852,2023-04-25,505,oven,18490,24000,5510,1,00212,India
741852,2023-04-25,501,iphone 15,60000,80000,20000,1,00212,India
741852,2023-04-25,507,washing machine,6990,16490,9500,1,00212,India
741852,2023-04-25,503,mixer,1349,3249,1900,1,00212,India
413157,2023-04-25,507,washing machine,6990,16490,9500,1,00428,India
413157,2023-04-25,504,iron,449,879,430,1,00428,India
413157,2023-04-25,501,iphone 15,60000,80000,20000,1,00428,India
486979,2023-04-25,502,iphone 15 pro max,100000,135000,35000,1,00372,India
486979,2023-04-25,504,iron,449,879,430,1,00372,India
484427,2023-04-25,504,iron,449,879,430,1,00141,India
484427,2023-04-25,505,oven,18490,24000,5510,1,00141,India
496297,2023-04-25,505,oven,18490,24000,5510,1,00261,India
496297,2023-04-25,502,iphone 15 pro max,100000,135000,35000,1,00261,India
496297,2023-04-25,504,iron,449,879,430,1,00261,India
640883,2023-04-25,504,iron,449,879,430,1,00120,India
640883,2023-04-25,505,oven,18490,24000,5510,1,00120,India
640883,2023-04-25,506,monitor,3249,8000,4751,1,00120,India
640883,2023-04-25,503,mixer,1349,3249,1900,1,00120,India
203540,2023-04-25,504,iron,449,879,430,1,00443,India
526140,2023-04-26,503,mixer,1349,3249,1900,1,00170,India
810784,2023-04-26,507,washing machine,6990,16490,9500,1,00207,India
810784,2023-04-26,502,iphone 15 pro max,100000,135000,35000,1,00207,India
810784,2023-04-26,501,iphone 15,60000,80000,20000,1,00207,India
810784,2023-04-26,505,oven,18490,24000,5510,1,00207,India
916992,2023-04-26,506,monitor,3249,8000,4751,1,00070,India
916992,2023-04-26,507,washing machine,6990,16490,9500,1,00070,India
449419,2023-04-26,505,oven,18490,24000,5510,1,00418,India
952549,2023-04-26,501,iphone 15,60000,80000,20000,1,00122,India
952549,2023-04-26,502,iphone 15 pro max,100000,135000,35000,1,00122,India
952549,2023-04-26,506,monitor,3249,8000,4751,1,00122,India
952549,2023-04-26,505,oven,18490,24000,5510,1,00122,India
299315,2023-04-26,507,washing machine,6990,16490,9500,1,00193,India
299315,2023-04-26,503,mixer,1349,3249,1900,1,00193,India
369504,2023-04-26,503,mixer,1349,3249,1900,1,00453,India
369504,2023-04-26,504,iron,449,879,430,1,00453,India
369504,2023-04-26,501,iphone 15,60000,80000,20000,1,00453,India
369504,2023-04-26,506,monitor,3249,8000,4751,1,00453,India
556009,2023-04-26,507,washing machine,6990,16490,9500,1,00217,India
556009,2023-04-26,502,iphone 15 pro max,100000,135000,35000,1,00217,India
359574,2023-04-26,505,oven,18490,24000,5510,1,00448,India
790961,2023-04-26,503,mixer,1349,3249,1900,1,00218,India
128904,2023-04-26,502,iphone 15 pro max,100000,135000,35000,1,00271,India
128904,2023-04-26,501,iphone 15,60000,80000,20000,1,00271,India
128904,2023-04-26,507,washing machine,6990,16490,9500,1,00271,India
128904,2023-04-26,503,mixer,1349,3249,1900,1,00271,India
603479,2023-04-26,504,iron,449,879,430,1,00299,India
603479,2023-04-26,503,mixer,1349,3249,1900,1,00299,India
603479,2023-04-26,502,iphone 15 pro max,100000,135000,35000,1,00299,India
528979,2023-04-26,505,oven,18490,24000,5510,1,00114,India
528979,2023-04-26,502,iphone 15 pro max,100000,135000,35000,1,00114,India
957849,2023-04-26,506,monitor,3249,8000,4751,1,00083,India
957849,2023-04-26,501,iphone 15,60000,80000,20000,1,00083,India
968029,2023-04-26,506,monitor,3249,8000,4751,1,00317,India
968029,2023-04-26,504,iron,449,879,430,1,00317,India
968029,2023-04-26,502,iphone 15 pro max,100000,135000,35000,1,00317,India
968029,2023-04-26,503,mixer,1349,3249,1900,1,00317,India
187757,2023-04-26,502,iphone 15 pro max,100000,135000,35000,1,00493,India
187757,2023-04-26,503,mixer,1349,3249,1900,1,00493,India
187757,2023-04-26,506,monitor,3249,8000,4751,1,00493,India
187757,2023-04-26,507,washing machine,6990,16490,9500,1,00493,India
720864,2023-04-26,505,oven,18490,24000,5510,1,00194,India
720864,2023-04-26,504,iron,449,879,430,1,00194,India
720864,2023-04-26,507,washing machine,6990,16490,9500,1,00194,India
461673,2023-04-26,504,iron,449,879,430,1,00108,India
297448,2023-04-26,506,monitor,3249,8000,4751,1,00373,India
297448,2023-04-26,502,iphone 15 pro max,100000,135000,35000,1,00373,India
461241,2023-04-26,505,oven,18490,24000,5510,1,00272,India
461241,2023-04-26,501,iphone 15,60000,80000,20000,1,00272,India
461241,2023-04-26,507,washing machine,6990,16490,9500,1,00272,India
461241,2023-04-26,506,monitor,3249,8000,4751,1,00272,India
213992,2023-04-26,507,washing machine,6990,16490,9500,1,00046,India
213992,2023-04-26,502,iphone 15 pro max,100000,135000,35000,1,00046,India
213992,2023-04-26,504,iron,449,879,430,1,00046,India
213992,2023-04-26,505,oven,18490,24000,5510,1,00046,India
423004,2023-04-26,503,mixer,1349,3249,1900,1,00493,India
423004,2023-04-26,502,iphone 15 pro max,100000,135000,35000,1,00493,India
423004,2023-04-26,507,washing machine,6990,16490,9500,1,00493,India
280366,2023-04-26,504,iron,449,879,430,1,00221,India
280366,2023-04-26,501,iphone 15,60000,80000,20000,1,00221,India
280366,2023-04-26,502,iphone 15 pro max,100000,135000,35000,1,00221,India
280366,2023-04-26,506,monitor,3249,8000,4751,1,00221,India
958811,2023-04-26,501,iphone 15,60000,80000,20000,1,00300,India
958811,2023-04-26,506,monitor,3249,8000,4751,1,00300,India
958811,2023-04-26,502,iphone 15 pro max,100000,135000,35000,1,00300,India
598303,2023-04-26,504,iron,449,879,430,1,00036,India
598303,2023-04-26,503,mixer,1349,3249,1900,1,00036,India
598303,2023-04-26,501,iphone 15,60000,80000,20000,1,00036,India
598303,2023-04-26,505,oven,18490,24000,5510,1,00036,India
800582,2023-04-26,504,iron,449,879,430,1,00027,India
800582,2023-04-26,503,mixer,1349,3249,1900,1,00027,India
800582,2023-04-26,501,iphone 15,60000,80000,20000,1,00027,India
800582,2023-04-26,505,oven,18490,24000,5510,1,00027,India
385150,2023-04-26,505,oven,18490,24000,5510,1,00143,India
385150,2023-04-26,502,iphone 15 pro max,100000,135000,35000,1,00143,India
917611,2023-04-26,501,iphone 15,60000,80000,20000,1,00036,India
917611,2023-04-26,504,iron,449,879,430,1,00036,India
917611,2023-04-26,502,iphone 15 pro max,100000,135000,35000,1,00036,India
917611,2023-04-26,505,oven,18490,24000,5510,1,00036,India
173784,2023-04-26,504,iron,449,879,430,1,00365,India
173784,2023-04-26,505,oven,18490,24000,5510,1,00365,India
173784,2023-04-26,503,mixer,1349,3249,1900,1,00365,India
963350,2023-04-26,505,oven,18490,24000,5510,1,00124,India
302618,2023-04-26,502,iphone 15 pro max,100000,135000,35000,1,00030,India
302618,2023-04-26,506,monitor,3249,8000,4751,1,00030,India
302618,2023-04-26,505,oven,18490,24000,5510,1,00030,India
265648,2023-04-26,504,iron,449,879,430,1,00488,India
265648,2023-04-26,505,oven,18490,24000,5510,1,00488,India
265648,2023-04-26,502,iphone 15 pro max,100000,135000,35000,1,00488,India
365097,2023-04-26,502,iphone 15 pro max,100000,135000,35000,1,00200,India
825679,2023-04-26,502,iphone 15 pro max,100000,135000,35000,1,00450,India
825679,2023-04-26,507,washing machine,6990,16490,9500,1,00450,India
825679,2023-04-26,501,iphone 15,60000,80000,20000,1,00450,India
427486,2023-04-26,502,iphone 15 pro max,100000,135000,35000,1,00168,India
916350,2023-04-26,506,monitor,3249,8000,4751,1,00380,India
916350,2023-04-26,503,mixer,1349,3249,1900,1,00380,India
778829,2023-04-26,504,iron,449,879,430,1,00251,India
778829,2023-04-26,505,oven,18490,24000,5510,1,00251,India
778829,2023-04-26,501,iphone 15,60000,80000,20000,1,00251,India
778829,2023-04-26,503,mixer,1349,3249,1900,1,00251,India
778923,2023-04-26,505,oven,18490,24000,5510,1,00300,India
778923,2023-04-26,501,iphone 15,60000,80000,20000,1,00300,India
778923,2023-04-26,502,iphone 15 pro max,100000,135000,35000,1,00300,India
698073,2023-04-26,501,iphone 15,60000,80000,20000,1,00353,India
698073,2023-04-26,505,oven,18490,24000,5510,1,00353,India
698073,2023-04-26,504,iron,449,879,430,1,00353,India
698073,2023-04-26,507,washing machine,6990,16490,9500,1,00353,India
108366,2023-04-26,505,oven,18490,24000,5510,1,00186,India
108366,2023-04-26,506,monitor,3249,8000,4751,1,00186,India
264383,2023-04-26,501,iphone 15,60000,80000,20000,1,00413,India
264383,2023-04-26,505,oven,18490,24000,5510,1,00413,India
264383,2023-04-26,507,washing machine,6990,16490,9500,1,00413,India
264383,2023-04-26,504,iron,449,879,430,1,00413,India
264383,2023-04-26,503,mixer,1349,3249,1900,1,00413,India
453103,2023-04-26,503,mixer,1349,3249,1900,1,00079,India
978262,2023-04-26,505,oven,18490,24000,5510,1,00398,India
978262,2023-04-26,501,iphone 15,60000,80000,20000,1,00398,India
978262,2023-04-26,504,iron,449,879,430,1,00398,India
978262,2023-04-26,502,iphone 15 pro max,100000,135000,35000,1,00398,India
279673,2023-04-26,507,washing machine,6990,16490,9500,1,00070,India
279673,2023-04-26,506,monitor,3249,8000,4751,1,00070,India
728396,2023-04-26,503,mixer,1349,3249,1900,1,00039,India
728396,2023-04-26,502,iphone 15 pro max,100000,135000,35000,1,00039,India
728396,2023-04-26,501,iphone 15,60000,80000,20000,1,00039,India
728396,2023-04-26,505,oven,18490,24000,5510,1,00039,India
203126,2023-04-26,507,washing machine,6990,16490,9500,1,00034,India
481674,2023-04-26,504,iron,449,879,430,1,00205,India
481674,2023-04-26,502,iphone 15 pro max,100000,135000,35000,1,00205,India
812420,2023-04-26,507,washing machine,6990,16490,9500,1,00219,India
433595,2023-04-26,506,monitor,3249,8000,4751,1,00306,India
433595,2023-04-26,507,washing machine,6990,16490,9500,1,00306,India
433595,2023-04-26,504,iron,449,879,430,1,00306,India
433595,2023-04-26,503,mixer,1349,3249,1900,1,00306,India
852941,2023-04-26,501,iphone 15,60000,80000,20000,1,00283,India
266119,2023-04-26,505,oven,18490,24000,5510,1,00139,India
266119,2023-04-26,501,iphone 15,60000,80000,20000,1,00139,India
266119,2023-04-26,504,iron,449,879,430,1,00139,India
556362,2023-04-26,507,washing machine,6990,16490,9500,1,00421,India
556362,2023-04-26,501,iphone 15,60000,80000,20000,1,00421,India
556362,2023-04-26,506,monitor,3249,8000,4751,1,00421,India
556362,2023-04-26,505,oven,18490,24000,5510,1,00421,India
349739,2023-04-26,507,washing machine,6990,16490,9500,1,00005,India
349739,2023-04-26,506,monitor,3249,8000,4751,1,00005,India
924684,2023-04-26,506,monitor,3249,8000,4751,1,00138,India
924684,2023-04-26,503,mixer,1349,3249,1900,1,00138,India
924684,2023-04-26,505,oven,18490,24000,5510,1,00138,India
658879,2023-04-26,505,oven,18490,24000,5510,1,00213,India
658879,2023-04-26,503,mixer,1349,3249,1900,1,00213,India
658879,2023-04-26,504,iron,449,879,430,1,00213,India
658879,2023-04-26,507,washing machine,6990,16490,9500,1,00213,India
224638,2023-04-26,501,iphone 15,60000,80000,20000,1,00131,India
224638,2023-04-26,504,iron,449,879,430,1,00131,India
174906,2023-04-26,507,washing machine,6990,16490,9500,1,00406,India
174906,2023-04-26,502,iphone 15 pro max,100000,135000,35000,1,00406,India
174906,2023-04-26,506,monitor,3249,8000,4751,1,00406,India
885123,2023-04-26,507,washing machine,6990,16490,9500,1,00168,India
893654,2023-04-26,507,washing machine,6990,16490,9500,1,00167,India
893654,2023-04-26,502,iphone 15 pro max,100000,135000,35000,1,00167,India
893654,2023-04-26,504,iron,449,879,430,1,00167,India
464837,2023-04-26,503,mixer,1349,3249,1900,1,00079,India
464837,2023-04-26,502,iphone 15 pro max,100000,135000,35000,1,00079,India
464837,2023-04-26,501,iphone 15,60000,80000,20000,1,00079,India
464837,2023-04-26,504,iron,449,879,430,1,00079,India
330684,2023-04-26,505,oven,18490,24000,5510,1,00494,India
911704,2023-04-26,501,iphone 15,60000,80000,20000,1,00087,India
911704,2023-04-26,503,mixer,1349,3249,1900,1,00087,India
911704,2023-04-26,506,monitor,3249,8000,4751,1,00087,India
187123,2023-04-26,503,mixer,1349,3249,1900,1,00118,India
381661,2023-04-26,506,monitor,3249,8000,4751,1,00118,India
381661,2023-04-26,505,oven,18490,24000,5510,1,00118,India
381661,2023-04-26,502,iphone 15 pro max,100000,135000,35000,1,00118,India
381661,2023-04-26,501,iphone 15,60000,80000,20000,1,00118,India
998476,2023-04-26,506,monitor,3249,8000,4751,1,00075,India
236074,2023-04-26,501,iphone 15,60000,80000,20000,1,00054,India
236074,2023-04-26,507,washing machine,6990,16490,9500,1,00054,India
236074,2023-04-26,502,iphone 15 pro max,100000,135000,35000,1,00054,India
140556,2023-04-26,503,mixer,1349,3249,1900,1,00472,India
140556,2023-04-26,504,iron,449,879,430,1,00472,India
140556,2023-04-26,502,iphone 15 pro max,100000,135000,35000,1,00472,India
140556,2023-04-26,505,oven,18490,24000,5510,1,00472,India
207993,2023-04-26,505,oven,18490,24000,5510,1,00194,India
207993,2023-04-26,502,iphone 15 pro max,100000,135000,35000,1,00194,India
207993,2023-04-26,506,monitor,3249,8000,4751,1,00194,India
992750,2023-04-26,507,washing machine,6990,16490,9500,1,00076,India
992750,2023-04-26,504,iron,449,879,430,1,00076,India
992750,2023-04-26,505,oven,18490,24000,5510,1,00076,India
992750,2023-04-26,502,iphone 15 pro max,100000,135000,35000,1,00076,India
746322,2023-04-26,505,oven,18490,24000,5510,1,00343,India
746322,2023-04-26,503,mixer,1349,3249,1900,1,00343,India
746322,2023-04-26,507,washing machine,6990,16490,9500,1,00343,India
412555,2023-04-26,502,iphone 15 pro max,100000,135000,35000,1,00196,India
526919,2023-04-26,502,iphone 15 pro max,100000,135000,35000,1,00109,India
526919,2023-04-26,503,mixer,1349,3249,1900,1,00109,India
235290,2023-04-26,507,washing machine,6990,16490,9500,1,00162,India
235290,2023-04-26,506,monitor,3249,8000,4751,1,00162,India
235290,2023-04-26,501,iphone 15,60000,80000,20000,1,00162,India
235290,2023-04-26,502,iphone 15 pro max,100000,135000,35000,1,00162,India
789147,2023-04-26,506,monitor,3249,8000,4751,1,00397,India
842563,2023-04-26,504,iron,449,879,430,1,00423,India
975014,2023-04-26,505,oven,18490,24000,5510,1,00498,India
975014,2023-04-26,501,iphone 15,60000,80000,20000,1,00498,India
227847,2023-04-26,505,oven,18490,24000,5510,1,00175,India
227847,2023-04-26,501,iphone 15,60000,80000,20000,1,00175,India
227847,2023-04-26,503,mixer,1349,3249,1900,1,00175,India
958728,2023-04-26,506,monitor,3249,8000,4751,1,00475,India
958728,2023-04-26,505,oven,18490,24000,5510,1,00475,India
958728,2023-04-26,501,iphone 15,60000,80000,20000,1,00475,India
968399,2023-04-26,505,oven,18490,24000,5510,1,00235,India
968399,2023-04-26,503,mixer,1349,3249,1900,1,00235,India
388243,2023-04-27,501,iphone 15,60000,80000,20000,1,00213,India
388243,2023-04-27,504,iron,449,879,430,1,00213,India
994506,2023-04-27,503,mixer,1349,3249,1900,1,00436,India
994506,2023-04-27,502,iphone 15 pro max,100000,135000,35000,1,00436,India
115369,2023-04-27,502,iphone 15 pro max,100000,135000,35000,1,00352,India
115369,2023-04-27,503,mixer,1349,3249,1900,1,00352,India
929360,2023-04-27,507,washing machine,6990,16490,9500,1,00407,India
929360,2023-04-27,503,mixer,1349,3249,1900,1,00407,India
929360,2023-04-27,501,iphone 15,60000,80000,20000,1,00407,India
478381,2023-04-27,505,oven,18490,24000,5510,1,00500,India
478381,2023-04-27,503,mixer,1349,3249,1900,1,00500,India
760060,2023-04-27,501,iphone 15,60000,80000,20000,1,00244,India
760060,2023-04-27,505,oven,18490,24000,5510,1,00244,India
992541,2023-04-27,503,mixer,1349,3249,1900,1,00433,India
992541,2023-04-27,501,iphone 15,60000,80000,20000,1,00433,India
992541,2023-04-27,505,oven,18490,24000,5510,1,00433,India
548244,2023-04-27,501,iphone 15,60000,80000,20000,1,00292,India
231930,2023-04-27,504,iron,449,879,430,1,00236,India
231930,2023-04-27,503,mixer,1349,3249,1900,1,00236,India
231930,2023-04-27,505,oven,18490,24000,5510,1,00236,India
879711,2023-04-27,505,oven,18490,24000,5510,1,00443,India
879711,2023-04-27,504,iron,449,879,430,1,00443,India
879711,2023-04-27,507,washing machine,6990,16490,9500,1,00443,India
279633,2023-04-27,507,washing machine,6990,16490,9500,1,00169,India
279633,2023-04-27,502,iphone 15 pro max,100000,135000,35000,1,00169,India
279633,2023-04-27,504,iron,449,879,430,1,00169,India
673774,2023-04-27,506,monitor,3249,8000,4751,1,00241,India
673774,2023-04-27,502,iphone 15 pro max,100000,135000,35000,1,00241,India
141613,2023-04-27,506,monitor,3249,8000,4751,1,00182,India
141613,2023-04-27,502,iphone 15 pro max,100000,135000,35000,1,00182,India
490446,2023-04-27,504,iron,449,879,430,1,00329,India
490446,2023-04-27,505,oven,18490,24000,5510,1,00329,India
786333,2023-04-27,502,iphone 15 pro max,100000,135000,35000,1,00402,India
786333,2023-04-27,507,washing machine,6990,16490,9500,1,00402,India
786333,2023-04-27,504,iron,449,879,430,1,00402,India
786333,2023-04-27,503,mixer,1349,3249,1900,1,00402,India
126468,2023-04-27,503,mixer,1349,3249,1900,1,00107,India
126468,2023-04-27,507,washing machine,6990,16490,9500,1,00107,India
126468,2023-04-27,501,iphone 15,60000,80000,20000,1,00107,India
328501,2023-04-27,503,mixer,1349,3249,1900,1,00044,India
328501,2023-04-27,504,iron,449,879,430,1,00044,India
328501,2023-04-27,501,iphone 15,60000,80000,20000,1,00044,India
328501,2023-04-27,505,oven,18490,24000,5510,1,00044,India
874122,2023-04-27,504,iron,449,879,430,1,00041,India
874122,2023-04-27,506,monitor,3249,8000,4751,1,00041,India
874122,2023-04-27,505,oven,18490,24000,5510,1,00041,India
431708,2023-04-27,501,iphone 15,60000,80000,20000,1,00010,India
904379,2023-04-27,502,iphone 15 pro max,100000,135000,35000,1,00489,India
904379,2023-04-27,501,iphone 15,60000,80000,20000,1,00489,India
904379,2023-04-27,507,washing machine,6990,16490,9500,1,00489,India
102889,2023-04-27,505,oven,18490,24000,5510,1,00424,India
102889,2023-04-27,504,iron,449,879,430,1,00424,India
102889,2023-04-27,506,monitor,3249,8000,4751,1,00424,India
102889,2023-04-27,507,washing machine,6990,16490,9500,1,00424,India
281508,2023-04-27,501,iphone 15,60000,80000,20000,1,00138,India
105175,2023-04-27,502,iphone 15 pro max,100000,135000,35000,1,00038,India
105175,2023-04-27,506,monitor,3249,8000,4751,1,00038,India
105175,2023-04-27,504,iron,449,879,430,1,00038,India
666865,2023-04-27,506,monitor,3249,8000,4751,1,00381,India
317300,2023-04-27,505,oven,18490,24000,5510,1,00369,India
317300,2023-04-27,504,iron,449,879,430,1,00369,India
317300,2023-04-27,507,washing machine,6990,16490,9500,1,00369,India
976785,2023-04-27,501,iphone 15,60000,80000,20000,1,00351,India
976785,2023-04-27,504,iron,449,879,430,1,00351,India
976785,2023-04-27,507,washing machine,6990,16490,9500,1,00351,India
102601,2023-04-27,506,monitor,3249,8000,4751,1,00302,India
102601,2023-04-27,502,iphone 15 pro max,100000,135000,35000,1,00302,India
102601,2023-04-27,504,iron,449,879,430,1,00302,India
775511,2023-04-27,501,iphone 15,60000,80000,20000,1,00291,India
388937,2023-04-27,506,monitor,3249,8000,4751,1,00135,India
407364,2023-04-27,502,iphone 15 pro max,100000,135000,35000,1,00445,India
407364,2023-04-27,506,monitor,3249,8000,4751,1,00445,India
407364,2023-04-27,501,iphone 15,60000,80000,20000,1,00445,India
979140,2023-04-27,504,iron,449,879,430,1,00017,India
979140,2023-04-27,506,monitor,3249,8000,4751,1,00017,India
211398,2023-04-27,504,iron,449,879,430,1,00326,India
211398,2023-04-27,507,washing machine,6990,16490,9500,1,00326,India
703750,2023-04-27,503,mixer,1349,3249,1900,1,00025,India
703750,2023-04-27,505,oven,18490,24000,5510,1,00025,India
703750,2023-04-27,507,washing machine,6990,16490,9500,1,00025,India
703750,2023-04-27,504,iron,449,879,430,1,00025,India
227386,2023-04-27,506,monitor,3249,8000,4751,1,00094,India
227386,2023-04-27,505,oven,18490,24000,5510,1,00094,India
425132,2023-04-27,506,monitor,3249,8000,4751,1,00196,India
425132,2023-04-27,503,mixer,1349,3249,1900,1,00196,India
425132,2023-04-27,501,iphone 15,60000,80000,20000,1,00196,India
425132,2023-04-27,505,oven,18490,24000,5510,1,00196,India
425132,2023-04-27,507,washing machine,6990,16490,9500,1,00196,India
324885,2023-04-27,507,washing machine,6990,16490,9500,1,00420,India
663855,2023-04-27,501,iphone 15,60000,80000,20000,1,00151,India
663855,2023-04-27,507,washing machine,6990,16490,9500,1,00151,India
663855,2023-04-27,502,iphone 15 pro max,100000,135000,35000,1,00151,India
251298,2023-04-27,507,washing machine,6990,16490,9500,1,00265,India
251298,2023-04-27,501,iphone 15,60000,80000,20000,1,00265,India
251298,2023-04-27,506,monitor,3249,8000,4751,1,00265,India
251298,2023-04-27,502,iphone 15 pro max,100000,135000,35000,1,00265,India
798695,2023-04-27,506,monitor,3249,8000,4751,1,00043,India
564514,2023-04-27,502,iphone 15 pro max,100000,135000,35000,1,00259,India
564514,2023-04-27,501,iphone 15,60000,80000,20000,1,00259,India
887193,2023-04-27,501,iphone 15,60000,80000,20000,1,00028,India
887193,2023-04-27,503,mixer,1349,3249,1900,1,00028,India
679427,2023-04-27,504,iron,449,879,430,1,00168,India
679427,2023-04-27,501,iphone 15,60000,80000,20000,1,00168,India
679427,2023-04-27,505,oven,18490,24000,5510,1,00168,India
929470,2023-04-27,506,monitor,3249,8000,4751,1,00153,India
929470,2023-04-27,502,iphone 15 pro max,100000,135000,35000,1,00153,India
929470,2023-04-27,504,iron,449,879,430,1,00153,India
929470,2023-04-27,503,mixer,1349,3249,1900,1,00153,India
887947,2023-04-27,503,mixer,1349,3249,1900,1,00302,India
162159,2023-04-27,505,oven,18490,24000,5510,1,00286,India
162159,2023-04-27,507,washing machine,6990,16490,9500,1,00286,India
912945,2023-04-27,502,iphone 15 pro max,100000,135000,35000,1,00058,India
912945,2023-04-27,506,monitor,3249,8000,4751,1,00058,India
912945,2023-04-27,501,iphone 15,60000,80000,20000,1,00058,India
113819,2023-04-27,501,iphone 15,60000,80000,20000,1,00269,India
113819,2023-04-27,503,mixer,1349,3249,1900,1,00269,India
113819,2023-04-27,502,iphone 15 pro max,100000,135000,35000,1,00269,India
113819,2023-04-27,507,washing machine,6990,16490,9500,1,00269,India
571835,2023-04-27,501,iphone 15,60000,80000,20000,1,00139,India
571835,2023-04-27,506,monitor,3249,8000,4751,1,00139,India
571835,2023-04-27,502,iphone 15 pro max,100000,135000,35000,1,00139,India
571835,2023-04-27,505,oven,18490,24000,5510,1,00139,India
571835,2023-04-27,504,iron,449,879,430,1,00139,India
103029,2023-04-27,503,mixer,1349,3249,1900,1,00372,India
103029,2023-04-27,505,oven,18490,24000,5510,1,00372,India
643353,2023-04-27,502,iphone 15 pro max,100000,135000,35000,1,00328,India
643353,2023-04-27,505,oven,18490,24000,5510,1,00328,India
643353,2023-04-27,501,iphone 15,60000,80000,20000,1,00328,India
750679,2023-04-27,502,iphone 15 pro max,100000,135000,35000,1,00399,India
750679,2023-04-27,507,washing machine,6990,16490,9500,1,00399,India
750679,2023-04-27,505,oven,18490,24000,5510,1,00399,India
750679,2023-04-27,501,iphone 15,60000,80000,20000,1,00399,India
388386,2023-04-27,506,monitor,3249,8000,4751,1,00262,India
388386,2023-04-27,507,washing machine,6990,16490,9500,1,00262,India
388386,2023-04-27,502,iphone 15 pro max,100000,135000,35000,1,00262,India
381981,2023-04-27,501,iphone 15,60000,80000,20000,1,00349,India
381981,2023-04-27,505,oven,18490,24000,5510,1,00349,India
381981,2023-04-27,504,iron,449,879,430,1,00349,India
989163,2023-04-27,504,iron,449,879,430,1,00204,India
989163,2023-04-27,502,iphone 15 pro max,100000,135000,35000,1,00204,India
155218,2023-04-27,507,washing machine,6990,16490,9500,1,00026,India
155218,2023-04-27,503,mixer,1349,3249,1900,1,00026,India
155218,2023-04-27,506,monitor,3249,8000,4751,1,00026,India
155218,2023-04-27,502,iphone 15 pro max,100000,135000,35000,1,00026,India
806537,2023-04-27,503,mixer,1349,3249,1900,1,00399,India
806537,2023-04-27,507,washing machine,6990,16490,9500,1,00399,India
806537,2023-04-27,502,iphone 15 pro max,100000,135000,35000,1,00399,India
688107,2023-04-27,507,washing machine,6990,16490,9500,1,00382,India
852114,2023-04-27,507,washing machine,6990,16490,9500,1,00364,India
852114,2023-04-27,504,iron,449,879,430,1,00364,India
852114,2023-04-27,501,iphone 15,60000,80000,20000,1,00364,India
852114,2023-04-27,506,monitor,3249,8000,4751,1,00364,India
852114,2023-04-27,502,iphone 15 pro max,100000,135000,35000,1,00364,India
430997,2023-04-27,507,washing machine,6990,16490,9500,1,00335,India
430997,2023-04-27,504,iron,449,879,430,1,00335,India
430997,2023-04-27,503,mixer,1349,3249,1900,1,00335,India
430997,2023-04-27,502,iphone 15 pro max,100000,135000,35000,1,00335,India
416257,2023-04-27,504,iron,449,879,430,1,00261,India
416257,2023-04-27,507,washing machine,6990,16490,9500,1,00261,India
416257,2023-04-27,502,iphone 15 pro max,100000,135000,35000,1,00261,India
416257,2023-04-27,501,iphone 15,60000,80000,20000,1,00261,India
871505,2023-04-27,505,oven,18490,24000,5510,1,00311,India
871505,2023-04-27,502,iphone 15 pro max,100000,135000,35000,1,00311,India
662769,2023-04-27,502,iphone 15 pro max,100000,135000,35000,1,00198,India
662769,2023-04-27,505,oven,18490,24000,5510,1,00198,India
662769,2023-04-27,501,iphone 15,60000,80000,20000,1,00198,India
662769,2023-04-27,506,monitor,3249,8000,4751,1,00198,India
312962,2023-04-27,504,iron,449,879,430,1,00378,India
571256,2023-04-27,505,oven,18490,24000,5510,1,00402,India
571256,2023-04-27,503,mixer,1349,3249,1900,1,00402,India
444631,2023-04-27,502,iphone 15 pro max,100000,135000,35000,1,00056,India
444631,2023-04-27,507,washing machine,6990,16490,9500,1,00056,India
444631,2023-04-27,506,monitor,3249,8000,4751,1,00056,India
444631,2023-04-27,501,iphone 15,60000,80000,20000,1,00056,India
973558,2023-04-27,506,monitor,3249,8000,4751,1,00232,India
405752,2023-04-27,501,iphone 15,60000,80000,20000,1,00212,India
550604,2023-04-27,507,washing machine,6990,16490,9500,1,00392,India
550604,2023-04-27,506,monitor,3249,8000,4751,1,00392,India
550604,2023-04-27,505,oven,18490,24000,5510,1,00392,India
755562,2023-04-27,505,oven,18490,24000,5510,1,00158,India
523271,2023-04-27,504,iron,449,879,430,1,00106,India
523271,2023-04-27,505,oven,18490,24000,5510,1,00106,India
842870,2023-04-27,503,mixer,1349,3249,1900,1,00104,India
842870,2023-04-27,501,iphone 15,60000,80000,20000,1,00104,India
557757,2023-04-27,507,washing machine,6990,16490,9500,1,00040,India
557757,2023-04-27,504,iron,449,879,430,1,00040,India
557757,2023-04-27,503,mixer,1349,3249,1900,1,00040,India
557757,2023-04-27,502,iphone 15 pro max,100000,135000,35000,1,00040,India
780303,2023-04-27,504,iron,449,879,430,1,00438,India
780303,2023-04-27,503,mixer,1349,3249,1900,1,00438,India
911298,2023-04-27,507,washing machine,6990,16490,9500,1,00346,India
448201,2023-04-27,507,washing machine,6990,16490,9500,1,00393,India
448201,2023-04-27,506,monitor,3249,8000,4751,1,00393,India
396176,2023-04-27,503,mixer,1349,3249,1900,1,00080,India
396176,2023-04-27,501,iphone 15,60000,80000,20000,1,00080,India
396176,2023-04-27,507,washing machine,6990,16490,9500,1,00080,India
786106,2023-04-27,504,iron,449,879,430,1,00025,India
786106,2023-04-27,507,washing machine,6990,16490,9500,1,00025,India
786106,2023-04-27,501,iphone 15,60000,80000,20000,1,00025,India
584799,2023-04-27,507,washing machine,6990,16490,9500,1,00144,India
584799,2023-04-27,501,iphone 15,60000,80000,20000,1,00144,India
640203,2023-04-27,501,iphone 15,60000,80000,20000,1,00094,India
387527,2023-04-27,505,oven,18490,24000,5510,1,00013,India
387527,2023-04-27,506,monitor,3249,8000,4751,1,00013,India
387527,2023-04-27,504,iron,449,879,430,1,00013,India
269424,2023-04-27,503,mixer,1349,3249,1900,1,00260,India
269424,2023-04-27,504,iron,449,879,430,1,00260,India
812555,2023-04-27,507,washing machine,6990,16490,9500,1,00372,India
812555,2023-04-27,505,oven,18490,24000,5510,1,00372,India
812555,2023-04-27,506,monitor,3249,8000,4751,1,00372,India
812555,2023-04-27,503,mixer,1349,3249,1900,1,00372,India
940508,2023-04-27,506,monitor,3249,8000,4751,1,00124,India
940508,2023-04-27,505,oven,18490,24000,5510,1,00124,India
940508,2023-04-27,507,washing machine,6990,16490,9500,1,00124,India
159859,2023-04-27,502,iphone 15 pro max,100000,135000,35000,1,00244,India
159859,2023-04-27,506,monitor,3249,8000,4751,1,00244,India
332297,2023-04-27,507,washing machine,6990,16490,9500,1,00378,India
332297,2023-04-27,504,iron,449,879,430,1,00378,India
332297,2023-04-27,505,oven,18490,24000,5510,1,00378,India
332297,2023-04-27,502,iphone 15 pro max,100000,135000,35000,1,00378,India
332297,2023-04-27,506,monitor,3249,8000,4751,1,00378,India
732887,2023-04-27,504,iron,449,879,430,1,00443,India
732887,2023-04-27,503,mixer,1349,3249,1900,1,00443,India
732887,2023-04-27,502,iphone 15 pro max,100000,135000,35000,1,00443,India
371781,2023-04-27,501,iphone 15,60000,80000,20000,1,00180,India
371781,2023-04-27,502,iphone 15 pro max,100000,135000,35000,1,00180,India
371781,2023-04-27,505,oven,18490,24000,5510,1,00180,India
457946,2023-04-27,501,iphone 15,60000,80000,20000,1,00230,India
356194,2023-04-27,504,iron,449,879,430,1,00092,India
356194,2023-04-27,503,mixer,1349,3249,1900,1,00092,India
280305,2023-04-27,504,iron,449,879,430,1,00254,India
280305,2023-04-27,505,oven,18490,24000,5510,1,00254,India
280305,2023-04-27,503,mixer,1349,3249,1900,1,00254,India
650068,2023-04-27,502,iphone 15 pro max,100000,135000,35000,1,00482,India
202076,2023-04-27,503,mixer,1349,3249,1900,1,00484,India
202076,2023-04-27,505,oven,18490,24000,5510,1,00484,India
202076,2023-04-27,507,washing machine,6990,16490,9500,1,00484,India
284866,2023-04-27,505,oven,18490,24000,5510,1,00013,India
284866,2023-04-27,502,iphone 15 pro max,100000,135000,35000,1,00013,India
284866,2023-04-27,504,iron,449,879,430,1,00013,India
885300,2023-04-27,507,washing machine,6990,16490,9500,1,00467,India
885300,2023-04-27,501,iphone 15,60000,80000,20000,1,00467,India
899003,2023-04-27,502,iphone 15 pro max,100000,135000,35000,1,00045,India
899003,2023-04-27,503,mixer,1349,3249,1900,1,00045,India
899003,2023-04-27,501,iphone 15,60000,80000,20000,1,00045,India
976149,2023-04-27,501,iphone 15,60000,80000,20000,1,00220,India
976149,2023-04-27,503,mixer,1349,3249,1900,1,00220,India
871670,2023-04-27,506,monitor,3249,8000,4751,1,00122,India
871670,2023-04-27,507,washing machine,6990,16490,9500,1,00122,India
677373,2023-04-28,504,iron,449,879,430,1,00136,India
677373,2023-04-28,501,iphone 15,60000,80000,20000,1,00136,India
677373,2023-04-28,505,oven,18490,24000,5510,1,00136,India
440109,2023-04-28,503,mixer,1349,3249,1900,1,00087,India
440109,2023-04-28,507,washing machine,6990,16490,9500,1,00087,India
773576,2023-04-28,501,iphone 15,60000,80000,20000,1,00396,India
773576,2023-04-28,503,mixer,1349,3249,1900,1,00396,India
773576,2023-04-28,507,washing machine,6990,16490,9500,1,00396,India
773576,2023-04-28,505,oven,18490,24000,5510,1,00396,India
773576,2023-04-28,504,iron,449,879,430,1,00396,India
881527,2023-04-28,501,iphone 15,60000,80000,20000,1,00483,India
881527,2023-04-28,506,monitor,3249,8000,4751,1,00483,India
881527,2023-04-28,502,iphone 15 pro max,100000,135000,35000,1,00483,India
454607,2023-04-28,503,mixer,1349,3249,1900,1,00256,India
454607,2023-04-28,505,oven,18490,24000,5510,1,00256,India
783298,2023-04-28,506,monitor,3249,8000,4751,1,00064,India
783298,2023-04-28,502,iphone 15 pro max,100000,135000,35000,1,00064,India
783298,2023-04-28,507,washing machine,6990,16490,9500,1,00064,India
783298,2023-04-28,505,oven,18490,24000,5510,1,00064,India
107753,2023-04-28,506,monitor,3249,8000,4751,1,00045,India
107753,2023-04-28,501,iphone 15,60000,80000,20000,1,00045,India
107753,2023-04-28,502,iphone 15 pro max,100000,135000,35000,1,00045,India
107753,2023-04-28,503,mixer,1349,3249,1900,1,00045,India
719591,2023-04-28,501,iphone 15,60000,80000,20000,1,00211,India
194298,2023-04-28,504,iron,449,879,430,1,00493,India
194298,2023-04-28,505,oven,18490,24000,5510,1,00493,India
194298,2023-04-28,506,monitor,3249,8000,4751,1,00493,India
194298,2023-04-28,501,iphone 15,60000,80000,20000,1,00493,India
815842,2023-04-28,505,oven,18490,24000,5510,1,00150,India
815842,2023-04-28,506,monitor,3249,8000,4751,1,00150,India
815842,2023-04-28,504,iron,449,879,430,1,00150,India
815842,2023-04-28,503,mixer,1349,3249,1900,1,00150,India
171751,2023-04-28,505,oven,18490,24000,5510,1,00341,India
171751,2023-04-28,506,monitor,3249,8000,4751,1,00341,India
613264,2023-04-28,505,oven,18490,24000,5510,1,00302,India
613264,2023-04-28,504,iron,449,879,430,1,00302,India
282765,2023-04-28,506,monitor,3249,8000,4751,1,00013,India
282765,2023-04-28,505,oven,18490,24000,5510,1,00013,India
282765,2023-04-28,504,iron,449,879,430,1,00013,India
282765,2023-04-28,507,washing machine,6990,16490,9500,1,00013,India
702220,2023-04-28,507,washing machine,6990,16490,9500,1,00188,India
281755,2023-04-28,506,monitor,3249,8000,4751,1,00093,India
831002,2023-04-28,503,mixer,1349,3249,1900,1,00192,India
831002,2023-04-28,506,monitor,3249,8000,4751,1,00192,India
522638,2023-04-28,502,iphone 15 pro max,100000,135000,35000,1,00475,India
522638,2023-04-28,507,washing machine,6990,16490,9500,1,00475,India
522638,2023-04-28,501,iphone 15,60000,80000,20000,1,00475,India
844929,2023-04-28,506,monitor,3249,8000,4751,1,00374,India
844929,2023-04-28,503,mixer,1349,3249,1900,1,00374,India
844929,2023-04-28,502,iphone 15 pro max,100000,135000,35000,1,00374,India
844929,2023-04-28,501,iphone 15,60000,80000,20000,1,00374,India
297090,2023-04-28,506,monitor,3249,8000,4751,1,00180,India
297090,2023-04-28,502,iphone 15 pro max,100000,135000,35000,1,00180,India
297090,2023-04-28,503,mixer,1349,3249,1900,1,00180,India
550239,2023-04-28,503,mixer,1349,3249,1900,1,00372,India
526200,2023-04-28,504,iron,449,879,430,1,00451,India
526200,2023-04-28,506,monitor,3249,8000,4751,1,00451,India
526200,2023-04-28,501,iphone 15,60000,80000,20000,1,00451,India
526200,2023-04-28,505,oven,18490,24000,5510,1,00451,India
530994,2023-04-28,504,iron,449,879,430,1,00342,India
530994,2023-04-28,505,oven,18490,24000,5510,1,00342,India
530994,2023-04-28,507,washing machine,6990,16490,9500,1,00342,India
603627,2023-04-28,502,iphone 15 pro max,100000,135000,35000,1,00093,India
126214,2023-04-28,503,mixer,1349,3249,1900,1,00092,India
126214,2023-04-28,507,washing machine,6990,16490,9500,1,00092,India
126214,2023-04-28,505,oven,18490,24000,5510,1,00092,India
198778,2023-04-28,506,monitor,3249,8000,4751,1,00103,India
198778,2023-04-28,503,mixer,1349,3249,1900,1,00103,India
222912,2023-04-28,505,oven,18490,24000,5510,1,00427,India
222912,2023-04-28,501,iphone 15,60000,80000,20000,1,00427,India
222912,2023-04-28,506,monitor,3249,8000,4751,1,00427,India
222912,2023-04-28,504,iron,449,879,430,1,00427,India
527638,2023-04-28,501,iphone 15,60000,80000,20000,1,00098,India
527638,2023-04-28,502,iphone 15 pro max,100000,135000,35000,1,00098,India
527638,2023-04-28,505,oven,18490,24000,5510,1,00098,India
527638,2023-04-28,507,washing machine,6990,16490,9500,1,00098,India
482226,2023-04-28,507,washing machine,6990,16490,9500,1,00060,India
482226,2023-04-28,504,iron,449,879,430,1,00060,India
482226,2023-04-28,506,monitor,3249,8000,4751,1,00060,India
346091,2023-04-28,501,iphone 15,60000,80000,20000,1,00494,India
346091,2023-04-28,503,mixer,1349,3249,1900,1,00494,India
346091,2023-04-28,507,washing machine,6990,16490,9500,1,00494,India
885930,2023-04-28,505,oven,18490,24000,5510,1,00112,India
885930,2023-04-28,507,washing machine,6990,16490,9500,1,00112,India
885930,2023-04-28,506,monitor,3249,8000,4751,1,00112,India
749916,2023-04-28,505,oven,18490,24000,5510,1,00427,India
749916,2023-04-28,502,iphone 15 pro max,100000,135000,35000,1,00427,India
749916,2023-04-28,501,iphone 15,60000,80000,20000,1,00427,India
408747,2023-04-28,506,monitor,3249,8000,4751,1,00389,India
408747,2023-04-28,503,mixer,1349,3249,1900,1,00389,India
263559,2023-04-28,506,monitor,3249,8000,4751,1,00107,India
263559,2023-04-28,505,oven,18490,24000,5510,1,00107,India
263559,2023-04-28,507,washing machine,6990,16490,9500,1,00107,India
682788,2023-04-28,502,iphone 15 pro max,100000,135000,35000,1,00120,India
682788,2023-04-28,503,mixer,1349,3249,1900,1,00120,India
682788,2023-04-28,501,iphone 15,60000,80000,20000,1,00120,India
136292,2023-04-28,502,iphone 15 pro max,100000,135000,35000,1,00457,India
136292,2023-04-28,506,monitor,3249,8000,4751,1,00457,India
136292,2023-04-28,503,mixer,1349,3249,1900,1,00457,India
136292,2023-04-28,505,oven,18490,24000,5510,1,00457,India
739988,2023-04-28,507,washing machine,6990,16490,9500,1,00320,India
739988,2023-04-28,504,iron,449,879,430,1,00320,India
739988,2023-04-28,503,mixer,1349,3249,1900,1,00320,India
491478,2023-04-28,503,mixer,1349,3249,1900,1,00062,India
491478,2023-04-28,501,iphone 15,60000,80000,20000,1,00062,India
491478,2023-04-28,506,monitor,3249,8000,4751,1,00062,India
580350,2023-04-28,501,iphone 15,60000,80000,20000,1,00425,India
543840,2023-04-28,503,mixer,1349,3249,1900,1,00491,India
328218,2023-04-28,506,monitor,3249,8000,4751,1,00310,India
328218,2023-04-28,504,iron,449,879,430,1,00310,India
328218,2023-04-28,505,oven,18490,24000,5510,1,00310,India
877641,2023-04-28,507,washing machine,6990,16490,9500,1,00265,India
917041,2023-04-28,504,iron,449,879,430,1,00123,India
917041,2023-04-28,501,iphone 15,60000,80000,20000,1,00123,India
917041,2023-04-28,503,mixer,1349,3249,1900,1,00123,India
874426,2023-04-28,507,washing machine,6990,16490,9500,1,00127,India
874426,2023-04-28,502,iphone 15 pro max,100000,135000,35000,1,00127,India
874426,2023-04-28,503,mixer,1349,3249,1900,1,00127,India
874426,2023-04-28,501,iphone 15,60000,80000,20000,1,00127,India
874426,2023-04-28,505,oven,18490,24000,5510,1,00127,India
956162,2023-04-28,502,iphone 15 pro max,100000,135000,35000,1,00017,India
956162,2023-04-28,506,monitor,3249,8000,4751,1,00017,India
271609,2023-04-28,505,oven,18490,24000,5510,1,00239,India
271609,2023-04-28,502,iphone 15 pro max,100000,135000,35000,1,00239,India
271609,2023-04-28,501,iphone 15,60000,80000,20000,1,00239,India
713266,2023-04-28,501,iphone 15,60000,80000,20000,1,00453,India
885357,2023-04-28,502,iphone 15 pro max,100000,135000,35000,1,00473,India
885357,2023-04-28,507,washing machine,6990,16490,9500,1,00473,India
885357,2023-04-28,505,oven,18490,24000,5510,1,00473,India
132798,2023-04-28,503,mixer,1349,3249,1900,1,00465,India
132798,2023-04-28,507,washing machine,6990,16490,9500,1,00465,India
132798,2023-04-28,506,monitor,3249,8000,4751,1,00465,India
963558,2023-04-28,507,washing machine,6990,16490,9500,1,00251,India
144844,2023-04-28,507,washing machine,6990,16490,9500,1,00136,India
144844,2023-04-28,504,iron,449,879,430,1,00136,India
472934,2023-04-28,503,mixer,1349,3249,1900,1,00116,India
472934,2023-04-28,506,monitor,3249,8000,4751,1,00116,India
472934,2023-04-28,507,washing machine,6990,16490,9500,1,00116,India
325629,2023-04-28,504,iron,449,879,430,1,00019,India
325629,2023-04-28,506,monitor,3249,8000,4751,1,00019,India
325629,2023-04-28,502,iphone 15 pro max,100000,135000,35000,1,00019,India
211826,2023-04-28,501,iphone 15,60000,80000,20000,1,00036,India
211826,2023-04-28,505,oven,18490,24000,5510,1,00036,India
761331,2023-04-28,502,iphone 15 pro max,100000,135000,35000,1,00344,India
761331,2023-04-28,505,oven,18490,24000,5510,1,00344,India
761331,2023-04-28,506,monitor,3249,8000,4751,1,00344,India
407346,2023-04-28,506,monitor,3249,8000,4751,1,00440,India
407346,2023-04-28,502,iphone 15 pro max,100000,135000,35000,1,00440,India
407346,2023-04-28,503,mixer,1349,3249,1900,1,00440,India
407346,2023-04-28,501,iphone 15,60000,80000,20000,1,00440,India
976835,2023-04-28,505,oven,18490,24000,5510,1,00407,India
976835,2023-04-28,503,mixer,1349,3249,1900,1,00407,India
976835,2023-04-28,502,iphone 15 pro max,100000,135000,35000,1,00407,India
403807,2023-04-28,504,iron,449,879,430,1,00326,India
403807,2023-04-28,505,oven,18490,24000,5510,1,00326,India
403807,2023-04-28,502,iphone 15 pro max,100000,135000,35000,1,00326,India
333473,2023-04-28,506,monitor,3249,8000,4751,1,00127,India
333473,2023-04-28,502,iphone 15 pro max,100000,135000,35000,1,00127,India
521610,2023-04-28,501,iphone 15,60000,80000,20000,1,00018,India
531103,2023-04-28,503,mixer,1349,3249,1900,1,00403,India
531103,2023-04-28,502,iphone 15 pro max,100000,135000,35000,1,00403,India
531103,2023-04-28,501,iphone 15,60000,80000,20000,1,00403,India
589151,2023-04-28,506,monitor,3249,8000,4751,1,00139,India
477773,2023-04-28,506,monitor,3249,8000,4751,1,00383,India
477773,2023-04-28,501,iphone 15,60000,80000,20000,1,00383,India
477773,2023-04-28,504,iron,449,879,430,1,00383,India
477773,2023-04-28,507,washing machine,6990,16490,9500,1,00383,India
371127,2023-04-28,506,monitor,3249,8000,4751,1,00191,India
915442,2023-04-28,505,oven,18490,24000,5510,1,00323,India
915442,2023-04-28,503,mixer,1349,3249,1900,1,00323,India
691377,2023-04-28,507,washing machine,6990,16490,9500,1,00340,India
691377,2023-04-28,502,iphone 15 pro max,100000,135000,35000,1,00340,India
691377,2023-04-28,501,iphone 15,60000,80000,20000,1,00340,India
691377,2023-04-28,504,iron,449,879,430,1,00340,India
673022,2023-04-28,501,iphone 15,60000,80000,20000,1,00094,India
673022,2023-04-28,505,oven,18490,24000,5510,1,00094,India
673022,2023-04-28,507,washing machine,6990,16490,9500,1,00094,India
673022,2023-04-28,506,monitor,3249,8000,4751,1,00094,India
846007,2023-04-28,507,washing machine,6990,16490,9500,1,00205,India
846007,2023-04-28,502,iphone 15 pro max,100000,135000,35000,1,00205,India
846007,2023-04-28,506,monitor,3249,8000,4751,1,00205,India
846007,2023-04-28,503,mixer,1349,3249,1900,1,00205,India
493943,2023-04-28,502,iphone 15 pro max,100000,135000,35000,1,00286,India
415745,2023-04-28,502,iphone 15 pro max,100000,135000,35000,1,00065,India
415745,2023-04-28,507,washing machine,6990,16490,9500,1,00065,India
415745,2023-04-28,506,monitor,3249,8000,4751,1,00065,India
415745,2023-04-28,503,mixer,1349,3249,1900,1,00065,India
896291,2023-04-28,502,iphone 15 pro max,100000,135000,35000,1,00243,India
896291,2023-04-28,504,iron,449,879,430,1,00243,India
896291,2023-04-28,501,iphone 15,60000,80000,20000,1,00243,India
164457,2023-04-28,506,monitor,3249,8000,4751,1,00360,India
164457,2023-04-28,504,iron,449,879,430,1,00360,India
164457,2023-04-28,503,mixer,1349,3249,1900,1,00360,India
164457,2023-04-28,502,iphone 15 pro max,100000,135000,35000,1,00360,India
188201,2023-04-28,506,monitor,3249,8000,4751,1,00281,India
188201,2023-04-28,504,iron,449,879,430,1,00281,India
188201,2023-04-28,502,iphone 15 pro max,100000,135000,35000,1,00281,India
520099,2023-04-28,504,iron,449,879,430,1,00063,India
321906,2023-04-28,501,iphone 15,60000,80000,20000,1,00066,India
321906,2023-04-28,502,iphone 15 pro max,100000,135000,35000,1,00066,India
321906,2023-04-28,505,oven,18490,24000,5510,1,00066,India
321906,2023-04-28,503,mixer,1349,3249,1900,1,00066,India
341055,2023-04-28,507,washing machine,6990,16490,9500,1,00023,India
747339,2023-04-28,502,iphone 15 pro max,100000,135000,35000,1,00483,India
747339,2023-04-28,507,washing machine,6990,16490,9500,1,00483,India
594696,2023-04-28,504,iron,449,879,430,1,00442,India
594696,2023-04-28,503,mixer,1349,3249,1900,1,00442,India
100533,2023-04-28,503,mixer,1349,3249,1900,1,00429,India
100533,2023-04-28,507,washing machine,6990,16490,9500,1,00429,India
100533,2023-04-28,505,oven,18490,24000,5510,1,00429,India
988290,2023-04-28,502,iphone 15 pro max,100000,135000,35000,1,00015,India
988290,2023-04-28,503,mixer,1349,3249,1900,1,00015,India
988290,2023-04-28,505,oven,18490,24000,5510,1,00015,India
544825,2023-04-28,501,iphone 15,60000,80000,20000,1,00054,India
544825,2023-04-28,504,iron,449,879,430,1,00054,India
959178,2023-04-28,501,iphone 15,60000,80000,20000,1,00228,India
959178,2023-04-28,502,iphone 15 pro max,100000,135000,35000,1,00228,India
182303,2023-04-28,507,washing machine,6990,16490,9500,1,00401,India
182303,2023-04-28,506,monitor,3249,8000,4751,1,00401,India
182303,2023-04-28,501,iphone 15,60000,80000,20000,1,00401,India
182303,2023-04-28,502,iphone 15 pro max,100000,135000,35000,1,00401,India
977723,2023-04-28,506,monitor,3249,8000,4751,1,00277,India
977723,2023-04-28,505,oven,18490,24000,5510,1,00277,India
290698,2023-04-28,507,washing machine,6990,16490,9500,1,00068,India
900306,2023-04-28,506,monitor,3249,8000,4751,1,00374,India
900306,2023-04-28,504,iron,449,879,430,1,00374,India
797857,2023-04-28,504,iron,449,879,430,1,00356,India
797857,2023-04-28,501,iphone 15,60000,80000,20000,1,00356,India
797857,2023-04-28,503,mixer,1349,3249,1900,1,00356,India
485281,2023-04-28,502,iphone 15 pro max,100000,135000,35000,1,00054,India
485281,2023-04-28,501,iphone 15,60000,80000,20000,1,00054,India
485281,2023-04-28,507,washing machine,6990,16490,9500,1,00054,India
485281,2023-04-28,503,mixer,1349,3249,1900,1,00054,India
485281,2023-04-28,506,monitor,3249,8000,4751,1,00054,India
387964,2023-04-28,503,mixer,1349,3249,1900,1,00213,India
387964,2023-04-28,501,iphone 15,60000,80000,20000,1,00213,India
387964,2023-04-28,506,monitor,3249,8000,4751,1,00213,India
387964,2023-04-28,505,oven,18490,24000,5510,1,00213,India
416054,2023-04-29,507,washing machine,6990,16490,9500,1,00312,India
613988,2023-04-29,506,monitor,3249,8000,4751,1,00182,India
439921,2023-04-29,501,iphone 15,60000,80000,20000,1,00452,India
439921,2023-04-29,506,monitor,3249,8000,4751,1,00452,India
439921,2023-04-29,504,iron,449,879,430,1,00452,India
101095,2023-04-29,503,mixer,1349,3249,1900,1,00148,India
199505,2023-04-29,501,iphone 15,60000,80000,20000,1,00474,India
199505,2023-04-29,503,mixer,1349,3249,1900,1,00474,India
199505,2023-04-29,505,oven,18490,24000,5510,1,00474,India
470540,2023-04-29,507,washing machine,6990,16490,9500,1,00180,India
470540,2023-04-29,505,oven,18490,24000,5510,1,00180,India
647326,2023-04-29,502,iphone 15 pro max,100000,135000,35000,1,00202,India
647326,2023-04-29,504,iron,449,879,430,1,00202,India
698439,2023-04-29,504,iron,449,879,430,1,00306,India
698439,2023-04-29,506,monitor,3249,8000,4751,1,00306,India
698439,2023-04-29,502,iphone 15 pro max,100000,135000,35000,1,00306,India
120608,2023-04-29,503,mixer,1349,3249,1900,1,00230,India
420521,2023-04-29,507,washing machine,6990,16490,9500,1,00098,India
420521,2023-04-29,505,oven,18490,24000,5510,1,00098,India
420521,2023-04-29,504,iron,449,879,430,1,00098,India
491434,2023-04-29,502,iphone 15 pro max,100000,135000,35000,1,00383,India
262114,2023-04-29,502,iphone 15 pro max,100000,135000,35000,1,00418,India
262114,2023-04-29,501,iphone 15,60000,80000,20000,1,00418,India
262114,2023-04-29,507,washing machine,6990,16490,9500,1,00418,India
680122,2023-04-29,505,oven,18490,24000,5510,1,00022,India
680122,2023-04-29,503,mixer,1349,3249,1900,1,00022,India
748100,2023-04-29,502,iphone 15 pro max,100000,135000,35000,1,00169,India
748100,2023-04-29,507,washing machine,6990,16490,9500,1,00169,India
212263,2023-04-29,502,iphone 15 pro max,100000,135000,35000,1,00116,India
212263,2023-04-29,504,iron,449,879,430,1,00116,India
212263,2023-04-29,503,mixer,1349,3249,1900,1,00116,India
212263,2023-04-29,505,oven,18490,24000,5510,1,00116,India
187283,2023-04-29,505,oven,18490,24000,5510,1,00123,India
187283,2023-04-29,507,washing machine,6990,16490,9500,1,00123,India
226115,2023-04-29,507,washing machine,6990,16490,9500,1,00376,India
226115,2023-04-29,503,mixer,1349,3249,1900,1,00376,India
226115,2023-04-29,501,iphone 15,60000,80000,20000,1,00376,India
147999,2023-04-29,501,iphone 15,60000,80000,20000,1,00378,India
147999,2023-04-29,502,iphone 15 pro max,100000,135000,35000,1,00378,India
147999,2023-04-29,505,oven,18490,24000,5510,1,00378,India
147999,2023-04-29,507,washing machine,6990,16490,9500,1,00378,India
482934,2023-04-29,505,oven,18490,24000,5510,1,00080,India
907736,2023-04-29,507,washing machine,6990,16490,9500,1,00269,India
907736,2023-04-29,504,iron,449,879,430,1,00269,India
907736,2023-04-29,505,oven,18490,24000,5510,1,00269,India
907736,2023-04-29,506,monitor,3249,8000,4751,1,00269,India
792095,2023-04-29,504,iron,449,879,430,1,00446,India
792095,2023-04-29,506,monitor,3249,8000,4751,1,00446,India
792095,2023-04-29,502,iphone 15 pro max,100000,135000,35000,1,00446,India
399819,2023-04-29,502,iphone 15 pro max,100000,135000,35000,1,00292,India
399819,2023-04-29,501,iphone 15,60000,80000,20000,1,00292,India
399819,2023-04-29,503,mixer,1349,3249,1900,1,00292,India
988572,2023-04-29,505,oven,18490,24000,5510,1,00246,India
988572,2023-04-29,504,iron,449,879,430,1,00246,India
988572,2023-04-29,502,iphone 15 pro max,100000,135000,35000,1,00246,India
258291,2023-04-29,503,mixer,1349,3249,1900,1,00158,India
401602,2023-04-29,506,monitor,3249,8000,4751,1,00053,India
401602,2023-04-29,505,oven,18490,24000,5510,1,00053,India
401602,2023-04-29,504,iron,449,879,430,1,00053,India
401602,2023-04-29,507,washing machine,6990,16490,9500,1,00053,India
139986,2023-04-29,504,iron,449,879,430,1,00292,India
139986,2023-04-29,503,mixer,1349,3249,1900,1,00292,India
754381,2023-04-29,506,monitor,3249,8000,4751,1,00103,India
720144,2023-04-29,503,mixer,1349,3249,1900,1,00166,India
720144,2023-04-29,501,iphone 15,60000,80000,20000,1,00166,India
980224,2023-04-29,507,washing machine,6990,16490,9500,1,00079,India
980224,2023-04-29,505,oven,18490,24000,5510,1,00079,India
980224,2023-04-29,502,iphone 15 pro max,100000,135000,35000,1,00079,India
980224,2023-04-29,503,mixer,1349,3249,1900,1,00079,India
216215,2023-04-29,503,mixer,1349,3249,1900,1,00275,India
216215,2023-04-29,507,washing machine,6990,16490,9500,1,00275,India
216215,2023-04-29,502,iphone 15 pro max,100000,135000,35000,1,00275,India
646194,2023-04-29,507,washing machine,6990,16490,9500,1,00192,India
539297,2023-04-29,507,washing machine,6990,16490,9500,1,00425,India
539297,2023-04-29,502,iphone 15 pro max,100000,135000,35000,1,00425,India
539297,2023-04-29,505,oven,18490,24000,5510,1,00425,India
301137,2023-04-29,502,iphone 15 pro max,100000,135000,35000,1,00185,India
802588,2023-04-29,501,iphone 15,60000,80000,20000,1,00013,India
802588,2023-04-29,507,washing machine,6990,16490,9500,1,00013,India
140125,2023-04-29,505,oven,18490,24000,5510,1,00270,India
140125,2023-04-29,504,iron,449,879,430,1,00270,India
303942,2023-04-29,505,oven,18490,24000,5510,1,00213,India
746484,2023-04-29,503,mixer,1349,3249,1900,1,00328,India
746484,2023-04-29,506,monitor,3249,8000,4751,1,00328,India
746484,2023-04-29,507,washing machine,6990,16490,9500,1,00328,India
702804,2023-04-29,505,oven,18490,24000,5510,1,00350,India
702804,2023-04-29,506,monitor,3249,8000,4751,1,00350,India
648591,2023-04-29,506,monitor,3249,8000,4751,1,00008,India
648591,2023-04-29,507,washing machine,6990,16490,9500,1,00008,India
648591,2023-04-29,503,mixer,1349,3249,1900,1,00008,India
648591,2023-04-29,504,iron,449,879,430,1,00008,India
553299,2023-04-29,507,washing machine,6990,16490,9500,1,00384,India
553299,2023-04-29,502,iphone 15 pro max,100000,135000,35000,1,00384,India
553299,2023-04-29,506,monitor,3249,8000,4751,1,00384,India
553299,2023-04-29,505,oven,18490,24000,5510,1,00384,India
553299,2023-04-29,501,iphone 15,60000,80000,20000,1,00384,India
675701,2023-04-29,503,mixer,1349,3249,1900,1,00083,India
675701,2023-04-29,507,washing machine,6990,16490,9500,1,00083,India
822671,2023-04-29,506,monitor,3249,8000,4751,1,00205,India
822671,2023-04-29,503,mixer,1349,3249,1900,1,00205,India
822671,2023-04-29,507,washing machine,6990,16490,9500,1,00205,India
822671,2023-04-29,505,oven,18490,24000,5510,1,00205,India
818529,2023-04-29,501,iphone 15,60000,80000,20000,1,00214,India
818529,2023-04-29,507,washing machine,6990,16490,9500,1,00214,India
818529,2023-04-29,502,iphone 15 pro max,100000,135000,35000,1,00214,India
442953,2023-04-29,502,iphone 15 pro max,100000,135000,35000,1,00231,India
726681,2023-04-29,506,monitor,3249,8000,4751,1,00189,India
726681,2023-04-29,504,iron,449,879,430,1,00189,India
203803,2023-04-29,505,oven,18490,24000,5510,1,00023,India
113278,2023-04-29,503,mixer,1349,3249,1900,1,00273,India
113278,2023-04-29,505,oven,18490,24000,5510,1,00273,India
113278,2023-04-29,504,iron,449,879,430,1,00273,India
113278,2023-04-29,506,monitor,3249,8000,4751,1,00273,India
727058,2023-04-29,503,mixer,1349,3249,1900,1,00299,India
727058,2023-04-29,506,monitor,3249,8000,4751,1,00299,India
727058,2023-04-29,507,washing machine,6990,16490,9500,1,00299,India
733632,2023-04-29,504,iron,449,879,430,1,00110,India
278702,2023-04-29,507,washing machine,6990,16490,9500,1,00011,India
304521,2023-04-29,504,iron,449,879,430,1,00359,India
304521,2023-04-29,501,iphone 15,60000,80000,20000,1,00359,India
304521,2023-04-29,507,washing machine,6990,16490,9500,1,00359,India
862344,2023-04-29,503,mixer,1349,3249,1900,1,00120,India
862344,2023-04-29,501,iphone 15,60000,80000,20000,1,00120,India
455678,2023-04-29,503,mixer,1349,3249,1900,1,00415,India
455678,2023-04-29,507,washing machine,6990,16490,9500,1,00415,India
455678,2023-04-29,505,oven,18490,24000,5510,1,00415,India
455678,2023-04-29,504,iron,449,879,430,1,00415,India
390457,2023-04-29,501,iphone 15,60000,80000,20000,1,00013,India
390457,2023-04-29,505,oven,18490,24000,5510,1,00013,India
390457,2023-04-29,506,monitor,3249,8000,4751,1,00013,India
390457,2023-04-29,504,iron,449,879,430,1,00013,India
647149,2023-04-29,507,washing machine,6990,16490,9500,1,00122,India
699896,2023-04-29,503,mixer,1349,3249,1900,1,00467,India
699896,2023-04-29,504,iron,449,879,430,1,00467,India
699896,2023-04-29,506,monitor,3249,8000,4751,1,00467,India
787521,2023-04-29,507,washing machine,6990,16490,9500,1,00197,India
699339,2023-04-29,507,washing machine,6990,16490,9500,1,00100,India
699339,2023-04-29,503,mixer,1349,3249,1900,1,00100,India
818719,2023-04-29,501,iphone 15,60000,80000,20000,1,00096,India
818719,2023-04-29,505,oven,18490,24000,5510,1,00096,India
818719,2023-04-29,504,iron,449,879,430,1,00096,India
818719,2023-04-29,507,washing machine,6990,16490,9500,1,00096,India
818719,2023-04-29,506,monitor,3249,8000,4751,1,00096,India
801550,2023-04-29,506,monitor,3249,8000,4751,1,00423,India
801550,2023-04-29,502,iphone 15 pro max,100000,135000,35000,1,00423,India
742138,2023-04-29,503,mixer,1349,3249,1900,1,00267,India
742138,2023-04-29,504,iron,449,879,430,1,00267,India
742138,2023-04-29,507,washing machine,6990,16490,9500,1,00267,India
742138,2023-04-29,502,iphone 15 pro max,100000,135000,35000,1,00267,India
275809,2023-04-29,503,mixer,1349,3249,1900,1,00334,India
282672,2023-04-29,503,mixer,1349,3249,1900,1,00180,India
282672,2023-04-29,501,iphone 15,60000,80000,20000,1,00180,India
282672,2023-04-29,506,monitor,3249,8000,4751,1,00180,India
678276,2023-04-29,504,iron,449,879,430,1,00431,India
678276,2023-04-29,502,iphone 15 pro max,100000,135000,35000,1,00431,India
678276,2023-04-29,501,iphone 15,60000,80000,20000,1,00431,India
251376,2023-04-29,507,washing machine,6990,16490,9500,1,00363,India
356056,2023-04-29,507,washing machine,6990,16490,9500,1,00048,India
760594,2023-04-29,507,washing machine,6990,16490,9500,1,00384,India
760594,2023-04-29,505,oven,18490,24000,5510,1,00384,India
760594,2023-04-29,506,monitor,3249,8000,4751,1,00384,India
760594,2023-04-29,502,iphone 15 pro max,100000,135000,35000,1,00384,India
411875,2023-04-29,501,iphone 15,60000,80000,20000,1,00199,India
866534,2023-04-29,501,iphone 15,60000,80000,20000,1,00437,India
866534,2023-04-29,505,oven,18490,24000,5510,1,00437,India
866534,2023-04-29,503,mixer,1349,3249,1900,1,00437,India
866534,2023-04-29,502,iphone 15 pro max,100000,135000,35000,1,00437,India
694884,2023-04-30,504,iron,449,879,430,1,00145,India
481086,2023-04-30,504,iron,449,879,430,1,00222,India
481086,2023-04-30,501,iphone 15,60000,80000,20000,1,00222,India
481086,2023-04-30,507,washing machine,6990,16490,9500,1,00222,India
160312,2023-04-30,504,iron,449,879,430,1,00295,India
160312,2023-04-30,502,iphone 15 pro max,100000,135000,35000,1,00295,India
160312,2023-04-30,503,mixer,1349,3249,1900,1,00295,India
592627,2023-04-30,501,iphone 15,60000,80000,20000,1,00098,India
592627,2023-04-30,504,iron,449,879,430,1,00098,India
592627,2023-04-30,502,iphone 15 pro max,100000,135000,35000,1,00098,India
268908,2023-04-30,507,washing machine,6990,16490,9500,1,00400,India
534098,2023-04-30,501,iphone 15,60000,80000,20000,1,00128,India
534098,2023-04-30,505,oven,18490,24000,5510,1,00128,India
395136,2023-04-30,507,washing machine,6990,16490,9500,1,00476,India
395136,2023-04-30,502,iphone 15 pro max,100000,135000,35000,1,00476,India
744382,2023-04-30,501,iphone 15,60000,80000,20000,1,00291,India
744382,2023-04-30,506,monitor,3249,8000,4751,1,00291,India
744382,2023-04-30,505,oven,18490,24000,5510,1,00291,India
308301,2023-04-30,507,washing machine,6990,16490,9500,1,00120,India
308301,2023-04-30,502,iphone 15 pro max,100000,135000,35000,1,00120,India
308301,2023-04-30,505,oven,18490,24000,5510,1,00120,India
464060,2023-04-30,506,monitor,3249,8000,4751,1,00350,India
464060,2023-04-30,503,mixer,1349,3249,1900,1,00350,India
974642,2023-04-30,504,iron,449,879,430,1,00017,India
974642,2023-04-30,501,iphone 15,60000,80000,20000,1,00017,India
974642,2023-04-30,502,iphone 15 pro max,100000,135000,35000,1,00017,India
185219,2023-04-30,503,mixer,1349,3249,1900,1,00439,India
185219,2023-04-30,502,iphone 15 pro max,100000,135000,35000,1,00439,India
185219,2023-04-30,506,monitor,3249,8000,4751,1,00439,India
939890,2023-04-30,502,iphone 15 pro max,100000,135000,35000,1,00111,India
600806,2023-04-30,505,oven,18490,24000,5510,1,00041,India
600806,2023-04-30,507,washing machine,6990,16490,9500,1,00041,India
981721,2023-04-30,502,iphone 15 pro max,100000,135000,35000,1,00151,India
981721,2023-04-30,507,washing machine,6990,16490,9500,1,00151,India
793783,2023-04-30,502,iphone 15 pro max,100000,135000,35000,1,00208,India
793783,2023-04-30,503,mixer,1349,3249,1900,1,00208,India
793783,2023-04-30,504,iron,449,879,430,1,00208,India
793783,2023-04-30,507,washing machine,6990,16490,9500,1,00208,India
672189,2023-04-30,505,oven,18490,24000,5510,1,00126,India
672189,2023-04-30,502,iphone 15 pro max,100000,135000,35000,1,00126,India
224631,2023-04-30,506,monitor,3249,8000,4751,1,00018,India
224631,2023-04-30,504,iron,449,879,430,1,00018,India
224631,2023-04-30,507,washing machine,6990,16490,9500,1,00018,India
505596,2023-04-30,507,washing machine,6990,16490,9500,1,00114,India
505596,2023-04-30,501,iphone 15,60000,80000,20000,1,00114,India
505596,2023-04-30,505,oven,18490,24000,5510,1,00114,India
488615,2023-04-30,502,iphone 15 pro max,100000,135000,35000,1,00103,India
488615,2023-04-30,503,mixer,1349,3249,1900,1,00103,India
488615,2023-04-30,505,oven,18490,24000,5510,1,00103,India
443372,2023-04-30,505,oven,18490,24000,5510,1,00135,India
312605,2023-04-30,506,monitor,3249,8000,4751,1,00136,India
312605,2023-04-30,501,iphone 15,60000,80000,20000,1,00136,India
257036,2023-04-30,503,mixer,1349,3249,1900,1,00047,India
257036,2023-04-30,502,iphone 15 pro max,100000,135000,35000,1,00047,India
745910,2023-04-30,503,mixer,1349,3249,1900,1,00061,India
745910,2023-04-30,501,iphone 15,60000,80000,20000,1,00061,India
847889,2023-04-30,502,iphone 15 pro max,100000,135000,35000,1,00369,India
847889,2023-04-30,507,washing machine,6990,16490,9500,1,00369,India
847889,2023-04-30,503,mixer,1349,3249,1900,1,00369,India
892366,2023-04-30,504,iron,449,879,430,1,00264,India
892366,2023-04-30,506,monitor,3249,8000,4751,1,00264,India
611913,2023-04-30,505,oven,18490,24000,5510,1,00248,India
611913,2023-04-30,501,iphone 15,60000,80000,20000,1,00248,India
611913,2023-04-30,507,washing machine,6990,16490,9500,1,00248,India
611913,2023-04-30,502,iphone 15 pro max,100000,135000,35000,1,00248,India
932689,2023-04-30,503,mixer,1349,3249,1900,1,00396,India
526546,2023-04-30,507,washing machine,6990,16490,9500,1,00201,India
526546,2023-04-30,504,iron,449,879,430,1,00201,India
526546,2023-04-30,501,iphone 15,60000,80000,20000,1,00201,India
506574,2023-04-30,506,monitor,3249,8000,4751,1,00497,India
936613,2023-04-30,505,oven,18490,24000,5510,1,00415,India
936613,2023-04-30,507,washing machine,6990,16490,9500,1,00415,India
936613,2023-04-30,503,mixer,1349,3249,1900,1,00415,India
365228,2023-04-30,501,iphone 15,60000,80000,20000,1,00207,India
365228,2023-04-30,503,mixer,1349,3249,1900,1,00207,India
365228,2023-04-30,502,iphone 15 pro max,100000,135000,35000,1,00207,India
486026,2023-04-30,506,monitor,3249,8000,4751,1,00304,India
486026,2023-04-30,503,mixer,1349,3249,1900,1,00304,India
486026,2023-04-30,502,iphone 15 pro max,100000,135000,35000,1,00304,India
708619,2023-04-30,506,monitor,3249,8000,4751,1,00392,India
708619,2023-04-30,502,iphone 15 pro max,100000,135000,35000,1,00392,India
708619,2023-04-30,501,iphone 15,60000,80000,20000,1,00392,India
708619,2023-04-30,505,oven,18490,24000,5510,1,00392,India
708619,2023-04-30,503,mixer,1349,3249,1900,1,00392,India
899915,2023-04-30,506,monitor,3249,8000,4751,1,00473,India
899915,2023-04-30,507,washing machine,6990,16490,9500,1,00473,India
816594,2023-04-30,504,iron,449,879,430,1,00357,India
816594,2023-04-30,506,monitor,3249,8000,4751,1,00357,India
867457,2023-04-30,504,iron,449,879,430,1,00266,India
867457,2023-04-30,506,monitor,3249,8000,4751,1,00266,India
385399,2023-04-30,507,washing machine,6990,16490,9500,1,00371,India
385399,2023-04-30,502,iphone 15 pro max,100000,135000,35000,1,00371,India
167805,2023-04-30,501,iphone 15,60000,80000,20000,1,00497,India
527665,2023-04-30,506,monitor,3249,8000,4751,1,00001,India
527665,2023-04-30,504,iron,449,879,430,1,00001,India
365266,2023-04-30,506,monitor,3249,8000,4751,1,00262,India
365266,2023-04-30,502,iphone 15 pro max,100000,135000,35000,1,00262,India
365535,2023-04-30,501,iphone 15,60000,80000,20000,1,00270,India
658919,2023-04-30,506,monitor,3249,8000,4751,1,00193,India
658919,2023-04-30,503,mixer,1349,3249,1900,1,00193,India
654506,2023-04-30,502,iphone 15 pro max,100000,135000,35000,1,00236,India
654506,2023-04-30,501,iphone 15,60000,80000,20000,1,00236,India
300435,2023-04-30,502,iphone 15 pro max,100000,135000,35000,1,00125,India
300435,2023-04-30,507,washing machine,6990,16490,9500,1,00125,India
324809,2023-04-30,506,monitor,3249,8000,4751,1,00094,India
717787,2023-04-30,506,monitor,3249,8000,4751,1,00333,India
717787,2023-04-30,503,mixer,1349,3249,1900,1,00333,India
717787,2023-04-30,504,iron,449,879,430,1,00333,India
717787,2023-04-30,502,iphone 15 pro max,100000,135000,35000,1,00333,India
967237,2023-04-30,502,iphone 15 pro max,100000,135000,35000,1,00019,India
967237,2023-04-30,505,oven,18490,24000,5510,1,00019,India
967237,2023-04-30,507,washing machine,6990,16490,9500,1,00019,India
782237,2023-04-30,507,washing machine,6990,16490,9500,1,00396,India
782237,2023-04-30,506,monitor,3249,8000,4751,1,00396,India
782237,2023-04-30,504,iron,449,879,430,1,00396,India
581808,2023-04-30,507,washing machine,6990,16490,9500,1,00142,India
581808,2023-04-30,502,iphone 15 pro max,100000,135000,35000,1,00142,India
581808,2023-04-30,506,monitor,3249,8000,4751,1,00142,India
581808,2023-04-30,505,oven,18490,24000,5510,1,00142,India
916639,2023-04-30,507,washing machine,6990,16490,9500,1,00441,India
898760,2023-04-30,506,monitor,3249,8000,4751,1,00073,India
377942,2023-04-30,506,monitor,3249,8000,4751,1,00396,India
377942,2023-04-30,504,iron,449,879,430,1,00396,India
377942,2023-04-30,505,oven,18490,24000,5510,1,00396,India
377942,2023-04-30,507,washing machine,6990,16490,9500,1,00396,India
911507,2023-04-30,506,monitor,3249,8000,4751,1,00497,India
911507,2023-04-30,502,iphone 15 pro max,100000,135000,35000,1,00497,India
781391,2023-04-30,506,monitor,3249,8000,4751,1,00196,India
781391,2023-04-30,505,oven,18490,24000,5510,1,00196,India
781391,2023-04-30,504,iron,449,879,430,1,00196,India
781391,2023-04-30,503,mixer,1349,3249,1900,1,00196,India
781391,2023-04-30,501,iphone 15,60000,80000,20000,1,00196,India
211243,2023-04-30,504,iron,449,879,430,1,00332,India
211243,2023-04-30,505,oven,18490,24000,5510,1,00332,India
211243,2023-04-30,506,monitor,3249,8000,4751,1,00332,India
211243,2023-04-30,507,washing machine,6990,16490,9500,1,00332,India
518709,2023-04-30,505,oven,18490,24000,5510,1,00430,India
953817,2023-04-30,504,iron,449,879,430,1,00136,India
953817,2023-04-30,507,washing machine,6990,16490,9500,1,00136,India
331410,2023-04-30,501,iphone 15,60000,80000,20000,1,00339,India
331410,2023-04-30,507,washing machine,6990,16490,9500,1,00339,India
331410,2023-04-30,504,iron,449,879,430,1,00339,India
212236,2023-04-30,504,iron,449,879,430,1,00153,India
212236,2023-04-30,502,iphone 15 pro max,100000,135000,35000,1,00153,India
212236,2023-04-30,507,washing machine,6990,16490,9500,1,00153,India
212236,2023-04-30,505,oven,18490,24000,5510,1,00153,India
201401,2023-04-30,503,mixer,1349,3249,1900,1,00239,India
201401,2023-04-30,507,washing machine,6990,16490,9500,1,00239,India
201401,2023-04-30,506,monitor,3249,8000,4751,1,00239,India
201401,2023-04-30,502,iphone 15 pro max,100000,135000,35000,1,00239,India
829226,2023-04-30,505,oven,18490,24000,5510,1,00042,India
837260,2023-05-01,507,washing machine,6990,16490,9500,1,00268,India
837260,2023-05-01,506,monitor,3249,8000,4751,1,00268,India
837260,2023-05-01,503,mixer,1349,3249,1900,1,00268,India
902961,2023-05-01,502,iphone 15 pro max,100000,135000,35000,1,00022,India
902961,2023-05-01,503,mixer,1349,3249,1900,1,00022,India
379262,2023-05-01,501,iphone 15,60000,80000,20000,1,00317,India
379262,2023-05-01,502,iphone 15 pro max,100000,135000,35000,1,00317,India
518944,2023-05-01,505,oven,18490,24000,5510,1,00474,India
518944,2023-05-01,504,iron,449,879,430,1,00474,India
164771,2023-05-01,502,iphone 15 pro max,100000,135000,35000,1,00063,India
164771,2023-05-01,507,washing machine,6990,16490,9500,1,00063,India
164771,2023-05-01,506,monitor,3249,8000,4751,1,00063,India
272702,2023-05-01,505,oven,18490,24000,5510,1,00378,India
272702,2023-05-01,506,monitor,3249,8000,4751,1,00378,India
876278,2023-05-01,505,oven,18490,24000,5510,1,00005,India
876278,2023-05-01,504,iron,449,879,430,1,00005,India
876278,2023-05-01,507,washing machine,6990,16490,9500,1,00005,India
876278,2023-05-01,506,monitor,3249,8000,4751,1,00005,India
628614,2023-05-01,507,washing machine,6990,16490,9500,1,00127,India
628614,2023-05-01,503,mixer,1349,3249,1900,1,00127,India
628614,2023-05-01,505,oven,18490,24000,5510,1,00127,India
628614,2023-05-01,504,iron,449,879,430,1,00127,India
573697,2023-05-01,502,iphone 15 pro max,100000,135000,35000,1,00232,India
573697,2023-05-01,507,washing machine,6990,16490,9500,1,00232,India
341045,2023-05-01,506,monitor,3249,8000,4751,1,00483,India
341045,2023-05-01,507,washing machine,6990,16490,9500,1,00483,India
426482,2023-05-01,504,iron,449,879,430,1,00474,India
817499,2023-05-01,504,iron,449,879,430,1,00240,India
419045,2023-05-01,504,iron,449,879,430,1,00327,India
419045,2023-05-01,503,mixer,1349,3249,1900,1,00327,India
818777,2023-05-01,507,washing machine,6990,16490,9500,1,00229,India
818777,2023-05-01,504,iron,449,879,430,1,00229,India
818777,2023-05-01,503,mixer,1349,3249,1900,1,00229,India
818777,2023-05-01,505,oven,18490,24000,5510,1,00229,India
291510,2023-05-01,503,mixer,1349,3249,1900,1,00112,India
291510,2023-05-01,506,monitor,3249,8000,4751,1,00112,India
377275,2023-05-01,502,iphone 15 pro max,100000,135000,35000,1,00241,India
688729,2023-05-01,502,iphone 15 pro max,100000,135000,35000,1,00418,India
688729,2023-05-01,501,iphone 15,60000,80000,20000,1,00418,India
688729,2023-05-01,505,oven,18490,24000,5510,1,00418,India
688729,2023-05-01,503,mixer,1349,3249,1900,1,00418,India
628442,2023-05-01,501,iphone 15,60000,80000,20000,1,00117,India
628442,2023-05-01,503,mixer,1349,3249,1900,1,00117,India
788800,2023-05-01,507,washing machine,6990,16490,9500,1,00361,India
788800,2023-05-01,501,iphone 15,60000,80000,20000,1,00361,India
788800,2023-05-01,502,iphone 15 pro max,100000,135000,35000,1,00361,India
415492,2023-05-01,506,monitor,3249,8000,4751,1,00317,India
415492,2023-05-01,505,oven,18490,24000,5510,1,00317,India
415492,2023-05-01,504,iron,449,879,430,1,00317,India
230891,2023-05-01,504,iron,449,879,430,1,00314,India
285635,2023-05-01,503,mixer,1349,3249,1900,1,00464,India
285635,2023-05-01,501,iphone 15,60000,80000,20000,1,00464,India
945944,2023-05-01,502,iphone 15 pro max,100000,135000,35000,1,00306,India
945944,2023-05-01,506,monitor,3249,8000,4751,1,00306,India
945944,2023-05-01,505,oven,18490,24000,5510,1,00306,India
851698,2023-05-01,506,monitor,3249,8000,4751,1,00299,India
851698,2023-05-01,505,oven,18490,24000,5510,1,00299,India
266350,2023-05-01,502,iphone 15 pro max,100000,135000,35000,1,00194,India
266350,2023-05-01,504,iron,449,879,430,1,00194,India
201214,2023-05-01,505,oven,18490,24000,5510,1,00164,India
201214,2023-05-01,502,iphone 15 pro max,100000,135000,35000,1,00164,India
201214,2023-05-01,506,monitor,3249,8000,4751,1,00164,India
201214,2023-05-01,501,iphone 15,60000,80000,20000,1,00164,India
201214,2023-05-01,507,washing machine,6990,16490,9500,1,00164,India
767851,2023-05-01,503,mixer,1349,3249,1900,1,00333,India
767851,2023-05-01,505,oven,18490,24000,5510,1,00333,India
767851,2023-05-01,504,iron,449,879,430,1,00333,India
299967,2023-05-01,504,iron,449,879,430,1,00074,India
299967,2023-05-01,505,oven,18490,24000,5510,1,00074,India
299967,2023-05-01,506,monitor,3249,8000,4751,1,00074,India
299967,2023-05-01,501,iphone 15,60000,80000,20000,1,00074,India
656918,2023-05-01,501,iphone 15,60000,80000,20000,1,00106,India
656918,2023-05-01,502,iphone 15 pro max,100000,135000,35000,1,00106,India
878497,2023-05-01,503,mixer,1349,3249,1900,1,00175,India
878497,2023-05-01,507,washing machine,6990,16490,9500,1,00175,India
717722,2023-05-01,505,oven,18490,24000,5510,1,00494,India
717722,2023-05-01,507,washing machine,6990,16490,9500,1,00494,India
634732,2023-05-01,504,iron,449,879,430,1,00252,India
634732,2023-05-01,501,iphone 15,60000,80000,20000,1,00252,India
634732,2023-05-01,506,monitor,3249,8000,4751,1,00252,India
199186,2023-05-01,506,monitor,3249,8000,4751,1,00157,India
816634,2023-05-01,502,iphone 15 pro max,100000,135000,35000,1,00064,India
816634,2023-05-01,507,washing machine,6990,16490,9500,1,00064,India
268528,2023-05-01,502,iphone 15 pro max,100000,135000,35000,1,00270,India
268528,2023-05-01,501,iphone 15,60000,80000,20000,1,00270,India
268528,2023-05-01,505,oven,18490,24000,5510,1,00270,India
268528,2023-05-01,507,washing machine,6990,16490,9500,1,00270,India
252297,2023-05-01,502,iphone 15 pro max,100000,135000,35000,1,00411,India
252297,2023-05-01,505,oven,18490,24000,5510,1,00411,India
252297,2023-05-01,507,washing machine,6990,16490,9500,1,00411,India
252297,2023-05-01,503,mixer,1349,3249,1900,1,00411,India
290760,2023-05-01,504,iron,449,879,430,1,00162,India
290760,2023-05-01,507,washing machine,6990,16490,9500,1,00162,India
440890,2023-05-01,503,mixer,1349,3249,1900,1,00487,India
440890,2023-05-01,505,oven,18490,24000,5510,1,00487,India
440890,2023-05-01,501,iphone 15,60000,80000,20000,1,00487,India
107615,2023-05-01,503,mixer,1349,3249,1900,1,00474,India
107615,2023-05-01,502,iphone 15 pro max,100000,135000,35000,1,00474,India
731088,2023-05-01,507,washing machine,6990,16490,9500,1,00458,India
323208,2023-05-01,504,iron,449,879,430,1,00219,India
112627,2023-05-01,503,mixer,1349,3249,1900,1,00136,India
112627,2023-05-01,505,oven,18490,24000,5510,1,00136,India
112627,2023-05-01,506,monitor,3249,8000,4751,1,00136,India
694155,2023-05-01,501,iphone 15,60000,80000,20000,1,00175,India
694155,2023-05-01,506,monitor,3249,8000,4751,1,00175,India
694155,2023-05-01,505,oven,18490,24000,5510,1,00175,India
828606,2023-05-01,502,iphone 15 pro max,100000,135000,35000,1,00454,India
828606,2023-05-01,503,mixer,1349,3249,1900,1,00454,India
228690,2023-05-01,504,iron,449,879,430,1,00194,India
228690,2023-05-01,503,mixer,1349,3249,1900,1,00194,India
228690,2023-05-01,502,iphone 15 pro max,100000,135000,35000,1,00194,India
732977,2023-05-01,507,washing machine,6990,16490,9500,1,00104,India
732977,2023-05-01,505,oven,18490,24000,5510,1,00104,India
666485,2023-05-01,505,oven,18490,24000,5510,1,00422,India
666485,2023-05-01,501,iphone 15,60000,80000,20000,1,00422,India
915988,2023-05-01,502,iphone 15 pro max,100000,135000,35000,1,00436,India
287707,2023-05-01,504,iron,449,879,430,1,00365,India
287707,2023-05-01,507,washing machine,6990,16490,9500,1,00365,India
287707,2023-05-01,502,iphone 15 pro max,100000,135000,35000,1,00365,India
287707,2023-05-01,505,oven,18490,24000,5510,1,00365,India
287707,2023-05-01,503,mixer,1349,3249,1900,1,00365,India
409428,2023-05-01,505,oven,18490,24000,5510,1,00321,India
493756,2023-05-01,507,washing machine,6990,16490,9500,1,00450,India
493756,2023-05-01,505,oven,18490,24000,5510,1,00450,India
493756,2023-05-01,504,iron,449,879,430,1,00450,India
493756,2023-05-01,506,monitor,3249,8000,4751,1,00450,India
274752,2023-05-01,502,iphone 15 pro max,100000,135000,35000,1,00375,India
274752,2023-05-01,503,mixer,1349,3249,1900,1,00375,India
741251,2023-05-01,504,iron,449,879,430,1,00460,India
741251,2023-05-01,506,monitor,3249,8000,4751,1,00460,India
436254,2023-05-01,502,iphone 15 pro max,100000,135000,35000,1,00281,India
436254,2023-05-01,501,iphone 15,60000,80000,20000,1,00281,India
953225,2023-05-01,503,mixer,1349,3249,1900,1,00098,India
953225,2023-05-01,505,oven,18490,24000,5510,1,00098,India
735981,2023-05-01,506,monitor,3249,8000,4751,1,00090,India
735981,2023-05-01,501,iphone 15,60000,80000,20000,1,00090,India
735981,2023-05-01,502,iphone 15 pro max,100000,135000,35000,1,00090,India
244613,2023-05-01,504,iron,449,879,430,1,00119,India
244613,2023-05-01,501,iphone 15,60000,80000,20000,1,00119,India
244613,2023-05-01,507,washing machine,6990,16490,9500,1,00119,India
244613,2023-05-01,502,iphone 15 pro max,100000,135000,35000,1,00119,India
180636,2023-05-01,506,monitor,3249,8000,4751,1,00191,India
180636,2023-05-01,505,oven,18490,24000,5510,1,00191,India
180636,2023-05-01,504,iron,449,879,430,1,00191,India
490267,2023-05-01,504,iron,449,879,430,1,00009,India
490267,2023-05-01,503,mixer,1349,3249,1900,1,00009,India
302028,2023-05-01,502,iphone 15 pro max,100000,135000,35000,1,00048,India
302028,2023-05-01,505,oven,18490,24000,5510,1,00048,India
302028,2023-05-01,506,monitor,3249,8000,4751,1,00048,India
945998,2023-05-01,503,mixer,1349,3249,1900,1,00069,India
945998,2023-05-01,504,iron,449,879,430,1,00069,India
530207,2023-05-01,503,mixer,1349,3249,1900,1,00422,India
521693,2023-05-01,506,monitor,3249,8000,4751,1,00196,India
521693,2023-05-01,507,washing machine,6990,16490,9500,1,00196,India
521693,2023-05-01,501,iphone 15,60000,80000,20000,1,00196,India
521693,2023-05-01,504,iron,449,879,430,1,00196,India
142410,2023-05-01,502,iphone 15 pro max,100000,135000,35000,1,00206,India
142410,2023-05-01,505,oven,18490,24000,5510,1,00206,India
142410,2023-05-01,504,iron,449,879,430,1,00206,India
744192,2023-05-01,505,oven,18490,24000,5510,1,00378,India
744192,2023-05-01,504,iron,449,879,430,1,00378,India
744192,2023-05-01,507,washing machine,6990,16490,9500,1,00378,India
792440,2023-05-01,503,mixer,1349,3249,1900,1,00482,India
178539,2023-05-01,505,oven,18490,24000,5510,1,00224,India
178539,2023-05-01,506,monitor,3249,8000,4751,1,00224,India
610108,2023-05-01,502,iphone 15 pro max,100000,135000,35000,1,00232,India
610108,2023-05-01,503,mixer,1349,3249,1900,1,00232,India
716898,2023-05-01,504,iron,449,879,430,1,00201,India
716898,2023-05-01,501,iphone 15,60000,80000,20000,1,00201,India
716898,2023-05-01,502,iphone 15 pro max,100000,135000,35000,1,00201,India
246488,2023-05-01,506,monitor,3249,8000,4751,1,00436,India
246488,2023-05-01,503,mixer,1349,3249,1900,1,00436,India
246488,2023-05-01,507,washing machine,6990,16490,9500,1,00436,India
387312,2023-05-01,504,iron,449,879,430,1,00355,India
387312,2023-05-01,506,monitor,3249,8000,4751,1,00355,India
387312,2023-05-01,503,mixer,1349,3249,1900,1,00355,India
693054,2023-05-01,503,mixer,1349,3249,1900,1,00393,India
600255,2023-05-01,505,oven,18490,24000,5510,1,00182,India
600255,2023-05-01,502,iphone 15 pro max,100000,135000,35000,1,00182,India
600255,2023-05-01,503,mixer,1349,3249,1900,1,00182,India
636524,2023-05-01,502,iphone 15 pro max,100000,135000,35000,1,00450,India
636524,2023-05-01,501,iphone 15,60000,80000,20000,1,00450,India
636524,2023-05-01,506,monitor,3249,8000,4751,1,00450,India
636524,2023-05-01,507,washing machine,6990,16490,9500,1,00450,India
189684,2023-05-02,505,oven,18490,24000,5510,1,00023,India
189684,2023-05-02,503,mixer,1349,3249,1900,1,00023,India
309005,2023-05-02,501,iphone 15,60000,80000,20000,1,00396,India
309005,2023-05-02,507,washing machine,6990,16490,9500,1,00396,India
398360,2023-05-02,501,iphone 15,60000,80000,20000,1,00325,India
398360,2023-05-02,503,mixer,1349,3249,1900,1,00325,India
720830,2023-05-02,504,iron,449,879,430,1,00014,India
720830,2023-05-02,501,iphone 15,60000,80000,20000,1,00014,India
720830,2023-05-02,502,iphone 15 pro max,100000,135000,35000,1,00014,India
115474,2023-05-02,503,mixer,1349,3249,1900,1,00450,India
565649,2023-05-02,504,iron,449,879,430,1,00264,India
565649,2023-05-02,503,mixer,1349,3249,1900,1,00264,India
565649,2023-05-02,506,monitor,3249,8000,4751,1,00264,India
565649,2023-05-02,505,oven,18490,24000,5510,1,00264,India
378285,2023-05-02,505,oven,18490,24000,5510,1,00274,India
378285,2023-05-02,507,washing machine,6990,16490,9500,1,00274,India
378285,2023-05-02,501,iphone 15,60000,80000,20000,1,00274,India
645097,2023-05-02,501,iphone 15,60000,80000,20000,1,00304,India
645097,2023-05-02,504,iron,449,879,430,1,00304,India
645097,2023-05-02,505,oven,18490,24000,5510,1,00304,India
209930,2023-05-02,507,washing machine,6990,16490,9500,1,00345,India
209930,2023-05-02,502,iphone 15 pro max,100000,135000,35000,1,00345,India
209930,2023-05-02,501,iphone 15,60000,80000,20000,1,00345,India
209930,2023-05-02,503,mixer,1349,3249,1900,1,00345,India
911693,2023-05-02,506,monitor,3249,8000,4751,1,00035,India
911693,2023-05-02,505,oven,18490,24000,5510,1,00035,India
110712,2023-05-02,503,mixer,1349,3249,1900,1,00269,India
110712,2023-05-02,502,iphone 15 pro max,100000,135000,35000,1,00269,India
110712,2023-05-02,505,oven,18490,24000,5510,1,00269,India
444871,2023-05-02,503,mixer,1349,3249,1900,1,00104,India
444871,2023-05-02,506,monitor,3249,8000,4751,1,00104,India
280192,2023-05-02,501,iphone 15,60000,80000,20000,1,00203,India
280192,2023-05-02,506,monitor,3249,8000,4751,1,00203,India
407073,2023-05-02,501,iphone 15,60000,80000,20000,1,00331,India
407073,2023-05-02,504,iron,449,879,430,1,00331,India
407073,2023-05-02,506,monitor,3249,8000,4751,1,00331,India
407073,2023-05-02,502,iphone 15 pro max,100000,135000,35000,1,00331,India
347734,2023-05-02,503,mixer,1349,3249,1900,1,00045,India
347734,2023-05-02,506,monitor,3249,8000,4751,1,00045,India
765075,2023-05-02,502,iphone 15 pro max,100000,135000,35000,1,00259,India
765075,2023-05-02,506,monitor,3249,8000,4751,1,00259,India
765075,2023-05-02,503,mixer,1349,3249,1900,1,00259,India
282399,2023-05-02,507,washing machine,6990,16490,9500,1,00231,India
286617,2023-05-02,506,monitor,3249,8000,4751,1,00342,India
286617,2023-05-02,504,iron,449,879,430,1,00342,India
276888,2023-05-02,503,mixer,1349,3249,1900,1,00172,India
276888,2023-05-02,504,iron,449,879,430,1,00172,India
276888,2023-05-02,505,oven,18490,24000,5510,1,00172,India
276888,2023-05-02,507,washing machine,6990,16490,9500,1,00172,India
947996,2023-05-02,503,mixer,1349,3249,1900,1,00406,India
947996,2023-05-02,501,iphone 15,60000,80000,20000,1,00406,India
947996,2023-05-02,502,iphone 15 pro max,100000,135000,35000,1,00406,India
658696,2023-05-02,502,iphone 15 pro max,100000,135000,35000,1,00207,India
658696,2023-05-02,503,mixer,1349,3249,1900,1,00207,India
658696,2023-05-02,504,iron,449,879,430,1,00207,India
658696,2023-05-02,505,oven,18490,24000,5510,1,00207,India
613717,2023-05-02,506,monitor,3249,8000,4751,1,00480,India
613717,2023-05-02,504,iron,449,879,430,1,00480,India
226299,2023-05-02,506,monitor,3249,8000,4751,1,00044,India
604651,2023-05-02,507,washing machine,6990,16490,9500,1,00101,India
604651,2023-05-02,506,monitor,3249,8000,4751,1,00101,India
785790,2023-05-02,506,monitor,3249,8000,4751,1,00120,India
939263,2023-05-02,504,iron,449,879,430,1,00339,India
479575,2023-05-02,502,iphone 15 pro max,100000,135000,35000,1,00424,India
479575,2023-05-02,507,washing machine,6990,16490,9500,1,00424,India
479575,2023-05-02,504,iron,449,879,430,1,00424,India
713835,2023-05-02,501,iphone 15,60000,80000,20000,1,00077,India
713835,2023-05-02,506,monitor,3249,8000,4751,1,00077,India
713835,2023-05-02,507,washing machine,6990,16490,9500,1,00077,India
755118,2023-05-02,501,iphone 15,60000,80000,20000,1,00474,India
755118,2023-05-02,503,mixer,1349,3249,1900,1,00474,India
755118,2023-05-02,507,washing machine,6990,16490,9500,1,00474,India
755118,2023-05-02,502,iphone 15 pro max,100000,135000,35000,1,00474,India
788563,2023-05-02,504,iron,449,879,430,1,00229,India
788563,2023-05-02,502,iphone 15 pro max,100000,135000,35000,1,00229,India
788563,2023-05-02,507,washing machine,6990,16490,9500,1,00229,India
918796,2023-05-02,504,iron,449,879,430,1,00379,India
918796,2023-05-02,506,monitor,3249,8000,4751,1,00379,India
918796,2023-05-02,505,oven,18490,24000,5510,1,00379,India
918796,2023-05-02,503,mixer,1349,3249,1900,1,00379,India
236705,2023-05-02,503,mixer,1349,3249,1900,1,00300,India
236705,2023-05-02,507,washing machine,6990,16490,9500,1,00300,India
236705,2023-05-02,502,iphone 15 pro max,100000,135000,35000,1,00300,India
677672,2023-05-02,506,monitor,3249,8000,4751,1,00369,India
677672,2023-05-02,505,oven,18490,24000,5510,1,00369,India
677672,2023-05-02,501,iphone 15,60000,80000,20000,1,00369,India
677672,2023-05-02,503,mixer,1349,3249,1900,1,00369,India
647331,2023-05-02,503,mixer,1349,3249,1900,1,00233,India
647331,2023-05-02,505,oven,18490,24000,5510,1,00233,India
406547,2023-05-02,506,monitor,3249,8000,4751,1,00161,India
406547,2023-05-02,503,mixer,1349,3249,1900,1,00161,India
899782,2023-05-02,503,mixer,1349,3249,1900,1,00265,India
899782,2023-05-02,505,oven,18490,24000,5510,1,00265,India
899782,2023-05-02,502,iphone 15 pro max,100000,135000,35000,1,00265,India
890771,2023-05-02,505,oven,18490,24000,5510,1,00219,India
890771,2023-05-02,501,iphone 15,60000,80000,20000,1,00219,India
890771,2023-05-02,507,washing machine,6990,16490,9500,1,00219,India
890771,2023-05-02,503,mixer,1349,3249,1900,1,00219,India
890771,2023-05-02,502,iphone 15 pro max,100000,135000,35000,1,00219,India
995555,2023-05-02,505,oven,18490,24000,5510,1,00441,India
995555,2023-05-02,507,washing machine,6990,16490,9500,1,00441,India
639096,2023-05-02,507,washing machine,6990,16490,9500,1,00236,India
575675,2023-05-02,507,washing machine,6990,16490,9500,1,00372,India
575675,2023-05-02,503,mixer,1349,3249,1900,1,00372,India
575675,2023-05-02,502,iphone 15 pro max,100000,135000,35000,1,00372,India
624522,2023-05-02,501,iphone 15,60000,80000,20000,1,00066,India
624522,2023-05-02,507,washing machine,6990,16490,9500,1,00066,India
619231,2023-05-02,502,iphone 15 pro max,100000,135000,35000,1,00163,India
619231,2023-05-02,507,washing machine,6990,16490,9500,1,00163,India
780883,2023-05-02,504,iron,449,879,430,1,00145,India
780883,2023-05-02,506,monitor,3249,8000,4751,1,00145,India
780883,2023-05-02,505,oven,18490,24000,5510,1,00145,India
780883,2023-05-02,501,iphone 15,60000,80000,20000,1,00145,India
246812,2023-05-02,502,iphone 15 pro max,100000,135000,35000,1,00235,India
246812,2023-05-02,506,monitor,3249,8000,4751,1,00235,India
246812,2023-05-02,507,washing machine,6990,16490,9500,1,00235,India
246812,2023-05-02,501,iphone 15,60000,80000,20000,1,00235,India
553839,2023-05-02,502,iphone 15 pro max,100000,135000,35000,1,00078,India
553839,2023-05-02,501,iphone 15,60000,80000,20000,1,00078,India
553839,2023-05-02,503,mixer,1349,3249,1900,1,00078,India
553839,2023-05-02,504,iron,449,879,430,1,00078,India
974184,2023-05-02,506,monitor,3249,8000,4751,1,00328,India
974184,2023-05-02,502,iphone 15 pro max,100000,135000,35000,1,00328,India
974184,2023-05-02,504,iron,449,879,430,1,00328,India
974184,2023-05-02,505,oven,18490,24000,5510,1,00328,India
184488,2023-05-02,505,oven,18490,24000,5510,1,00067,India
184488,2023-05-02,506,monitor,3249,8000,4751,1,00067,India
184488,2023-05-02,501,iphone 15,60000,80000,20000,1,00067,India
184488,2023-05-02,503,mixer,1349,3249,1900,1,00067,India
849643,2023-05-02,504,iron,449,879,430,1,00157,India
188068,2023-05-02,505,oven,18490,24000,5510,1,00018,India
188068,2023-05-02,502,iphone 15 pro max,100000,135000,35000,1,00018,India
397268,2023-05-02,505,oven,18490,24000,5510,1,00097,India
397268,2023-05-02,504,iron,449,879,430,1,00097,India
813301,2023-05-02,506,monitor,3249,8000,4751,1,00143,India
974228,2023-05-02,504,iron,449,879,430,1,00284,India
974228,2023-05-02,505,oven,18490,24000,5510,1,00284,India
974228,2023-05-02,501,iphone 15,60000,80000,20000,1,00284,India
402043,2023-05-02,505,oven,18490,24000,5510,1,00089,India
345685,2023-05-02,504,iron,449,879,430,1,00040,India
345685,2023-05-02,507,washing machine,6990,16490,9500,1,00040,India
345685,2023-05-02,503,mixer,1349,3249,1900,1,00040,India
345685,2023-05-02,502,iphone 15 pro max,100000,135000,35000,1,00040,India
449837,2023-05-02,504,iron,449,879,430,1,00288,India
449837,2023-05-02,501,iphone 15,60000,80000,20000,1,00288,India
449837,2023-05-02,503,mixer,1349,3249,1900,1,00288,India
449837,2023-05-02,502,iphone 15 pro max,100000,135000,35000,1,00288,India
574269,2023-05-03,507,washing machine,6990,16490,9500,1,00493,India
574269,2023-05-03,505,oven,18490,24000,5510,1,00493,India
574269,2023-05-03,503,mixer,1349,3249,1900,1,00493,India
574269,2023-05-03,501,iphone 15,60000,80000,20000,1,00493,India
500066,2023-05-03,503,mixer,1349,3249,1900,1,00360,India
500066,2023-05-03,504,iron,449,879,430,1,00360,India
748881,2023-05-03,505,oven,18490,24000,5510,1,00008,India
748881,2023-05-03,501,iphone 15,60000,80000,20000,1,00008,India
697502,2023-05-03,501,iphone 15,60000,80000,20000,1,00307,India
697502,2023-05-03,503,mixer,1349,3249,1900,1,00307,India
961388,2023-05-03,501,iphone 15,60000,80000,20000,1,00147,India
961388,2023-05-03,506,monitor,3249,8000,4751,1,00147,India
921006,2023-05-03,506,monitor,3249,8000,4751,1,00100,India
921006,2023-05-03,503,mixer,1349,3249,1900,1,00100,India
921006,2023-05-03,505,oven,18490,24000,5510,1,00100,India
657949,2023-05-03,501,iphone 15,60000,80000,20000,1,00334,India
782148,2023-05-03,501,iphone 15,60000,80000,20000,1,00056,India
782148,2023-05-03,505,oven,18490,24000,5510,1,00056,India
782148,2023-05-03,506,monitor,3249,8000,4751,1,00056,India
693564,2023-05-03,505,oven,18490,24000,5510,1,00067,India
674003,2023-05-03,506,monitor,3249,8000,4751,1,00380,India
674003,2023-05-03,504,iron,449,879,430,1,00380,India
674003,2023-05-03,505,oven,18490,24000,5510,1,00380,India
674003,2023-05-03,503,mixer,1349,3249,1900,1,00380,India
153881,2023-05-03,504,iron,449,879,430,1,00277,India
918037,2023-05-03,505,oven,18490,24000,5510,1,00085,India
918037,2023-05-03,502,iphone 15 pro max,100000,135000,35000,1,00085,India
918037,2023-05-03,506,monitor,3249,8000,4751,1,00085,India
418187,2023-05-03,501,iphone 15,60000,80000,20000,1,00447,India
418187,2023-05-03,504,iron,449,879,430,1,00447,India
860767,2023-05-03,507,washing machine,6990,16490,9500,1,00331,India
860767,2023-05-03,504,iron,449,879,430,1,00331,India
860767,2023-05-03,502,iphone 15 pro max,100000,135000,35000,1,00331,India
860767,2023-05-03,505,oven,18490,24000,5510,1,00331,India
825463,2023-05-03,503,mixer,1349,3249,1900,1,00415,India
825463,2023-05-03,502,iphone 15 pro max,100000,135000,35000,1,00415,India
825463,2023-05-03,506,monitor,3249,8000,4751,1,00415,India
211064,2023-05-03,503,mixer,1349,3249,1900,1,00449,India
211064,2023-05-03,505,oven,18490,24000,5510,1,00449,India
336878,2023-05-03,502,iphone 15 pro max,100000,135000,35000,1,00258,India
219710,2023-05-03,501,iphone 15,60000,80000,20000,1,00117,India
219710,2023-05-03,502,iphone 15 pro max,100000,135000,35000,1,00117,India
219710,2023-05-03,504,iron,449,879,430,1,00117,India
219710,2023-05-03,506,monitor,3249,8000,4751,1,00117,India
232114,2023-05-03,504,iron,449,879,430,1,00026,India
232114,2023-05-03,505,oven,18490,24000,5510,1,00026,India
232114,2023-05-03,506,monitor,3249,8000,4751,1,00026,India
163677,2023-05-03,505,oven,18490,24000,5510,1,00039,India
587145,2023-05-03,502,iphone 15 pro max,100000,135000,35000,1,00318,India
587145,2023-05-03,501,iphone 15,60000,80000,20000,1,00318,India
570651,2023-05-03,506,monitor,3249,8000,4751,1,00002,India
570651,2023-05-03,507,washing machine,6990,16490,9500,1,00002,India
570651,2023-05-03,503,mixer,1349,3249,1900,1,00002,India
741519,2023-05-03,505,oven,18490,24000,5510,1,00046,India
741519,2023-05-03,507,washing machine,6990,16490,9500,1,00046,India
741519,2023-05-03,504,iron,449,879,430,1,00046,India
964776,2023-05-03,504,iron,449,879,430,1,00055,India
964776,2023-05-03,501,iphone 15,60000,80000,20000,1,00055,India
964776,2023-05-03,503,mixer,1349,3249,1900,1,00055,India
964776,2023-05-03,505,oven,18490,24000,5510,1,00055,India
964776,2023-05-03,506,monitor,3249,8000,4751,1,00055,India
866270,2023-05-03,501,iphone 15,60000,80000,20000,1,00363,India
866270,2023-05-03,507,washing machine,6990,16490,9500,1,00363,India
866270,2023-05-03,504,iron,449,879,430,1,00363,India
866270,2023-05-03,506,monitor,3249,8000,4751,1,00363,India
960886,2023-05-03,507,washing machine,6990,16490,9500,1,00007,India
960886,2023-05-03,504,iron,449,879,430,1,00007,India
960886,2023-05-03,506,monitor,3249,8000,4751,1,00007,India
960886,2023-05-03,505,oven,18490,24000,5510,1,00007,India
903703,2023-05-03,507,washing machine,6990,16490,9500,1,00201,India
135183,2023-05-03,502,iphone 15 pro max,100000,135000,35000,1,00241,India
354008,2023-05-03,502,iphone 15 pro max,100000,135000,35000,1,00090,India
859402,2023-05-03,502,iphone 15 pro max,100000,135000,35000,1,00444,India
859402,2023-05-03,506,monitor,3249,8000,4751,1,00444,India
859402,2023-05-03,507,washing machine,6990,16490,9500,1,00444,India
574337,2023-05-03,507,washing machine,6990,16490,9500,1,00489,India
461582,2023-05-03,506,monitor,3249,8000,4751,1,00218,India
306272,2023-05-03,507,washing machine,6990,16490,9500,1,00150,India
464406,2023-05-03,502,iphone 15 pro max,100000,135000,35000,1,00211,India
464406,2023-05-03,506,monitor,3249,8000,4751,1,00211,India
464406,2023-05-03,505,oven,18490,24000,5510,1,00211,India
564020,2023-05-03,507,washing machine,6990,16490,9500,1,00027,India
753855,2023-05-03,506,monitor,3249,8000,4751,1,00104,India
753855,2023-05-03,502,iphone 15 pro max,100000,135000,35000,1,00104,India
753855,2023-05-03,504,iron,449,879,430,1,00104,India
592670,2023-05-03,501,iphone 15,60000,80000,20000,1,00041,India
707435,2023-05-03,504,iron,449,879,430,1,00184,India
538480,2023-05-03,505,oven,18490,24000,5510,1,00367,India
941606,2023-05-03,506,monitor,3249,8000,4751,1,00092,India
178701,2023-05-03,505,oven,18490,24000,5510,1,00030,India
178701,2023-05-03,506,monitor,3249,8000,4751,1,00030,India
178701,2023-05-03,503,mixer,1349,3249,1900,1,00030,India
516951,2023-05-03,501,iphone 15,60000,80000,20000,1,00176,India
516951,2023-05-03,503,mixer,1349,3249,1900,1,00176,India
516951,2023-05-03,504,iron,449,879,430,1,00176,India
516951,2023-05-03,502,iphone 15 pro max,100000,135000,35000,1,00176,India
516951,2023-05-03,507,washing machine,6990,16490,9500,1,00176,India
638959,2023-05-03,507,washing machine,6990,16490,9500,1,00411,India
638959,2023-05-03,506,monitor,3249,8000,4751,1,00411,India
344465,2023-05-03,504,iron,449,879,430,1,00480,India
344465,2023-05-03,501,iphone 15,60000,80000,20000,1,00480,India
344465,2023-05-03,502,iphone 15 pro max,100000,135000,35000,1,00480,India
344465,2023-05-03,503,mixer,1349,3249,1900,1,00480,India
915903,2023-05-03,502,iphone 15 pro max,100000,135000,35000,1,00346,India
344895,2023-05-03,507,washing machine,6990,16490,9500,1,00404,India
731831,2023-05-03,507,washing machine,6990,16490,9500,1,00138,India
731831,2023-05-03,505,oven,18490,24000,5510,1,00138,India
613335,2023-05-03,504,iron,449,879,430,1,00471,India
613335,2023-05-03,501,iphone 15,60000,80000,20000,1,00471,India
613335,2023-05-03,503,mixer,1349,3249,1900,1,00471,India
694885,2023-05-03,506,monitor,3249,8000,4751,1,00283,India
694885,2023-05-03,504,iron,449,879,430,1,00283,India
694885,2023-05-03,501,iphone 15,60000,80000,20000,1,00283,India
694885,2023-05-03,502,iphone 15 pro max,100000,135000,35000,1,00283,India
329784,2023-05-03,506,monitor,3249,8000,4751,1,00101,India
329784,2023-05-03,502,iphone 15 pro max,100000,135000,35000,1,00101,India
329784,2023-05-03,501,iphone 15,60000,80000,20000,1,00101,India
215253,2023-05-03,504,iron,449,879,430,1,00148,India
145675,2023-05-03,506,monitor,3249,8000,4751,1,00189,India
180753,2023-05-03,504,iron,449,879,430,1,00282,India
180753,2023-05-03,503,mixer,1349,3249,1900,1,00282,India
180753,2023-05-03,506,monitor,3249,8000,4751,1,00282,India
180753,2023-05-03,502,iphone 15 pro max,100000,135000,35000,1,00282,India
254318,2023-05-03,503,mixer,1349,3249,1900,1,00306,India
254318,2023-05-03,506,monitor,3249,8000,4751,1,00306,India
701142,2023-05-03,506,monitor,3249,8000,4751,1,00200,India
701142,2023-05-03,504,iron,449,879,430,1,00200,India
701142,2023-05-03,505,oven,18490,24000,5510,1,00200,India
663222,2023-05-03,505,oven,18490,24000,5510,1,00006,India
663222,2023-05-03,503,mixer,1349,3249,1900,1,00006,India
663222,2023-05-03,501,iphone 15,60000,80000,20000,1,00006,India
612549,2023-05-04,503,mixer,1349,3249,1900,1,00270,India
612549,2023-05-04,507,washing machine,6990,16490,9500,1,00270,India
612549,2023-05-04,504,iron,449,879,430,1,00270,India
592537,2023-05-04,505,oven,18490,24000,5510,1,00067,India
592537,2023-05-04,503,mixer,1349,3249,1900,1,00067,India
592537,2023-05-04,506,monitor,3249,8000,4751,1,00067,India
651731,2023-05-04,504,iron,449,879,430,1,00057,India
651731,2023-05-04,501,iphone 15,60000,80000,20000,1,00057,India
651731,2023-05-04,502,iphone 15 pro max,100000,135000,35000,1,00057,India
227396,2023-05-04,504,iron,449,879,430,1,00159,India
227396,2023-05-04,505,oven,18490,24000,5510,1,00159,India
416212,2023-05-04,503,mixer,1349,3249,1900,1,00217,India
416212,2023-05-04,507,washing machine,6990,16490,9500,1,00217,India
416212,2023-05-04,505,oven,18490,24000,5510,1,00217,India
416212,2023-05-04,506,monitor,3249,8000,4751,1,00217,India
837223,2023-05-04,505,oven,18490,24000,5510,1,00357,India
837223,2023-05-04,501,iphone 15,60000,80000,20000,1,00357,India
837223,2023-05-04,504,iron,449,879,430,1,00357,India
891995,2023-05-04,504,iron,449,879,430,1,00211,India
891995,2023-05-04,507,washing machine,6990,16490,9500,1,00211,India
891995,2023-05-04,506,monitor,3249,8000,4751,1,00211,India
430430,2023-05-04,504,iron,449,879,430,1,00125,India
430430,2023-05-04,507,washing machine,6990,16490,9500,1,00125,India
430430,2023-05-04,502,iphone 15 pro max,100000,135000,35000,1,00125,India
656689,2023-05-04,502,iphone 15 pro max,100000,135000,35000,1,00308,India
656689,2023-05-04,506,monitor,3249,8000,4751,1,00308,India
656689,2023-05-04,503,mixer,1349,3249,1900,1,00308,India
498473,2023-05-04,505,oven,18490,24000,5510,1,00067,India
916973,2023-05-04,501,iphone 15,60000,80000,20000,1,00264,India
305370,2023-05-04,504,iron,449,879,430,1,00313,India
305370,2023-05-04,505,oven,18490,24000,5510,1,00313,India
776846,2023-05-04,505,oven,18490,24000,5510,1,00062,India
776846,2023-05-04,506,monitor,3249,8000,4751,1,00062,India
720113,2023-05-04,505,oven,18490,24000,5510,1,00117,India
358588,2023-05-04,501,iphone 15,60000,80000,20000,1,00053,India
358588,2023-05-04,503,mixer,1349,3249,1900,1,00053,India
358588,2023-05-04,505,oven,18490,24000,5510,1,00053,India
197485,2023-05-04,503,mixer,1349,3249,1900,1,00464,India
197485,2023-05-04,505,oven,18490,24000,5510,1,00464,India
197485,2023-05-04,507,washing machine,6990,16490,9500,1,00464,India
197485,2023-05-04,501,iphone 15,60000,80000,20000,1,00464,India
558664,2023-05-04,505,oven,18490,24000,5510,1,00328,India
558664,2023-05-04,501,iphone 15,60000,80000,20000,1,00328,India
558664,2023-05-04,507,washing machine,6990,16490,9500,1,00328,India
558664,2023-05-04,502,iphone 15 pro max,100000,135000,35000,1,00328,India
558664,2023-05-04,506,monitor,3249,8000,4751,1,00328,India
944525,2023-05-04,506,monitor,3249,8000,4751,1,00314,India
944525,2023-05-04,507,washing machine,6990,16490,9500,1,00314,India
944525,2023-05-04,501,iphone 15,60000,80000,20000,1,00314,India
797601,2023-05-04,501,iphone 15,60000,80000,20000,1,00242,India
797601,2023-05-04,507,washing machine,6990,16490,9500,1,00242,India
400988,2023-05-04,502,iphone 15 pro max,100000,135000,35000,1,00467,India
400988,2023-05-04,507,washing machine,6990,16490,9500,1,00467,India
425328,2023-05-04,507,washing machine,6990,16490,9500,1,00381,India
425328,2023-05-04,502,iphone 15 pro max,100000,135000,35000,1,00381,India
425328,2023-05-04,503,mixer,1349,3249,1900,1,00381,India
425328,2023-05-04,506,monitor,3249,8000,4751,1,00381,India
425328,2023-05-04,501,iphone 15,60000,80000,20000,1,00381,India
682869,2023-05-04,501,iphone 15,60000,80000,20000,1,00404,India
170532,2023-05-04,503,mixer,1349,3249,1900,1,00162,India
446516,2023-05-04,503,mixer,1349,3249,1900,1,00080,India
446516,2023-05-04,507,washing machine,6990,16490,9500,1,00080,India
614687,2023-05-04,506,monitor,3249,8000,4751,1,00139,India
191379,2023-05-04,501,iphone 15,60000,80000,20000,1,00343,India
475278,2023-05-04,504,iron,449,879,430,1,00303,India
475278,2023-05-04,507,washing machine,6990,16490,9500,1,00303,India
475278,2023-05-04,506,monitor,3249,8000,4751,1,00303,India
475278,2023-05-04,501,iphone 15,60000,80000,20000,1,00303,India
287846,2023-05-04,507,washing machine,6990,16490,9500,1,00121,India
433424,2023-05-04,502,iphone 15 pro max,100000,135000,35000,1,00319,India
433424,2023-05-04,503,mixer,1349,3249,1900,1,00319,India
433424,2023-05-04,507,washing machine,6990,16490,9500,1,00319,India
124000,2023-05-04,503,mixer,1349,3249,1900,1,00290,India
124000,2023-05-04,502,iphone 15 pro max,100000,135000,35000,1,00290,India
124000,2023-05-04,504,iron,449,879,430,1,00290,India
249809,2023-05-04,504,iron,449,879,430,1,00300,India
249809,2023-05-04,502,iphone 15 pro max,100000,135000,35000,1,00300,India
113258,2023-05-04,503,mixer,1349,3249,1900,1,00114,India
113258,2023-05-04,502,iphone 15 pro max,100000,135000,35000,1,00114,India
113258,2023-05-04,506,monitor,3249,8000,4751,1,00114,India
113258,2023-05-04,507,washing machine,6990,16490,9500,1,00114,India
975114,2023-05-04,503,mixer,1349,3249,1900,1,00053,India
975114,2023-05-04,502,iphone 15 pro max,100000,135000,35000,1,00053,India
975114,2023-05-04,505,oven,18490,24000,5510,1,00053,India
387499,2023-05-04,504,iron,449,879,430,1,00428,India
387499,2023-05-04,503,mixer,1349,3249,1900,1,00428,India
387499,2023-05-04,506,monitor,3249,8000,4751,1,00428,India
387499,2023-05-04,502,iphone 15 pro max,100000,135000,35000,1,00428,India
246930,2023-05-04,503,mixer,1349,3249,1900,1,00396,India
246930,2023-05-04,507,washing machine,6990,16490,9500,1,00396,India
376857,2023-05-04,501,iphone 15,60000,80000,20000,1,00337,India
206811,2023-05-04,507,washing machine,6990,16490,9500,1,00116,India
175280,2023-05-04,504,iron,449,879,430,1,00353,India
175280,2023-05-04,502,iphone 15 pro max,100000,135000,35000,1,00353,India
819625,2023-05-04,502,iphone 15 pro max,100000,135000,35000,1,00441,India
819625,2023-05-04,505,oven,18490,24000,5510,1,00441,India
819625,2023-05-04,501,iphone 15,60000,80000,20000,1,00441,India
733241,2023-05-04,505,oven,18490,24000,5510,1,00336,India
382424,2023-05-04,505,oven,18490,24000,5510,1,00294,India
382424,2023-05-04,502,iphone 15 pro max,100000,135000,35000,1,00294,India
676691,2023-05-04,506,monitor,3249,8000,4751,1,00294,India
676691,2023-05-04,503,mixer,1349,3249,1900,1,00294,India
676691,2023-05-04,507,washing machine,6990,16490,9500,1,00294,India
676691,2023-05-04,502,iphone 15 pro max,100000,135000,35000,1,00294,India
870888,2023-05-04,502,iphone 15 pro max,100000,135000,35000,1,00321,India
870888,2023-05-04,506,monitor,3249,8000,4751,1,00321,India
786062,2023-05-04,505,oven,18490,24000,5510,1,00226,India
786062,2023-05-04,503,mixer,1349,3249,1900,1,00226,India
267481,2023-05-04,503,mixer,1349,3249,1900,1,00313,India
267481,2023-05-04,504,iron,449,879,430,1,00313,India
267481,2023-05-04,501,iphone 15,60000,80000,20000,1,00313,India
671405,2023-05-04,501,iphone 15,60000,80000,20000,1,00043,India
671405,2023-05-04,506,monitor,3249,8000,4751,1,00043,India
671405,2023-05-04,505,oven,18490,24000,5510,1,00043,India
634485,2023-05-04,501,iphone 15,60000,80000,20000,1,00109,India
634485,2023-05-04,502,iphone 15 pro max,100000,135000,35000,1,00109,India
808074,2023-05-04,503,mixer,1349,3249,1900,1,00428,India
808074,2023-05-04,505,oven,18490,24000,5510,1,00428,India
808074,2023-05-04,504,iron,449,879,430,1,00428,India
678549,2023-05-04,505,oven,18490,24000,5510,1,00475,India
678549,2023-05-04,502,iphone 15 pro max,100000,135000,35000,1,00475,India
939064,2023-05-04,505,oven,18490,24000,5510,1,00209,India
563229,2023-05-04,505,oven,18490,24000,5510,1,00398,India
334606,2023-05-04,503,mixer,1349,3249,1900,1,00423,India
365810,2023-05-04,502,iphone 15 pro max,100000,135000,35000,1,00124,India
365810,2023-05-04,507,washing machine,6990,16490,9500,1,00124,India
927100,2023-05-04,504,iron,449,879,430,1,00239,India
927100,2023-05-04,501,iphone 15,60000,80000,20000,1,00239,India
567603,2023-05-04,502,iphone 15 pro max,100000,135000,35000,1,00125,India
567603,2023-05-04,507,washing machine,6990,16490,9500,1,00125,India
567603,2023-05-04,505,oven,18490,24000,5510,1,00125,India
567603,2023-05-04,501,iphone 15,60000,80000,20000,1,00125,India
134409,2023-05-04,504,iron,449,879,430,1,00067,India
134409,2023-05-04,503,mixer,1349,3249,1900,1,00067,India
134409,2023-05-04,507,washing machine,6990,16490,9500,1,00067,India
590585,2023-05-04,506,monitor,3249,8000,4751,1,00278,India
258947,2023-05-04,502,iphone 15 pro max,100000,135000,35000,1,00200,India
680707,2023-05-04,502,iphone 15 pro max,100000,135000,35000,1,00092,India
680707,2023-05-04,506,monitor,3249,8000,4751,1,00092,India
680707,2023-05-04,501,iphone 15,60000,80000,20000,1,00092,India
680707,2023-05-04,507,washing machine,6990,16490,9500,1,00092,India
105145,2023-05-04,506,monitor,3249,8000,4751,1,00045,India
105145,2023-05-04,505,oven,18490,24000,5510,1,00045,India
105145,2023-05-04,504,iron,449,879,430,1,00045,India
105145,2023-05-04,502,iphone 15 pro max,100000,135000,35000,1,00045,India
489475,2023-05-04,503,mixer,1349,3249,1900,1,00017,India
489475,2023-05-04,502,iphone 15 pro max,100000,135000,35000,1,00017,India
489475,2023-05-04,506,monitor,3249,8000,4751,1,00017,India
293086,2023-05-04,505,oven,18490,24000,5510,1,00223,India
293086,2023-05-04,503,mixer,1349,3249,1900,1,00223,India
108293,2023-05-04,505,oven,18490,24000,5510,1,00313,India
108293,2023-05-04,507,washing machine,6990,16490,9500,1,00313,India
553568,2023-05-04,504,iron,449,879,430,1,00439,India
553568,2023-05-04,503,mixer,1349,3249,1900,1,00439,India
553568,2023-05-04,502,iphone 15 pro max,100000,135000,35000,1,00439,India
735990,2023-05-04,506,monitor,3249,8000,4751,1,00256,India
735990,2023-05-04,501,iphone 15,60000,80000,20000,1,00256,India
735990,2023-05-04,503,mixer,1349,3249,1900,1,00256,India
735990,2023-05-04,504,iron,449,879,430,1,00256,India
692561,2023-05-04,502,iphone 15 pro max,100000,135000,35000,1,00049,India
303000,2023-05-04,505,oven,18490,24000,5510,1,00229,India
303000,2023-05-04,506,monitor,3249,8000,4751,1,00229,India
902932,2023-05-04,505,oven,18490,24000,5510,1,00129,India
267628,2023-05-04,504,iron,449,879,430,1,00089,India
267628,2023-05-04,505,oven,18490,24000,5510,1,00089,India
267628,2023-05-04,501,iphone 15,60000,80000,20000,1,00089,India
651636,2023-05-04,501,iphone 15,60000,80000,20000,1,00441,India
774764,2023-05-04,504,iron,449,879,430,1,00238,India
872026,2023-05-04,505,oven,18490,24000,5510,1,00183,India
872026,2023-05-04,507,washing machine,6990,16490,9500,1,00183,India
872026,2023-05-04,501,iphone 15,60000,80000,20000,1,00183,India
872026,2023-05-04,502,iphone 15 pro max,100000,135000,35000,1,00183,India
623794,2023-05-04,504,iron,449,879,430,1,00184,India
623794,2023-05-04,507,washing machine,6990,16490,9500,1,00184,India
623794,2023-05-04,502,iphone 15 pro max,100000,135000,35000,1,00184,India
930241,2023-05-04,502,iphone 15 pro max,100000,135000,35000,1,00043,India
930241,2023-05-04,507,washing machine,6990,16490,9500,1,00043,India
930241,2023-05-04,501,iphone 15,60000,80000,20000,1,00043,India
272789,2023-05-04,507,washing machine,6990,16490,9500,1,00455,India
912979,2023-05-04,501,iphone 15,60000,80000,20000,1,00145,India
912979,2023-05-04,503,mixer,1349,3249,1900,1,00145,India
792226,2023-05-04,504,iron,449,879,430,1,00127,India
156311,2023-05-04,507,washing machine,6990,16490,9500,1,00213,India
759155,2023-05-04,507,washing machine,6990,16490,9500,1,00205,India
670456,2023-05-04,506,monitor,3249,8000,4751,1,00362,India
670456,2023-05-04,507,washing machine,6990,16490,9500,1,00362,India
670456,2023-05-04,504,iron,449,879,430,1,00362,India
719707,2023-05-04,503,mixer,1349,3249,1900,1,00096,India
719707,2023-05-04,506,monitor,3249,8000,4751,1,00096,India
719707,2023-05-04,501,iphone 15,60000,80000,20000,1,00096,India
211938,2023-05-04,503,mixer,1349,3249,1900,1,00172,India
337034,2023-05-04,504,iron,449,879,430,1,00203,India
337034,2023-05-04,505,oven,18490,24000,5510,1,00203,India
337034,2023-05-04,503,mixer,1349,3249,1900,1,00203,India
674445,2023-05-04,505,oven,18490,24000,5510,1,00095,India
674445,2023-05-04,506,monitor,3249,8000,4751,1,00095,India
674445,2023-05-04,502,iphone 15 pro max,100000,135000,35000,1,00095,India
674445,2023-05-04,501,iphone 15,60000,80000,20000,1,00095,India
326767,2023-05-04,502,iphone 15 pro max,100000,135000,35000,1,00118,India
326767,2023-05-04,503,mixer,1349,3249,1900,1,00118,India
326767,2023-05-04,507,washing machine,6990,16490,9500,1,00118,India
332552,2023-05-04,507,washing machine,6990,16490,9500,1,00067,India
342957,2023-05-04,503,mixer,1349,3249,1900,1,00010,India
342957,2023-05-04,507,washing machine,6990,16490,9500,1,00010,India
342957,2023-05-04,506,monitor,3249,8000,4751,1,00010,India
342957,2023-05-04,504,iron,449,879,430,1,00010,India
716329,2023-05-04,504,iron,449,879,430,1,00294,India
716329,2023-05-04,502,iphone 15 pro max,100000,135000,35000,1,00294,India
716329,2023-05-04,503,mixer,1349,3249,1900,1,00294,India
716329,2023-05-04,505,oven,18490,24000,5510,1,00294,India
635377,2023-05-04,505,oven,18490,24000,5510,1,00305,India
635377,2023-05-04,506,monitor,3249,8000,4751,1,00305,India
635377,2023-05-04,504,iron,449,879,430,1,00305,India
728258,2023-05-05,507,washing machine,6990,16490,9500,1,00390,India
728258,2023-05-05,506,monitor,3249,8000,4751,1,00390,India
728258,2023-05-05,504,iron,449,879,430,1,00390,India
728258,2023-05-05,502,iphone 15 pro max,100000,135000,35000,1,00390,India
584500,2023-05-05,501,iphone 15,60000,80000,20000,1,00360,India
679011,2023-05-05,504,iron,449,879,430,1,00203,India
679011,2023-05-05,507,washing machine,6990,16490,9500,1,00203,India
679011,2023-05-05,503,mixer,1349,3249,1900,1,00203,India
331359,2023-05-05,507,washing machine,6990,16490,9500,1,00270,India
331359,2023-05-05,505,oven,18490,24000,5510,1,00270,India
331359,2023-05-05,506,monitor,3249,8000,4751,1,00270,India
659869,2023-05-05,504,iron,449,879,430,1,00305,India
659869,2023-05-05,501,iphone 15,60000,80000,20000,1,00305,India
659869,2023-05-05,505,oven,18490,24000,5510,1,00305,India
659869,2023-05-05,506,monitor,3249,8000,4751,1,00305,India
253650,2023-05-05,504,iron,449,879,430,1,00161,India
253650,2023-05-05,501,iphone 15,60000,80000,20000,1,00161,India
253650,2023-05-05,503,mixer,1349,3249,1900,1,00161,India
927817,2023-05-05,507,washing machine,6990,16490,9500,1,00309,India
810569,2023-05-05,503,mixer,1349,3249,1900,1,00013,India
966387,2023-05-05,504,iron,449,879,430,1,00413,India
966387,2023-05-05,505,oven,18490,24000,5510,1,00413,India
966387,2023-05-05,503,mixer,1349,3249,1900,1,00413,India
529996,2023-05-05,503,mixer,1349,3249,1900,1,00355,India
529996,2023-05-05,504,iron,449,879,430,1,00355,India
529996,2023-05-05,506,monitor,3249,8000,4751,1,00355,India
211282,2023-05-05,506,monitor,3249,8000,4751,1,00453,India
211282,2023-05-05,502,iphone 15 pro max,100000,135000,35000,1,00453,India
286446,2023-05-05,502,iphone 15 pro max,100000,135000,35000,1,00300,India
286446,2023-05-05,503,mixer,1349,3249,1900,1,00300,India
286446,2023-05-05,507,washing machine,6990,16490,9500,1,00300,India
560640,2023-05-05,505,oven,18490,24000,5510,1,00007,India
899121,2023-05-05,503,mixer,1349,3249,1900,1,00060,India
899121,2023-05-05,507,washing machine,6990,16490,9500,1,00060,India
899121,2023-05-05,504,iron,449,879,430,1,00060,India
974628,2023-05-05,503,mixer,1349,3249,1900,1,00170,India
974628,2023-05-05,501,iphone 15,60000,80000,20000,1,00170,India
866794,2023-05-05,503,mixer,1349,3249,1900,1,00250,India
866794,2023-05-05,506,monitor,3249,8000,4751,1,00250,India
779561,2023-05-05,505,oven,18490,24000,5510,1,00400,India
779561,2023-05-05,506,monitor,3249,8000,4751,1,00400,India
779561,2023-05-05,507,washing machine,6990,16490,9500,1,00400,India
904723,2023-05-05,506,monitor,3249,8000,4751,1,00012,India
399275,2023-05-05,505,oven,18490,24000,5510,1,00076,India
523398,2023-05-05,503,mixer,1349,3249,1900,1,00019,India
837502,2023-05-05,506,monitor,3249,8000,4751,1,00275,India
837502,2023-05-05,501,iphone 15,60000,80000,20000,1,00275,India
795767,2023-05-05,506,monitor,3249,8000,4751,1,00071,India
795767,2023-05-05,507,washing machine,6990,16490,9500,1,00071,India
795767,2023-05-05,504,iron,449,879,430,1,00071,India
470647,2023-05-05,507,washing machine,6990,16490,9500,1,00239,India
470647,2023-05-05,503,mixer,1349,3249,1900,1,00239,India
470647,2023-05-05,505,oven,18490,24000,5510,1,00239,India
319022,2023-05-05,506,monitor,3249,8000,4751,1,00415,India
319022,2023-05-05,502,iphone 15 pro max,100000,135000,35000,1,00415,India
530953,2023-05-05,502,iphone 15 pro max,100000,135000,35000,1,00423,India
530953,2023-05-05,507,washing machine,6990,16490,9500,1,00423,India
530953,2023-05-05,505,oven,18490,24000,5510,1,00423,India
530953,2023-05-05,503,mixer,1349,3249,1900,1,00423,India
221542,2023-05-05,501,iphone 15,60000,80000,20000,1,00143,India
221542,2023-05-05,504,iron,449,879,430,1,00143,India
221542,2023-05-05,505,oven,18490,24000,5510,1,00143,India
506943,2023-05-05,507,washing machine,6990,16490,9500,1,00389,India
506943,2023-05-05,502,iphone 15 pro max,100000,135000,35000,1,00389,India
571649,2023-05-05,507,washing machine,6990,16490,9500,1,00472,India
388543,2023-05-05,507,washing machine,6990,16490,9500,1,00204,India
886285,2023-05-05,507,washing machine,6990,16490,9500,1,00182,India
886285,2023-05-05,505,oven,18490,24000,5510,1,00182,India
886285,2023-05-05,503,mixer,1349,3249,1900,1,00182,India
424006,2023-05-05,504,iron,449,879,430,1,00440,India
424006,2023-05-05,505,oven,18490,24000,5510,1,00440,India
424006,2023-05-05,502,iphone 15 pro max,100000,135000,35000,1,00440,India
559852,2023-05-05,507,washing machine,6990,16490,9500,1,00240,India
230384,2023-05-05,507,washing machine,6990,16490,9500,1,00092,India
230384,2023-05-05,503,mixer,1349,3249,1900,1,00092,India
230384,2023-05-05,506,monitor,3249,8000,4751,1,00092,India
585752,2023-05-05,501,iphone 15,60000,80000,20000,1,00223,India
585752,2023-05-05,503,mixer,1349,3249,1900,1,00223,India
490446,2023-05-05,501,iphone 15,60000,80000,20000,1,00329,India
490446,2023-05-05,502,iphone 15 pro max,100000,135000,35000,1,00329,India
490446,2023-05-05,506,monitor,3249,8000,4751,1,00329,India
881504,2023-05-05,505,oven,18490,24000,5510,1,00314,India
108380,2023-05-05,506,monitor,3249,8000,4751,1,00332,India
615973,2023-05-05,507,washing machine,6990,16490,9500,1,00219,India
249376,2023-05-05,504,iron,449,879,430,1,00414,India
249376,2023-05-05,505,oven,18490,24000,5510,1,00414,India
865491,2023-05-05,504,iron,449,879,430,1,00336,India
680797,2023-05-05,504,iron,449,879,430,1,00089,India
680797,2023-05-05,505,oven,18490,24000,5510,1,00089,India
680797,2023-05-05,502,iphone 15 pro max,100000,135000,35000,1,00089,India
680797,2023-05-05,506,monitor,3249,8000,4751,1,00089,India
333131,2023-05-05,507,washing machine,6990,16490,9500,1,00108,India
333131,2023-05-05,501,iphone 15,60000,80000,20000,1,00108,India
619474,2023-05-05,502,iphone 15 pro max,100000,135000,35000,1,00314,India
770348,2023-05-05,506,monitor,3249,8000,4751,1,00337,India
770348,2023-05-05,502,iphone 15 pro max,100000,135000,35000,1,00337,India
770348,2023-05-05,504,iron,449,879,430,1,00337,India
336439,2023-05-05,505,oven,18490,24000,5510,1,00310,India
336439,2023-05-05,504,iron,449,879,430,1,00310,India
336439,2023-05-05,506,monitor,3249,8000,4751,1,00310,India
336439,2023-05-05,502,iphone 15 pro max,100000,135000,35000,1,00310,India
447639,2023-05-05,501,iphone 15,60000,80000,20000,1,00332,India
447639,2023-05-05,505,oven,18490,24000,5510,1,00332,India
474086,2023-05-05,501,iphone 15,60000,80000,20000,1,00466,India
621741,2023-05-05,505,oven,18490,24000,5510,1,00064,India
454861,2023-05-05,507,washing machine,6990,16490,9500,1,00067,India
454861,2023-05-05,503,mixer,1349,3249,1900,1,00067,India
454861,2023-05-05,502,iphone 15 pro max,100000,135000,35000,1,00067,India
454861,2023-05-05,501,iphone 15,60000,80000,20000,1,00067,India
300182,2023-05-05,504,iron,449,879,430,1,00304,India
478131,2023-05-05,503,mixer,1349,3249,1900,1,00190,India
478131,2023-05-05,501,iphone 15,60000,80000,20000,1,00190,India
478131,2023-05-05,504,iron,449,879,430,1,00190,India
565211,2023-05-05,502,iphone 15 pro max,100000,135000,35000,1,00273,India
565211,2023-05-05,504,iron,449,879,430,1,00273,India
565211,2023-05-05,501,iphone 15,60000,80000,20000,1,00273,India
746466,2023-05-05,503,mixer,1349,3249,1900,1,00331,India
500149,2023-05-05,501,iphone 15,60000,80000,20000,1,00144,India
885985,2023-05-05,501,iphone 15,60000,80000,20000,1,00456,India
885985,2023-05-05,503,mixer,1349,3249,1900,1,00456,India
885985,2023-05-05,504,iron,449,879,430,1,00456,India
479931,2023-05-05,506,monitor,3249,8000,4751,1,00006,India
479931,2023-05-05,507,washing machine,6990,16490,9500,1,00006,India
479931,2023-05-05,504,iron,449,879,430,1,00006,India
479931,2023-05-05,501,iphone 15,60000,80000,20000,1,00006,India
583150,2023-05-05,507,washing machine,6990,16490,9500,1,00277,India
583150,2023-05-05,506,monitor,3249,8000,4751,1,00277,India
583150,2023-05-05,503,mixer,1349,3249,1900,1,00277,India
583150,2023-05-05,505,oven,18490,24000,5510,1,00277,India
209178,2023-05-05,501,iphone 15,60000,80000,20000,1,00384,India
209178,2023-05-05,506,monitor,3249,8000,4751,1,00384,India
209178,2023-05-05,503,mixer,1349,3249,1900,1,00384,India
927533,2023-05-05,506,monitor,3249,8000,4751,1,00063,India
927533,2023-05-05,507,washing machine,6990,16490,9500,1,00063,India
787491,2023-05-05,504,iron,449,879,430,1,00479,India
787491,2023-05-05,506,monitor,3249,8000,4751,1,00479,India
787491,2023-05-05,505,oven,18490,24000,5510,1,00479,India
349980,2023-05-05,505,oven,18490,24000,5510,1,00219,India
349980,2023-05-05,502,iphone 15 pro max,100000,135000,35000,1,00219,India
349980,2023-05-05,507,washing machine,6990,16490,9500,1,00219,India
161788,2023-05-05,502,iphone 15 pro max,100000,135000,35000,1,00452,India
154126,2023-05-05,503,mixer,1349,3249,1900,1,00075,India
154126,2023-05-05,507,washing machine,6990,16490,9500,1,00075,India
258082,2023-05-05,507,washing machine,6990,16490,9500,1,00044,India
258082,2023-05-05,506,monitor,3249,8000,4751,1,00044,India
258082,2023-05-05,505,oven,18490,24000,5510,1,00044,India
258082,2023-05-05,501,iphone 15,60000,80000,20000,1,00044,India
606366,2023-05-05,502,iphone 15 pro max,100000,135000,35000,1,00284,India
456382,2023-05-05,501,iphone 15,60000,80000,20000,1,00309,India
456382,2023-05-05,504,iron,449,879,430,1,00309,India
312088,2023-05-05,507,washing machine,6990,16490,9500,1,00276,India
312088,2023-05-05,504,iron,449,879,430,1,00276,India
452085,2023-05-05,506,monitor,3249,8000,4751,1,00246,India
333679,2023-05-05,505,oven,18490,24000,5510,1,00302,India
333679,2023-05-05,504,iron,449,879,430,1,00302,India
333679,2023-05-05,506,monitor,3249,8000,4751,1,00302,India
489308,2023-05-05,504,iron,449,879,430,1,00478,India
438308,2023-05-05,504,iron,449,879,430,1,00200,India
438308,2023-05-05,502,iphone 15 pro max,100000,135000,35000,1,00200,India
438308,2023-05-05,507,washing machine,6990,16490,9500,1,00200,India
438308,2023-05-05,501,iphone 15,60000,80000,20000,1,00200,India
438308,2023-05-05,503,mixer,1349,3249,1900,1,00200,India
551543,2023-05-05,504,iron,449,879,430,1,00038,India
551543,2023-05-05,507,washing machine,6990,16490,9500,1,00038,India
551543,2023-05-05,502,iphone 15 pro max,100000,135000,35000,1,00038,India
551543,2023-05-05,501,iphone 15,60000,80000,20000,1,00038,India
658946,2023-05-05,502,iphone 15 pro max,100000,135000,35000,1,00098,India
658946,2023-05-05,503,mixer,1349,3249,1900,1,00098,India
658946,2023-05-05,506,monitor,3249,8000,4751,1,00098,India
658946,2023-05-05,505,oven,18490,24000,5510,1,00098,India
658946,2023-05-05,501,iphone 15,60000,80000,20000,1,00098,India
516145,2023-05-05,503,mixer,1349,3249,1900,1,00017,India
516145,2023-05-05,505,oven,18490,24000,5510,1,00017,India
411774,2023-05-05,503,mixer,1349,3249,1900,1,00387,India
411774,2023-05-05,501,iphone 15,60000,80000,20000,1,00387,India
411774,2023-05-05,507,washing machine,6990,16490,9500,1,00387,India
132646,2023-05-05,501,iphone 15,60000,80000,20000,1,00086,India
132646,2023-05-05,503,mixer,1349,3249,1900,1,00086,India
132646,2023-05-05,506,monitor,3249,8000,4751,1,00086,India
663592,2023-05-05,503,mixer,1349,3249,1900,1,00399,India
663592,2023-05-05,504,iron,449,879,430,1,00399,India
663592,2023-05-05,502,iphone 15 pro max,100000,135000,35000,1,00399,India
663592,2023-05-05,501,iphone 15,60000,80000,20000,1,00399,India
577568,2023-05-05,505,oven,18490,24000,5510,1,00107,India
577568,2023-05-05,506,monitor,3249,8000,4751,1,00107,India
624419,2023-05-05,504,iron,449,879,430,1,00280,India
624419,2023-05-05,501,iphone 15,60000,80000,20000,1,00280,India
624419,2023-05-05,505,oven,18490,24000,5510,1,00280,India
624419,2023-05-05,502,iphone 15 pro max,100000,135000,35000,1,00280,India
216042,2023-05-05,502,iphone 15 pro max,100000,135000,35000,1,00339,India
216042,2023-05-05,507,washing machine,6990,16490,9500,1,00339,India
104707,2023-05-05,502,iphone 15 pro max,100000,135000,35000,1,00051,India
104707,2023-05-05,501,iphone 15,60000,80000,20000,1,00051,India
550999,2023-05-05,504,iron,449,879,430,1,00095,India
550999,2023-05-05,503,mixer,1349,3249,1900,1,00095,India
253729,2023-05-05,504,iron,449,879,430,1,00075,India
253729,2023-05-05,505,oven,18490,24000,5510,1,00075,India
253729,2023-05-05,507,washing machine,6990,16490,9500,1,00075,India
253729,2023-05-05,506,monitor,3249,8000,4751,1,00075,India
253729,2023-05-05,502,iphone 15 pro max,100000,135000,35000,1,00075,India
534359,2023-05-05,503,mixer,1349,3249,1900,1,00246,India
534359,2023-05-05,502,iphone 15 pro max,100000,135000,35000,1,00246,India
534359,2023-05-05,504,iron,449,879,430,1,00246,India
534359,2023-05-05,507,washing machine,6990,16490,9500,1,00246,India
534359,2023-05-05,505,oven,18490,24000,5510,1,00246,India
947367,2023-05-05,502,iphone 15 pro max,100000,135000,35000,1,00451,India
720593,2023-05-05,504,iron,449,879,430,1,00322,India
720593,2023-05-05,503,mixer,1349,3249,1900,1,00322,India
720593,2023-05-05,506,monitor,3249,8000,4751,1,00322,India
720593,2023-05-05,507,washing machine,6990,16490,9500,1,00322,India
593550,2023-05-05,503,mixer,1349,3249,1900,1,00090,India
593550,2023-05-05,501,iphone 15,60000,80000,20000,1,00090,India
736914,2023-05-05,504,iron,449,879,430,1,00204,India
736914,2023-05-05,506,monitor,3249,8000,4751,1,00204,India
736914,2023-05-05,505,oven,18490,24000,5510,1,00204,India
340432,2023-05-05,503,mixer,1349,3249,1900,1,00398,India
340432,2023-05-05,501,iphone 15,60000,80000,20000,1,00398,India
977308,2023-05-06,504,iron,449,879,430,1,00287,India
396584,2023-05-06,506,monitor,3249,8000,4751,1,00164,India
396584,2023-05-06,504,iron,449,879,430,1,00164,India
985750,2023-05-06,503,mixer,1349,3249,1900,1,00116,India
985750,2023-05-06,505,oven,18490,24000,5510,1,00116,India
316190,2023-05-06,503,mixer,1349,3249,1900,1,00101,India
316190,2023-05-06,502,iphone 15 pro max,100000,135000,35000,1,00101,India
316190,2023-05-06,507,washing machine,6990,16490,9500,1,00101,India
316190,2023-05-06,504,iron,449,879,430,1,00101,India
552290,2023-05-06,506,monitor,3249,8000,4751,1,00069,India
552290,2023-05-06,502,iphone 15 pro max,100000,135000,35000,1,00069,India
552290,2023-05-06,505,oven,18490,24000,5510,1,00069,India
552290,2023-05-06,504,iron,449,879,430,1,00069,India
609164,2023-05-06,502,iphone 15 pro max,100000,135000,35000,1,00054,India
609164,2023-05-06,504,iron,449,879,430,1,00054,India
268841,2023-05-06,505,oven,18490,24000,5510,1,00024,India
268841,2023-05-06,506,monitor,3249,8000,4751,1,00024,India
268841,2023-05-06,502,iphone 15 pro max,100000,135000,35000,1,00024,India
268841,2023-05-06,504,iron,449,879,430,1,00024,India
873681,2023-05-06,505,oven,18490,24000,5510,1,00302,India
873681,2023-05-06,501,iphone 15,60000,80000,20000,1,00302,India
216870,2023-05-06,507,washing machine,6990,16490,9500,1,00218,India
107558,2023-05-06,504,iron,449,879,430,1,00369,India
107558,2023-05-06,507,washing machine,6990,16490,9500,1,00369,India
107558,2023-05-06,506,monitor,3249,8000,4751,1,00369,India
107558,2023-05-06,502,iphone 15 pro max,100000,135000,35000,1,00369,India
274907,2023-05-06,507,washing machine,6990,16490,9500,1,00314,India
274907,2023-05-06,506,monitor,3249,8000,4751,1,00314,India
274907,2023-05-06,505,oven,18490,24000,5510,1,00314,India
327339,2023-05-06,507,washing machine,6990,16490,9500,1,00365,India
327339,2023-05-06,501,iphone 15,60000,80000,20000,1,00365,India
327339,2023-05-06,506,monitor,3249,8000,4751,1,00365,India
395989,2023-05-06,504,iron,449,879,430,1,00452,India
395989,2023-05-06,503,mixer,1349,3249,1900,1,00452,India
368595,2023-05-06,503,mixer,1349,3249,1900,1,00201,India
368595,2023-05-06,507,washing machine,6990,16490,9500,1,00201,India
368595,2023-05-06,504,iron,449,879,430,1,00201,India
368595,2023-05-06,502,iphone 15 pro max,100000,135000,35000,1,00201,India
485142,2023-05-06,505,oven,18490,24000,5510,1,00122,India
485142,2023-05-06,502,iphone 15 pro max,100000,135000,35000,1,00122,India
485142,2023-05-06,504,iron,449,879,430,1,00122,India
485142,2023-05-06,507,washing machine,6990,16490,9500,1,00122,India
333552,2023-05-06,507,washing machine,6990,16490,9500,1,00445,India
333552,2023-05-06,506,monitor,3249,8000,4751,1,00445,India
333552,2023-05-06,503,mixer,1349,3249,1900,1,00445,India
884171,2023-05-06,507,washing machine,6990,16490,9500,1,00252,India
251755,2023-05-06,502,iphone 15 pro max,100000,135000,35000,1,00294,India
462262,2023-05-06,506,monitor,3249,8000,4751,1,00384,India
462262,2023-05-06,505,oven,18490,24000,5510,1,00384,India
591885,2023-05-06,507,washing machine,6990,16490,9500,1,00260,India
591885,2023-05-06,505,oven,18490,24000,5510,1,00260,India
591885,2023-05-06,506,monitor,3249,8000,4751,1,00260,India
652904,2023-05-06,504,iron,449,879,430,1,00245,India
649877,2023-05-06,506,monitor,3249,8000,4751,1,00212,India
600351,2023-05-06,503,mixer,1349,3249,1900,1,00322,India
600351,2023-05-06,502,iphone 15 pro max,100000,135000,35000,1,00322,India
600351,2023-05-06,506,monitor,3249,8000,4751,1,00322,India
600351,2023-05-06,504,iron,449,879,430,1,00322,India
508765,2023-05-06,503,mixer,1349,3249,1900,1,00195,India
508765,2023-05-06,504,iron,449,879,430,1,00195,India
508765,2023-05-06,502,iphone 15 pro max,100000,135000,35000,1,00195,India
976263,2023-05-06,503,mixer,1349,3249,1900,1,00433,India
976263,2023-05-06,502,iphone 15 pro max,100000,135000,35000,1,00433,India
666143,2023-05-06,505,oven,18490,24000,5510,1,00352,India
666143,2023-05-06,501,iphone 15,60000,80000,20000,1,00352,India
666143,2023-05-06,503,mixer,1349,3249,1900,1,00352,India
666143,2023-05-06,504,iron,449,879,430,1,00352,India
854472,2023-05-06,501,iphone 15,60000,80000,20000,1,00316,India
692482,2023-05-06,505,oven,18490,24000,5510,1,00312,India
692482,2023-05-06,503,mixer,1349,3249,1900,1,00312,India
230069,2023-05-06,506,monitor,3249,8000,4751,1,00226,India
230069,2023-05-06,501,iphone 15,60000,80000,20000,1,00226,India
568369,2023-05-06,504,iron,449,879,430,1,00063,India
568369,2023-05-06,506,monitor,3249,8000,4751,1,00063,India
568369,2023-05-06,501,iphone 15,60000,80000,20000,1,00063,India
568369,2023-05-06,507,washing machine,6990,16490,9500,1,00063,India
934617,2023-05-06,501,iphone 15,60000,80000,20000,1,00159,India
225829,2023-05-06,501,iphone 15,60000,80000,20000,1,00295,India
225829,2023-05-06,504,iron,449,879,430,1,00295,India
675825,2023-05-06,502,iphone 15 pro max,100000,135000,35000,1,00261,India
675825,2023-05-06,507,washing machine,6990,16490,9500,1,00261,India
675825,2023-05-06,504,iron,449,879,430,1,00261,India
675825,2023-05-06,501,iphone 15,60000,80000,20000,1,00261,India
312672,2023-05-06,503,mixer,1349,3249,1900,1,00109,India
312672,2023-05-06,501,iphone 15,60000,80000,20000,1,00109,India
312672,2023-05-06,502,iphone 15 pro max,100000,135000,35000,1,00109,India
602182,2023-05-06,504,iron,449,879,430,1,00027,India
602182,2023-05-06,506,monitor,3249,8000,4751,1,00027,India
602182,2023-05-06,507,washing machine,6990,16490,9500,1,00027,India
602182,2023-05-06,501,iphone 15,60000,80000,20000,1,00027,India
522122,2023-05-06,504,iron,449,879,430,1,00293,India
517013,2023-05-06,501,iphone 15,60000,80000,20000,1,00144,India
517013,2023-05-06,507,washing machine,6990,16490,9500,1,00144,India
517013,2023-05-06,504,iron,449,879,430,1,00144,India
766964,2023-05-06,505,oven,18490,24000,5510,1,00366,India
326508,2023-05-06,506,monitor,3249,8000,4751,1,00113,India
326508,2023-05-06,503,mixer,1349,3249,1900,1,00113,India
146981,2023-05-06,501,iphone 15,60000,80000,20000,1,00230,India
988452,2023-05-06,505,oven,18490,24000,5510,1,00354,India
988452,2023-05-06,501,iphone 15,60000,80000,20000,1,00354,India
988452,2023-05-06,507,washing machine,6990,16490,9500,1,00354,India
988452,2023-05-06,504,iron,449,879,430,1,00354,India
418354,2023-05-06,505,oven,18490,24000,5510,1,00401,India
418354,2023-05-06,506,monitor,3249,8000,4751,1,00401,India
418354,2023-05-06,501,iphone 15,60000,80000,20000,1,00401,India
515294,2023-05-06,501,iphone 15,60000,80000,20000,1,00293,India
515294,2023-05-06,505,oven,18490,24000,5510,1,00293,India
522551,2023-05-06,504,iron,449,879,430,1,00306,India
522551,2023-05-06,505,oven,18490,24000,5510,1,00306,India
522551,2023-05-06,501,iphone 15,60000,80000,20000,1,00306,India
522551,2023-05-06,507,washing machine,6990,16490,9500,1,00306,India
522551,2023-05-06,506,monitor,3249,8000,4751,1,00306,India
771469,2023-05-06,507,washing machine,6990,16490,9500,1,00483,India
771469,2023-05-06,503,mixer,1349,3249,1900,1,00483,India
947690,2023-05-06,505,oven,18490,24000,5510,1,00228,India
947690,2023-05-06,506,monitor,3249,8000,4751,1,00228,India
947690,2023-05-06,502,iphone 15 pro max,100000,135000,35000,1,00228,India
853079,2023-05-06,507,washing machine,6990,16490,9500,1,00050,India
853079,2023-05-06,503,mixer,1349,3249,1900,1,00050,India
871285,2023-05-06,505,oven,18490,24000,5510,1,00107,India
492390,2023-05-06,502,iphone 15 pro max,100000,135000,35000,1,00453,India
492390,2023-05-06,507,washing machine,6990,16490,9500,1,00453,India
364828,2023-05-06,503,mixer,1349,3249,1900,1,00431,India
364828,2023-05-06,505,oven,18490,24000,5510,1,00431,India
389067,2023-05-06,505,oven,18490,24000,5510,1,00295,India
389067,2023-05-06,506,monitor,3249,8000,4751,1,00295,India
410129,2023-05-06,505,oven,18490,24000,5510,1,00272,India
410129,2023-05-06,503,mixer,1349,3249,1900,1,00272,India
410129,2023-05-06,502,iphone 15 pro max,100000,135000,35000,1,00272,India
410129,2023-05-06,506,monitor,3249,8000,4751,1,00272,India
940730,2023-05-06,506,monitor,3249,8000,4751,1,00484,India
940730,2023-05-06,502,iphone 15 pro max,100000,135000,35000,1,00484,India
135362,2023-05-06,505,oven,18490,24000,5510,1,00307,India
135362,2023-05-06,506,monitor,3249,8000,4751,1,00307,India
380188,2023-05-06,502,iphone 15 pro max,100000,135000,35000,1,00223,India
380188,2023-05-06,501,iphone 15,60000,80000,20000,1,00223,India
380188,2023-05-06,507,washing machine,6990,16490,9500,1,00223,India
380188,2023-05-06,506,monitor,3249,8000,4751,1,00223,India
862334,2023-05-06,507,washing machine,6990,16490,9500,1,00104,India
862334,2023-05-06,506,monitor,3249,8000,4751,1,00104,India
862334,2023-05-06,502,iphone 15 pro max,100000,135000,35000,1,00104,India
813966,2023-05-06,503,mixer,1349,3249,1900,1,00355,India
813966,2023-05-06,506,monitor,3249,8000,4751,1,00355,India
446592,2023-05-06,506,monitor,3249,8000,4751,1,00197,India
809807,2023-05-06,506,monitor,3249,8000,4751,1,00296,India
809807,2023-05-06,501,iphone 15,60000,80000,20000,1,00296,India
809807,2023-05-06,502,iphone 15 pro max,100000,135000,35000,1,00296,India
304649,2023-05-06,505,oven,18490,24000,5510,1,00165,India
515828,2023-05-06,506,monitor,3249,8000,4751,1,00171,India
515828,2023-05-06,501,iphone 15,60000,80000,20000,1,00171,India
515828,2023-05-06,507,washing machine,6990,16490,9500,1,00171,India
844853,2023-05-06,507,washing machine,6990,16490,9500,1,00472,India
844853,2023-05-06,504,iron,449,879,430,1,00472,India
844853,2023-05-06,501,iphone 15,60000,80000,20000,1,00472,India
422491,2023-05-06,504,iron,449,879,430,1,00389,India
422491,2023-05-06,505,oven,18490,24000,5510,1,00389,India
422491,2023-05-06,503,mixer,1349,3249,1900,1,00389,India
624618,2023-05-06,505,oven,18490,24000,5510,1,00067,India
624618,2023-05-06,501,iphone 15,60000,80000,20000,1,00067,India
624618,2023-05-06,503,mixer,1349,3249,1900,1,00067,India
109812,2023-05-06,503,mixer,1349,3249,1900,1,00134,India
109812,2023-05-06,506,monitor,3249,8000,4751,1,00134,India
855719,2023-05-07,505,oven,18490,24000,5510,1,00354,India
855719,2023-05-07,506,monitor,3249,8000,4751,1,00354,India
794324,2023-05-07,506,monitor,3249,8000,4751,1,00440,India
794324,2023-05-07,507,washing machine,6990,16490,9500,1,00440,India
794324,2023-05-07,503,mixer,1349,3249,1900,1,00440,India
487265,2023-05-07,501,iphone 15,60000,80000,20000,1,00375,India
487265,2023-05-07,505,oven,18490,24000,5510,1,00375,India
487265,2023-05-07,502,iphone 15 pro max,100000,135000,35000,1,00375,India
446140,2023-05-07,502,iphone 15 pro max,100000,135000,35000,1,00128,India
594441,2023-05-07,505,oven,18490,24000,5510,1,00372,India
594441,2023-05-07,502,iphone 15 pro max,100000,135000,35000,1,00372,India
594441,2023-05-07,503,mixer,1349,3249,1900,1,00372,India
190024,2023-05-07,501,iphone 15,60000,80000,20000,1,00371,India
190024,2023-05-07,502,iphone 15 pro max,100000,135000,35000,1,00371,India
190024,2023-05-07,504,iron,449,879,430,1,00371,India
190024,2023-05-07,505,oven,18490,24000,5510,1,00371,India
324046,2023-05-07,503,mixer,1349,3249,1900,1,00083,India
324046,2023-05-07,504,iron,449,879,430,1,00083,India
870028,2023-05-07,504,iron,449,879,430,1,00077,India
870028,2023-05-07,503,mixer,1349,3249,1900,1,00077,India
870028,2023-05-07,505,oven,18490,24000,5510,1,00077,India
768715,2023-05-07,507,washing machine,6990,16490,9500,1,00214,India
768715,2023-05-07,502,iphone 15 pro max,100000,135000,35000,1,00214,India
768715,2023-05-07,503,mixer,1349,3249,1900,1,00214,India
768715,2023-05-07,505,oven,18490,24000,5510,1,00214,India
216530,2023-05-07,506,monitor,3249,8000,4751,1,00488,India
741898,2023-05-07,507,washing machine,6990,16490,9500,1,00141,India
741898,2023-05-07,501,iphone 15,60000,80000,20000,1,00141,India
880555,2023-05-07,503,mixer,1349,3249,1900,1,00026,India
431914,2023-05-07,501,iphone 15,60000,80000,20000,1,00127,India
431914,2023-05-07,506,monitor,3249,8000,4751,1,00127,India
260450,2023-05-07,507,washing machine,6990,16490,9500,1,00266,India
260450,2023-05-07,506,monitor,3249,8000,4751,1,00266,India
260450,2023-05-07,503,mixer,1349,3249,1900,1,00266,India
955386,2023-05-07,505,oven,18490,24000,5510,1,00060,India
955386,2023-05-07,502,iphone 15 pro max,100000,135000,35000,1,00060,India
955386,2023-05-07,506,monitor,3249,8000,4751,1,00060,India
417995,2023-05-07,507,washing machine,6990,16490,9500,1,00216,India
417995,2023-05-07,504,iron,449,879,430,1,00216,India
929580,2023-05-07,504,iron,449,879,430,1,00339,India
929580,2023-05-07,505,oven,18490,24000,5510,1,00339,India
929580,2023-05-07,502,iphone 15 pro max,100000,135000,35000,1,00339,India
900087,2023-05-07,505,oven,18490,24000,5510,1,00281,India
392999,2023-05-07,501,iphone 15,60000,80000,20000,1,00441,India
392999,2023-05-07,504,iron,449,879,430,1,00441,India
306998,2023-05-07,502,iphone 15 pro max,100000,135000,35000,1,00474,India
306998,2023-05-07,505,oven,18490,24000,5510,1,00474,India
648726,2023-05-07,501,iphone 15,60000,80000,20000,1,00322,India
648726,2023-05-07,502,iphone 15 pro max,100000,135000,35000,1,00322,India
110306,2023-05-07,501,iphone 15,60000,80000,20000,1,00049,India
110306,2023-05-07,504,iron,449,879,430,1,00049,India
314580,2023-05-07,503,mixer,1349,3249,1900,1,00296,India
314580,2023-05-07,501,iphone 15,60000,80000,20000,1,00296,India
314580,2023-05-07,506,monitor,3249,8000,4751,1,00296,India
615687,2023-05-07,507,washing machine,6990,16490,9500,1,00186,India
615687,2023-05-07,501,iphone 15,60000,80000,20000,1,00186,India
615687,2023-05-07,506,monitor,3249,8000,4751,1,00186,India
615687,2023-05-07,503,mixer,1349,3249,1900,1,00186,India
230620,2023-05-07,501,iphone 15,60000,80000,20000,1,00350,India
230620,2023-05-07,506,monitor,3249,8000,4751,1,00350,India
230620,2023-05-07,507,washing machine,6990,16490,9500,1,00350,India
721033,2023-05-07,501,iphone 15,60000,80000,20000,1,00278,India
721033,2023-05-07,505,oven,18490,24000,5510,1,00278,India
721033,2023-05-07,507,washing machine,6990,16490,9500,1,00278,India
721033,2023-05-07,502,iphone 15 pro max,100000,135000,35000,1,00278,India
405460,2023-05-07,501,iphone 15,60000,80000,20000,1,00096,India
405460,2023-05-07,504,iron,449,879,430,1,00096,India
405460,2023-05-07,502,iphone 15 pro max,100000,135000,35000,1,00096,India
951940,2023-05-07,507,washing machine,6990,16490,9500,1,00144,India
951940,2023-05-07,501,iphone 15,60000,80000,20000,1,00144,India
951940,2023-05-07,504,iron,449,879,430,1,00144,India
662846,2023-05-07,502,iphone 15 pro max,100000,135000,35000,1,00340,India
662846,2023-05-07,501,iphone 15,60000,80000,20000,1,00340,India
308720,2023-05-07,505,oven,18490,24000,5510,1,00094,India
308720,2023-05-07,507,washing machine,6990,16490,9500,1,00094,India
864402,2023-05-07,503,mixer,1349,3249,1900,1,00141,India
864402,2023-05-07,506,monitor,3249,8000,4751,1,00141,India
864402,2023-05-07,501,iphone 15,60000,80000,20000,1,00141,India
200951,2023-05-07,501,iphone 15,60000,80000,20000,1,00096,India
200951,2023-05-07,505,oven,18490,24000,5510,1,00096,India
934943,2023-05-07,503,mixer,1349,3249,1900,1,00423,India
934943,2023-05-07,502,iphone 15 pro max,100000,135000,35000,1,00423,India
504665,2023-05-07,507,washing machine,6990,16490,9500,1,00370,India
504665,2023-05-07,502,iphone 15 pro max,100000,135000,35000,1,00370,India
504665,2023-05-07,505,oven,18490,24000,5510,1,00370,India
865292,2023-05-07,506,monitor,3249,8000,4751,1,00429,India
154394,2023-05-07,505,oven,18490,24000,5510,1,00046,India
154394,2023-05-07,504,iron,449,879,430,1,00046,India
154394,2023-05-07,507,washing machine,6990,16490,9500,1,00046,India
545909,2023-05-07,503,mixer,1349,3249,1900,1,00232,India
545909,2023-05-07,505,oven,18490,24000,5510,1,00232,India
545909,2023-05-07,504,iron,449,879,430,1,00232,India
545909,2023-05-07,507,washing machine,6990,16490,9500,1,00232,India
169015,2023-05-07,501,iphone 15,60000,80000,20000,1,00202,India
169015,2023-05-07,506,monitor,3249,8000,4751,1,00202,India
246329,2023-05-07,506,monitor,3249,8000,4751,1,00001,India
492064,2023-05-07,504,iron,449,879,430,1,00049,India
753712,2023-05-07,504,iron,449,879,430,1,00075,India
753712,2023-05-07,503,mixer,1349,3249,1900,1,00075,India
753712,2023-05-07,505,oven,18490,24000,5510,1,00075,India
628994,2023-05-07,506,monitor,3249,8000,4751,1,00411,India
628994,2023-05-07,503,mixer,1349,3249,1900,1,00411,India
674634,2023-05-07,506,monitor,3249,8000,4751,1,00437,India
560950,2023-05-07,504,iron,449,879,430,1,00010,India
616871,2023-05-07,506,monitor,3249,8000,4751,1,00320,India
428782,2023-05-07,503,mixer,1349,3249,1900,1,00366,India
428782,2023-05-07,505,oven,18490,24000,5510,1,00366,India
428782,2023-05-07,507,washing machine,6990,16490,9500,1,00366,India
428782,2023-05-07,506,monitor,3249,8000,4751,1,00366,India
101894,2023-05-07,501,iphone 15,60000,80000,20000,1,00316,India
101894,2023-05-07,504,iron,449,879,430,1,00316,India
101894,2023-05-07,507,washing machine,6990,16490,9500,1,00316,India
891950,2023-05-07,501,iphone 15,60000,80000,20000,1,00350,India
891950,2023-05-07,505,oven,18490,24000,5510,1,00350,India
891950,2023-05-07,502,iphone 15 pro max,100000,135000,35000,1,00350,India
891950,2023-05-07,503,mixer,1349,3249,1900,1,00350,India
342735,2023-05-07,503,mixer,1349,3249,1900,1,00325,India
342735,2023-05-07,502,iphone 15 pro max,100000,135000,35000,1,00325,India
791071,2023-05-07,501,iphone 15,60000,80000,20000,1,00090,India
791071,2023-05-07,506,monitor,3249,8000,4751,1,00090,India
392202,2023-05-07,507,washing machine,6990,16490,9500,1,00258,India
392202,2023-05-07,505,oven,18490,24000,5510,1,00258,India
392202,2023-05-07,503,mixer,1349,3249,1900,1,00258,India
392202,2023-05-07,501,iphone 15,60000,80000,20000,1,00258,India
512021,2023-05-07,505,oven,18490,24000,5510,1,00475,India
512021,2023-05-07,502,iphone 15 pro max,100000,135000,35000,1,00475,India
342786,2023-05-07,506,monitor,3249,8000,4751,1,00464,India
423383,2023-05-07,503,mixer,1349,3249,1900,1,00439,India
423383,2023-05-07,501,iphone 15,60000,80000,20000,1,00439,India
423383,2023-05-07,506,monitor,3249,8000,4751,1,00439,India
423383,2023-05-07,502,iphone 15 pro max,100000,135000,35000,1,00439,India
209510,2023-05-07,506,monitor,3249,8000,4751,1,00125,India
209510,2023-05-07,503,mixer,1349,3249,1900,1,00125,India
494266,2023-05-07,502,iphone 15 pro max,100000,135000,35000,1,00126,India
494266,2023-05-07,505,oven,18490,24000,5510,1,00126,India
833957,2023-05-07,503,mixer,1349,3249,1900,1,00139,India
833957,2023-05-07,506,monitor,3249,8000,4751,1,00139,India
305706,2023-05-07,502,iphone 15 pro max,100000,135000,35000,1,00282,India
305706,2023-05-07,505,oven,18490,24000,5510,1,00282,India
305706,2023-05-07,507,washing machine,6990,16490,9500,1,00282,India
203633,2023-05-07,503,mixer,1349,3249,1900,1,00219,India
235362,2023-05-07,505,oven,18490,24000,5510,1,00326,India
235362,2023-05-07,503,mixer,1349,3249,1900,1,00326,India
235362,2023-05-07,506,monitor,3249,8000,4751,1,00326,India
498477,2023-05-07,502,iphone 15 pro max,100000,135000,35000,1,00245,India
498477,2023-05-07,507,washing machine,6990,16490,9500,1,00245,India
680321,2023-05-07,502,iphone 15 pro max,100000,135000,35000,1,00271,India
680321,2023-05-07,505,oven,18490,24000,5510,1,00271,India
680321,2023-05-07,506,monitor,3249,8000,4751,1,00271,India
680321,2023-05-07,501,iphone 15,60000,80000,20000,1,00271,India
272072,2023-05-07,502,iphone 15 pro max,100000,135000,35000,1,00256,India
197632,2023-05-07,505,oven,18490,24000,5510,1,00446,India
197632,2023-05-07,502,iphone 15 pro max,100000,135000,35000,1,00446,India
749166,2023-05-07,505,oven,18490,24000,5510,1,00200,India
538216,2023-05-08,505,oven,18490,24000,5510,1,00217,India
538216,2023-05-08,507,washing machine,6990,16490,9500,1,00217,India
538216,2023-05-08,506,monitor,3249,8000,4751,1,00217,India
538216,2023-05-08,504,iron,449,879,430,1,00217,India
763477,2023-05-08,506,monitor,3249,8000,4751,1,00311,India
719215,2023-05-08,502,iphone 15 pro max,100000,135000,35000,1,00297,India
719215,2023-05-08,507,washing machine,6990,16490,9500,1,00297,India
719215,2023-05-08,503,mixer,1349,3249,1900,1,00297,India
942874,2023-05-08,507,washing machine,6990,16490,9500,1,00021,India
942874,2023-05-08,503,mixer,1349,3249,1900,1,00021,India
942874,2023-05-08,506,monitor,3249,8000,4751,1,00021,India
942874,2023-05-08,504,iron,449,879,430,1,00021,India
304725,2023-05-08,503,mixer,1349,3249,1900,1,00269,India
304725,2023-05-08,507,washing machine,6990,16490,9500,1,00269,India
853763,2023-05-08,506,monitor,3249,8000,4751,1,00183,India
853763,2023-05-08,507,washing machine,6990,16490,9500,1,00183,India
853763,2023-05-08,502,iphone 15 pro max,100000,135000,35000,1,00183,India
795795,2023-05-08,503,mixer,1349,3249,1900,1,00315,India
196102,2023-05-08,501,iphone 15,60000,80000,20000,1,00179,India
196102,2023-05-08,505,oven,18490,24000,5510,1,00179,India
196102,2023-05-08,503,mixer,1349,3249,1900,1,00179,India
365937,2023-05-08,505,oven,18490,24000,5510,1,00138,India
365937,2023-05-08,504,iron,449,879,430,1,00138,India
365937,2023-05-08,507,washing machine,6990,16490,9500,1,00138,India
796925,2023-05-08,503,mixer,1349,3249,1900,1,00015,India
796925,2023-05-08,501,iphone 15,60000,80000,20000,1,00015,India
796925,2023-05-08,507,washing machine,6990,16490,9500,1,00015,India
617369,2023-05-08,504,iron,449,879,430,1,00129,India
617369,2023-05-08,503,mixer,1349,3249,1900,1,00129,India
617369,2023-05-08,507,washing machine,6990,16490,9500,1,00129,India
493541,2023-05-08,501,iphone 15,60000,80000,20000,1,00016,India
493541,2023-05-08,506,monitor,3249,8000,4751,1,00016,India
493541,2023-05-08,507,washing machine,6990,16490,9500,1,00016,India
111252,2023-05-08,506,monitor,3249,8000,4751,1,00300,India
111252,2023-05-08,502,iphone 15 pro max,100000,135000,35000,1,00300,India
111252,2023-05-08,507,washing machine,6990,16490,9500,1,00300,India
111252,2023-05-08,501,iphone 15,60000,80000,20000,1,00300,India
997484,2023-05-08,505,oven,18490,24000,5510,1,00254,India
997484,2023-05-08,503,mixer,1349,3249,1900,1,00254,India
997484,2023-05-08,506,monitor,3249,8000,4751,1,00254,India
570726,2023-05-08,505,oven,18490,24000,5510,1,00051,India
570726,2023-05-08,507,washing machine,6990,16490,9500,1,00051,India
570726,2023-05-08,506,monitor,3249,8000,4751,1,00051,India
570726,2023-05-08,504,iron,449,879,430,1,00051,India
607077,2023-05-08,501,iphone 15,60000,80000,20000,1,00069,India
607077,2023-05-08,502,iphone 15 pro max,100000,135000,35000,1,00069,India
607077,2023-05-08,507,washing machine,6990,16490,9500,1,00069,India
533563,2023-05-08,507,washing machine,6990,16490,9500,1,00128,India
900487,2023-05-08,503,mixer,1349,3249,1900,1,00343,India
900487,2023-05-08,502,iphone 15 pro max,100000,135000,35000,1,00343,India
430668,2023-05-08,506,monitor,3249,8000,4751,1,00379,India
430668,2023-05-08,503,mixer,1349,3249,1900,1,00379,India
430668,2023-05-08,504,iron,449,879,430,1,00379,India
530353,2023-05-08,502,iphone 15 pro max,100000,135000,35000,1,00181,India
530353,2023-05-08,507,washing machine,6990,16490,9500,1,00181,India
530353,2023-05-08,503,mixer,1349,3249,1900,1,00181,India
178057,2023-05-08,501,iphone 15,60000,80000,20000,1,00450,India
178057,2023-05-08,504,iron,449,879,430,1,00450,India
563749,2023-05-08,503,mixer,1349,3249,1900,1,00244,India
518910,2023-05-08,505,oven,18490,24000,5510,1,00298,India
518910,2023-05-08,502,iphone 15 pro max,100000,135000,35000,1,00298,India
631910,2023-05-08,502,iphone 15 pro max,100000,135000,35000,1,00216,India
686417,2023-05-08,507,washing machine,6990,16490,9500,1,00499,India
499184,2023-05-08,504,iron,449,879,430,1,00224,India
123768,2023-05-08,507,washing machine,6990,16490,9500,1,00320,India
123768,2023-05-08,505,oven,18490,24000,5510,1,00320,India
414437,2023-05-08,506,monitor,3249,8000,4751,1,00485,India
414437,2023-05-08,502,iphone 15 pro max,100000,135000,35000,1,00485,India
414437,2023-05-08,501,iphone 15,60000,80000,20000,1,00485,India
414437,2023-05-08,504,iron,449,879,430,1,00485,India
709964,2023-05-08,504,iron,449,879,430,1,00090,India
709964,2023-05-08,501,iphone 15,60000,80000,20000,1,00090,India
709964,2023-05-08,507,washing machine,6990,16490,9500,1,00090,India
181919,2023-05-08,502,iphone 15 pro max,100000,135000,35000,1,00289,India
143930,2023-05-08,503,mixer,1349,3249,1900,1,00202,India
942317,2023-05-08,504,iron,449,879,430,1,00210,India
942317,2023-05-08,503,mixer,1349,3249,1900,1,00210,India
942317,2023-05-08,506,monitor,3249,8000,4751,1,00210,India
942317,2023-05-08,505,oven,18490,24000,5510,1,00210,India
942317,2023-05-08,501,iphone 15,60000,80000,20000,1,00210,India
853811,2023-05-08,503,mixer,1349,3249,1900,1,00425,India
853811,2023-05-08,501,iphone 15,60000,80000,20000,1,00425,India
233834,2023-05-08,503,mixer,1349,3249,1900,1,00309,India
419817,2023-05-08,505,oven,18490,24000,5510,1,00367,India
419817,2023-05-08,503,mixer,1349,3249,1900,1,00367,India
419817,2023-05-08,504,iron,449,879,430,1,00367,India
419817,2023-05-08,502,iphone 15 pro max,100000,135000,35000,1,00367,India
945331,2023-05-08,505,oven,18490,24000,5510,1,00112,India
945331,2023-05-08,504,iron,449,879,430,1,00112,India
945331,2023-05-08,503,mixer,1349,3249,1900,1,00112,India
945331,2023-05-08,506,monitor,3249,8000,4751,1,00112,India
533362,2023-05-08,502,iphone 15 pro max,100000,135000,35000,1,00269,India
533362,2023-05-08,505,oven,18490,24000,5510,1,00269,India
533362,2023-05-08,506,monitor,3249,8000,4751,1,00269,India
807776,2023-05-08,504,iron,449,879,430,1,00174,India
381741,2023-05-08,504,iron,449,879,430,1,00151,India
664799,2023-05-08,503,mixer,1349,3249,1900,1,00033,India
664799,2023-05-08,504,iron,449,879,430,1,00033,India
664799,2023-05-08,506,monitor,3249,8000,4751,1,00033,India
664799,2023-05-08,502,iphone 15 pro max,100000,135000,35000,1,00033,India
834601,2023-05-08,507,washing machine,6990,16490,9500,1,00199,India
834601,2023-05-08,506,monitor,3249,8000,4751,1,00199,India
834601,2023-05-08,501,iphone 15,60000,80000,20000,1,00199,India
441815,2023-05-08,506,monitor,3249,8000,4751,1,00126,India
441815,2023-05-08,504,iron,449,879,430,1,00126,India
441815,2023-05-08,505,oven,18490,24000,5510,1,00126,India
441815,2023-05-08,501,iphone 15,60000,80000,20000,1,00126,India
441815,2023-05-08,507,washing machine,6990,16490,9500,1,00126,India
195078,2023-05-08,507,washing machine,6990,16490,9500,1,00435,India
784028,2023-05-08,507,washing machine,6990,16490,9500,1,00239,India
784028,2023-05-08,505,oven,18490,24000,5510,1,00239,India
784028,2023-05-08,502,iphone 15 pro max,100000,135000,35000,1,00239,India
784028,2023-05-08,503,mixer,1349,3249,1900,1,00239,India
784028,2023-05-08,504,iron,449,879,430,1,00239,India
872109,2023-05-08,503,mixer,1349,3249,1900,1,00200,India
507345,2023-05-08,501,iphone 15,60000,80000,20000,1,00068,India
507345,2023-05-08,506,monitor,3249,8000,4751,1,00068,India
507345,2023-05-08,503,mixer,1349,3249,1900,1,00068,India
507345,2023-05-08,502,iphone 15 pro max,100000,135000,35000,1,00068,India
876494,2023-05-08,505,oven,18490,24000,5510,1,00425,India
584335,2023-05-08,501,iphone 15,60000,80000,20000,1,00426,India
584335,2023-05-08,506,monitor,3249,8000,4751,1,00426,India
698371,2023-05-08,501,iphone 15,60000,80000,20000,1,00302,India
698371,2023-05-08,506,monitor,3249,8000,4751,1,00302,India
698371,2023-05-08,504,iron,449,879,430,1,00302,India
550411,2023-05-08,504,iron,449,879,430,1,00296,India
550411,2023-05-08,503,mixer,1349,3249,1900,1,00296,India
550411,2023-05-08,502,iphone 15 pro max,100000,135000,35000,1,00296,India
161643,2023-05-08,507,washing machine,6990,16490,9500,1,00053,India
161643,2023-05-08,505,oven,18490,24000,5510,1,00053,India
136426,2023-05-08,502,iphone 15 pro max,100000,135000,35000,1,00246,India
136426,2023-05-08,503,mixer,1349,3249,1900,1,00246,India
136426,2023-05-08,501,iphone 15,60000,80000,20000,1,00246,India
751176,2023-05-08,503,mixer,1349,3249,1900,1,00209,India
751176,2023-05-08,507,washing machine,6990,16490,9500,1,00209,India
751176,2023-05-08,504,iron,449,879,430,1,00209,India
177982,2023-05-08,505,oven,18490,24000,5510,1,00128,India
177982,2023-05-08,507,washing machine,6990,16490,9500,1,00128,India
177982,2023-05-08,501,iphone 15,60000,80000,20000,1,00128,India
910379,2023-05-08,501,iphone 15,60000,80000,20000,1,00167,India
910379,2023-05-08,504,iron,449,879,430,1,00167,India
910379,2023-05-08,505,oven,18490,24000,5510,1,00167,India
910379,2023-05-08,503,mixer,1349,3249,1900,1,00167,India
716090,2023-05-08,505,oven,18490,24000,5510,1,00423,India
716090,2023-05-08,502,iphone 15 pro max,100000,135000,35000,1,00423,India
716090,2023-05-08,501,iphone 15,60000,80000,20000,1,00423,India
716090,2023-05-08,507,washing machine,6990,16490,9500,1,00423,India
333721,2023-05-08,506,monitor,3249,8000,4751,1,00279,India
333721,2023-05-08,501,iphone 15,60000,80000,20000,1,00279,India
333721,2023-05-08,503,mixer,1349,3249,1900,1,00279,India
626192,2023-05-08,504,iron,449,879,430,1,00003,India
626192,2023-05-08,507,washing machine,6990,16490,9500,1,00003,India
504301,2023-05-08,506,monitor,3249,8000,4751,1,00200,India
504301,2023-05-08,501,iphone 15,60000,80000,20000,1,00200,India
504301,2023-05-08,507,washing machine,6990,16490,9500,1,00200,India
447096,2023-05-08,507,washing machine,6990,16490,9500,1,00016,India
447096,2023-05-08,502,iphone 15 pro max,100000,135000,35000,1,00016,India
447096,2023-05-08,501,iphone 15,60000,80000,20000,1,00016,India
415020,2023-05-08,501,iphone 15,60000,80000,20000,1,00091,India
415020,2023-05-08,506,monitor,3249,8000,4751,1,00091,India
415020,2023-05-08,504,iron,449,879,430,1,00091,India
565877,2023-05-08,505,oven,18490,24000,5510,1,00186,India
565877,2023-05-08,504,iron,449,879,430,1,00186,India
565877,2023-05-08,503,mixer,1349,3249,1900,1,00186,India
189866,2023-05-08,506,monitor,3249,8000,4751,1,00401,India
189866,2023-05-08,507,washing machine,6990,16490,9500,1,00401,India
189866,2023-05-08,501,iphone 15,60000,80000,20000,1,00401,India
189866,2023-05-08,504,iron,449,879,430,1,00401,India
760685,2023-05-08,502,iphone 15 pro max,100000,135000,35000,1,00016,India
760685,2023-05-08,501,iphone 15,60000,80000,20000,1,00016,India
760685,2023-05-08,503,mixer,1349,3249,1900,1,00016,India
545392,2023-05-08,502,iphone 15 pro max,100000,135000,35000,1,00357,India
545392,2023-05-08,504,iron,449,879,430,1,00357,India
545392,2023-05-08,507,washing machine,6990,16490,9500,1,00357,India
545392,2023-05-08,506,monitor,3249,8000,4751,1,00357,India
725608,2023-05-08,503,mixer,1349,3249,1900,1,00345,India
725608,2023-05-08,506,monitor,3249,8000,4751,1,00345,India
808856,2023-05-08,504,iron,449,879,430,1,00202,India
808856,2023-05-08,503,mixer,1349,3249,1900,1,00202,India
808856,2023-05-08,505,oven,18490,24000,5510,1,00202,India
156066,2023-05-08,507,washing machine,6990,16490,9500,1,00384,India
156066,2023-05-08,501,iphone 15,60000,80000,20000,1,00384,India
152367,2023-05-08,503,mixer,1349,3249,1900,1,00106,India
569789,2023-05-08,505,oven,18490,24000,5510,1,00242,India
719919,2023-05-08,503,mixer,1349,3249,1900,1,00494,India
719919,2023-05-08,505,oven,18490,24000,5510,1,00494,India
719919,2023-05-08,507,washing machine,6990,16490,9500,1,00494,India
797567,2023-05-08,501,iphone 15,60000,80000,20000,1,00457,India
797567,2023-05-08,507,washing machine,6990,16490,9500,1,00457,India
797567,2023-05-08,504,iron,449,879,430,1,00457,India
684993,2023-05-08,504,iron,449,879,430,1,00152,India
804247,2023-05-08,507,washing machine,6990,16490,9500,1,00148,India
804247,2023-05-08,504,iron,449,879,430,1,00148,India
804247,2023-05-08,503,mixer,1349,3249,1900,1,00148,India
486921,2023-05-08,503,mixer,1349,3249,1900,1,00472,India
486921,2023-05-08,507,washing machine,6990,16490,9500,1,00472,India
486921,2023-05-08,505,oven,18490,24000,5510,1,00472,India
674184,2023-05-08,504,iron,449,879,430,1,00135,India
862999,2023-05-08,507,washing machine,6990,16490,9500,1,00148,India
862999,2023-05-08,504,iron,449,879,430,1,00148,India
817336,2023-05-08,507,washing machine,6990,16490,9500,1,00168,India
817336,2023-05-08,501,iphone 15,60000,80000,20000,1,00168,India
817336,2023-05-08,504,iron,449,879,430,1,00168,India
817336,2023-05-08,503,mixer,1349,3249,1900,1,00168,India
952250,2023-05-08,503,mixer,1349,3249,1900,1,00306,India
952250,2023-05-08,505,oven,18490,24000,5510,1,00306,India
952250,2023-05-08,504,iron,449,879,430,1,00306,India
952250,2023-05-08,501,iphone 15,60000,80000,20000,1,00306,India
856240,2023-05-08,503,mixer,1349,3249,1900,1,00479,India
260705,2023-05-08,501,iphone 15,60000,80000,20000,1,00422,India
260705,2023-05-08,505,oven,18490,24000,5510,1,00422,India
394250,2023-05-08,504,iron,449,879,430,1,00302,India
394250,2023-05-08,506,monitor,3249,8000,4751,1,00302,India
394250,2023-05-08,501,iphone 15,60000,80000,20000,1,00302,India
705693,2023-05-08,506,monitor,3249,8000,4751,1,00368,India
274460,2023-05-08,507,washing machine,6990,16490,9500,1,00481,India
274460,2023-05-08,503,mixer,1349,3249,1900,1,00481,India
274460,2023-05-08,502,iphone 15 pro max,100000,135000,35000,1,00481,India
274460,2023-05-08,504,iron,449,879,430,1,00481,India
483900,2023-05-09,502,iphone 15 pro max,100000,135000,35000,1,00068,India
391797,2023-05-09,507,washing machine,6990,16490,9500,1,00043,India
391797,2023-05-09,506,monitor,3249,8000,4751,1,00043,India
391797,2023-05-09,505,oven,18490,24000,5510,1,00043,India
391797,2023-05-09,503,mixer,1349,3249,1900,1,00043,India
391797,2023-05-09,501,iphone 15,60000,80000,20000,1,00043,India
394804,2023-05-09,505,oven,18490,24000,5510,1,00262,India
394804,2023-05-09,506,monitor,3249,8000,4751,1,00262,India
394804,2023-05-09,504,iron,449,879,430,1,00262,India
656839,2023-05-09,503,mixer,1349,3249,1900,1,00094,India
656839,2023-05-09,504,iron,449,879,430,1,00094,India
820855,2023-05-09,507,washing machine,6990,16490,9500,1,00017,India
820855,2023-05-09,503,mixer,1349,3249,1900,1,00017,India
820855,2023-05-09,506,monitor,3249,8000,4751,1,00017,India
762444,2023-05-09,505,oven,18490,24000,5510,1,00403,India
762444,2023-05-09,504,iron,449,879,430,1,00403,India
762444,2023-05-09,501,iphone 15,60000,80000,20000,1,00403,India
762444,2023-05-09,503,mixer,1349,3249,1900,1,00403,India
852306,2023-05-09,503,mixer,1349,3249,1900,1,00303,India
852306,2023-05-09,506,monitor,3249,8000,4751,1,00303,India
852306,2023-05-09,505,oven,18490,24000,5510,1,00303,India
852306,2023-05-09,504,iron,449,879,430,1,00303,India
119310,2023-05-09,506,monitor,3249,8000,4751,1,00168,India
119310,2023-05-09,505,oven,18490,24000,5510,1,00168,India
442268,2023-05-09,507,washing machine,6990,16490,9500,1,00016,India
442268,2023-05-09,504,iron,449,879,430,1,00016,India
442268,2023-05-09,502,iphone 15 pro max,100000,135000,35000,1,00016,India
223512,2023-05-09,507,washing machine,6990,16490,9500,1,00098,India
518462,2023-05-09,502,iphone 15 pro max,100000,135000,35000,1,00276,India
518462,2023-05-09,501,iphone 15,60000,80000,20000,1,00276,India
518462,2023-05-09,506,monitor,3249,8000,4751,1,00276,India
518462,2023-05-09,505,oven,18490,24000,5510,1,00276,India
471032,2023-05-09,503,mixer,1349,3249,1900,1,00209,India
471032,2023-05-09,505,oven,18490,24000,5510,1,00209,India
772866,2023-05-09,507,washing machine,6990,16490,9500,1,00307,India
772866,2023-05-09,504,iron,449,879,430,1,00307,India
936123,2023-05-09,504,iron,449,879,430,1,00430,India
936123,2023-05-09,501,iphone 15,60000,80000,20000,1,00430,India
936123,2023-05-09,507,washing machine,6990,16490,9500,1,00430,India
802020,2023-05-09,507,washing machine,6990,16490,9500,1,00135,India
802020,2023-05-09,504,iron,449,879,430,1,00135,India
802020,2023-05-09,506,monitor,3249,8000,4751,1,00135,India
273714,2023-05-09,504,iron,449,879,430,1,00469,India
489301,2023-05-09,505,oven,18490,24000,5510,1,00305,India
489301,2023-05-09,507,washing machine,6990,16490,9500,1,00305,India
489301,2023-05-09,501,iphone 15,60000,80000,20000,1,00305,India
870341,2023-05-09,501,iphone 15,60000,80000,20000,1,00316,India
870341,2023-05-09,504,iron,449,879,430,1,00316,India
870341,2023-05-09,503,mixer,1349,3249,1900,1,00316,India
870341,2023-05-09,502,iphone 15 pro max,100000,135000,35000,1,00316,India
725940,2023-05-09,505,oven,18490,24000,5510,1,00309,India
725940,2023-05-09,503,mixer,1349,3249,1900,1,00309,India
491082,2023-05-09,504,iron,449,879,430,1,00046,India
491082,2023-05-09,505,oven,18490,24000,5510,1,00046,India
811431,2023-05-09,506,monitor,3249,8000,4751,1,00237,India
811431,2023-05-09,507,washing machine,6990,16490,9500,1,00237,India
811431,2023-05-09,502,iphone 15 pro max,100000,135000,35000,1,00237,India
627853,2023-05-09,505,oven,18490,24000,5510,1,00428,India
668977,2023-05-09,506,monitor,3249,8000,4751,1,00147,India
524101,2023-05-09,502,iphone 15 pro max,100000,135000,35000,1,00184,India
524101,2023-05-09,503,mixer,1349,3249,1900,1,00184,India
481020,2023-05-09,501,iphone 15,60000,80000,20000,1,00480,India
481020,2023-05-09,502,iphone 15 pro max,100000,135000,35000,1,00480,India
481020,2023-05-09,505,oven,18490,24000,5510,1,00480,India
481020,2023-05-09,507,washing machine,6990,16490,9500,1,00480,India
829412,2023-05-09,507,washing machine,6990,16490,9500,1,00425,India
662601,2023-05-09,503,mixer,1349,3249,1900,1,00015,India
662601,2023-05-09,501,iphone 15,60000,80000,20000,1,00015,India
662601,2023-05-09,504,iron,449,879,430,1,00015,India
662601,2023-05-09,506,monitor,3249,8000,4751,1,00015,India
830156,2023-05-09,505,oven,18490,24000,5510,1,00252,India
828865,2023-05-09,507,washing machine,6990,16490,9500,1,00288,India
828865,2023-05-09,504,iron,449,879,430,1,00288,India
709133,2023-05-09,506,monitor,3249,8000,4751,1,00126,India
709133,2023-05-09,501,iphone 15,60000,80000,20000,1,00126,India
645720,2023-05-09,503,mixer,1349,3249,1900,1,00141,India
645720,2023-05-09,502,iphone 15 pro max,100000,135000,35000,1,00141,India
618377,2023-05-09,507,washing machine,6990,16490,9500,1,00428,India
618377,2023-05-09,502,iphone 15 pro max,100000,135000,35000,1,00428,India
618377,2023-05-09,505,oven,18490,24000,5510,1,00428,India
425314,2023-05-09,502,iphone 15 pro max,100000,135000,35000,1,00462,India
425314,2023-05-09,505,oven,18490,24000,5510,1,00462,India
551869,2023-05-09,503,mixer,1349,3249,1900,1,00018,India
632770,2023-05-09,503,mixer,1349,3249,1900,1,00190,India
632770,2023-05-09,501,iphone 15,60000,80000,20000,1,00190,India
632770,2023-05-09,502,iphone 15 pro max,100000,135000,35000,1,00190,India
442650,2023-05-09,503,mixer,1349,3249,1900,1,00491,India
442650,2023-05-09,502,iphone 15 pro max,100000,135000,35000,1,00491,India
442650,2023-05-09,506,monitor,3249,8000,4751,1,00491,India
652396,2023-05-09,506,monitor,3249,8000,4751,1,00085,India
791387,2023-05-09,506,monitor,3249,8000,4751,1,00338,India
791387,2023-05-09,501,iphone 15,60000,80000,20000,1,00338,India
558622,2023-05-09,505,oven,18490,24000,5510,1,00015,India
861280,2023-05-09,506,monitor,3249,8000,4751,1,00018,India
861280,2023-05-09,503,mixer,1349,3249,1900,1,00018,India
488037,2023-05-09,502,iphone 15 pro max,100000,135000,35000,1,00291,India
488037,2023-05-09,501,iphone 15,60000,80000,20000,1,00291,India
488037,2023-05-09,506,monitor,3249,8000,4751,1,00291,India
676820,2023-05-09,507,washing machine,6990,16490,9500,1,00366,India
676820,2023-05-09,502,iphone 15 pro max,100000,135000,35000,1,00366,India
676820,2023-05-09,505,oven,18490,24000,5510,1,00366,India
676820,2023-05-09,506,monitor,3249,8000,4751,1,00366,India
220039,2023-05-09,503,mixer,1349,3249,1900,1,00370,India
220039,2023-05-09,505,oven,18490,24000,5510,1,00370,India
779802,2023-05-09,507,washing machine,6990,16490,9500,1,00074,India
779802,2023-05-09,502,iphone 15 pro max,100000,135000,35000,1,00074,India
779802,2023-05-09,503,mixer,1349,3249,1900,1,00074,India
322799,2023-05-09,507,washing machine,6990,16490,9500,1,00407,India
322799,2023-05-09,502,iphone 15 pro max,100000,135000,35000,1,00407,India
322799,2023-05-09,503,mixer,1349,3249,1900,1,00407,India
322799,2023-05-09,501,iphone 15,60000,80000,20000,1,00407,India
399413,2023-05-09,503,mixer,1349,3249,1900,1,00012,India
399413,2023-05-09,501,iphone 15,60000,80000,20000,1,00012,India
953624,2023-05-09,504,iron,449,879,430,1,00320,India
608171,2023-05-09,506,monitor,3249,8000,4751,1,00115,India
608171,2023-05-09,507,washing machine,6990,16490,9500,1,00115,India
608171,2023-05-09,505,oven,18490,24000,5510,1,00115,India
117491,2023-05-09,501,iphone 15,60000,80000,20000,1,00044,India
117491,2023-05-09,506,monitor,3249,8000,4751,1,00044,India
117491,2023-05-09,505,oven,18490,24000,5510,1,00044,India
866577,2023-05-09,504,iron,449,879,430,1,00073,India
866577,2023-05-09,505,oven,18490,24000,5510,1,00073,India
292537,2023-05-09,506,monitor,3249,8000,4751,1,00308,India
292537,2023-05-09,503,mixer,1349,3249,1900,1,00308,India
486163,2023-05-10,504,iron,449,879,430,1,00288,India
486163,2023-05-10,501,iphone 15,60000,80000,20000,1,00288,India
486163,2023-05-10,502,iphone 15 pro max,100000,135000,35000,1,00288,India
262997,2023-05-10,502,iphone 15 pro max,100000,135000,35000,1,00020,India
262997,2023-05-10,501,iphone 15,60000,80000,20000,1,00020,India
262997,2023-05-10,505,oven,18490,24000,5510,1,00020,India
819195,2023-05-10,502,iphone 15 pro max,100000,135000,35000,1,00366,India
587637,2023-05-10,506,monitor,3249,8000,4751,1,00277,India
587637,2023-05-10,503,mixer,1349,3249,1900,1,00277,India
587637,2023-05-10,504,iron,449,879,430,1,00277,India
211201,2023-05-10,505,oven,18490,24000,5510,1,00201,India
211201,2023-05-10,506,monitor,3249,8000,4751,1,00201,India
211201,2023-05-10,501,iphone 15,60000,80000,20000,1,00201,India
211201,2023-05-10,507,washing machine,6990,16490,9500,1,00201,India
211201,2023-05-10,504,iron,449,879,430,1,00201,India
878339,2023-05-10,502,iphone 15 pro max,100000,135000,35000,1,00296,India
878339,2023-05-10,507,washing machine,6990,16490,9500,1,00296,India
878339,2023-05-10,501,iphone 15,60000,80000,20000,1,00296,India
713703,2023-05-10,502,iphone 15 pro max,100000,135000,35000,1,00472,India
831082,2023-05-10,504,iron,449,879,430,1,00406,India
831082,2023-05-10,505,oven,18490,24000,5510,1,00406,India
831082,2023-05-10,501,iphone 15,60000,80000,20000,1,00406,India
889020,2023-05-10,506,monitor,3249,8000,4751,1,00259,India
889020,2023-05-10,504,iron,449,879,430,1,00259,India
889020,2023-05-10,505,oven,18490,24000,5510,1,00259,India
889020,2023-05-10,502,iphone 15 pro max,100000,135000,35000,1,00259,India
552617,2023-05-10,506,monitor,3249,8000,4751,1,00412,India
788652,2023-05-10,502,iphone 15 pro max,100000,135000,35000,1,00310,India
235003,2023-05-10,503,mixer,1349,3249,1900,1,00255,India
512797,2023-05-10,506,monitor,3249,8000,4751,1,00421,India
512797,2023-05-10,507,washing machine,6990,16490,9500,1,00421,India
628060,2023-05-10,503,mixer,1349,3249,1900,1,00232,India
628060,2023-05-10,507,washing machine,6990,16490,9500,1,00232,India
628060,2023-05-10,504,iron,449,879,430,1,00232,India
946894,2023-05-10,501,iphone 15,60000,80000,20000,1,00361,India
946894,2023-05-10,506,monitor,3249,8000,4751,1,00361,India
717405,2023-05-10,501,iphone 15,60000,80000,20000,1,00167,India
717405,2023-05-10,506,monitor,3249,8000,4751,1,00167,India
385474,2023-05-10,501,iphone 15,60000,80000,20000,1,00470,India
385474,2023-05-10,506,monitor,3249,8000,4751,1,00470,India
975631,2023-05-10,507,washing machine,6990,16490,9500,1,00106,India
895747,2023-05-10,504,iron,449,879,430,1,00487,India
895747,2023-05-10,502,iphone 15 pro max,100000,135000,35000,1,00487,India
895747,2023-05-10,501,iphone 15,60000,80000,20000,1,00487,India
895747,2023-05-10,503,mixer,1349,3249,1900,1,00487,India
861743,2023-05-10,506,monitor,3249,8000,4751,1,00009,India
861743,2023-05-10,501,iphone 15,60000,80000,20000,1,00009,India
861743,2023-05-10,505,oven,18490,24000,5510,1,00009,India
916191,2023-05-10,503,mixer,1349,3249,1900,1,00410,India
916191,2023-05-10,507,washing machine,6990,16490,9500,1,00410,India
916191,2023-05-10,506,monitor,3249,8000,4751,1,00410,India
819410,2023-05-10,502,iphone 15 pro max,100000,135000,35000,1,00333,India
819410,2023-05-10,506,monitor,3249,8000,4751,1,00333,India
819410,2023-05-10,507,washing machine,6990,16490,9500,1,00333,India
163447,2023-05-10,507,washing machine,6990,16490,9500,1,00431,India
255507,2023-05-10,503,mixer,1349,3249,1900,1,00465,India
255507,2023-05-10,504,iron,449,879,430,1,00465,India
255507,2023-05-10,506,monitor,3249,8000,4751,1,00465,India
688987,2023-05-10,505,oven,18490,24000,5510,1,00466,India
688987,2023-05-10,501,iphone 15,60000,80000,20000,1,00466,India
688987,2023-05-10,502,iphone 15 pro max,100000,135000,35000,1,00466,India
804321,2023-05-10,506,monitor,3249,8000,4751,1,00055,India
804321,2023-05-10,503,mixer,1349,3249,1900,1,00055,India
765222,2023-05-10,507,washing machine,6990,16490,9500,1,00095,India
765222,2023-05-10,502,iphone 15 pro max,100000,135000,35000,1,00095,India
765222,2023-05-10,505,oven,18490,24000,5510,1,00095,India
765222,2023-05-10,501,iphone 15,60000,80000,20000,1,00095,India
512034,2023-05-10,506,monitor,3249,8000,4751,1,00147,India
512034,2023-05-10,503,mixer,1349,3249,1900,1,00147,India
567982,2023-05-10,507,washing machine,6990,16490,9500,1,00181,India
567982,2023-05-10,503,mixer,1349,3249,1900,1,00181,India
862167,2023-05-10,501,iphone 15,60000,80000,20000,1,00330,India
862167,2023-05-10,503,mixer,1349,3249,1900,1,00330,India
862167,2023-05-10,507,washing machine,6990,16490,9500,1,00330,India
456424,2023-05-10,503,mixer,1349,3249,1900,1,00031,India
456424,2023-05-10,501,iphone 15,60000,80000,20000,1,00031,India
456424,2023-05-10,502,iphone 15 pro max,100000,135000,35000,1,00031,India
319573,2023-05-10,504,iron,449,879,430,1,00132,India
319573,2023-05-10,505,oven,18490,24000,5510,1,00132,India
319573,2023-05-10,503,mixer,1349,3249,1900,1,00132,India
868408,2023-05-10,507,washing machine,6990,16490,9500,1,00374,India
868408,2023-05-10,501,iphone 15,60000,80000,20000,1,00374,India
107819,2023-05-10,503,mixer,1349,3249,1900,1,00204,India
107819,2023-05-10,502,iphone 15 pro max,100000,135000,35000,1,00204,India
107819,2023-05-10,505,oven,18490,24000,5510,1,00204,India
969584,2023-05-10,506,monitor,3249,8000,4751,1,00341,India
969584,2023-05-10,505,oven,18490,24000,5510,1,00341,India
969584,2023-05-10,502,iphone 15 pro max,100000,135000,35000,1,00341,India
360643,2023-05-10,507,washing machine,6990,16490,9500,1,00202,India
360643,2023-05-10,503,mixer,1349,3249,1900,1,00202,India
360643,2023-05-10,506,monitor,3249,8000,4751,1,00202,India
360643,2023-05-10,504,iron,449,879,430,1,00202,India
130994,2023-05-10,507,washing machine,6990,16490,9500,1,00314,India
130994,2023-05-10,501,iphone 15,60000,80000,20000,1,00314,India
130994,2023-05-10,504,iron,449,879,430,1,00314,India
235874,2023-05-10,507,washing machine,6990,16490,9500,1,00348,India
235874,2023-05-10,503,mixer,1349,3249,1900,1,00348,India
235874,2023-05-10,502,iphone 15 pro max,100000,135000,35000,1,00348,India
235874,2023-05-10,501,iphone 15,60000,80000,20000,1,00348,India
328965,2023-05-10,501,iphone 15,60000,80000,20000,1,00470,India
328965,2023-05-10,503,mixer,1349,3249,1900,1,00470,India
206588,2023-05-10,505,oven,18490,24000,5510,1,00396,India
854488,2023-05-10,503,mixer,1349,3249,1900,1,00016,India
854488,2023-05-10,501,iphone 15,60000,80000,20000,1,00016,India
494570,2023-05-10,506,monitor,3249,8000,4751,1,00389,India
494570,2023-05-10,504,iron,449,879,430,1,00389,India
494570,2023-05-10,505,oven,18490,24000,5510,1,00389,India
494570,2023-05-10,501,iphone 15,60000,80000,20000,1,00389,India
229883,2023-05-10,504,iron,449,879,430,1,00265,India
522175,2023-05-10,502,iphone 15 pro max,100000,135000,35000,1,00011,India
732066,2023-05-10,504,iron,449,879,430,1,00393,India
732066,2023-05-10,507,washing machine,6990,16490,9500,1,00393,India
884451,2023-05-10,505,oven,18490,24000,5510,1,00433,India
884451,2023-05-10,504,iron,449,879,430,1,00433,India
884451,2023-05-10,502,iphone 15 pro max,100000,135000,35000,1,00433,India
884451,2023-05-10,503,mixer,1349,3249,1900,1,00433,India
101229,2023-05-10,504,iron,449,879,430,1,00228,India
880744,2023-05-10,503,mixer,1349,3249,1900,1,00464,India
880744,2023-05-10,505,oven,18490,24000,5510,1,00464,India
880744,2023-05-10,506,monitor,3249,8000,4751,1,00464,India
951524,2023-05-10,502,iphone 15 pro max,100000,135000,35000,1,00248,India
951524,2023-05-10,506,monitor,3249,8000,4751,1,00248,India
951524,2023-05-10,507,washing machine,6990,16490,9500,1,00248,India
951524,2023-05-10,503,mixer,1349,3249,1900,1,00248,India
285197,2023-05-10,504,iron,449,879,430,1,00122,India
285197,2023-05-10,505,oven,18490,24000,5510,1,00122,India
285197,2023-05-10,507,washing machine,6990,16490,9500,1,00122,India
285197,2023-05-10,501,iphone 15,60000,80000,20000,1,00122,India
773769,2023-05-10,502,iphone 15 pro max,100000,135000,35000,1,00438,India
773769,2023-05-10,506,monitor,3249,8000,4751,1,00438,India
773769,2023-05-10,505,oven,18490,24000,5510,1,00438,India
773769,2023-05-10,503,mixer,1349,3249,1900,1,00438,India
158456,2023-05-10,506,monitor,3249,8000,4751,1,00279,India
158456,2023-05-10,501,iphone 15,60000,80000,20000,1,00279,India
882095,2023-05-10,503,mixer,1349,3249,1900,1,00120,India
882095,2023-05-10,501,iphone 15,60000,80000,20000,1,00120,India
349455,2023-05-10,502,iphone 15 pro max,100000,135000,35000,1,00361,India
349455,2023-05-10,507,washing machine,6990,16490,9500,1,00361,India
349455,2023-05-10,504,iron,449,879,430,1,00361,India
349455,2023-05-10,506,monitor,3249,8000,4751,1,00361,India
405661,2023-05-10,504,iron,449,879,430,1,00140,India
937031,2023-05-10,501,iphone 15,60000,80000,20000,1,00277,India
937031,2023-05-10,506,monitor,3249,8000,4751,1,00277,India
487562,2023-05-10,504,iron,449,879,430,1,00493,India
487562,2023-05-10,506,monitor,3249,8000,4751,1,00493,India
895740,2023-05-10,506,monitor,3249,8000,4751,1,00480,India
895740,2023-05-10,501,iphone 15,60000,80000,20000,1,00480,India
895740,2023-05-10,503,mixer,1349,3249,1900,1,00480,India
358675,2023-05-10,505,oven,18490,24000,5510,1,00010,India
358675,2023-05-10,503,mixer,1349,3249,1900,1,00010,India
445773,2023-05-10,503,mixer,1349,3249,1900,1,00120,India
445773,2023-05-10,502,iphone 15 pro max,100000,135000,35000,1,00120,India
445773,2023-05-10,506,monitor,3249,8000,4751,1,00120,India
445773,2023-05-10,501,iphone 15,60000,80000,20000,1,00120,India
101183,2023-05-10,502,iphone 15 pro max,100000,135000,35000,1,00161,India
101183,2023-05-10,501,iphone 15,60000,80000,20000,1,00161,India
101183,2023-05-10,503,mixer,1349,3249,1900,1,00161,India
339055,2023-05-10,503,mixer,1349,3249,1900,1,00025,India
339055,2023-05-10,502,iphone 15 pro max,100000,135000,35000,1,00025,India
525735,2023-05-10,507,washing machine,6990,16490,9500,1,00205,India
525735,2023-05-10,504,iron,449,879,430,1,00205,India
525735,2023-05-10,506,monitor,3249,8000,4751,1,00205,India
525735,2023-05-10,501,iphone 15,60000,80000,20000,1,00205,India
939514,2023-05-10,503,mixer,1349,3249,1900,1,00469,India
939514,2023-05-10,502,iphone 15 pro max,100000,135000,35000,1,00469,India
939514,2023-05-10,506,monitor,3249,8000,4751,1,00469,India
814482,2023-05-10,501,iphone 15,60000,80000,20000,1,00056,India
814482,2023-05-10,507,washing machine,6990,16490,9500,1,00056,India
480657,2023-05-10,504,iron,449,879,430,1,00113,India
480657,2023-05-10,501,iphone 15,60000,80000,20000,1,00113,India
480657,2023-05-10,502,iphone 15 pro max,100000,135000,35000,1,00113,India
480657,2023-05-10,505,oven,18490,24000,5510,1,00113,India
273019,2023-05-10,505,oven,18490,24000,5510,1,00428,India
273019,2023-05-10,504,iron,449,879,430,1,00428,India
273019,2023-05-10,507,washing machine,6990,16490,9500,1,00428,India
273019,2023-05-10,502,iphone 15 pro max,100000,135000,35000,1,00428,India
763179,2023-05-10,504,iron,449,879,430,1,00158,India
763179,2023-05-10,506,monitor,3249,8000,4751,1,00158,India
736760,2023-05-10,504,iron,449,879,430,1,00478,India
736760,2023-05-10,501,iphone 15,60000,80000,20000,1,00478,India
457924,2023-05-10,502,iphone 15 pro max,100000,135000,35000,1,00213,India
457924,2023-05-10,506,monitor,3249,8000,4751,1,00213,India
837685,2023-05-10,501,iphone 15,60000,80000,20000,1,00276,India
837685,2023-05-10,506,monitor,3249,8000,4751,1,00276,India
831127,2023-05-10,502,iphone 15 pro max,100000,135000,35000,1,00164,India
831127,2023-05-10,503,mixer,1349,3249,1900,1,00164,India
831127,2023-05-10,505,oven,18490,24000,5510,1,00164,India
967980,2023-05-10,506,monitor,3249,8000,4751,1,00110,India
967980,2023-05-10,507,washing machine,6990,16490,9500,1,00110,India
967980,2023-05-10,502,iphone 15 pro max,100000,135000,35000,1,00110,India
548949,2023-05-11,502,iphone 15 pro max,100000,135000,35000,1,00054,India
548949,2023-05-11,505,oven,18490,24000,5510,1,00054,India
115438,2023-05-11,502,iphone 15 pro max,100000,135000,35000,1,00196,India
115438,2023-05-11,501,iphone 15,60000,80000,20000,1,00196,India
115438,2023-05-11,503,mixer,1349,3249,1900,1,00196,India
115438,2023-05-11,507,washing machine,6990,16490,9500,1,00196,India
239553,2023-05-11,501,iphone 15,60000,80000,20000,1,00201,India
239553,2023-05-11,504,iron,449,879,430,1,00201,India
239553,2023-05-11,507,washing machine,6990,16490,9500,1,00201,India
573772,2023-05-11,506,monitor,3249,8000,4751,1,00108,India
573772,2023-05-11,501,iphone 15,60000,80000,20000,1,00108,India
573772,2023-05-11,502,iphone 15 pro max,100000,135000,35000,1,00108,India
573772,2023-05-11,505,oven,18490,24000,5510,1,00108,India
879164,2023-05-11,506,monitor,3249,8000,4751,1,00369,India
879164,2023-05-11,507,washing machine,6990,16490,9500,1,00369,India
997769,2023-05-11,504,iron,449,879,430,1,00401,India
434543,2023-05-11,502,iphone 15 pro max,100000,135000,35000,1,00212,India
434543,2023-05-11,504,iron,449,879,430,1,00212,India
434543,2023-05-11,506,monitor,3249,8000,4751,1,00212,India
754915,2023-05-11,502,iphone 15 pro max,100000,135000,35000,1,00087,India
353164,2023-05-11,506,monitor,3249,8000,4751,1,00383,India
733399,2023-05-11,503,mixer,1349,3249,1900,1,00463,India
733399,2023-05-11,502,iphone 15 pro max,100000,135000,35000,1,00463,India
733399,2023-05-11,501,iphone 15,60000,80000,20000,1,00463,India
390761,2023-05-11,505,oven,18490,24000,5510,1,00089,India
390761,2023-05-11,502,iphone 15 pro max,100000,135000,35000,1,00089,India
398100,2023-05-11,506,monitor,3249,8000,4751,1,00481,India
398100,2023-05-11,505,oven,18490,24000,5510,1,00481,India
398100,2023-05-11,501,iphone 15,60000,80000,20000,1,00481,India
398100,2023-05-11,507,washing machine,6990,16490,9500,1,00481,India
398100,2023-05-11,502,iphone 15 pro max,100000,135000,35000,1,00481,India
994827,2023-05-11,502,iphone 15 pro max,100000,135000,35000,1,00457,India
994827,2023-05-11,503,mixer,1349,3249,1900,1,00457,India
994827,2023-05-11,504,iron,449,879,430,1,00457,India
994827,2023-05-11,505,oven,18490,24000,5510,1,00457,India
995066,2023-05-11,503,mixer,1349,3249,1900,1,00500,India
995066,2023-05-11,506,monitor,3249,8000,4751,1,00500,India
393612,2023-05-11,507,washing machine,6990,16490,9500,1,00001,India
393612,2023-05-11,501,iphone 15,60000,80000,20000,1,00001,India
393612,2023-05-11,503,mixer,1349,3249,1900,1,00001,India
393612,2023-05-11,506,monitor,3249,8000,4751,1,00001,India
393612,2023-05-11,502,iphone 15 pro max,100000,135000,35000,1,00001,India
883346,2023-05-11,505,oven,18490,24000,5510,1,00027,India
243634,2023-05-11,502,iphone 15 pro max,100000,135000,35000,1,00148,India
243634,2023-05-11,506,monitor,3249,8000,4751,1,00148,India
243634,2023-05-11,505,oven,18490,24000,5510,1,00148,India
186509,2023-05-11,501,iphone 15,60000,80000,20000,1,00022,India
186509,2023-05-11,505,oven,18490,24000,5510,1,00022,India
186509,2023-05-11,503,mixer,1349,3249,1900,1,00022,India
668515,2023-05-11,506,monitor,3249,8000,4751,1,00184,India
939618,2023-05-11,504,iron,449,879,430,1,00470,India
239592,2023-05-11,504,iron,449,879,430,1,00344,India
239592,2023-05-11,507,washing machine,6990,16490,9500,1,00344,India
239592,2023-05-11,501,iphone 15,60000,80000,20000,1,00344,India
778502,2023-05-11,501,iphone 15,60000,80000,20000,1,00101,India
778502,2023-05-11,506,monitor,3249,8000,4751,1,00101,India
501944,2023-05-11,501,iphone 15,60000,80000,20000,1,00298,India
501944,2023-05-11,504,iron,449,879,430,1,00298,India
313048,2023-05-11,504,iron,449,879,430,1,00443,India
313048,2023-05-11,505,oven,18490,24000,5510,1,00443,India
313048,2023-05-11,507,washing machine,6990,16490,9500,1,00443,India
902658,2023-05-11,503,mixer,1349,3249,1900,1,00159,India
902658,2023-05-11,506,monitor,3249,8000,4751,1,00159,India
321617,2023-05-11,503,mixer,1349,3249,1900,1,00459,India
321617,2023-05-11,504,iron,449,879,430,1,00459,India
321617,2023-05-11,507,washing machine,6990,16490,9500,1,00459,India
266102,2023-05-11,507,washing machine,6990,16490,9500,1,00223,India
266102,2023-05-11,506,monitor,3249,8000,4751,1,00223,India
663918,2023-05-11,504,iron,449,879,430,1,00186,India
663918,2023-05-11,503,mixer,1349,3249,1900,1,00186,India
663918,2023-05-11,501,iphone 15,60000,80000,20000,1,00186,India
663918,2023-05-11,505,oven,18490,24000,5510,1,00186,India
462356,2023-05-11,503,mixer,1349,3249,1900,1,00348,India
766854,2023-05-11,505,oven,18490,24000,5510,1,00406,India
742695,2023-05-11,503,mixer,1349,3249,1900,1,00289,India
742695,2023-05-11,502,iphone 15 pro max,100000,135000,35000,1,00289,India
742695,2023-05-11,505,oven,18490,24000,5510,1,00289,India
687415,2023-05-11,503,mixer,1349,3249,1900,1,00250,India
687415,2023-05-11,506,monitor,3249,8000,4751,1,00250,India
678058,2023-05-11,504,iron,449,879,430,1,00029,India
678058,2023-05-11,501,iphone 15,60000,80000,20000,1,00029,India
678058,2023-05-11,506,monitor,3249,8000,4751,1,00029,India
818621,2023-05-11,505,oven,18490,24000,5510,1,00096,India
818621,2023-05-11,507,washing machine,6990,16490,9500,1,00096,India
818621,2023-05-11,503,mixer,1349,3249,1900,1,00096,India
201531,2023-05-11,505,oven,18490,24000,5510,1,00198,India
201531,2023-05-11,501,iphone 15,60000,80000,20000,1,00198,India
170158,2023-05-11,504,iron,449,879,430,1,00024,India
170158,2023-05-11,505,oven,18490,24000,5510,1,00024,India
981622,2023-05-11,501,iphone 15,60000,80000,20000,1,00370,India
981622,2023-05-11,506,monitor,3249,8000,4751,1,00370,India
850278,2023-05-11,504,iron,449,879,430,1,00156,India
850278,2023-05-11,506,monitor,3249,8000,4751,1,00156,India
468881,2023-05-11,506,monitor,3249,8000,4751,1,00499,India
468881,2023-05-11,505,oven,18490,24000,5510,1,00499,India
468881,2023-05-11,502,iphone 15 pro max,100000,135000,35000,1,00499,India
200936,2023-05-11,501,iphone 15,60000,80000,20000,1,00190,India
200936,2023-05-11,502,iphone 15 pro max,100000,135000,35000,1,00190,India
335381,2023-05-11,507,washing machine,6990,16490,9500,1,00394,India
335381,2023-05-11,502,iphone 15 pro max,100000,135000,35000,1,00394,India
335381,2023-05-11,504,iron,449,879,430,1,00394,India
335381,2023-05-11,503,mixer,1349,3249,1900,1,00394,India
714906,2023-05-11,504,iron,449,879,430,1,00263,India
714906,2023-05-11,507,washing machine,6990,16490,9500,1,00263,India
714906,2023-05-11,506,monitor,3249,8000,4751,1,00263,India
714906,2023-05-11,501,iphone 15,60000,80000,20000,1,00263,India
995035,2023-05-11,502,iphone 15 pro max,100000,135000,35000,1,00336,India
250304,2023-05-11,503,mixer,1349,3249,1900,1,00085,India
250304,2023-05-11,507,washing machine,6990,16490,9500,1,00085,India
250304,2023-05-11,505,oven,18490,24000,5510,1,00085,India
191127,2023-05-11,505,oven,18490,24000,5510,1,00013,India
191127,2023-05-11,504,iron,449,879,430,1,00013,India
191127,2023-05-11,502,iphone 15 pro max,100000,135000,35000,1,00013,India
179026,2023-05-11,506,monitor,3249,8000,4751,1,00309,India
239119,2023-05-11,503,mixer,1349,3249,1900,1,00107,India
239119,2023-05-11,502,iphone 15 pro max,100000,135000,35000,1,00107,India
861979,2023-05-11,502,iphone 15 pro max,100000,135000,35000,1,00051,India
861979,2023-05-11,504,iron,449,879,430,1,00051,India
861979,2023-05-11,503,mixer,1349,3249,1900,1,00051,India
773082,2023-05-11,504,iron,449,879,430,1,00324,India
773082,2023-05-11,503,mixer,1349,3249,1900,1,00324,India
823557,2023-05-11,505,oven,18490,24000,5510,1,00051,India
883338,2023-05-11,502,iphone 15 pro max,100000,135000,35000,1,00388,India
883338,2023-05-11,505,oven,18490,24000,5510,1,00388,India
760416,2023-05-11,503,mixer,1349,3249,1900,1,00274,India
760416,2023-05-11,504,iron,449,879,430,1,00274,India
760416,2023-05-11,502,iphone 15 pro max,100000,135000,35000,1,00274,India
760416,2023-05-11,505,oven,18490,24000,5510,1,00274,India
625359,2023-05-11,501,iphone 15,60000,80000,20000,1,00378,India
543786,2023-05-11,505,oven,18490,24000,5510,1,00160,India
543786,2023-05-11,502,iphone 15 pro max,100000,135000,35000,1,00160,India
300489,2023-05-11,501,iphone 15,60000,80000,20000,1,00371,India
300489,2023-05-11,507,washing machine,6990,16490,9500,1,00371,India
300489,2023-05-11,505,oven,18490,24000,5510,1,00371,India
370335,2023-05-11,503,mixer,1349,3249,1900,1,00078,India
370335,2023-05-11,504,iron,449,879,430,1,00078,India
370335,2023-05-11,502,iphone 15 pro max,100000,135000,35000,1,00078,India
814669,2023-05-11,507,washing machine,6990,16490,9500,1,00086,India
814669,2023-05-11,505,oven,18490,24000,5510,1,00086,India
814669,2023-05-11,502,iphone 15 pro max,100000,135000,35000,1,00086,India
814669,2023-05-11,504,iron,449,879,430,1,00086,India
629815,2023-05-11,505,oven,18490,24000,5510,1,00479,India
629815,2023-05-11,503,mixer,1349,3249,1900,1,00479,India
629815,2023-05-11,507,washing machine,6990,16490,9500,1,00479,India
629815,2023-05-11,504,iron,449,879,430,1,00479,India
629815,2023-05-11,501,iphone 15,60000,80000,20000,1,00479,India
574783,2023-05-11,507,washing machine,6990,16490,9500,1,00084,India
574783,2023-05-11,506,monitor,3249,8000,4751,1,00084,India
574783,2023-05-11,502,iphone 15 pro max,100000,135000,35000,1,00084,India
948878,2023-05-11,503,mixer,1349,3249,1900,1,00484,India
296678,2023-05-11,502,iphone 15 pro max,100000,135000,35000,1,00003,India
296678,2023-05-11,503,mixer,1349,3249,1900,1,00003,India
786292,2023-05-11,507,washing machine,6990,16490,9500,1,00443,India
786292,2023-05-11,502,iphone 15 pro max,100000,135000,35000,1,00443,India
786292,2023-05-11,501,iphone 15,60000,80000,20000,1,00443,India
886365,2023-05-11,504,iron,449,879,430,1,00163,India
886365,2023-05-11,501,iphone 15,60000,80000,20000,1,00163,India
886365,2023-05-11,502,iphone 15 pro max,100000,135000,35000,1,00163,India
964506,2023-05-11,506,monitor,3249,8000,4751,1,00031,India
964506,2023-05-11,507,washing machine,6990,16490,9500,1,00031,India
964506,2023-05-11,505,oven,18490,24000,5510,1,00031,India
964506,2023-05-11,504,iron,449,879,430,1,00031,India
199273,2023-05-11,503,mixer,1349,3249,1900,1,00422,India
199273,2023-05-11,506,monitor,3249,8000,4751,1,00422,India
199273,2023-05-11,507,washing machine,6990,16490,9500,1,00422,India
199273,2023-05-11,501,iphone 15,60000,80000,20000,1,00422,India
592406,2023-05-11,507,washing machine,6990,16490,9500,1,00435,India
592406,2023-05-11,504,iron,449,879,430,1,00435,India
592406,2023-05-11,503,mixer,1349,3249,1900,1,00435,India
738418,2023-05-11,502,iphone 15 pro max,100000,135000,35000,1,00441,India
707157,2023-05-11,501,iphone 15,60000,80000,20000,1,00439,India
707157,2023-05-11,505,oven,18490,24000,5510,1,00439,India
258464,2023-05-11,503,mixer,1349,3249,1900,1,00363,India
258464,2023-05-11,506,monitor,3249,8000,4751,1,00363,India
258464,2023-05-11,501,iphone 15,60000,80000,20000,1,00363,India
945373,2023-05-11,503,mixer,1349,3249,1900,1,00183,India
945373,2023-05-11,502,iphone 15 pro max,100000,135000,35000,1,00183,India
215764,2023-05-11,502,iphone 15 pro max,100000,135000,35000,1,00225,India
215764,2023-05-11,504,iron,449,879,430,1,00225,India
215764,2023-05-11,506,monitor,3249,8000,4751,1,00225,India
598521,2023-05-11,506,monitor,3249,8000,4751,1,00423,India
812509,2023-05-11,503,mixer,1349,3249,1900,1,00453,India
576766,2023-05-11,506,monitor,3249,8000,4751,1,00284,India
576766,2023-05-11,507,washing machine,6990,16490,9500,1,00284,India
576766,2023-05-11,504,iron,449,879,430,1,00284,India
576766,2023-05-11,502,iphone 15 pro max,100000,135000,35000,1,00284,India
576766,2023-05-11,501,iphone 15,60000,80000,20000,1,00284,India
987800,2023-05-11,504,iron,449,879,430,1,00384,India
987800,2023-05-11,503,mixer,1349,3249,1900,1,00384,India
987800,2023-05-11,505,oven,18490,24000,5510,1,00384,India
340551,2023-05-11,504,iron,449,879,430,1,00292,India
340551,2023-05-11,502,iphone 15 pro max,100000,135000,35000,1,00292,India
340551,2023-05-11,507,washing machine,6990,16490,9500,1,00292,India
340551,2023-05-11,506,monitor,3249,8000,4751,1,00292,India
340551,2023-05-11,505,oven,18490,24000,5510,1,00292,India
477835,2023-05-11,504,iron,449,879,430,1,00199,India
477835,2023-05-11,506,monitor,3249,8000,4751,1,00199,India
477835,2023-05-11,501,iphone 15,60000,80000,20000,1,00199,India
940646,2023-05-11,502,iphone 15 pro max,100000,135000,35000,1,00205,India
940646,2023-05-11,507,washing machine,6990,16490,9500,1,00205,India
940646,2023-05-11,504,iron,449,879,430,1,00205,India
940646,2023-05-11,501,iphone 15,60000,80000,20000,1,00205,India
940646,2023-05-11,503,mixer,1349,3249,1900,1,00205,India
253977,2023-05-11,505,oven,18490,24000,5510,1,00495,India
253977,2023-05-11,502,iphone 15 pro max,100000,135000,35000,1,00495,India
253977,2023-05-11,503,mixer,1349,3249,1900,1,00495,India
418896,2023-05-11,506,monitor,3249,8000,4751,1,00152,India
418896,2023-05-11,503,mixer,1349,3249,1900,1,00152,India
297056,2023-05-12,503,mixer,1349,3249,1900,1,00437,India
529908,2023-05-12,506,monitor,3249,8000,4751,1,00383,India
529908,2023-05-12,502,iphone 15 pro max,100000,135000,35000,1,00383,India
529908,2023-05-12,507,washing machine,6990,16490,9500,1,00383,India
529908,2023-05-12,501,iphone 15,60000,80000,20000,1,00383,India
316143,2023-05-12,507,washing machine,6990,16490,9500,1,00184,India
732596,2023-05-12,503,mixer,1349,3249,1900,1,00350,India
732596,2023-05-12,501,iphone 15,60000,80000,20000,1,00350,India
732596,2023-05-12,504,iron,449,879,430,1,00350,India
746217,2023-05-12,504,iron,449,879,430,1,00434,India
746217,2023-05-12,507,washing machine,6990,16490,9500,1,00434,India
746217,2023-05-12,506,monitor,3249,8000,4751,1,00434,India
655938,2023-05-12,507,washing machine,6990,16490,9500,1,00264,India
655938,2023-05-12,504,iron,449,879,430,1,00264,India
655938,2023-05-12,501,iphone 15,60000,80000,20000,1,00264,India
655938,2023-05-12,502,iphone 15 pro max,100000,135000,35000,1,00264,India
214363,2023-05-12,504,iron,449,879,430,1,00051,India
214363,2023-05-12,501,iphone 15,60000,80000,20000,1,00051,India
214363,2023-05-12,507,washing machine,6990,16490,9500,1,00051,India
804058,2023-05-12,502,iphone 15 pro max,100000,135000,35000,1,00024,India
102325,2023-05-12,501,iphone 15,60000,80000,20000,1,00431,India
771402,2023-05-12,505,oven,18490,24000,5510,1,00315,India
771402,2023-05-12,503,mixer,1349,3249,1900,1,00315,India
850656,2023-05-12,503,mixer,1349,3249,1900,1,00100,India
850656,2023-05-12,504,iron,449,879,430,1,00100,India
850656,2023-05-12,501,iphone 15,60000,80000,20000,1,00100,India
159836,2023-05-12,505,oven,18490,24000,5510,1,00443,India
159836,2023-05-12,503,mixer,1349,3249,1900,1,00443,India
159836,2023-05-12,504,iron,449,879,430,1,00443,India
535142,2023-05-12,503,mixer,1349,3249,1900,1,00118,India
535142,2023-05-12,502,iphone 15 pro max,100000,135000,35000,1,00118,India
535142,2023-05-12,501,iphone 15,60000,80000,20000,1,00118,India
535142,2023-05-12,506,monitor,3249,8000,4751,1,00118,India
337526,2023-05-12,503,mixer,1349,3249,1900,1,00375,India
337526,2023-05-12,502,iphone 15 pro max,100000,135000,35000,1,00375,India
782867,2023-05-12,504,iron,449,879,430,1,00255,India
782867,2023-05-12,501,iphone 15,60000,80000,20000,1,00255,India
782867,2023-05-12,506,monitor,3249,8000,4751,1,00255,India
782867,2023-05-12,502,iphone 15 pro max,100000,135000,35000,1,00255,India
791732,2023-05-12,503,mixer,1349,3249,1900,1,00189,India
529506,2023-05-12,504,iron,449,879,430,1,00455,India
529506,2023-05-12,501,iphone 15,60000,80000,20000,1,00455,India
529506,2023-05-12,507,washing machine,6990,16490,9500,1,00455,India
228886,2023-05-12,505,oven,18490,24000,5510,1,00090,India
228886,2023-05-12,504,iron,449,879,430,1,00090,India
228886,2023-05-12,507,washing machine,6990,16490,9500,1,00090,India
556885,2023-05-12,507,washing machine,6990,16490,9500,1,00172,India
556885,2023-05-12,503,mixer,1349,3249,1900,1,00172,India
556885,2023-05-12,502,iphone 15 pro max,100000,135000,35000,1,00172,India
300516,2023-05-12,503,mixer,1349,3249,1900,1,00254,India
300516,2023-05-12,505,oven,18490,24000,5510,1,00254,India
313448,2023-05-12,506,monitor,3249,8000,4751,1,00485,India
313448,2023-05-12,502,iphone 15 pro max,100000,135000,35000,1,00485,India
755193,2023-05-12,503,mixer,1349,3249,1900,1,00387,India
614341,2023-05-12,503,mixer,1349,3249,1900,1,00123,India
317847,2023-05-12,501,iphone 15,60000,80000,20000,1,00451,India
317847,2023-05-12,504,iron,449,879,430,1,00451,India
317847,2023-05-12,506,monitor,3249,8000,4751,1,00451,India
317847,2023-05-12,503,mixer,1349,3249,1900,1,00451,India
637765,2023-05-12,504,iron,449,879,430,1,00284,India
648400,2023-05-12,502,iphone 15 pro max,100000,135000,35000,1,00487,India
179092,2023-05-12,503,mixer,1349,3249,1900,1,00227,India
179092,2023-05-12,506,monitor,3249,8000,4751,1,00227,India
179092,2023-05-12,501,iphone 15,60000,80000,20000,1,00227,India
892147,2023-05-12,505,oven,18490,24000,5510,1,00332,India
892147,2023-05-12,502,iphone 15 pro max,100000,135000,35000,1,00332,India
728701,2023-05-12,501,iphone 15,60000,80000,20000,1,00394,India
728701,2023-05-12,505,oven,18490,24000,5510,1,00394,India
728701,2023-05-12,506,monitor,3249,8000,4751,1,00394,India
728701,2023-05-12,507,washing machine,6990,16490,9500,1,00394,India
978594,2023-05-12,502,iphone 15 pro max,100000,135000,35000,1,00117,India
978594,2023-05-12,505,oven,18490,24000,5510,1,00117,India
978594,2023-05-12,501,iphone 15,60000,80000,20000,1,00117,India
978594,2023-05-12,506,monitor,3249,8000,4751,1,00117,India
470637,2023-05-12,504,iron,449,879,430,1,00148,India
470637,2023-05-12,501,iphone 15,60000,80000,20000,1,00148,India
470637,2023-05-12,505,oven,18490,24000,5510,1,00148,India
713030,2023-05-12,502,iphone 15 pro max,100000,135000,35000,1,00005,India
713030,2023-05-12,501,iphone 15,60000,80000,20000,1,00005,India
713030,2023-05-12,505,oven,18490,24000,5510,1,00005,India
617635,2023-05-12,501,iphone 15,60000,80000,20000,1,00343,India
830273,2023-05-12,507,washing machine,6990,16490,9500,1,00047,India
830273,2023-05-12,505,oven,18490,24000,5510,1,00047,India
830273,2023-05-12,504,iron,449,879,430,1,00047,India
470541,2023-05-12,504,iron,449,879,430,1,00075,India
470541,2023-05-12,505,oven,18490,24000,5510,1,00075,India
470541,2023-05-12,503,mixer,1349,3249,1900,1,00075,India
994819,2023-05-12,503,mixer,1349,3249,1900,1,00335,India
994819,2023-05-12,502,iphone 15 pro max,100000,135000,35000,1,00335,India
994819,2023-05-12,505,oven,18490,24000,5510,1,00335,India
278239,2023-05-12,507,washing machine,6990,16490,9500,1,00112,India
278239,2023-05-12,502,iphone 15 pro max,100000,135000,35000,1,00112,India
278239,2023-05-12,505,oven,18490,24000,5510,1,00112,India
881964,2023-05-12,503,mixer,1349,3249,1900,1,00087,India
881964,2023-05-12,505,oven,18490,24000,5510,1,00087,India
881964,2023-05-12,502,iphone 15 pro max,100000,135000,35000,1,00087,India
422809,2023-05-12,506,monitor,3249,8000,4751,1,00201,India
298613,2023-05-12,504,iron,449,879,430,1,00116,India
298613,2023-05-12,503,mixer,1349,3249,1900,1,00116,India
298613,2023-05-12,507,washing machine,6990,16490,9500,1,00116,India
298613,2023-05-12,502,iphone 15 pro max,100000,135000,35000,1,00116,India
587315,2023-05-12,507,washing machine,6990,16490,9500,1,00153,India
587315,2023-05-12,506,monitor,3249,8000,4751,1,00153,India
105553,2023-05-12,503,mixer,1349,3249,1900,1,00088,India
105553,2023-05-12,504,iron,449,879,430,1,00088,India
424809,2023-05-12,505,oven,18490,24000,5510,1,00382,India
424809,2023-05-12,501,iphone 15,60000,80000,20000,1,00382,India
424809,2023-05-12,504,iron,449,879,430,1,00382,India
936837,2023-05-12,506,monitor,3249,8000,4751,1,00003,India
936837,2023-05-12,503,mixer,1349,3249,1900,1,00003,India
936837,2023-05-12,505,oven,18490,24000,5510,1,00003,India
175184,2023-05-12,507,washing machine,6990,16490,9500,1,00306,India
175184,2023-05-12,505,oven,18490,24000,5510,1,00306,India
175184,2023-05-12,503,mixer,1349,3249,1900,1,00306,India
944970,2023-05-12,503,mixer,1349,3249,1900,1,00160,India
944970,2023-05-12,504,iron,449,879,430,1,00160,India
944970,2023-05-12,502,iphone 15 pro max,100000,135000,35000,1,00160,India
860963,2023-05-12,505,oven,18490,24000,5510,1,00205,India
860963,2023-05-12,502,iphone 15 pro max,100000,135000,35000,1,00205,India
860963,2023-05-12,507,washing machine,6990,16490,9500,1,00205,India
113078,2023-05-12,503,mixer,1349,3249,1900,1,00256,India
113078,2023-05-12,507,washing machine,6990,16490,9500,1,00256,India
113078,2023-05-12,505,oven,18490,24000,5510,1,00256,India
750999,2023-05-12,501,iphone 15,60000,80000,20000,1,00416,India
750999,2023-05-12,506,monitor,3249,8000,4751,1,00416,India
750999,2023-05-12,504,iron,449,879,430,1,00416,India
203912,2023-05-12,503,mixer,1349,3249,1900,1,00104,India
203912,2023-05-12,502,iphone 15 pro max,100000,135000,35000,1,00104,India
203912,2023-05-12,504,iron,449,879,430,1,00104,India
203912,2023-05-12,505,oven,18490,24000,5510,1,00104,India
907782,2023-05-12,505,oven,18490,24000,5510,1,00362,India
357854,2023-05-12,505,oven,18490,24000,5510,1,00168,India
357854,2023-05-12,507,washing machine,6990,16490,9500,1,00168,India
357854,2023-05-12,502,iphone 15 pro max,100000,135000,35000,1,00168,India
170852,2023-05-12,505,oven,18490,24000,5510,1,00185,India
170852,2023-05-12,504,iron,449,879,430,1,00185,India
170852,2023-05-12,507,washing machine,6990,16490,9500,1,00185,India
170852,2023-05-12,506,monitor,3249,8000,4751,1,00185,India
170852,2023-05-12,502,iphone 15 pro max,100000,135000,35000,1,00185,India
666166,2023-05-12,501,iphone 15,60000,80000,20000,1,00265,India
666166,2023-05-12,502,iphone 15 pro max,100000,135000,35000,1,00265,India
666166,2023-05-12,507,washing machine,6990,16490,9500,1,00265,India
666166,2023-05-12,503,mixer,1349,3249,1900,1,00265,India
709589,2023-05-12,504,iron,449,879,430,1,00324,India
709589,2023-05-12,501,iphone 15,60000,80000,20000,1,00324,India
709589,2023-05-12,506,monitor,3249,8000,4751,1,00324,India
709589,2023-05-12,507,washing machine,6990,16490,9500,1,00324,India
522072,2023-05-12,502,iphone 15 pro max,100000,135000,35000,1,00425,India
323202,2023-05-12,504,iron,449,879,430,1,00143,India
323202,2023-05-12,506,monitor,3249,8000,4751,1,00143,India
753936,2023-05-12,506,monitor,3249,8000,4751,1,00128,India
336149,2023-05-12,503,mixer,1349,3249,1900,1,00236,India
336149,2023-05-12,501,iphone 15,60000,80000,20000,1,00236,India
336149,2023-05-12,502,iphone 15 pro max,100000,135000,35000,1,00236,India
336149,2023-05-12,506,monitor,3249,8000,4751,1,00236,India
462399,2023-05-12,502,iphone 15 pro max,100000,135000,35000,1,00152,India
462399,2023-05-12,505,oven,18490,24000,5510,1,00152,India
826191,2023-05-12,507,washing machine,6990,16490,9500,1,00129,India
976994,2023-05-12,505,oven,18490,24000,5510,1,00354,India
436591,2023-05-12,504,iron,449,879,430,1,00306,India
436591,2023-05-12,501,iphone 15,60000,80000,20000,1,00306,India
436591,2023-05-12,506,monitor,3249,8000,4751,1,00306,India
436591,2023-05-12,502,iphone 15 pro max,100000,135000,35000,1,00306,India
200892,2023-05-12,503,mixer,1349,3249,1900,1,00286,India
200892,2023-05-12,507,washing machine,6990,16490,9500,1,00286,India
344847,2023-05-12,505,oven,18490,24000,5510,1,00102,India
344847,2023-05-12,502,iphone 15 pro max,100000,135000,35000,1,00102,India
225857,2023-05-12,501,iphone 15,60000,80000,20000,1,00028,India
225857,2023-05-12,503,mixer,1349,3249,1900,1,00028,India
225857,2023-05-12,504,iron,449,879,430,1,00028,India
573488,2023-05-12,507,washing machine,6990,16490,9500,1,00088,India
206673,2023-05-12,505,oven,18490,24000,5510,1,00235,India
206673,2023-05-12,502,iphone 15 pro max,100000,135000,35000,1,00235,India
618470,2023-05-12,506,monitor,3249,8000,4751,1,00229,India
618470,2023-05-12,503,mixer,1349,3249,1900,1,00229,India
793681,2023-05-13,507,washing machine,6990,16490,9500,1,00449,India
790408,2023-05-13,501,iphone 15,60000,80000,20000,1,00003,India
790408,2023-05-13,503,mixer,1349,3249,1900,1,00003,India
790408,2023-05-13,505,oven,18490,24000,5510,1,00003,India
790408,2023-05-13,507,washing machine,6990,16490,9500,1,00003,India
323280,2023-05-13,506,monitor,3249,8000,4751,1,00180,India
323280,2023-05-13,501,iphone 15,60000,80000,20000,1,00180,India
323280,2023-05-13,502,iphone 15 pro max,100000,135000,35000,1,00180,India
451972,2023-05-13,506,monitor,3249,8000,4751,1,00150,India
242320,2023-05-13,503,mixer,1349,3249,1900,1,00056,India
242320,2023-05-13,504,iron,449,879,430,1,00056,India
242320,2023-05-13,507,washing machine,6990,16490,9500,1,00056,India
643087,2023-05-13,501,iphone 15,60000,80000,20000,1,00282,India
643087,2023-05-13,506,monitor,3249,8000,4751,1,00282,India
428477,2023-05-13,503,mixer,1349,3249,1900,1,00152,India
428477,2023-05-13,507,washing machine,6990,16490,9500,1,00152,India
428477,2023-05-13,501,iphone 15,60000,80000,20000,1,00152,India
428477,2023-05-13,505,oven,18490,24000,5510,1,00152,India
357903,2023-05-13,502,iphone 15 pro max,100000,135000,35000,1,00063,India
357903,2023-05-13,506,monitor,3249,8000,4751,1,00063,India
357903,2023-05-13,504,iron,449,879,430,1,00063,India
973504,2023-05-13,506,monitor,3249,8000,4751,1,00296,India
973504,2023-05-13,504,iron,449,879,430,1,00296,India
973504,2023-05-13,507,washing machine,6990,16490,9500,1,00296,India
973504,2023-05-13,502,iphone 15 pro max,100000,135000,35000,1,00296,India
531119,2023-05-13,503,mixer,1349,3249,1900,1,00405,India
571546,2023-05-13,507,washing machine,6990,16490,9500,1,00333,India
571546,2023-05-13,501,iphone 15,60000,80000,20000,1,00333,India
571546,2023-05-13,506,monitor,3249,8000,4751,1,00333,India
787440,2023-05-13,501,iphone 15,60000,80000,20000,1,00106,India
787440,2023-05-13,505,oven,18490,24000,5510,1,00106,India
665775,2023-05-13,506,monitor,3249,8000,4751,1,00167,India
665775,2023-05-13,505,oven,18490,24000,5510,1,00167,India
862372,2023-05-13,502,iphone 15 pro max,100000,135000,35000,1,00446,India
862372,2023-05-13,504,iron,449,879,430,1,00446,India
862372,2023-05-13,506,monitor,3249,8000,4751,1,00446,India
763775,2023-05-13,507,washing machine,6990,16490,9500,1,00058,India
763775,2023-05-13,501,iphone 15,60000,80000,20000,1,00058,India
763775,2023-05-13,503,mixer,1349,3249,1900,1,00058,India
436817,2023-05-13,501,iphone 15,60000,80000,20000,1,00072,India
436817,2023-05-13,507,washing machine,6990,16490,9500,1,00072,India
436817,2023-05-13,503,mixer,1349,3249,1900,1,00072,India
436817,2023-05-13,506,monitor,3249,8000,4751,1,00072,India
651411,2023-05-13,507,washing machine,6990,16490,9500,1,00412,India
651411,2023-05-13,506,monitor,3249,8000,4751,1,00412,India
651411,2023-05-13,505,oven,18490,24000,5510,1,00412,India
354086,2023-05-13,505,oven,18490,24000,5510,1,00224,India
354086,2023-05-13,501,iphone 15,60000,80000,20000,1,00224,India
354086,2023-05-13,504,iron,449,879,430,1,00224,India
123704,2023-05-13,502,iphone 15 pro max,100000,135000,35000,1,00488,India
123704,2023-05-13,505,oven,18490,24000,5510,1,00488,India
123704,2023-05-13,501,iphone 15,60000,80000,20000,1,00488,India
123704,2023-05-13,504,iron,449,879,430,1,00488,India
468855,2023-05-13,503,mixer,1349,3249,1900,1,00278,India
468855,2023-05-13,502,iphone 15 pro max,100000,135000,35000,1,00278,India
273439,2023-05-13,505,oven,18490,24000,5510,1,00201,India
273439,2023-05-13,501,iphone 15,60000,80000,20000,1,00201,India
273439,2023-05-13,503,mixer,1349,3249,1900,1,00201,India
325599,2023-05-13,503,mixer,1349,3249,1900,1,00314,India
325599,2023-05-13,502,iphone 15 pro max,100000,135000,35000,1,00314,India
325599,2023-05-13,504,iron,449,879,430,1,00314,India
537480,2023-05-13,505,oven,18490,24000,5510,1,00304,India
537480,2023-05-13,503,mixer,1349,3249,1900,1,00304,India
537480,2023-05-13,506,monitor,3249,8000,4751,1,00304,India
802319,2023-05-13,502,iphone 15 pro max,100000,135000,35000,1,00258,India
717056,2023-05-13,506,monitor,3249,8000,4751,1,00396,India
490520,2023-05-13,507,washing machine,6990,16490,9500,1,00163,India
532505,2023-05-13,506,monitor,3249,8000,4751,1,00345,India
532505,2023-05-13,501,iphone 15,60000,80000,20000,1,00345,India
532505,2023-05-13,504,iron,449,879,430,1,00345,India
532505,2023-05-13,503,mixer,1349,3249,1900,1,00345,India
711911,2023-05-13,501,iphone 15,60000,80000,20000,1,00252,India
711911,2023-05-13,507,washing machine,6990,16490,9500,1,00252,India
711911,2023-05-13,503,mixer,1349,3249,1900,1,00252,India
711911,2023-05-13,502,iphone 15 pro max,100000,135000,35000,1,00252,India
711911,2023-05-13,504,iron,449,879,430,1,00252,India
700734,2023-05-13,502,iphone 15 pro max,100000,135000,35000,1,00473,India
700734,2023-05-13,504,iron,449,879,430,1,00473,India
888939,2023-05-13,505,oven,18490,24000,5510,1,00348,India
888939,2023-05-13,507,washing machine,6990,16490,9500,1,00348,India
888939,2023-05-13,502,iphone 15 pro max,100000,135000,35000,1,00348,India
888939,2023-05-13,506,monitor,3249,8000,4751,1,00348,India
658469,2023-05-13,503,mixer,1349,3249,1900,1,00237,India
658469,2023-05-13,501,iphone 15,60000,80000,20000,1,00237,India
658469,2023-05-13,502,iphone 15 pro max,100000,135000,35000,1,00237,India
815536,2023-05-13,506,monitor,3249,8000,4751,1,00209,India
815536,2023-05-13,501,iphone 15,60000,80000,20000,1,00209,India
815536,2023-05-13,504,iron,449,879,430,1,00209,India
348286,2023-05-13,506,monitor,3249,8000,4751,1,00047,India
348286,2023-05-13,507,washing machine,6990,16490,9500,1,00047,India
348286,2023-05-13,502,iphone 15 pro max,100000,135000,35000,1,00047,India
348286,2023-05-13,503,mixer,1349,3249,1900,1,00047,India
348286,2023-05-13,505,oven,18490,24000,5510,1,00047,India
274927,2023-05-13,501,iphone 15,60000,80000,20000,1,00319,India
274927,2023-05-13,502,iphone 15 pro max,100000,135000,35000,1,00319,India
274927,2023-05-13,506,monitor,3249,8000,4751,1,00319,India
274927,2023-05-13,505,oven,18490,24000,5510,1,00319,India
128566,2023-05-13,507,washing machine,6990,16490,9500,1,00308,India
128566,2023-05-13,501,iphone 15,60000,80000,20000,1,00308,India
922914,2023-05-13,501,iphone 15,60000,80000,20000,1,00308,India
922914,2023-05-13,506,monitor,3249,8000,4751,1,00308,India
760244,2023-05-13,502,iphone 15 pro max,100000,135000,35000,1,00447,India
150722,2023-05-13,506,monitor,3249,8000,4751,1,00451,India
410490,2023-05-13,502,iphone 15 pro max,100000,135000,35000,1,00282,India
697223,2023-05-13,507,washing machine,6990,16490,9500,1,00006,India
697223,2023-05-13,506,monitor,3249,8000,4751,1,00006,India
697223,2023-05-13,504,iron,449,879,430,1,00006,India
697223,2023-05-13,503,mixer,1349,3249,1900,1,00006,India
697223,2023-05-13,502,iphone 15 pro max,100000,135000,35000,1,00006,India
550139,2023-05-13,504,iron,449,879,430,1,00061,India
550139,2023-05-13,505,oven,18490,24000,5510,1,00061,India
550139,2023-05-13,507,washing machine,6990,16490,9500,1,00061,India
573653,2023-05-13,507,washing machine,6990,16490,9500,1,00341,India
573653,2023-05-13,503,mixer,1349,3249,1900,1,00341,India
573653,2023-05-13,502,iphone 15 pro max,100000,135000,35000,1,00341,India
573653,2023-05-13,504,iron,449,879,430,1,00341,India
830918,2023-05-13,504,iron,449,879,430,1,00413,India
830918,2023-05-13,501,iphone 15,60000,80000,20000,1,00413,India
619458,2023-05-13,501,iphone 15,60000,80000,20000,1,00202,India
619458,2023-05-13,502,iphone 15 pro max,100000,135000,35000,1,00202,India
619458,2023-05-13,506,monitor,3249,8000,4751,1,00202,India
619458,2023-05-13,503,mixer,1349,3249,1900,1,00202,India
809523,2023-05-13,505,oven,18490,24000,5510,1,00331,India
809523,2023-05-13,503,mixer,1349,3249,1900,1,00331,India
809523,2023-05-13,502,iphone 15 pro max,100000,135000,35000,1,00331,India
729802,2023-05-13,505,oven,18490,24000,5510,1,00057,India
729802,2023-05-13,503,mixer,1349,3249,1900,1,00057,India
729802,2023-05-13,507,washing machine,6990,16490,9500,1,00057,India
241652,2023-05-13,502,iphone 15 pro max,100000,135000,35000,1,00028,India
241652,2023-05-13,504,iron,449,879,430,1,00028,India
182104,2023-05-13,505,oven,18490,24000,5510,1,00111,India
182104,2023-05-13,503,mixer,1349,3249,1900,1,00111,India
931003,2023-05-13,501,iphone 15,60000,80000,20000,1,00434,India
931003,2023-05-13,502,iphone 15 pro max,100000,135000,35000,1,00434,India
931003,2023-05-13,504,iron,449,879,430,1,00434,India
807056,2023-05-13,503,mixer,1349,3249,1900,1,00086,India
807056,2023-05-13,507,washing machine,6990,16490,9500,1,00086,India
807056,2023-05-13,506,monitor,3249,8000,4751,1,00086,India
807056,2023-05-13,502,iphone 15 pro max,100000,135000,35000,1,00086,India
366700,2023-05-13,506,monitor,3249,8000,4751,1,00026,India
366700,2023-05-13,505,oven,18490,24000,5510,1,00026,India
521816,2023-05-13,506,monitor,3249,8000,4751,1,00461,India
521816,2023-05-13,501,iphone 15,60000,80000,20000,1,00461,India
521816,2023-05-13,505,oven,18490,24000,5510,1,00461,India
348856,2023-05-13,506,monitor,3249,8000,4751,1,00184,India
806535,2023-05-13,506,monitor,3249,8000,4751,1,00358,India
147038,2023-05-13,505,oven,18490,24000,5510,1,00052,India
147038,2023-05-13,506,monitor,3249,8000,4751,1,00052,India
147038,2023-05-13,504,iron,449,879,430,1,00052,India
147038,2023-05-13,503,mixer,1349,3249,1900,1,00052,India
483634,2023-05-13,503,mixer,1349,3249,1900,1,00039,India
320850,2023-05-13,507,washing machine,6990,16490,9500,1,00094,India
577899,2023-05-13,507,washing machine,6990,16490,9500,1,00292,India
577899,2023-05-13,503,mixer,1349,3249,1900,1,00292,India
169846,2023-05-13,502,iphone 15 pro max,100000,135000,35000,1,00122,India
169846,2023-05-13,504,iron,449,879,430,1,00122,India
238498,2023-05-13,505,oven,18490,24000,5510,1,00063,India
238498,2023-05-13,501,iphone 15,60000,80000,20000,1,00063,India
238498,2023-05-13,506,monitor,3249,8000,4751,1,00063,India
238498,2023-05-13,504,iron,449,879,430,1,00063,India
901363,2023-05-13,504,iron,449,879,430,1,00408,India
901363,2023-05-13,506,monitor,3249,8000,4751,1,00408,India
593017,2023-05-13,501,iphone 15,60000,80000,20000,1,00287,India
593017,2023-05-13,505,oven,18490,24000,5510,1,00287,India
465752,2023-05-13,502,iphone 15 pro max,100000,135000,35000,1,00434,India
465752,2023-05-13,505,oven,18490,24000,5510,1,00434,India
286541,2023-05-13,506,monitor,3249,8000,4751,1,00149,India
286541,2023-05-13,507,washing machine,6990,16490,9500,1,00149,India
286541,2023-05-13,504,iron,449,879,430,1,00149,India
686820,2023-05-13,501,iphone 15,60000,80000,20000,1,00105,India
686820,2023-05-13,506,monitor,3249,8000,4751,1,00105,India
686820,2023-05-13,502,iphone 15 pro max,100000,135000,35000,1,00105,India
686820,2023-05-13,503,mixer,1349,3249,1900,1,00105,India
747136,2023-05-13,504,iron,449,879,430,1,00266,India
747136,2023-05-13,502,iphone 15 pro max,100000,135000,35000,1,00266,India
547790,2023-05-13,501,iphone 15,60000,80000,20000,1,00308,India
547790,2023-05-13,505,oven,18490,24000,5510,1,00308,India
547790,2023-05-13,503,mixer,1349,3249,1900,1,00308,India
668614,2023-05-13,507,washing machine,6990,16490,9500,1,00369,India
405160,2023-05-13,507,washing machine,6990,16490,9500,1,00200,India
405160,2023-05-13,501,iphone 15,60000,80000,20000,1,00200,India
276528,2023-05-13,506,monitor,3249,8000,4751,1,00258,India
276528,2023-05-13,502,iphone 15 pro max,100000,135000,35000,1,00258,India
276528,2023-05-13,503,mixer,1349,3249,1900,1,00258,India
963110,2023-05-13,506,monitor,3249,8000,4751,1,00438,India
776330,2023-05-13,503,mixer,1349,3249,1900,1,00089,India
776330,2023-05-13,505,oven,18490,24000,5510,1,00089,India
776330,2023-05-13,506,monitor,3249,8000,4751,1,00089,India
776330,2023-05-13,501,iphone 15,60000,80000,20000,1,00089,India
950690,2023-05-13,502,iphone 15 pro max,100000,135000,35000,1,00046,India
851963,2023-05-13,505,oven,18490,24000,5510,1,00022,India
851963,2023-05-13,502,iphone 15 pro max,100000,135000,35000,1,00022,India
851963,2023-05-13,507,washing machine,6990,16490,9500,1,00022,India
851963,2023-05-13,503,mixer,1349,3249,1900,1,00022,India
254447,2023-05-13,504,iron,449,879,430,1,00325,India
254447,2023-05-13,506,monitor,3249,8000,4751,1,00325,India
312383,2023-05-13,502,iphone 15 pro max,100000,135000,35000,1,00067,India
312383,2023-05-13,503,mixer,1349,3249,1900,1,00067,India
312383,2023-05-13,507,washing machine,6990,16490,9500,1,00067,India
967858,2023-05-13,506,monitor,3249,8000,4751,1,00332,India
967858,2023-05-13,504,iron,449,879,430,1,00332,India
967858,2023-05-13,502,iphone 15 pro max,100000,135000,35000,1,00332,India
922452,2023-05-14,506,monitor,3249,8000,4751,1,00233,India
922452,2023-05-14,502,iphone 15 pro max,100000,135000,35000,1,00233,India
294966,2023-05-14,504,iron,449,879,430,1,00144,India
294966,2023-05-14,507,washing machine,6990,16490,9500,1,00144,India
653156,2023-05-14,502,iphone 15 pro max,100000,135000,35000,1,00376,India
642616,2023-05-14,505,oven,18490,24000,5510,1,00023,India
505038,2023-05-14,502,iphone 15 pro max,100000,135000,35000,1,00201,India
505038,2023-05-14,507,washing machine,6990,16490,9500,1,00201,India
505038,2023-05-14,501,iphone 15,60000,80000,20000,1,00201,India
505038,2023-05-14,504,iron,449,879,430,1,00201,India
987940,2023-05-14,503,mixer,1349,3249,1900,1,00048,India
987940,2023-05-14,506,monitor,3249,8000,4751,1,00048,India
987940,2023-05-14,505,oven,18490,24000,5510,1,00048,India
987940,2023-05-14,502,iphone 15 pro max,100000,135000,35000,1,00048,India
543474,2023-05-14,503,mixer,1349,3249,1900,1,00206,India
543474,2023-05-14,502,iphone 15 pro max,100000,135000,35000,1,00206,India
558066,2023-05-14,501,iphone 15,60000,80000,20000,1,00017,India
620556,2023-05-14,507,washing machine,6990,16490,9500,1,00444,India
620556,2023-05-14,506,monitor,3249,8000,4751,1,00444,India
620556,2023-05-14,504,iron,449,879,430,1,00444,India
101174,2023-05-14,507,washing machine,6990,16490,9500,1,00427,India
101174,2023-05-14,504,iron,449,879,430,1,00427,India
101174,2023-05-14,503,mixer,1349,3249,1900,1,00427,India
667554,2023-05-14,502,iphone 15 pro max,100000,135000,35000,1,00489,India
983125,2023-05-14,506,monitor,3249,8000,4751,1,00231,India
983125,2023-05-14,504,iron,449,879,430,1,00231,India
983125,2023-05-14,503,mixer,1349,3249,1900,1,00231,India
662698,2023-05-14,503,mixer,1349,3249,1900,1,00068,India
332628,2023-05-14,507,washing machine,6990,16490,9500,1,00174,India
332628,2023-05-14,505,oven,18490,24000,5510,1,00174,India
765798,2023-05-14,502,iphone 15 pro max,100000,135000,35000,1,00018,India
546276,2023-05-14,507,washing machine,6990,16490,9500,1,00379,India
546276,2023-05-14,504,iron,449,879,430,1,00379,India
538188,2023-05-14,502,iphone 15 pro max,100000,135000,35000,1,00153,India
538188,2023-05-14,501,iphone 15,60000,80000,20000,1,00153,India
538188,2023-05-14,507,washing machine,6990,16490,9500,1,00153,India
471265,2023-05-14,502,iphone 15 pro max,100000,135000,35000,1,00101,India
768062,2023-05-14,503,mixer,1349,3249,1900,1,00426,India
768062,2023-05-14,504,iron,449,879,430,1,00426,India
768062,2023-05-14,501,iphone 15,60000,80000,20000,1,00426,India
468238,2023-05-14,507,washing machine,6990,16490,9500,1,00043,India
468238,2023-05-14,504,iron,449,879,430,1,00043,India
468238,2023-05-14,502,iphone 15 pro max,100000,135000,35000,1,00043,India
830773,2023-05-14,502,iphone 15 pro max,100000,135000,35000,1,00024,India
830773,2023-05-14,503,mixer,1349,3249,1900,1,00024,India
596354,2023-05-14,501,iphone 15,60000,80000,20000,1,00122,India
596354,2023-05-14,507,washing machine,6990,16490,9500,1,00122,India
596354,2023-05-14,502,iphone 15 pro max,100000,135000,35000,1,00122,India
138126,2023-05-14,504,iron,449,879,430,1,00016,India
138126,2023-05-14,507,washing machine,6990,16490,9500,1,00016,India
138126,2023-05-14,502,iphone 15 pro max,100000,135000,35000,1,00016,India
146138,2023-05-14,502,iphone 15 pro max,100000,135000,35000,1,00307,India
146138,2023-05-14,501,iphone 15,60000,80000,20000,1,00307,India
404622,2023-05-14,504,iron,449,879,430,1,00053,India
404622,2023-05-14,501,iphone 15,60000,80000,20000,1,00053,India
864009,2023-05-14,507,washing machine,6990,16490,9500,1,00323,India
864009,2023-05-14,501,iphone 15,60000,80000,20000,1,00323,India
864009,2023-05-14,505,oven,18490,24000,5510,1,00323,India
864009,2023-05-14,506,monitor,3249,8000,4751,1,00323,India
881911,2023-05-14,501,iphone 15,60000,80000,20000,1,00087,India
881911,2023-05-14,504,iron,449,879,430,1,00087,India
881911,2023-05-14,502,iphone 15 pro max,100000,135000,35000,1,00087,India
850866,2023-05-14,505,oven,18490,24000,5510,1,00306,India
375747,2023-05-14,502,iphone 15 pro max,100000,135000,35000,1,00102,India
375747,2023-05-14,505,oven,18490,24000,5510,1,00102,India
902987,2023-05-14,503,mixer,1349,3249,1900,1,00441,India
902987,2023-05-14,504,iron,449,879,430,1,00441,India
902987,2023-05-14,506,monitor,3249,8000,4751,1,00441,India
425798,2023-05-14,505,oven,18490,24000,5510,1,00233,India
425798,2023-05-14,506,monitor,3249,8000,4751,1,00233,India
425798,2023-05-14,507,washing machine,6990,16490,9500,1,00233,India
871937,2023-05-14,506,monitor,3249,8000,4751,1,00126,India
871937,2023-05-14,503,mixer,1349,3249,1900,1,00126,India
871937,2023-05-14,507,washing machine,6990,16490,9500,1,00126,India
871937,2023-05-14,504,iron,449,879,430,1,00126,India
561944,2023-05-14,503,mixer,1349,3249,1900,1,00113,India
561944,2023-05-14,502,iphone 15 pro max,100000,135000,35000,1,00113,India
561944,2023-05-14,501,iphone 15,60000,80000,20000,1,00113,India
561944,2023-05-14,506,monitor,3249,8000,4751,1,00113,India
561944,2023-05-14,504,iron,449,879,430,1,00113,India
687924,2023-05-14,502,iphone 15 pro max,100000,135000,35000,1,00255,India
239533,2023-05-14,505,oven,18490,24000,5510,1,00236,India
239533,2023-05-14,501,iphone 15,60000,80000,20000,1,00236,India
239533,2023-05-14,507,washing machine,6990,16490,9500,1,00236,India
239533,2023-05-14,502,iphone 15 pro max,100000,135000,35000,1,00236,India
325928,2023-05-14,504,iron,449,879,430,1,00026,India
325928,2023-05-14,502,iphone 15 pro max,100000,135000,35000,1,00026,India
325928,2023-05-14,501,iphone 15,60000,80000,20000,1,00026,India
325928,2023-05-14,505,oven,18490,24000,5510,1,00026,India
613424,2023-05-14,506,monitor,3249,8000,4751,1,00279,India
559030,2023-05-14,506,monitor,3249,8000,4751,1,00114,India
559030,2023-05-14,502,iphone 15 pro max,100000,135000,35000,1,00114,India
559030,2023-05-14,504,iron,449,879,430,1,00114,India
470950,2023-05-14,502,iphone 15 pro max,100000,135000,35000,1,00091,India
518052,2023-05-14,504,iron,449,879,430,1,00391,India
892865,2023-05-14,507,washing machine,6990,16490,9500,1,00431,India
892865,2023-05-14,505,oven,18490,24000,5510,1,00431,India
892865,2023-05-14,501,iphone 15,60000,80000,20000,1,00431,India
892865,2023-05-14,502,iphone 15 pro max,100000,135000,35000,1,00431,India
892865,2023-05-14,506,monitor,3249,8000,4751,1,00431,India
424149,2023-05-14,502,iphone 15 pro max,100000,135000,35000,1,00305,India
424149,2023-05-14,503,mixer,1349,3249,1900,1,00305,India
424149,2023-05-14,504,iron,449,879,430,1,00305,India
424149,2023-05-14,501,iphone 15,60000,80000,20000,1,00305,India
424149,2023-05-14,506,monitor,3249,8000,4751,1,00305,India
311995,2023-05-14,506,monitor,3249,8000,4751,1,00302,India
311995,2023-05-14,501,iphone 15,60000,80000,20000,1,00302,India
311995,2023-05-14,504,iron,449,879,430,1,00302,India
342991,2023-05-14,507,washing machine,6990,16490,9500,1,00191,India
342991,2023-05-14,506,monitor,3249,8000,4751,1,00191,India
342991,2023-05-14,503,mixer,1349,3249,1900,1,00191,India
342991,2023-05-14,505,oven,18490,24000,5510,1,00191,India
325184,2023-05-14,505,oven,18490,24000,5510,1,00211,India
325184,2023-05-14,507,washing machine,6990,16490,9500,1,00211,India
325184,2023-05-14,503,mixer,1349,3249,1900,1,00211,India
325184,2023-05-14,502,iphone 15 pro max,100000,135000,35000,1,00211,India
325184,2023-05-14,501,iphone 15,60000,80000,20000,1,00211,India
114314,2023-05-14,506,monitor,3249,8000,4751,1,00469,India
114314,2023-05-14,503,mixer,1349,3249,1900,1,00469,India
693930,2023-05-14,501,iphone 15,60000,80000,20000,1,00268,India
693930,2023-05-14,507,washing machine,6990,16490,9500,1,00268,India
693930,2023-05-14,506,monitor,3249,8000,4751,1,00268,India
693930,2023-05-14,505,oven,18490,24000,5510,1,00268,India
409396,2023-05-14,502,iphone 15 pro max,100000,135000,35000,1,00024,India
409396,2023-05-14,507,washing machine,6990,16490,9500,1,00024,India
686108,2023-05-14,506,monitor,3249,8000,4751,1,00497,India
445486,2023-05-14,503,mixer,1349,3249,1900,1,00050,India
224772,2023-05-14,502,iphone 15 pro max,100000,135000,35000,1,00405,India
224772,2023-05-14,504,iron,449,879,430,1,00405,India
224772,2023-05-14,505,oven,18490,24000,5510,1,00405,India
965923,2023-05-14,506,monitor,3249,8000,4751,1,00176,India
596337,2023-05-14,504,iron,449,879,430,1,00454,India
345240,2023-05-14,507,washing machine,6990,16490,9500,1,00408,India
444131,2023-05-14,504,iron,449,879,430,1,00099,India
444131,2023-05-14,501,iphone 15,60000,80000,20000,1,00099,India
444131,2023-05-14,507,washing machine,6990,16490,9500,1,00099,India
162763,2023-05-14,504,iron,449,879,430,1,00496,India
162763,2023-05-14,505,oven,18490,24000,5510,1,00496,India
162763,2023-05-14,507,washing machine,6990,16490,9500,1,00496,India
162763,2023-05-14,502,iphone 15 pro max,100000,135000,35000,1,00496,India
396365,2023-05-14,503,mixer,1349,3249,1900,1,00351,India
396365,2023-05-14,501,iphone 15,60000,80000,20000,1,00351,India
824545,2023-05-14,507,washing machine,6990,16490,9500,1,00162,India
824545,2023-05-14,501,iphone 15,60000,80000,20000,1,00162,India
824545,2023-05-14,506,monitor,3249,8000,4751,1,00162,India
261747,2023-05-14,503,mixer,1349,3249,1900,1,00396,India
261747,2023-05-14,502,iphone 15 pro max,100000,135000,35000,1,00396,India
261747,2023-05-14,501,iphone 15,60000,80000,20000,1,00396,India
261747,2023-05-14,504,iron,449,879,430,1,00396,India
865749,2023-05-14,502,iphone 15 pro max,100000,135000,35000,1,00375,India
865749,2023-05-14,507,washing machine,6990,16490,9500,1,00375,India
865749,2023-05-14,501,iphone 15,60000,80000,20000,1,00375,India
454102,2023-05-14,506,monitor,3249,8000,4751,1,00304,India
454102,2023-05-14,503,mixer,1349,3249,1900,1,00304,India
454102,2023-05-14,505,oven,18490,24000,5510,1,00304,India
771892,2023-05-14,501,iphone 15,60000,80000,20000,1,00307,India
771892,2023-05-14,505,oven,18490,24000,5510,1,00307,India
923912,2023-05-14,505,oven,18490,24000,5510,1,00362,India
923912,2023-05-14,507,washing machine,6990,16490,9500,1,00362,India
923912,2023-05-14,502,iphone 15 pro max,100000,135000,35000,1,00362,India
923912,2023-05-14,506,monitor,3249,8000,4751,1,00362,India
842568,2023-05-14,507,washing machine,6990,16490,9500,1,00069,India
644683,2023-05-14,504,iron,449,879,430,1,00186,India
831832,2023-05-14,504,iron,449,879,430,1,00041,India
831832,2023-05-14,507,washing machine,6990,16490,9500,1,00041,India
670022,2023-05-14,504,iron,449,879,430,1,00472,India
670022,2023-05-14,507,washing machine,6990,16490,9500,1,00472,India
164600,2023-05-14,501,iphone 15,60000,80000,20000,1,00453,India
164600,2023-05-14,502,iphone 15 pro max,100000,135000,35000,1,00453,India
164600,2023-05-14,507,washing machine,6990,16490,9500,1,00453,India
953089,2023-05-14,501,iphone 15,60000,80000,20000,1,00461,India
953089,2023-05-14,507,washing machine,6990,16490,9500,1,00461,India
953089,2023-05-14,504,iron,449,879,430,1,00461,India
953089,2023-05-14,502,iphone 15 pro max,100000,135000,35000,1,00461,India
761151,2023-05-14,507,washing machine,6990,16490,9500,1,00060,India
761151,2023-05-14,504,iron,449,879,430,1,00060,India
761151,2023-05-14,501,iphone 15,60000,80000,20000,1,00060,India
761151,2023-05-14,502,iphone 15 pro max,100000,135000,35000,1,00060,India
137283,2023-05-14,504,iron,449,879,430,1,00090,India
137283,2023-05-14,506,monitor,3249,8000,4751,1,00090,India
510044,2023-05-14,502,iphone 15 pro max,100000,135000,35000,1,00012,India
981536,2023-05-14,505,oven,18490,24000,5510,1,00173,India
981536,2023-05-14,506,monitor,3249,8000,4751,1,00173,India
981536,2023-05-14,502,iphone 15 pro max,100000,135000,35000,1,00173,India
981536,2023-05-14,503,mixer,1349,3249,1900,1,00173,India
786798,2023-05-14,507,washing machine,6990,16490,9500,1,00013,India
786798,2023-05-14,505,oven,18490,24000,5510,1,00013,India
786798,2023-05-14,503,mixer,1349,3249,1900,1,00013,India
919894,2023-05-14,506,monitor,3249,8000,4751,1,00411,India
618556,2023-05-14,506,monitor,3249,8000,4751,1,00391,India
618556,2023-05-14,503,mixer,1349,3249,1900,1,00391,India
618556,2023-05-14,507,washing machine,6990,16490,9500,1,00391,India
176058,2023-05-14,505,oven,18490,24000,5510,1,00028,India
176058,2023-05-14,502,iphone 15 pro max,100000,135000,35000,1,00028,India
533258,2023-05-15,505,oven,18490,24000,5510,1,00286,India
533258,2023-05-15,504,iron,449,879,430,1,00286,India
533258,2023-05-15,503,mixer,1349,3249,1900,1,00286,India
108097,2023-05-15,502,iphone 15 pro max,100000,135000,35000,1,00347,India
108097,2023-05-15,506,monitor,3249,8000,4751,1,00347,India
108097,2023-05-15,503,mixer,1349,3249,1900,1,00347,India
818756,2023-05-15,507,washing machine,6990,16490,9500,1,00351,India
818756,2023-05-15,501,iphone 15,60000,80000,20000,1,00351,India
818756,2023-05-15,502,iphone 15 pro max,100000,135000,35000,1,00351,India
510801,2023-05-15,507,washing machine,6990,16490,9500,1,00273,India
510801,2023-05-15,504,iron,449,879,430,1,00273,India
196442,2023-05-15,505,oven,18490,24000,5510,1,00120,India
196442,2023-05-15,506,monitor,3249,8000,4751,1,00120,India
917017,2023-05-15,502,iphone 15 pro max,100000,135000,35000,1,00168,India
917017,2023-05-15,506,monitor,3249,8000,4751,1,00168,India
917017,2023-05-15,507,washing machine,6990,16490,9500,1,00168,India
917017,2023-05-15,503,mixer,1349,3249,1900,1,00168,India
404801,2023-05-15,503,mixer,1349,3249,1900,1,00051,India
404801,2023-05-15,504,iron,449,879,430,1,00051,India
404801,2023-05-15,505,oven,18490,24000,5510,1,00051,India
527530,2023-05-15,503,mixer,1349,3249,1900,1,00399,India
527530,2023-05-15,502,iphone 15 pro max,100000,135000,35000,1,00399,India
893278,2023-05-15,505,oven,18490,24000,5510,1,00222,India
893278,2023-05-15,506,monitor,3249,8000,4751,1,00222,India
494168,2023-05-15,504,iron,449,879,430,1,00048,India
977890,2023-05-15,505,oven,18490,24000,5510,1,00141,India
977890,2023-05-15,506,monitor,3249,8000,4751,1,00141,India
977890,2023-05-15,507,washing machine,6990,16490,9500,1,00141,India
576259,2023-05-15,506,monitor,3249,8000,4751,1,00243,India
366053,2023-05-15,503,mixer,1349,3249,1900,1,00010,India
681171,2023-05-15,502,iphone 15 pro max,100000,135000,35000,1,00396,India
104434,2023-05-15,502,iphone 15 pro max,100000,135000,35000,1,00014,India
870791,2023-05-15,506,monitor,3249,8000,4751,1,00449,India
870791,2023-05-15,507,washing machine,6990,16490,9500,1,00449,India
825722,2023-05-15,502,iphone 15 pro max,100000,135000,35000,1,00204,India
801397,2023-05-15,502,iphone 15 pro max,100000,135000,35000,1,00319,India
801397,2023-05-15,504,iron,449,879,430,1,00319,India
303570,2023-05-15,504,iron,449,879,430,1,00403,India
303570,2023-05-15,503,mixer,1349,3249,1900,1,00403,India
303570,2023-05-15,506,monitor,3249,8000,4751,1,00403,India
303570,2023-05-15,501,iphone 15,60000,80000,20000,1,00403,India
879391,2023-05-15,502,iphone 15 pro max,100000,135000,35000,1,00493,India
646372,2023-05-15,506,monitor,3249,8000,4751,1,00441,India
646372,2023-05-15,501,iphone 15,60000,80000,20000,1,00441,India
186995,2023-05-15,506,monitor,3249,8000,4751,1,00271,India
186995,2023-05-15,507,washing machine,6990,16490,9500,1,00271,India
489637,2023-05-15,505,oven,18490,24000,5510,1,00390,India
945762,2023-05-15,503,mixer,1349,3249,1900,1,00435,India
306366,2023-05-15,504,iron,449,879,430,1,00028,India
243908,2023-05-15,501,iphone 15,60000,80000,20000,1,00131,India
243908,2023-05-15,502,iphone 15 pro max,100000,135000,35000,1,00131,India
243908,2023-05-15,503,mixer,1349,3249,1900,1,00131,India
919154,2023-05-15,506,monitor,3249,8000,4751,1,00311,India
919154,2023-05-15,502,iphone 15 pro max,100000,135000,35000,1,00311,India
919154,2023-05-15,504,iron,449,879,430,1,00311,India
579713,2023-05-15,507,washing machine,6990,16490,9500,1,00083,India
579713,2023-05-15,506,monitor,3249,8000,4751,1,00083,India
579713,2023-05-15,504,iron,449,879,430,1,00083,India
352799,2023-05-15,507,washing machine,6990,16490,9500,1,00286,India
260157,2023-05-15,506,monitor,3249,8000,4751,1,00199,India
260157,2023-05-15,505,oven,18490,24000,5510,1,00199,India
493114,2023-05-15,506,monitor,3249,8000,4751,1,00457,India
493114,2023-05-15,504,iron,449,879,430,1,00457,India
579441,2023-05-15,504,iron,449,879,430,1,00271,India
579441,2023-05-15,501,iphone 15,60000,80000,20000,1,00271,India
250816,2023-05-15,502,iphone 15 pro max,100000,135000,35000,1,00043,India
250816,2023-05-15,506,monitor,3249,8000,4751,1,00043,India
571583,2023-05-15,501,iphone 15,60000,80000,20000,1,00126,India
316480,2023-05-15,506,monitor,3249,8000,4751,1,00342,India
846013,2023-05-15,504,iron,449,879,430,1,00455,India
974067,2023-05-15,507,washing machine,6990,16490,9500,1,00174,India
974067,2023-05-15,501,iphone 15,60000,80000,20000,1,00174,India
652149,2023-05-15,507,washing machine,6990,16490,9500,1,00442,India
110488,2023-05-15,501,iphone 15,60000,80000,20000,1,00199,India
785887,2023-05-15,505,oven,18490,24000,5510,1,00420,India
785887,2023-05-15,507,washing machine,6990,16490,9500,1,00420,India
785887,2023-05-15,503,mixer,1349,3249,1900,1,00420,India
130061,2023-05-15,502,iphone 15 pro max,100000,135000,35000,1,00119,India
130061,2023-05-15,503,mixer,1349,3249,1900,1,00119,India
645014,2023-05-15,504,iron,449,879,430,1,00142,India
893931,2023-05-15,504,iron,449,879,430,1,00362,India
893931,2023-05-15,505,oven,18490,24000,5510,1,00362,India
893931,2023-05-15,506,monitor,3249,8000,4751,1,00362,India
893931,2023-05-15,501,iphone 15,60000,80000,20000,1,00362,India
137378,2023-05-15,504,iron,449,879,430,1,00001,India
137378,2023-05-15,502,iphone 15 pro max,100000,135000,35000,1,00001,India
137378,2023-05-15,503,mixer,1349,3249,1900,1,00001,India
137378,2023-05-15,507,washing machine,6990,16490,9500,1,00001,India
819343,2023-05-15,501,iphone 15,60000,80000,20000,1,00186,India
819343,2023-05-15,504,iron,449,879,430,1,00186,India
810854,2023-05-15,506,monitor,3249,8000,4751,1,00439,India
810854,2023-05-15,507,washing machine,6990,16490,9500,1,00439,India
810854,2023-05-15,505,oven,18490,24000,5510,1,00439,India
809164,2023-05-15,503,mixer,1349,3249,1900,1,00443,India
809164,2023-05-15,501,iphone 15,60000,80000,20000,1,00443,India
809164,2023-05-15,502,iphone 15 pro max,100000,135000,35000,1,00443,India
809164,2023-05-15,506,monitor,3249,8000,4751,1,00443,India
809164,2023-05-15,504,iron,449,879,430,1,00443,India
756515,2023-05-15,502,iphone 15 pro max,100000,135000,35000,1,00160,India
756515,2023-05-15,505,oven,18490,24000,5510,1,00160,India
262442,2023-05-15,501,iphone 15,60000,80000,20000,1,00062,India
262442,2023-05-15,502,iphone 15 pro max,100000,135000,35000,1,00062,India
262442,2023-05-15,507,washing machine,6990,16490,9500,1,00062,India
995297,2023-05-15,503,mixer,1349,3249,1900,1,00463,India
995297,2023-05-15,506,monitor,3249,8000,4751,1,00463,India
995297,2023-05-15,504,iron,449,879,430,1,00463,India
995297,2023-05-15,502,iphone 15 pro max,100000,135000,35000,1,00463,India
104504,2023-05-15,507,washing machine,6990,16490,9500,1,00477,India
307491,2023-05-15,503,mixer,1349,3249,1900,1,00119,India
440812,2023-05-15,505,oven,18490,24000,5510,1,00180,India
492518,2023-05-15,503,mixer,1349,3249,1900,1,00458,India
492518,2023-05-15,506,monitor,3249,8000,4751,1,00458,India
492518,2023-05-15,507,washing machine,6990,16490,9500,1,00458,India
492518,2023-05-15,505,oven,18490,24000,5510,1,00458,India
429272,2023-05-15,504,iron,449,879,430,1,00431,India
429272,2023-05-15,502,iphone 15 pro max,100000,135000,35000,1,00431,India
429272,2023-05-15,506,monitor,3249,8000,4751,1,00431,India
834979,2023-05-15,504,iron,449,879,430,1,00053,India
475104,2023-05-15,507,washing machine,6990,16490,9500,1,00275,India
475104,2023-05-15,501,iphone 15,60000,80000,20000,1,00275,India
475104,2023-05-15,505,oven,18490,24000,5510,1,00275,India
694678,2023-05-15,505,oven,18490,24000,5510,1,00322,India
694678,2023-05-15,502,iphone 15 pro max,100000,135000,35000,1,00322,India
694678,2023-05-15,506,monitor,3249,8000,4751,1,00322,India
694678,2023-05-15,501,iphone 15,60000,80000,20000,1,00322,India
406125,2023-05-15,501,iphone 15,60000,80000,20000,1,00148,India
406125,2023-05-15,502,iphone 15 pro max,100000,135000,35000,1,00148,India
470270,2023-05-15,502,iphone 15 pro max,100000,135000,35000,1,00096,India
470270,2023-05-15,501,iphone 15,60000,80000,20000,1,00096,India
470270,2023-05-15,503,mixer,1349,3249,1900,1,00096,India
992802,2023-05-15,506,monitor,3249,8000,4751,1,00085,India
992802,2023-05-15,504,iron,449,879,430,1,00085,India
225449,2023-05-15,506,monitor,3249,8000,4751,1,00009,India
225449,2023-05-15,505,oven,18490,24000,5510,1,00009,India
225449,2023-05-15,507,washing machine,6990,16490,9500,1,00009,India
225449,2023-05-15,502,iphone 15 pro max,100000,135000,35000,1,00009,India
347702,2023-05-15,504,iron,449,879,430,1,00260,India
347702,2023-05-15,507,washing machine,6990,16490,9500,1,00260,India
312723,2023-05-15,501,iphone 15,60000,80000,20000,1,00147,India
312723,2023-05-15,505,oven,18490,24000,5510,1,00147,India
816599,2023-05-15,506,monitor,3249,8000,4751,1,00338,India
771611,2023-05-15,507,washing machine,6990,16490,9500,1,00355,India
771611,2023-05-15,503,mixer,1349,3249,1900,1,00355,India
256472,2023-05-15,505,oven,18490,24000,5510,1,00150,India
256472,2023-05-15,502,iphone 15 pro max,100000,135000,35000,1,00150,India
256472,2023-05-15,506,monitor,3249,8000,4751,1,00150,India
752361,2023-05-15,504,iron,449,879,430,1,00089,India
752361,2023-05-15,501,iphone 15,60000,80000,20000,1,00089,India
900476,2023-05-15,501,iphone 15,60000,80000,20000,1,00484,India
900476,2023-05-15,502,iphone 15 pro max,100000,135000,35000,1,00484,India
900476,2023-05-15,505,oven,18490,24000,5510,1,00484,India
182537,2023-05-15,501,iphone 15,60000,80000,20000,1,00330,India
182537,2023-05-15,505,oven,18490,24000,5510,1,00330,India
182537,2023-05-15,503,mixer,1349,3249,1900,1,00330,India
182537,2023-05-15,502,iphone 15 pro max,100000,135000,35000,1,00330,India
282971,2023-05-16,507,washing machine,6990,16490,9500,1,00145,India
282971,2023-05-16,504,iron,449,879,430,1,00145,India
282971,2023-05-16,503,mixer,1349,3249,1900,1,00145,India
441473,2023-05-16,505,oven,18490,24000,5510,1,00469,India
959910,2023-05-16,501,iphone 15,60000,80000,20000,1,00056,India
959910,2023-05-16,506,monitor,3249,8000,4751,1,00056,India
959910,2023-05-16,503,mixer,1349,3249,1900,1,00056,India
479228,2023-05-16,506,monitor,3249,8000,4751,1,00344,India
479228,2023-05-16,503,mixer,1349,3249,1900,1,00344,India
479228,2023-05-16,504,iron,449,879,430,1,00344,India
479228,2023-05-16,507,washing machine,6990,16490,9500,1,00344,India
204249,2023-05-16,504,iron,449,879,430,1,00212,India
204249,2023-05-16,502,iphone 15 pro max,100000,135000,35000,1,00212,India
204249,2023-05-16,506,monitor,3249,8000,4751,1,00212,India
839280,2023-05-16,502,iphone 15 pro max,100000,135000,35000,1,00049,India
971171,2023-05-16,503,mixer,1349,3249,1900,1,00144,India
236352,2023-05-16,502,iphone 15 pro max,100000,135000,35000,1,00084,India
236352,2023-05-16,505,oven,18490,24000,5510,1,00084,India
749825,2023-05-16,502,iphone 15 pro max,100000,135000,35000,1,00142,India
599058,2023-05-16,502,iphone 15 pro max,100000,135000,35000,1,00152,India
599058,2023-05-16,507,washing machine,6990,16490,9500,1,00152,India
599058,2023-05-16,503,mixer,1349,3249,1900,1,00152,India
599058,2023-05-16,501,iphone 15,60000,80000,20000,1,00152,India
663226,2023-05-16,506,monitor,3249,8000,4751,1,00123,India
851101,2023-05-16,501,iphone 15,60000,80000,20000,1,00275,India
851101,2023-05-16,502,iphone 15 pro max,100000,135000,35000,1,00275,India
851101,2023-05-16,507,washing machine,6990,16490,9500,1,00275,India
225941,2023-05-16,501,iphone 15,60000,80000,20000,1,00074,India
225941,2023-05-16,502,iphone 15 pro max,100000,135000,35000,1,00074,India
312982,2023-05-16,504,iron,449,879,430,1,00273,India
361781,2023-05-16,501,iphone 15,60000,80000,20000,1,00384,India
361781,2023-05-16,504,iron,449,879,430,1,00384,India
361781,2023-05-16,507,washing machine,6990,16490,9500,1,00384,India
811683,2023-05-16,507,washing machine,6990,16490,9500,1,00303,India
811683,2023-05-16,504,iron,449,879,430,1,00303,India
811683,2023-05-16,503,mixer,1349,3249,1900,1,00303,India
811683,2023-05-16,501,iphone 15,60000,80000,20000,1,00303,India
458162,2023-05-16,505,oven,18490,24000,5510,1,00469,India
458162,2023-05-16,504,iron,449,879,430,1,00469,India
458162,2023-05-16,503,mixer,1349,3249,1900,1,00469,India
669483,2023-05-16,504,iron,449,879,430,1,00087,India
669483,2023-05-16,506,monitor,3249,8000,4751,1,00087,India
683112,2023-05-16,504,iron,449,879,430,1,00446,India
683112,2023-05-16,503,mixer,1349,3249,1900,1,00446,India
683112,2023-05-16,505,oven,18490,24000,5510,1,00446,India
641055,2023-05-16,501,iphone 15,60000,80000,20000,1,00097,India
641055,2023-05-16,503,mixer,1349,3249,1900,1,00097,India
641055,2023-05-16,505,oven,18490,24000,5510,1,00097,India
377168,2023-05-16,501,iphone 15,60000,80000,20000,1,00189,India
377168,2023-05-16,503,mixer,1349,3249,1900,1,00189,India
529203,2023-05-16,503,mixer,1349,3249,1900,1,00285,India
529203,2023-05-16,502,iphone 15 pro max,100000,135000,35000,1,00285,India
275059,2023-05-16,504,iron,449,879,430,1,00297,India
275059,2023-05-16,505,oven,18490,24000,5510,1,00297,India
275059,2023-05-16,507,washing machine,6990,16490,9500,1,00297,India
119486,2023-05-16,501,iphone 15,60000,80000,20000,1,00372,India
119486,2023-05-16,504,iron,449,879,430,1,00372,India
898884,2023-05-16,504,iron,449,879,430,1,00124,India
898884,2023-05-16,503,mixer,1349,3249,1900,1,00124,India
273305,2023-05-16,502,iphone 15 pro max,100000,135000,35000,1,00011,India
273305,2023-05-16,506,monitor,3249,8000,4751,1,00011,India
273305,2023-05-16,501,iphone 15,60000,80000,20000,1,00011,India
632666,2023-05-16,501,iphone 15,60000,80000,20000,1,00388,India
632666,2023-05-16,507,washing machine,6990,16490,9500,1,00388,India
894147,2023-05-16,506,monitor,3249,8000,4751,1,00195,India
894147,2023-05-16,502,iphone 15 pro max,100000,135000,35000,1,00195,India
894147,2023-05-16,503,mixer,1349,3249,1900,1,00195,India
719971,2023-05-16,503,mixer,1349,3249,1900,1,00222,India
719971,2023-05-16,506,monitor,3249,8000,4751,1,00222,India
719971,2023-05-16,507,washing machine,6990,16490,9500,1,00222,India
594548,2023-05-16,501,iphone 15,60000,80000,20000,1,00465,India
594548,2023-05-16,503,mixer,1349,3249,1900,1,00465,India
594548,2023-05-16,504,iron,449,879,430,1,00465,India
624130,2023-05-16,504,iron,449,879,430,1,00080,India
624130,2023-05-16,502,iphone 15 pro max,100000,135000,35000,1,00080,India
624130,2023-05-16,503,mixer,1349,3249,1900,1,00080,India
284340,2023-05-16,501,iphone 15,60000,80000,20000,1,00455,India
284340,2023-05-16,502,iphone 15 pro max,100000,135000,35000,1,00455,India
284340,2023-05-16,507,washing machine,6990,16490,9500,1,00455,India
284340,2023-05-16,506,monitor,3249,8000,4751,1,00455,India
883969,2023-05-16,502,iphone 15 pro max,100000,135000,35000,1,00426,India
883969,2023-05-16,501,iphone 15,60000,80000,20000,1,00426,India
883969,2023-05-16,504,iron,449,879,430,1,00426,India
371107,2023-05-16,505,oven,18490,24000,5510,1,00132,India
371107,2023-05-16,501,iphone 15,60000,80000,20000,1,00132,India
473884,2023-05-16,507,washing machine,6990,16490,9500,1,00214,India
473884,2023-05-16,506,monitor,3249,8000,4751,1,00214,India
473884,2023-05-16,502,iphone 15 pro max,100000,135000,35000,1,00214,India
100005,2023-05-16,501,iphone 15,60000,80000,20000,1,00196,India
100005,2023-05-16,502,iphone 15 pro max,100000,135000,35000,1,00196,India
576276,2023-05-16,501,iphone 15,60000,80000,20000,1,00396,India
576276,2023-05-16,503,mixer,1349,3249,1900,1,00396,India
303399,2023-05-16,505,oven,18490,24000,5510,1,00498,India
523445,2023-05-16,506,monitor,3249,8000,4751,1,00063,India
125333,2023-05-16,505,oven,18490,24000,5510,1,00230,India
125333,2023-05-16,507,washing machine,6990,16490,9500,1,00230,India
198564,2023-05-16,507,washing machine,6990,16490,9500,1,00337,India
198564,2023-05-16,506,monitor,3249,8000,4751,1,00337,India
198564,2023-05-16,501,iphone 15,60000,80000,20000,1,00337,India
748790,2023-05-16,507,washing machine,6990,16490,9500,1,00411,India
748790,2023-05-16,502,iphone 15 pro max,100000,135000,35000,1,00411,India
766048,2023-05-16,504,iron,449,879,430,1,00044,India
766048,2023-05-16,505,oven,18490,24000,5510,1,00044,India
117956,2023-05-16,505,oven,18490,24000,5510,1,00496,India
117956,2023-05-16,503,mixer,1349,3249,1900,1,00496,India
117956,2023-05-16,502,iphone 15 pro max,100000,135000,35000,1,00496,India
328965,2023-05-16,504,iron,449,879,430,1,00470,India
328965,2023-05-16,506,monitor,3249,8000,4751,1,00470,India
328965,2023-05-16,507,washing machine,6990,16490,9500,1,00470,India
197531,2023-05-16,504,iron,449,879,430,1,00076,India
197531,2023-05-16,505,oven,18490,24000,5510,1,00076,India
424820,2023-05-16,506,monitor,3249,8000,4751,1,00259,India
424820,2023-05-16,502,iphone 15 pro max,100000,135000,35000,1,00259,India
424820,2023-05-16,503,mixer,1349,3249,1900,1,00259,India
784217,2023-05-16,502,iphone 15 pro max,100000,135000,35000,1,00297,India
932121,2023-05-16,501,iphone 15,60000,80000,20000,1,00461,India
932121,2023-05-16,503,mixer,1349,3249,1900,1,00461,India
932121,2023-05-16,506,monitor,3249,8000,4751,1,00461,India
932121,2023-05-16,504,iron,449,879,430,1,00461,India
578755,2023-05-16,504,iron,449,879,430,1,00495,India
862441,2023-05-16,503,mixer,1349,3249,1900,1,00476,India
862441,2023-05-16,506,monitor,3249,8000,4751,1,00476,India
862441,2023-05-16,501,iphone 15,60000,80000,20000,1,00476,India
862441,2023-05-16,505,oven,18490,24000,5510,1,00476,India
862441,2023-05-16,502,iphone 15 pro max,100000,135000,35000,1,00476,India
675528,2023-05-16,504,iron,449,879,430,1,00078,India
675528,2023-05-16,501,iphone 15,60000,80000,20000,1,00078,India
284694,2023-05-16,507,washing machine,6990,16490,9500,1,00101,India
284694,2023-05-16,505,oven,18490,24000,5510,1,00101,India
284694,2023-05-16,501,iphone 15,60000,80000,20000,1,00101,India
167761,2023-05-16,506,monitor,3249,8000,4751,1,00197,India
167761,2023-05-16,507,washing machine,6990,16490,9500,1,00197,India
167761,2023-05-16,503,mixer,1349,3249,1900,1,00197,India
248965,2023-05-16,501,iphone 15,60000,80000,20000,1,00259,India
248965,2023-05-16,505,oven,18490,24000,5510,1,00259,India
944602,2023-05-16,501,iphone 15,60000,80000,20000,1,00221,India
944602,2023-05-16,504,iron,449,879,430,1,00221,India
944602,2023-05-16,502,iphone 15 pro max,100000,135000,35000,1,00221,India
944602,2023-05-16,505,oven,18490,24000,5510,1,00221,India
638385,2023-05-16,504,iron,449,879,430,1,00068,India
638385,2023-05-16,503,mixer,1349,3249,1900,1,00068,India
750150,2023-05-16,501,iphone 15,60000,80000,20000,1,00489,India
529157,2023-05-16,504,iron,449,879,430,1,00441,India
529157,2023-05-16,507,washing machine,6990,16490,9500,1,00441,India
762296,2023-05-16,502,iphone 15 pro max,100000,135000,35000,1,00040,India
762296,2023-05-16,504,iron,449,879,430,1,00040,India
762296,2023-05-16,505,oven,18490,24000,5510,1,00040,India
762296,2023-05-16,501,iphone 15,60000,80000,20000,1,00040,India
288075,2023-05-16,507,washing machine,6990,16490,9500,1,00117,India
288075,2023-05-16,504,iron,449,879,430,1,00117,India
288075,2023-05-16,505,oven,18490,24000,5510,1,00117,India
288075,2023-05-16,502,iphone 15 pro max,100000,135000,35000,1,00117,India
615636,2023-05-16,503,mixer,1349,3249,1900,1,00222,India
615636,2023-05-16,507,washing machine,6990,16490,9500,1,00222,India
615636,2023-05-16,504,iron,449,879,430,1,00222,India
356497,2023-05-16,505,oven,18490,24000,5510,1,00408,India
356497,2023-05-16,504,iron,449,879,430,1,00408,India
195181,2023-05-16,506,monitor,3249,8000,4751,1,00461,India
195181,2023-05-16,507,washing machine,6990,16490,9500,1,00461,India
411541,2023-05-16,506,monitor,3249,8000,4751,1,00396,India
411541,2023-05-16,507,washing machine,6990,16490,9500,1,00396,India
241100,2023-05-16,507,washing machine,6990,16490,9500,1,00156,India
241100,2023-05-16,501,iphone 15,60000,80000,20000,1,00156,India
241100,2023-05-16,504,iron,449,879,430,1,00156,India
570098,2023-05-16,501,iphone 15,60000,80000,20000,1,00139,India
570098,2023-05-16,504,iron,449,879,430,1,00139,India
565520,2023-05-16,504,iron,449,879,430,1,00382,India
565520,2023-05-16,503,mixer,1349,3249,1900,1,00382,India
636591,2023-05-16,504,iron,449,879,430,1,00013,India
873872,2023-05-16,506,monitor,3249,8000,4751,1,00294,India
873872,2023-05-16,504,iron,449,879,430,1,00294,India
873872,2023-05-16,505,oven,18490,24000,5510,1,00294,India
869695,2023-05-16,506,monitor,3249,8000,4751,1,00424,India
613438,2023-05-16,506,monitor,3249,8000,4751,1,00225,India
613438,2023-05-16,504,iron,449,879,430,1,00225,India
613438,2023-05-16,503,mixer,1349,3249,1900,1,00225,India
467572,2023-05-16,502,iphone 15 pro max,100000,135000,35000,1,00448,India
687865,2023-05-16,501,iphone 15,60000,80000,20000,1,00330,India
915093,2023-05-16,505,oven,18490,24000,5510,1,00156,India
915093,2023-05-16,504,iron,449,879,430,1,00156,India
929602,2023-05-16,502,iphone 15 pro max,100000,135000,35000,1,00470,India
929602,2023-05-16,503,mixer,1349,3249,1900,1,00470,India
652369,2023-05-16,502,iphone 15 pro max,100000,135000,35000,1,00321,India
652369,2023-05-16,503,mixer,1349,3249,1900,1,00321,India
652369,2023-05-16,501,iphone 15,60000,80000,20000,1,00321,India
652369,2023-05-16,506,monitor,3249,8000,4751,1,00321,India
789798,2023-05-16,502,iphone 15 pro max,100000,135000,35000,1,00118,India
789798,2023-05-16,506,monitor,3249,8000,4751,1,00118,India
789798,2023-05-16,503,mixer,1349,3249,1900,1,00118,India
164832,2023-05-16,505,oven,18490,24000,5510,1,00328,India
164832,2023-05-16,501,iphone 15,60000,80000,20000,1,00328,India
164832,2023-05-16,507,washing machine,6990,16490,9500,1,00328,India
164832,2023-05-16,503,mixer,1349,3249,1900,1,00328,India
929228,2023-05-16,502,iphone 15 pro max,100000,135000,35000,1,00222,India
570625,2023-05-16,504,iron,449,879,430,1,00441,India
570625,2023-05-16,503,mixer,1349,3249,1900,1,00441,India
570625,2023-05-16,502,iphone 15 pro max,100000,135000,35000,1,00441,India
697273,2023-05-16,504,iron,449,879,430,1,00109,India
697273,2023-05-16,505,oven,18490,24000,5510,1,00109,India
697273,2023-05-16,502,iphone 15 pro max,100000,135000,35000,1,00109,India
697273,2023-05-16,507,washing machine,6990,16490,9500,1,00109,India
693908,2023-05-16,501,iphone 15,60000,80000,20000,1,00201,India
693908,2023-05-16,507,washing machine,6990,16490,9500,1,00201,India
693908,2023-05-16,503,mixer,1349,3249,1900,1,00201,India
693908,2023-05-16,506,monitor,3249,8000,4751,1,00201,India
472081,2023-05-16,505,oven,18490,24000,5510,1,00253,India
472081,2023-05-16,506,monitor,3249,8000,4751,1,00253,India
472081,2023-05-16,503,mixer,1349,3249,1900,1,00253,India
360471,2023-05-16,504,iron,449,879,430,1,00198,India
360471,2023-05-16,502,iphone 15 pro max,100000,135000,35000,1,00198,India
347191,2023-05-16,507,washing machine,6990,16490,9500,1,00186,India
347191,2023-05-16,502,iphone 15 pro max,100000,135000,35000,1,00186,India
946221,2023-05-16,503,mixer,1349,3249,1900,1,00369,India
946221,2023-05-16,506,monitor,3249,8000,4751,1,00369,India
946221,2023-05-16,504,iron,449,879,430,1,00369,India
937633,2023-05-16,506,monitor,3249,8000,4751,1,00485,India
129639,2023-05-16,507,washing machine,6990,16490,9500,1,00342,India
129639,2023-05-16,503,mixer,1349,3249,1900,1,00342,India
374872,2023-05-17,504,iron,449,879,430,1,00254,India
374872,2023-05-17,501,iphone 15,60000,80000,20000,1,00254,India
244135,2023-05-17,501,iphone 15,60000,80000,20000,1,00462,India
244135,2023-05-17,504,iron,449,879,430,1,00462,India
244135,2023-05-17,505,oven,18490,24000,5510,1,00462,India
893619,2023-05-17,504,iron,449,879,430,1,00439,India
893619,2023-05-17,503,mixer,1349,3249,1900,1,00439,India
893619,2023-05-17,507,washing machine,6990,16490,9500,1,00439,India
270444,2023-05-17,501,iphone 15,60000,80000,20000,1,00331,India
270444,2023-05-17,503,mixer,1349,3249,1900,1,00331,India
270444,2023-05-17,504,iron,449,879,430,1,00331,India
600287,2023-05-17,503,mixer,1349,3249,1900,1,00494,India
319261,2023-05-17,501,iphone 15,60000,80000,20000,1,00231,India
319261,2023-05-17,506,monitor,3249,8000,4751,1,00231,India
319261,2023-05-17,504,iron,449,879,430,1,00231,India
746437,2023-05-17,507,washing machine,6990,16490,9500,1,00427,India
746437,2023-05-17,502,iphone 15 pro max,100000,135000,35000,1,00427,India
746437,2023-05-17,506,monitor,3249,8000,4751,1,00427,India
316468,2023-05-17,505,oven,18490,24000,5510,1,00300,India
316468,2023-05-17,506,monitor,3249,8000,4751,1,00300,India
912018,2023-05-17,501,iphone 15,60000,80000,20000,1,00388,India
912018,2023-05-17,502,iphone 15 pro max,100000,135000,35000,1,00388,India
912018,2023-05-17,506,monitor,3249,8000,4751,1,00388,India
912018,2023-05-17,507,washing machine,6990,16490,9500,1,00388,India
550150,2023-05-17,504,iron,449,879,430,1,00218,India
550150,2023-05-17,503,mixer,1349,3249,1900,1,00218,India
550150,2023-05-17,501,iphone 15,60000,80000,20000,1,00218,India
550150,2023-05-17,505,oven,18490,24000,5510,1,00218,India
496972,2023-05-17,505,oven,18490,24000,5510,1,00346,India
496972,2023-05-17,503,mixer,1349,3249,1900,1,00346,India
496972,2023-05-17,506,monitor,3249,8000,4751,1,00346,India
234462,2023-05-17,503,mixer,1349,3249,1900,1,00055,India
234462,2023-05-17,505,oven,18490,24000,5510,1,00055,India
234462,2023-05-17,507,washing machine,6990,16490,9500,1,00055,India
234462,2023-05-17,501,iphone 15,60000,80000,20000,1,00055,India
453389,2023-05-17,503,mixer,1349,3249,1900,1,00451,India
453389,2023-05-17,502,iphone 15 pro max,100000,135000,35000,1,00451,India
453389,2023-05-17,506,monitor,3249,8000,4751,1,00451,India
452943,2023-05-17,504,iron,449,879,430,1,00174,India
452943,2023-05-17,501,iphone 15,60000,80000,20000,1,00174,India
356576,2023-05-17,502,iphone 15 pro max,100000,135000,35000,1,00283,India
356576,2023-05-17,506,monitor,3249,8000,4751,1,00283,India
356576,2023-05-17,501,iphone 15,60000,80000,20000,1,00283,India
356576,2023-05-17,505,oven,18490,24000,5510,1,00283,India
609144,2023-05-17,505,oven,18490,24000,5510,1,00456,India
609144,2023-05-17,504,iron,449,879,430,1,00456,India
577239,2023-05-17,506,monitor,3249,8000,4751,1,00087,India
626411,2023-05-17,504,iron,449,879,430,1,00230,India
924520,2023-05-17,502,iphone 15 pro max,100000,135000,35000,1,00238,India
924520,2023-05-17,504,iron,449,879,430,1,00238,India
816035,2023-05-17,504,iron,449,879,430,1,00251,India
816035,2023-05-17,506,monitor,3249,8000,4751,1,00251,India
816035,2023-05-17,502,iphone 15 pro max,100000,135000,35000,1,00251,India
816035,2023-05-17,505,oven,18490,24000,5510,1,00251,India
216288,2023-05-17,504,iron,449,879,430,1,00122,India
216288,2023-05-17,501,iphone 15,60000,80000,20000,1,00122,India
975013,2023-05-17,503,mixer,1349,3249,1900,1,00076,India
975013,2023-05-17,507,washing machine,6990,16490,9500,1,00076,India
410689,2023-05-17,506,monitor,3249,8000,4751,1,00479,India
645666,2023-05-17,503,mixer,1349,3249,1900,1,00094,India
645666,2023-05-17,507,washing machine,6990,16490,9500,1,00094,India
645666,2023-05-17,504,iron,449,879,430,1,00094,India
136784,2023-05-17,505,oven,18490,24000,5510,1,00057,India
136784,2023-05-17,501,iphone 15,60000,80000,20000,1,00057,India
951990,2023-05-17,507,washing machine,6990,16490,9500,1,00060,India
416234,2023-05-17,502,iphone 15 pro max,100000,135000,35000,1,00064,India
416234,2023-05-17,501,iphone 15,60000,80000,20000,1,00064,India
162620,2023-05-17,502,iphone 15 pro max,100000,135000,35000,1,00249,India
162620,2023-05-17,504,iron,449,879,430,1,00249,India
162620,2023-05-17,505,oven,18490,24000,5510,1,00249,India
752843,2023-05-17,502,iphone 15 pro max,100000,135000,35000,1,00254,India
752843,2023-05-17,506,monitor,3249,8000,4751,1,00254,India
960790,2023-05-17,505,oven,18490,24000,5510,1,00001,India
960790,2023-05-17,501,iphone 15,60000,80000,20000,1,00001,India
160653,2023-05-17,502,iphone 15 pro max,100000,135000,35000,1,00430,India
160653,2023-05-17,507,washing machine,6990,16490,9500,1,00430,India
160653,2023-05-17,506,monitor,3249,8000,4751,1,00430,India
160653,2023-05-17,503,mixer,1349,3249,1900,1,00430,India
886336,2023-05-17,507,washing machine,6990,16490,9500,1,00300,India
886336,2023-05-17,501,iphone 15,60000,80000,20000,1,00300,India
886336,2023-05-17,506,monitor,3249,8000,4751,1,00300,India
886336,2023-05-17,503,mixer,1349,3249,1900,1,00300,India
371390,2023-05-17,502,iphone 15 pro max,100000,135000,35000,1,00109,India
371390,2023-05-17,505,oven,18490,24000,5510,1,00109,India
235269,2023-05-17,507,washing machine,6990,16490,9500,1,00406,India
235269,2023-05-17,503,mixer,1349,3249,1900,1,00406,India
235269,2023-05-17,505,oven,18490,24000,5510,1,00406,India
912751,2023-05-17,504,iron,449,879,430,1,00183,India
218631,2023-05-17,502,iphone 15 pro max,100000,135000,35000,1,00251,India
218631,2023-05-17,507,washing machine,6990,16490,9500,1,00251,India
218631,2023-05-17,504,iron,449,879,430,1,00251,India
218631,2023-05-17,505,oven,18490,24000,5510,1,00251,India
201659,2023-05-17,502,iphone 15 pro max,100000,135000,35000,1,00305,India
201659,2023-05-17,503,mixer,1349,3249,1900,1,00305,India
986061,2023-05-17,504,iron,449,879,430,1,00232,India
986061,2023-05-17,506,monitor,3249,8000,4751,1,00232,India
740353,2023-05-17,506,monitor,3249,8000,4751,1,00091,India
740353,2023-05-17,503,mixer,1349,3249,1900,1,00091,India
740353,2023-05-17,507,washing machine,6990,16490,9500,1,00091,India
740353,2023-05-17,504,iron,449,879,430,1,00091,India
700115,2023-05-17,502,iphone 15 pro max,100000,135000,35000,1,00321,India
700115,2023-05-17,507,washing machine,6990,16490,9500,1,00321,India
700115,2023-05-17,503,mixer,1349,3249,1900,1,00321,India
700115,2023-05-17,505,oven,18490,24000,5510,1,00321,India
348831,2023-05-17,507,washing machine,6990,16490,9500,1,00224,India
348831,2023-05-17,501,iphone 15,60000,80000,20000,1,00224,India
348831,2023-05-17,502,iphone 15 pro max,100000,135000,35000,1,00224,India
660950,2023-05-17,507,washing machine,6990,16490,9500,1,00303,India
660950,2023-05-17,506,monitor,3249,8000,4751,1,00303,India
660950,2023-05-17,502,iphone 15 pro max,100000,135000,35000,1,00303,India
660950,2023-05-17,503,mixer,1349,3249,1900,1,00303,India
730221,2023-05-17,506,monitor,3249,8000,4751,1,00224,India
406762,2023-05-17,504,iron,449,879,430,1,00256,India
406762,2023-05-17,505,oven,18490,24000,5510,1,00256,India
406762,2023-05-17,502,iphone 15 pro max,100000,135000,35000,1,00256,India
406762,2023-05-17,503,mixer,1349,3249,1900,1,00256,India
759321,2023-05-17,507,washing machine,6990,16490,9500,1,00077,India
759321,2023-05-17,502,iphone 15 pro max,100000,135000,35000,1,00077,India
759321,2023-05-17,506,monitor,3249,8000,4751,1,00077,India
502802,2023-05-17,504,iron,449,879,430,1,00221,India
965832,2023-05-17,506,monitor,3249,8000,4751,1,00236,India
673518,2023-05-17,502,iphone 15 pro max,100000,135000,35000,1,00205,India
673518,2023-05-17,507,washing machine,6990,16490,9500,1,00205,India
673518,2023-05-17,506,monitor,3249,8000,4751,1,00205,India
950713,2023-05-17,501,iphone 15,60000,80000,20000,1,00374,India
718196,2023-05-17,506,monitor,3249,8000,4751,1,00189,India
718196,2023-05-17,505,oven,18490,24000,5510,1,00189,India
917912,2023-05-17,501,iphone 15,60000,80000,20000,1,00307,India
917912,2023-05-17,503,mixer,1349,3249,1900,1,00307,India
917912,2023-05-17,506,monitor,3249,8000,4751,1,00307,India
917912,2023-05-17,504,iron,449,879,430,1,00307,India
781432,2023-05-17,507,washing machine,6990,16490,9500,1,00124,India
781432,2023-05-17,503,mixer,1349,3249,1900,1,00124,India
211991,2023-05-17,505,oven,18490,24000,5510,1,00395,India
211991,2023-05-17,502,iphone 15 pro max,100000,135000,35000,1,00395,India
211991,2023-05-17,506,monitor,3249,8000,4751,1,00395,India
716936,2023-05-17,503,mixer,1349,3249,1900,1,00296,India
716936,2023-05-17,507,washing machine,6990,16490,9500,1,00296,India
716936,2023-05-17,506,monitor,3249,8000,4751,1,00296,India
855263,2023-05-18,501,iphone 15,60000,80000,20000,1,00443,India
855263,2023-05-18,506,monitor,3249,8000,4751,1,00443,India
855263,2023-05-18,502,iphone 15 pro max,100000,135000,35000,1,00443,India
855263,2023-05-18,503,mixer,1349,3249,1900,1,00443,India
650471,2023-05-18,503,mixer,1349,3249,1900,1,00401,India
782496,2023-05-18,507,washing machine,6990,16490,9500,1,00243,India
782496,2023-05-18,502,iphone 15 pro max,100000,135000,35000,1,00243,India
782496,2023-05-18,501,iphone 15,60000,80000,20000,1,00243,India
782496,2023-05-18,505,oven,18490,24000,5510,1,00243,India
253828,2023-05-18,504,iron,449,879,430,1,00022,India
253828,2023-05-18,506,monitor,3249,8000,4751,1,00022,India
253828,2023-05-18,501,iphone 15,60000,80000,20000,1,00022,India
476015,2023-05-18,502,iphone 15 pro max,100000,135000,35000,1,00046,India
476015,2023-05-18,506,monitor,3249,8000,4751,1,00046,India
147178,2023-05-18,503,mixer,1349,3249,1900,1,00103,India
147178,2023-05-18,506,monitor,3249,8000,4751,1,00103,India
147178,2023-05-18,504,iron,449,879,430,1,00103,India
167840,2023-05-18,507,washing machine,6990,16490,9500,1,00073,India
259860,2023-05-18,507,washing machine,6990,16490,9500,1,00146,India
259860,2023-05-18,505,oven,18490,24000,5510,1,00146,India
589363,2023-05-18,501,iphone 15,60000,80000,20000,1,00231,India
589363,2023-05-18,502,iphone 15 pro max,100000,135000,35000,1,00231,India
589363,2023-05-18,504,iron,449,879,430,1,00231,India
936220,2023-05-18,505,oven,18490,24000,5510,1,00098,India
936220,2023-05-18,507,washing machine,6990,16490,9500,1,00098,India
936220,2023-05-18,504,iron,449,879,430,1,00098,India
936220,2023-05-18,503,mixer,1349,3249,1900,1,00098,India
936220,2023-05-18,502,iphone 15 pro max,100000,135000,35000,1,00098,India
585005,2023-05-18,505,oven,18490,24000,5510,1,00177,India
585005,2023-05-18,504,iron,449,879,430,1,00177,India
585005,2023-05-18,502,iphone 15 pro max,100000,135000,35000,1,00177,India
566205,2023-05-18,504,iron,449,879,430,1,00039,India
144580,2023-05-18,505,oven,18490,24000,5510,1,00481,India
144580,2023-05-18,504,iron,449,879,430,1,00481,India
144580,2023-05-18,502,iphone 15 pro max,100000,135000,35000,1,00481,India
769185,2023-05-18,506,monitor,3249,8000,4751,1,00437,India
769185,2023-05-18,505,oven,18490,24000,5510,1,00437,India
942839,2023-05-18,505,oven,18490,24000,5510,1,00154,India
449731,2023-05-18,504,iron,449,879,430,1,00141,India
449731,2023-05-18,507,washing machine,6990,16490,9500,1,00141,India
449731,2023-05-18,501,iphone 15,60000,80000,20000,1,00141,India
750583,2023-05-18,504,iron,449,879,430,1,00274,India
975176,2023-05-18,507,washing machine,6990,16490,9500,1,00288,India
975176,2023-05-18,505,oven,18490,24000,5510,1,00288,India
975176,2023-05-18,504,iron,449,879,430,1,00288,India
975176,2023-05-18,502,iphone 15 pro max,100000,135000,35000,1,00288,India
762088,2023-05-18,506,monitor,3249,8000,4751,1,00238,India
762088,2023-05-18,507,washing machine,6990,16490,9500,1,00238,India
898933,2023-05-18,503,mixer,1349,3249,1900,1,00290,India
938808,2023-05-18,505,oven,18490,24000,5510,1,00436,India
938808,2023-05-18,506,monitor,3249,8000,4751,1,00436,India
470547,2023-05-18,502,iphone 15 pro max,100000,135000,35000,1,00318,India
470547,2023-05-18,507,washing machine,6990,16490,9500,1,00318,India
470547,2023-05-18,506,monitor,3249,8000,4751,1,00318,India
839210,2023-05-18,501,iphone 15,60000,80000,20000,1,00139,India
839210,2023-05-18,502,iphone 15 pro max,100000,135000,35000,1,00139,India
839210,2023-05-18,503,mixer,1349,3249,1900,1,00139,India
551144,2023-05-18,501,iphone 15,60000,80000,20000,1,00495,India
551144,2023-05-18,502,iphone 15 pro max,100000,135000,35000,1,00495,India
551144,2023-05-18,507,washing machine,6990,16490,9500,1,00495,India
498331,2023-05-18,502,iphone 15 pro max,100000,135000,35000,1,00213,India
498331,2023-05-18,505,oven,18490,24000,5510,1,00213,India
498331,2023-05-18,506,monitor,3249,8000,4751,1,00213,India
498331,2023-05-18,507,washing machine,6990,16490,9500,1,00213,India
196594,2023-05-18,501,iphone 15,60000,80000,20000,1,00470,India
196594,2023-05-18,506,monitor,3249,8000,4751,1,00470,India
901657,2023-05-18,503,mixer,1349,3249,1900,1,00500,India
933976,2023-05-18,501,iphone 15,60000,80000,20000,1,00350,India
614616,2023-05-18,501,iphone 15,60000,80000,20000,1,00396,India
199437,2023-05-18,504,iron,449,879,430,1,00275,India
199437,2023-05-18,503,mixer,1349,3249,1900,1,00275,India
199437,2023-05-18,507,washing machine,6990,16490,9500,1,00275,India
999780,2023-05-18,505,oven,18490,24000,5510,1,00017,India
999780,2023-05-18,501,iphone 15,60000,80000,20000,1,00017,India
573265,2023-05-18,502,iphone 15 pro max,100000,135000,35000,1,00427,India
573265,2023-05-18,506,monitor,3249,8000,4751,1,00427,India
573265,2023-05-18,504,iron,449,879,430,1,00427,India
573265,2023-05-18,503,mixer,1349,3249,1900,1,00427,India
109677,2023-05-18,506,monitor,3249,8000,4751,1,00134,India
109677,2023-05-18,507,washing machine,6990,16490,9500,1,00134,India
109677,2023-05-18,503,mixer,1349,3249,1900,1,00134,India
109677,2023-05-18,504,iron,449,879,430,1,00134,India
109677,2023-05-18,501,iphone 15,60000,80000,20000,1,00134,India
798161,2023-05-18,503,mixer,1349,3249,1900,1,00242,India
798161,2023-05-18,504,iron,449,879,430,1,00242,India
798161,2023-05-18,502,iphone 15 pro max,100000,135000,35000,1,00242,India
681342,2023-05-18,506,monitor,3249,8000,4751,1,00448,India
530274,2023-05-18,505,oven,18490,24000,5510,1,00279,India
530274,2023-05-18,503,mixer,1349,3249,1900,1,00279,India
530274,2023-05-18,506,monitor,3249,8000,4751,1,00279,India
211013,2023-05-18,506,monitor,3249,8000,4751,1,00401,India
211013,2023-05-18,501,iphone 15,60000,80000,20000,1,00401,India
211013,2023-05-18,504,iron,449,879,430,1,00401,India
211013,2023-05-18,505,oven,18490,24000,5510,1,00401,India
849041,2023-05-18,504,iron,449,879,430,1,00453,India
488641,2023-05-18,501,iphone 15,60000,80000,20000,1,00468,India
488641,2023-05-18,507,washing machine,6990,16490,9500,1,00468,India
417971,2023-05-18,507,washing machine,6990,16490,9500,1,00112,India
417971,2023-05-18,503,mixer,1349,3249,1900,1,00112,India
824390,2023-05-18,505,oven,18490,24000,5510,1,00116,India
824390,2023-05-18,506,monitor,3249,8000,4751,1,00116,India
299525,2023-05-18,507,washing machine,6990,16490,9500,1,00344,India
299525,2023-05-18,506,monitor,3249,8000,4751,1,00344,India
299525,2023-05-18,505,oven,18490,24000,5510,1,00344,India
120988,2023-05-18,506,monitor,3249,8000,4751,1,00085,India
445928,2023-05-18,504,iron,449,879,430,1,00130,India
445928,2023-05-18,505,oven,18490,24000,5510,1,00130,India
333268,2023-05-18,502,iphone 15 pro max,100000,135000,35000,1,00422,India
333268,2023-05-18,504,iron,449,879,430,1,00422,India
868789,2023-05-18,504,iron,449,879,430,1,00477,India
868789,2023-05-18,505,oven,18490,24000,5510,1,00477,India
493069,2023-05-18,503,mixer,1349,3249,1900,1,00042,India
493069,2023-05-18,507,washing machine,6990,16490,9500,1,00042,India
117520,2023-05-18,502,iphone 15 pro max,100000,135000,35000,1,00368,India
117520,2023-05-18,505,oven,18490,24000,5510,1,00368,India
117520,2023-05-18,501,iphone 15,60000,80000,20000,1,00368,India
117520,2023-05-18,504,iron,449,879,430,1,00368,India
706121,2023-05-18,506,monitor,3249,8000,4751,1,00266,India
706121,2023-05-18,505,oven,18490,24000,5510,1,00266,India
706121,2023-05-18,503,mixer,1349,3249,1900,1,00266,India
835770,2023-05-18,506,monitor,3249,8000,4751,1,00028,India
835770,2023-05-18,504,iron,449,879,430,1,00028,India
870205,2023-05-18,504,iron,449,879,430,1,00452,India
870205,2023-05-18,507,washing machine,6990,16490,9500,1,00452,India
379616,2023-05-18,506,monitor,3249,8000,4751,1,00359,India
379616,2023-05-18,507,washing machine,6990,16490,9500,1,00359,India
713194,2023-05-18,505,oven,18490,24000,5510,1,00170,India
713194,2023-05-18,507,washing machine,6990,16490,9500,1,00170,India
129792,2023-05-18,501,iphone 15,60000,80000,20000,1,00010,India
129792,2023-05-18,503,mixer,1349,3249,1900,1,00010,India
871272,2023-05-18,505,oven,18490,24000,5510,1,00092,India
871272,2023-05-18,501,iphone 15,60000,80000,20000,1,00092,India
466424,2023-05-18,503,mixer,1349,3249,1900,1,00092,India
466424,2023-05-18,504,iron,449,879,430,1,00092,India
466424,2023-05-18,506,monitor,3249,8000,4751,1,00092,India
185690,2023-05-18,506,monitor,3249,8000,4751,1,00127,India
185690,2023-05-18,507,washing machine,6990,16490,9500,1,00127,India
677923,2023-05-18,501,iphone 15,60000,80000,20000,1,00490,India
677923,2023-05-18,504,iron,449,879,430,1,00490,India
326778,2023-05-18,507,washing machine,6990,16490,9500,1,00123,India
326778,2023-05-18,502,iphone 15 pro max,100000,135000,35000,1,00123,India
326778,2023-05-18,505,oven,18490,24000,5510,1,00123,India
326778,2023-05-18,501,iphone 15,60000,80000,20000,1,00123,India
131169,2023-05-18,504,iron,449,879,430,1,00014,India
131169,2023-05-18,505,oven,18490,24000,5510,1,00014,India
978791,2023-05-18,504,iron,449,879,430,1,00344,India
440022,2023-05-18,505,oven,18490,24000,5510,1,00096,India
440022,2023-05-18,501,iphone 15,60000,80000,20000,1,00096,India
561344,2023-05-18,501,iphone 15,60000,80000,20000,1,00485,India
561344,2023-05-18,504,iron,449,879,430,1,00485,India
561344,2023-05-18,503,mixer,1349,3249,1900,1,00485,India
561344,2023-05-18,502,iphone 15 pro max,100000,135000,35000,1,00485,India
993961,2023-05-19,503,mixer,1349,3249,1900,1,00258,India
466454,2023-05-19,506,monitor,3249,8000,4751,1,00444,India
466454,2023-05-19,505,oven,18490,24000,5510,1,00444,India
178410,2023-05-19,506,monitor,3249,8000,4751,1,00157,India
178410,2023-05-19,502,iphone 15 pro max,100000,135000,35000,1,00157,India
894389,2023-05-19,505,oven,18490,24000,5510,1,00383,India
775145,2023-05-19,505,oven,18490,24000,5510,1,00088,India
775145,2023-05-19,502,iphone 15 pro max,100000,135000,35000,1,00088,India
775145,2023-05-19,506,monitor,3249,8000,4751,1,00088,India
775145,2023-05-19,504,iron,449,879,430,1,00088,India
338982,2023-05-19,507,washing machine,6990,16490,9500,1,00265,India
338982,2023-05-19,503,mixer,1349,3249,1900,1,00265,India
657174,2023-05-19,506,monitor,3249,8000,4751,1,00246,India
657174,2023-05-19,503,mixer,1349,3249,1900,1,00246,India
657174,2023-05-19,502,iphone 15 pro max,100000,135000,35000,1,00246,India
495818,2023-05-19,506,monitor,3249,8000,4751,1,00261,India
495818,2023-05-19,501,iphone 15,60000,80000,20000,1,00261,India
837866,2023-05-19,501,iphone 15,60000,80000,20000,1,00199,India
837866,2023-05-19,506,monitor,3249,8000,4751,1,00199,India
837866,2023-05-19,503,mixer,1349,3249,1900,1,00199,India
884701,2023-05-19,502,iphone 15 pro max,100000,135000,35000,1,00288,India
884701,2023-05-19,506,monitor,3249,8000,4751,1,00288,India
810721,2023-05-19,502,iphone 15 pro max,100000,135000,35000,1,00335,India
810721,2023-05-19,503,mixer,1349,3249,1900,1,00335,India
810721,2023-05-19,506,monitor,3249,8000,4751,1,00335,India
235567,2023-05-19,506,monitor,3249,8000,4751,1,00131,India
235567,2023-05-19,502,iphone 15 pro max,100000,135000,35000,1,00131,India
235567,2023-05-19,507,washing machine,6990,16490,9500,1,00131,India
614135,2023-05-19,507,washing machine,6990,16490,9500,1,00423,India
614135,2023-05-19,504,iron,449,879,430,1,00423,India
525303,2023-05-19,503,mixer,1349,3249,1900,1,00019,India
525303,2023-05-19,501,iphone 15,60000,80000,20000,1,00019,India
525303,2023-05-19,504,iron,449,879,430,1,00019,India
525186,2023-05-19,506,monitor,3249,8000,4751,1,00112,India
525186,2023-05-19,501,iphone 15,60000,80000,20000,1,00112,India
525186,2023-05-19,507,washing machine,6990,16490,9500,1,00112,India
730096,2023-05-19,504,iron,449,879,430,1,00197,India
190532,2023-05-19,507,washing machine,6990,16490,9500,1,00322,India
190532,2023-05-19,503,mixer,1349,3249,1900,1,00322,India
190532,2023-05-19,506,monitor,3249,8000,4751,1,00322,India
190532,2023-05-19,501,iphone 15,60000,80000,20000,1,00322,India
592323,2023-05-19,502,iphone 15 pro max,100000,135000,35000,1,00466,India
592323,2023-05-19,507,washing machine,6990,16490,9500,1,00466,India
732184,2023-05-19,504,iron,449,879,430,1,00495,India
945180,2023-05-19,503,mixer,1349,3249,1900,1,00280,India
703240,2023-05-19,507,washing machine,6990,16490,9500,1,00461,India
703240,2023-05-19,501,iphone 15,60000,80000,20000,1,00461,India
538837,2023-05-19,505,oven,18490,24000,5510,1,00143,India
538837,2023-05-19,506,monitor,3249,8000,4751,1,00143,India
538837,2023-05-19,507,washing machine,6990,16490,9500,1,00143,India
389322,2023-05-19,503,mixer,1349,3249,1900,1,00442,India
389322,2023-05-19,502,iphone 15 pro max,100000,135000,35000,1,00442,India
389322,2023-05-19,506,monitor,3249,8000,4751,1,00442,India
389322,2023-05-19,505,oven,18490,24000,5510,1,00442,India
727753,2023-05-19,507,washing machine,6990,16490,9500,1,00276,India
727753,2023-05-19,506,monitor,3249,8000,4751,1,00276,India
727753,2023-05-19,503,mixer,1349,3249,1900,1,00276,India
155585,2023-05-19,506,monitor,3249,8000,4751,1,00338,India
155585,2023-05-19,505,oven,18490,24000,5510,1,00338,India
155585,2023-05-19,503,mixer,1349,3249,1900,1,00338,India
657205,2023-05-19,507,washing machine,6990,16490,9500,1,00419,India
657205,2023-05-19,502,iphone 15 pro max,100000,135000,35000,1,00419,India
657205,2023-05-19,501,iphone 15,60000,80000,20000,1,00419,India
657205,2023-05-19,506,monitor,3249,8000,4751,1,00419,India
657205,2023-05-19,505,oven,18490,24000,5510,1,00419,India
341579,2023-05-19,504,iron,449,879,430,1,00439,India
341579,2023-05-19,506,monitor,3249,8000,4751,1,00439,India
341579,2023-05-19,505,oven,18490,24000,5510,1,00439,India
860827,2023-05-19,504,iron,449,879,430,1,00346,India
860827,2023-05-19,503,mixer,1349,3249,1900,1,00346,India
860827,2023-05-19,506,monitor,3249,8000,4751,1,00346,India
444837,2023-05-19,507,washing machine,6990,16490,9500,1,00206,India
444837,2023-05-19,502,iphone 15 pro max,100000,135000,35000,1,00206,India
444837,2023-05-19,503,mixer,1349,3249,1900,1,00206,India
850810,2023-05-19,501,iphone 15,60000,80000,20000,1,00358,India
850810,2023-05-19,506,monitor,3249,8000,4751,1,00358,India
733426,2023-05-19,501,iphone 15,60000,80000,20000,1,00088,India
733426,2023-05-19,502,iphone 15 pro max,100000,135000,35000,1,00088,India
344618,2023-05-19,505,oven,18490,24000,5510,1,00009,India
344618,2023-05-19,501,iphone 15,60000,80000,20000,1,00009,India
344618,2023-05-19,502,iphone 15 pro max,100000,135000,35000,1,00009,India
344618,2023-05-19,507,washing machine,6990,16490,9500,1,00009,India
378387,2023-05-19,506,monitor,3249,8000,4751,1,00085,India
378387,2023-05-19,507,washing machine,6990,16490,9500,1,00085,India
864181,2023-05-19,507,washing machine,6990,16490,9500,1,00321,India
864181,2023-05-19,501,iphone 15,60000,80000,20000,1,00321,India
864181,2023-05-19,504,iron,449,879,430,1,00321,India
864181,2023-05-19,503,mixer,1349,3249,1900,1,00321,India
255609,2023-05-19,501,iphone 15,60000,80000,20000,1,00211,India
255609,2023-05-19,503,mixer,1349,3249,1900,1,00211,India
283338,2023-05-19,506,monitor,3249,8000,4751,1,00256,India
283338,2023-05-19,507,washing machine,6990,16490,9500,1,00256,India
953622,2023-05-19,503,mixer,1349,3249,1900,1,00156,India
953622,2023-05-19,501,iphone 15,60000,80000,20000,1,00156,India
953622,2023-05-19,504,iron,449,879,430,1,00156,India
953622,2023-05-19,507,washing machine,6990,16490,9500,1,00156,India
998796,2023-05-19,502,iphone 15 pro max,100000,135000,35000,1,00126,India
998796,2023-05-19,501,iphone 15,60000,80000,20000,1,00126,India
104262,2023-05-19,504,iron,449,879,430,1,00408,India
104262,2023-05-19,501,iphone 15,60000,80000,20000,1,00408,India
104262,2023-05-19,507,washing machine,6990,16490,9500,1,00408,India
104262,2023-05-19,506,monitor,3249,8000,4751,1,00408,India
509553,2023-05-19,507,washing machine,6990,16490,9500,1,00155,India
509553,2023-05-19,504,iron,449,879,430,1,00155,India
509553,2023-05-19,501,iphone 15,60000,80000,20000,1,00155,India
509553,2023-05-19,506,monitor,3249,8000,4751,1,00155,India
829308,2023-05-19,502,iphone 15 pro max,100000,135000,35000,1,00439,India
829308,2023-05-19,504,iron,449,879,430,1,00439,India
829308,2023-05-19,507,washing machine,6990,16490,9500,1,00439,India
924369,2023-05-19,503,mixer,1349,3249,1900,1,00087,India
924369,2023-05-19,501,iphone 15,60000,80000,20000,1,00087,India
627580,2023-05-19,503,mixer,1349,3249,1900,1,00344,India
810593,2023-05-19,504,iron,449,879,430,1,00110,India
810593,2023-05-19,506,monitor,3249,8000,4751,1,00110,India
810593,2023-05-19,507,washing machine,6990,16490,9500,1,00110,India
810593,2023-05-19,501,iphone 15,60000,80000,20000,1,00110,India
850226,2023-05-19,506,monitor,3249,8000,4751,1,00123,India
850226,2023-05-19,501,iphone 15,60000,80000,20000,1,00123,India
850226,2023-05-19,505,oven,18490,24000,5510,1,00123,India
362691,2023-05-19,502,iphone 15 pro max,100000,135000,35000,1,00029,India
362691,2023-05-19,505,oven,18490,24000,5510,1,00029,India
583162,2023-05-19,504,iron,449,879,430,1,00009,India
579277,2023-05-19,507,washing machine,6990,16490,9500,1,00266,India
579277,2023-05-19,502,iphone 15 pro max,100000,135000,35000,1,00266,India
579277,2023-05-19,501,iphone 15,60000,80000,20000,1,00266,India
743502,2023-05-19,502,iphone 15 pro max,100000,135000,35000,1,00129,India
743502,2023-05-19,501,iphone 15,60000,80000,20000,1,00129,India
743502,2023-05-19,507,washing machine,6990,16490,9500,1,00129,India
517100,2023-05-19,504,iron,449,879,430,1,00317,India
517100,2023-05-19,507,washing machine,6990,16490,9500,1,00317,India
517100,2023-05-19,502,iphone 15 pro max,100000,135000,35000,1,00317,India
799558,2023-05-19,503,mixer,1349,3249,1900,1,00471,India
799558,2023-05-19,506,monitor,3249,8000,4751,1,00471,India
799558,2023-05-19,504,iron,449,879,430,1,00471,India
799558,2023-05-19,502,iphone 15 pro max,100000,135000,35000,1,00471,India
329166,2023-05-19,505,oven,18490,24000,5510,1,00449,India
211817,2023-05-19,505,oven,18490,24000,5510,1,00213,India
211817,2023-05-19,504,iron,449,879,430,1,00213,India
211817,2023-05-19,501,iphone 15,60000,80000,20000,1,00213,India
385274,2023-05-19,507,washing machine,6990,16490,9500,1,00399,India
385274,2023-05-19,501,iphone 15,60000,80000,20000,1,00399,India
596630,2023-05-19,506,monitor,3249,8000,4751,1,00326,India
596630,2023-05-19,507,washing machine,6990,16490,9500,1,00326,India
596630,2023-05-19,504,iron,449,879,430,1,00326,India
364902,2023-05-19,504,iron,449,879,430,1,00419,India
364902,2023-05-19,505,oven,18490,24000,5510,1,00419,India
364902,2023-05-19,506,monitor,3249,8000,4751,1,00419,India
364902,2023-05-19,507,washing machine,6990,16490,9500,1,00419,India
518696,2023-05-19,501,iphone 15,60000,80000,20000,1,00170,India
518696,2023-05-19,507,washing machine,6990,16490,9500,1,00170,India
518696,2023-05-19,506,monitor,3249,8000,4751,1,00170,India
480055,2023-05-19,501,iphone 15,60000,80000,20000,1,00296,India
480055,2023-05-19,502,iphone 15 pro max,100000,135000,35000,1,00296,India
480055,2023-05-19,506,monitor,3249,8000,4751,1,00296,India
577718,2023-05-19,504,iron,449,879,430,1,00099,India
577718,2023-05-19,507,washing machine,6990,16490,9500,1,00099,India
909161,2023-05-19,506,monitor,3249,8000,4751,1,00076,India
909161,2023-05-19,507,washing machine,6990,16490,9500,1,00076,India
909161,2023-05-19,502,iphone 15 pro max,100000,135000,35000,1,00076,India
139885,2023-05-19,506,monitor,3249,8000,4751,1,00229,India
139885,2023-05-19,504,iron,449,879,430,1,00229,India
139885,2023-05-19,502,iphone 15 pro max,100000,135000,35000,1,00229,India
781179,2023-05-19,505,oven,18490,24000,5510,1,00030,India
781179,2023-05-19,502,iphone 15 pro max,100000,135000,35000,1,00030,India
781179,2023-05-19,501,iphone 15,60000,80000,20000,1,00030,India
781179,2023-05-19,504,iron,449,879,430,1,00030,India
733279,2023-05-19,501,iphone 15,60000,80000,20000,1,00065,India
733279,2023-05-19,503,mixer,1349,3249,1900,1,00065,India
733279,2023-05-19,504,iron,449,879,430,1,00065,India
733279,2023-05-19,505,oven,18490,24000,5510,1,00065,India
516242,2023-05-19,505,oven,18490,24000,5510,1,00038,India
516242,2023-05-19,507,washing machine,6990,16490,9500,1,00038,India
985931,2023-05-19,504,iron,449,879,430,1,00361,India
577018,2023-05-19,506,monitor,3249,8000,4751,1,00309,India
577018,2023-05-19,504,iron,449,879,430,1,00309,India
881195,2023-05-19,503,mixer,1349,3249,1900,1,00453,India
146985,2023-05-19,506,monitor,3249,8000,4751,1,00210,India
680628,2023-05-19,501,iphone 15,60000,80000,20000,1,00192,India
680628,2023-05-19,507,washing machine,6990,16490,9500,1,00192,India
377375,2023-05-19,504,iron,449,879,430,1,00487,India
377375,2023-05-19,502,iphone 15 pro max,100000,135000,35000,1,00487,India
844456,2023-05-19,504,iron,449,879,430,1,00109,India
844456,2023-05-19,506,monitor,3249,8000,4751,1,00109,India
844456,2023-05-19,501,iphone 15,60000,80000,20000,1,00109,India
844456,2023-05-19,505,oven,18490,24000,5510,1,00109,India
734573,2023-05-20,503,mixer,1349,3249,1900,1,00095,India
734573,2023-05-20,505,oven,18490,24000,5510,1,00095,India
382420,2023-05-20,506,monitor,3249,8000,4751,1,00242,India
665659,2023-05-20,506,monitor,3249,8000,4751,1,00100,India
665659,2023-05-20,505,oven,18490,24000,5510,1,00100,India
665659,2023-05-20,502,iphone 15 pro max,100000,135000,35000,1,00100,India
436842,2023-05-20,503,mixer,1349,3249,1900,1,00244,India
436842,2023-05-20,502,iphone 15 pro max,100000,135000,35000,1,00244,India
436842,2023-05-20,504,iron,449,879,430,1,00244,India
321205,2023-05-20,502,iphone 15 pro max,100000,135000,35000,1,00259,India
321205,2023-05-20,503,mixer,1349,3249,1900,1,00259,India
321205,2023-05-20,501,iphone 15,60000,80000,20000,1,00259,India
559836,2023-05-20,501,iphone 15,60000,80000,20000,1,00078,India
559836,2023-05-20,503,mixer,1349,3249,1900,1,00078,India
166282,2023-05-20,507,washing machine,6990,16490,9500,1,00372,India
166282,2023-05-20,502,iphone 15 pro max,100000,135000,35000,1,00372,India
166282,2023-05-20,504,iron,449,879,430,1,00372,India
501542,2023-05-20,507,washing machine,6990,16490,9500,1,00101,India
957551,2023-05-20,501,iphone 15,60000,80000,20000,1,00367,India
957551,2023-05-20,503,mixer,1349,3249,1900,1,00367,India
957551,2023-05-20,504,iron,449,879,430,1,00367,India
978375,2023-05-20,507,washing machine,6990,16490,9500,1,00177,India
978375,2023-05-20,506,monitor,3249,8000,4751,1,00177,India
159999,2023-05-20,507,washing machine,6990,16490,9500,1,00223,India
159999,2023-05-20,502,iphone 15 pro max,100000,135000,35000,1,00223,India
597249,2023-05-20,505,oven,18490,24000,5510,1,00110,India
597249,2023-05-20,504,iron,449,879,430,1,00110,India
929508,2023-05-20,506,monitor,3249,8000,4751,1,00399,India
929508,2023-05-20,507,washing machine,6990,16490,9500,1,00399,India
929508,2023-05-20,501,iphone 15,60000,80000,20000,1,00399,India
172011,2023-05-20,504,iron,449,879,430,1,00436,India
172011,2023-05-20,506,monitor,3249,8000,4751,1,00436,India
172011,2023-05-20,505,oven,18490,24000,5510,1,00436,India
343751,2023-05-20,503,mixer,1349,3249,1900,1,00440,India
145986,2023-05-20,506,monitor,3249,8000,4751,1,00126,India
145986,2023-05-20,507,washing machine,6990,16490,9500,1,00126,India
963721,2023-05-20,504,iron,449,879,430,1,00308,India
846394,2023-05-20,503,mixer,1349,3249,1900,1,00290,India
846394,2023-05-20,505,oven,18490,24000,5510,1,00290,India
846394,2023-05-20,504,iron,449,879,430,1,00290,India
988968,2023-05-20,505,oven,18490,24000,5510,1,00143,India
988968,2023-05-20,507,washing machine,6990,16490,9500,1,00143,India
988968,2023-05-20,502,iphone 15 pro max,100000,135000,35000,1,00143,India
363131,2023-05-20,507,washing machine,6990,16490,9500,1,00340,India
363131,2023-05-20,506,monitor,3249,8000,4751,1,00340,India
363131,2023-05-20,502,iphone 15 pro max,100000,135000,35000,1,00340,India
363131,2023-05-20,501,iphone 15,60000,80000,20000,1,00340,India
199225,2023-05-20,502,iphone 15 pro max,100000,135000,35000,1,00159,India
199225,2023-05-20,506,monitor,3249,8000,4751,1,00159,India
199225,2023-05-20,501,iphone 15,60000,80000,20000,1,00159,India
447220,2023-05-20,505,oven,18490,24000,5510,1,00248,India
447220,2023-05-20,503,mixer,1349,3249,1900,1,00248,India
447220,2023-05-20,502,iphone 15 pro max,100000,135000,35000,1,00248,India
447220,2023-05-20,504,iron,449,879,430,1,00248,India
447220,2023-05-20,506,monitor,3249,8000,4751,1,00248,India
712656,2023-05-20,507,washing machine,6990,16490,9500,1,00181,India
712656,2023-05-20,503,mixer,1349,3249,1900,1,00181,India
712656,2023-05-20,506,monitor,3249,8000,4751,1,00181,India
712656,2023-05-20,501,iphone 15,60000,80000,20000,1,00181,India
288128,2023-05-20,507,washing machine,6990,16490,9500,1,00450,India
288128,2023-05-20,502,iphone 15 pro max,100000,135000,35000,1,00450,India
814685,2023-05-20,502,iphone 15 pro max,100000,135000,35000,1,00361,India
814685,2023-05-20,503,mixer,1349,3249,1900,1,00361,India
814685,2023-05-20,506,monitor,3249,8000,4751,1,00361,India
876948,2023-05-20,502,iphone 15 pro max,100000,135000,35000,1,00375,India
691178,2023-05-20,501,iphone 15,60000,80000,20000,1,00443,India
691178,2023-05-20,507,washing machine,6990,16490,9500,1,00443,India
691178,2023-05-20,504,iron,449,879,430,1,00443,India
691178,2023-05-20,506,monitor,3249,8000,4751,1,00443,India
691178,2023-05-20,505,oven,18490,24000,5510,1,00443,India
617814,2023-05-20,504,iron,449,879,430,1,00281,India
412586,2023-05-20,502,iphone 15 pro max,100000,135000,35000,1,00270,India
412586,2023-05-20,506,monitor,3249,8000,4751,1,00270,India
330891,2023-05-20,505,oven,18490,24000,5510,1,00344,India
986443,2023-05-20,505,oven,18490,24000,5510,1,00177,India
986443,2023-05-20,502,iphone 15 pro max,100000,135000,35000,1,00177,India
182273,2023-05-20,506,monitor,3249,8000,4751,1,00321,India
167678,2023-05-20,504,iron,449,879,430,1,00483,India
167678,2023-05-20,505,oven,18490,24000,5510,1,00483,India
935817,2023-05-20,504,iron,449,879,430,1,00093,India
935817,2023-05-20,502,iphone 15 pro max,100000,135000,35000,1,00093,India
935817,2023-05-20,507,washing machine,6990,16490,9500,1,00093,India
695181,2023-05-20,503,mixer,1349,3249,1900,1,00297,India
961042,2023-05-20,501,iphone 15,60000,80000,20000,1,00280,India
457826,2023-05-20,505,oven,18490,24000,5510,1,00400,India
457826,2023-05-20,502,iphone 15 pro max,100000,135000,35000,1,00400,India
402462,2023-05-20,502,iphone 15 pro max,100000,135000,35000,1,00022,India
774181,2023-05-20,505,oven,18490,24000,5510,1,00280,India
774181,2023-05-20,503,mixer,1349,3249,1900,1,00280,India
430921,2023-05-20,501,iphone 15,60000,80000,20000,1,00314,India
430921,2023-05-20,504,iron,449,879,430,1,00314,India
430921,2023-05-20,507,washing machine,6990,16490,9500,1,00314,India
430921,2023-05-20,506,monitor,3249,8000,4751,1,00314,India
540031,2023-05-20,507,washing machine,6990,16490,9500,1,00482,India
540031,2023-05-20,502,iphone 15 pro max,100000,135000,35000,1,00482,India
540031,2023-05-20,506,monitor,3249,8000,4751,1,00482,India
540031,2023-05-20,504,iron,449,879,430,1,00482,India
683918,2023-05-20,504,iron,449,879,430,1,00165,India
683918,2023-05-20,501,iphone 15,60000,80000,20000,1,00165,India
683918,2023-05-20,505,oven,18490,24000,5510,1,00165,India
683918,2023-05-20,503,mixer,1349,3249,1900,1,00165,India
244031,2023-05-20,502,iphone 15 pro max,100000,135000,35000,1,00376,India
608157,2023-05-20,503,mixer,1349,3249,1900,1,00025,India
463094,2023-05-20,505,oven,18490,24000,5510,1,00315,India
463094,2023-05-20,501,iphone 15,60000,80000,20000,1,00315,India
314707,2023-05-20,506,monitor,3249,8000,4751,1,00023,India
314707,2023-05-20,504,iron,449,879,430,1,00023,India
314707,2023-05-20,505,oven,18490,24000,5510,1,00023,India
234581,2023-05-20,503,mixer,1349,3249,1900,1,00347,India
234581,2023-05-20,501,iphone 15,60000,80000,20000,1,00347,India
234581,2023-05-20,504,iron,449,879,430,1,00347,India
234581,2023-05-20,506,monitor,3249,8000,4751,1,00347,India
798972,2023-05-20,502,iphone 15 pro max,100000,135000,35000,1,00084,India
798972,2023-05-20,501,iphone 15,60000,80000,20000,1,00084,India
562487,2023-05-20,501,iphone 15,60000,80000,20000,1,00458,India
562487,2023-05-20,503,mixer,1349,3249,1900,1,00458,India
562487,2023-05-20,504,iron,449,879,430,1,00458,India
361177,2023-05-20,504,iron,449,879,430,1,00388,India
412271,2023-05-20,505,oven,18490,24000,5510,1,00443,India
404097,2023-05-20,502,iphone 15 pro max,100000,135000,35000,1,00318,India
404097,2023-05-20,506,monitor,3249,8000,4751,1,00318,India
428517,2023-05-20,504,iron,449,879,430,1,00040,India
428517,2023-05-20,501,iphone 15,60000,80000,20000,1,00040,India
428517,2023-05-20,507,washing machine,6990,16490,9500,1,00040,India
371715,2023-05-20,503,mixer,1349,3249,1900,1,00134,India
371715,2023-05-20,506,monitor,3249,8000,4751,1,00134,India
394888,2023-05-20,502,iphone 15 pro max,100000,135000,35000,1,00478,India
394888,2023-05-20,507,washing machine,6990,16490,9500,1,00478,India
686293,2023-05-20,503,mixer,1349,3249,1900,1,00067,India
686293,2023-05-20,505,oven,18490,24000,5510,1,00067,India
686293,2023-05-20,507,washing machine,6990,16490,9500,1,00067,India
799795,2023-05-20,507,washing machine,6990,16490,9500,1,00017,India
976795,2023-05-20,505,oven,18490,24000,5510,1,00433,India
976795,2023-05-20,507,washing machine,6990,16490,9500,1,00433,India
976795,2023-05-20,506,monitor,3249,8000,4751,1,00433,India
176840,2023-05-20,507,washing machine,6990,16490,9500,1,00194,India
176840,2023-05-20,503,mixer,1349,3249,1900,1,00194,India
376570,2023-05-20,505,oven,18490,24000,5510,1,00287,India
376570,2023-05-20,501,iphone 15,60000,80000,20000,1,00287,India
376570,2023-05-20,504,iron,449,879,430,1,00287,India
630887,2023-05-20,506,monitor,3249,8000,4751,1,00199,India
630887,2023-05-20,507,washing machine,6990,16490,9500,1,00199,India
261782,2023-05-20,505,oven,18490,24000,5510,1,00158,India
517779,2023-05-20,502,iphone 15 pro max,100000,135000,35000,1,00269,India
517779,2023-05-20,506,monitor,3249,8000,4751,1,00269,India
517779,2023-05-20,503,mixer,1349,3249,1900,1,00269,India
559189,2023-05-20,503,mixer,1349,3249,1900,1,00364,India
559189,2023-05-20,501,iphone 15,60000,80000,20000,1,00364,India
559189,2023-05-20,502,iphone 15 pro max,100000,135000,35000,1,00364,India
566957,2023-05-20,507,washing machine,6990,16490,9500,1,00102,India
566957,2023-05-20,504,iron,449,879,430,1,00102,India
566957,2023-05-20,506,monitor,3249,8000,4751,1,00102,India
566957,2023-05-20,501,iphone 15,60000,80000,20000,1,00102,India
175317,2023-05-20,506,monitor,3249,8000,4751,1,00027,India
175317,2023-05-20,507,washing machine,6990,16490,9500,1,00027,India
175317,2023-05-20,502,iphone 15 pro max,100000,135000,35000,1,00027,India
606110,2023-05-20,501,iphone 15,60000,80000,20000,1,00262,India
169562,2023-05-20,501,iphone 15,60000,80000,20000,1,00144,India
169562,2023-05-20,504,iron,449,879,430,1,00144,India
169562,2023-05-20,505,oven,18490,24000,5510,1,00144,India
585971,2023-05-20,501,iphone 15,60000,80000,20000,1,00369,India
585971,2023-05-20,503,mixer,1349,3249,1900,1,00369,India
585971,2023-05-20,507,washing machine,6990,16490,9500,1,00369,India
810249,2023-05-20,507,washing machine,6990,16490,9500,1,00048,India
810249,2023-05-20,506,monitor,3249,8000,4751,1,00048,India
810249,2023-05-20,502,iphone 15 pro max,100000,135000,35000,1,00048,India
353661,2023-05-20,506,monitor,3249,8000,4751,1,00059,India
353661,2023-05-20,505,oven,18490,24000,5510,1,00059,India
353661,2023-05-20,502,iphone 15 pro max,100000,135000,35000,1,00059,India
353661,2023-05-20,501,iphone 15,60000,80000,20000,1,00059,India
353661,2023-05-20,507,washing machine,6990,16490,9500,1,00059,India
975115,2023-05-20,506,monitor,3249,8000,4751,1,00074,India
637150,2023-05-20,501,iphone 15,60000,80000,20000,1,00340,India
637150,2023-05-20,507,washing machine,6990,16490,9500,1,00340,India
637150,2023-05-20,505,oven,18490,24000,5510,1,00340,India
637150,2023-05-20,504,iron,449,879,430,1,00340,India
307733,2023-05-20,507,washing machine,6990,16490,9500,1,00077,India
307733,2023-05-20,501,iphone 15,60000,80000,20000,1,00077,India
954994,2023-05-20,502,iphone 15 pro max,100000,135000,35000,1,00390,India
954994,2023-05-20,504,iron,449,879,430,1,00390,India
954994,2023-05-20,505,oven,18490,24000,5510,1,00390,India
609584,2023-05-20,506,monitor,3249,8000,4751,1,00219,India
507896,2023-05-20,503,mixer,1349,3249,1900,1,00025,India
507896,2023-05-20,505,oven,18490,24000,5510,1,00025,India
507896,2023-05-20,504,iron,449,879,430,1,00025,India
507896,2023-05-20,501,iphone 15,60000,80000,20000,1,00025,India
507896,2023-05-20,507,washing machine,6990,16490,9500,1,00025,India
248074,2023-05-20,501,iphone 15,60000,80000,20000,1,00386,India
373573,2023-05-20,506,monitor,3249,8000,4751,1,00093,India
373573,2023-05-20,505,oven,18490,24000,5510,1,00093,India
373573,2023-05-20,501,iphone 15,60000,80000,20000,1,00093,India
373573,2023-05-20,504,iron,449,879,430,1,00093,India
395078,2023-05-20,502,iphone 15 pro max,100000,135000,35000,1,00164,India
395078,2023-05-20,505,oven,18490,24000,5510,1,00164,India
395078,2023-05-20,504,iron,449,879,430,1,00164,India
395078,2023-05-20,503,mixer,1349,3249,1900,1,00164,India
682411,2023-05-20,502,iphone 15 pro max,100000,135000,35000,1,00276,India
508618,2023-05-20,504,iron,449,879,430,1,00399,India
508618,2023-05-20,505,oven,18490,24000,5510,1,00399,India
508618,2023-05-20,507,washing machine,6990,16490,9500,1,00399,India
429892,2023-05-20,507,washing machine,6990,16490,9500,1,00380,India
429892,2023-05-20,504,iron,449,879,430,1,00380,India
429892,2023-05-20,502,iphone 15 pro max,100000,135000,35000,1,00380,India
235775,2023-05-20,503,mixer,1349,3249,1900,1,00194,India
235775,2023-05-20,507,washing machine,6990,16490,9500,1,00194,India
858419,2023-05-20,504,iron,449,879,430,1,00103,India
858419,2023-05-20,505,oven,18490,24000,5510,1,00103,India
858419,2023-05-20,503,mixer,1349,3249,1900,1,00103,India
570803,2023-05-21,503,mixer,1349,3249,1900,1,00489,India
570803,2023-05-21,507,washing machine,6990,16490,9500,1,00489,India
847512,2023-05-21,507,washing machine,6990,16490,9500,1,00173,India
847512,2023-05-21,503,mixer,1349,3249,1900,1,00173,India
847512,2023-05-21,501,iphone 15,60000,80000,20000,1,00173,India
847512,2023-05-21,504,iron,449,879,430,1,00173,India
847512,2023-05-21,505,oven,18490,24000,5510,1,00173,India
934356,2023-05-21,504,iron,449,879,430,1,00090,India
934356,2023-05-21,502,iphone 15 pro max,100000,135000,35000,1,00090,India
934356,2023-05-21,503,mixer,1349,3249,1900,1,00090,India
934356,2023-05-21,506,monitor,3249,8000,4751,1,00090,India
503942,2023-05-21,506,monitor,3249,8000,4751,1,00476,India
503942,2023-05-21,505,oven,18490,24000,5510,1,00476,India
503942,2023-05-21,504,iron,449,879,430,1,00476,India
503942,2023-05-21,503,mixer,1349,3249,1900,1,00476,India
912830,2023-05-21,505,oven,18490,24000,5510,1,00487,India
912830,2023-05-21,507,washing machine,6990,16490,9500,1,00487,India
912830,2023-05-21,503,mixer,1349,3249,1900,1,00487,India
404793,2023-05-21,503,mixer,1349,3249,1900,1,00116,India
404793,2023-05-21,501,iphone 15,60000,80000,20000,1,00116,India
404793,2023-05-21,506,monitor,3249,8000,4751,1,00116,India
268129,2023-05-21,505,oven,18490,24000,5510,1,00071,India
879007,2023-05-21,507,washing machine,6990,16490,9500,1,00336,India
879007,2023-05-21,505,oven,18490,24000,5510,1,00336,India
879007,2023-05-21,502,iphone 15 pro max,100000,135000,35000,1,00336,India
879007,2023-05-21,504,iron,449,879,430,1,00336,India
271033,2023-05-21,501,iphone 15,60000,80000,20000,1,00118,India
271033,2023-05-21,506,monitor,3249,8000,4751,1,00118,India
166625,2023-05-21,504,iron,449,879,430,1,00045,India
895341,2023-05-21,502,iphone 15 pro max,100000,135000,35000,1,00068,India
895341,2023-05-21,501,iphone 15,60000,80000,20000,1,00068,India
895341,2023-05-21,504,iron,449,879,430,1,00068,India
606334,2023-05-21,505,oven,18490,24000,5510,1,00040,India
606334,2023-05-21,506,monitor,3249,8000,4751,1,00040,India
606334,2023-05-21,504,iron,449,879,430,1,00040,India
606334,2023-05-21,507,washing machine,6990,16490,9500,1,00040,India
699716,2023-05-21,504,iron,449,879,430,1,00329,India
699716,2023-05-21,505,oven,18490,24000,5510,1,00329,India
699716,2023-05-21,502,iphone 15 pro max,100000,135000,35000,1,00329,India
699716,2023-05-21,503,mixer,1349,3249,1900,1,00329,India
699716,2023-05-21,501,iphone 15,60000,80000,20000,1,00329,India
739302,2023-05-21,506,monitor,3249,8000,4751,1,00299,India
739302,2023-05-21,507,washing machine,6990,16490,9500,1,00299,India
391179,2023-05-21,501,iphone 15,60000,80000,20000,1,00017,India
391179,2023-05-21,507,washing machine,6990,16490,9500,1,00017,India
391179,2023-05-21,505,oven,18490,24000,5510,1,00017,India
391179,2023-05-21,506,monitor,3249,8000,4751,1,00017,India
391179,2023-05-21,504,iron,449,879,430,1,00017,India
584770,2023-05-21,502,iphone 15 pro max,100000,135000,35000,1,00243,India
584770,2023-05-21,505,oven,18490,24000,5510,1,00243,India
584770,2023-05-21,503,mixer,1349,3249,1900,1,00243,India
584770,2023-05-21,506,monitor,3249,8000,4751,1,00243,India
790103,2023-05-21,501,iphone 15,60000,80000,20000,1,00350,India
934300,2023-05-21,504,iron,449,879,430,1,00163,India
934300,2023-05-21,507,washing machine,6990,16490,9500,1,00163,India
934300,2023-05-21,505,oven,18490,24000,5510,1,00163,India
773768,2023-05-21,506,monitor,3249,8000,4751,1,00408,India
773768,2023-05-21,502,iphone 15 pro max,100000,135000,35000,1,00408,India
773768,2023-05-21,505,oven,18490,24000,5510,1,00408,India
773768,2023-05-21,504,iron,449,879,430,1,00408,India
771521,2023-05-21,505,oven,18490,24000,5510,1,00367,India
159659,2023-05-21,505,oven,18490,24000,5510,1,00278,India
159659,2023-05-21,507,washing machine,6990,16490,9500,1,00278,India
159659,2023-05-21,502,iphone 15 pro max,100000,135000,35000,1,00278,India
747567,2023-05-21,505,oven,18490,24000,5510,1,00340,India
135085,2023-05-21,505,oven,18490,24000,5510,1,00495,India
135085,2023-05-21,507,washing machine,6990,16490,9500,1,00495,India
135085,2023-05-21,504,iron,449,879,430,1,00495,India
135085,2023-05-21,503,mixer,1349,3249,1900,1,00495,India
135085,2023-05-21,501,iphone 15,60000,80000,20000,1,00495,India
787476,2023-05-21,503,mixer,1349,3249,1900,1,00194,India
787476,2023-05-21,504,iron,449,879,430,1,00194,India
787476,2023-05-21,505,oven,18490,24000,5510,1,00194,India
350041,2023-05-21,502,iphone 15 pro max,100000,135000,35000,1,00457,India
350041,2023-05-21,503,mixer,1349,3249,1900,1,00457,India
980205,2023-05-21,502,iphone 15 pro max,100000,135000,35000,1,00128,India
993076,2023-05-21,506,monitor,3249,8000,4751,1,00454,India
845973,2023-05-21,503,mixer,1349,3249,1900,1,00245,India
845973,2023-05-21,504,iron,449,879,430,1,00245,India
845973,2023-05-21,501,iphone 15,60000,80000,20000,1,00245,India
944904,2023-05-21,506,monitor,3249,8000,4751,1,00006,India
944904,2023-05-21,507,washing machine,6990,16490,9500,1,00006,India
944904,2023-05-21,505,oven,18490,24000,5510,1,00006,India
979386,2023-05-21,504,iron,449,879,430,1,00416,India
979386,2023-05-21,503,mixer,1349,3249,1900,1,00416,India
648163,2023-05-21,507,washing machine,6990,16490,9500,1,00216,India
648163,2023-05-21,506,monitor,3249,8000,4751,1,00216,India
648163,2023-05-21,501,iphone 15,60000,80000,20000,1,00216,India
338921,2023-05-21,501,iphone 15,60000,80000,20000,1,00285,India
706823,2023-05-21,504,iron,449,879,430,1,00075,India
706823,2023-05-21,506,monitor,3249,8000,4751,1,00075,India
706823,2023-05-21,503,mixer,1349,3249,1900,1,00075,India
242376,2023-05-21,504,iron,449,879,430,1,00404,India
805959,2023-05-21,506,monitor,3249,8000,4751,1,00362,India
805959,2023-05-21,505,oven,18490,24000,5510,1,00362,India
805959,2023-05-21,504,iron,449,879,430,1,00362,India
394885,2023-05-21,501,iphone 15,60000,80000,20000,1,00333,India
394885,2023-05-21,502,iphone 15 pro max,100000,135000,35000,1,00333,India
394885,2023-05-21,507,washing machine,6990,16490,9500,1,00333,India
394885,2023-05-21,506,monitor,3249,8000,4751,1,00333,India
674782,2023-05-21,505,oven,18490,24000,5510,1,00466,India
674782,2023-05-21,507,washing machine,6990,16490,9500,1,00466,India
915095,2023-05-21,505,oven,18490,24000,5510,1,00500,India
651895,2023-05-21,503,mixer,1349,3249,1900,1,00372,India
651895,2023-05-21,505,oven,18490,24000,5510,1,00372,India
651895,2023-05-21,502,iphone 15 pro max,100000,135000,35000,1,00372,India
651895,2023-05-21,501,iphone 15,60000,80000,20000,1,00372,India
238921,2023-05-21,507,washing machine,6990,16490,9500,1,00150,India
238921,2023-05-21,502,iphone 15 pro max,100000,135000,35000,1,00150,India
238921,2023-05-21,503,mixer,1349,3249,1900,1,00150,India
660727,2023-05-21,502,iphone 15 pro max,100000,135000,35000,1,00214,India
660727,2023-05-21,506,monitor,3249,8000,4751,1,00214,India
660727,2023-05-21,505,oven,18490,24000,5510,1,00214,India
660727,2023-05-21,501,iphone 15,60000,80000,20000,1,00214,India
302897,2023-05-21,505,oven,18490,24000,5510,1,00452,India
302897,2023-05-21,501,iphone 15,60000,80000,20000,1,00452,India
198392,2023-05-21,501,iphone 15,60000,80000,20000,1,00380,India
198392,2023-05-21,506,monitor,3249,8000,4751,1,00380,India
198392,2023-05-21,502,iphone 15 pro max,100000,135000,35000,1,00380,India
566887,2023-05-21,506,monitor,3249,8000,4751,1,00226,India
566887,2023-05-21,504,iron,449,879,430,1,00226,India
574441,2023-05-21,507,washing machine,6990,16490,9500,1,00468,India
574441,2023-05-21,502,iphone 15 pro max,100000,135000,35000,1,00468,India
574441,2023-05-21,504,iron,449,879,430,1,00468,India
256795,2023-05-21,505,oven,18490,24000,5510,1,00043,India
256795,2023-05-21,501,iphone 15,60000,80000,20000,1,00043,India
256795,2023-05-21,502,iphone 15 pro max,100000,135000,35000,1,00043,India
962431,2023-05-21,505,oven,18490,24000,5510,1,00437,India
962431,2023-05-21,502,iphone 15 pro max,100000,135000,35000,1,00437,India
962431,2023-05-21,506,monitor,3249,8000,4751,1,00437,India
962431,2023-05-21,501,iphone 15,60000,80000,20000,1,00437,India
832983,2023-05-21,501,iphone 15,60000,80000,20000,1,00421,India
832983,2023-05-21,502,iphone 15 pro max,100000,135000,35000,1,00421,India
832983,2023-05-21,504,iron,449,879,430,1,00421,India
706533,2023-05-21,507,washing machine,6990,16490,9500,1,00444,India
706533,2023-05-21,505,oven,18490,24000,5510,1,00444,India
115998,2023-05-21,503,mixer,1349,3249,1900,1,00260,India
115998,2023-05-21,505,oven,18490,24000,5510,1,00260,India
115998,2023-05-21,502,iphone 15 pro max,100000,135000,35000,1,00260,India
115998,2023-05-21,507,washing machine,6990,16490,9500,1,00260,India
199339,2023-05-21,503,mixer,1349,3249,1900,1,00166,India
199339,2023-05-21,501,iphone 15,60000,80000,20000,1,00166,India
199339,2023-05-21,504,iron,449,879,430,1,00166,India
996848,2023-05-21,501,iphone 15,60000,80000,20000,1,00437,India
996848,2023-05-21,503,mixer,1349,3249,1900,1,00437,India
996848,2023-05-21,502,iphone 15 pro max,100000,135000,35000,1,00437,India
443367,2023-05-21,504,iron,449,879,430,1,00049,India
443367,2023-05-21,506,monitor,3249,8000,4751,1,00049,India
443367,2023-05-21,507,washing machine,6990,16490,9500,1,00049,India
238896,2023-05-21,503,mixer,1349,3249,1900,1,00389,India
456253,2023-05-21,505,oven,18490,24000,5510,1,00081,India
456253,2023-05-21,506,monitor,3249,8000,4751,1,00081,India
456253,2023-05-21,502,iphone 15 pro max,100000,135000,35000,1,00081,India
318717,2023-05-21,504,iron,449,879,430,1,00304,India
318717,2023-05-21,502,iphone 15 pro max,100000,135000,35000,1,00304,India
318717,2023-05-21,506,monitor,3249,8000,4751,1,00304,India
964726,2023-05-21,502,iphone 15 pro max,100000,135000,35000,1,00175,India
964726,2023-05-21,506,monitor,3249,8000,4751,1,00175,India
964726,2023-05-21,505,oven,18490,24000,5510,1,00175,India
737261,2023-05-21,502,iphone 15 pro max,100000,135000,35000,1,00463,India
737261,2023-05-21,506,monitor,3249,8000,4751,1,00463,India
737261,2023-05-21,504,iron,449,879,430,1,00463,India
737261,2023-05-21,503,mixer,1349,3249,1900,1,00463,India
776795,2023-05-21,503,mixer,1349,3249,1900,1,00302,India
504548,2023-05-21,504,iron,449,879,430,1,00450,India
557533,2023-05-21,504,iron,449,879,430,1,00176,India
557533,2023-05-21,506,monitor,3249,8000,4751,1,00176,India
557533,2023-05-21,507,washing machine,6990,16490,9500,1,00176,India
535140,2023-05-21,503,mixer,1349,3249,1900,1,00478,India
535140,2023-05-21,506,monitor,3249,8000,4751,1,00478,India
535140,2023-05-21,501,iphone 15,60000,80000,20000,1,00478,India
639491,2023-05-21,504,iron,449,879,430,1,00472,India
639491,2023-05-21,507,washing machine,6990,16490,9500,1,00472,India
639491,2023-05-21,506,monitor,3249,8000,4751,1,00472,India
639491,2023-05-21,503,mixer,1349,3249,1900,1,00472,India
962156,2023-05-21,502,iphone 15 pro max,100000,135000,35000,1,00473,India
637226,2023-05-21,505,oven,18490,24000,5510,1,00448,India
637226,2023-05-21,506,monitor,3249,8000,4751,1,00448,India
213642,2023-05-21,504,iron,449,879,430,1,00197,India
319304,2023-05-21,502,iphone 15 pro max,100000,135000,35000,1,00499,India
319304,2023-05-21,503,mixer,1349,3249,1900,1,00499,India
319304,2023-05-21,506,monitor,3249,8000,4751,1,00499,India
923606,2023-05-21,504,iron,449,879,430,1,00113,India
923606,2023-05-21,503,mixer,1349,3249,1900,1,00113,India
923606,2023-05-21,507,washing machine,6990,16490,9500,1,00113,India
923606,2023-05-21,502,iphone 15 pro max,100000,135000,35000,1,00113,India
634352,2023-05-21,506,monitor,3249,8000,4751,1,00107,India
634352,2023-05-21,507,washing machine,6990,16490,9500,1,00107,India
651011,2023-05-21,502,iphone 15 pro max,100000,135000,35000,1,00497,India
651011,2023-05-21,507,washing machine,6990,16490,9500,1,00497,India
651011,2023-05-21,504,iron,449,879,430,1,00497,India
175192,2023-05-21,505,oven,18490,24000,5510,1,00018,India
175192,2023-05-21,502,iphone 15 pro max,100000,135000,35000,1,00018,India
598251,2023-05-21,501,iphone 15,60000,80000,20000,1,00490,India
598251,2023-05-21,503,mixer,1349,3249,1900,1,00490,India
598251,2023-05-21,502,iphone 15 pro max,100000,135000,35000,1,00490,India
598251,2023-05-21,505,oven,18490,24000,5510,1,00490,India
121449,2023-05-21,504,iron,449,879,430,1,00170,India
121449,2023-05-21,505,oven,18490,24000,5510,1,00170,India
404286,2023-05-21,506,monitor,3249,8000,4751,1,00059,India
974311,2023-05-21,506,monitor,3249,8000,4751,1,00106,India
637312,2023-05-21,505,oven,18490,24000,5510,1,00272,India
637312,2023-05-21,506,monitor,3249,8000,4751,1,00272,India
530724,2023-05-21,507,washing machine,6990,16490,9500,1,00415,India
530724,2023-05-21,504,iron,449,879,430,1,00415,India
530724,2023-05-21,505,oven,18490,24000,5510,1,00415,India
530724,2023-05-21,502,iphone 15 pro max,100000,135000,35000,1,00415,India
589787,2023-05-21,502,iphone 15 pro max,100000,135000,35000,1,00379,India
591203,2023-05-21,503,mixer,1349,3249,1900,1,00313,India
262119,2023-05-21,501,iphone 15,60000,80000,20000,1,00216,India
853308,2023-05-21,504,iron,449,879,430,1,00031,India
853308,2023-05-21,503,mixer,1349,3249,1900,1,00031,India
853308,2023-05-21,506,monitor,3249,8000,4751,1,00031,India
853308,2023-05-21,502,iphone 15 pro max,100000,135000,35000,1,00031,India
821206,2023-05-21,502,iphone 15 pro max,100000,135000,35000,1,00237,India
821206,2023-05-21,507,washing machine,6990,16490,9500,1,00237,India
833432,2023-05-21,507,washing machine,6990,16490,9500,1,00388,India
833432,2023-05-21,503,mixer,1349,3249,1900,1,00388,India
833432,2023-05-21,501,iphone 15,60000,80000,20000,1,00388,India
833432,2023-05-21,504,iron,449,879,430,1,00388,India
916827,2023-05-21,501,iphone 15,60000,80000,20000,1,00286,India
916827,2023-05-21,502,iphone 15 pro max,100000,135000,35000,1,00286,India
916827,2023-05-21,507,washing machine,6990,16490,9500,1,00286,India
935384,2023-05-21,502,iphone 15 pro max,100000,135000,35000,1,00260,India
935384,2023-05-21,501,iphone 15,60000,80000,20000,1,00260,India
935384,2023-05-21,503,mixer,1349,3249,1900,1,00260,India
125090,2023-05-21,506,monitor,3249,8000,4751,1,00383,India
125090,2023-05-21,502,iphone 15 pro max,100000,135000,35000,1,00383,India
125090,2023-05-21,503,mixer,1349,3249,1900,1,00383,India
125090,2023-05-21,505,oven,18490,24000,5510,1,00383,India
803537,2023-05-22,501,iphone 15,60000,80000,20000,1,00435,India
589511,2023-05-22,501,iphone 15,60000,80000,20000,1,00355,India
589511,2023-05-22,504,iron,449,879,430,1,00355,India
589511,2023-05-22,506,monitor,3249,8000,4751,1,00355,India
526948,2023-05-22,502,iphone 15 pro max,100000,135000,35000,1,00377,India
200640,2023-05-22,506,monitor,3249,8000,4751,1,00355,India
200640,2023-05-22,505,oven,18490,24000,5510,1,00355,India
200640,2023-05-22,503,mixer,1349,3249,1900,1,00355,India
200640,2023-05-22,501,iphone 15,60000,80000,20000,1,00355,India
964070,2023-05-22,501,iphone 15,60000,80000,20000,1,00464,India
964070,2023-05-22,502,iphone 15 pro max,100000,135000,35000,1,00464,India
964070,2023-05-22,506,monitor,3249,8000,4751,1,00464,India
964070,2023-05-22,505,oven,18490,24000,5510,1,00464,India
648263,2023-05-22,506,monitor,3249,8000,4751,1,00494,India
648263,2023-05-22,505,oven,18490,24000,5510,1,00494,India
517396,2023-05-22,507,washing machine,6990,16490,9500,1,00148,India
517396,2023-05-22,503,mixer,1349,3249,1900,1,00148,India
640315,2023-05-22,503,mixer,1349,3249,1900,1,00210,India
640315,2023-05-22,501,iphone 15,60000,80000,20000,1,00210,India
640315,2023-05-22,507,washing machine,6990,16490,9500,1,00210,India
917245,2023-05-22,507,washing machine,6990,16490,9500,1,00249,India
212158,2023-05-22,507,washing machine,6990,16490,9500,1,00258,India
212158,2023-05-22,505,oven,18490,24000,5510,1,00258,India
471044,2023-05-22,503,mixer,1349,3249,1900,1,00176,India
426801,2023-05-22,502,iphone 15 pro max,100000,135000,35000,1,00491,India
426801,2023-05-22,507,washing machine,6990,16490,9500,1,00491,India
426801,2023-05-22,506,monitor,3249,8000,4751,1,00491,India
290801,2023-05-22,503,mixer,1349,3249,1900,1,00480,India
290801,2023-05-22,502,iphone 15 pro max,100000,135000,35000,1,00480,India
581414,2023-05-22,505,oven,18490,24000,5510,1,00307,India
799628,2023-05-22,506,monitor,3249,8000,4751,1,00299,India
813685,2023-05-22,507,washing machine,6990,16490,9500,1,00358,India
813685,2023-05-22,505,oven,18490,24000,5510,1,00358,India
639992,2023-05-22,503,mixer,1349,3249,1900,1,00254,India
639992,2023-05-22,507,washing machine,6990,16490,9500,1,00254,India
639992,2023-05-22,501,iphone 15,60000,80000,20000,1,00254,India
300966,2023-05-22,507,washing machine,6990,16490,9500,1,00244,India
300966,2023-05-22,503,mixer,1349,3249,1900,1,00244,India
300966,2023-05-22,504,iron,449,879,430,1,00244,India
300966,2023-05-22,505,oven,18490,24000,5510,1,00244,India
672398,2023-05-22,501,iphone 15,60000,80000,20000,1,00083,India
672398,2023-05-22,506,monitor,3249,8000,4751,1,00083,India
672398,2023-05-22,505,oven,18490,24000,5510,1,00083,India
219553,2023-05-22,507,washing machine,6990,16490,9500,1,00165,India
219553,2023-05-22,503,mixer,1349,3249,1900,1,00165,India
943444,2023-05-22,503,mixer,1349,3249,1900,1,00468,India
943444,2023-05-22,502,iphone 15 pro max,100000,135000,35000,1,00468,India
943444,2023-05-22,505,oven,18490,24000,5510,1,00468,India
943444,2023-05-22,506,monitor,3249,8000,4751,1,00468,India
362420,2023-05-22,504,iron,449,879,430,1,00160,India
362420,2023-05-22,506,monitor,3249,8000,4751,1,00160,India
362420,2023-05-22,507,washing machine,6990,16490,9500,1,00160,India
362420,2023-05-22,505,oven,18490,24000,5510,1,00160,India
767649,2023-05-22,507,washing machine,6990,16490,9500,1,00004,India
767649,2023-05-22,505,oven,18490,24000,5510,1,00004,India
767649,2023-05-22,502,iphone 15 pro max,100000,135000,35000,1,00004,India
741798,2023-05-22,501,iphone 15,60000,80000,20000,1,00281,India
741798,2023-05-22,507,washing machine,6990,16490,9500,1,00281,India
563014,2023-05-22,502,iphone 15 pro max,100000,135000,35000,1,00208,India
911263,2023-05-22,503,mixer,1349,3249,1900,1,00043,India
911263,2023-05-22,506,monitor,3249,8000,4751,1,00043,India
911263,2023-05-22,501,iphone 15,60000,80000,20000,1,00043,India
911263,2023-05-22,502,iphone 15 pro max,100000,135000,35000,1,00043,India
196992,2023-05-22,504,iron,449,879,430,1,00067,India
196992,2023-05-22,507,washing machine,6990,16490,9500,1,00067,India
196992,2023-05-22,505,oven,18490,24000,5510,1,00067,India
240210,2023-05-22,506,monitor,3249,8000,4751,1,00238,India
240210,2023-05-22,502,iphone 15 pro max,100000,135000,35000,1,00238,India
240210,2023-05-22,507,washing machine,6990,16490,9500,1,00238,India
524205,2023-05-22,504,iron,449,879,430,1,00345,India
524205,2023-05-22,502,iphone 15 pro max,100000,135000,35000,1,00345,India
524205,2023-05-22,505,oven,18490,24000,5510,1,00345,India
524205,2023-05-22,503,mixer,1349,3249,1900,1,00345,India
961796,2023-05-22,503,mixer,1349,3249,1900,1,00114,India
961796,2023-05-22,507,washing machine,6990,16490,9500,1,00114,India
631657,2023-05-22,503,mixer,1349,3249,1900,1,00034,India
776980,2023-05-22,503,mixer,1349,3249,1900,1,00082,India
756997,2023-05-22,506,monitor,3249,8000,4751,1,00405,India
756997,2023-05-22,505,oven,18490,24000,5510,1,00405,India
756997,2023-05-22,502,iphone 15 pro max,100000,135000,35000,1,00405,India
658444,2023-05-22,502,iphone 15 pro max,100000,135000,35000,1,00220,India
658444,2023-05-22,503,mixer,1349,3249,1900,1,00220,India
801713,2023-05-22,504,iron,449,879,430,1,00055,India
801713,2023-05-22,505,oven,18490,24000,5510,1,00055,India
801713,2023-05-22,507,washing machine,6990,16490,9500,1,00055,India
148677,2023-05-22,507,washing machine,6990,16490,9500,1,00219,India
148677,2023-05-22,506,monitor,3249,8000,4751,1,00219,India
403892,2023-05-22,501,iphone 15,60000,80000,20000,1,00334,India
403892,2023-05-22,505,oven,18490,24000,5510,1,00334,India
403892,2023-05-22,506,monitor,3249,8000,4751,1,00334,India
863927,2023-05-22,504,iron,449,879,430,1,00484,India
863927,2023-05-22,503,mixer,1349,3249,1900,1,00484,India
863927,2023-05-22,505,oven,18490,24000,5510,1,00484,India
863927,2023-05-22,501,iphone 15,60000,80000,20000,1,00484,India
863927,2023-05-22,507,washing machine,6990,16490,9500,1,00484,India
113437,2023-05-22,502,iphone 15 pro max,100000,135000,35000,1,00390,India
113437,2023-05-22,501,iphone 15,60000,80000,20000,1,00390,India
846457,2023-05-22,502,iphone 15 pro max,100000,135000,35000,1,00200,India
846457,2023-05-22,503,mixer,1349,3249,1900,1,00200,India
846457,2023-05-22,501,iphone 15,60000,80000,20000,1,00200,India
846457,2023-05-22,505,oven,18490,24000,5510,1,00200,India
986811,2023-05-22,505,oven,18490,24000,5510,1,00353,India
986811,2023-05-22,503,mixer,1349,3249,1900,1,00353,India
986811,2023-05-22,506,monitor,3249,8000,4751,1,00353,India
608843,2023-05-22,506,monitor,3249,8000,4751,1,00333,India
608843,2023-05-22,503,mixer,1349,3249,1900,1,00333,India
608843,2023-05-22,504,iron,449,879,430,1,00333,India
608843,2023-05-22,505,oven,18490,24000,5510,1,00333,India
403981,2023-05-22,503,mixer,1349,3249,1900,1,00126,India
403981,2023-05-22,502,iphone 15 pro max,100000,135000,35000,1,00126,India
403981,2023-05-22,501,iphone 15,60000,80000,20000,1,00126,India
630890,2023-05-22,506,monitor,3249,8000,4751,1,00207,India
630890,2023-05-22,502,iphone 15 pro max,100000,135000,35000,1,00207,India
630890,2023-05-22,505,oven,18490,24000,5510,1,00207,India
630890,2023-05-22,504,iron,449,879,430,1,00207,India
596215,2023-05-22,503,mixer,1349,3249,1900,1,00084,India
596215,2023-05-22,501,iphone 15,60000,80000,20000,1,00084,India
596215,2023-05-22,507,washing machine,6990,16490,9500,1,00084,India
723341,2023-05-22,505,oven,18490,24000,5510,1,00441,India
723341,2023-05-22,503,mixer,1349,3249,1900,1,00441,India
719825,2023-05-22,507,washing machine,6990,16490,9500,1,00035,India
533437,2023-05-22,501,iphone 15,60000,80000,20000,1,00262,India
770186,2023-05-22,502,iphone 15 pro max,100000,135000,35000,1,00298,India
770186,2023-05-22,503,mixer,1349,3249,1900,1,00298,India
770186,2023-05-22,507,washing machine,6990,16490,9500,1,00298,India
764618,2023-05-22,504,iron,449,879,430,1,00493,India
764618,2023-05-22,507,washing machine,6990,16490,9500,1,00493,India
764618,2023-05-22,506,monitor,3249,8000,4751,1,00493,India
617418,2023-05-22,503,mixer,1349,3249,1900,1,00290,India
617418,2023-05-22,506,monitor,3249,8000,4751,1,00290,India
617418,2023-05-22,502,iphone 15 pro max,100000,135000,35000,1,00290,India
617418,2023-05-22,504,iron,449,879,430,1,00290,India
832574,2023-05-22,501,iphone 15,60000,80000,20000,1,00218,India
832574,2023-05-22,503,mixer,1349,3249,1900,1,00218,India
786439,2023-05-22,503,mixer,1349,3249,1900,1,00323,India
786439,2023-05-22,502,iphone 15 pro max,100000,135000,35000,1,00323,India
839736,2023-05-22,504,iron,449,879,430,1,00087,India
839736,2023-05-22,502,iphone 15 pro max,100000,135000,35000,1,00087,India
839736,2023-05-22,503,mixer,1349,3249,1900,1,00087,India
128187,2023-05-22,504,iron,449,879,430,1,00437,India
128187,2023-05-22,505,oven,18490,24000,5510,1,00437,India
128187,2023-05-22,501,iphone 15,60000,80000,20000,1,00437,India
101400,2023-05-22,506,monitor,3249,8000,4751,1,00142,India
887037,2023-05-22,505,oven,18490,24000,5510,1,00366,India
658469,2023-05-22,502,iphone 15 pro max,100000,135000,35000,1,00237,India
658469,2023-05-22,503,mixer,1349,3249,1900,1,00237,India
658469,2023-05-22,504,iron,449,879,430,1,00237,India
368891,2023-05-22,506,monitor,3249,8000,4751,1,00413,India
368891,2023-05-22,505,oven,18490,24000,5510,1,00413,India
282519,2023-05-22,502,iphone 15 pro max,100000,135000,35000,1,00413,India
778916,2023-05-22,501,iphone 15,60000,80000,20000,1,00371,India
908763,2023-05-23,506,monitor,3249,8000,4751,1,00021,India
908763,2023-05-23,502,iphone 15 pro max,100000,135000,35000,1,00021,India
459569,2023-05-23,506,monitor,3249,8000,4751,1,00231,India
459569,2023-05-23,507,washing machine,6990,16490,9500,1,00231,India
342797,2023-05-23,504,iron,449,879,430,1,00281,India
342797,2023-05-23,507,washing machine,6990,16490,9500,1,00281,India
342797,2023-05-23,503,mixer,1349,3249,1900,1,00281,India
342797,2023-05-23,505,oven,18490,24000,5510,1,00281,India
538441,2023-05-23,503,mixer,1349,3249,1900,1,00192,India
538441,2023-05-23,502,iphone 15 pro max,100000,135000,35000,1,00192,India
775659,2023-05-23,503,mixer,1349,3249,1900,1,00118,India
775659,2023-05-23,505,oven,18490,24000,5510,1,00118,India
114628,2023-05-23,506,monitor,3249,8000,4751,1,00085,India
114628,2023-05-23,505,oven,18490,24000,5510,1,00085,India
419870,2023-05-23,505,oven,18490,24000,5510,1,00309,India
419870,2023-05-23,504,iron,449,879,430,1,00309,India
419870,2023-05-23,506,monitor,3249,8000,4751,1,00309,India
419870,2023-05-23,501,iphone 15,60000,80000,20000,1,00309,India
584076,2023-05-23,507,washing machine,6990,16490,9500,1,00353,India
584076,2023-05-23,504,iron,449,879,430,1,00353,India
584076,2023-05-23,503,mixer,1349,3249,1900,1,00353,India
584076,2023-05-23,506,monitor,3249,8000,4751,1,00353,India
908609,2023-05-23,504,iron,449,879,430,1,00093,India
908609,2023-05-23,502,iphone 15 pro max,100000,135000,35000,1,00093,India
908609,2023-05-23,503,mixer,1349,3249,1900,1,00093,India
908609,2023-05-23,501,iphone 15,60000,80000,20000,1,00093,India
532398,2023-05-23,503,mixer,1349,3249,1900,1,00434,India
532398,2023-05-23,506,monitor,3249,8000,4751,1,00434,India
532398,2023-05-23,505,oven,18490,24000,5510,1,00434,India
914651,2023-05-23,502,iphone 15 pro max,100000,135000,35000,1,00165,India
630236,2023-05-23,506,monitor,3249,8000,4751,1,00151,India
630236,2023-05-23,502,iphone 15 pro max,100000,135000,35000,1,00151,India
630236,2023-05-23,504,iron,449,879,430,1,00151,India
859351,2023-05-23,501,iphone 15,60000,80000,20000,1,00024,India
859351,2023-05-23,505,oven,18490,24000,5510,1,00024,India
859351,2023-05-23,507,washing machine,6990,16490,9500,1,00024,India
859351,2023-05-23,504,iron,449,879,430,1,00024,India
705873,2023-05-23,503,mixer,1349,3249,1900,1,00203,India
546714,2023-05-23,503,mixer,1349,3249,1900,1,00212,India
546714,2023-05-23,504,iron,449,879,430,1,00212,India
378107,2023-05-23,501,iphone 15,60000,80000,20000,1,00406,India
378107,2023-05-23,503,mixer,1349,3249,1900,1,00406,India
378107,2023-05-23,506,monitor,3249,8000,4751,1,00406,India
378107,2023-05-23,502,iphone 15 pro max,100000,135000,35000,1,00406,India
378107,2023-05-23,505,oven,18490,24000,5510,1,00406,India
125129,2023-05-23,504,iron,449,879,430,1,00348,India
125129,2023-05-23,507,washing machine,6990,16490,9500,1,00348,India
125129,2023-05-23,502,iphone 15 pro max,100000,135000,35000,1,00348,India
326959,2023-05-23,505,oven,18490,24000,5510,1,00495,India
777999,2023-05-23,503,mixer,1349,3249,1900,1,00050,India
777999,2023-05-23,507,washing machine,6990,16490,9500,1,00050,India
777999,2023-05-23,504,iron,449,879,430,1,00050,India
240916,2023-05-23,505,oven,18490,24000,5510,1,00111,India
240916,2023-05-23,507,washing machine,6990,16490,9500,1,00111,India
240916,2023-05-23,504,iron,449,879,430,1,00111,India
240916,2023-05-23,503,mixer,1349,3249,1900,1,00111,India
240916,2023-05-23,506,monitor,3249,8000,4751,1,00111,India
533126,2023-05-23,504,iron,449,879,430,1,00439,India
533126,2023-05-23,503,mixer,1349,3249,1900,1,00439,India
533126,2023-05-23,502,iphone 15 pro max,100000,135000,35000,1,00439,India
533126,2023-05-23,506,monitor,3249,8000,4751,1,00439,India
131662,2023-05-23,507,washing machine,6990,16490,9500,1,00391,India
131662,2023-05-23,504,iron,449,879,430,1,00391,India
131662,2023-05-23,506,monitor,3249,8000,4751,1,00391,India
693641,2023-05-23,504,iron,449,879,430,1,00339,India
693641,2023-05-23,505,oven,18490,24000,5510,1,00339,India
693641,2023-05-23,503,mixer,1349,3249,1900,1,00339,India
279971,2023-05-23,504,iron,449,879,430,1,00158,India
279971,2023-05-23,503,mixer,1349,3249,1900,1,00158,India
872309,2023-05-23,504,iron,449,879,430,1,00178,India
872309,2023-05-23,505,oven,18490,24000,5510,1,00178,India
872309,2023-05-23,501,iphone 15,60000,80000,20000,1,00178,India
607548,2023-05-23,505,oven,18490,24000,5510,1,00349,India
176581,2023-05-23,506,monitor,3249,8000,4751,1,00290,India
964971,2023-05-23,506,monitor,3249,8000,4751,1,00385,India
964971,2023-05-23,505,oven,18490,24000,5510,1,00385,India
964971,2023-05-23,507,washing machine,6990,16490,9500,1,00385,India
964971,2023-05-23,502,iphone 15 pro max,100000,135000,35000,1,00385,India
901880,2023-05-23,502,iphone 15 pro max,100000,135000,35000,1,00420,India
901880,2023-05-23,507,washing machine,6990,16490,9500,1,00420,India
901880,2023-05-23,504,iron,449,879,430,1,00420,India
901880,2023-05-23,506,monitor,3249,8000,4751,1,00420,India
136658,2023-05-23,501,iphone 15,60000,80000,20000,1,00233,India
297659,2023-05-23,501,iphone 15,60000,80000,20000,1,00323,India
788294,2023-05-23,505,oven,18490,24000,5510,1,00020,India
262583,2023-05-23,504,iron,449,879,430,1,00456,India
262583,2023-05-23,501,iphone 15,60000,80000,20000,1,00456,India
889411,2023-05-23,501,iphone 15,60000,80000,20000,1,00447,India
889411,2023-05-23,506,monitor,3249,8000,4751,1,00447,India
254536,2023-05-23,503,mixer,1349,3249,1900,1,00110,India
254536,2023-05-23,504,iron,449,879,430,1,00110,India
254536,2023-05-23,501,iphone 15,60000,80000,20000,1,00110,India
143032,2023-05-23,507,washing machine,6990,16490,9500,1,00188,India
143032,2023-05-23,504,iron,449,879,430,1,00188,India
660071,2023-05-23,504,iron,449,879,430,1,00072,India
660071,2023-05-23,507,washing machine,6990,16490,9500,1,00072,India
660071,2023-05-23,502,iphone 15 pro max,100000,135000,35000,1,00072,India
902297,2023-05-23,505,oven,18490,24000,5510,1,00453,India
902297,2023-05-23,501,iphone 15,60000,80000,20000,1,00453,India
902297,2023-05-23,502,iphone 15 pro max,100000,135000,35000,1,00453,India
645068,2023-05-23,507,washing machine,6990,16490,9500,1,00305,India
877710,2023-05-23,501,iphone 15,60000,80000,20000,1,00203,India
101715,2023-05-23,506,monitor,3249,8000,4751,1,00432,India
101715,2023-05-23,501,iphone 15,60000,80000,20000,1,00432,India
101715,2023-05-23,507,washing machine,6990,16490,9500,1,00432,India
101715,2023-05-23,502,iphone 15 pro max,100000,135000,35000,1,00432,India
102416,2023-05-23,505,oven,18490,24000,5510,1,00137,India
102416,2023-05-23,507,washing machine,6990,16490,9500,1,00137,India
102416,2023-05-23,501,iphone 15,60000,80000,20000,1,00137,India
102416,2023-05-23,503,mixer,1349,3249,1900,1,00137,India
200946,2023-05-23,503,mixer,1349,3249,1900,1,00031,India
571037,2023-05-23,505,oven,18490,24000,5510,1,00292,India
571037,2023-05-23,502,iphone 15 pro max,100000,135000,35000,1,00292,India
571037,2023-05-23,507,washing machine,6990,16490,9500,1,00292,India
571037,2023-05-23,506,monitor,3249,8000,4751,1,00292,India
619373,2023-05-23,505,oven,18490,24000,5510,1,00289,India
619373,2023-05-23,506,monitor,3249,8000,4751,1,00289,India
619373,2023-05-23,502,iphone 15 pro max,100000,135000,35000,1,00289,India
566247,2023-05-23,506,monitor,3249,8000,4751,1,00374,India
566247,2023-05-23,507,washing machine,6990,16490,9500,1,00374,India
566247,2023-05-23,502,iphone 15 pro max,100000,135000,35000,1,00374,India
443456,2023-05-23,504,iron,449,879,430,1,00277,India
821091,2023-05-23,503,mixer,1349,3249,1900,1,00295,India
420403,2023-05-23,502,iphone 15 pro max,100000,135000,35000,1,00223,India
420403,2023-05-23,505,oven,18490,24000,5510,1,00223,India
420403,2023-05-23,506,monitor,3249,8000,4751,1,00223,India
557265,2023-05-23,506,monitor,3249,8000,4751,1,00487,India
557265,2023-05-23,507,washing machine,6990,16490,9500,1,00487,India
531466,2023-05-23,501,iphone 15,60000,80000,20000,1,00164,India
802583,2023-05-23,503,mixer,1349,3249,1900,1,00142,India
744767,2023-05-23,501,iphone 15,60000,80000,20000,1,00340,India
571258,2023-05-24,505,oven,18490,24000,5510,1,00179,India
571258,2023-05-24,506,monitor,3249,8000,4751,1,00179,India
571258,2023-05-24,504,iron,449,879,430,1,00179,India
588257,2023-05-24,506,monitor,3249,8000,4751,1,00098,India
588257,2023-05-24,503,mixer,1349,3249,1900,1,00098,India
162173,2023-05-24,501,iphone 15,60000,80000,20000,1,00192,India
162173,2023-05-24,505,oven,18490,24000,5510,1,00192,India
632906,2023-05-24,507,washing machine,6990,16490,9500,1,00394,India
632906,2023-05-24,501,iphone 15,60000,80000,20000,1,00394,India
632906,2023-05-24,503,mixer,1349,3249,1900,1,00394,India
609001,2023-05-24,506,monitor,3249,8000,4751,1,00148,India
609001,2023-05-24,503,mixer,1349,3249,1900,1,00148,India
647505,2023-05-24,506,monitor,3249,8000,4751,1,00416,India
647505,2023-05-24,507,washing machine,6990,16490,9500,1,00416,India
647505,2023-05-24,503,mixer,1349,3249,1900,1,00416,India
115665,2023-05-24,505,oven,18490,24000,5510,1,00415,India
115665,2023-05-24,503,mixer,1349,3249,1900,1,00415,India
295700,2023-05-24,505,oven,18490,24000,5510,1,00403,India
295700,2023-05-24,503,mixer,1349,3249,1900,1,00403,India
295700,2023-05-24,506,monitor,3249,8000,4751,1,00403,India
295700,2023-05-24,507,washing machine,6990,16490,9500,1,00403,India
628151,2023-05-24,505,oven,18490,24000,5510,1,00325,India
628151,2023-05-24,501,iphone 15,60000,80000,20000,1,00325,India
628151,2023-05-24,502,iphone 15 pro max,100000,135000,35000,1,00325,India
628151,2023-05-24,504,iron,449,879,430,1,00325,India
737810,2023-05-24,506,monitor,3249,8000,4751,1,00246,India
737810,2023-05-24,501,iphone 15,60000,80000,20000,1,00246,India
107125,2023-05-24,503,mixer,1349,3249,1900,1,00258,India
107125,2023-05-24,502,iphone 15 pro max,100000,135000,35000,1,00258,India
107125,2023-05-24,507,washing machine,6990,16490,9500,1,00258,India
232463,2023-05-24,507,washing machine,6990,16490,9500,1,00019,India
831510,2023-05-24,503,mixer,1349,3249,1900,1,00357,India
831510,2023-05-24,502,iphone 15 pro max,100000,135000,35000,1,00357,India
914204,2023-05-24,507,washing machine,6990,16490,9500,1,00268,India
914204,2023-05-24,502,iphone 15 pro max,100000,135000,35000,1,00268,India
914204,2023-05-24,501,iphone 15,60000,80000,20000,1,00268,India
934909,2023-05-24,504,iron,449,879,430,1,00488,India
412529,2023-05-24,503,mixer,1349,3249,1900,1,00365,India
412529,2023-05-24,507,washing machine,6990,16490,9500,1,00365,India
142582,2023-05-24,507,washing machine,6990,16490,9500,1,00045,India
250900,2023-05-24,501,iphone 15,60000,80000,20000,1,00374,India
250900,2023-05-24,503,mixer,1349,3249,1900,1,00374,India
761897,2023-05-24,501,iphone 15,60000,80000,20000,1,00442,India
761897,2023-05-24,506,monitor,3249,8000,4751,1,00442,India
545224,2023-05-24,506,monitor,3249,8000,4751,1,00256,India
545224,2023-05-24,507,washing machine,6990,16490,9500,1,00256,India
279896,2023-05-24,501,iphone 15,60000,80000,20000,1,00093,India
500227,2023-05-24,503,mixer,1349,3249,1900,1,00211,India
500227,2023-05-24,501,iphone 15,60000,80000,20000,1,00211,India
500227,2023-05-24,506,monitor,3249,8000,4751,1,00211,India
937896,2023-05-24,507,washing machine,6990,16490,9500,1,00007,India
937896,2023-05-24,505,oven,18490,24000,5510,1,00007,India
937896,2023-05-24,503,mixer,1349,3249,1900,1,00007,India
937896,2023-05-24,504,iron,449,879,430,1,00007,India
197834,2023-05-24,506,monitor,3249,8000,4751,1,00393,India
197834,2023-05-24,507,washing machine,6990,16490,9500,1,00393,India
197834,2023-05-24,502,iphone 15 pro max,100000,135000,35000,1,00393,India
197834,2023-05-24,504,iron,449,879,430,1,00393,India
101919,2023-05-24,503,mixer,1349,3249,1900,1,00159,India
101919,2023-05-24,501,iphone 15,60000,80000,20000,1,00159,India
101919,2023-05-24,507,washing machine,6990,16490,9500,1,00159,India
101919,2023-05-24,505,oven,18490,24000,5510,1,00159,India
987057,2023-05-24,506,monitor,3249,8000,4751,1,00230,India
987057,2023-05-24,501,iphone 15,60000,80000,20000,1,00230,India
987057,2023-05-24,503,mixer,1349,3249,1900,1,00230,India
987057,2023-05-24,504,iron,449,879,430,1,00230,India
292829,2023-05-24,503,mixer,1349,3249,1900,1,00168,India
511691,2023-05-24,505,oven,18490,24000,5510,1,00144,India
511691,2023-05-24,507,washing machine,6990,16490,9500,1,00144,India
511691,2023-05-24,504,iron,449,879,430,1,00144,India
511691,2023-05-24,501,iphone 15,60000,80000,20000,1,00144,India
110884,2023-05-24,502,iphone 15 pro max,100000,135000,35000,1,00344,India
110884,2023-05-24,505,oven,18490,24000,5510,1,00344,India
675511,2023-05-24,507,washing machine,6990,16490,9500,1,00431,India
675511,2023-05-24,506,monitor,3249,8000,4751,1,00431,India
179841,2023-05-24,502,iphone 15 pro max,100000,135000,35000,1,00399,India
179841,2023-05-24,505,oven,18490,24000,5510,1,00399,India
648572,2023-05-24,503,mixer,1349,3249,1900,1,00380,India
648572,2023-05-24,501,iphone 15,60000,80000,20000,1,00380,India
648572,2023-05-24,507,washing machine,6990,16490,9500,1,00380,India
648572,2023-05-24,502,iphone 15 pro max,100000,135000,35000,1,00380,India
922683,2023-05-24,501,iphone 15,60000,80000,20000,1,00324,India
922683,2023-05-24,503,mixer,1349,3249,1900,1,00324,India
705759,2023-05-24,503,mixer,1349,3249,1900,1,00209,India
705759,2023-05-24,507,washing machine,6990,16490,9500,1,00209,India
324937,2023-05-24,505,oven,18490,24000,5510,1,00154,India
324937,2023-05-24,507,washing machine,6990,16490,9500,1,00154,India
324937,2023-05-24,504,iron,449,879,430,1,00154,India
324937,2023-05-24,502,iphone 15 pro max,100000,135000,35000,1,00154,India
552825,2023-05-24,505,oven,18490,24000,5510,1,00017,India
552825,2023-05-24,506,monitor,3249,8000,4751,1,00017,India
437773,2023-05-24,506,monitor,3249,8000,4751,1,00296,India
437773,2023-05-24,505,oven,18490,24000,5510,1,00296,India
679016,2023-05-24,506,monitor,3249,8000,4751,1,00432,India
679016,2023-05-24,507,washing machine,6990,16490,9500,1,00432,India
679016,2023-05-24,502,iphone 15 pro max,100000,135000,35000,1,00432,India
679016,2023-05-24,504,iron,449,879,430,1,00432,India
779613,2023-05-24,505,oven,18490,24000,5510,1,00035,India
779613,2023-05-24,504,iron,449,879,430,1,00035,India
874085,2023-05-24,506,monitor,3249,8000,4751,1,00346,India
874085,2023-05-24,504,iron,449,879,430,1,00346,India
874085,2023-05-24,505,oven,18490,24000,5510,1,00346,India
874085,2023-05-24,503,mixer,1349,3249,1900,1,00346,India
685281,2023-05-24,503,mixer,1349,3249,1900,1,00001,India
685281,2023-05-24,502,iphone 15 pro max,100000,135000,35000,1,00001,India
685281,2023-05-24,504,iron,449,879,430,1,00001,India
371552,2023-05-24,506,monitor,3249,8000,4751,1,00178,India
371552,2023-05-24,503,mixer,1349,3249,1900,1,00178,India
371552,2023-05-24,507,washing machine,6990,16490,9500,1,00178,India
838932,2023-05-24,501,iphone 15,60000,80000,20000,1,00338,India
838932,2023-05-24,505,oven,18490,24000,5510,1,00338,India
882638,2023-05-24,503,mixer,1349,3249,1900,1,00118,India
882638,2023-05-24,502,iphone 15 pro max,100000,135000,35000,1,00118,India
940410,2023-05-24,506,monitor,3249,8000,4751,1,00209,India
735434,2023-05-24,504,iron,449,879,430,1,00290,India
735434,2023-05-24,505,oven,18490,24000,5510,1,00290,India
735434,2023-05-24,503,mixer,1349,3249,1900,1,00290,India
735434,2023-05-24,507,washing machine,6990,16490,9500,1,00290,India
952858,2023-05-24,503,mixer,1349,3249,1900,1,00500,India
923490,2023-05-24,506,monitor,3249,8000,4751,1,00101,India
923490,2023-05-24,507,washing machine,6990,16490,9500,1,00101,India
106152,2023-05-24,505,oven,18490,24000,5510,1,00331,India
106152,2023-05-24,504,iron,449,879,430,1,00331,India
106152,2023-05-24,503,mixer,1349,3249,1900,1,00331,India
106152,2023-05-24,501,iphone 15,60000,80000,20000,1,00331,India
883431,2023-05-24,507,washing machine,6990,16490,9500,1,00221,India
883431,2023-05-24,502,iphone 15 pro max,100000,135000,35000,1,00221,India
883431,2023-05-24,506,monitor,3249,8000,4751,1,00221,India
913906,2023-05-24,506,monitor,3249,8000,4751,1,00218,India
786853,2023-05-24,505,oven,18490,24000,5510,1,00267,India
786853,2023-05-24,503,mixer,1349,3249,1900,1,00267,India
786853,2023-05-24,506,monitor,3249,8000,4751,1,00267,India
239192,2023-05-24,506,monitor,3249,8000,4751,1,00128,India
239192,2023-05-24,501,iphone 15,60000,80000,20000,1,00128,India
662585,2023-05-24,503,mixer,1349,3249,1900,1,00402,India
431400,2023-05-24,504,iron,449,879,430,1,00346,India
431400,2023-05-24,501,iphone 15,60000,80000,20000,1,00346,India
431400,2023-05-24,505,oven,18490,24000,5510,1,00346,India
703150,2023-05-24,503,mixer,1349,3249,1900,1,00256,India
703150,2023-05-24,504,iron,449,879,430,1,00256,India
703150,2023-05-24,505,oven,18490,24000,5510,1,00256,India
628503,2023-05-24,504,iron,449,879,430,1,00433,India
628503,2023-05-24,506,monitor,3249,8000,4751,1,00433,India
976471,2023-05-24,504,iron,449,879,430,1,00420,India
976471,2023-05-24,502,iphone 15 pro max,100000,135000,35000,1,00420,India
562000,2023-05-24,505,oven,18490,24000,5510,1,00002,India
562000,2023-05-24,504,iron,449,879,430,1,00002,India
562000,2023-05-24,501,iphone 15,60000,80000,20000,1,00002,India
591426,2023-05-24,506,monitor,3249,8000,4751,1,00143,India
635531,2023-05-24,503,mixer,1349,3249,1900,1,00010,India
635531,2023-05-24,502,iphone 15 pro max,100000,135000,35000,1,00010,India
635531,2023-05-24,505,oven,18490,24000,5510,1,00010,India
549586,2023-05-24,503,mixer,1349,3249,1900,1,00006,India
549586,2023-05-24,502,iphone 15 pro max,100000,135000,35000,1,00006,India
549586,2023-05-24,507,washing machine,6990,16490,9500,1,00006,India
685426,2023-05-24,507,washing machine,6990,16490,9500,1,00413,India
685426,2023-05-24,501,iphone 15,60000,80000,20000,1,00413,India
685426,2023-05-24,504,iron,449,879,430,1,00413,India
685426,2023-05-24,502,iphone 15 pro max,100000,135000,35000,1,00413,India
482553,2023-05-24,504,iron,449,879,430,1,00217,India
482553,2023-05-24,506,monitor,3249,8000,4751,1,00217,India
482553,2023-05-24,507,washing machine,6990,16490,9500,1,00217,India
267720,2023-05-24,504,iron,449,879,430,1,00332,India
267720,2023-05-24,502,iphone 15 pro max,100000,135000,35000,1,00332,India
267720,2023-05-24,501,iphone 15,60000,80000,20000,1,00332,India
267720,2023-05-24,506,monitor,3249,8000,4751,1,00332,India
117485,2023-05-24,507,washing machine,6990,16490,9500,1,00163,India
117485,2023-05-24,502,iphone 15 pro max,100000,135000,35000,1,00163,India
723148,2023-05-24,507,washing machine,6990,16490,9500,1,00280,India
723148,2023-05-24,505,oven,18490,24000,5510,1,00280,India
549778,2023-05-24,505,oven,18490,24000,5510,1,00049,India
549778,2023-05-24,503,mixer,1349,3249,1900,1,00049,India
549778,2023-05-24,502,iphone 15 pro max,100000,135000,35000,1,00049,India
747689,2023-05-24,503,mixer,1349,3249,1900,1,00394,India
527096,2023-05-24,502,iphone 15 pro max,100000,135000,35000,1,00492,India
527096,2023-05-24,505,oven,18490,24000,5510,1,00492,India
822872,2023-05-24,501,iphone 15,60000,80000,20000,1,00039,India
822872,2023-05-24,502,iphone 15 pro max,100000,135000,35000,1,00039,India
822872,2023-05-24,503,mixer,1349,3249,1900,1,00039,India
822872,2023-05-24,506,monitor,3249,8000,4751,1,00039,India
310478,2023-05-24,506,monitor,3249,8000,4751,1,00492,India
846320,2023-05-24,505,oven,18490,24000,5510,1,00443,India
846320,2023-05-24,501,iphone 15,60000,80000,20000,1,00443,India
846320,2023-05-24,502,iphone 15 pro max,100000,135000,35000,1,00443,India
444704,2023-05-24,507,washing machine,6990,16490,9500,1,00098,India
444704,2023-05-24,504,iron,449,879,430,1,00098,India
444704,2023-05-24,506,monitor,3249,8000,4751,1,00098,India
693937,2023-05-24,505,oven,18490,24000,5510,1,00247,India
693937,2023-05-24,506,monitor,3249,8000,4751,1,00247,India
693937,2023-05-24,504,iron,449,879,430,1,00247,India
766430,2023-05-24,503,mixer,1349,3249,1900,1,00227,India
766430,2023-05-24,502,iphone 15 pro max,100000,135000,35000,1,00227,India
766430,2023-05-24,506,monitor,3249,8000,4751,1,00227,India
766430,2023-05-24,505,oven,18490,24000,5510,1,00227,India
307070,2023-05-24,501,iphone 15,60000,80000,20000,1,00437,India
307070,2023-05-24,503,mixer,1349,3249,1900,1,00437,India
307070,2023-05-24,504,iron,449,879,430,1,00437,India
548017,2023-05-24,505,oven,18490,24000,5510,1,00132,India
110382,2023-05-24,502,iphone 15 pro max,100000,135000,35000,1,00307,India
110382,2023-05-24,503,mixer,1349,3249,1900,1,00307,India
110382,2023-05-24,507,washing machine,6990,16490,9500,1,00307,India
766269,2023-05-24,503,mixer,1349,3249,1900,1,00396,India
766269,2023-05-24,504,iron,449,879,430,1,00396,India
766269,2023-05-24,506,monitor,3249,8000,4751,1,00396,India
766269,2023-05-24,507,washing machine,6990,16490,9500,1,00396,India
135377,2023-05-24,507,washing machine,6990,16490,9500,1,00184,India
135377,2023-05-24,506,monitor,3249,8000,4751,1,00184,India
135377,2023-05-24,503,mixer,1349,3249,1900,1,00184,India
438983,2023-05-24,505,oven,18490,24000,5510,1,00177,India
323129,2023-05-24,503,mixer,1349,3249,1900,1,00240,India
323129,2023-05-24,505,oven,18490,24000,5510,1,00240,India
361337,2023-05-24,501,iphone 15,60000,80000,20000,1,00131,India
361337,2023-05-24,504,iron,449,879,430,1,00131,India
361337,2023-05-24,503,mixer,1349,3249,1900,1,00131,India
413241,2023-05-24,507,washing machine,6990,16490,9500,1,00450,India
413241,2023-05-24,505,oven,18490,24000,5510,1,00450,India
413241,2023-05-24,506,monitor,3249,8000,4751,1,00450,India
413241,2023-05-24,501,iphone 15,60000,80000,20000,1,00450,India
637543,2023-05-24,504,iron,449,879,430,1,00279,India
128836,2023-05-24,504,iron,449,879,430,1,00144,India
933714,2023-05-24,502,iphone 15 pro max,100000,135000,35000,1,00463,India
158136,2023-05-24,507,washing machine,6990,16490,9500,1,00023,India
158136,2023-05-24,504,iron,449,879,430,1,00023,India
158136,2023-05-24,502,iphone 15 pro max,100000,135000,35000,1,00023,India
752503,2023-05-24,501,iphone 15,60000,80000,20000,1,00363,India
287261,2023-05-25,507,washing machine,6990,16490,9500,1,00367,India
287261,2023-05-25,504,iron,449,879,430,1,00367,India
894880,2023-05-25,506,monitor,3249,8000,4751,1,00334,India
894880,2023-05-25,503,mixer,1349,3249,1900,1,00334,India
894880,2023-05-25,505,oven,18490,24000,5510,1,00334,India
894880,2023-05-25,502,iphone 15 pro max,100000,135000,35000,1,00334,India
409050,2023-05-25,501,iphone 15,60000,80000,20000,1,00179,India
409050,2023-05-25,507,washing machine,6990,16490,9500,1,00179,India
881697,2023-05-25,502,iphone 15 pro max,100000,135000,35000,1,00447,India
854510,2023-05-25,501,iphone 15,60000,80000,20000,1,00498,India
854510,2023-05-25,505,oven,18490,24000,5510,1,00498,India
854510,2023-05-25,507,washing machine,6990,16490,9500,1,00498,India
163028,2023-05-25,503,mixer,1349,3249,1900,1,00066,India
163028,2023-05-25,506,monitor,3249,8000,4751,1,00066,India
627380,2023-05-25,505,oven,18490,24000,5510,1,00008,India
627380,2023-05-25,507,washing machine,6990,16490,9500,1,00008,India
627380,2023-05-25,504,iron,449,879,430,1,00008,India
553026,2023-05-25,505,oven,18490,24000,5510,1,00243,India
553026,2023-05-25,503,mixer,1349,3249,1900,1,00243,India
553026,2023-05-25,504,iron,449,879,430,1,00243,India
235115,2023-05-25,505,oven,18490,24000,5510,1,00350,India
235115,2023-05-25,504,iron,449,879,430,1,00350,India
528766,2023-05-25,504,iron,449,879,430,1,00179,India
449340,2023-05-25,507,washing machine,6990,16490,9500,1,00083,India
449340,2023-05-25,504,iron,449,879,430,1,00083,India
449340,2023-05-25,502,iphone 15 pro max,100000,135000,35000,1,00083,India
449340,2023-05-25,501,iphone 15,60000,80000,20000,1,00083,India
599211,2023-05-25,504,iron,449,879,430,1,00107,India
819916,2023-05-25,504,iron,449,879,430,1,00041,India
773726,2023-05-25,501,iphone 15,60000,80000,20000,1,00322,India
773726,2023-05-25,505,oven,18490,24000,5510,1,00322,India
773726,2023-05-25,507,washing machine,6990,16490,9500,1,00322,India
533100,2023-05-25,504,iron,449,879,430,1,00441,India
533100,2023-05-25,506,monitor,3249,8000,4751,1,00441,India
533100,2023-05-25,505,oven,18490,24000,5510,1,00441,India
751972,2023-05-25,503,mixer,1349,3249,1900,1,00222,India
751972,2023-05-25,502,iphone 15 pro max,100000,135000,35000,1,00222,India
482027,2023-05-25,507,washing machine,6990,16490,9500,1,00500,India
482027,2023-05-25,502,iphone 15 pro max,100000,135000,35000,1,00500,India
234430,2023-05-25,502,iphone 15 pro max,100000,135000,35000,1,00336,India
234430,2023-05-25,507,washing machine,6990,16490,9500,1,00336,India
234430,2023-05-25,503,mixer,1349,3249,1900,1,00336,India
299763,2023-05-25,501,iphone 15,60000,80000,20000,1,00139,India
117441,2023-05-25,505,oven,18490,24000,5510,1,00091,India
117441,2023-05-25,507,washing machine,6990,16490,9500,1,00091,India
117441,2023-05-25,504,iron,449,879,430,1,00091,India
117441,2023-05-25,501,iphone 15,60000,80000,20000,1,00091,India
845698,2023-05-25,506,monitor,3249,8000,4751,1,00198,India
845698,2023-05-25,505,oven,18490,24000,5510,1,00198,India
599136,2023-05-25,507,washing machine,6990,16490,9500,1,00032,India
473156,2023-05-25,501,iphone 15,60000,80000,20000,1,00162,India
473156,2023-05-25,503,mixer,1349,3249,1900,1,00162,India
473156,2023-05-25,502,iphone 15 pro max,100000,135000,35000,1,00162,India
118814,2023-05-25,505,oven,18490,24000,5510,1,00237,India
118814,2023-05-25,506,monitor,3249,8000,4751,1,00237,India
399080,2023-05-25,507,washing machine,6990,16490,9500,1,00470,India
399080,2023-05-25,504,iron,449,879,430,1,00470,India
399080,2023-05-25,502,iphone 15 pro max,100000,135000,35000,1,00470,India
447505,2023-05-25,502,iphone 15 pro max,100000,135000,35000,1,00265,India
447505,2023-05-25,506,monitor,3249,8000,4751,1,00265,India
447505,2023-05-25,505,oven,18490,24000,5510,1,00265,India
266441,2023-05-25,501,iphone 15,60000,80000,20000,1,00288,India
266441,2023-05-25,504,iron,449,879,430,1,00288,India
277468,2023-05-25,506,monitor,3249,8000,4751,1,00302,India
277468,2023-05-25,501,iphone 15,60000,80000,20000,1,00302,India
277468,2023-05-25,503,mixer,1349,3249,1900,1,00302,India
355853,2023-05-25,507,washing machine,6990,16490,9500,1,00208,India
577882,2023-05-25,506,monitor,3249,8000,4751,1,00381,India
577882,2023-05-25,507,washing machine,6990,16490,9500,1,00381,India
101708,2023-05-25,503,mixer,1349,3249,1900,1,00136,India
101708,2023-05-25,506,monitor,3249,8000,4751,1,00136,India
101708,2023-05-25,505,oven,18490,24000,5510,1,00136,India
584641,2023-05-25,506,monitor,3249,8000,4751,1,00357,India
957568,2023-05-25,501,iphone 15,60000,80000,20000,1,00435,India
957568,2023-05-25,504,iron,449,879,430,1,00435,India
930621,2023-05-25,504,iron,449,879,430,1,00072,India
930621,2023-05-25,503,mixer,1349,3249,1900,1,00072,India
930621,2023-05-25,507,washing machine,6990,16490,9500,1,00072,India
930621,2023-05-25,502,iphone 15 pro max,100000,135000,35000,1,00072,India
794515,2023-05-25,503,mixer,1349,3249,1900,1,00417,India
496335,2023-05-25,507,washing machine,6990,16490,9500,1,00318,India
496335,2023-05-25,505,oven,18490,24000,5510,1,00318,India
333605,2023-05-25,507,washing machine,6990,16490,9500,1,00160,India
333605,2023-05-25,502,iphone 15 pro max,100000,135000,35000,1,00160,India
333605,2023-05-25,506,monitor,3249,8000,4751,1,00160,India
333605,2023-05-25,501,iphone 15,60000,80000,20000,1,00160,India
148292,2023-05-25,502,iphone 15 pro max,100000,135000,35000,1,00118,India
148292,2023-05-25,501,iphone 15,60000,80000,20000,1,00118,India
148292,2023-05-25,503,mixer,1349,3249,1900,1,00118,India
275284,2023-05-25,503,mixer,1349,3249,1900,1,00353,India
209335,2023-05-25,501,iphone 15,60000,80000,20000,1,00171,India
209335,2023-05-25,504,iron,449,879,430,1,00171,India
696594,2023-05-25,502,iphone 15 pro max,100000,135000,35000,1,00176,India
696594,2023-05-25,503,mixer,1349,3249,1900,1,00176,India
696594,2023-05-25,504,iron,449,879,430,1,00176,India
696594,2023-05-25,501,iphone 15,60000,80000,20000,1,00176,India
996733,2023-05-25,501,iphone 15,60000,80000,20000,1,00012,India
578704,2023-05-25,506,monitor,3249,8000,4751,1,00138,India
578704,2023-05-25,504,iron,449,879,430,1,00138,India
572391,2023-05-25,501,iphone 15,60000,80000,20000,1,00375,India
572391,2023-05-25,504,iron,449,879,430,1,00375,India
572391,2023-05-25,506,monitor,3249,8000,4751,1,00375,India
501154,2023-05-25,506,monitor,3249,8000,4751,1,00242,India
501154,2023-05-25,507,washing machine,6990,16490,9500,1,00242,India
501154,2023-05-25,504,iron,449,879,430,1,00242,India
281771,2023-05-25,504,iron,449,879,430,1,00279,India
281771,2023-05-25,501,iphone 15,60000,80000,20000,1,00279,India
281771,2023-05-25,506,monitor,3249,8000,4751,1,00279,India
675165,2023-05-25,502,iphone 15 pro max,100000,135000,35000,1,00287,India
408077,2023-05-25,506,monitor,3249,8000,4751,1,00421,India
408077,2023-05-25,504,iron,449,879,430,1,00421,India
408077,2023-05-25,501,iphone 15,60000,80000,20000,1,00421,India
408077,2023-05-25,502,iphone 15 pro max,100000,135000,35000,1,00421,India
972065,2023-05-25,507,washing machine,6990,16490,9500,1,00111,India
972065,2023-05-25,506,monitor,3249,8000,4751,1,00111,India
972065,2023-05-25,505,oven,18490,24000,5510,1,00111,India
972065,2023-05-25,502,iphone 15 pro max,100000,135000,35000,1,00111,India
128237,2023-05-25,507,washing machine,6990,16490,9500,1,00109,India
384493,2023-05-25,501,iphone 15,60000,80000,20000,1,00172,India
610145,2023-05-25,504,iron,449,879,430,1,00030,India
610145,2023-05-25,503,mixer,1349,3249,1900,1,00030,India
610145,2023-05-25,507,washing machine,6990,16490,9500,1,00030,India
610145,2023-05-25,506,monitor,3249,8000,4751,1,00030,India
559273,2023-05-25,504,iron,449,879,430,1,00281,India
559273,2023-05-25,503,mixer,1349,3249,1900,1,00281,India
559273,2023-05-25,502,iphone 15 pro max,100000,135000,35000,1,00281,India
107268,2023-05-25,506,monitor,3249,8000,4751,1,00316,India
107268,2023-05-25,502,iphone 15 pro max,100000,135000,35000,1,00316,India
107268,2023-05-25,501,iphone 15,60000,80000,20000,1,00316,India
107268,2023-05-25,503,mixer,1349,3249,1900,1,00316,India
485723,2023-05-25,505,oven,18490,24000,5510,1,00100,India
485723,2023-05-25,501,iphone 15,60000,80000,20000,1,00100,India
485723,2023-05-25,504,iron,449,879,430,1,00100,India
776293,2023-05-25,502,iphone 15 pro max,100000,135000,35000,1,00219,India
776293,2023-05-25,506,monitor,3249,8000,4751,1,00219,India
776293,2023-05-25,507,washing machine,6990,16490,9500,1,00219,India
195067,2023-05-25,504,iron,449,879,430,1,00225,India
195067,2023-05-25,506,monitor,3249,8000,4751,1,00225,India
413604,2023-05-25,501,iphone 15,60000,80000,20000,1,00368,India
413604,2023-05-25,502,iphone 15 pro max,100000,135000,35000,1,00368,India
413604,2023-05-25,505,oven,18490,24000,5510,1,00368,India
413604,2023-05-25,506,monitor,3249,8000,4751,1,00368,India
108787,2023-05-25,507,washing machine,6990,16490,9500,1,00349,India
108787,2023-05-25,506,monitor,3249,8000,4751,1,00349,India
108787,2023-05-25,503,mixer,1349,3249,1900,1,00349,India
108787,2023-05-25,504,iron,449,879,430,1,00349,India
177789,2023-05-25,504,iron,449,879,430,1,00449,India
177789,2023-05-25,505,oven,18490,24000,5510,1,00449,India
177789,2023-05-25,506,monitor,3249,8000,4751,1,00449,India
177789,2023-05-25,507,washing machine,6990,16490,9500,1,00449,India
708449,2023-05-25,501,iphone 15,60000,80000,20000,1,00313,India
708449,2023-05-25,507,washing machine,6990,16490,9500,1,00313,India
708449,2023-05-25,504,iron,449,879,430,1,00313,India
697779,2023-05-26,505,oven,18490,24000,5510,1,00130,India
806496,2023-05-26,505,oven,18490,24000,5510,1,00311,India
806496,2023-05-26,507,washing machine,6990,16490,9500,1,00311,India
379898,2023-05-26,505,oven,18490,24000,5510,1,00170,India
379898,2023-05-26,502,iphone 15 pro max,100000,135000,35000,1,00170,India
379898,2023-05-26,503,mixer,1349,3249,1900,1,00170,India
511626,2023-05-26,505,oven,18490,24000,5510,1,00114,India
511626,2023-05-26,503,mixer,1349,3249,1900,1,00114,India
511626,2023-05-26,507,washing machine,6990,16490,9500,1,00114,India
642509,2023-05-26,505,oven,18490,24000,5510,1,00450,India
642509,2023-05-26,501,iphone 15,60000,80000,20000,1,00450,India
642509,2023-05-26,503,mixer,1349,3249,1900,1,00450,India
642509,2023-05-26,502,iphone 15 pro max,100000,135000,35000,1,00450,India
910659,2023-05-26,504,iron,449,879,430,1,00097,India
910659,2023-05-26,505,oven,18490,24000,5510,1,00097,India
382640,2023-05-26,502,iphone 15 pro max,100000,135000,35000,1,00018,India
382640,2023-05-26,505,oven,18490,24000,5510,1,00018,India
382640,2023-05-26,501,iphone 15,60000,80000,20000,1,00018,India
382640,2023-05-26,503,mixer,1349,3249,1900,1,00018,India
239258,2023-05-26,504,iron,449,879,430,1,00256,India
239258,2023-05-26,505,oven,18490,24000,5510,1,00256,India
416492,2023-05-26,501,iphone 15,60000,80000,20000,1,00134,India
137948,2023-05-26,505,oven,18490,24000,5510,1,00115,India
330491,2023-05-26,507,washing machine,6990,16490,9500,1,00006,India
330491,2023-05-26,503,mixer,1349,3249,1900,1,00006,India
330491,2023-05-26,504,iron,449,879,430,1,00006,India
330491,2023-05-26,502,iphone 15 pro max,100000,135000,35000,1,00006,India
926594,2023-05-26,506,monitor,3249,8000,4751,1,00414,India
926594,2023-05-26,501,iphone 15,60000,80000,20000,1,00414,India
926594,2023-05-26,507,washing machine,6990,16490,9500,1,00414,India
913329,2023-05-26,502,iphone 15 pro max,100000,135000,35000,1,00222,India
852693,2023-05-26,503,mixer,1349,3249,1900,1,00020,India
852693,2023-05-26,507,washing machine,6990,16490,9500,1,00020,India
852693,2023-05-26,502,iphone 15 pro max,100000,135000,35000,1,00020,India
861316,2023-05-26,507,washing machine,6990,16490,9500,1,00093,India
861316,2023-05-26,505,oven,18490,24000,5510,1,00093,India
875794,2023-05-26,506,monitor,3249,8000,4751,1,00300,India
875794,2023-05-26,504,iron,449,879,430,1,00300,India
875794,2023-05-26,501,iphone 15,60000,80000,20000,1,00300,India
417832,2023-05-26,506,monitor,3249,8000,4751,1,00386,India
417832,2023-05-26,505,oven,18490,24000,5510,1,00386,India
142730,2023-05-26,505,oven,18490,24000,5510,1,00500,India
142730,2023-05-26,502,iphone 15 pro max,100000,135000,35000,1,00500,India
126715,2023-05-26,502,iphone 15 pro max,100000,135000,35000,1,00309,India
126715,2023-05-26,507,washing machine,6990,16490,9500,1,00309,India
126715,2023-05-26,503,mixer,1349,3249,1900,1,00309,India
126715,2023-05-26,505,oven,18490,24000,5510,1,00309,India
798114,2023-05-26,501,iphone 15,60000,80000,20000,1,00128,India
798114,2023-05-26,503,mixer,1349,3249,1900,1,00128,India
798114,2023-05-26,505,oven,18490,24000,5510,1,00128,India
939010,2023-05-26,507,washing machine,6990,16490,9500,1,00419,India
939010,2023-05-26,502,iphone 15 pro max,100000,135000,35000,1,00419,India
474691,2023-05-26,501,iphone 15,60000,80000,20000,1,00232,India
474691,2023-05-26,507,washing machine,6990,16490,9500,1,00232,India
588591,2023-05-26,501,iphone 15,60000,80000,20000,1,00263,India
588591,2023-05-26,507,washing machine,6990,16490,9500,1,00263,India
588591,2023-05-26,502,iphone 15 pro max,100000,135000,35000,1,00263,India
588591,2023-05-26,504,iron,449,879,430,1,00263,India
323313,2023-05-26,504,iron,449,879,430,1,00419,India
323313,2023-05-26,502,iphone 15 pro max,100000,135000,35000,1,00419,India
250357,2023-05-26,507,washing machine,6990,16490,9500,1,00269,India
689283,2023-05-26,501,iphone 15,60000,80000,20000,1,00423,India
689283,2023-05-26,504,iron,449,879,430,1,00423,India
689283,2023-05-26,506,monitor,3249,8000,4751,1,00423,India
689283,2023-05-26,507,washing machine,6990,16490,9500,1,00423,India
420920,2023-05-26,501,iphone 15,60000,80000,20000,1,00052,India
420920,2023-05-26,504,iron,449,879,430,1,00052,India
664895,2023-05-26,503,mixer,1349,3249,1900,1,00084,India
664895,2023-05-26,507,washing machine,6990,16490,9500,1,00084,India
709896,2023-05-26,501,iphone 15,60000,80000,20000,1,00224,India
709896,2023-05-26,506,monitor,3249,8000,4751,1,00224,India
709896,2023-05-26,504,iron,449,879,430,1,00224,India
567398,2023-05-26,506,monitor,3249,8000,4751,1,00262,India
567398,2023-05-26,504,iron,449,879,430,1,00262,India
357699,2023-05-26,504,iron,449,879,430,1,00025,India
357699,2023-05-26,505,oven,18490,24000,5510,1,00025,India
129011,2023-05-26,507,washing machine,6990,16490,9500,1,00073,India
129011,2023-05-26,503,mixer,1349,3249,1900,1,00073,India
129011,2023-05-26,506,monitor,3249,8000,4751,1,00073,India
920726,2023-05-26,501,iphone 15,60000,80000,20000,1,00481,India
920726,2023-05-26,502,iphone 15 pro max,100000,135000,35000,1,00481,India
920726,2023-05-26,503,mixer,1349,3249,1900,1,00481,India
705497,2023-05-26,506,monitor,3249,8000,4751,1,00483,India
705497,2023-05-26,505,oven,18490,24000,5510,1,00483,India
569779,2023-05-26,506,monitor,3249,8000,4751,1,00429,India
569779,2023-05-26,507,washing machine,6990,16490,9500,1,00429,India
823282,2023-05-26,502,iphone 15 pro max,100000,135000,35000,1,00174,India
282389,2023-05-26,507,washing machine,6990,16490,9500,1,00182,India
282389,2023-05-26,506,monitor,3249,8000,4751,1,00182,India
165029,2023-05-26,503,mixer,1349,3249,1900,1,00382,India
165029,2023-05-26,502,iphone 15 pro max,100000,135000,35000,1,00382,India
901525,2023-05-26,505,oven,18490,24000,5510,1,00302,India
901525,2023-05-26,507,washing machine,6990,16490,9500,1,00302,India
901525,2023-05-26,503,mixer,1349,3249,1900,1,00302,India
568428,2023-05-26,505,oven,18490,24000,5510,1,00185,India
568428,2023-05-26,503,mixer,1349,3249,1900,1,00185,India
568428,2023-05-26,506,monitor,3249,8000,4751,1,00185,India
505914,2023-05-26,504,iron,449,879,430,1,00108,India
505914,2023-05-26,503,mixer,1349,3249,1900,1,00108,India
505914,2023-05-26,502,iphone 15 pro max,100000,135000,35000,1,00108,India
620468,2023-05-26,502,iphone 15 pro max,100000,135000,35000,1,00111,India
620468,2023-05-26,506,monitor,3249,8000,4751,1,00111,India
620468,2023-05-26,505,oven,18490,24000,5510,1,00111,India
620468,2023-05-26,501,iphone 15,60000,80000,20000,1,00111,India
655623,2023-05-26,502,iphone 15 pro max,100000,135000,35000,1,00065,India
655623,2023-05-26,503,mixer,1349,3249,1900,1,00065,India
963485,2023-05-26,503,mixer,1349,3249,1900,1,00345,India
963485,2023-05-26,504,iron,449,879,430,1,00345,India
509017,2023-05-26,506,monitor,3249,8000,4751,1,00219,India
509017,2023-05-26,501,iphone 15,60000,80000,20000,1,00219,India
406731,2023-05-26,507,washing machine,6990,16490,9500,1,00077,India
406731,2023-05-26,501,iphone 15,60000,80000,20000,1,00077,India
406731,2023-05-26,504,iron,449,879,430,1,00077,India
191003,2023-05-26,507,washing machine,6990,16490,9500,1,00452,India
850339,2023-05-26,501,iphone 15,60000,80000,20000,1,00411,India
850339,2023-05-26,507,washing machine,6990,16490,9500,1,00411,India
850339,2023-05-26,505,oven,18490,24000,5510,1,00411,India
850339,2023-05-26,504,iron,449,879,430,1,00411,India
856385,2023-05-26,504,iron,449,879,430,1,00347,India
268670,2023-05-26,506,monitor,3249,8000,4751,1,00146,India
268670,2023-05-26,504,iron,449,879,430,1,00146,India
268670,2023-05-26,502,iphone 15 pro max,100000,135000,35000,1,00146,India
160846,2023-05-26,506,monitor,3249,8000,4751,1,00482,India
160846,2023-05-26,503,mixer,1349,3249,1900,1,00482,India
791837,2023-05-26,505,oven,18490,24000,5510,1,00465,India
791837,2023-05-26,501,iphone 15,60000,80000,20000,1,00465,India
570101,2023-05-26,505,oven,18490,24000,5510,1,00442,India
570101,2023-05-26,506,monitor,3249,8000,4751,1,00442,India
570101,2023-05-26,504,iron,449,879,430,1,00442,India
570101,2023-05-26,503,mixer,1349,3249,1900,1,00442,India
578991,2023-05-26,502,iphone 15 pro max,100000,135000,35000,1,00318,India
578991,2023-05-26,503,mixer,1349,3249,1900,1,00318,India
509199,2023-05-26,501,iphone 15,60000,80000,20000,1,00186,India
509199,2023-05-26,507,washing machine,6990,16490,9500,1,00186,India
509199,2023-05-26,502,iphone 15 pro max,100000,135000,35000,1,00186,India
273147,2023-05-26,503,mixer,1349,3249,1900,1,00260,India
273147,2023-05-26,506,monitor,3249,8000,4751,1,00260,India
224546,2023-05-26,501,iphone 15,60000,80000,20000,1,00195,India
697849,2023-05-26,507,washing machine,6990,16490,9500,1,00268,India
115099,2023-05-26,505,oven,18490,24000,5510,1,00429,India
115099,2023-05-26,501,iphone 15,60000,80000,20000,1,00429,India
942848,2023-05-26,506,monitor,3249,8000,4751,1,00277,India
942848,2023-05-26,507,washing machine,6990,16490,9500,1,00277,India
610660,2023-05-26,505,oven,18490,24000,5510,1,00331,India
423114,2023-05-26,507,washing machine,6990,16490,9500,1,00113,India
423114,2023-05-26,501,iphone 15,60000,80000,20000,1,00113,India
168425,2023-05-26,501,iphone 15,60000,80000,20000,1,00262,India
168425,2023-05-26,507,washing machine,6990,16490,9500,1,00262,India
285941,2023-05-26,505,oven,18490,24000,5510,1,00019,India
285941,2023-05-26,507,washing machine,6990,16490,9500,1,00019,India
524674,2023-05-26,504,iron,449,879,430,1,00225,India
524674,2023-05-26,501,iphone 15,60000,80000,20000,1,00225,India
700074,2023-05-26,507,washing machine,6990,16490,9500,1,00277,India
700074,2023-05-26,506,monitor,3249,8000,4751,1,00277,India
700074,2023-05-26,503,mixer,1349,3249,1900,1,00277,India
700074,2023-05-26,501,iphone 15,60000,80000,20000,1,00277,India
249788,2023-05-26,507,washing machine,6990,16490,9500,1,00118,India
610691,2023-05-26,504,iron,449,879,430,1,00281,India
610691,2023-05-26,503,mixer,1349,3249,1900,1,00281,India
773541,2023-05-26,506,monitor,3249,8000,4751,1,00483,India
773541,2023-05-26,507,washing machine,6990,16490,9500,1,00483,India
805388,2023-05-26,506,monitor,3249,8000,4751,1,00486,India
683427,2023-05-26,501,iphone 15,60000,80000,20000,1,00222,India
683427,2023-05-26,503,mixer,1349,3249,1900,1,00222,India
683427,2023-05-26,502,iphone 15 pro max,100000,135000,35000,1,00222,India
683427,2023-05-26,504,iron,449,879,430,1,00222,India
248170,2023-05-26,502,iphone 15 pro max,100000,135000,35000,1,00089,India
562697,2023-05-26,506,monitor,3249,8000,4751,1,00004,India
171152,2023-05-26,505,oven,18490,24000,5510,1,00465,India
171152,2023-05-26,507,washing machine,6990,16490,9500,1,00465,India
171152,2023-05-26,502,iphone 15 pro max,100000,135000,35000,1,00465,India
876265,2023-05-26,505,oven,18490,24000,5510,1,00125,India
876265,2023-05-26,507,washing machine,6990,16490,9500,1,00125,India
413977,2023-05-26,501,iphone 15,60000,80000,20000,1,00373,India
413977,2023-05-26,502,iphone 15 pro max,100000,135000,35000,1,00373,India
953454,2023-05-26,503,mixer,1349,3249,1900,1,00450,India
173345,2023-05-26,504,iron,449,879,430,1,00344,India
173345,2023-05-26,502,iphone 15 pro max,100000,135000,35000,1,00344,India
173345,2023-05-26,506,monitor,3249,8000,4751,1,00344,India
173345,2023-05-26,505,oven,18490,24000,5510,1,00344,India
648597,2023-05-26,503,mixer,1349,3249,1900,1,00253,India
648597,2023-05-26,504,iron,449,879,430,1,00253,India
525040,2023-05-26,503,mixer,1349,3249,1900,1,00437,India
525040,2023-05-26,502,iphone 15 pro max,100000,135000,35000,1,00437,India
534266,2023-05-26,506,monitor,3249,8000,4751,1,00360,India
534266,2023-05-26,504,iron,449,879,430,1,00360,India
427243,2023-05-26,503,mixer,1349,3249,1900,1,00286,India
427243,2023-05-26,502,iphone 15 pro max,100000,135000,35000,1,00286,India
427243,2023-05-26,506,monitor,3249,8000,4751,1,00286,India
427243,2023-05-26,501,iphone 15,60000,80000,20000,1,00286,India
427243,2023-05-26,505,oven,18490,24000,5510,1,00286,India
374575,2023-05-26,503,mixer,1349,3249,1900,1,00116,India
374575,2023-05-26,504,iron,449,879,430,1,00116,India
116483,2023-05-26,504,iron,449,879,430,1,00046,India
116483,2023-05-26,507,washing machine,6990,16490,9500,1,00046,India
116483,2023-05-26,501,iphone 15,60000,80000,20000,1,00046,India
334874,2023-05-26,503,mixer,1349,3249,1900,1,00106,India
334874,2023-05-26,502,iphone 15 pro max,100000,135000,35000,1,00106,India
334874,2023-05-26,506,monitor,3249,8000,4751,1,00106,India
249670,2023-05-26,507,washing machine,6990,16490,9500,1,00305,India
727192,2023-05-26,503,mixer,1349,3249,1900,1,00047,India
727192,2023-05-26,506,monitor,3249,8000,4751,1,00047,India
641203,2023-05-26,505,oven,18490,24000,5510,1,00384,India
641203,2023-05-26,503,mixer,1349,3249,1900,1,00384,India
729840,2023-05-26,503,mixer,1349,3249,1900,1,00458,India
729840,2023-05-26,504,iron,449,879,430,1,00458,India
729840,2023-05-26,507,washing machine,6990,16490,9500,1,00458,India
849062,2023-05-26,504,iron,449,879,430,1,00368,India
849062,2023-05-26,501,iphone 15,60000,80000,20000,1,00368,India
849062,2023-05-26,507,washing machine,6990,16490,9500,1,00368,India
588834,2023-05-27,507,washing machine,6990,16490,9500,1,00020,India
588834,2023-05-27,501,iphone 15,60000,80000,20000,1,00020,India
588834,2023-05-27,502,iphone 15 pro max,100000,135000,35000,1,00020,India
542455,2023-05-27,503,mixer,1349,3249,1900,1,00058,India
542455,2023-05-27,504,iron,449,879,430,1,00058,India
542455,2023-05-27,505,oven,18490,24000,5510,1,00058,India
838020,2023-05-27,501,iphone 15,60000,80000,20000,1,00060,India
838020,2023-05-27,503,mixer,1349,3249,1900,1,00060,India
838020,2023-05-27,505,oven,18490,24000,5510,1,00060,India
742330,2023-05-27,506,monitor,3249,8000,4751,1,00465,India
208493,2023-05-27,505,oven,18490,24000,5510,1,00346,India
208493,2023-05-27,501,iphone 15,60000,80000,20000,1,00346,India
208493,2023-05-27,504,iron,449,879,430,1,00346,India
627748,2023-05-27,506,monitor,3249,8000,4751,1,00370,India
627748,2023-05-27,503,mixer,1349,3249,1900,1,00370,India
627748,2023-05-27,501,iphone 15,60000,80000,20000,1,00370,India
627748,2023-05-27,507,washing machine,6990,16490,9500,1,00370,India
835615,2023-05-27,501,iphone 15,60000,80000,20000,1,00282,India
835615,2023-05-27,502,iphone 15 pro max,100000,135000,35000,1,00282,India
835615,2023-05-27,504,iron,449,879,430,1,00282,India
835615,2023-05-27,507,washing machine,6990,16490,9500,1,00282,India
284937,2023-05-27,501,iphone 15,60000,80000,20000,1,00065,India
322352,2023-05-27,501,iphone 15,60000,80000,20000,1,00458,India
322352,2023-05-27,505,oven,18490,24000,5510,1,00458,India
322352,2023-05-27,506,monitor,3249,8000,4751,1,00458,India
317722,2023-05-27,506,monitor,3249,8000,4751,1,00115,India
317722,2023-05-27,501,iphone 15,60000,80000,20000,1,00115,India
317722,2023-05-27,504,iron,449,879,430,1,00115,India
951527,2023-05-27,504,iron,449,879,430,1,00494,India
951527,2023-05-27,503,mixer,1349,3249,1900,1,00494,India
622166,2023-05-27,507,washing machine,6990,16490,9500,1,00255,India
622166,2023-05-27,506,monitor,3249,8000,4751,1,00255,India
622166,2023-05-27,505,oven,18490,24000,5510,1,00255,India
622166,2023-05-27,502,iphone 15 pro max,100000,135000,35000,1,00255,India
513758,2023-05-27,504,iron,449,879,430,1,00266,India
513758,2023-05-27,505,oven,18490,24000,5510,1,00266,India
513758,2023-05-27,506,monitor,3249,8000,4751,1,00266,India
513758,2023-05-27,501,iphone 15,60000,80000,20000,1,00266,India
513758,2023-05-27,503,mixer,1349,3249,1900,1,00266,India
439598,2023-05-27,506,monitor,3249,8000,4751,1,00436,India
937758,2023-05-27,502,iphone 15 pro max,100000,135000,35000,1,00399,India
937758,2023-05-27,507,washing machine,6990,16490,9500,1,00399,India
235112,2023-05-27,501,iphone 15,60000,80000,20000,1,00311,India
235112,2023-05-27,503,mixer,1349,3249,1900,1,00311,India
968676,2023-05-27,507,washing machine,6990,16490,9500,1,00163,India
968676,2023-05-27,501,iphone 15,60000,80000,20000,1,00163,India
785685,2023-05-27,501,iphone 15,60000,80000,20000,1,00221,India
785685,2023-05-27,506,monitor,3249,8000,4751,1,00221,India
785685,2023-05-27,505,oven,18490,24000,5510,1,00221,India
785685,2023-05-27,503,mixer,1349,3249,1900,1,00221,India
170425,2023-05-27,506,monitor,3249,8000,4751,1,00426,India
170425,2023-05-27,501,iphone 15,60000,80000,20000,1,00426,India
170425,2023-05-27,505,oven,18490,24000,5510,1,00426,India
254255,2023-05-27,501,iphone 15,60000,80000,20000,1,00420,India
254255,2023-05-27,503,mixer,1349,3249,1900,1,00420,India
254255,2023-05-27,502,iphone 15 pro max,100000,135000,35000,1,00420,India
254255,2023-05-27,504,iron,449,879,430,1,00420,India
254255,2023-05-27,505,oven,18490,24000,5510,1,00420,India
840412,2023-05-27,506,monitor,3249,8000,4751,1,00153,India
605318,2023-05-27,503,mixer,1349,3249,1900,1,00035,India
605318,2023-05-27,502,iphone 15 pro max,100000,135000,35000,1,00035,India
605318,2023-05-27,501,iphone 15,60000,80000,20000,1,00035,India
737186,2023-05-27,507,washing machine,6990,16490,9500,1,00245,India
737186,2023-05-27,505,oven,18490,24000,5510,1,00245,India
737186,2023-05-27,503,mixer,1349,3249,1900,1,00245,India
737186,2023-05-27,506,monitor,3249,8000,4751,1,00245,India
215346,2023-05-27,504,iron,449,879,430,1,00361,India
215346,2023-05-27,505,oven,18490,24000,5510,1,00361,India
215346,2023-05-27,507,washing machine,6990,16490,9500,1,00361,India
438327,2023-05-27,505,oven,18490,24000,5510,1,00355,India
438327,2023-05-27,503,mixer,1349,3249,1900,1,00355,India
438327,2023-05-27,501,iphone 15,60000,80000,20000,1,00355,India
438327,2023-05-27,502,iphone 15 pro max,100000,135000,35000,1,00355,India
254603,2023-05-27,507,washing machine,6990,16490,9500,1,00484,India
254603,2023-05-27,505,oven,18490,24000,5510,1,00484,India
977171,2023-05-27,502,iphone 15 pro max,100000,135000,35000,1,00161,India
422307,2023-05-27,502,iphone 15 pro max,100000,135000,35000,1,00195,India
422307,2023-05-27,506,monitor,3249,8000,4751,1,00195,India
741366,2023-05-27,505,oven,18490,24000,5510,1,00276,India
741366,2023-05-27,507,washing machine,6990,16490,9500,1,00276,India
741366,2023-05-27,504,iron,449,879,430,1,00276,India
662277,2023-05-27,502,iphone 15 pro max,100000,135000,35000,1,00403,India
662277,2023-05-27,505,oven,18490,24000,5510,1,00403,India
744622,2023-05-27,501,iphone 15,60000,80000,20000,1,00187,India
744622,2023-05-27,504,iron,449,879,430,1,00187,India
744622,2023-05-27,505,oven,18490,24000,5510,1,00187,India
271751,2023-05-27,507,washing machine,6990,16490,9500,1,00233,India
271751,2023-05-27,505,oven,18490,24000,5510,1,00233,India
334261,2023-05-27,503,mixer,1349,3249,1900,1,00400,India
131250,2023-05-27,503,mixer,1349,3249,1900,1,00035,India
131250,2023-05-27,501,iphone 15,60000,80000,20000,1,00035,India
131250,2023-05-27,505,oven,18490,24000,5510,1,00035,India
849371,2023-05-27,507,washing machine,6990,16490,9500,1,00015,India
895894,2023-05-27,504,iron,449,879,430,1,00352,India
895894,2023-05-27,505,oven,18490,24000,5510,1,00352,India
840904,2023-05-27,504,iron,449,879,430,1,00216,India
840904,2023-05-27,502,iphone 15 pro max,100000,135000,35000,1,00216,India
840904,2023-05-27,505,oven,18490,24000,5510,1,00216,India
840904,2023-05-27,501,iphone 15,60000,80000,20000,1,00216,India
421793,2023-05-27,506,monitor,3249,8000,4751,1,00134,India
421793,2023-05-27,501,iphone 15,60000,80000,20000,1,00134,India
898644,2023-05-27,506,monitor,3249,8000,4751,1,00477,India
898644,2023-05-27,502,iphone 15 pro max,100000,135000,35000,1,00477,India
898644,2023-05-27,505,oven,18490,24000,5510,1,00477,India
898644,2023-05-27,501,iphone 15,60000,80000,20000,1,00477,India
989026,2023-05-27,505,oven,18490,24000,5510,1,00101,India
942331,2023-05-27,504,iron,449,879,430,1,00405,India
942331,2023-05-27,506,monitor,3249,8000,4751,1,00405,India
942331,2023-05-27,501,iphone 15,60000,80000,20000,1,00405,India
677793,2023-05-27,501,iphone 15,60000,80000,20000,1,00431,India
302007,2023-05-27,503,mixer,1349,3249,1900,1,00342,India
302007,2023-05-27,507,washing machine,6990,16490,9500,1,00342,India
680338,2023-05-27,507,washing machine,6990,16490,9500,1,00325,India
680338,2023-05-27,502,iphone 15 pro max,100000,135000,35000,1,00325,India
680338,2023-05-27,503,mixer,1349,3249,1900,1,00325,India
588021,2023-05-27,507,washing machine,6990,16490,9500,1,00357,India
588021,2023-05-27,505,oven,18490,24000,5510,1,00357,India
588021,2023-05-27,506,monitor,3249,8000,4751,1,00357,India
907141,2023-05-27,506,monitor,3249,8000,4751,1,00321,India
491338,2023-05-27,501,iphone 15,60000,80000,20000,1,00385,India
491338,2023-05-27,507,washing machine,6990,16490,9500,1,00385,India
251080,2023-05-27,501,iphone 15,60000,80000,20000,1,00113,India
251080,2023-05-27,502,iphone 15 pro max,100000,135000,35000,1,00113,India
595497,2023-05-27,507,washing machine,6990,16490,9500,1,00395,India
595497,2023-05-27,503,mixer,1349,3249,1900,1,00395,India
748575,2023-05-27,504,iron,449,879,430,1,00209,India
748575,2023-05-27,505,oven,18490,24000,5510,1,00209,India
748575,2023-05-27,507,washing machine,6990,16490,9500,1,00209,India
684792,2023-05-27,504,iron,449,879,430,1,00029,India
684792,2023-05-27,506,monitor,3249,8000,4751,1,00029,India
684792,2023-05-27,507,washing machine,6990,16490,9500,1,00029,India
806013,2023-05-27,503,mixer,1349,3249,1900,1,00197,India
806013,2023-05-27,502,iphone 15 pro max,100000,135000,35000,1,00197,India
806013,2023-05-27,507,washing machine,6990,16490,9500,1,00197,India
806013,2023-05-27,504,iron,449,879,430,1,00197,India
222446,2023-05-27,506,monitor,3249,8000,4751,1,00218,India
222446,2023-05-27,505,oven,18490,24000,5510,1,00218,India
982152,2023-05-27,503,mixer,1349,3249,1900,1,00499,India
982152,2023-05-27,501,iphone 15,60000,80000,20000,1,00499,India
982152,2023-05-27,506,monitor,3249,8000,4751,1,00499,India
982152,2023-05-27,505,oven,18490,24000,5510,1,00499,India
583385,2023-05-27,505,oven,18490,24000,5510,1,00238,India
583385,2023-05-27,506,monitor,3249,8000,4751,1,00238,India
583385,2023-05-27,507,washing machine,6990,16490,9500,1,00238,India
627493,2023-05-27,503,mixer,1349,3249,1900,1,00341,India
627493,2023-05-27,501,iphone 15,60000,80000,20000,1,00341,India
461077,2023-05-27,505,oven,18490,24000,5510,1,00261,India
461077,2023-05-27,506,monitor,3249,8000,4751,1,00261,India
461077,2023-05-27,503,mixer,1349,3249,1900,1,00261,India
461077,2023-05-27,501,iphone 15,60000,80000,20000,1,00261,India
273305,2023-05-27,507,washing machine,6990,16490,9500,1,00011,India
799794,2023-05-28,502,iphone 15 pro max,100000,135000,35000,1,00047,India
799794,2023-05-28,501,iphone 15,60000,80000,20000,1,00047,India
799794,2023-05-28,505,oven,18490,24000,5510,1,00047,India
134725,2023-05-28,506,monitor,3249,8000,4751,1,00184,India
134725,2023-05-28,505,oven,18490,24000,5510,1,00184,India
259043,2023-05-28,505,oven,18490,24000,5510,1,00269,India
259043,2023-05-28,503,mixer,1349,3249,1900,1,00269,India
259043,2023-05-28,507,washing machine,6990,16490,9500,1,00269,India
152656,2023-05-28,507,washing machine,6990,16490,9500,1,00341,India
152656,2023-05-28,504,iron,449,879,430,1,00341,India
152656,2023-05-28,505,oven,18490,24000,5510,1,00341,India
917915,2023-05-28,504,iron,449,879,430,1,00366,India
243076,2023-05-28,507,washing machine,6990,16490,9500,1,00021,India
243076,2023-05-28,503,mixer,1349,3249,1900,1,00021,India
347032,2023-05-28,505,oven,18490,24000,5510,1,00224,India
347032,2023-05-28,504,iron,449,879,430,1,00224,India
347032,2023-05-28,503,mixer,1349,3249,1900,1,00224,India
761445,2023-05-28,501,iphone 15,60000,80000,20000,1,00100,India
761445,2023-05-28,504,iron,449,879,430,1,00100,India
761445,2023-05-28,503,mixer,1349,3249,1900,1,00100,India
517311,2023-05-28,502,iphone 15 pro max,100000,135000,35000,1,00461,India
517311,2023-05-28,506,monitor,3249,8000,4751,1,00461,India
517311,2023-05-28,507,washing machine,6990,16490,9500,1,00461,India
380958,2023-05-28,502,iphone 15 pro max,100000,135000,35000,1,00253,India
554315,2023-05-28,504,iron,449,879,430,1,00276,India
878926,2023-05-28,507,washing machine,6990,16490,9500,1,00288,India
878926,2023-05-28,501,iphone 15,60000,80000,20000,1,00288,India
878926,2023-05-28,502,iphone 15 pro max,100000,135000,35000,1,00288,India
172535,2023-05-28,504,iron,449,879,430,1,00337,India
172535,2023-05-28,505,oven,18490,24000,5510,1,00337,India
303261,2023-05-28,507,washing machine,6990,16490,9500,1,00276,India
303261,2023-05-28,504,iron,449,879,430,1,00276,India
253941,2023-05-28,501,iphone 15,60000,80000,20000,1,00083,India
253941,2023-05-28,505,oven,18490,24000,5510,1,00083,India
239938,2023-05-28,507,washing machine,6990,16490,9500,1,00245,India
239938,2023-05-28,502,iphone 15 pro max,100000,135000,35000,1,00245,India
239938,2023-05-28,505,oven,18490,24000,5510,1,00245,India
165111,2023-05-28,506,monitor,3249,8000,4751,1,00494,India
702264,2023-05-28,504,iron,449,879,430,1,00136,India
533943,2023-05-28,501,iphone 15,60000,80000,20000,1,00220,India
483290,2023-05-28,501,iphone 15,60000,80000,20000,1,00134,India
483290,2023-05-28,506,monitor,3249,8000,4751,1,00134,India
483290,2023-05-28,507,washing machine,6990,16490,9500,1,00134,India
505433,2023-05-28,505,oven,18490,24000,5510,1,00391,India
627272,2023-05-28,504,iron,449,879,430,1,00395,India
627272,2023-05-28,506,monitor,3249,8000,4751,1,00395,India
627272,2023-05-28,505,oven,18490,24000,5510,1,00395,India
627272,2023-05-28,503,mixer,1349,3249,1900,1,00395,India
544607,2023-05-28,507,washing machine,6990,16490,9500,1,00160,India
801956,2023-05-28,505,oven,18490,24000,5510,1,00124,India
801956,2023-05-28,504,iron,449,879,430,1,00124,India
801956,2023-05-28,506,monitor,3249,8000,4751,1,00124,India
430128,2023-05-28,506,monitor,3249,8000,4751,1,00477,India
430128,2023-05-28,503,mixer,1349,3249,1900,1,00477,India
430128,2023-05-28,504,iron,449,879,430,1,00477,India
100619,2023-05-28,505,oven,18490,24000,5510,1,00120,India
698131,2023-05-28,505,oven,18490,24000,5510,1,00126,India
698131,2023-05-28,504,iron,449,879,430,1,00126,India
698131,2023-05-28,502,iphone 15 pro max,100000,135000,35000,1,00126,India
238402,2023-05-28,506,monitor,3249,8000,4751,1,00181,India
238402,2023-05-28,503,mixer,1349,3249,1900,1,00181,India
238402,2023-05-28,504,iron,449,879,430,1,00181,India
328878,2023-05-28,501,iphone 15,60000,80000,20000,1,00354,India
328878,2023-05-28,505,oven,18490,24000,5510,1,00354,India
328878,2023-05-28,506,monitor,3249,8000,4751,1,00354,India
139544,2023-05-28,503,mixer,1349,3249,1900,1,00332,India
139544,2023-05-28,504,iron,449,879,430,1,00332,India
516994,2023-05-28,504,iron,449,879,430,1,00460,India
516994,2023-05-28,503,mixer,1349,3249,1900,1,00460,India
256965,2023-05-28,502,iphone 15 pro max,100000,135000,35000,1,00494,India
395421,2023-05-28,503,mixer,1349,3249,1900,1,00337,India
395421,2023-05-28,504,iron,449,879,430,1,00337,India
643567,2023-05-28,504,iron,449,879,430,1,00188,India
643567,2023-05-28,505,oven,18490,24000,5510,1,00188,India
643567,2023-05-28,501,iphone 15,60000,80000,20000,1,00188,India
826756,2023-05-28,506,monitor,3249,8000,4751,1,00327,India
826756,2023-05-28,501,iphone 15,60000,80000,20000,1,00327,India
311326,2023-05-28,505,oven,18490,24000,5510,1,00138,India
311326,2023-05-28,506,monitor,3249,8000,4751,1,00138,India
311326,2023-05-28,503,mixer,1349,3249,1900,1,00138,India
311326,2023-05-28,501,iphone 15,60000,80000,20000,1,00138,India
738917,2023-05-28,504,iron,449,879,430,1,00305,India
738917,2023-05-28,506,monitor,3249,8000,4751,1,00305,India
738917,2023-05-28,501,iphone 15,60000,80000,20000,1,00305,India
738917,2023-05-28,503,mixer,1349,3249,1900,1,00305,India
271141,2023-05-28,507,washing machine,6990,16490,9500,1,00447,India
271141,2023-05-28,501,iphone 15,60000,80000,20000,1,00447,India
849692,2023-05-28,506,monitor,3249,8000,4751,1,00317,India
849692,2023-05-28,503,mixer,1349,3249,1900,1,00317,India
147405,2023-05-28,504,iron,449,879,430,1,00121,India
989978,2023-05-28,504,iron,449,879,430,1,00387,India
349232,2023-05-28,501,iphone 15,60000,80000,20000,1,00417,India
349232,2023-05-28,504,iron,449,879,430,1,00417,India
369969,2023-05-28,506,monitor,3249,8000,4751,1,00235,India
369969,2023-05-28,507,washing machine,6990,16490,9500,1,00235,India
369969,2023-05-28,501,iphone 15,60000,80000,20000,1,00235,India
914797,2023-05-28,501,iphone 15,60000,80000,20000,1,00134,India
461787,2023-05-28,507,washing machine,6990,16490,9500,1,00012,India
461787,2023-05-28,505,oven,18490,24000,5510,1,00012,India
461787,2023-05-28,504,iron,449,879,430,1,00012,India
461787,2023-05-28,502,iphone 15 pro max,100000,135000,35000,1,00012,India
703805,2023-05-28,505,oven,18490,24000,5510,1,00396,India
703805,2023-05-28,506,monitor,3249,8000,4751,1,00396,India
695568,2023-05-28,505,oven,18490,24000,5510,1,00029,India
695568,2023-05-28,506,monitor,3249,8000,4751,1,00029,India
695568,2023-05-28,502,iphone 15 pro max,100000,135000,35000,1,00029,India
419054,2023-05-28,502,iphone 15 pro max,100000,135000,35000,1,00187,India
419054,2023-05-28,507,washing machine,6990,16490,9500,1,00187,India
433596,2023-05-28,501,iphone 15,60000,80000,20000,1,00038,India
704849,2023-05-28,505,oven,18490,24000,5510,1,00498,India
704849,2023-05-28,507,washing machine,6990,16490,9500,1,00498,India
183429,2023-05-28,502,iphone 15 pro max,100000,135000,35000,1,00134,India
178907,2023-05-28,502,iphone 15 pro max,100000,135000,35000,1,00153,India
178907,2023-05-28,506,monitor,3249,8000,4751,1,00153,India
178907,2023-05-28,503,mixer,1349,3249,1900,1,00153,India
178907,2023-05-28,501,iphone 15,60000,80000,20000,1,00153,India
678765,2023-05-28,506,monitor,3249,8000,4751,1,00391,India
594562,2023-05-28,501,iphone 15,60000,80000,20000,1,00144,India
959537,2023-05-28,503,mixer,1349,3249,1900,1,00119,India
959537,2023-05-28,501,iphone 15,60000,80000,20000,1,00119,India
148261,2023-05-28,506,monitor,3249,8000,4751,1,00134,India
148261,2023-05-28,503,mixer,1349,3249,1900,1,00134,India
148261,2023-05-28,501,iphone 15,60000,80000,20000,1,00134,India
148261,2023-05-28,502,iphone 15 pro max,100000,135000,35000,1,00134,India
148261,2023-05-28,507,washing machine,6990,16490,9500,1,00134,India
897462,2023-05-28,501,iphone 15,60000,80000,20000,1,00177,India
897462,2023-05-28,505,oven,18490,24000,5510,1,00177,India
680422,2023-05-28,501,iphone 15,60000,80000,20000,1,00034,India
680422,2023-05-28,506,monitor,3249,8000,4751,1,00034,India
680422,2023-05-28,503,mixer,1349,3249,1900,1,00034,India
248713,2023-05-28,505,oven,18490,24000,5510,1,00422,India
248713,2023-05-28,506,monitor,3249,8000,4751,1,00422,India
248713,2023-05-28,501,iphone 15,60000,80000,20000,1,00422,India
645994,2023-05-28,505,oven,18490,24000,5510,1,00326,India
880906,2023-05-28,505,oven,18490,24000,5510,1,00019,India
880906,2023-05-28,502,iphone 15 pro max,100000,135000,35000,1,00019,India
880906,2023-05-28,506,monitor,3249,8000,4751,1,00019,India
756353,2023-05-28,501,iphone 15,60000,80000,20000,1,00141,India
778152,2023-05-28,503,mixer,1349,3249,1900,1,00414,India
778152,2023-05-28,505,oven,18490,24000,5510,1,00414,India
778152,2023-05-28,504,iron,449,879,430,1,00414,India
676976,2023-05-28,501,iphone 15,60000,80000,20000,1,00109,India
676976,2023-05-28,504,iron,449,879,430,1,00109,India
775052,2023-05-28,507,washing machine,6990,16490,9500,1,00352,India
775052,2023-05-28,505,oven,18490,24000,5510,1,00352,India
775052,2023-05-28,506,monitor,3249,8000,4751,1,00352,India
775052,2023-05-28,502,iphone 15 pro max,100000,135000,35000,1,00352,India
480832,2023-05-28,504,iron,449,879,430,1,00198,India
480832,2023-05-28,505,oven,18490,24000,5510,1,00198,India
480832,2023-05-28,506,monitor,3249,8000,4751,1,00198,India
480832,2023-05-28,501,iphone 15,60000,80000,20000,1,00198,India
683666,2023-05-28,505,oven,18490,24000,5510,1,00362,India
757593,2023-05-28,505,oven,18490,24000,5510,1,00029,India
757593,2023-05-28,502,iphone 15 pro max,100000,135000,35000,1,00029,India
682824,2023-05-28,502,iphone 15 pro max,100000,135000,35000,1,00435,India
682824,2023-05-28,507,washing machine,6990,16490,9500,1,00435,India
682824,2023-05-28,505,oven,18490,24000,5510,1,00435,India
723299,2023-05-28,503,mixer,1349,3249,1900,1,00067,India
734669,2023-05-28,507,washing machine,6990,16490,9500,1,00454,India
734669,2023-05-28,503,mixer,1349,3249,1900,1,00454,India
734669,2023-05-28,505,oven,18490,24000,5510,1,00454,India
178446,2023-05-28,505,oven,18490,24000,5510,1,00302,India
178446,2023-05-28,501,iphone 15,60000,80000,20000,1,00302,India
920331,2023-05-28,503,mixer,1349,3249,1900,1,00047,India
920331,2023-05-28,507,washing machine,6990,16490,9500,1,00047,India
920331,2023-05-28,502,iphone 15 pro max,100000,135000,35000,1,00047,India
337866,2023-05-28,507,washing machine,6990,16490,9500,1,00156,India
337866,2023-05-28,501,iphone 15,60000,80000,20000,1,00156,India
337866,2023-05-28,505,oven,18490,24000,5510,1,00156,India
337866,2023-05-28,504,iron,449,879,430,1,00156,India
219721,2023-05-28,506,monitor,3249,8000,4751,1,00288,India
219721,2023-05-28,504,iron,449,879,430,1,00288,India
219721,2023-05-28,507,washing machine,6990,16490,9500,1,00288,India
874437,2023-05-28,505,oven,18490,24000,5510,1,00399,India
874437,2023-05-28,504,iron,449,879,430,1,00399,India
874437,2023-05-28,501,iphone 15,60000,80000,20000,1,00399,India
220814,2023-05-28,506,monitor,3249,8000,4751,1,00385,India
220814,2023-05-28,505,oven,18490,24000,5510,1,00385,India
220814,2023-05-28,503,mixer,1349,3249,1900,1,00385,India
150038,2023-05-28,502,iphone 15 pro max,100000,135000,35000,1,00257,India
978238,2023-05-28,506,monitor,3249,8000,4751,1,00455,India
978238,2023-05-28,507,washing machine,6990,16490,9500,1,00455,India
978238,2023-05-28,504,iron,449,879,430,1,00455,India
400344,2023-05-28,506,monitor,3249,8000,4751,1,00492,India
400344,2023-05-28,507,washing machine,6990,16490,9500,1,00492,India
209880,2023-05-28,501,iphone 15,60000,80000,20000,1,00179,India
209880,2023-05-28,506,monitor,3249,8000,4751,1,00179,India
516679,2023-05-29,504,iron,449,879,430,1,00225,India
516679,2023-05-29,502,iphone 15 pro max,100000,135000,35000,1,00225,India
516679,2023-05-29,506,monitor,3249,8000,4751,1,00225,India
516679,2023-05-29,503,mixer,1349,3249,1900,1,00225,India
516679,2023-05-29,501,iphone 15,60000,80000,20000,1,00225,India
319153,2023-05-29,504,iron,449,879,430,1,00018,India
319153,2023-05-29,506,monitor,3249,8000,4751,1,00018,India
788589,2023-05-29,501,iphone 15,60000,80000,20000,1,00399,India
788589,2023-05-29,505,oven,18490,24000,5510,1,00399,India
813654,2023-05-29,507,washing machine,6990,16490,9500,1,00421,India
813654,2023-05-29,502,iphone 15 pro max,100000,135000,35000,1,00421,India
813654,2023-05-29,504,iron,449,879,430,1,00421,India
813654,2023-05-29,506,monitor,3249,8000,4751,1,00421,India
411820,2023-05-29,501,iphone 15,60000,80000,20000,1,00386,India
411820,2023-05-29,503,mixer,1349,3249,1900,1,00386,India
591329,2023-05-29,506,monitor,3249,8000,4751,1,00012,India
576570,2023-05-29,502,iphone 15 pro max,100000,135000,35000,1,00188,India
576570,2023-05-29,501,iphone 15,60000,80000,20000,1,00188,India
576570,2023-05-29,506,monitor,3249,8000,4751,1,00188,India
385020,2023-05-29,502,iphone 15 pro max,100000,135000,35000,1,00343,India
385020,2023-05-29,505,oven,18490,24000,5510,1,00343,India
385020,2023-05-29,507,washing machine,6990,16490,9500,1,00343,India
175574,2023-05-29,502,iphone 15 pro max,100000,135000,35000,1,00491,India
175574,2023-05-29,507,washing machine,6990,16490,9500,1,00491,India
175574,2023-05-29,506,monitor,3249,8000,4751,1,00491,India
369755,2023-05-29,503,mixer,1349,3249,1900,1,00242,India
369755,2023-05-29,502,iphone 15 pro max,100000,135000,35000,1,00242,India
371312,2023-05-29,501,iphone 15,60000,80000,20000,1,00334,India
371312,2023-05-29,504,iron,449,879,430,1,00334,India
371312,2023-05-29,506,monitor,3249,8000,4751,1,00334,India
371312,2023-05-29,505,oven,18490,24000,5510,1,00334,India
347905,2023-05-29,501,iphone 15,60000,80000,20000,1,00052,India
100272,2023-05-29,507,washing machine,6990,16490,9500,1,00380,India
100272,2023-05-29,503,mixer,1349,3249,1900,1,00380,India
573899,2023-05-29,507,washing machine,6990,16490,9500,1,00458,India
573899,2023-05-29,506,monitor,3249,8000,4751,1,00458,India
573899,2023-05-29,502,iphone 15 pro max,100000,135000,35000,1,00458,India
573899,2023-05-29,504,iron,449,879,430,1,00458,India
489090,2023-05-29,505,oven,18490,24000,5510,1,00210,India
489090,2023-05-29,501,iphone 15,60000,80000,20000,1,00210,India
489090,2023-05-29,507,washing machine,6990,16490,9500,1,00210,India
489090,2023-05-29,502,iphone 15 pro max,100000,135000,35000,1,00210,India
449983,2023-05-29,504,iron,449,879,430,1,00043,India
449983,2023-05-29,507,washing machine,6990,16490,9500,1,00043,India
449983,2023-05-29,506,monitor,3249,8000,4751,1,00043,India
473542,2023-05-29,501,iphone 15,60000,80000,20000,1,00080,India
473542,2023-05-29,505,oven,18490,24000,5510,1,00080,India
473542,2023-05-29,506,monitor,3249,8000,4751,1,00080,India
473542,2023-05-29,507,washing machine,6990,16490,9500,1,00080,India
727000,2023-05-29,504,iron,449,879,430,1,00415,India
727000,2023-05-29,507,washing machine,6990,16490,9500,1,00415,India
627558,2023-05-29,504,iron,449,879,430,1,00475,India
627558,2023-05-29,507,washing machine,6990,16490,9500,1,00475,India
302453,2023-05-29,507,washing machine,6990,16490,9500,1,00036,India
302453,2023-05-29,504,iron,449,879,430,1,00036,India
302453,2023-05-29,506,monitor,3249,8000,4751,1,00036,India
724839,2023-05-29,507,washing machine,6990,16490,9500,1,00488,India
724839,2023-05-29,503,mixer,1349,3249,1900,1,00488,India
724839,2023-05-29,502,iphone 15 pro max,100000,135000,35000,1,00488,India
689306,2023-05-29,507,washing machine,6990,16490,9500,1,00047,India
689306,2023-05-29,503,mixer,1349,3249,1900,1,00047,India
689306,2023-05-29,502,iphone 15 pro max,100000,135000,35000,1,00047,India
689306,2023-05-29,504,iron,449,879,430,1,00047,India
335894,2023-05-29,506,monitor,3249,8000,4751,1,00394,India
335894,2023-05-29,505,oven,18490,24000,5510,1,00394,India
335894,2023-05-29,501,iphone 15,60000,80000,20000,1,00394,India
576810,2023-05-29,506,monitor,3249,8000,4751,1,00278,India
576810,2023-05-29,501,iphone 15,60000,80000,20000,1,00278,India
778365,2023-05-29,506,monitor,3249,8000,4751,1,00088,India
778365,2023-05-29,501,iphone 15,60000,80000,20000,1,00088,India
778365,2023-05-29,507,washing machine,6990,16490,9500,1,00088,India
519387,2023-05-29,502,iphone 15 pro max,100000,135000,35000,1,00019,India
519387,2023-05-29,507,washing machine,6990,16490,9500,1,00019,India
519387,2023-05-29,506,monitor,3249,8000,4751,1,00019,India
602087,2023-05-29,504,iron,449,879,430,1,00048,India
602087,2023-05-29,502,iphone 15 pro max,100000,135000,35000,1,00048,India
674556,2023-05-29,506,monitor,3249,8000,4751,1,00385,India
674556,2023-05-29,504,iron,449,879,430,1,00385,India
674556,2023-05-29,505,oven,18490,24000,5510,1,00385,India
674556,2023-05-29,501,iphone 15,60000,80000,20000,1,00385,India
674556,2023-05-29,507,washing machine,6990,16490,9500,1,00385,India
183363,2023-05-29,507,washing machine,6990,16490,9500,1,00183,India
183363,2023-05-29,506,monitor,3249,8000,4751,1,00183,India
183363,2023-05-29,503,mixer,1349,3249,1900,1,00183,India
183363,2023-05-29,501,iphone 15,60000,80000,20000,1,00183,India
183363,2023-05-29,504,iron,449,879,430,1,00183,India
460296,2023-05-29,501,iphone 15,60000,80000,20000,1,00108,India
217498,2023-05-29,504,iron,449,879,430,1,00307,India
217498,2023-05-29,502,iphone 15 pro max,100000,135000,35000,1,00307,India
217498,2023-05-29,507,washing machine,6990,16490,9500,1,00307,India
217498,2023-05-29,505,oven,18490,24000,5510,1,00307,India
542562,2023-05-29,503,mixer,1349,3249,1900,1,00274,India
628052,2023-05-29,501,iphone 15,60000,80000,20000,1,00136,India
628052,2023-05-29,506,monitor,3249,8000,4751,1,00136,India
628052,2023-05-29,503,mixer,1349,3249,1900,1,00136,India
628052,2023-05-29,504,iron,449,879,430,1,00136,India
622505,2023-05-29,503,mixer,1349,3249,1900,1,00286,India
622505,2023-05-29,506,monitor,3249,8000,4751,1,00286,India
622505,2023-05-29,504,iron,449,879,430,1,00286,India
945786,2023-05-29,504,iron,449,879,430,1,00307,India
945786,2023-05-29,505,oven,18490,24000,5510,1,00307,India
945786,2023-05-29,502,iphone 15 pro max,100000,135000,35000,1,00307,India
252540,2023-05-29,504,iron,449,879,430,1,00096,India
252540,2023-05-29,502,iphone 15 pro max,100000,135000,35000,1,00096,India
308000,2023-05-29,506,monitor,3249,8000,4751,1,00188,India
308000,2023-05-29,502,iphone 15 pro max,100000,135000,35000,1,00188,India
500308,2023-05-29,506,monitor,3249,8000,4751,1,00471,India
500308,2023-05-29,502,iphone 15 pro max,100000,135000,35000,1,00471,India
500308,2023-05-29,505,oven,18490,24000,5510,1,00471,India
500308,2023-05-29,503,mixer,1349,3249,1900,1,00471,India
330362,2023-05-29,501,iphone 15,60000,80000,20000,1,00383,India
785379,2023-05-29,501,iphone 15,60000,80000,20000,1,00500,India
785379,2023-05-29,506,monitor,3249,8000,4751,1,00500,India
502247,2023-05-29,506,monitor,3249,8000,4751,1,00086,India
906992,2023-05-29,501,iphone 15,60000,80000,20000,1,00326,India
941681,2023-05-29,503,mixer,1349,3249,1900,1,00111,India
111725,2023-05-29,503,mixer,1349,3249,1900,1,00463,India
778259,2023-05-29,504,iron,449,879,430,1,00359,India
778259,2023-05-29,505,oven,18490,24000,5510,1,00359,India
168462,2023-05-29,505,oven,18490,24000,5510,1,00295,India
168462,2023-05-29,506,monitor,3249,8000,4751,1,00295,India
168462,2023-05-29,503,mixer,1349,3249,1900,1,00295,India
168462,2023-05-29,504,iron,449,879,430,1,00295,India
829073,2023-05-29,503,mixer,1349,3249,1900,1,00316,India
767147,2023-05-29,504,iron,449,879,430,1,00388,India
767147,2023-05-29,506,monitor,3249,8000,4751,1,00388,India
728454,2023-05-29,506,monitor,3249,8000,4751,1,00226,India
728454,2023-05-29,507,washing machine,6990,16490,9500,1,00226,India
728454,2023-05-29,505,oven,18490,24000,5510,1,00226,India
613704,2023-05-29,505,oven,18490,24000,5510,1,00277,India
613704,2023-05-29,501,iphone 15,60000,80000,20000,1,00277,India
613704,2023-05-29,502,iphone 15 pro max,100000,135000,35000,1,00277,India
507224,2023-05-29,505,oven,18490,24000,5510,1,00052,India
507224,2023-05-29,504,iron,449,879,430,1,00052,India
507224,2023-05-29,502,iphone 15 pro max,100000,135000,35000,1,00052,India
507224,2023-05-29,506,monitor,3249,8000,4751,1,00052,India
507224,2023-05-29,501,iphone 15,60000,80000,20000,1,00052,India
156447,2023-05-30,503,mixer,1349,3249,1900,1,00368,India
156447,2023-05-30,506,monitor,3249,8000,4751,1,00368,India
973658,2023-05-30,503,mixer,1349,3249,1900,1,00068,India
973658,2023-05-30,504,iron,449,879,430,1,00068,India
725164,2023-05-30,505,oven,18490,24000,5510,1,00104,India
725164,2023-05-30,502,iphone 15 pro max,100000,135000,35000,1,00104,India
725164,2023-05-30,506,monitor,3249,8000,4751,1,00104,India
725164,2023-05-30,507,washing machine,6990,16490,9500,1,00104,India
725164,2023-05-30,501,iphone 15,60000,80000,20000,1,00104,India
229785,2023-05-30,504,iron,449,879,430,1,00052,India
320016,2023-05-30,503,mixer,1349,3249,1900,1,00284,India
320016,2023-05-30,507,washing machine,6990,16490,9500,1,00284,India
320016,2023-05-30,506,monitor,3249,8000,4751,1,00284,India
657762,2023-05-30,505,oven,18490,24000,5510,1,00256,India
657762,2023-05-30,506,monitor,3249,8000,4751,1,00256,India
657762,2023-05-30,503,mixer,1349,3249,1900,1,00256,India
257064,2023-05-30,501,iphone 15,60000,80000,20000,1,00246,India
257064,2023-05-30,503,mixer,1349,3249,1900,1,00246,India
257064,2023-05-30,505,oven,18490,24000,5510,1,00246,India
257064,2023-05-30,502,iphone 15 pro max,100000,135000,35000,1,00246,India
797940,2023-05-30,501,iphone 15,60000,80000,20000,1,00301,India
797940,2023-05-30,504,iron,449,879,430,1,00301,India
797940,2023-05-30,503,mixer,1349,3249,1900,1,00301,India
802447,2023-05-30,503,mixer,1349,3249,1900,1,00011,India
592863,2023-05-30,506,monitor,3249,8000,4751,1,00199,India
810063,2023-05-30,503,mixer,1349,3249,1900,1,00260,India
137205,2023-05-30,504,iron,449,879,430,1,00428,India
137205,2023-05-30,506,monitor,3249,8000,4751,1,00428,India
819960,2023-05-30,505,oven,18490,24000,5510,1,00203,India
819960,2023-05-30,504,iron,449,879,430,1,00203,India
819960,2023-05-30,507,washing machine,6990,16490,9500,1,00203,India
819960,2023-05-30,506,monitor,3249,8000,4751,1,00203,India
702645,2023-05-30,504,iron,449,879,430,1,00440,India
702645,2023-05-30,507,washing machine,6990,16490,9500,1,00440,India
702645,2023-05-30,501,iphone 15,60000,80000,20000,1,00440,India
702645,2023-05-30,506,monitor,3249,8000,4751,1,00440,India
596297,2023-05-30,505,oven,18490,24000,5510,1,00150,India
596297,2023-05-30,503,mixer,1349,3249,1900,1,00150,India
596297,2023-05-30,507,washing machine,6990,16490,9500,1,00150,India
596297,2023-05-30,506,monitor,3249,8000,4751,1,00150,India
104341,2023-05-30,507,washing machine,6990,16490,9500,1,00380,India
104341,2023-05-30,503,mixer,1349,3249,1900,1,00380,India
999103,2023-05-30,504,iron,449,879,430,1,00166,India
999103,2023-05-30,503,mixer,1349,3249,1900,1,00166,India
999103,2023-05-30,506,monitor,3249,8000,4751,1,00166,India
678511,2023-05-30,506,monitor,3249,8000,4751,1,00218,India
678511,2023-05-30,504,iron,449,879,430,1,00218,India
678511,2023-05-30,502,iphone 15 pro max,100000,135000,35000,1,00218,India
109831,2023-05-30,503,mixer,1349,3249,1900,1,00411,India
109831,2023-05-30,502,iphone 15 pro max,100000,135000,35000,1,00411,India
919039,2023-05-30,504,iron,449,879,430,1,00249,India
919039,2023-05-30,507,washing machine,6990,16490,9500,1,00249,India
919039,2023-05-30,501,iphone 15,60000,80000,20000,1,00249,India
130755,2023-05-30,507,washing machine,6990,16490,9500,1,00184,India
130755,2023-05-30,506,monitor,3249,8000,4751,1,00184,India
130755,2023-05-30,501,iphone 15,60000,80000,20000,1,00184,India
130755,2023-05-30,505,oven,18490,24000,5510,1,00184,India
178224,2023-05-30,507,washing machine,6990,16490,9500,1,00235,India
178224,2023-05-30,504,iron,449,879,430,1,00235,India
178224,2023-05-30,503,mixer,1349,3249,1900,1,00235,India
178224,2023-05-30,505,oven,18490,24000,5510,1,00235,India
317643,2023-05-30,503,mixer,1349,3249,1900,1,00369,India
388494,2023-05-30,504,iron,449,879,430,1,00135,India
234304,2023-05-30,503,mixer,1349,3249,1900,1,00134,India
234304,2023-05-30,506,monitor,3249,8000,4751,1,00134,India
234304,2023-05-30,504,iron,449,879,430,1,00134,India
882349,2023-05-30,503,mixer,1349,3249,1900,1,00118,India
882349,2023-05-30,506,monitor,3249,8000,4751,1,00118,India
250946,2023-05-30,503,mixer,1349,3249,1900,1,00402,India
313356,2023-05-30,501,iphone 15,60000,80000,20000,1,00279,India
313356,2023-05-30,506,monitor,3249,8000,4751,1,00279,India
552119,2023-05-30,505,oven,18490,24000,5510,1,00364,India
552119,2023-05-30,507,washing machine,6990,16490,9500,1,00364,India
552119,2023-05-30,504,iron,449,879,430,1,00364,India
113987,2023-05-30,506,monitor,3249,8000,4751,1,00341,India
113987,2023-05-30,501,iphone 15,60000,80000,20000,1,00341,India
113987,2023-05-30,504,iron,449,879,430,1,00341,India
917159,2023-05-30,503,mixer,1349,3249,1900,1,00254,India
917159,2023-05-30,502,iphone 15 pro max,100000,135000,35000,1,00254,India
917159,2023-05-30,507,washing machine,6990,16490,9500,1,00254,India
917159,2023-05-30,505,oven,18490,24000,5510,1,00254,India
579207,2023-05-30,505,oven,18490,24000,5510,1,00129,India
579207,2023-05-30,502,iphone 15 pro max,100000,135000,35000,1,00129,India
579207,2023-05-30,501,iphone 15,60000,80000,20000,1,00129,India
579207,2023-05-30,503,mixer,1349,3249,1900,1,00129,India
625167,2023-05-30,503,mixer,1349,3249,1900,1,00287,India
625167,2023-05-30,507,washing machine,6990,16490,9500,1,00287,India
625167,2023-05-30,501,iphone 15,60000,80000,20000,1,00287,India
467599,2023-05-30,507,washing machine,6990,16490,9500,1,00370,India
467599,2023-05-30,506,monitor,3249,8000,4751,1,00370,India
467599,2023-05-30,503,mixer,1349,3249,1900,1,00370,India
659293,2023-05-30,502,iphone 15 pro max,100000,135000,35000,1,00304,India
659293,2023-05-30,504,iron,449,879,430,1,00304,India
431321,2023-05-30,507,washing machine,6990,16490,9500,1,00450,India
431321,2023-05-30,506,monitor,3249,8000,4751,1,00450,India
696085,2023-05-30,502,iphone 15 pro max,100000,135000,35000,1,00248,India
696085,2023-05-30,503,mixer,1349,3249,1900,1,00248,India
974180,2023-05-30,502,iphone 15 pro max,100000,135000,35000,1,00472,India
974180,2023-05-30,501,iphone 15,60000,80000,20000,1,00472,India
974180,2023-05-30,507,washing machine,6990,16490,9500,1,00472,India
974180,2023-05-30,505,oven,18490,24000,5510,1,00472,India
686546,2023-05-30,503,mixer,1349,3249,1900,1,00074,India
686546,2023-05-30,502,iphone 15 pro max,100000,135000,35000,1,00074,India
686546,2023-05-30,507,washing machine,6990,16490,9500,1,00074,India
686546,2023-05-30,501,iphone 15,60000,80000,20000,1,00074,India
521695,2023-05-30,503,mixer,1349,3249,1900,1,00487,India
521695,2023-05-30,507,washing machine,6990,16490,9500,1,00487,India
320979,2023-05-30,505,oven,18490,24000,5510,1,00305,India
786432,2023-05-30,505,oven,18490,24000,5510,1,00368,India
786432,2023-05-30,506,monitor,3249,8000,4751,1,00368,India
467518,2023-05-30,503,mixer,1349,3249,1900,1,00217,India
467518,2023-05-30,506,monitor,3249,8000,4751,1,00217,India
467518,2023-05-30,501,iphone 15,60000,80000,20000,1,00217,India
927676,2023-05-30,505,oven,18490,24000,5510,1,00327,India
199120,2023-05-30,501,iphone 15,60000,80000,20000,1,00332,India
199120,2023-05-30,502,iphone 15 pro max,100000,135000,35000,1,00332,India
189106,2023-05-30,504,iron,449,879,430,1,00169,India
189106,2023-05-30,507,washing machine,6990,16490,9500,1,00169,India
189106,2023-05-30,503,mixer,1349,3249,1900,1,00169,India
973193,2023-05-30,505,oven,18490,24000,5510,1,00108,India
973193,2023-05-30,506,monitor,3249,8000,4751,1,00108,India
780649,2023-05-30,507,washing machine,6990,16490,9500,1,00334,India
143066,2023-05-30,506,monitor,3249,8000,4751,1,00494,India
143066,2023-05-30,507,washing machine,6990,16490,9500,1,00494,India
420193,2023-05-30,505,oven,18490,24000,5510,1,00046,India
250258,2023-05-30,503,mixer,1349,3249,1900,1,00276,India
250258,2023-05-30,502,iphone 15 pro max,100000,135000,35000,1,00276,India
716556,2023-05-30,506,monitor,3249,8000,4751,1,00427,India
707779,2023-05-30,501,iphone 15,60000,80000,20000,1,00390,India
707779,2023-05-30,504,iron,449,879,430,1,00390,India
707779,2023-05-30,505,oven,18490,24000,5510,1,00390,India
305019,2023-05-30,502,iphone 15 pro max,100000,135000,35000,1,00201,India
305019,2023-05-30,501,iphone 15,60000,80000,20000,1,00201,India
900647,2023-05-30,502,iphone 15 pro max,100000,135000,35000,1,00257,India
592934,2023-05-30,507,washing machine,6990,16490,9500,1,00292,India
592934,2023-05-30,504,iron,449,879,430,1,00292,India
592934,2023-05-30,503,mixer,1349,3249,1900,1,00292,India
845063,2023-05-30,502,iphone 15 pro max,100000,135000,35000,1,00430,India
845063,2023-05-30,506,monitor,3249,8000,4751,1,00430,India
945973,2023-05-30,507,washing machine,6990,16490,9500,1,00368,India
945973,2023-05-30,504,iron,449,879,430,1,00368,India
945973,2023-05-30,503,mixer,1349,3249,1900,1,00368,India
678375,2023-05-30,501,iphone 15,60000,80000,20000,1,00201,India
678375,2023-05-30,507,washing machine,6990,16490,9500,1,00201,India
678375,2023-05-30,506,monitor,3249,8000,4751,1,00201,India
678375,2023-05-30,504,iron,449,879,430,1,00201,India
414817,2023-05-30,503,mixer,1349,3249,1900,1,00468,India
768956,2023-05-30,503,mixer,1349,3249,1900,1,00206,India
982413,2023-05-30,506,monitor,3249,8000,4751,1,00136,India
982413,2023-05-30,505,oven,18490,24000,5510,1,00136,India
982413,2023-05-30,501,iphone 15,60000,80000,20000,1,00136,India
808345,2023-05-30,506,monitor,3249,8000,4751,1,00307,India
808345,2023-05-30,505,oven,18490,24000,5510,1,00307,India
423163,2023-05-30,504,iron,449,879,430,1,00193,India
423163,2023-05-30,507,washing machine,6990,16490,9500,1,00193,India
423163,2023-05-30,502,iphone 15 pro max,100000,135000,35000,1,00193,India
386439,2023-05-30,502,iphone 15 pro max,100000,135000,35000,1,00472,India
386439,2023-05-30,501,iphone 15,60000,80000,20000,1,00472,India
272037,2023-05-30,501,iphone 15,60000,80000,20000,1,00058,India
272037,2023-05-30,505,oven,18490,24000,5510,1,00058,India
272037,2023-05-30,507,washing machine,6990,16490,9500,1,00058,India
272037,2023-05-30,506,monitor,3249,8000,4751,1,00058,India
617274,2023-05-30,504,iron,449,879,430,1,00485,India
617274,2023-05-30,502,iphone 15 pro max,100000,135000,35000,1,00485,India
617274,2023-05-30,507,washing machine,6990,16490,9500,1,00485,India
617274,2023-05-30,506,monitor,3249,8000,4751,1,00485,India
579163,2023-05-30,502,iphone 15 pro max,100000,135000,35000,1,00021,India
579163,2023-05-30,503,mixer,1349,3249,1900,1,00021,India
579163,2023-05-30,505,oven,18490,24000,5510,1,00021,India
606591,2023-05-30,505,oven,18490,24000,5510,1,00379,India
369921,2023-05-30,502,iphone 15 pro max,100000,135000,35000,1,00333,India
369921,2023-05-30,501,iphone 15,60000,80000,20000,1,00333,India
369921,2023-05-30,504,iron,449,879,430,1,00333,India
990441,2023-05-30,503,mixer,1349,3249,1900,1,00143,India
990441,2023-05-30,507,washing machine,6990,16490,9500,1,00143,India
345172,2023-05-30,504,iron,449,879,430,1,00236,India
799991,2023-05-30,503,mixer,1349,3249,1900,1,00028,India
799991,2023-05-30,507,washing machine,6990,16490,9500,1,00028,India
799991,2023-05-30,501,iphone 15,60000,80000,20000,1,00028,India
799991,2023-05-30,502,iphone 15 pro max,100000,135000,35000,1,00028,India
369047,2023-05-30,507,washing machine,6990,16490,9500,1,00400,India
369047,2023-05-30,506,monitor,3249,8000,4751,1,00400,India
372542,2023-05-30,507,washing machine,6990,16490,9500,1,00458,India
372542,2023-05-30,502,iphone 15 pro max,100000,135000,35000,1,00458,India
372542,2023-05-30,505,oven,18490,24000,5510,1,00458,India
885075,2023-05-30,504,iron,449,879,430,1,00269,India
885075,2023-05-30,506,monitor,3249,8000,4751,1,00269,India
885075,2023-05-30,502,iphone 15 pro max,100000,135000,35000,1,00269,India
885075,2023-05-30,505,oven,18490,24000,5510,1,00269,India
465750,2023-05-30,503,mixer,1349,3249,1900,1,00264,India
465750,2023-05-30,505,oven,18490,24000,5510,1,00264,India
232736,2023-05-30,503,mixer,1349,3249,1900,1,00089,India
232736,2023-05-30,502,iphone 15 pro max,100000,135000,35000,1,00089,India
955674,2023-05-30,503,mixer,1349,3249,1900,1,00242,India
289997,2023-05-30,507,washing machine,6990,16490,9500,1,00473,India
289997,2023-05-30,504,iron,449,879,430,1,00473,India
137450,2023-05-30,505,oven,18490,24000,5510,1,00128,India
137450,2023-05-30,506,monitor,3249,8000,4751,1,00128,India
904176,2023-05-30,504,iron,449,879,430,1,00203,India
904176,2023-05-30,503,mixer,1349,3249,1900,1,00203,India
904176,2023-05-30,505,oven,18490,24000,5510,1,00203,India
856349,2023-05-30,506,monitor,3249,8000,4751,1,00237,India
856349,2023-05-30,503,mixer,1349,3249,1900,1,00237,India
856349,2023-05-30,504,iron,449,879,430,1,00237,India
690745,2023-05-30,505,oven,18490,24000,5510,1,00153,India
599513,2023-05-30,504,iron,449,879,430,1,00424,India
599513,2023-05-30,503,mixer,1349,3249,1900,1,00424,India
599513,2023-05-30,501,iphone 15,60000,80000,20000,1,00424,India
599513,2023-05-30,507,washing machine,6990,16490,9500,1,00424,India
493353,2023-05-31,501,iphone 15,60000,80000,20000,1,00055,India
958057,2023-05-31,501,iphone 15,60000,80000,20000,1,00262,India
958057,2023-05-31,504,iron,449,879,430,1,00262,India
958057,2023-05-31,506,monitor,3249,8000,4751,1,00262,India
958057,2023-05-31,507,washing machine,6990,16490,9500,1,00262,India
209133,2023-05-31,506,monitor,3249,8000,4751,1,00469,India
811413,2023-05-31,507,washing machine,6990,16490,9500,1,00461,India
811413,2023-05-31,504,iron,449,879,430,1,00461,India
811413,2023-05-31,501,iphone 15,60000,80000,20000,1,00461,India
811413,2023-05-31,502,iphone 15 pro max,100000,135000,35000,1,00461,India
734770,2023-05-31,506,monitor,3249,8000,4751,1,00194,India
653594,2023-05-31,505,oven,18490,24000,5510,1,00422,India
653594,2023-05-31,506,monitor,3249,8000,4751,1,00422,India
750616,2023-05-31,501,iphone 15,60000,80000,20000,1,00025,India
750616,2023-05-31,503,mixer,1349,3249,1900,1,00025,India
750616,2023-05-31,505,oven,18490,24000,5510,1,00025,India
118006,2023-05-31,507,washing machine,6990,16490,9500,1,00308,India
118006,2023-05-31,501,iphone 15,60000,80000,20000,1,00308,India
118006,2023-05-31,504,iron,449,879,430,1,00308,India
440482,2023-05-31,505,oven,18490,24000,5510,1,00080,India
440482,2023-05-31,501,iphone 15,60000,80000,20000,1,00080,India
440482,2023-05-31,507,washing machine,6990,16490,9500,1,00080,India
440482,2023-05-31,502,iphone 15 pro max,100000,135000,35000,1,00080,India
930085,2023-05-31,506,monitor,3249,8000,4751,1,00386,India
930085,2023-05-31,507,washing machine,6990,16490,9500,1,00386,India
874289,2023-05-31,502,iphone 15 pro max,100000,135000,35000,1,00474,India
874289,2023-05-31,503,mixer,1349,3249,1900,1,00474,India
963900,2023-05-31,504,iron,449,879,430,1,00471,India
149189,2023-05-31,505,oven,18490,24000,5510,1,00272,India
149189,2023-05-31,507,washing machine,6990,16490,9500,1,00272,India
292028,2023-05-31,503,mixer,1349,3249,1900,1,00021,India
292028,2023-05-31,505,oven,18490,24000,5510,1,00021,India
292028,2023-05-31,506,monitor,3249,8000,4751,1,00021,India
192806,2023-05-31,506,monitor,3249,8000,4751,1,00093,India
192806,2023-05-31,505,oven,18490,24000,5510,1,00093,India
192806,2023-05-31,502,iphone 15 pro max,100000,135000,35000,1,00093,India
192806,2023-05-31,504,iron,449,879,430,1,00093,India
192806,2023-05-31,503,mixer,1349,3249,1900,1,00093,India
335224,2023-05-31,507,washing machine,6990,16490,9500,1,00367,India
335224,2023-05-31,503,mixer,1349,3249,1900,1,00367,India
335224,2023-05-31,505,oven,18490,24000,5510,1,00367,India
731400,2023-05-31,504,iron,449,879,430,1,00266,India
893457,2023-05-31,503,mixer,1349,3249,1900,1,00257,India
833842,2023-05-31,504,iron,449,879,430,1,00436,India
833842,2023-05-31,506,monitor,3249,8000,4751,1,00436,India
833842,2023-05-31,505,oven,18490,24000,5510,1,00436,India
833842,2023-05-31,503,mixer,1349,3249,1900,1,00436,India
327301,2023-05-31,507,washing machine,6990,16490,9500,1,00250,India
911410,2023-05-31,506,monitor,3249,8000,4751,1,00205,India
911410,2023-05-31,507,washing machine,6990,16490,9500,1,00205,India
911410,2023-05-31,502,iphone 15 pro max,100000,135000,35000,1,00205,India
111384,2023-05-31,507,washing machine,6990,16490,9500,1,00170,India
111384,2023-05-31,502,iphone 15 pro max,100000,135000,35000,1,00170,India
111384,2023-05-31,503,mixer,1349,3249,1900,1,00170,India
111384,2023-05-31,506,monitor,3249,8000,4751,1,00170,India
585685,2023-05-31,505,oven,18490,24000,5510,1,00308,India
585685,2023-05-31,504,iron,449,879,430,1,00308,India
190301,2023-05-31,501,iphone 15,60000,80000,20000,1,00029,India
190301,2023-05-31,503,mixer,1349,3249,1900,1,00029,India
856950,2023-05-31,503,mixer,1349,3249,1900,1,00043,India
824593,2023-05-31,507,washing machine,6990,16490,9500,1,00165,India
824593,2023-05-31,506,monitor,3249,8000,4751,1,00165,India
824593,2023-05-31,503,mixer,1349,3249,1900,1,00165,India
824593,2023-05-31,502,iphone 15 pro max,100000,135000,35000,1,00165,India
730346,2023-05-31,506,monitor,3249,8000,4751,1,00209,India
283046,2023-05-31,503,mixer,1349,3249,1900,1,00093,India
953483,2023-05-31,505,oven,18490,24000,5510,1,00495,India
453058,2023-05-31,504,iron,449,879,430,1,00424,India
244732,2023-05-31,505,oven,18490,24000,5510,1,00186,India
244732,2023-05-31,507,washing machine,6990,16490,9500,1,00186,India
244732,2023-05-31,503,mixer,1349,3249,1900,1,00186,India
244732,2023-05-31,504,iron,449,879,430,1,00186,India
647725,2023-05-31,501,iphone 15,60000,80000,20000,1,00183,India
647725,2023-05-31,503,mixer,1349,3249,1900,1,00183,India
647725,2023-05-31,505,oven,18490,24000,5510,1,00183,India
647725,2023-05-31,502,iphone 15 pro max,100000,135000,35000,1,00183,India
647725,2023-05-31,507,washing machine,6990,16490,9500,1,00183,India
245752,2023-05-31,501,iphone 15,60000,80000,20000,1,00186,India
245752,2023-05-31,506,monitor,3249,8000,4751,1,00186,India
245752,2023-05-31,505,oven,18490,24000,5510,1,00186,India
245752,2023-05-31,503,mixer,1349,3249,1900,1,00186,India
342634,2023-05-31,506,monitor,3249,8000,4751,1,00005,India
342634,2023-05-31,501,iphone 15,60000,80000,20000,1,00005,India
342634,2023-05-31,505,oven,18490,24000,5510,1,00005,India
756049,2023-05-31,504,iron,449,879,430,1,00456,India
700782,2023-05-31,501,iphone 15,60000,80000,20000,1,00379,India
700782,2023-05-31,503,mixer,1349,3249,1900,1,00379,India
700782,2023-05-31,505,oven,18490,24000,5510,1,00379,India
309535,2023-05-31,503,mixer,1349,3249,1900,1,00308,India
619176,2023-05-31,501,iphone 15,60000,80000,20000,1,00271,India
619176,2023-05-31,503,mixer,1349,3249,1900,1,00271,India
628220,2023-05-31,505,oven,18490,24000,5510,1,00248,India
628220,2023-05-31,506,monitor,3249,8000,4751,1,00248,India
628220,2023-05-31,507,washing machine,6990,16490,9500,1,00248,India
793449,2023-05-31,501,iphone 15,60000,80000,20000,1,00149,India
921670,2023-05-31,505,oven,18490,24000,5510,1,00054,India
921670,2023-05-31,504,iron,449,879,430,1,00054,India
921670,2023-05-31,502,iphone 15 pro max,100000,135000,35000,1,00054,India
718182,2023-05-31,504,iron,449,879,430,1,00280,India
718182,2023-05-31,503,mixer,1349,3249,1900,1,00280,India
718182,2023-05-31,506,monitor,3249,8000,4751,1,00280,India
853449,2023-05-31,504,iron,449,879,430,1,00497,India
636505,2023-05-31,506,monitor,3249,8000,4751,1,00263,India
286630,2023-05-31,504,iron,449,879,430,1,00391,India
286630,2023-05-31,501,iphone 15,60000,80000,20000,1,00391,India
847801,2023-05-31,505,oven,18490,24000,5510,1,00279,India
716863,2023-05-31,506,monitor,3249,8000,4751,1,00367,India
716863,2023-05-31,507,washing machine,6990,16490,9500,1,00367,India
141365,2023-05-31,507,washing machine,6990,16490,9500,1,00251,India
141365,2023-05-31,506,monitor,3249,8000,4751,1,00251,India
648549,2023-05-31,506,monitor,3249,8000,4751,1,00060,India
335116,2023-05-31,501,iphone 15,60000,80000,20000,1,00123,India
335116,2023-05-31,507,washing machine,6990,16490,9500,1,00123,India
200131,2023-05-31,501,iphone 15,60000,80000,20000,1,00056,India
669732,2023-05-31,502,iphone 15 pro max,100000,135000,35000,1,00332,India
840334,2023-05-31,501,iphone 15,60000,80000,20000,1,00208,India
840334,2023-05-31,504,iron,449,879,430,1,00208,India
840334,2023-05-31,503,mixer,1349,3249,1900,1,00208,India
126561,2023-05-31,507,washing machine,6990,16490,9500,1,00401,India
257749,2023-05-31,504,iron,449,879,430,1,00494,India
257749,2023-05-31,501,iphone 15,60000,80000,20000,1,00494,India
676582,2023-05-31,502,iphone 15 pro max,100000,135000,35000,1,00050,India
493656,2023-05-31,504,iron,449,879,430,1,00013,India
493656,2023-05-31,502,iphone 15 pro max,100000,135000,35000,1,00013,India
493656,2023-05-31,501,iphone 15,60000,80000,20000,1,00013,India
658006,2023-05-31,506,monitor,3249,8000,4751,1,00111,India
658006,2023-05-31,504,iron,449,879,430,1,00111,India
658006,2023-05-31,502,iphone 15 pro max,100000,135000,35000,1,00111,India
563688,2023-05-31,505,oven,18490,24000,5510,1,00335,India
563688,2023-05-31,507,washing machine,6990,16490,9500,1,00335,India
563688,2023-05-31,506,monitor,3249,8000,4751,1,00335,India
563688,2023-05-31,501,iphone 15,60000,80000,20000,1,00335,India
563688,2023-05-31,504,iron,449,879,430,1,00335,India
638375,2023-05-31,506,monitor,3249,8000,4751,1,00097,India
638375,2023-05-31,503,mixer,1349,3249,1900,1,00097,India
638375,2023-05-31,502,iphone 15 pro max,100000,135000,35000,1,00097,India
741201,2023-05-31,507,washing machine,6990,16490,9500,1,00115,India
741201,2023-05-31,505,oven,18490,24000,5510,1,00115,India
741201,2023-05-31,502,iphone 15 pro max,100000,135000,35000,1,00115,India
787423,2023-05-31,502,iphone 15 pro max,100000,135000,35000,1,00083,India
787423,2023-05-31,503,mixer,1349,3249,1900,1,00083,India
787423,2023-05-31,504,iron,449,879,430,1,00083,India
787423,2023-05-31,505,oven,18490,24000,5510,1,00083,India
525705,2023-05-31,507,washing machine,6990,16490,9500,1,00104,India
525705,2023-05-31,506,monitor,3249,8000,4751,1,00104,India
525705,2023-05-31,502,iphone 15 pro max,100000,135000,35000,1,00104,India
771070,2023-05-31,504,iron,449,879,430,1,00411,India
771070,2023-05-31,507,washing machine,6990,16490,9500,1,00411,India
992097,2023-05-31,504,iron,449,879,430,1,00148,India
992097,2023-05-31,502,iphone 15 pro max,100000,135000,35000,1,00148,India
992097,2023-05-31,503,mixer,1349,3249,1900,1,00148,India
992097,2023-05-31,501,iphone 15,60000,80000,20000,1,00148,India
168230,2023-05-31,503,mixer,1349,3249,1900,1,00434,India
168230,2023-05-31,502,iphone 15 pro max,100000,135000,35000,1,00434,India
168230,2023-05-31,507,washing machine,6990,16490,9500,1,00434,India
168230,2023-05-31,504,iron,449,879,430,1,00434,India
705853,2023-05-31,503,mixer,1349,3249,1900,1,00203,India
705853,2023-05-31,506,monitor,3249,8000,4751,1,00203,India
945865,2023-05-31,501,iphone 15,60000,80000,20000,1,00183,India
764495,2023-05-31,503,mixer,1349,3249,1900,1,00468,India
764495,2023-05-31,504,iron,449,879,430,1,00468,India
764495,2023-05-31,506,monitor,3249,8000,4751,1,00468,India
764495,2023-05-31,502,iphone 15 pro max,100000,135000,35000,1,00468,India
287509,2023-05-31,504,iron,449,879,430,1,00089,India
287509,2023-05-31,505,oven,18490,24000,5510,1,00089,India
287509,2023-05-31,501,iphone 15,60000,80000,20000,1,00089,India
396863,2023-05-31,502,iphone 15 pro max,100000,135000,35000,1,00388,India
152045,2023-05-31,501,iphone 15,60000,80000,20000,1,00462,India
152045,2023-05-31,505,oven,18490,24000,5510,1,00462,India
152045,2023-05-31,506,monitor,3249,8000,4751,1,00462,India
152045,2023-05-31,502,iphone 15 pro max,100000,135000,35000,1,00462,India
222852,2023-05-31,502,iphone 15 pro max,100000,135000,35000,1,00171,India
222852,2023-05-31,507,washing machine,6990,16490,9500,1,00171,India
222852,2023-05-31,501,iphone 15,60000,80000,20000,1,00171,India
455675,2023-05-31,504,iron,449,879,430,1,00278,India
455675,2023-05-31,503,mixer,1349,3249,1900,1,00278,India
947595,2023-05-31,505,oven,18490,24000,5510,1,00147,India
947595,2023-05-31,501,iphone 15,60000,80000,20000,1,00147,India
947595,2023-05-31,506,monitor,3249,8000,4751,1,00147,India
947595,2023-05-31,502,iphone 15 pro max,100000,135000,35000,1,00147,India
206064,2023-05-31,503,mixer,1349,3249,1900,1,00004,India
358472,2023-05-31,501,iphone 15,60000,80000,20000,1,00284,India
358472,2023-05-31,504,iron,449,879,430,1,00284,India
358472,2023-05-31,506,monitor,3249,8000,4751,1,00284,India
358472,2023-05-31,507,washing machine,6990,16490,9500,1,00284,India
885215,2023-05-31,501,iphone 15,60000,80000,20000,1,00274,India
885215,2023-05-31,503,mixer,1349,3249,1900,1,00274,India
885215,2023-05-31,506,monitor,3249,8000,4751,1,00274,India
885215,2023-05-31,502,iphone 15 pro max,100000,135000,35000,1,00274,India
262083,2023-05-31,502,iphone 15 pro max,100000,135000,35000,1,00300,India
262083,2023-05-31,503,mixer,1349,3249,1900,1,00300,India
485676,2023-05-31,501,iphone 15,60000,80000,20000,1,00080,India
544055,2023-05-31,507,washing machine,6990,16490,9500,1,00288,India
544055,2023-05-31,505,oven,18490,24000,5510,1,00288,India
388540,2023-05-31,503,mixer,1349,3249,1900,1,00094,India
388540,2023-05-31,502,iphone 15 pro max,100000,135000,35000,1,00094,India
388540,2023-05-31,504,iron,449,879,430,1,00094,India
138491,2023-05-31,501,iphone 15,60000,80000,20000,1,00313,India
138491,2023-05-31,506,monitor,3249,8000,4751,1,00313,India
138491,2023-05-31,505,oven,18490,24000,5510,1,00313,India
800948,2023-05-31,504,iron,449,879,430,1,00335,India
800948,2023-05-31,507,washing machine,6990,16490,9500,1,00335,India
800948,2023-05-31,505,oven,18490,24000,5510,1,00335,India
651254,2023-05-31,501,iphone 15,60000,80000,20000,1,00302,India
651254,2023-05-31,503,mixer,1349,3249,1900,1,00302,India
651254,2023-05-31,504,iron,449,879,430,1,00302,India
404891,2023-05-31,505,oven,18490,24000,5510,1,00434,India
404891,2023-05-31,506,monitor,3249,8000,4751,1,00434,India
404891,2023-05-31,501,iphone 15,60000,80000,20000,1,00434,India
785024,2023-05-31,506,monitor,3249,8000,4751,1,00119,India
971989,2023-05-31,501,iphone 15,60000,80000,20000,1,00142,India
158721,2023-05-31,507,washing machine,6990,16490,9500,1,00133,India
611636,2023-06-01,506,monitor,3249,8000,4751,1,00267,India
611636,2023-06-01,501,iphone 15,60000,80000,20000,1,00267,India
611636,2023-06-01,503,mixer,1349,3249,1900,1,00267,India
648881,2023-06-01,501,iphone 15,60000,80000,20000,1,00058,India
648881,2023-06-01,503,mixer,1349,3249,1900,1,00058,India
648881,2023-06-01,507,washing machine,6990,16490,9500,1,00058,India
404614,2023-06-01,505,oven,18490,24000,5510,1,00359,India
527733,2023-06-01,506,monitor,3249,8000,4751,1,00100,India
527733,2023-06-01,504,iron,449,879,430,1,00100,India
527733,2023-06-01,503,mixer,1349,3249,1900,1,00100,India
527733,2023-06-01,505,oven,18490,24000,5510,1,00100,India
849467,2023-06-01,504,iron,449,879,430,1,00045,India
849467,2023-06-01,501,iphone 15,60000,80000,20000,1,00045,India
849467,2023-06-01,503,mixer,1349,3249,1900,1,00045,India
849467,2023-06-01,507,washing machine,6990,16490,9500,1,00045,India
560939,2023-06-01,505,oven,18490,24000,5510,1,00275,India
560939,2023-06-01,501,iphone 15,60000,80000,20000,1,00275,India
560939,2023-06-01,506,monitor,3249,8000,4751,1,00275,India
560939,2023-06-01,504,iron,449,879,430,1,00275,India
105194,2023-06-01,504,iron,449,879,430,1,00223,India
105194,2023-06-01,506,monitor,3249,8000,4751,1,00223,India
113621,2023-06-01,504,iron,449,879,430,1,00135,India
113621,2023-06-01,502,iphone 15 pro max,100000,135000,35000,1,00135,India
113621,2023-06-01,501,iphone 15,60000,80000,20000,1,00135,India
985990,2023-06-01,502,iphone 15 pro max,100000,135000,35000,1,00288,India
985990,2023-06-01,501,iphone 15,60000,80000,20000,1,00288,India
813395,2023-06-01,507,washing machine,6990,16490,9500,1,00483,India
774383,2023-06-01,504,iron,449,879,430,1,00489,India
774383,2023-06-01,506,monitor,3249,8000,4751,1,00489,India
658610,2023-06-01,502,iphone 15 pro max,100000,135000,35000,1,00095,India
658610,2023-06-01,506,monitor,3249,8000,4751,1,00095,India
658610,2023-06-01,503,mixer,1349,3249,1900,1,00095,India
552285,2023-06-01,503,mixer,1349,3249,1900,1,00113,India
151358,2023-06-01,503,mixer,1349,3249,1900,1,00182,India
151358,2023-06-01,507,washing machine,6990,16490,9500,1,00182,India
151358,2023-06-01,505,oven,18490,24000,5510,1,00182,India
151358,2023-06-01,502,iphone 15 pro max,100000,135000,35000,1,00182,India
434345,2023-06-01,504,iron,449,879,430,1,00443,India
434345,2023-06-01,502,iphone 15 pro max,100000,135000,35000,1,00443,India
434345,2023-06-01,506,monitor,3249,8000,4751,1,00443,India
434345,2023-06-01,503,mixer,1349,3249,1900,1,00443,India
677141,2023-06-01,502,iphone 15 pro max,100000,135000,35000,1,00314,India
766608,2023-06-01,503,mixer,1349,3249,1900,1,00260,India
766608,2023-06-01,507,washing machine,6990,16490,9500,1,00260,India
766608,2023-06-01,502,iphone 15 pro max,100000,135000,35000,1,00260,India
785572,2023-06-01,501,iphone 15,60000,80000,20000,1,00043,India
785572,2023-06-01,503,mixer,1349,3249,1900,1,00043,India
785572,2023-06-01,505,oven,18490,24000,5510,1,00043,India
346468,2023-06-01,501,iphone 15,60000,80000,20000,1,00404,India
346468,2023-06-01,507,washing machine,6990,16490,9500,1,00404,India
346468,2023-06-01,502,iphone 15 pro max,100000,135000,35000,1,00404,India
346468,2023-06-01,503,mixer,1349,3249,1900,1,00404,India
703238,2023-06-01,502,iphone 15 pro max,100000,135000,35000,1,00143,India
703238,2023-06-01,501,iphone 15,60000,80000,20000,1,00143,India
136132,2023-06-01,503,mixer,1349,3249,1900,1,00382,India
136132,2023-06-01,504,iron,449,879,430,1,00382,India
136132,2023-06-01,505,oven,18490,24000,5510,1,00382,India
446218,2023-06-01,506,monitor,3249,8000,4751,1,00391,India
444884,2023-06-01,504,iron,449,879,430,1,00332,India
444884,2023-06-01,507,washing machine,6990,16490,9500,1,00332,India
444884,2023-06-01,505,oven,18490,24000,5510,1,00332,India
535126,2023-06-01,507,washing machine,6990,16490,9500,1,00280,India
535126,2023-06-01,505,oven,18490,24000,5510,1,00280,India
255540,2023-06-01,503,mixer,1349,3249,1900,1,00021,India
255540,2023-06-01,507,washing machine,6990,16490,9500,1,00021,India
255540,2023-06-01,504,iron,449,879,430,1,00021,India
955813,2023-06-01,503,mixer,1349,3249,1900,1,00223,India
955813,2023-06-01,504,iron,449,879,430,1,00223,India
955813,2023-06-01,501,iphone 15,60000,80000,20000,1,00223,India
614362,2023-06-01,505,oven,18490,24000,5510,1,00073,India
584438,2023-06-01,505,oven,18490,24000,5510,1,00343,India
584438,2023-06-01,501,iphone 15,60000,80000,20000,1,00343,India
584438,2023-06-01,502,iphone 15 pro max,100000,135000,35000,1,00343,India
230098,2023-06-01,504,iron,449,879,430,1,00113,India
230098,2023-06-01,502,iphone 15 pro max,100000,135000,35000,1,00113,India
230098,2023-06-01,501,iphone 15,60000,80000,20000,1,00113,India
230098,2023-06-01,503,mixer,1349,3249,1900,1,00113,India
176490,2023-06-01,501,iphone 15,60000,80000,20000,1,00269,India
176490,2023-06-01,503,mixer,1349,3249,1900,1,00269,India
567182,2023-06-01,507,washing machine,6990,16490,9500,1,00337,India
567182,2023-06-01,503,mixer,1349,3249,1900,1,00337,India
567182,2023-06-01,506,monitor,3249,8000,4751,1,00337,India
567182,2023-06-01,505,oven,18490,24000,5510,1,00337,India
567182,2023-06-01,501,iphone 15,60000,80000,20000,1,00337,India
418492,2023-06-01,505,oven,18490,24000,5510,1,00291,India
418492,2023-06-01,503,mixer,1349,3249,1900,1,00291,India
418492,2023-06-01,502,iphone 15 pro max,100000,135000,35000,1,00291,India
845888,2023-06-01,505,oven,18490,24000,5510,1,00237,India
845888,2023-06-01,503,mixer,1349,3249,1900,1,00237,India
777777,2023-06-01,506,monitor,3249,8000,4751,1,00262,India
777777,2023-06-01,504,iron,449,879,430,1,00262,India
777777,2023-06-01,507,washing machine,6990,16490,9500,1,00262,India
438032,2023-06-01,501,iphone 15,60000,80000,20000,1,00294,India
438032,2023-06-01,502,iphone 15 pro max,100000,135000,35000,1,00294,India
438032,2023-06-01,505,oven,18490,24000,5510,1,00294,India
438032,2023-06-01,507,washing machine,6990,16490,9500,1,00294,India
137645,2023-06-01,506,monitor,3249,8000,4751,1,00127,India
137645,2023-06-01,502,iphone 15 pro max,100000,135000,35000,1,00127,India
137645,2023-06-01,501,iphone 15,60000,80000,20000,1,00127,India
137645,2023-06-01,505,oven,18490,24000,5510,1,00127,India
828745,2023-06-01,501,iphone 15,60000,80000,20000,1,00147,India
828745,2023-06-01,507,washing machine,6990,16490,9500,1,00147,India
828745,2023-06-01,504,iron,449,879,430,1,00147,India
828745,2023-06-01,506,monitor,3249,8000,4751,1,00147,India
665817,2023-06-01,506,monitor,3249,8000,4751,1,00242,India
665817,2023-06-01,504,iron,449,879,430,1,00242,India
665817,2023-06-01,502,iphone 15 pro max,100000,135000,35000,1,00242,India
502887,2023-06-01,501,iphone 15,60000,80000,20000,1,00379,India
502887,2023-06-01,505,oven,18490,24000,5510,1,00379,India
502887,2023-06-01,507,washing machine,6990,16490,9500,1,00379,India
502887,2023-06-01,503,mixer,1349,3249,1900,1,00379,India
266435,2023-06-01,502,iphone 15 pro max,100000,135000,35000,1,00475,India
266435,2023-06-01,504,iron,449,879,430,1,00475,India
324258,2023-06-01,502,iphone 15 pro max,100000,135000,35000,1,00314,India
324258,2023-06-01,506,monitor,3249,8000,4751,1,00314,India
324258,2023-06-01,504,iron,449,879,430,1,00314,India
324258,2023-06-01,507,washing machine,6990,16490,9500,1,00314,India
838315,2023-06-01,503,mixer,1349,3249,1900,1,00250,India
838315,2023-06-01,502,iphone 15 pro max,100000,135000,35000,1,00250,India
838315,2023-06-01,507,washing machine,6990,16490,9500,1,00250,India
838315,2023-06-01,504,iron,449,879,430,1,00250,India
302868,2023-06-01,506,monitor,3249,8000,4751,1,00332,India
302868,2023-06-01,504,iron,449,879,430,1,00332,India
302868,2023-06-01,507,washing machine,6990,16490,9500,1,00332,India
302868,2023-06-01,502,iphone 15 pro max,100000,135000,35000,1,00332,India
507142,2023-06-01,507,washing machine,6990,16490,9500,1,00123,India
507142,2023-06-01,504,iron,449,879,430,1,00123,India
116815,2023-06-01,502,iphone 15 pro max,100000,135000,35000,1,00362,India
116815,2023-06-01,506,monitor,3249,8000,4751,1,00362,India
116815,2023-06-01,504,iron,449,879,430,1,00362,India
116815,2023-06-01,507,washing machine,6990,16490,9500,1,00362,India
967393,2023-06-01,502,iphone 15 pro max,100000,135000,35000,1,00298,India
967393,2023-06-01,505,oven,18490,24000,5510,1,00298,India
967393,2023-06-01,506,monitor,3249,8000,4751,1,00298,India
957356,2023-06-01,501,iphone 15,60000,80000,20000,1,00415,India
549422,2023-06-01,504,iron,449,879,430,1,00315,India
549422,2023-06-01,501,iphone 15,60000,80000,20000,1,00315,India
549422,2023-06-01,503,mixer,1349,3249,1900,1,00315,India
101035,2023-06-01,502,iphone 15 pro max,100000,135000,35000,1,00322,India
101035,2023-06-01,503,mixer,1349,3249,1900,1,00322,India
963116,2023-06-01,505,oven,18490,24000,5510,1,00305,India
963116,2023-06-01,502,iphone 15 pro max,100000,135000,35000,1,00305,India
581116,2023-06-01,502,iphone 15 pro max,100000,135000,35000,1,00492,India
581116,2023-06-01,501,iphone 15,60000,80000,20000,1,00492,India
776315,2023-06-01,506,monitor,3249,8000,4751,1,00314,India
752345,2023-06-01,505,oven,18490,24000,5510,1,00222,India
752345,2023-06-01,507,washing machine,6990,16490,9500,1,00222,India
752345,2023-06-01,502,iphone 15 pro max,100000,135000,35000,1,00222,India
752345,2023-06-01,506,monitor,3249,8000,4751,1,00222,India
900276,2023-06-01,501,iphone 15,60000,80000,20000,1,00380,India
900276,2023-06-01,507,washing machine,6990,16490,9500,1,00380,India
900276,2023-06-01,504,iron,449,879,430,1,00380,India
900276,2023-06-01,506,monitor,3249,8000,4751,1,00380,India
613976,2023-06-01,505,oven,18490,24000,5510,1,00415,India
613976,2023-06-01,502,iphone 15 pro max,100000,135000,35000,1,00415,India
152341,2023-06-01,507,washing machine,6990,16490,9500,1,00481,India
152341,2023-06-01,503,mixer,1349,3249,1900,1,00481,India
152341,2023-06-01,506,monitor,3249,8000,4751,1,00481,India
751989,2023-06-01,504,iron,449,879,430,1,00289,India
751989,2023-06-01,505,oven,18490,24000,5510,1,00289,India
751989,2023-06-01,502,iphone 15 pro max,100000,135000,35000,1,00289,India
898370,2023-06-01,507,washing machine,6990,16490,9500,1,00172,India
898370,2023-06-01,505,oven,18490,24000,5510,1,00172,India
898370,2023-06-01,502,iphone 15 pro max,100000,135000,35000,1,00172,India
958178,2023-06-01,501,iphone 15,60000,80000,20000,1,00455,India
864680,2023-06-01,504,iron,449,879,430,1,00136,India
864680,2023-06-01,505,oven,18490,24000,5510,1,00136,India
393631,2023-06-01,501,iphone 15,60000,80000,20000,1,00141,India
393631,2023-06-01,507,washing machine,6990,16490,9500,1,00141,India
996855,2023-06-01,507,washing machine,6990,16490,9500,1,00112,India
996855,2023-06-01,506,monitor,3249,8000,4751,1,00112,India
345672,2023-06-01,507,washing machine,6990,16490,9500,1,00011,India
345672,2023-06-01,506,monitor,3249,8000,4751,1,00011,India
345672,2023-06-01,505,oven,18490,24000,5510,1,00011,India
790629,2023-06-01,507,washing machine,6990,16490,9500,1,00083,India
790629,2023-06-01,506,monitor,3249,8000,4751,1,00083,India
790629,2023-06-01,503,mixer,1349,3249,1900,1,00083,India
731951,2023-06-01,503,mixer,1349,3249,1900,1,00018,India
731951,2023-06-01,502,iphone 15 pro max,100000,135000,35000,1,00018,India
578546,2023-06-01,506,monitor,3249,8000,4751,1,00172,India
578546,2023-06-01,502,iphone 15 pro max,100000,135000,35000,1,00172,India
578546,2023-06-01,505,oven,18490,24000,5510,1,00172,India
957514,2023-06-01,506,monitor,3249,8000,4751,1,00144,India
280827,2023-06-01,502,iphone 15 pro max,100000,135000,35000,1,00055,India
280827,2023-06-01,504,iron,449,879,430,1,00055,India
280827,2023-06-01,507,washing machine,6990,16490,9500,1,00055,India
578743,2023-06-01,503,mixer,1349,3249,1900,1,00416,India
578743,2023-06-01,502,iphone 15 pro max,100000,135000,35000,1,00416,India
578743,2023-06-01,505,oven,18490,24000,5510,1,00416,India
377694,2023-06-01,505,oven,18490,24000,5510,1,00490,India
377694,2023-06-01,503,mixer,1349,3249,1900,1,00490,India
377694,2023-06-01,501,iphone 15,60000,80000,20000,1,00490,India
485610,2023-06-01,503,mixer,1349,3249,1900,1,00464,India
962838,2023-06-01,505,oven,18490,24000,5510,1,00250,India
962838,2023-06-01,507,washing machine,6990,16490,9500,1,00250,India
962838,2023-06-01,506,monitor,3249,8000,4751,1,00250,India
288765,2023-06-01,502,iphone 15 pro max,100000,135000,35000,1,00492,India
288765,2023-06-01,506,monitor,3249,8000,4751,1,00492,India
202632,2023-06-01,502,iphone 15 pro max,100000,135000,35000,1,00277,India
202632,2023-06-01,501,iphone 15,60000,80000,20000,1,00277,India
380814,2023-06-01,503,mixer,1349,3249,1900,1,00093,India
380814,2023-06-01,506,monitor,3249,8000,4751,1,00093,India
490718,2023-06-01,507,washing machine,6990,16490,9500,1,00497,India
490718,2023-06-01,505,oven,18490,24000,5510,1,00497,India
490718,2023-06-01,506,monitor,3249,8000,4751,1,00497,India
652439,2023-06-01,503,mixer,1349,3249,1900,1,00294,India
652439,2023-06-01,506,monitor,3249,8000,4751,1,00294,India
652439,2023-06-01,507,washing machine,6990,16490,9500,1,00294,India
652439,2023-06-01,502,iphone 15 pro max,100000,135000,35000,1,00294,India
889289,2023-06-01,505,oven,18490,24000,5510,1,00292,India
889289,2023-06-01,507,washing machine,6990,16490,9500,1,00292,India
845389,2023-06-01,503,mixer,1349,3249,1900,1,00475,India
845389,2023-06-01,507,washing machine,6990,16490,9500,1,00475,India
292075,2023-06-01,503,mixer,1349,3249,1900,1,00409,India
292075,2023-06-01,502,iphone 15 pro max,100000,135000,35000,1,00409,India
292075,2023-06-01,501,iphone 15,60000,80000,20000,1,00409,India
292075,2023-06-01,507,washing machine,6990,16490,9500,1,00409,India
306029,2023-06-01,506,monitor,3249,8000,4751,1,00216,India
306029,2023-06-01,505,oven,18490,24000,5510,1,00216,India
306029,2023-06-01,504,iron,449,879,430,1,00216,India
492684,2023-06-01,503,mixer,1349,3249,1900,1,00335,India
492684,2023-06-01,504,iron,449,879,430,1,00335,India
492684,2023-06-01,505,oven,18490,24000,5510,1,00335,India
492684,2023-06-01,501,iphone 15,60000,80000,20000,1,00335,India
957489,2023-06-01,506,monitor,3249,8000,4751,1,00265,India
957489,2023-06-01,501,iphone 15,60000,80000,20000,1,00265,India
957489,2023-06-01,505,oven,18490,24000,5510,1,00265,India
946407,2023-06-01,502,iphone 15 pro max,100000,135000,35000,1,00100,India
946407,2023-06-01,501,iphone 15,60000,80000,20000,1,00100,India
946407,2023-06-01,505,oven,18490,24000,5510,1,00100,India
221105,2023-06-01,506,monitor,3249,8000,4751,1,00190,India
205406,2023-06-01,506,monitor,3249,8000,4751,1,00111,India
205406,2023-06-01,504,iron,449,879,430,1,00111,India
205406,2023-06-01,507,washing machine,6990,16490,9500,1,00111,India
205406,2023-06-01,501,iphone 15,60000,80000,20000,1,00111,India
238262,2023-06-02,507,washing machine,6990,16490,9500,1,00231,India
238262,2023-06-02,505,oven,18490,24000,5510,1,00231,India
238262,2023-06-02,503,mixer,1349,3249,1900,1,00231,India
874835,2023-06-02,505,oven,18490,24000,5510,1,00052,India
874835,2023-06-02,507,washing machine,6990,16490,9500,1,00052,India
639926,2023-06-02,501,iphone 15,60000,80000,20000,1,00114,India
639926,2023-06-02,505,oven,18490,24000,5510,1,00114,India
639926,2023-06-02,507,washing machine,6990,16490,9500,1,00114,India
263716,2023-06-02,506,monitor,3249,8000,4751,1,00331,India
263716,2023-06-02,501,iphone 15,60000,80000,20000,1,00331,India
879330,2023-06-02,504,iron,449,879,430,1,00385,India
672221,2023-06-02,504,iron,449,879,430,1,00493,India
657689,2023-06-02,506,monitor,3249,8000,4751,1,00464,India
982516,2023-06-02,502,iphone 15 pro max,100000,135000,35000,1,00110,India
982516,2023-06-02,507,washing machine,6990,16490,9500,1,00110,India
377970,2023-06-02,507,washing machine,6990,16490,9500,1,00122,India
377970,2023-06-02,502,iphone 15 pro max,100000,135000,35000,1,00122,India
936861,2023-06-02,504,iron,449,879,430,1,00401,India
936861,2023-06-02,501,iphone 15,60000,80000,20000,1,00401,India
936861,2023-06-02,507,washing machine,6990,16490,9500,1,00401,India
215483,2023-06-02,501,iphone 15,60000,80000,20000,1,00492,India
215483,2023-06-02,503,mixer,1349,3249,1900,1,00492,India
834392,2023-06-02,505,oven,18490,24000,5510,1,00232,India
834392,2023-06-02,502,iphone 15 pro max,100000,135000,35000,1,00232,India
834392,2023-06-02,506,monitor,3249,8000,4751,1,00232,India
272046,2023-06-02,503,mixer,1349,3249,1900,1,00481,India
272046,2023-06-02,504,iron,449,879,430,1,00481,India
272046,2023-06-02,507,washing machine,6990,16490,9500,1,00481,India
535181,2023-06-02,505,oven,18490,24000,5510,1,00231,India
535181,2023-06-02,504,iron,449,879,430,1,00231,India
535181,2023-06-02,501,iphone 15,60000,80000,20000,1,00231,India
535564,2023-06-02,501,iphone 15,60000,80000,20000,1,00340,India
535564,2023-06-02,507,washing machine,6990,16490,9500,1,00340,India
253610,2023-06-02,505,oven,18490,24000,5510,1,00016,India
819745,2023-06-02,501,iphone 15,60000,80000,20000,1,00074,India
819745,2023-06-02,503,mixer,1349,3249,1900,1,00074,India
751235,2023-06-02,505,oven,18490,24000,5510,1,00121,India
829541,2023-06-02,503,mixer,1349,3249,1900,1,00475,India
122535,2023-06-02,504,iron,449,879,430,1,00496,India
372893,2023-06-02,502,iphone 15 pro max,100000,135000,35000,1,00455,India
372893,2023-06-02,503,mixer,1349,3249,1900,1,00455,India
859513,2023-06-02,501,iphone 15,60000,80000,20000,1,00251,India
859513,2023-06-02,502,iphone 15 pro max,100000,135000,35000,1,00251,India
859513,2023-06-02,503,mixer,1349,3249,1900,1,00251,India
488949,2023-06-02,507,washing machine,6990,16490,9500,1,00059,India
488949,2023-06-02,504,iron,449,879,430,1,00059,India
488949,2023-06-02,502,iphone 15 pro max,100000,135000,35000,1,00059,India
515046,2023-06-02,505,oven,18490,24000,5510,1,00403,India
515046,2023-06-02,502,iphone 15 pro max,100000,135000,35000,1,00403,India
515046,2023-06-02,504,iron,449,879,430,1,00403,India
515046,2023-06-02,507,washing machine,6990,16490,9500,1,00403,India
515046,2023-06-02,506,monitor,3249,8000,4751,1,00403,India
933337,2023-06-02,507,washing machine,6990,16490,9500,1,00058,India
997049,2023-06-02,503,mixer,1349,3249,1900,1,00353,India
997049,2023-06-02,501,iphone 15,60000,80000,20000,1,00353,India
997049,2023-06-02,502,iphone 15 pro max,100000,135000,35000,1,00353,India
997049,2023-06-02,505,oven,18490,24000,5510,1,00353,India
347809,2023-06-02,504,iron,449,879,430,1,00055,India
571667,2023-06-02,503,mixer,1349,3249,1900,1,00341,India
992034,2023-06-02,505,oven,18490,24000,5510,1,00280,India
992034,2023-06-02,507,washing machine,6990,16490,9500,1,00280,India
632063,2023-06-02,502,iphone 15 pro max,100000,135000,35000,1,00198,India
314485,2023-06-02,507,washing machine,6990,16490,9500,1,00208,India
314485,2023-06-02,502,iphone 15 pro max,100000,135000,35000,1,00208,India
314485,2023-06-02,504,iron,449,879,430,1,00208,India
269292,2023-06-02,504,iron,449,879,430,1,00465,India
269292,2023-06-02,502,iphone 15 pro max,100000,135000,35000,1,00465,India
596242,2023-06-02,506,monitor,3249,8000,4751,1,00022,India
596242,2023-06-02,501,iphone 15,60000,80000,20000,1,00022,India
654756,2023-06-02,504,iron,449,879,430,1,00088,India
654756,2023-06-02,507,washing machine,6990,16490,9500,1,00088,India
178449,2023-06-02,507,washing machine,6990,16490,9500,1,00020,India
178449,2023-06-02,502,iphone 15 pro max,100000,135000,35000,1,00020,India
178449,2023-06-02,504,iron,449,879,430,1,00020,India
582910,2023-06-02,503,mixer,1349,3249,1900,1,00181,India
604873,2023-06-02,504,iron,449,879,430,1,00101,India
672153,2023-06-02,507,washing machine,6990,16490,9500,1,00463,India
672153,2023-06-02,506,monitor,3249,8000,4751,1,00463,India
672153,2023-06-02,505,oven,18490,24000,5510,1,00463,India
672153,2023-06-02,504,iron,449,879,430,1,00463,India
539452,2023-06-02,506,monitor,3249,8000,4751,1,00220,India
539452,2023-06-02,504,iron,449,879,430,1,00220,India
539452,2023-06-02,503,mixer,1349,3249,1900,1,00220,India
539452,2023-06-02,505,oven,18490,24000,5510,1,00220,India
671055,2023-06-02,506,monitor,3249,8000,4751,1,00357,India
671055,2023-06-02,504,iron,449,879,430,1,00357,India
671055,2023-06-02,507,washing machine,6990,16490,9500,1,00357,India
762672,2023-06-02,504,iron,449,879,430,1,00035,India
244394,2023-06-02,506,monitor,3249,8000,4751,1,00292,India
244394,2023-06-02,501,iphone 15,60000,80000,20000,1,00292,India
244394,2023-06-02,504,iron,449,879,430,1,00292,India
960189,2023-06-02,502,iphone 15 pro max,100000,135000,35000,1,00156,India
502206,2023-06-02,501,iphone 15,60000,80000,20000,1,00052,India
502206,2023-06-02,507,washing machine,6990,16490,9500,1,00052,India
502206,2023-06-02,506,monitor,3249,8000,4751,1,00052,India
485656,2023-06-02,501,iphone 15,60000,80000,20000,1,00302,India
485656,2023-06-02,507,washing machine,6990,16490,9500,1,00302,India
494687,2023-06-02,507,washing machine,6990,16490,9500,1,00364,India
494687,2023-06-02,506,monitor,3249,8000,4751,1,00364,India
598961,2023-06-02,506,monitor,3249,8000,4751,1,00106,India
598961,2023-06-02,504,iron,449,879,430,1,00106,India
598961,2023-06-02,503,mixer,1349,3249,1900,1,00106,India
993428,2023-06-02,503,mixer,1349,3249,1900,1,00025,India
343835,2023-06-02,503,mixer,1349,3249,1900,1,00017,India
343835,2023-06-02,507,washing machine,6990,16490,9500,1,00017,India
343835,2023-06-02,502,iphone 15 pro max,100000,135000,35000,1,00017,India
218012,2023-06-02,503,mixer,1349,3249,1900,1,00265,India
218012,2023-06-02,501,iphone 15,60000,80000,20000,1,00265,India
218012,2023-06-02,504,iron,449,879,430,1,00265,India
733694,2023-06-02,507,washing machine,6990,16490,9500,1,00486,India
733694,2023-06-02,501,iphone 15,60000,80000,20000,1,00486,India
733694,2023-06-02,503,mixer,1349,3249,1900,1,00486,India
733694,2023-06-02,505,oven,18490,24000,5510,1,00486,India
750749,2023-06-02,501,iphone 15,60000,80000,20000,1,00362,India
750749,2023-06-02,504,iron,449,879,430,1,00362,India
750749,2023-06-02,507,washing machine,6990,16490,9500,1,00362,India
767525,2023-06-02,506,monitor,3249,8000,4751,1,00126,India
350474,2023-06-02,505,oven,18490,24000,5510,1,00487,India
350474,2023-06-02,502,iphone 15 pro max,100000,135000,35000,1,00487,India
350474,2023-06-02,506,monitor,3249,8000,4751,1,00487,India
350474,2023-06-02,507,washing machine,6990,16490,9500,1,00487,India
361103,2023-06-02,504,iron,449,879,430,1,00365,India
361103,2023-06-02,507,washing machine,6990,16490,9500,1,00365,India
361103,2023-06-02,503,mixer,1349,3249,1900,1,00365,India
361103,2023-06-02,506,monitor,3249,8000,4751,1,00365,India
648201,2023-06-02,502,iphone 15 pro max,100000,135000,35000,1,00430,India
437082,2023-06-02,504,iron,449,879,430,1,00082,India
437082,2023-06-02,507,washing machine,6990,16490,9500,1,00082,India
437082,2023-06-02,506,monitor,3249,8000,4751,1,00082,India
402597,2023-06-02,501,iphone 15,60000,80000,20000,1,00061,India
402597,2023-06-02,504,iron,449,879,430,1,00061,India
402597,2023-06-02,503,mixer,1349,3249,1900,1,00061,India
299529,2023-06-02,504,iron,449,879,430,1,00068,India
299529,2023-06-02,505,oven,18490,24000,5510,1,00068,India
299529,2023-06-02,501,iphone 15,60000,80000,20000,1,00068,India
299529,2023-06-02,506,monitor,3249,8000,4751,1,00068,India
299529,2023-06-02,507,washing machine,6990,16490,9500,1,00068,India
382597,2023-06-02,506,monitor,3249,8000,4751,1,00103,India
382597,2023-06-02,507,washing machine,6990,16490,9500,1,00103,India
382597,2023-06-02,505,oven,18490,24000,5510,1,00103,India
239332,2023-06-02,505,oven,18490,24000,5510,1,00468,India
239332,2023-06-02,502,iphone 15 pro max,100000,135000,35000,1,00468,India
239332,2023-06-02,504,iron,449,879,430,1,00468,India
861797,2023-06-02,504,iron,449,879,430,1,00411,India
861797,2023-06-02,503,mixer,1349,3249,1900,1,00411,India
861797,2023-06-02,506,monitor,3249,8000,4751,1,00411,India
505853,2023-06-02,502,iphone 15 pro max,100000,135000,35000,1,00353,India
505853,2023-06-02,505,oven,18490,24000,5510,1,00353,India
576634,2023-06-02,507,washing machine,6990,16490,9500,1,00050,India
576634,2023-06-02,501,iphone 15,60000,80000,20000,1,00050,India
942043,2023-06-02,507,washing machine,6990,16490,9500,1,00493,India
712136,2023-06-02,507,washing machine,6990,16490,9500,1,00177,India
712136,2023-06-02,502,iphone 15 pro max,100000,135000,35000,1,00177,India
239242,2023-06-02,501,iphone 15,60000,80000,20000,1,00046,India
239242,2023-06-02,502,iphone 15 pro max,100000,135000,35000,1,00046,India
141388,2023-06-02,502,iphone 15 pro max,100000,135000,35000,1,00124,India
141388,2023-06-02,507,washing machine,6990,16490,9500,1,00124,India
141388,2023-06-02,503,mixer,1349,3249,1900,1,00124,India
141388,2023-06-02,505,oven,18490,24000,5510,1,00124,India
896857,2023-06-02,506,monitor,3249,8000,4751,1,00094,India
896857,2023-06-02,502,iphone 15 pro max,100000,135000,35000,1,00094,India
896857,2023-06-02,504,iron,449,879,430,1,00094,India
806921,2023-06-02,502,iphone 15 pro max,100000,135000,35000,1,00147,India
806921,2023-06-02,503,mixer,1349,3249,1900,1,00147,India
201688,2023-06-02,502,iphone 15 pro max,100000,135000,35000,1,00072,India
201688,2023-06-02,501,iphone 15,60000,80000,20000,1,00072,India
144365,2023-06-02,504,iron,449,879,430,1,00411,India
144365,2023-06-02,506,monitor,3249,8000,4751,1,00411,India
144365,2023-06-02,503,mixer,1349,3249,1900,1,00411,India
774114,2023-06-02,503,mixer,1349,3249,1900,1,00452,India
774114,2023-06-02,507,washing machine,6990,16490,9500,1,00452,India
774114,2023-06-02,506,monitor,3249,8000,4751,1,00452,India
774114,2023-06-02,504,iron,449,879,430,1,00452,India
185766,2023-06-02,506,monitor,3249,8000,4751,1,00488,India
185766,2023-06-02,503,mixer,1349,3249,1900,1,00488,India
185766,2023-06-02,502,iphone 15 pro max,100000,135000,35000,1,00488,India
185766,2023-06-02,505,oven,18490,24000,5510,1,00488,India
856956,2023-06-02,502,iphone 15 pro max,100000,135000,35000,1,00402,India
856956,2023-06-02,504,iron,449,879,430,1,00402,India
856956,2023-06-02,506,monitor,3249,8000,4751,1,00402,India
856956,2023-06-02,503,mixer,1349,3249,1900,1,00402,India
848610,2023-06-02,502,iphone 15 pro max,100000,135000,35000,1,00431,India
848610,2023-06-02,503,mixer,1349,3249,1900,1,00431,India
880314,2023-06-02,505,oven,18490,24000,5510,1,00035,India
880314,2023-06-02,503,mixer,1349,3249,1900,1,00035,India
295724,2023-06-02,502,iphone 15 pro max,100000,135000,35000,1,00208,India
295724,2023-06-02,507,washing machine,6990,16490,9500,1,00208,India
295724,2023-06-02,503,mixer,1349,3249,1900,1,00208,India
923514,2023-06-03,507,washing machine,6990,16490,9500,1,00302,India
923514,2023-06-03,501,iphone 15,60000,80000,20000,1,00302,India
923514,2023-06-03,503,mixer,1349,3249,1900,1,00302,India
939044,2023-06-03,502,iphone 15 pro max,100000,135000,35000,1,00305,India
939044,2023-06-03,504,iron,449,879,430,1,00305,India
156339,2023-06-03,505,oven,18490,24000,5510,1,00146,India
156339,2023-06-03,502,iphone 15 pro max,100000,135000,35000,1,00146,India
156339,2023-06-03,504,iron,449,879,430,1,00146,India
156339,2023-06-03,506,monitor,3249,8000,4751,1,00146,India
156339,2023-06-03,501,iphone 15,60000,80000,20000,1,00146,India
700702,2023-06-03,502,iphone 15 pro max,100000,135000,35000,1,00403,India
700702,2023-06-03,501,iphone 15,60000,80000,20000,1,00403,India
700702,2023-06-03,505,oven,18490,24000,5510,1,00403,India
700702,2023-06-03,507,washing machine,6990,16490,9500,1,00403,India
700702,2023-06-03,503,mixer,1349,3249,1900,1,00403,India
955641,2023-06-03,502,iphone 15 pro max,100000,135000,35000,1,00164,India
760377,2023-06-03,501,iphone 15,60000,80000,20000,1,00121,India
440093,2023-06-03,504,iron,449,879,430,1,00183,India
440093,2023-06-03,505,oven,18490,24000,5510,1,00183,India
440093,2023-06-03,506,monitor,3249,8000,4751,1,00183,India
443965,2023-06-03,507,washing machine,6990,16490,9500,1,00378,India
443965,2023-06-03,506,monitor,3249,8000,4751,1,00378,India
372839,2023-06-03,506,monitor,3249,8000,4751,1,00216,India
372839,2023-06-03,505,oven,18490,24000,5510,1,00216,India
542506,2023-06-03,502,iphone 15 pro max,100000,135000,35000,1,00431,India
542506,2023-06-03,503,mixer,1349,3249,1900,1,00431,India
608602,2023-06-03,502,iphone 15 pro max,100000,135000,35000,1,00160,India
608602,2023-06-03,507,washing machine,6990,16490,9500,1,00160,India
246652,2023-06-03,504,iron,449,879,430,1,00172,India
246652,2023-06-03,501,iphone 15,60000,80000,20000,1,00172,India
246652,2023-06-03,502,iphone 15 pro max,100000,135000,35000,1,00172,India
685512,2023-06-03,506,monitor,3249,8000,4751,1,00068,India
997378,2023-06-03,501,iphone 15,60000,80000,20000,1,00440,India
348324,2023-06-03,504,iron,449,879,430,1,00428,India
348324,2023-06-03,502,iphone 15 pro max,100000,135000,35000,1,00428,India
348324,2023-06-03,507,washing machine,6990,16490,9500,1,00428,India
611951,2023-06-03,501,iphone 15,60000,80000,20000,1,00300,India
611951,2023-06-03,502,iphone 15 pro max,100000,135000,35000,1,00300,India
611951,2023-06-03,507,washing machine,6990,16490,9500,1,00300,India
611951,2023-06-03,505,oven,18490,24000,5510,1,00300,India
611951,2023-06-03,506,monitor,3249,8000,4751,1,00300,India
717474,2023-06-03,501,iphone 15,60000,80000,20000,1,00319,India
249868,2023-06-03,505,oven,18490,24000,5510,1,00054,India
767942,2023-06-03,507,washing machine,6990,16490,9500,1,00058,India
787095,2023-06-03,503,mixer,1349,3249,1900,1,00331,India
787095,2023-06-03,507,washing machine,6990,16490,9500,1,00331,India
787095,2023-06-03,505,oven,18490,24000,5510,1,00331,India
583573,2023-06-03,502,iphone 15 pro max,100000,135000,35000,1,00496,India
583573,2023-06-03,506,monitor,3249,8000,4751,1,00496,India
583573,2023-06-03,505,oven,18490,24000,5510,1,00496,India
583573,2023-06-03,504,iron,449,879,430,1,00496,India
382708,2023-06-03,507,washing machine,6990,16490,9500,1,00149,India
840806,2023-06-03,501,iphone 15,60000,80000,20000,1,00263,India
840806,2023-06-03,506,monitor,3249,8000,4751,1,00263,India
840806,2023-06-03,505,oven,18490,24000,5510,1,00263,India
261340,2023-06-03,507,washing machine,6990,16490,9500,1,00222,India
866567,2023-06-03,505,oven,18490,24000,5510,1,00087,India
866567,2023-06-03,503,mixer,1349,3249,1900,1,00087,India
866567,2023-06-03,504,iron,449,879,430,1,00087,India
866567,2023-06-03,507,washing machine,6990,16490,9500,1,00087,India
822490,2023-06-03,502,iphone 15 pro max,100000,135000,35000,1,00100,India
822490,2023-06-03,501,iphone 15,60000,80000,20000,1,00100,India
822490,2023-06-03,504,iron,449,879,430,1,00100,India
822490,2023-06-03,507,washing machine,6990,16490,9500,1,00100,India
486370,2023-06-03,507,washing machine,6990,16490,9500,1,00221,India
486370,2023-06-03,505,oven,18490,24000,5510,1,00221,India
486370,2023-06-03,506,monitor,3249,8000,4751,1,00221,India
252616,2023-06-03,503,mixer,1349,3249,1900,1,00409,India
252616,2023-06-03,502,iphone 15 pro max,100000,135000,35000,1,00409,India
252616,2023-06-03,506,monitor,3249,8000,4751,1,00409,India
252616,2023-06-03,501,iphone 15,60000,80000,20000,1,00409,India
495040,2023-06-03,507,washing machine,6990,16490,9500,1,00232,India
495040,2023-06-03,502,iphone 15 pro max,100000,135000,35000,1,00232,India
169727,2023-06-03,507,washing machine,6990,16490,9500,1,00400,India
169727,2023-06-03,501,iphone 15,60000,80000,20000,1,00400,India
169727,2023-06-03,506,monitor,3249,8000,4751,1,00400,India
169727,2023-06-03,504,iron,449,879,430,1,00400,India
104256,2023-06-03,504,iron,449,879,430,1,00275,India
104256,2023-06-03,501,iphone 15,60000,80000,20000,1,00275,India
243867,2023-06-03,504,iron,449,879,430,1,00350,India
243867,2023-06-03,502,iphone 15 pro max,100000,135000,35000,1,00350,India
243867,2023-06-03,507,washing machine,6990,16490,9500,1,00350,India
243867,2023-06-03,506,monitor,3249,8000,4751,1,00350,India
679963,2023-06-03,506,monitor,3249,8000,4751,1,00379,India
679963,2023-06-03,504,iron,449,879,430,1,00379,India
679963,2023-06-03,503,mixer,1349,3249,1900,1,00379,India
825374,2023-06-03,505,oven,18490,24000,5510,1,00453,India
825374,2023-06-03,506,monitor,3249,8000,4751,1,00453,India
825374,2023-06-03,507,washing machine,6990,16490,9500,1,00453,India
825374,2023-06-03,502,iphone 15 pro max,100000,135000,35000,1,00453,India
461451,2023-06-03,505,oven,18490,24000,5510,1,00031,India
461451,2023-06-03,501,iphone 15,60000,80000,20000,1,00031,India
461451,2023-06-03,503,mixer,1349,3249,1900,1,00031,India
188983,2023-06-03,501,iphone 15,60000,80000,20000,1,00466,India
188983,2023-06-03,502,iphone 15 pro max,100000,135000,35000,1,00466,India
726604,2023-06-03,503,mixer,1349,3249,1900,1,00257,India
771405,2023-06-03,504,iron,449,879,430,1,00016,India
771405,2023-06-03,503,mixer,1349,3249,1900,1,00016,India
771405,2023-06-03,505,oven,18490,24000,5510,1,00016,India
771405,2023-06-03,501,iphone 15,60000,80000,20000,1,00016,India
635800,2023-06-03,507,washing machine,6990,16490,9500,1,00153,India
635800,2023-06-03,501,iphone 15,60000,80000,20000,1,00153,India
635800,2023-06-03,504,iron,449,879,430,1,00153,India
635800,2023-06-03,502,iphone 15 pro max,100000,135000,35000,1,00153,India
635800,2023-06-03,503,mixer,1349,3249,1900,1,00153,India
107505,2023-06-03,502,iphone 15 pro max,100000,135000,35000,1,00234,India
107505,2023-06-03,506,monitor,3249,8000,4751,1,00234,India
107505,2023-06-03,505,oven,18490,24000,5510,1,00234,India
957017,2023-06-03,503,mixer,1349,3249,1900,1,00019,India
957017,2023-06-03,504,iron,449,879,430,1,00019,India
957017,2023-06-03,501,iphone 15,60000,80000,20000,1,00019,India
502836,2023-06-03,507,washing machine,6990,16490,9500,1,00204,India
502836,2023-06-03,501,iphone 15,60000,80000,20000,1,00204,India
502836,2023-06-03,506,monitor,3249,8000,4751,1,00204,India
182615,2023-06-03,501,iphone 15,60000,80000,20000,1,00439,India
182615,2023-06-03,506,monitor,3249,8000,4751,1,00439,India
182615,2023-06-03,504,iron,449,879,430,1,00439,India
182615,2023-06-03,502,iphone 15 pro max,100000,135000,35000,1,00439,India
383420,2023-06-03,504,iron,449,879,430,1,00498,India
383420,2023-06-03,502,iphone 15 pro max,100000,135000,35000,1,00498,India
383420,2023-06-03,503,mixer,1349,3249,1900,1,00498,India
383420,2023-06-03,501,iphone 15,60000,80000,20000,1,00498,India
117790,2023-06-03,506,monitor,3249,8000,4751,1,00491,India
117790,2023-06-03,503,mixer,1349,3249,1900,1,00491,India
117790,2023-06-03,501,iphone 15,60000,80000,20000,1,00491,India
117790,2023-06-03,502,iphone 15 pro max,100000,135000,35000,1,00491,India
730152,2023-06-03,507,washing machine,6990,16490,9500,1,00461,India
900130,2023-06-03,502,iphone 15 pro max,100000,135000,35000,1,00216,India
900130,2023-06-03,501,iphone 15,60000,80000,20000,1,00216,India
900130,2023-06-03,503,mixer,1349,3249,1900,1,00216,India
900130,2023-06-03,505,oven,18490,24000,5510,1,00216,India
121555,2023-06-03,505,oven,18490,24000,5510,1,00292,India
121555,2023-06-03,502,iphone 15 pro max,100000,135000,35000,1,00292,India
121555,2023-06-03,503,mixer,1349,3249,1900,1,00292,India
121555,2023-06-03,504,iron,449,879,430,1,00292,India
419895,2023-06-03,504,iron,449,879,430,1,00173,India
311273,2023-06-03,504,iron,449,879,430,1,00084,India
311273,2023-06-03,507,washing machine,6990,16490,9500,1,00084,India
910830,2023-06-03,504,iron,449,879,430,1,00280,India
910830,2023-06-03,507,washing machine,6990,16490,9500,1,00280,India
910830,2023-06-03,506,monitor,3249,8000,4751,1,00280,India
606421,2023-06-03,505,oven,18490,24000,5510,1,00393,India
606421,2023-06-03,502,iphone 15 pro max,100000,135000,35000,1,00393,India
956838,2023-06-03,501,iphone 15,60000,80000,20000,1,00099,India
956838,2023-06-03,507,washing machine,6990,16490,9500,1,00099,India
956838,2023-06-03,505,oven,18490,24000,5510,1,00099,India
956838,2023-06-03,502,iphone 15 pro max,100000,135000,35000,1,00099,India
389962,2023-06-03,504,iron,449,879,430,1,00219,India
389962,2023-06-03,501,iphone 15,60000,80000,20000,1,00219,India
389962,2023-06-03,507,washing machine,6990,16490,9500,1,00219,India
387246,2023-06-03,502,iphone 15 pro max,100000,135000,35000,1,00414,India
387246,2023-06-03,503,mixer,1349,3249,1900,1,00414,India
387246,2023-06-03,506,monitor,3249,8000,4751,1,00414,India
411646,2023-06-03,502,iphone 15 pro max,100000,135000,35000,1,00195,India
411646,2023-06-03,507,washing machine,6990,16490,9500,1,00195,India
411646,2023-06-03,506,monitor,3249,8000,4751,1,00195,India
411646,2023-06-03,503,mixer,1349,3249,1900,1,00195,India
485726,2023-06-03,501,iphone 15,60000,80000,20000,1,00153,India
485726,2023-06-03,503,mixer,1349,3249,1900,1,00153,India
485726,2023-06-03,506,monitor,3249,8000,4751,1,00153,India
635966,2023-06-03,501,iphone 15,60000,80000,20000,1,00443,India
635966,2023-06-03,504,iron,449,879,430,1,00443,India
635966,2023-06-03,506,monitor,3249,8000,4751,1,00443,India
626139,2023-06-03,503,mixer,1349,3249,1900,1,00134,India
626139,2023-06-03,506,monitor,3249,8000,4751,1,00134,India
626139,2023-06-03,505,oven,18490,24000,5510,1,00134,India
560135,2023-06-03,503,mixer,1349,3249,1900,1,00395,India
560135,2023-06-03,505,oven,18490,24000,5510,1,00395,India
503859,2023-06-03,507,washing machine,6990,16490,9500,1,00261,India
370433,2023-06-03,504,iron,449,879,430,1,00185,India
302329,2023-06-03,503,mixer,1349,3249,1900,1,00336,India
302329,2023-06-03,504,iron,449,879,430,1,00336,India
284564,2023-06-03,506,monitor,3249,8000,4751,1,00342,India
284564,2023-06-03,505,oven,18490,24000,5510,1,00342,India
284564,2023-06-03,507,washing machine,6990,16490,9500,1,00342,India
284564,2023-06-03,504,iron,449,879,430,1,00342,India
259616,2023-06-03,501,iphone 15,60000,80000,20000,1,00046,India
259616,2023-06-03,506,monitor,3249,8000,4751,1,00046,India
962699,2023-06-03,506,monitor,3249,8000,4751,1,00281,India
962699,2023-06-03,502,iphone 15 pro max,100000,135000,35000,1,00281,India
962699,2023-06-03,503,mixer,1349,3249,1900,1,00281,India
157997,2023-06-03,507,washing machine,6990,16490,9500,1,00207,India
157997,2023-06-03,504,iron,449,879,430,1,00207,India
322821,2023-06-03,507,washing machine,6990,16490,9500,1,00246,India
322821,2023-06-03,502,iphone 15 pro max,100000,135000,35000,1,00246,India
322821,2023-06-03,506,monitor,3249,8000,4751,1,00246,India
322821,2023-06-03,504,iron,449,879,430,1,00246,India
834219,2023-06-03,504,iron,449,879,430,1,00331,India
834219,2023-06-03,502,iphone 15 pro max,100000,135000,35000,1,00331,India
304437,2023-06-04,506,monitor,3249,8000,4751,1,00079,India
304437,2023-06-04,503,mixer,1349,3249,1900,1,00079,India
846966,2023-06-04,502,iphone 15 pro max,100000,135000,35000,1,00199,India
846966,2023-06-04,504,iron,449,879,430,1,00199,India
918278,2023-06-04,501,iphone 15,60000,80000,20000,1,00198,India
918278,2023-06-04,504,iron,449,879,430,1,00198,India
918278,2023-06-04,507,washing machine,6990,16490,9500,1,00198,India
918278,2023-06-04,503,mixer,1349,3249,1900,1,00198,India
558591,2023-06-04,503,mixer,1349,3249,1900,1,00054,India
558591,2023-06-04,504,iron,449,879,430,1,00054,India
558591,2023-06-04,505,oven,18490,24000,5510,1,00054,India
634877,2023-06-04,502,iphone 15 pro max,100000,135000,35000,1,00020,India
122375,2023-06-04,505,oven,18490,24000,5510,1,00155,India
122375,2023-06-04,504,iron,449,879,430,1,00155,India
511455,2023-06-04,502,iphone 15 pro max,100000,135000,35000,1,00413,India
511455,2023-06-04,506,monitor,3249,8000,4751,1,00413,India
511455,2023-06-04,507,washing machine,6990,16490,9500,1,00413,India
706364,2023-06-04,507,washing machine,6990,16490,9500,1,00145,India
774062,2023-06-04,504,iron,449,879,430,1,00287,India
223138,2023-06-04,505,oven,18490,24000,5510,1,00399,India
223138,2023-06-04,502,iphone 15 pro max,100000,135000,35000,1,00399,India
221925,2023-06-04,505,oven,18490,24000,5510,1,00258,India
221925,2023-06-04,502,iphone 15 pro max,100000,135000,35000,1,00258,India
221925,2023-06-04,503,mixer,1349,3249,1900,1,00258,India
349169,2023-06-04,502,iphone 15 pro max,100000,135000,35000,1,00445,India
349169,2023-06-04,504,iron,449,879,430,1,00445,India
349169,2023-06-04,503,mixer,1349,3249,1900,1,00445,India
381551,2023-06-04,504,iron,449,879,430,1,00098,India
381551,2023-06-04,505,oven,18490,24000,5510,1,00098,India
539117,2023-06-04,504,iron,449,879,430,1,00475,India
539117,2023-06-04,503,mixer,1349,3249,1900,1,00475,India
484226,2023-06-04,506,monitor,3249,8000,4751,1,00206,India
484226,2023-06-04,507,washing machine,6990,16490,9500,1,00206,India
640584,2023-06-04,501,iphone 15,60000,80000,20000,1,00117,India
640584,2023-06-04,504,iron,449,879,430,1,00117,India
640584,2023-06-04,506,monitor,3249,8000,4751,1,00117,India
640584,2023-06-04,502,iphone 15 pro max,100000,135000,35000,1,00117,India
109569,2023-06-04,502,iphone 15 pro max,100000,135000,35000,1,00128,India
211104,2023-06-04,501,iphone 15,60000,80000,20000,1,00399,India
211104,2023-06-04,504,iron,449,879,430,1,00399,India
211104,2023-06-04,506,monitor,3249,8000,4751,1,00399,India
211104,2023-06-04,507,washing machine,6990,16490,9500,1,00399,India
247938,2023-06-04,505,oven,18490,24000,5510,1,00177,India
247938,2023-06-04,506,monitor,3249,8000,4751,1,00177,India
247938,2023-06-04,507,washing machine,6990,16490,9500,1,00177,India
247938,2023-06-04,502,iphone 15 pro max,100000,135000,35000,1,00177,India
505586,2023-06-04,507,washing machine,6990,16490,9500,1,00098,India
505586,2023-06-04,504,iron,449,879,430,1,00098,India
807617,2023-06-04,501,iphone 15,60000,80000,20000,1,00368,India
807617,2023-06-04,505,oven,18490,24000,5510,1,00368,India
807617,2023-06-04,503,mixer,1349,3249,1900,1,00368,India
807617,2023-06-04,502,iphone 15 pro max,100000,135000,35000,1,00368,India
664768,2023-06-04,503,mixer,1349,3249,1900,1,00244,India
664768,2023-06-04,501,iphone 15,60000,80000,20000,1,00244,India
664768,2023-06-04,502,iphone 15 pro max,100000,135000,35000,1,00244,India
664768,2023-06-04,504,iron,449,879,430,1,00244,India
936185,2023-06-04,502,iphone 15 pro max,100000,135000,35000,1,00295,India
936185,2023-06-04,505,oven,18490,24000,5510,1,00295,India
936185,2023-06-04,507,washing machine,6990,16490,9500,1,00295,India
510285,2023-06-04,502,iphone 15 pro max,100000,135000,35000,1,00009,India
510285,2023-06-04,505,oven,18490,24000,5510,1,00009,India
373101,2023-06-04,501,iphone 15,60000,80000,20000,1,00449,India
373101,2023-06-04,504,iron,449,879,430,1,00449,India
373101,2023-06-04,507,washing machine,6990,16490,9500,1,00449,India
373101,2023-06-04,505,oven,18490,24000,5510,1,00449,India
549726,2023-06-04,503,mixer,1349,3249,1900,1,00093,India
549726,2023-06-04,507,washing machine,6990,16490,9500,1,00093,India
549726,2023-06-04,504,iron,449,879,430,1,00093,India
549726,2023-06-04,501,iphone 15,60000,80000,20000,1,00093,India
311812,2023-06-04,504,iron,449,879,430,1,00356,India
311812,2023-06-04,506,monitor,3249,8000,4751,1,00356,India
527277,2023-06-04,501,iphone 15,60000,80000,20000,1,00481,India
527277,2023-06-04,505,oven,18490,24000,5510,1,00481,India
235153,2023-06-04,505,oven,18490,24000,5510,1,00408,India
235153,2023-06-04,507,washing machine,6990,16490,9500,1,00408,India
235153,2023-06-04,506,monitor,3249,8000,4751,1,00408,India
625503,2023-06-04,505,oven,18490,24000,5510,1,00405,India
625503,2023-06-04,501,iphone 15,60000,80000,20000,1,00405,India
102752,2023-06-04,504,iron,449,879,430,1,00495,India
102752,2023-06-04,507,washing machine,6990,16490,9500,1,00495,India
102752,2023-06-04,506,monitor,3249,8000,4751,1,00495,India
102752,2023-06-04,501,iphone 15,60000,80000,20000,1,00495,India
543139,2023-06-04,504,iron,449,879,430,1,00417,India
658548,2023-06-04,504,iron,449,879,430,1,00357,India
658548,2023-06-04,501,iphone 15,60000,80000,20000,1,00357,India
658548,2023-06-04,503,mixer,1349,3249,1900,1,00357,India
558364,2023-06-04,505,oven,18490,24000,5510,1,00078,India
558364,2023-06-04,501,iphone 15,60000,80000,20000,1,00078,India
822716,2023-06-04,501,iphone 15,60000,80000,20000,1,00486,India
822716,2023-06-04,505,oven,18490,24000,5510,1,00486,India
822716,2023-06-04,507,washing machine,6990,16490,9500,1,00486,India
822716,2023-06-04,504,iron,449,879,430,1,00486,India
487940,2023-06-04,501,iphone 15,60000,80000,20000,1,00122,India
487940,2023-06-04,507,washing machine,6990,16490,9500,1,00122,India
218886,2023-06-04,505,oven,18490,24000,5510,1,00012,India
218886,2023-06-04,503,mixer,1349,3249,1900,1,00012,India
218886,2023-06-04,502,iphone 15 pro max,100000,135000,35000,1,00012,India
218886,2023-06-04,506,monitor,3249,8000,4751,1,00012,India
576732,2023-06-04,501,iphone 15,60000,80000,20000,1,00031,India
576732,2023-06-04,504,iron,449,879,430,1,00031,India
915132,2023-06-04,506,monitor,3249,8000,4751,1,00428,India
233718,2023-06-04,504,iron,449,879,430,1,00208,India
233718,2023-06-04,506,monitor,3249,8000,4751,1,00208,India
233718,2023-06-04,503,mixer,1349,3249,1900,1,00208,India
145885,2023-06-04,505,oven,18490,24000,5510,1,00081,India
145885,2023-06-04,502,iphone 15 pro max,100000,135000,35000,1,00081,India
463738,2023-06-04,501,iphone 15,60000,80000,20000,1,00122,India
463738,2023-06-04,506,monitor,3249,8000,4751,1,00122,India
337970,2023-06-04,507,washing machine,6990,16490,9500,1,00446,India
337970,2023-06-04,503,mixer,1349,3249,1900,1,00446,India
337970,2023-06-04,502,iphone 15 pro max,100000,135000,35000,1,00446,India
337970,2023-06-04,501,iphone 15,60000,80000,20000,1,00446,India
890738,2023-06-04,501,iphone 15,60000,80000,20000,1,00112,India
890738,2023-06-04,503,mixer,1349,3249,1900,1,00112,India
527194,2023-06-04,505,oven,18490,24000,5510,1,00361,India
527194,2023-06-04,507,washing machine,6990,16490,9500,1,00361,India
527194,2023-06-04,506,monitor,3249,8000,4751,1,00361,India
527194,2023-06-04,504,iron,449,879,430,1,00361,India
527194,2023-06-04,501,iphone 15,60000,80000,20000,1,00361,India
540833,2023-06-04,504,iron,449,879,430,1,00234,India
540833,2023-06-04,507,washing machine,6990,16490,9500,1,00234,India
586458,2023-06-04,505,oven,18490,24000,5510,1,00186,India
586458,2023-06-04,501,iphone 15,60000,80000,20000,1,00186,India
586458,2023-06-04,506,monitor,3249,8000,4751,1,00186,India
128509,2023-06-04,505,oven,18490,24000,5510,1,00152,India
128509,2023-06-04,503,mixer,1349,3249,1900,1,00152,India
128509,2023-06-04,507,washing machine,6990,16490,9500,1,00152,India
128509,2023-06-04,502,iphone 15 pro max,100000,135000,35000,1,00152,India
370153,2023-06-04,507,washing machine,6990,16490,9500,1,00044,India
370153,2023-06-04,502,iphone 15 pro max,100000,135000,35000,1,00044,India
537488,2023-06-04,507,washing machine,6990,16490,9500,1,00257,India
537488,2023-06-04,502,iphone 15 pro max,100000,135000,35000,1,00257,India
554271,2023-06-04,503,mixer,1349,3249,1900,1,00028,India
654784,2023-06-04,504,iron,449,879,430,1,00174,India
654784,2023-06-04,501,iphone 15,60000,80000,20000,1,00174,India
654784,2023-06-04,502,iphone 15 pro max,100000,135000,35000,1,00174,India
654784,2023-06-04,507,washing machine,6990,16490,9500,1,00174,India
223070,2023-06-04,501,iphone 15,60000,80000,20000,1,00239,India
223070,2023-06-04,507,washing machine,6990,16490,9500,1,00239,India
223070,2023-06-04,503,mixer,1349,3249,1900,1,00239,India
223070,2023-06-04,502,iphone 15 pro max,100000,135000,35000,1,00239,India
745355,2023-06-04,507,washing machine,6990,16490,9500,1,00394,India
745355,2023-06-04,501,iphone 15,60000,80000,20000,1,00394,India
753338,2023-06-04,503,mixer,1349,3249,1900,1,00393,India
753338,2023-06-04,501,iphone 15,60000,80000,20000,1,00393,India
376898,2023-06-04,502,iphone 15 pro max,100000,135000,35000,1,00104,India
376898,2023-06-04,503,mixer,1349,3249,1900,1,00104,India
481688,2023-06-04,505,oven,18490,24000,5510,1,00204,India
562186,2023-06-05,503,mixer,1349,3249,1900,1,00269,India
562186,2023-06-05,501,iphone 15,60000,80000,20000,1,00269,India
562186,2023-06-05,507,washing machine,6990,16490,9500,1,00269,India
562186,2023-06-05,506,monitor,3249,8000,4751,1,00269,India
890306,2023-06-05,506,monitor,3249,8000,4751,1,00079,India
827235,2023-06-05,506,monitor,3249,8000,4751,1,00316,India
983702,2023-06-05,507,washing machine,6990,16490,9500,1,00156,India
983702,2023-06-05,504,iron,449,879,430,1,00156,India
983702,2023-06-05,506,monitor,3249,8000,4751,1,00156,India
983702,2023-06-05,501,iphone 15,60000,80000,20000,1,00156,India
139122,2023-06-05,503,mixer,1349,3249,1900,1,00220,India
139122,2023-06-05,506,monitor,3249,8000,4751,1,00220,India
139122,2023-06-05,504,iron,449,879,430,1,00220,India
139122,2023-06-05,501,iphone 15,60000,80000,20000,1,00220,India
155069,2023-06-05,507,washing machine,6990,16490,9500,1,00278,India
155069,2023-06-05,505,oven,18490,24000,5510,1,00278,India
155069,2023-06-05,504,iron,449,879,430,1,00278,India
155069,2023-06-05,502,iphone 15 pro max,100000,135000,35000,1,00278,India
940863,2023-06-05,503,mixer,1349,3249,1900,1,00408,India
629007,2023-06-05,502,iphone 15 pro max,100000,135000,35000,1,00066,India
629007,2023-06-05,504,iron,449,879,430,1,00066,India
629007,2023-06-05,506,monitor,3249,8000,4751,1,00066,India
876623,2023-06-05,504,iron,449,879,430,1,00362,India
857116,2023-06-05,505,oven,18490,24000,5510,1,00180,India
857116,2023-06-05,506,monitor,3249,8000,4751,1,00180,India
874216,2023-06-05,506,monitor,3249,8000,4751,1,00318,India
874216,2023-06-05,505,oven,18490,24000,5510,1,00318,India
874216,2023-06-05,507,washing machine,6990,16490,9500,1,00318,India
305181,2023-06-05,502,iphone 15 pro max,100000,135000,35000,1,00305,India
305181,2023-06-05,506,monitor,3249,8000,4751,1,00305,India
305181,2023-06-05,505,oven,18490,24000,5510,1,00305,India
305181,2023-06-05,501,iphone 15,60000,80000,20000,1,00305,India
100422,2023-06-05,505,oven,18490,24000,5510,1,00435,India
100422,2023-06-05,507,washing machine,6990,16490,9500,1,00435,India
421062,2023-06-05,502,iphone 15 pro max,100000,135000,35000,1,00119,India
421062,2023-06-05,507,washing machine,6990,16490,9500,1,00119,India
421062,2023-06-05,503,mixer,1349,3249,1900,1,00119,India
421062,2023-06-05,505,oven,18490,24000,5510,1,00119,India
918394,2023-06-05,506,monitor,3249,8000,4751,1,00241,India
918394,2023-06-05,505,oven,18490,24000,5510,1,00241,India
968528,2023-06-05,502,iphone 15 pro max,100000,135000,35000,1,00318,India
968528,2023-06-05,507,washing machine,6990,16490,9500,1,00318,India
802349,2023-06-05,506,monitor,3249,8000,4751,1,00403,India
802349,2023-06-05,503,mixer,1349,3249,1900,1,00403,India
144002,2023-06-05,503,mixer,1349,3249,1900,1,00372,India
144002,2023-06-05,501,iphone 15,60000,80000,20000,1,00372,India
420452,2023-06-05,506,monitor,3249,8000,4751,1,00072,India
420452,2023-06-05,507,washing machine,6990,16490,9500,1,00072,India
420452,2023-06-05,501,iphone 15,60000,80000,20000,1,00072,India
520035,2023-06-05,507,washing machine,6990,16490,9500,1,00407,India
520035,2023-06-05,505,oven,18490,24000,5510,1,00407,India
520035,2023-06-05,504,iron,449,879,430,1,00407,India
520035,2023-06-05,502,iphone 15 pro max,100000,135000,35000,1,00407,India
608546,2023-06-05,507,washing machine,6990,16490,9500,1,00381,India
433292,2023-06-05,501,iphone 15,60000,80000,20000,1,00398,India
433292,2023-06-05,506,monitor,3249,8000,4751,1,00398,India
159109,2023-06-05,505,oven,18490,24000,5510,1,00083,India
159109,2023-06-05,507,washing machine,6990,16490,9500,1,00083,India
159109,2023-06-05,502,iphone 15 pro max,100000,135000,35000,1,00083,India
587942,2023-06-05,502,iphone 15 pro max,100000,135000,35000,1,00176,India
587942,2023-06-05,501,iphone 15,60000,80000,20000,1,00176,India
587942,2023-06-05,507,washing machine,6990,16490,9500,1,00176,India
587942,2023-06-05,504,iron,449,879,430,1,00176,India
472551,2023-06-05,507,washing machine,6990,16490,9500,1,00157,India
472551,2023-06-05,503,mixer,1349,3249,1900,1,00157,India
654340,2023-06-05,504,iron,449,879,430,1,00382,India
820256,2023-06-05,502,iphone 15 pro max,100000,135000,35000,1,00077,India
820256,2023-06-05,503,mixer,1349,3249,1900,1,00077,India
820256,2023-06-05,506,monitor,3249,8000,4751,1,00077,India
820256,2023-06-05,504,iron,449,879,430,1,00077,India
186441,2023-06-05,503,mixer,1349,3249,1900,1,00376,India
186441,2023-06-05,506,monitor,3249,8000,4751,1,00376,India
186441,2023-06-05,504,iron,449,879,430,1,00376,India
186441,2023-06-05,501,iphone 15,60000,80000,20000,1,00376,India
583527,2023-06-05,501,iphone 15,60000,80000,20000,1,00193,India
191509,2023-06-05,501,iphone 15,60000,80000,20000,1,00092,India
191509,2023-06-05,504,iron,449,879,430,1,00092,India
191509,2023-06-05,502,iphone 15 pro max,100000,135000,35000,1,00092,India
283354,2023-06-05,507,washing machine,6990,16490,9500,1,00272,India
283354,2023-06-05,506,monitor,3249,8000,4751,1,00272,India
283354,2023-06-05,505,oven,18490,24000,5510,1,00272,India
887207,2023-06-05,505,oven,18490,24000,5510,1,00231,India
335469,2023-06-05,503,mixer,1349,3249,1900,1,00214,India
335469,2023-06-05,505,oven,18490,24000,5510,1,00214,India
517995,2023-06-05,502,iphone 15 pro max,100000,135000,35000,1,00436,India
915554,2023-06-05,505,oven,18490,24000,5510,1,00130,India
915554,2023-06-05,501,iphone 15,60000,80000,20000,1,00130,India
915554,2023-06-05,502,iphone 15 pro max,100000,135000,35000,1,00130,India
915554,2023-06-05,504,iron,449,879,430,1,00130,India
918108,2023-06-05,501,iphone 15,60000,80000,20000,1,00045,India
918108,2023-06-05,507,washing machine,6990,16490,9500,1,00045,India
918108,2023-06-05,505,oven,18490,24000,5510,1,00045,India
672748,2023-06-05,504,iron,449,879,430,1,00454,India
672748,2023-06-05,505,oven,18490,24000,5510,1,00454,India
681530,2023-06-05,503,mixer,1349,3249,1900,1,00438,India
681530,2023-06-05,506,monitor,3249,8000,4751,1,00438,India
681530,2023-06-05,502,iphone 15 pro max,100000,135000,35000,1,00438,India
402777,2023-06-05,501,iphone 15,60000,80000,20000,1,00078,India
402777,2023-06-05,504,iron,449,879,430,1,00078,India
904082,2023-06-05,506,monitor,3249,8000,4751,1,00062,India
904082,2023-06-05,503,mixer,1349,3249,1900,1,00062,India
191603,2023-06-05,502,iphone 15 pro max,100000,135000,35000,1,00061,India
191603,2023-06-05,507,washing machine,6990,16490,9500,1,00061,India
191603,2023-06-05,501,iphone 15,60000,80000,20000,1,00061,India
632756,2023-06-05,505,oven,18490,24000,5510,1,00257,India
632756,2023-06-05,502,iphone 15 pro max,100000,135000,35000,1,00257,India
599311,2023-06-05,502,iphone 15 pro max,100000,135000,35000,1,00486,India
599311,2023-06-05,506,monitor,3249,8000,4751,1,00486,India
132678,2023-06-05,504,iron,449,879,430,1,00126,India
420256,2023-06-05,505,oven,18490,24000,5510,1,00204,India
420256,2023-06-05,504,iron,449,879,430,1,00204,India
703457,2023-06-05,506,monitor,3249,8000,4751,1,00291,India
221454,2023-06-05,507,washing machine,6990,16490,9500,1,00256,India
221454,2023-06-05,502,iphone 15 pro max,100000,135000,35000,1,00256,India
221454,2023-06-05,503,mixer,1349,3249,1900,1,00256,India
221454,2023-06-05,504,iron,449,879,430,1,00256,India
913746,2023-06-05,502,iphone 15 pro max,100000,135000,35000,1,00167,India
913746,2023-06-05,503,mixer,1349,3249,1900,1,00167,India
874742,2023-06-05,501,iphone 15,60000,80000,20000,1,00295,India
874742,2023-06-05,503,mixer,1349,3249,1900,1,00295,India
874742,2023-06-05,507,washing machine,6990,16490,9500,1,00295,India
222304,2023-06-05,502,iphone 15 pro max,100000,135000,35000,1,00151,India
256768,2023-06-05,507,washing machine,6990,16490,9500,1,00175,India
256768,2023-06-05,504,iron,449,879,430,1,00175,India
256768,2023-06-05,505,oven,18490,24000,5510,1,00175,India
410456,2023-06-05,507,washing machine,6990,16490,9500,1,00019,India
410456,2023-06-05,506,monitor,3249,8000,4751,1,00019,India
410456,2023-06-05,504,iron,449,879,430,1,00019,India
410456,2023-06-05,501,iphone 15,60000,80000,20000,1,00019,India
111579,2023-06-05,506,monitor,3249,8000,4751,1,00252,India
111579,2023-06-05,504,iron,449,879,430,1,00252,India
324068,2023-06-05,505,oven,18490,24000,5510,1,00387,India
324068,2023-06-05,507,washing machine,6990,16490,9500,1,00387,India
776486,2023-06-05,501,iphone 15,60000,80000,20000,1,00427,India
776486,2023-06-05,506,monitor,3249,8000,4751,1,00427,India
776486,2023-06-05,507,washing machine,6990,16490,9500,1,00427,India
498994,2023-06-05,507,washing machine,6990,16490,9500,1,00102,India
498994,2023-06-05,501,iphone 15,60000,80000,20000,1,00102,India
498994,2023-06-05,504,iron,449,879,430,1,00102,India
498994,2023-06-05,505,oven,18490,24000,5510,1,00102,India
628578,2023-06-05,504,iron,449,879,430,1,00196,India
628578,2023-06-05,506,monitor,3249,8000,4751,1,00196,India
928240,2023-06-05,506,monitor,3249,8000,4751,1,00088,India
928240,2023-06-05,504,iron,449,879,430,1,00088,India
928240,2023-06-05,503,mixer,1349,3249,1900,1,00088,India
928240,2023-06-05,507,washing machine,6990,16490,9500,1,00088,India
946100,2023-06-05,502,iphone 15 pro max,100000,135000,35000,1,00339,India
733585,2023-06-05,502,iphone 15 pro max,100000,135000,35000,1,00193,India
733585,2023-06-05,506,monitor,3249,8000,4751,1,00193,India
733585,2023-06-05,507,washing machine,6990,16490,9500,1,00193,India
733585,2023-06-05,501,iphone 15,60000,80000,20000,1,00193,India
816487,2023-06-05,505,oven,18490,24000,5510,1,00308,India
902436,2023-06-05,507,washing machine,6990,16490,9500,1,00238,India
902436,2023-06-05,506,monitor,3249,8000,4751,1,00238,India
149952,2023-06-05,502,iphone 15 pro max,100000,135000,35000,1,00036,India
149952,2023-06-05,505,oven,18490,24000,5510,1,00036,India
109668,2023-06-05,506,monitor,3249,8000,4751,1,00390,India
109668,2023-06-05,504,iron,449,879,430,1,00390,India
139063,2023-06-05,506,monitor,3249,8000,4751,1,00105,India
940820,2023-06-05,507,washing machine,6990,16490,9500,1,00250,India
940820,2023-06-05,506,monitor,3249,8000,4751,1,00250,India
940820,2023-06-05,504,iron,449,879,430,1,00250,India
940820,2023-06-05,502,iphone 15 pro max,100000,135000,35000,1,00250,India
571543,2023-06-05,503,mixer,1349,3249,1900,1,00183,India
571543,2023-06-05,502,iphone 15 pro max,100000,135000,35000,1,00183,India
201707,2023-06-05,506,monitor,3249,8000,4751,1,00203,India
201707,2023-06-05,507,washing machine,6990,16490,9500,1,00203,India
632589,2023-06-05,501,iphone 15,60000,80000,20000,1,00494,India
772045,2023-06-05,503,mixer,1349,3249,1900,1,00210,India
772045,2023-06-05,502,iphone 15 pro max,100000,135000,35000,1,00210,India
772045,2023-06-05,501,iphone 15,60000,80000,20000,1,00210,India
611385,2023-06-05,503,mixer,1349,3249,1900,1,00246,India
611385,2023-06-05,501,iphone 15,60000,80000,20000,1,00246,India
611385,2023-06-05,507,washing machine,6990,16490,9500,1,00246,India
248934,2023-06-05,501,iphone 15,60000,80000,20000,1,00234,India
248934,2023-06-05,503,mixer,1349,3249,1900,1,00234,India
248934,2023-06-05,506,monitor,3249,8000,4751,1,00234,India
504537,2023-06-05,502,iphone 15 pro max,100000,135000,35000,1,00436,India
504537,2023-06-05,504,iron,449,879,430,1,00436,India
265101,2023-06-05,502,iphone 15 pro max,100000,135000,35000,1,00237,India
265101,2023-06-05,505,oven,18490,24000,5510,1,00237,India
958408,2023-06-05,501,iphone 15,60000,80000,20000,1,00303,India
958408,2023-06-05,502,iphone 15 pro max,100000,135000,35000,1,00303,India
557710,2023-06-05,504,iron,449,879,430,1,00193,India
938267,2023-06-05,506,monitor,3249,8000,4751,1,00204,India
938267,2023-06-05,502,iphone 15 pro max,100000,135000,35000,1,00204,India
938267,2023-06-05,507,washing machine,6990,16490,9500,1,00204,India
621397,2023-06-05,501,iphone 15,60000,80000,20000,1,00473,India
621397,2023-06-05,502,iphone 15 pro max,100000,135000,35000,1,00473,India
621397,2023-06-05,503,mixer,1349,3249,1900,1,00473,India
428529,2023-06-05,503,mixer,1349,3249,1900,1,00238,India
601519,2023-06-05,504,iron,449,879,430,1,00078,India
601519,2023-06-05,503,mixer,1349,3249,1900,1,00078,India
552788,2023-06-05,501,iphone 15,60000,80000,20000,1,00064,India
552788,2023-06-05,507,washing machine,6990,16490,9500,1,00064,India
988181,2023-06-05,504,iron,449,879,430,1,00083,India
988181,2023-06-05,502,iphone 15 pro max,100000,135000,35000,1,00083,India
988181,2023-06-05,506,monitor,3249,8000,4751,1,00083,India
612171,2023-06-05,502,iphone 15 pro max,100000,135000,35000,1,00024,India
612171,2023-06-05,506,monitor,3249,8000,4751,1,00024,India
223099,2023-06-05,504,iron,449,879,430,1,00479,India
223099,2023-06-05,502,iphone 15 pro max,100000,135000,35000,1,00479,India
854854,2023-06-05,503,mixer,1349,3249,1900,1,00467,India
854854,2023-06-05,507,washing machine,6990,16490,9500,1,00467,India
246516,2023-06-05,502,iphone 15 pro max,100000,135000,35000,1,00179,India
405658,2023-06-05,502,iphone 15 pro max,100000,135000,35000,1,00195,India
972405,2023-06-05,507,washing machine,6990,16490,9500,1,00178,India
972405,2023-06-05,506,monitor,3249,8000,4751,1,00178,India
972405,2023-06-05,501,iphone 15,60000,80000,20000,1,00178,India
149020,2023-06-05,506,monitor,3249,8000,4751,1,00380,India
149020,2023-06-05,505,oven,18490,24000,5510,1,00380,India
611195,2023-06-05,505,oven,18490,24000,5510,1,00033,India
611195,2023-06-05,503,mixer,1349,3249,1900,1,00033,India
611195,2023-06-05,506,monitor,3249,8000,4751,1,00033,India
488934,2023-06-05,503,mixer,1349,3249,1900,1,00241,India
488934,2023-06-05,507,washing machine,6990,16490,9500,1,00241,India
488934,2023-06-05,506,monitor,3249,8000,4751,1,00241,India
488934,2023-06-05,502,iphone 15 pro max,100000,135000,35000,1,00241,India
766639,2023-06-05,505,oven,18490,24000,5510,1,00482,India
766639,2023-06-05,506,monitor,3249,8000,4751,1,00482,India
346764,2023-06-05,504,iron,449,879,430,1,00191,India
346764,2023-06-05,501,iphone 15,60000,80000,20000,1,00191,India
346764,2023-06-05,503,mixer,1349,3249,1900,1,00191,India
634163,2023-06-05,504,iron,449,879,430,1,00240,India
634163,2023-06-05,501,iphone 15,60000,80000,20000,1,00240,India
634163,2023-06-05,507,washing machine,6990,16490,9500,1,00240,India
634163,2023-06-05,502,iphone 15 pro max,100000,135000,35000,1,00240,India
940936,2023-06-05,503,mixer,1349,3249,1900,1,00142,India
940936,2023-06-05,502,iphone 15 pro max,100000,135000,35000,1,00142,India
940936,2023-06-05,507,washing machine,6990,16490,9500,1,00142,India
940936,2023-06-05,504,iron,449,879,430,1,00142,India
133073,2023-06-05,501,iphone 15,60000,80000,20000,1,00455,India
705964,2023-06-06,501,iphone 15,60000,80000,20000,1,00140,India
705964,2023-06-06,505,oven,18490,24000,5510,1,00140,India
260678,2023-06-06,501,iphone 15,60000,80000,20000,1,00349,India
560555,2023-06-06,507,washing machine,6990,16490,9500,1,00493,India
560555,2023-06-06,502,iphone 15 pro max,100000,135000,35000,1,00493,India
560555,2023-06-06,506,monitor,3249,8000,4751,1,00493,India
560555,2023-06-06,501,iphone 15,60000,80000,20000,1,00493,India
388943,2023-06-06,501,iphone 15,60000,80000,20000,1,00012,India
388943,2023-06-06,506,monitor,3249,8000,4751,1,00012,India
641173,2023-06-06,507,washing machine,6990,16490,9500,1,00166,India
641173,2023-06-06,505,oven,18490,24000,5510,1,00166,India
633186,2023-06-06,505,oven,18490,24000,5510,1,00060,India
633186,2023-06-06,507,washing machine,6990,16490,9500,1,00060,India
633186,2023-06-06,502,iphone 15 pro max,100000,135000,35000,1,00060,India
694194,2023-06-06,502,iphone 15 pro max,100000,135000,35000,1,00426,India
694194,2023-06-06,507,washing machine,6990,16490,9500,1,00426,India
224594,2023-06-06,506,monitor,3249,8000,4751,1,00268,India
380000,2023-06-06,502,iphone 15 pro max,100000,135000,35000,1,00110,India
217523,2023-06-06,502,iphone 15 pro max,100000,135000,35000,1,00281,India
217523,2023-06-06,505,oven,18490,24000,5510,1,00281,India
486694,2023-06-06,505,oven,18490,24000,5510,1,00232,India
486694,2023-06-06,501,iphone 15,60000,80000,20000,1,00232,India
947019,2023-06-06,503,mixer,1349,3249,1900,1,00165,India
798928,2023-06-06,502,iphone 15 pro max,100000,135000,35000,1,00076,India
255942,2023-06-06,504,iron,449,879,430,1,00258,India
255942,2023-06-06,506,monitor,3249,8000,4751,1,00258,India
255942,2023-06-06,507,washing machine,6990,16490,9500,1,00258,India
255942,2023-06-06,505,oven,18490,24000,5510,1,00258,India
734436,2023-06-06,505,oven,18490,24000,5510,1,00189,India
381585,2023-06-06,505,oven,18490,24000,5510,1,00007,India
381585,2023-06-06,507,washing machine,6990,16490,9500,1,00007,India
381585,2023-06-06,501,iphone 15,60000,80000,20000,1,00007,India
772554,2023-06-06,502,iphone 15 pro max,100000,135000,35000,1,00035,India
152847,2023-06-06,507,washing machine,6990,16490,9500,1,00319,India
152847,2023-06-06,504,iron,449,879,430,1,00319,India
152847,2023-06-06,505,oven,18490,24000,5510,1,00319,India
252146,2023-06-06,504,iron,449,879,430,1,00344,India
252146,2023-06-06,505,oven,18490,24000,5510,1,00344,India
252146,2023-06-06,507,washing machine,6990,16490,9500,1,00344,India
252146,2023-06-06,503,mixer,1349,3249,1900,1,00344,India
252146,2023-06-06,502,iphone 15 pro max,100000,135000,35000,1,00344,India
988090,2023-06-06,501,iphone 15,60000,80000,20000,1,00428,India
988090,2023-06-06,505,oven,18490,24000,5510,1,00428,India
683576,2023-06-06,506,monitor,3249,8000,4751,1,00148,India
683576,2023-06-06,505,oven,18490,24000,5510,1,00148,India
683576,2023-06-06,503,mixer,1349,3249,1900,1,00148,India
683576,2023-06-06,501,iphone 15,60000,80000,20000,1,00148,India
343561,2023-06-06,503,mixer,1349,3249,1900,1,00383,India
343561,2023-06-06,505,oven,18490,24000,5510,1,00383,India
343561,2023-06-06,507,washing machine,6990,16490,9500,1,00383,India
343561,2023-06-06,504,iron,449,879,430,1,00383,India
308663,2023-06-06,501,iphone 15,60000,80000,20000,1,00337,India
829884,2023-06-06,507,washing machine,6990,16490,9500,1,00322,India
829884,2023-06-06,503,mixer,1349,3249,1900,1,00322,India
829884,2023-06-06,505,oven,18490,24000,5510,1,00322,India
756438,2023-06-06,505,oven,18490,24000,5510,1,00370,India
466468,2023-06-06,501,iphone 15,60000,80000,20000,1,00419,India
456104,2023-06-06,504,iron,449,879,430,1,00381,India
456104,2023-06-06,505,oven,18490,24000,5510,1,00381,India
661423,2023-06-06,507,washing machine,6990,16490,9500,1,00359,India
661423,2023-06-06,502,iphone 15 pro max,100000,135000,35000,1,00359,India
661423,2023-06-06,501,iphone 15,60000,80000,20000,1,00359,India
443099,2023-06-06,503,mixer,1349,3249,1900,1,00448,India
443099,2023-06-06,506,monitor,3249,8000,4751,1,00448,India
142238,2023-06-06,501,iphone 15,60000,80000,20000,1,00312,India
142238,2023-06-06,503,mixer,1349,3249,1900,1,00312,India
142238,2023-06-06,504,iron,449,879,430,1,00312,India
142238,2023-06-06,507,washing machine,6990,16490,9500,1,00312,India
539776,2023-06-06,503,mixer,1349,3249,1900,1,00052,India
840385,2023-06-06,507,washing machine,6990,16490,9500,1,00142,India
840385,2023-06-06,506,monitor,3249,8000,4751,1,00142,India
840385,2023-06-06,504,iron,449,879,430,1,00142,India
840385,2023-06-06,502,iphone 15 pro max,100000,135000,35000,1,00142,India
100844,2023-06-06,502,iphone 15 pro max,100000,135000,35000,1,00055,India
100844,2023-06-06,504,iron,449,879,430,1,00055,India
100844,2023-06-06,505,oven,18490,24000,5510,1,00055,India
954034,2023-06-06,503,mixer,1349,3249,1900,1,00366,India
954034,2023-06-06,501,iphone 15,60000,80000,20000,1,00366,India
324832,2023-06-06,502,iphone 15 pro max,100000,135000,35000,1,00427,India
324832,2023-06-06,505,oven,18490,24000,5510,1,00427,India
324832,2023-06-06,506,monitor,3249,8000,4751,1,00427,India
634505,2023-06-06,504,iron,449,879,430,1,00322,India
834541,2023-06-06,502,iphone 15 pro max,100000,135000,35000,1,00429,India
834541,2023-06-06,507,washing machine,6990,16490,9500,1,00429,India
834541,2023-06-06,505,oven,18490,24000,5510,1,00429,India
116448,2023-06-06,507,washing machine,6990,16490,9500,1,00128,India
116448,2023-06-06,505,oven,18490,24000,5510,1,00128,India
116448,2023-06-06,501,iphone 15,60000,80000,20000,1,00128,India
335705,2023-06-06,504,iron,449,879,430,1,00397,India
335705,2023-06-06,505,oven,18490,24000,5510,1,00397,India
335705,2023-06-06,502,iphone 15 pro max,100000,135000,35000,1,00397,India
194990,2023-06-06,502,iphone 15 pro max,100000,135000,35000,1,00386,India
194990,2023-06-06,506,monitor,3249,8000,4751,1,00386,India
194990,2023-06-06,507,washing machine,6990,16490,9500,1,00386,India
984780,2023-06-06,504,iron,449,879,430,1,00003,India
940164,2023-06-06,503,mixer,1349,3249,1900,1,00156,India
940164,2023-06-06,501,iphone 15,60000,80000,20000,1,00156,India
940164,2023-06-06,507,washing machine,6990,16490,9500,1,00156,India
430186,2023-06-06,505,oven,18490,24000,5510,1,00178,India
188062,2023-06-06,501,iphone 15,60000,80000,20000,1,00101,India
188062,2023-06-06,503,mixer,1349,3249,1900,1,00101,India
539655,2023-06-06,503,mixer,1349,3249,1900,1,00284,India
539655,2023-06-06,502,iphone 15 pro max,100000,135000,35000,1,00284,India
539655,2023-06-06,506,monitor,3249,8000,4751,1,00284,India
539655,2023-06-06,507,washing machine,6990,16490,9500,1,00284,India
539655,2023-06-06,505,oven,18490,24000,5510,1,00284,India
205857,2023-06-06,506,monitor,3249,8000,4751,1,00021,India
205857,2023-06-06,507,washing machine,6990,16490,9500,1,00021,India
205857,2023-06-06,503,mixer,1349,3249,1900,1,00021,India
741523,2023-06-06,503,mixer,1349,3249,1900,1,00252,India
741523,2023-06-06,505,oven,18490,24000,5510,1,00252,India
103255,2023-06-06,502,iphone 15 pro max,100000,135000,35000,1,00323,India
103255,2023-06-06,504,iron,449,879,430,1,00323,India
103255,2023-06-06,506,monitor,3249,8000,4751,1,00323,India
103255,2023-06-06,507,washing machine,6990,16490,9500,1,00323,India
176189,2023-06-06,502,iphone 15 pro max,100000,135000,35000,1,00422,India
466490,2023-06-06,501,iphone 15,60000,80000,20000,1,00323,India
466490,2023-06-06,507,washing machine,6990,16490,9500,1,00323,India
466490,2023-06-06,503,mixer,1349,3249,1900,1,00323,India
280335,2023-06-06,505,oven,18490,24000,5510,1,00481,India
280335,2023-06-06,502,iphone 15 pro max,100000,135000,35000,1,00481,India
280335,2023-06-06,506,monitor,3249,8000,4751,1,00481,India
280335,2023-06-06,501,iphone 15,60000,80000,20000,1,00481,India
707967,2023-06-06,504,iron,449,879,430,1,00023,India
707967,2023-06-06,505,oven,18490,24000,5510,1,00023,India
646386,2023-06-06,501,iphone 15,60000,80000,20000,1,00163,India
646386,2023-06-06,506,monitor,3249,8000,4751,1,00163,India
646386,2023-06-06,504,iron,449,879,430,1,00163,India
647930,2023-06-06,506,monitor,3249,8000,4751,1,00324,India
647930,2023-06-06,504,iron,449,879,430,1,00324,India
953665,2023-06-06,502,iphone 15 pro max,100000,135000,35000,1,00376,India
953665,2023-06-06,505,oven,18490,24000,5510,1,00376,India
953665,2023-06-06,504,iron,449,879,430,1,00376,India
953665,2023-06-06,507,washing machine,6990,16490,9500,1,00376,India
377898,2023-06-06,503,mixer,1349,3249,1900,1,00270,India
377898,2023-06-06,501,iphone 15,60000,80000,20000,1,00270,India
377898,2023-06-06,502,iphone 15 pro max,100000,135000,35000,1,00270,India
639769,2023-06-06,505,oven,18490,24000,5510,1,00386,India
639769,2023-06-06,506,monitor,3249,8000,4751,1,00386,India
914941,2023-06-06,504,iron,449,879,430,1,00469,India
914941,2023-06-06,505,oven,18490,24000,5510,1,00469,India
914941,2023-06-06,502,iphone 15 pro max,100000,135000,35000,1,00469,India
338990,2023-06-06,504,iron,449,879,430,1,00310,India
338990,2023-06-06,507,washing machine,6990,16490,9500,1,00310,India
397143,2023-06-06,505,oven,18490,24000,5510,1,00489,India
397143,2023-06-06,501,iphone 15,60000,80000,20000,1,00489,India
397143,2023-06-06,503,mixer,1349,3249,1900,1,00489,India
328723,2023-06-06,502,iphone 15 pro max,100000,135000,35000,1,00442,India
328723,2023-06-06,506,monitor,3249,8000,4751,1,00442,India
328723,2023-06-06,501,iphone 15,60000,80000,20000,1,00442,India
928316,2023-06-06,504,iron,449,879,430,1,00164,India
928316,2023-06-06,503,mixer,1349,3249,1900,1,00164,India
461043,2023-06-06,501,iphone 15,60000,80000,20000,1,00400,India
461043,2023-06-06,503,mixer,1349,3249,1900,1,00400,India
461043,2023-06-06,504,iron,449,879,430,1,00400,India
461043,2023-06-06,506,monitor,3249,8000,4751,1,00400,India
172837,2023-06-06,501,iphone 15,60000,80000,20000,1,00039,India
372907,2023-06-06,504,iron,449,879,430,1,00144,India
372907,2023-06-06,505,oven,18490,24000,5510,1,00144,India
439873,2023-06-06,501,iphone 15,60000,80000,20000,1,00201,India
439873,2023-06-06,507,washing machine,6990,16490,9500,1,00201,India
424828,2023-06-06,507,washing machine,6990,16490,9500,1,00445,India
424828,2023-06-06,502,iphone 15 pro max,100000,135000,35000,1,00445,India
349298,2023-06-06,504,iron,449,879,430,1,00116,India
581268,2023-06-06,507,washing machine,6990,16490,9500,1,00156,India
581268,2023-06-06,503,mixer,1349,3249,1900,1,00156,India
581268,2023-06-06,505,oven,18490,24000,5510,1,00156,India
109967,2023-06-06,501,iphone 15,60000,80000,20000,1,00029,India
109967,2023-06-06,506,monitor,3249,8000,4751,1,00029,India
441551,2023-06-06,504,iron,449,879,430,1,00319,India
441551,2023-06-06,503,mixer,1349,3249,1900,1,00319,India
504584,2023-06-06,502,iphone 15 pro max,100000,135000,35000,1,00167,India
504584,2023-06-06,504,iron,449,879,430,1,00167,India
504584,2023-06-06,507,washing machine,6990,16490,9500,1,00167,India
458243,2023-06-06,506,monitor,3249,8000,4751,1,00012,India
818927,2023-06-06,505,oven,18490,24000,5510,1,00342,India
614634,2023-06-06,504,iron,449,879,430,1,00087,India
614634,2023-06-06,503,mixer,1349,3249,1900,1,00087,India
614634,2023-06-06,505,oven,18490,24000,5510,1,00087,India
227510,2023-06-06,506,monitor,3249,8000,4751,1,00286,India
806909,2023-06-06,505,oven,18490,24000,5510,1,00347,India
806909,2023-06-06,501,iphone 15,60000,80000,20000,1,00347,India
806909,2023-06-06,502,iphone 15 pro max,100000,135000,35000,1,00347,India
111163,2023-06-06,506,monitor,3249,8000,4751,1,00311,India
111163,2023-06-06,503,mixer,1349,3249,1900,1,00311,India
111163,2023-06-06,502,iphone 15 pro max,100000,135000,35000,1,00311,India
337972,2023-06-06,503,mixer,1349,3249,1900,1,00171,India
337972,2023-06-06,506,monitor,3249,8000,4751,1,00171,India
337972,2023-06-06,507,washing machine,6990,16490,9500,1,00171,India
337972,2023-06-06,501,iphone 15,60000,80000,20000,1,00171,India
314926,2023-06-06,502,iphone 15 pro max,100000,135000,35000,1,00036,India
544082,2023-06-06,507,washing machine,6990,16490,9500,1,00332,India
544082,2023-06-06,502,iphone 15 pro max,100000,135000,35000,1,00332,India
544082,2023-06-06,505,oven,18490,24000,5510,1,00332,India
404764,2023-06-06,503,mixer,1349,3249,1900,1,00215,India
979863,2023-06-06,501,iphone 15,60000,80000,20000,1,00042,India
979863,2023-06-06,503,mixer,1349,3249,1900,1,00042,India
979863,2023-06-06,502,iphone 15 pro max,100000,135000,35000,1,00042,India
260569,2023-06-06,506,monitor,3249,8000,4751,1,00263,India
729489,2023-06-06,504,iron,449,879,430,1,00087,India
511083,2023-06-06,506,monitor,3249,8000,4751,1,00279,India
511083,2023-06-06,501,iphone 15,60000,80000,20000,1,00279,India
185664,2023-06-06,505,oven,18490,24000,5510,1,00454,India
185664,2023-06-06,502,iphone 15 pro max,100000,135000,35000,1,00454,India
185664,2023-06-06,501,iphone 15,60000,80000,20000,1,00454,India
861174,2023-06-06,506,monitor,3249,8000,4751,1,00487,India
861174,2023-06-06,502,iphone 15 pro max,100000,135000,35000,1,00487,India
861174,2023-06-06,505,oven,18490,24000,5510,1,00487,India
518119,2023-06-06,505,oven,18490,24000,5510,1,00196,India
518119,2023-06-06,504,iron,449,879,430,1,00196,India
518119,2023-06-06,507,washing machine,6990,16490,9500,1,00196,India
161882,2023-06-06,504,iron,449,879,430,1,00066,India
161882,2023-06-06,503,mixer,1349,3249,1900,1,00066,India
686604,2023-06-07,507,washing machine,6990,16490,9500,1,00277,India
686604,2023-06-07,503,mixer,1349,3249,1900,1,00277,India
686604,2023-06-07,504,iron,449,879,430,1,00277,India
416477,2023-06-07,504,iron,449,879,430,1,00171,India
416477,2023-06-07,503,mixer,1349,3249,1900,1,00171,India
416477,2023-06-07,501,iphone 15,60000,80000,20000,1,00171,India
957945,2023-06-07,502,iphone 15 pro max,100000,135000,35000,1,00098,India
957945,2023-06-07,504,iron,449,879,430,1,00098,India
596110,2023-06-07,504,iron,449,879,430,1,00323,India
992707,2023-06-07,503,mixer,1349,3249,1900,1,00394,India
166624,2023-06-07,505,oven,18490,24000,5510,1,00147,India
166624,2023-06-07,507,washing machine,6990,16490,9500,1,00147,India
548601,2023-06-07,507,washing machine,6990,16490,9500,1,00119,India
775143,2023-06-07,507,washing machine,6990,16490,9500,1,00377,India
775143,2023-06-07,506,monitor,3249,8000,4751,1,00377,India
775143,2023-06-07,505,oven,18490,24000,5510,1,00377,India
775143,2023-06-07,503,mixer,1349,3249,1900,1,00377,India
426401,2023-06-07,501,iphone 15,60000,80000,20000,1,00341,India
426401,2023-06-07,507,washing machine,6990,16490,9500,1,00341,India
426401,2023-06-07,504,iron,449,879,430,1,00341,India
426401,2023-06-07,503,mixer,1349,3249,1900,1,00341,India
931240,2023-06-07,505,oven,18490,24000,5510,1,00043,India
931240,2023-06-07,502,iphone 15 pro max,100000,135000,35000,1,00043,India
993431,2023-06-07,504,iron,449,879,430,1,00442,India
993431,2023-06-07,501,iphone 15,60000,80000,20000,1,00442,India
993431,2023-06-07,507,washing machine,6990,16490,9500,1,00442,India
523205,2023-06-07,503,mixer,1349,3249,1900,1,00089,India
523205,2023-06-07,504,iron,449,879,430,1,00089,India
523205,2023-06-07,501,iphone 15,60000,80000,20000,1,00089,India
366810,2023-06-07,506,monitor,3249,8000,4751,1,00125,India
366810,2023-06-07,503,mixer,1349,3249,1900,1,00125,India
845195,2023-06-07,503,mixer,1349,3249,1900,1,00300,India
845195,2023-06-07,505,oven,18490,24000,5510,1,00300,India
845195,2023-06-07,502,iphone 15 pro max,100000,135000,35000,1,00300,India
706217,2023-06-07,503,mixer,1349,3249,1900,1,00445,India
706217,2023-06-07,501,iphone 15,60000,80000,20000,1,00445,India
133814,2023-06-07,507,washing machine,6990,16490,9500,1,00207,India
133814,2023-06-07,501,iphone 15,60000,80000,20000,1,00207,India
133814,2023-06-07,505,oven,18490,24000,5510,1,00207,India
696947,2023-06-07,506,monitor,3249,8000,4751,1,00047,India
696947,2023-06-07,502,iphone 15 pro max,100000,135000,35000,1,00047,India
797528,2023-06-07,506,monitor,3249,8000,4751,1,00374,India
797528,2023-06-07,504,iron,449,879,430,1,00374,India
797528,2023-06-07,503,mixer,1349,3249,1900,1,00374,India
674528,2023-06-07,505,oven,18490,24000,5510,1,00347,India
111767,2023-06-07,503,mixer,1349,3249,1900,1,00065,India
111767,2023-06-07,507,washing machine,6990,16490,9500,1,00065,India
111767,2023-06-07,504,iron,449,879,430,1,00065,India
812287,2023-06-07,506,monitor,3249,8000,4751,1,00214,India
812287,2023-06-07,501,iphone 15,60000,80000,20000,1,00214,India
450281,2023-06-07,507,washing machine,6990,16490,9500,1,00061,India
450281,2023-06-07,506,monitor,3249,8000,4751,1,00061,India
450281,2023-06-07,505,oven,18490,24000,5510,1,00061,India
123980,2023-06-07,505,oven,18490,24000,5510,1,00350,India
123980,2023-06-07,501,iphone 15,60000,80000,20000,1,00350,India
123980,2023-06-07,506,monitor,3249,8000,4751,1,00350,India
123980,2023-06-07,504,iron,449,879,430,1,00350,India
712573,2023-06-07,504,iron,449,879,430,1,00438,India
712573,2023-06-07,503,mixer,1349,3249,1900,1,00438,India
712573,2023-06-07,506,monitor,3249,8000,4751,1,00438,India
608083,2023-06-07,506,monitor,3249,8000,4751,1,00051,India
608083,2023-06-07,502,iphone 15 pro max,100000,135000,35000,1,00051,India
454954,2023-06-07,502,iphone 15 pro max,100000,135000,35000,1,00386,India
216184,2023-06-07,502,iphone 15 pro max,100000,135000,35000,1,00403,India
216184,2023-06-07,505,oven,18490,24000,5510,1,00403,India
216184,2023-06-07,504,iron,449,879,430,1,00403,India
725097,2023-06-07,505,oven,18490,24000,5510,1,00464,India
725097,2023-06-07,502,iphone 15 pro max,100000,135000,35000,1,00464,India
483890,2023-06-07,507,washing machine,6990,16490,9500,1,00225,India
483890,2023-06-07,503,mixer,1349,3249,1900,1,00225,India
483890,2023-06-07,504,iron,449,879,430,1,00225,India
483890,2023-06-07,501,iphone 15,60000,80000,20000,1,00225,India
217177,2023-06-07,507,washing machine,6990,16490,9500,1,00033,India
896638,2023-06-07,502,iphone 15 pro max,100000,135000,35000,1,00016,India
896638,2023-06-07,505,oven,18490,24000,5510,1,00016,India
896638,2023-06-07,506,monitor,3249,8000,4751,1,00016,India
896638,2023-06-07,507,washing machine,6990,16490,9500,1,00016,India
305392,2023-06-07,502,iphone 15 pro max,100000,135000,35000,1,00206,India
305392,2023-06-07,507,washing machine,6990,16490,9500,1,00206,India
305392,2023-06-07,501,iphone 15,60000,80000,20000,1,00206,India
764656,2023-06-07,506,monitor,3249,8000,4751,1,00047,India
764656,2023-06-07,505,oven,18490,24000,5510,1,00047,India
218447,2023-06-07,506,monitor,3249,8000,4751,1,00232,India
218447,2023-06-07,501,iphone 15,60000,80000,20000,1,00232,India
150971,2023-06-07,504,iron,449,879,430,1,00288,India
312188,2023-06-07,506,monitor,3249,8000,4751,1,00014,India
312188,2023-06-07,504,iron,449,879,430,1,00014,India
805842,2023-06-07,504,iron,449,879,430,1,00119,India
274797,2023-06-07,502,iphone 15 pro max,100000,135000,35000,1,00214,India
274797,2023-06-07,507,washing machine,6990,16490,9500,1,00214,India
274797,2023-06-07,504,iron,449,879,430,1,00214,India
854975,2023-06-07,505,oven,18490,24000,5510,1,00080,India
854975,2023-06-07,506,monitor,3249,8000,4751,1,00080,India
766484,2023-06-07,501,iphone 15,60000,80000,20000,1,00397,India
766484,2023-06-07,505,oven,18490,24000,5510,1,00397,India
766484,2023-06-07,503,mixer,1349,3249,1900,1,00397,India
766484,2023-06-07,504,iron,449,879,430,1,00397,India
315830,2023-06-07,504,iron,449,879,430,1,00003,India
315830,2023-06-07,506,monitor,3249,8000,4751,1,00003,India
557369,2023-06-07,504,iron,449,879,430,1,00206,India
557369,2023-06-07,507,washing machine,6990,16490,9500,1,00206,India
700383,2023-06-07,504,iron,449,879,430,1,00236,India
700383,2023-06-07,501,iphone 15,60000,80000,20000,1,00236,India
700383,2023-06-07,507,washing machine,6990,16490,9500,1,00236,India
482006,2023-06-07,501,iphone 15,60000,80000,20000,1,00143,India
482006,2023-06-07,506,monitor,3249,8000,4751,1,00143,India
482006,2023-06-07,502,iphone 15 pro max,100000,135000,35000,1,00143,India
685861,2023-06-07,504,iron,449,879,430,1,00011,India
685861,2023-06-07,501,iphone 15,60000,80000,20000,1,00011,India
685861,2023-06-07,506,monitor,3249,8000,4751,1,00011,India
781970,2023-06-07,506,monitor,3249,8000,4751,1,00288,India
781970,2023-06-07,504,iron,449,879,430,1,00288,India
781970,2023-06-07,501,iphone 15,60000,80000,20000,1,00288,India
781970,2023-06-07,507,washing machine,6990,16490,9500,1,00288,India
781970,2023-06-07,502,iphone 15 pro max,100000,135000,35000,1,00288,India
577441,2023-06-07,503,mixer,1349,3249,1900,1,00324,India
577441,2023-06-07,506,monitor,3249,8000,4751,1,00324,India
577441,2023-06-07,507,washing machine,6990,16490,9500,1,00324,India
962079,2023-06-07,507,washing machine,6990,16490,9500,1,00105,India
962079,2023-06-07,503,mixer,1349,3249,1900,1,00105,India
298989,2023-06-07,504,iron,449,879,430,1,00344,India
298989,2023-06-07,507,washing machine,6990,16490,9500,1,00344,India
142784,2023-06-07,506,monitor,3249,8000,4751,1,00345,India
142784,2023-06-07,507,washing machine,6990,16490,9500,1,00345,India
142784,2023-06-07,501,iphone 15,60000,80000,20000,1,00345,India
886365,2023-06-07,502,iphone 15 pro max,100000,135000,35000,1,00163,India
886365,2023-06-07,503,mixer,1349,3249,1900,1,00163,India
405659,2023-06-07,504,iron,449,879,430,1,00124,India
405659,2023-06-07,505,oven,18490,24000,5510,1,00124,India
405659,2023-06-07,507,washing machine,6990,16490,9500,1,00124,India
666244,2023-06-07,504,iron,449,879,430,1,00220,India
666244,2023-06-07,503,mixer,1349,3249,1900,1,00220,India
685782,2023-06-07,506,monitor,3249,8000,4751,1,00244,India
685782,2023-06-07,507,washing machine,6990,16490,9500,1,00244,India
685782,2023-06-07,501,iphone 15,60000,80000,20000,1,00244,India
124938,2023-06-08,501,iphone 15,60000,80000,20000,1,00413,India
124938,2023-06-08,503,mixer,1349,3249,1900,1,00413,India
124938,2023-06-08,506,monitor,3249,8000,4751,1,00413,India
124938,2023-06-08,505,oven,18490,24000,5510,1,00413,India
120939,2023-06-08,506,monitor,3249,8000,4751,1,00335,India
120939,2023-06-08,507,washing machine,6990,16490,9500,1,00335,India
120939,2023-06-08,503,mixer,1349,3249,1900,1,00335,India
726063,2023-06-08,502,iphone 15 pro max,100000,135000,35000,1,00302,India
726063,2023-06-08,503,mixer,1349,3249,1900,1,00302,India
726063,2023-06-08,504,iron,449,879,430,1,00302,India
789663,2023-06-08,501,iphone 15,60000,80000,20000,1,00061,India
789663,2023-06-08,504,iron,449,879,430,1,00061,India
789663,2023-06-08,505,oven,18490,24000,5510,1,00061,India
105906,2023-06-08,501,iphone 15,60000,80000,20000,1,00147,India
462521,2023-06-08,507,washing machine,6990,16490,9500,1,00256,India
462521,2023-06-08,503,mixer,1349,3249,1900,1,00256,India
462521,2023-06-08,504,iron,449,879,430,1,00256,India
249217,2023-06-08,505,oven,18490,24000,5510,1,00054,India
249217,2023-06-08,502,iphone 15 pro max,100000,135000,35000,1,00054,India
519908,2023-06-08,503,mixer,1349,3249,1900,1,00066,India
519908,2023-06-08,507,washing machine,6990,16490,9500,1,00066,India
519908,2023-06-08,506,monitor,3249,8000,4751,1,00066,India
640462,2023-06-08,505,oven,18490,24000,5510,1,00399,India
640462,2023-06-08,502,iphone 15 pro max,100000,135000,35000,1,00399,India
640462,2023-06-08,503,mixer,1349,3249,1900,1,00399,India
239163,2023-06-08,503,mixer,1349,3249,1900,1,00068,India
617900,2023-06-08,501,iphone 15,60000,80000,20000,1,00323,India
617900,2023-06-08,504,iron,449,879,430,1,00323,India
640419,2023-06-08,504,iron,449,879,430,1,00138,India
640419,2023-06-08,503,mixer,1349,3249,1900,1,00138,India
640419,2023-06-08,502,iphone 15 pro max,100000,135000,35000,1,00138,India
640419,2023-06-08,505,oven,18490,24000,5510,1,00138,India
115406,2023-06-08,507,washing machine,6990,16490,9500,1,00219,India
544856,2023-06-08,502,iphone 15 pro max,100000,135000,35000,1,00191,India
544856,2023-06-08,503,mixer,1349,3249,1900,1,00191,India
134849,2023-06-08,501,iphone 15,60000,80000,20000,1,00336,India
134849,2023-06-08,504,iron,449,879,430,1,00336,India
134849,2023-06-08,507,washing machine,6990,16490,9500,1,00336,India
134849,2023-06-08,502,iphone 15 pro max,100000,135000,35000,1,00336,India
362973,2023-06-08,506,monitor,3249,8000,4751,1,00048,India
362973,2023-06-08,504,iron,449,879,430,1,00048,India
362973,2023-06-08,505,oven,18490,24000,5510,1,00048,India
866462,2023-06-08,502,iphone 15 pro max,100000,135000,35000,1,00377,India
866462,2023-06-08,501,iphone 15,60000,80000,20000,1,00377,India
331206,2023-06-08,501,iphone 15,60000,80000,20000,1,00395,India
331206,2023-06-08,505,oven,18490,24000,5510,1,00395,India
331206,2023-06-08,504,iron,449,879,430,1,00395,India
800377,2023-06-08,504,iron,449,879,430,1,00324,India
800377,2023-06-08,507,washing machine,6990,16490,9500,1,00324,India
800377,2023-06-08,501,iphone 15,60000,80000,20000,1,00324,India
331464,2023-06-08,505,oven,18490,24000,5510,1,00417,India
331464,2023-06-08,501,iphone 15,60000,80000,20000,1,00417,India
331464,2023-06-08,506,monitor,3249,8000,4751,1,00417,India
331464,2023-06-08,504,iron,449,879,430,1,00417,India
945326,2023-06-08,502,iphone 15 pro max,100000,135000,35000,1,00228,India
945326,2023-06-08,505,oven,18490,24000,5510,1,00228,India
187324,2023-06-08,502,iphone 15 pro max,100000,135000,35000,1,00279,India
187324,2023-06-08,505,oven,18490,24000,5510,1,00279,India
187324,2023-06-08,504,iron,449,879,430,1,00279,India
187324,2023-06-08,506,monitor,3249,8000,4751,1,00279,India
134348,2023-06-08,502,iphone 15 pro max,100000,135000,35000,1,00144,India
834512,2023-06-08,501,iphone 15,60000,80000,20000,1,00195,India
338641,2023-06-08,506,monitor,3249,8000,4751,1,00102,India
338641,2023-06-08,503,mixer,1349,3249,1900,1,00102,India
338641,2023-06-08,505,oven,18490,24000,5510,1,00102,India
207462,2023-06-08,504,iron,449,879,430,1,00036,India
207462,2023-06-08,507,washing machine,6990,16490,9500,1,00036,India
207462,2023-06-08,506,monitor,3249,8000,4751,1,00036,India
207462,2023-06-08,503,mixer,1349,3249,1900,1,00036,India
219383,2023-06-08,502,iphone 15 pro max,100000,135000,35000,1,00165,India
908764,2023-06-08,504,iron,449,879,430,1,00014,India
106444,2023-06-08,501,iphone 15,60000,80000,20000,1,00348,India
106444,2023-06-08,502,iphone 15 pro max,100000,135000,35000,1,00348,India
106444,2023-06-08,506,monitor,3249,8000,4751,1,00348,India
592268,2023-06-08,502,iphone 15 pro max,100000,135000,35000,1,00366,India
592268,2023-06-08,501,iphone 15,60000,80000,20000,1,00366,India
592268,2023-06-08,507,washing machine,6990,16490,9500,1,00366,India
280153,2023-06-08,503,mixer,1349,3249,1900,1,00135,India
280153,2023-06-08,506,monitor,3249,8000,4751,1,00135,India
183002,2023-06-08,507,washing machine,6990,16490,9500,1,00109,India
183002,2023-06-08,501,iphone 15,60000,80000,20000,1,00109,India
215949,2023-06-08,506,monitor,3249,8000,4751,1,00352,India
215949,2023-06-08,501,iphone 15,60000,80000,20000,1,00352,India
215949,2023-06-08,507,washing machine,6990,16490,9500,1,00352,India
966879,2023-06-08,502,iphone 15 pro max,100000,135000,35000,1,00124,India
752877,2023-06-08,505,oven,18490,24000,5510,1,00337,India
752877,2023-06-08,502,iphone 15 pro max,100000,135000,35000,1,00337,India
752877,2023-06-08,504,iron,449,879,430,1,00337,India
752877,2023-06-08,501,iphone 15,60000,80000,20000,1,00337,India
159955,2023-06-08,501,iphone 15,60000,80000,20000,1,00376,India
159955,2023-06-08,506,monitor,3249,8000,4751,1,00376,India
159955,2023-06-08,507,washing machine,6990,16490,9500,1,00376,India
275906,2023-06-08,504,iron,449,879,430,1,00387,India
275906,2023-06-08,507,washing machine,6990,16490,9500,1,00387,India
475282,2023-06-08,507,washing machine,6990,16490,9500,1,00113,India
475282,2023-06-08,501,iphone 15,60000,80000,20000,1,00113,India
737721,2023-06-08,505,oven,18490,24000,5510,1,00041,India
737721,2023-06-08,502,iphone 15 pro max,100000,135000,35000,1,00041,India
737721,2023-06-08,503,mixer,1349,3249,1900,1,00041,India
259902,2023-06-08,507,washing machine,6990,16490,9500,1,00173,India
259902,2023-06-08,504,iron,449,879,430,1,00173,India
259902,2023-06-08,501,iphone 15,60000,80000,20000,1,00173,India
259902,2023-06-08,502,iphone 15 pro max,100000,135000,35000,1,00173,India
186366,2023-06-08,504,iron,449,879,430,1,00034,India
186366,2023-06-08,507,washing machine,6990,16490,9500,1,00034,India
186366,2023-06-08,503,mixer,1349,3249,1900,1,00034,India
807105,2023-06-08,504,iron,449,879,430,1,00191,India
560971,2023-06-08,501,iphone 15,60000,80000,20000,1,00063,India
560971,2023-06-08,503,mixer,1349,3249,1900,1,00063,India
472281,2023-06-08,502,iphone 15 pro max,100000,135000,35000,1,00066,India
472281,2023-06-08,506,monitor,3249,8000,4751,1,00066,India
472281,2023-06-08,505,oven,18490,24000,5510,1,00066,India
653982,2023-06-08,505,oven,18490,24000,5510,1,00441,India
653982,2023-06-08,502,iphone 15 pro max,100000,135000,35000,1,00441,India
693010,2023-06-08,503,mixer,1349,3249,1900,1,00239,India
693010,2023-06-08,502,iphone 15 pro max,100000,135000,35000,1,00239,India
172174,2023-06-08,505,oven,18490,24000,5510,1,00021,India
172174,2023-06-08,507,washing machine,6990,16490,9500,1,00021,India
313257,2023-06-08,504,iron,449,879,430,1,00236,India
313257,2023-06-08,507,washing machine,6990,16490,9500,1,00236,India
571003,2023-06-08,506,monitor,3249,8000,4751,1,00100,India
571003,2023-06-08,503,mixer,1349,3249,1900,1,00100,India
571003,2023-06-08,505,oven,18490,24000,5510,1,00100,India
810758,2023-06-08,503,mixer,1349,3249,1900,1,00356,India
810758,2023-06-08,505,oven,18490,24000,5510,1,00356,India
810758,2023-06-08,501,iphone 15,60000,80000,20000,1,00356,India
810758,2023-06-08,507,washing machine,6990,16490,9500,1,00356,India
296207,2023-06-08,505,oven,18490,24000,5510,1,00060,India
296207,2023-06-08,504,iron,449,879,430,1,00060,India
296207,2023-06-08,507,washing machine,6990,16490,9500,1,00060,India
299096,2023-06-08,505,oven,18490,24000,5510,1,00236,India
299096,2023-06-08,506,monitor,3249,8000,4751,1,00236,India
327276,2023-06-08,505,oven,18490,24000,5510,1,00425,India
327276,2023-06-08,507,washing machine,6990,16490,9500,1,00425,India
327276,2023-06-08,501,iphone 15,60000,80000,20000,1,00425,India
296032,2023-06-08,502,iphone 15 pro max,100000,135000,35000,1,00037,India
472768,2023-06-08,504,iron,449,879,430,1,00204,India
472768,2023-06-08,502,iphone 15 pro max,100000,135000,35000,1,00204,India
514576,2023-06-08,507,washing machine,6990,16490,9500,1,00039,India
514576,2023-06-08,504,iron,449,879,430,1,00039,India
514576,2023-06-08,506,monitor,3249,8000,4751,1,00039,India
996975,2023-06-08,507,washing machine,6990,16490,9500,1,00379,India
996975,2023-06-08,502,iphone 15 pro max,100000,135000,35000,1,00379,India
996975,2023-06-08,504,iron,449,879,430,1,00379,India
996975,2023-06-08,503,mixer,1349,3249,1900,1,00379,India
890462,2023-06-08,504,iron,449,879,430,1,00208,India
174848,2023-06-08,503,mixer,1349,3249,1900,1,00213,India
174848,2023-06-08,501,iphone 15,60000,80000,20000,1,00213,India
761255,2023-06-08,506,monitor,3249,8000,4751,1,00002,India
761255,2023-06-08,507,washing machine,6990,16490,9500,1,00002,India
591035,2023-06-08,506,monitor,3249,8000,4751,1,00302,India
591035,2023-06-08,501,iphone 15,60000,80000,20000,1,00302,India
903404,2023-06-08,504,iron,449,879,430,1,00318,India
903404,2023-06-08,501,iphone 15,60000,80000,20000,1,00318,India
903404,2023-06-08,505,oven,18490,24000,5510,1,00318,India
551818,2023-06-08,506,monitor,3249,8000,4751,1,00159,India
551818,2023-06-08,502,iphone 15 pro max,100000,135000,35000,1,00159,India
551818,2023-06-08,504,iron,449,879,430,1,00159,India
551818,2023-06-08,507,washing machine,6990,16490,9500,1,00159,India
125928,2023-06-08,504,iron,449,879,430,1,00367,India
297851,2023-06-08,506,monitor,3249,8000,4751,1,00426,India
297851,2023-06-08,501,iphone 15,60000,80000,20000,1,00426,India
297851,2023-06-08,507,washing machine,6990,16490,9500,1,00426,India
426081,2023-06-08,503,mixer,1349,3249,1900,1,00052,India
426081,2023-06-08,507,washing machine,6990,16490,9500,1,00052,India
426081,2023-06-08,506,monitor,3249,8000,4751,1,00052,India
610737,2023-06-08,502,iphone 15 pro max,100000,135000,35000,1,00364,India
610737,2023-06-08,503,mixer,1349,3249,1900,1,00364,India
610737,2023-06-08,504,iron,449,879,430,1,00364,India
536126,2023-06-08,505,oven,18490,24000,5510,1,00013,India
536126,2023-06-08,507,washing machine,6990,16490,9500,1,00013,India
536126,2023-06-08,504,iron,449,879,430,1,00013,India
729833,2023-06-08,507,washing machine,6990,16490,9500,1,00303,India
729833,2023-06-08,506,monitor,3249,8000,4751,1,00303,India
729833,2023-06-08,502,iphone 15 pro max,100000,135000,35000,1,00303,India
729833,2023-06-08,505,oven,18490,24000,5510,1,00303,India
729833,2023-06-08,504,iron,449,879,430,1,00303,India
818273,2023-06-08,506,monitor,3249,8000,4751,1,00013,India
818273,2023-06-08,503,mixer,1349,3249,1900,1,00013,India
818273,2023-06-08,505,oven,18490,24000,5510,1,00013,India
279177,2023-06-08,506,monitor,3249,8000,4751,1,00485,India
279177,2023-06-08,502,iphone 15 pro max,100000,135000,35000,1,00485,India
975412,2023-06-08,507,washing machine,6990,16490,9500,1,00233,India
975412,2023-06-08,506,monitor,3249,8000,4751,1,00233,India
879631,2023-06-08,501,iphone 15,60000,80000,20000,1,00420,India
291730,2023-06-08,501,iphone 15,60000,80000,20000,1,00196,India
291730,2023-06-08,503,mixer,1349,3249,1900,1,00196,India
749197,2023-06-08,504,iron,449,879,430,1,00397,India
749197,2023-06-08,503,mixer,1349,3249,1900,1,00397,India
749197,2023-06-08,502,iphone 15 pro max,100000,135000,35000,1,00397,India
758529,2023-06-08,506,monitor,3249,8000,4751,1,00112,India
758529,2023-06-08,507,washing machine,6990,16490,9500,1,00112,India
758529,2023-06-08,501,iphone 15,60000,80000,20000,1,00112,India
392693,2023-06-08,507,washing machine,6990,16490,9500,1,00256,India
867340,2023-06-08,503,mixer,1349,3249,1900,1,00469,India
446108,2023-06-08,503,mixer,1349,3249,1900,1,00456,India
446108,2023-06-08,501,iphone 15,60000,80000,20000,1,00456,India
446108,2023-06-08,502,iphone 15 pro max,100000,135000,35000,1,00456,India
446108,2023-06-08,506,monitor,3249,8000,4751,1,00456,India
434764,2023-06-08,505,oven,18490,24000,5510,1,00223,India
434764,2023-06-08,502,iphone 15 pro max,100000,135000,35000,1,00223,India
434764,2023-06-08,501,iphone 15,60000,80000,20000,1,00223,India
434764,2023-06-08,507,washing machine,6990,16490,9500,1,00223,India
434764,2023-06-08,503,mixer,1349,3249,1900,1,00223,India
307617,2023-06-08,507,washing machine,6990,16490,9500,1,00462,India
307617,2023-06-08,501,iphone 15,60000,80000,20000,1,00462,India
307617,2023-06-08,505,oven,18490,24000,5510,1,00462,India
307617,2023-06-08,502,iphone 15 pro max,100000,135000,35000,1,00462,India
307617,2023-06-08,506,monitor,3249,8000,4751,1,00462,India
739071,2023-06-08,502,iphone 15 pro max,100000,135000,35000,1,00205,India
739071,2023-06-08,504,iron,449,879,430,1,00205,India
739071,2023-06-08,507,washing machine,6990,16490,9500,1,00205,India
767228,2023-06-08,507,washing machine,6990,16490,9500,1,00225,India
767228,2023-06-08,503,mixer,1349,3249,1900,1,00225,India
767228,2023-06-08,505,oven,18490,24000,5510,1,00225,India
767228,2023-06-08,502,iphone 15 pro max,100000,135000,35000,1,00225,India
387547,2023-06-08,504,iron,449,879,430,1,00069,India
387547,2023-06-08,505,oven,18490,24000,5510,1,00069,India
387547,2023-06-08,503,mixer,1349,3249,1900,1,00069,India
105956,2023-06-08,502,iphone 15 pro max,100000,135000,35000,1,00198,India
105956,2023-06-08,503,mixer,1349,3249,1900,1,00198,India
325327,2023-06-08,506,monitor,3249,8000,4751,1,00063,India
325327,2023-06-08,504,iron,449,879,430,1,00063,India
160791,2023-06-08,504,iron,449,879,430,1,00480,India
160791,2023-06-08,507,washing machine,6990,16490,9500,1,00480,India
160791,2023-06-08,505,oven,18490,24000,5510,1,00480,India
160791,2023-06-08,502,iphone 15 pro max,100000,135000,35000,1,00480,India
674884,2023-06-08,502,iphone 15 pro max,100000,135000,35000,1,00498,India
674884,2023-06-08,504,iron,449,879,430,1,00498,India
253566,2023-06-08,503,mixer,1349,3249,1900,1,00297,India
253566,2023-06-08,502,iphone 15 pro max,100000,135000,35000,1,00297,India
253566,2023-06-08,507,washing machine,6990,16490,9500,1,00297,India
839353,2023-06-08,504,iron,449,879,430,1,00316,India
741448,2023-06-08,504,iron,449,879,430,1,00362,India
741448,2023-06-08,505,oven,18490,24000,5510,1,00362,India
741448,2023-06-08,501,iphone 15,60000,80000,20000,1,00362,India
208930,2023-06-08,504,iron,449,879,430,1,00253,India
208930,2023-06-08,506,monitor,3249,8000,4751,1,00253,India
208930,2023-06-08,502,iphone 15 pro max,100000,135000,35000,1,00253,India
382471,2023-06-08,507,washing machine,6990,16490,9500,1,00484,India
766154,2023-06-09,501,iphone 15,60000,80000,20000,1,00173,India
766154,2023-06-09,507,washing machine,6990,16490,9500,1,00173,India
589153,2023-06-09,505,oven,18490,24000,5510,1,00267,India
607900,2023-06-09,502,iphone 15 pro max,100000,135000,35000,1,00469,India
607900,2023-06-09,507,washing machine,6990,16490,9500,1,00469,India
607900,2023-06-09,501,iphone 15,60000,80000,20000,1,00469,India
607900,2023-06-09,504,iron,449,879,430,1,00469,India
716251,2023-06-09,503,mixer,1349,3249,1900,1,00384,India
716251,2023-06-09,507,washing machine,6990,16490,9500,1,00384,India
585784,2023-06-09,505,oven,18490,24000,5510,1,00031,India
585784,2023-06-09,504,iron,449,879,430,1,00031,India
749054,2023-06-09,504,iron,449,879,430,1,00061,India
749054,2023-06-09,506,monitor,3249,8000,4751,1,00061,India
666135,2023-06-09,502,iphone 15 pro max,100000,135000,35000,1,00382,India
860997,2023-06-09,501,iphone 15,60000,80000,20000,1,00046,India
860997,2023-06-09,505,oven,18490,24000,5510,1,00046,India
793389,2023-06-09,505,oven,18490,24000,5510,1,00142,India
793389,2023-06-09,506,monitor,3249,8000,4751,1,00142,India
793389,2023-06-09,507,washing machine,6990,16490,9500,1,00142,India
400208,2023-06-09,502,iphone 15 pro max,100000,135000,35000,1,00155,India
701798,2023-06-09,507,washing machine,6990,16490,9500,1,00073,India
854720,2023-06-09,501,iphone 15,60000,80000,20000,1,00489,India
854720,2023-06-09,505,oven,18490,24000,5510,1,00489,India
854720,2023-06-09,503,mixer,1349,3249,1900,1,00489,India
878361,2023-06-09,507,washing machine,6990,16490,9500,1,00205,India
142909,2023-06-09,503,mixer,1349,3249,1900,1,00165,India
142909,2023-06-09,504,iron,449,879,430,1,00165,India
971027,2023-06-09,501,iphone 15,60000,80000,20000,1,00343,India
971027,2023-06-09,506,monitor,3249,8000,4751,1,00343,India
971027,2023-06-09,507,washing machine,6990,16490,9500,1,00343,India
357276,2023-06-09,504,iron,449,879,430,1,00075,India
357276,2023-06-09,507,washing machine,6990,16490,9500,1,00075,India
357276,2023-06-09,501,iphone 15,60000,80000,20000,1,00075,India
385537,2023-06-09,503,mixer,1349,3249,1900,1,00398,India
385537,2023-06-09,502,iphone 15 pro max,100000,135000,35000,1,00398,India
385537,2023-06-09,501,iphone 15,60000,80000,20000,1,00398,India
385537,2023-06-09,504,iron,449,879,430,1,00398,India
276422,2023-06-09,504,iron,449,879,430,1,00349,India
276422,2023-06-09,503,mixer,1349,3249,1900,1,00349,India
450691,2023-06-09,505,oven,18490,24000,5510,1,00111,India
450691,2023-06-09,504,iron,449,879,430,1,00111,India
315038,2023-06-09,502,iphone 15 pro max,100000,135000,35000,1,00387,India
315038,2023-06-09,501,iphone 15,60000,80000,20000,1,00387,India
315038,2023-06-09,505,oven,18490,24000,5510,1,00387,India
315038,2023-06-09,504,iron,449,879,430,1,00387,India
315038,2023-06-09,503,mixer,1349,3249,1900,1,00387,India
522012,2023-06-09,503,mixer,1349,3249,1900,1,00046,India
522012,2023-06-09,505,oven,18490,24000,5510,1,00046,India
522012,2023-06-09,501,iphone 15,60000,80000,20000,1,00046,India
522012,2023-06-09,507,washing machine,6990,16490,9500,1,00046,India
522012,2023-06-09,502,iphone 15 pro max,100000,135000,35000,1,00046,India
778406,2023-06-09,501,iphone 15,60000,80000,20000,1,00067,India
778406,2023-06-09,504,iron,449,879,430,1,00067,India
381954,2023-06-09,503,mixer,1349,3249,1900,1,00286,India
381954,2023-06-09,506,monitor,3249,8000,4751,1,00286,India
877107,2023-06-09,504,iron,449,879,430,1,00041,India
819525,2023-06-09,502,iphone 15 pro max,100000,135000,35000,1,00238,India
819525,2023-06-09,503,mixer,1349,3249,1900,1,00238,India
819525,2023-06-09,501,iphone 15,60000,80000,20000,1,00238,India
528524,2023-06-09,505,oven,18490,24000,5510,1,00112,India
528524,2023-06-09,503,mixer,1349,3249,1900,1,00112,India
970553,2023-06-09,503,mixer,1349,3249,1900,1,00159,India
970553,2023-06-09,501,iphone 15,60000,80000,20000,1,00159,India
970553,2023-06-09,506,monitor,3249,8000,4751,1,00159,India
970553,2023-06-09,504,iron,449,879,430,1,00159,India
970553,2023-06-09,507,washing machine,6990,16490,9500,1,00159,India
471958,2023-06-09,507,washing machine,6990,16490,9500,1,00255,India
471958,2023-06-09,502,iphone 15 pro max,100000,135000,35000,1,00255,India
471958,2023-06-09,504,iron,449,879,430,1,00255,India
149138,2023-06-09,507,washing machine,6990,16490,9500,1,00198,India
149138,2023-06-09,504,iron,449,879,430,1,00198,India
149138,2023-06-09,506,monitor,3249,8000,4751,1,00198,India
884377,2023-06-09,506,monitor,3249,8000,4751,1,00399,India
884377,2023-06-09,502,iphone 15 pro max,100000,135000,35000,1,00399,India
884377,2023-06-09,505,oven,18490,24000,5510,1,00399,India
563495,2023-06-09,503,mixer,1349,3249,1900,1,00203,India
280531,2023-06-09,501,iphone 15,60000,80000,20000,1,00095,India
280531,2023-06-09,505,oven,18490,24000,5510,1,00095,India
280531,2023-06-09,502,iphone 15 pro max,100000,135000,35000,1,00095,India
119607,2023-06-09,502,iphone 15 pro max,100000,135000,35000,1,00139,India
119607,2023-06-09,506,monitor,3249,8000,4751,1,00139,India
119607,2023-06-09,505,oven,18490,24000,5510,1,00139,India
149517,2023-06-09,503,mixer,1349,3249,1900,1,00155,India
149517,2023-06-09,502,iphone 15 pro max,100000,135000,35000,1,00155,India
597335,2023-06-09,504,iron,449,879,430,1,00186,India
231015,2023-06-09,503,mixer,1349,3249,1900,1,00434,India
231015,2023-06-09,502,iphone 15 pro max,100000,135000,35000,1,00434,India
231015,2023-06-09,501,iphone 15,60000,80000,20000,1,00434,India
329887,2023-06-09,507,washing machine,6990,16490,9500,1,00253,India
329887,2023-06-09,505,oven,18490,24000,5510,1,00253,India
329887,2023-06-09,501,iphone 15,60000,80000,20000,1,00253,India
329887,2023-06-09,506,monitor,3249,8000,4751,1,00253,India
537075,2023-06-09,504,iron,449,879,430,1,00015,India
537075,2023-06-09,502,iphone 15 pro max,100000,135000,35000,1,00015,India
537075,2023-06-09,507,washing machine,6990,16490,9500,1,00015,India
325370,2023-06-09,504,iron,449,879,430,1,00045,India
325370,2023-06-09,501,iphone 15,60000,80000,20000,1,00045,India
325370,2023-06-09,503,mixer,1349,3249,1900,1,00045,India
659783,2023-06-09,506,monitor,3249,8000,4751,1,00160,India
659783,2023-06-09,507,washing machine,6990,16490,9500,1,00160,India
659783,2023-06-09,505,oven,18490,24000,5510,1,00160,India
677129,2023-06-09,506,monitor,3249,8000,4751,1,00451,India
677129,2023-06-09,504,iron,449,879,430,1,00451,India
677129,2023-06-09,502,iphone 15 pro max,100000,135000,35000,1,00451,India
233303,2023-06-09,503,mixer,1349,3249,1900,1,00479,India
233303,2023-06-09,501,iphone 15,60000,80000,20000,1,00479,India
233303,2023-06-09,504,iron,449,879,430,1,00479,India
878069,2023-06-09,501,iphone 15,60000,80000,20000,1,00328,India
878069,2023-06-09,506,monitor,3249,8000,4751,1,00328,India
750352,2023-06-09,501,iphone 15,60000,80000,20000,1,00345,India
386987,2023-06-09,502,iphone 15 pro max,100000,135000,35000,1,00385,India
386987,2023-06-09,503,mixer,1349,3249,1900,1,00385,India
258113,2023-06-09,504,iron,449,879,430,1,00115,India
258113,2023-06-09,502,iphone 15 pro max,100000,135000,35000,1,00115,India
259683,2023-06-09,505,oven,18490,24000,5510,1,00323,India
588038,2023-06-09,502,iphone 15 pro max,100000,135000,35000,1,00003,India
588038,2023-06-09,507,washing machine,6990,16490,9500,1,00003,India
588038,2023-06-09,503,mixer,1349,3249,1900,1,00003,India
477607,2023-06-09,505,oven,18490,24000,5510,1,00359,India
477607,2023-06-09,504,iron,449,879,430,1,00359,India
320058,2023-06-09,507,washing machine,6990,16490,9500,1,00176,India
320058,2023-06-09,506,monitor,3249,8000,4751,1,00176,India
320058,2023-06-09,503,mixer,1349,3249,1900,1,00176,India
399902,2023-06-09,506,monitor,3249,8000,4751,1,00423,India
245153,2023-06-09,507,washing machine,6990,16490,9500,1,00080,India
245153,2023-06-09,505,oven,18490,24000,5510,1,00080,India
901735,2023-06-09,503,mixer,1349,3249,1900,1,00483,India
901735,2023-06-09,502,iphone 15 pro max,100000,135000,35000,1,00483,India
901735,2023-06-09,501,iphone 15,60000,80000,20000,1,00483,India
669853,2023-06-09,504,iron,449,879,430,1,00055,India
443038,2023-06-09,503,mixer,1349,3249,1900,1,00173,India
443038,2023-06-09,501,iphone 15,60000,80000,20000,1,00173,India
443038,2023-06-09,507,washing machine,6990,16490,9500,1,00173,India
443038,2023-06-09,506,monitor,3249,8000,4751,1,00173,India
875061,2023-06-09,504,iron,449,879,430,1,00497,India
574055,2023-06-09,507,washing machine,6990,16490,9500,1,00467,India
574055,2023-06-09,501,iphone 15,60000,80000,20000,1,00467,India
574055,2023-06-09,505,oven,18490,24000,5510,1,00467,India
574055,2023-06-09,506,monitor,3249,8000,4751,1,00467,India
590256,2023-06-09,502,iphone 15 pro max,100000,135000,35000,1,00492,India
590256,2023-06-09,501,iphone 15,60000,80000,20000,1,00492,India
808973,2023-06-09,505,oven,18490,24000,5510,1,00302,India
808973,2023-06-09,507,washing machine,6990,16490,9500,1,00302,India
808973,2023-06-09,501,iphone 15,60000,80000,20000,1,00302,India
938805,2023-06-09,503,mixer,1349,3249,1900,1,00435,India
938805,2023-06-09,502,iphone 15 pro max,100000,135000,35000,1,00435,India
938805,2023-06-09,501,iphone 15,60000,80000,20000,1,00435,India
713054,2023-06-09,507,washing machine,6990,16490,9500,1,00215,India
901748,2023-06-09,503,mixer,1349,3249,1900,1,00395,India
901748,2023-06-09,504,iron,449,879,430,1,00395,India
901748,2023-06-09,501,iphone 15,60000,80000,20000,1,00395,India
596722,2023-06-09,507,washing machine,6990,16490,9500,1,00174,India
753628,2023-06-09,506,monitor,3249,8000,4751,1,00046,India
587767,2023-06-09,505,oven,18490,24000,5510,1,00154,India
587767,2023-06-09,506,monitor,3249,8000,4751,1,00154,India
590796,2023-06-09,505,oven,18490,24000,5510,1,00181,India
390431,2023-06-09,503,mixer,1349,3249,1900,1,00062,India
443342,2023-06-09,503,mixer,1349,3249,1900,1,00491,India
443342,2023-06-09,506,monitor,3249,8000,4751,1,00491,India
443342,2023-06-09,504,iron,449,879,430,1,00491,India
443342,2023-06-09,501,iphone 15,60000,80000,20000,1,00491,India
956392,2023-06-09,503,mixer,1349,3249,1900,1,00003,India
595606,2023-06-09,507,washing machine,6990,16490,9500,1,00014,India
595606,2023-06-09,504,iron,449,879,430,1,00014,India
595606,2023-06-09,503,mixer,1349,3249,1900,1,00014,India
595606,2023-06-09,506,monitor,3249,8000,4751,1,00014,India
977347,2023-06-09,502,iphone 15 pro max,100000,135000,35000,1,00433,India
114749,2023-06-09,502,iphone 15 pro max,100000,135000,35000,1,00261,India
396100,2023-06-09,501,iphone 15,60000,80000,20000,1,00068,India
811306,2023-06-09,501,iphone 15,60000,80000,20000,1,00150,India
811306,2023-06-09,504,iron,449,879,430,1,00150,India
811306,2023-06-09,503,mixer,1349,3249,1900,1,00150,India
811306,2023-06-09,502,iphone 15 pro max,100000,135000,35000,1,00150,India
880544,2023-06-09,503,mixer,1349,3249,1900,1,00174,India
254734,2023-06-09,506,monitor,3249,8000,4751,1,00459,India
254734,2023-06-09,503,mixer,1349,3249,1900,1,00459,India
254734,2023-06-09,507,washing machine,6990,16490,9500,1,00459,India
550895,2023-06-09,505,oven,18490,24000,5510,1,00441,India
634137,2023-06-09,505,oven,18490,24000,5510,1,00038,India
634137,2023-06-09,507,washing machine,6990,16490,9500,1,00038,India
634137,2023-06-09,501,iphone 15,60000,80000,20000,1,00038,India
669432,2023-06-09,506,monitor,3249,8000,4751,1,00320,India
669432,2023-06-09,503,mixer,1349,3249,1900,1,00320,India
125066,2023-06-09,503,mixer,1349,3249,1900,1,00273,India
125066,2023-06-09,505,oven,18490,24000,5510,1,00273,India
125066,2023-06-09,501,iphone 15,60000,80000,20000,1,00273,India
857535,2023-06-09,506,monitor,3249,8000,4751,1,00088,India
857535,2023-06-09,503,mixer,1349,3249,1900,1,00088,India
138074,2023-06-09,503,mixer,1349,3249,1900,1,00209,India
210957,2023-06-09,502,iphone 15 pro max,100000,135000,35000,1,00324,India
210957,2023-06-09,503,mixer,1349,3249,1900,1,00324,India
210957,2023-06-09,501,iphone 15,60000,80000,20000,1,00324,India
928111,2023-06-09,503,mixer,1349,3249,1900,1,00094,India
928111,2023-06-09,504,iron,449,879,430,1,00094,India
928111,2023-06-09,505,oven,18490,24000,5510,1,00094,India
928111,2023-06-09,507,washing machine,6990,16490,9500,1,00094,India
928111,2023-06-09,501,iphone 15,60000,80000,20000,1,00094,India
685777,2023-06-10,507,washing machine,6990,16490,9500,1,00230,India
685777,2023-06-10,506,monitor,3249,8000,4751,1,00230,India
685777,2023-06-10,504,iron,449,879,430,1,00230,India
685777,2023-06-10,505,oven,18490,24000,5510,1,00230,India
327382,2023-06-10,502,iphone 15 pro max,100000,135000,35000,1,00065,India
974483,2023-06-10,504,iron,449,879,430,1,00203,India
974483,2023-06-10,507,washing machine,6990,16490,9500,1,00203,India
974483,2023-06-10,505,oven,18490,24000,5510,1,00203,India
168414,2023-06-10,507,washing machine,6990,16490,9500,1,00194,India
168414,2023-06-10,502,iphone 15 pro max,100000,135000,35000,1,00194,India
168414,2023-06-10,506,monitor,3249,8000,4751,1,00194,India
134469,2023-06-10,501,iphone 15,60000,80000,20000,1,00064,India
134469,2023-06-10,507,washing machine,6990,16490,9500,1,00064,India
322760,2023-06-10,507,washing machine,6990,16490,9500,1,00039,India
960575,2023-06-10,506,monitor,3249,8000,4751,1,00086,India
960575,2023-06-10,503,mixer,1349,3249,1900,1,00086,India
453717,2023-06-10,501,iphone 15,60000,80000,20000,1,00154,India
453717,2023-06-10,507,washing machine,6990,16490,9500,1,00154,India
453717,2023-06-10,505,oven,18490,24000,5510,1,00154,India
642738,2023-06-10,504,iron,449,879,430,1,00443,India
642738,2023-06-10,505,oven,18490,24000,5510,1,00443,India
642738,2023-06-10,503,mixer,1349,3249,1900,1,00443,India
656161,2023-06-10,505,oven,18490,24000,5510,1,00258,India
656161,2023-06-10,501,iphone 15,60000,80000,20000,1,00258,India
656161,2023-06-10,503,mixer,1349,3249,1900,1,00258,India
656161,2023-06-10,506,monitor,3249,8000,4751,1,00258,India
742291,2023-06-10,501,iphone 15,60000,80000,20000,1,00408,India
742291,2023-06-10,506,monitor,3249,8000,4751,1,00408,India
742291,2023-06-10,502,iphone 15 pro max,100000,135000,35000,1,00408,India
742291,2023-06-10,504,iron,449,879,430,1,00408,India
224781,2023-06-10,501,iphone 15,60000,80000,20000,1,00037,India
224781,2023-06-10,502,iphone 15 pro max,100000,135000,35000,1,00037,India
224781,2023-06-10,505,oven,18490,24000,5510,1,00037,India
737092,2023-06-10,505,oven,18490,24000,5510,1,00414,India
737092,2023-06-10,503,mixer,1349,3249,1900,1,00414,India
863747,2023-06-10,506,monitor,3249,8000,4751,1,00078,India
863747,2023-06-10,502,iphone 15 pro max,100000,135000,35000,1,00078,India
863747,2023-06-10,503,mixer,1349,3249,1900,1,00078,India
126639,2023-06-10,504,iron,449,879,430,1,00095,India
126639,2023-06-10,505,oven,18490,24000,5510,1,00095,India
224896,2023-06-10,503,mixer,1349,3249,1900,1,00275,India
724166,2023-06-10,507,washing machine,6990,16490,9500,1,00345,India
225339,2023-06-10,505,oven,18490,24000,5510,1,00271,India
225339,2023-06-10,506,monitor,3249,8000,4751,1,00271,India
225339,2023-06-10,501,iphone 15,60000,80000,20000,1,00271,India
729620,2023-06-10,502,iphone 15 pro max,100000,135000,35000,1,00014,India
695401,2023-06-10,506,monitor,3249,8000,4751,1,00393,India
829779,2023-06-10,501,iphone 15,60000,80000,20000,1,00145,India
829779,2023-06-10,505,oven,18490,24000,5510,1,00145,India
829779,2023-06-10,502,iphone 15 pro max,100000,135000,35000,1,00145,India
712085,2023-06-10,506,monitor,3249,8000,4751,1,00257,India
712085,2023-06-10,501,iphone 15,60000,80000,20000,1,00257,India
712085,2023-06-10,502,iphone 15 pro max,100000,135000,35000,1,00257,India
712085,2023-06-10,503,mixer,1349,3249,1900,1,00257,India
712085,2023-06-10,505,oven,18490,24000,5510,1,00257,India
786262,2023-06-10,503,mixer,1349,3249,1900,1,00140,India
786262,2023-06-10,505,oven,18490,24000,5510,1,00140,India
786262,2023-06-10,501,iphone 15,60000,80000,20000,1,00140,India
786262,2023-06-10,502,iphone 15 pro max,100000,135000,35000,1,00140,India
950916,2023-06-10,504,iron,449,879,430,1,00126,India
950916,2023-06-10,502,iphone 15 pro max,100000,135000,35000,1,00126,India
950916,2023-06-10,506,monitor,3249,8000,4751,1,00126,India
950916,2023-06-10,505,oven,18490,24000,5510,1,00126,India
950916,2023-06-10,503,mixer,1349,3249,1900,1,00126,India
371302,2023-06-10,501,iphone 15,60000,80000,20000,1,00301,India
517498,2023-06-10,504,iron,449,879,430,1,00130,India
517498,2023-06-10,502,iphone 15 pro max,100000,135000,35000,1,00130,India
517498,2023-06-10,507,washing machine,6990,16490,9500,1,00130,India
670906,2023-06-10,503,mixer,1349,3249,1900,1,00351,India
670906,2023-06-10,507,washing machine,6990,16490,9500,1,00351,India
670906,2023-06-10,504,iron,449,879,430,1,00351,India
315328,2023-06-10,503,mixer,1349,3249,1900,1,00331,India
315328,2023-06-10,507,washing machine,6990,16490,9500,1,00331,India
756009,2023-06-10,504,iron,449,879,430,1,00066,India
612770,2023-06-10,502,iphone 15 pro max,100000,135000,35000,1,00292,India
612770,2023-06-10,505,oven,18490,24000,5510,1,00292,India
612770,2023-06-10,501,iphone 15,60000,80000,20000,1,00292,India
954030,2023-06-10,504,iron,449,879,430,1,00333,India
954030,2023-06-10,507,washing machine,6990,16490,9500,1,00333,India
954030,2023-06-10,505,oven,18490,24000,5510,1,00333,India
100394,2023-06-10,503,mixer,1349,3249,1900,1,00385,India
100394,2023-06-10,502,iphone 15 pro max,100000,135000,35000,1,00385,India
100394,2023-06-10,501,iphone 15,60000,80000,20000,1,00385,India
100394,2023-06-10,505,oven,18490,24000,5510,1,00385,India
279184,2023-06-10,505,oven,18490,24000,5510,1,00444,India
279184,2023-06-10,501,iphone 15,60000,80000,20000,1,00444,India
279184,2023-06-10,507,washing machine,6990,16490,9500,1,00444,India
279184,2023-06-10,502,iphone 15 pro max,100000,135000,35000,1,00444,India
329642,2023-06-10,502,iphone 15 pro max,100000,135000,35000,1,00490,India
329642,2023-06-10,507,washing machine,6990,16490,9500,1,00490,India
329642,2023-06-10,503,mixer,1349,3249,1900,1,00490,India
329642,2023-06-10,504,iron,449,879,430,1,00490,India
600072,2023-06-10,501,iphone 15,60000,80000,20000,1,00252,India
600072,2023-06-10,507,washing machine,6990,16490,9500,1,00252,India
202570,2023-06-10,507,washing machine,6990,16490,9500,1,00097,India
202570,2023-06-10,503,mixer,1349,3249,1900,1,00097,India
202570,2023-06-10,504,iron,449,879,430,1,00097,India
202570,2023-06-10,505,oven,18490,24000,5510,1,00097,India
623694,2023-06-10,507,washing machine,6990,16490,9500,1,00173,India
623694,2023-06-10,502,iphone 15 pro max,100000,135000,35000,1,00173,India
623694,2023-06-10,503,mixer,1349,3249,1900,1,00173,India
623694,2023-06-10,504,iron,449,879,430,1,00173,India
623694,2023-06-10,505,oven,18490,24000,5510,1,00173,India
888136,2023-06-10,505,oven,18490,24000,5510,1,00244,India
888136,2023-06-10,503,mixer,1349,3249,1900,1,00244,India
888136,2023-06-10,507,washing machine,6990,16490,9500,1,00244,India
313806,2023-06-10,506,monitor,3249,8000,4751,1,00063,India
577662,2023-06-10,506,monitor,3249,8000,4751,1,00407,India
270628,2023-06-10,501,iphone 15,60000,80000,20000,1,00160,India
270628,2023-06-10,505,oven,18490,24000,5510,1,00160,India
270628,2023-06-10,503,mixer,1349,3249,1900,1,00160,India
270628,2023-06-10,507,washing machine,6990,16490,9500,1,00160,India
577581,2023-06-10,501,iphone 15,60000,80000,20000,1,00147,India
577581,2023-06-10,503,mixer,1349,3249,1900,1,00147,India
307249,2023-06-10,505,oven,18490,24000,5510,1,00001,India
307249,2023-06-10,507,washing machine,6990,16490,9500,1,00001,India
624786,2023-06-10,501,iphone 15,60000,80000,20000,1,00003,India
624786,2023-06-10,503,mixer,1349,3249,1900,1,00003,India
624786,2023-06-10,505,oven,18490,24000,5510,1,00003,India
334725,2023-06-10,506,monitor,3249,8000,4751,1,00029,India
100954,2023-06-10,504,iron,449,879,430,1,00422,India
600753,2023-06-10,505,oven,18490,24000,5510,1,00261,India
600753,2023-06-10,506,monitor,3249,8000,4751,1,00261,India
600753,2023-06-10,504,iron,449,879,430,1,00261,India
687186,2023-06-10,507,washing machine,6990,16490,9500,1,00085,India
687186,2023-06-10,505,oven,18490,24000,5510,1,00085,India
687186,2023-06-10,504,iron,449,879,430,1,00085,India
687186,2023-06-10,503,mixer,1349,3249,1900,1,00085,India
836720,2023-06-10,505,oven,18490,24000,5510,1,00177,India
836720,2023-06-10,502,iphone 15 pro max,100000,135000,35000,1,00177,India
884826,2023-06-10,507,washing machine,6990,16490,9500,1,00347,India
884826,2023-06-10,506,monitor,3249,8000,4751,1,00347,India
884826,2023-06-10,501,iphone 15,60000,80000,20000,1,00347,India
572953,2023-06-10,506,monitor,3249,8000,4751,1,00478,India
327100,2023-06-10,506,monitor,3249,8000,4751,1,00284,India
976062,2023-06-10,501,iphone 15,60000,80000,20000,1,00424,India
976062,2023-06-10,505,oven,18490,24000,5510,1,00424,India
295705,2023-06-10,507,washing machine,6990,16490,9500,1,00490,India
295705,2023-06-10,505,oven,18490,24000,5510,1,00490,India
295705,2023-06-10,504,iron,449,879,430,1,00490,India
416940,2023-06-10,506,monitor,3249,8000,4751,1,00078,India
416940,2023-06-10,505,oven,18490,24000,5510,1,00078,India
473263,2023-06-10,507,washing machine,6990,16490,9500,1,00410,India
473263,2023-06-10,503,mixer,1349,3249,1900,1,00410,India
473263,2023-06-10,501,iphone 15,60000,80000,20000,1,00410,India
473263,2023-06-10,505,oven,18490,24000,5510,1,00410,India
490131,2023-06-10,507,washing machine,6990,16490,9500,1,00099,India
490131,2023-06-10,506,monitor,3249,8000,4751,1,00099,India
630017,2023-06-11,503,mixer,1349,3249,1900,1,00240,India
630017,2023-06-11,502,iphone 15 pro max,100000,135000,35000,1,00240,India
705462,2023-06-11,504,iron,449,879,430,1,00286,India
705462,2023-06-11,506,monitor,3249,8000,4751,1,00286,India
261471,2023-06-11,507,washing machine,6990,16490,9500,1,00401,India
261471,2023-06-11,503,mixer,1349,3249,1900,1,00401,India
107403,2023-06-11,505,oven,18490,24000,5510,1,00091,India
127617,2023-06-11,504,iron,449,879,430,1,00348,India
127617,2023-06-11,507,washing machine,6990,16490,9500,1,00348,India
127617,2023-06-11,506,monitor,3249,8000,4751,1,00348,India
685540,2023-06-11,505,oven,18490,24000,5510,1,00054,India
685540,2023-06-11,507,washing machine,6990,16490,9500,1,00054,India
685540,2023-06-11,502,iphone 15 pro max,100000,135000,35000,1,00054,India
685540,2023-06-11,506,monitor,3249,8000,4751,1,00054,India
685540,2023-06-11,501,iphone 15,60000,80000,20000,1,00054,India
606499,2023-06-11,506,monitor,3249,8000,4751,1,00273,India
606499,2023-06-11,502,iphone 15 pro max,100000,135000,35000,1,00273,India
606499,2023-06-11,501,iphone 15,60000,80000,20000,1,00273,India
228028,2023-06-11,507,washing machine,6990,16490,9500,1,00323,India
228028,2023-06-11,506,monitor,3249,8000,4751,1,00323,India
865652,2023-06-11,507,washing machine,6990,16490,9500,1,00446,India
865652,2023-06-11,504,iron,449,879,430,1,00446,India
607086,2023-06-11,504,iron,449,879,430,1,00341,India
786751,2023-06-11,506,monitor,3249,8000,4751,1,00036,India
786751,2023-06-11,503,mixer,1349,3249,1900,1,00036,India
786751,2023-06-11,502,iphone 15 pro max,100000,135000,35000,1,00036,India
786751,2023-06-11,504,iron,449,879,430,1,00036,India
662215,2023-06-11,503,mixer,1349,3249,1900,1,00071,India
906787,2023-06-11,502,iphone 15 pro max,100000,135000,35000,1,00100,India
906787,2023-06-11,506,monitor,3249,8000,4751,1,00100,India
906787,2023-06-11,503,mixer,1349,3249,1900,1,00100,India
866610,2023-06-11,502,iphone 15 pro max,100000,135000,35000,1,00359,India
866610,2023-06-11,501,iphone 15,60000,80000,20000,1,00359,India
866610,2023-06-11,504,iron,449,879,430,1,00359,India
271337,2023-06-11,501,iphone 15,60000,80000,20000,1,00380,India
905497,2023-06-11,502,iphone 15 pro max,100000,135000,35000,1,00018,India
905497,2023-06-11,506,monitor,3249,8000,4751,1,00018,India
339101,2023-06-11,506,monitor,3249,8000,4751,1,00241,India
339101,2023-06-11,502,iphone 15 pro max,100000,135000,35000,1,00241,India
339101,2023-06-11,503,mixer,1349,3249,1900,1,00241,India
650812,2023-06-11,504,iron,449,879,430,1,00359,India
650812,2023-06-11,503,mixer,1349,3249,1900,1,00359,India
453110,2023-06-11,507,washing machine,6990,16490,9500,1,00338,India
453110,2023-06-11,504,iron,449,879,430,1,00338,India
453110,2023-06-11,502,iphone 15 pro max,100000,135000,35000,1,00338,India
348471,2023-06-11,505,oven,18490,24000,5510,1,00094,India
348471,2023-06-11,506,monitor,3249,8000,4751,1,00094,India
348471,2023-06-11,503,mixer,1349,3249,1900,1,00094,India
793288,2023-06-11,501,iphone 15,60000,80000,20000,1,00148,India
793288,2023-06-11,507,washing machine,6990,16490,9500,1,00148,India
957934,2023-06-11,504,iron,449,879,430,1,00254,India
957934,2023-06-11,501,iphone 15,60000,80000,20000,1,00254,India
957934,2023-06-11,503,mixer,1349,3249,1900,1,00254,India
422887,2023-06-11,504,iron,449,879,430,1,00405,India
306460,2023-06-11,507,washing machine,6990,16490,9500,1,00109,India
306460,2023-06-11,502,iphone 15 pro max,100000,135000,35000,1,00109,India
306460,2023-06-11,503,mixer,1349,3249,1900,1,00109,India
306460,2023-06-11,505,oven,18490,24000,5510,1,00109,India
704352,2023-06-11,503,mixer,1349,3249,1900,1,00048,India
704352,2023-06-11,501,iphone 15,60000,80000,20000,1,00048,India
704352,2023-06-11,506,monitor,3249,8000,4751,1,00048,India
577257,2023-06-11,507,washing machine,6990,16490,9500,1,00254,India
577257,2023-06-11,503,mixer,1349,3249,1900,1,00254,India
577257,2023-06-11,504,iron,449,879,430,1,00254,India
577257,2023-06-11,501,iphone 15,60000,80000,20000,1,00254,India
202224,2023-06-11,505,oven,18490,24000,5510,1,00029,India
202224,2023-06-11,504,iron,449,879,430,1,00029,India
202224,2023-06-11,507,washing machine,6990,16490,9500,1,00029,India
202224,2023-06-11,502,iphone 15 pro max,100000,135000,35000,1,00029,India
726497,2023-06-11,505,oven,18490,24000,5510,1,00182,India
726497,2023-06-11,507,washing machine,6990,16490,9500,1,00182,India
726497,2023-06-11,504,iron,449,879,430,1,00182,India
726497,2023-06-11,501,iphone 15,60000,80000,20000,1,00182,India
726497,2023-06-11,502,iphone 15 pro max,100000,135000,35000,1,00182,India
570325,2023-06-11,503,mixer,1349,3249,1900,1,00351,India
570325,2023-06-11,501,iphone 15,60000,80000,20000,1,00351,India
570325,2023-06-11,504,iron,449,879,430,1,00351,India
149047,2023-06-11,503,mixer,1349,3249,1900,1,00388,India
149047,2023-06-11,507,washing machine,6990,16490,9500,1,00388,India
149047,2023-06-11,501,iphone 15,60000,80000,20000,1,00388,India
149047,2023-06-11,504,iron,449,879,430,1,00388,India
547256,2023-06-11,501,iphone 15,60000,80000,20000,1,00484,India
547256,2023-06-11,504,iron,449,879,430,1,00484,India
129024,2023-06-11,504,iron,449,879,430,1,00280,India
129024,2023-06-11,506,monitor,3249,8000,4751,1,00280,India
129024,2023-06-11,501,iphone 15,60000,80000,20000,1,00280,India
552969,2023-06-11,503,mixer,1349,3249,1900,1,00177,India
552969,2023-06-11,501,iphone 15,60000,80000,20000,1,00177,India
552969,2023-06-11,502,iphone 15 pro max,100000,135000,35000,1,00177,India
324199,2023-06-11,504,iron,449,879,430,1,00198,India
324199,2023-06-11,507,washing machine,6990,16490,9500,1,00198,India
346193,2023-06-11,506,monitor,3249,8000,4751,1,00077,India
346193,2023-06-11,502,iphone 15 pro max,100000,135000,35000,1,00077,India
346193,2023-06-11,503,mixer,1349,3249,1900,1,00077,India
346193,2023-06-11,504,iron,449,879,430,1,00077,India
268071,2023-06-11,502,iphone 15 pro max,100000,135000,35000,1,00434,India
268071,2023-06-11,506,monitor,3249,8000,4751,1,00434,India
388868,2023-06-11,502,iphone 15 pro max,100000,135000,35000,1,00254,India
388868,2023-06-11,505,oven,18490,24000,5510,1,00254,India
388868,2023-06-11,504,iron,449,879,430,1,00254,India
379620,2023-06-11,504,iron,449,879,430,1,00258,India
379620,2023-06-11,502,iphone 15 pro max,100000,135000,35000,1,00258,India
326220,2023-06-11,506,monitor,3249,8000,4751,1,00377,India
326220,2023-06-11,504,iron,449,879,430,1,00377,India
326220,2023-06-11,502,iphone 15 pro max,100000,135000,35000,1,00377,India
568440,2023-06-11,505,oven,18490,24000,5510,1,00222,India
568440,2023-06-11,503,mixer,1349,3249,1900,1,00222,India
367015,2023-06-11,504,iron,449,879,430,1,00207,India
367015,2023-06-11,505,oven,18490,24000,5510,1,00207,India
263302,2023-06-11,502,iphone 15 pro max,100000,135000,35000,1,00426,India
263302,2023-06-11,501,iphone 15,60000,80000,20000,1,00426,India
263302,2023-06-11,507,washing machine,6990,16490,9500,1,00426,India
610672,2023-06-11,506,monitor,3249,8000,4751,1,00283,India
353723,2023-06-11,501,iphone 15,60000,80000,20000,1,00232,India
622634,2023-06-11,505,oven,18490,24000,5510,1,00246,India
622634,2023-06-11,506,monitor,3249,8000,4751,1,00246,India
622634,2023-06-11,507,washing machine,6990,16490,9500,1,00246,India
622634,2023-06-11,504,iron,449,879,430,1,00246,India
479739,2023-06-11,505,oven,18490,24000,5510,1,00265,India
479739,2023-06-11,502,iphone 15 pro max,100000,135000,35000,1,00265,India
479739,2023-06-11,507,washing machine,6990,16490,9500,1,00265,India
479739,2023-06-11,506,monitor,3249,8000,4751,1,00265,India
479739,2023-06-11,504,iron,449,879,430,1,00265,India
235521,2023-06-11,501,iphone 15,60000,80000,20000,1,00488,India
235521,2023-06-11,505,oven,18490,24000,5510,1,00488,India
695502,2023-06-11,506,monitor,3249,8000,4751,1,00141,India
695502,2023-06-11,504,iron,449,879,430,1,00141,India
545662,2023-06-11,507,washing machine,6990,16490,9500,1,00283,India
545662,2023-06-11,506,monitor,3249,8000,4751,1,00283,India
545662,2023-06-11,501,iphone 15,60000,80000,20000,1,00283,India
545662,2023-06-11,502,iphone 15 pro max,100000,135000,35000,1,00283,India
755129,2023-06-11,504,iron,449,879,430,1,00076,India
755129,2023-06-11,502,iphone 15 pro max,100000,135000,35000,1,00076,India
791000,2023-06-11,505,oven,18490,24000,5510,1,00495,India
626564,2023-06-11,505,oven,18490,24000,5510,1,00094,India
626564,2023-06-11,506,monitor,3249,8000,4751,1,00094,India
626564,2023-06-11,507,washing machine,6990,16490,9500,1,00094,India
626564,2023-06-11,503,mixer,1349,3249,1900,1,00094,India
305701,2023-06-11,506,monitor,3249,8000,4751,1,00212,India
305701,2023-06-11,503,mixer,1349,3249,1900,1,00212,India
305701,2023-06-11,505,oven,18490,24000,5510,1,00212,India
576755,2023-06-11,507,washing machine,6990,16490,9500,1,00146,India
576755,2023-06-11,503,mixer,1349,3249,1900,1,00146,India
241862,2023-06-11,503,mixer,1349,3249,1900,1,00181,India
241862,2023-06-11,502,iphone 15 pro max,100000,135000,35000,1,00181,India
241862,2023-06-11,501,iphone 15,60000,80000,20000,1,00181,India
241862,2023-06-11,504,iron,449,879,430,1,00181,India
355203,2023-06-11,506,monitor,3249,8000,4751,1,00494,India
355203,2023-06-11,503,mixer,1349,3249,1900,1,00494,India
355203,2023-06-11,505,oven,18490,24000,5510,1,00494,India
355203,2023-06-11,507,washing machine,6990,16490,9500,1,00494,India
641783,2023-06-11,507,washing machine,6990,16490,9500,1,00354,India
641783,2023-06-11,502,iphone 15 pro max,100000,135000,35000,1,00354,India
190131,2023-06-11,503,mixer,1349,3249,1900,1,00061,India
190131,2023-06-11,501,iphone 15,60000,80000,20000,1,00061,India
190131,2023-06-11,507,washing machine,6990,16490,9500,1,00061,India
190131,2023-06-11,504,iron,449,879,430,1,00061,India
641430,2023-06-11,503,mixer,1349,3249,1900,1,00014,India
440306,2023-06-11,505,oven,18490,24000,5510,1,00182,India
654246,2023-06-11,503,mixer,1349,3249,1900,1,00281,India
654246,2023-06-11,504,iron,449,879,430,1,00281,India
559361,2023-06-11,502,iphone 15 pro max,100000,135000,35000,1,00319,India
559361,2023-06-11,506,monitor,3249,8000,4751,1,00319,India
920925,2023-06-11,506,monitor,3249,8000,4751,1,00091,India
354291,2023-06-11,503,mixer,1349,3249,1900,1,00276,India
254569,2023-06-11,503,mixer,1349,3249,1900,1,00286,India
254569,2023-06-11,501,iphone 15,60000,80000,20000,1,00286,India
254569,2023-06-11,504,iron,449,879,430,1,00286,India
161922,2023-06-11,503,mixer,1349,3249,1900,1,00325,India
161922,2023-06-11,504,iron,449,879,430,1,00325,India
161922,2023-06-11,505,oven,18490,24000,5510,1,00325,India
161922,2023-06-11,507,washing machine,6990,16490,9500,1,00325,India
413589,2023-06-11,507,washing machine,6990,16490,9500,1,00270,India
413589,2023-06-11,502,iphone 15 pro max,100000,135000,35000,1,00270,India
413589,2023-06-11,501,iphone 15,60000,80000,20000,1,00270,India
751097,2023-06-11,503,mixer,1349,3249,1900,1,00209,India
751097,2023-06-11,507,washing machine,6990,16490,9500,1,00209,India
751097,2023-06-11,501,iphone 15,60000,80000,20000,1,00209,India
678153,2023-06-11,504,iron,449,879,430,1,00324,India
678153,2023-06-11,505,oven,18490,24000,5510,1,00324,India
678153,2023-06-11,503,mixer,1349,3249,1900,1,00324,India
678153,2023-06-11,501,iphone 15,60000,80000,20000,1,00324,India
370450,2023-06-11,504,iron,449,879,430,1,00459,India
355242,2023-06-11,505,oven,18490,24000,5510,1,00463,India
355242,2023-06-11,507,washing machine,6990,16490,9500,1,00463,India
656939,2023-06-11,507,washing machine,6990,16490,9500,1,00056,India
656939,2023-06-11,502,iphone 15 pro max,100000,135000,35000,1,00056,India
635465,2023-06-12,506,monitor,3249,8000,4751,1,00218,India
635465,2023-06-12,505,oven,18490,24000,5510,1,00218,India
297380,2023-06-12,503,mixer,1349,3249,1900,1,00461,India
297380,2023-06-12,505,oven,18490,24000,5510,1,00461,India
297380,2023-06-12,501,iphone 15,60000,80000,20000,1,00461,India
297380,2023-06-12,504,iron,449,879,430,1,00461,India
124242,2023-06-12,506,monitor,3249,8000,4751,1,00217,India
124242,2023-06-12,504,iron,449,879,430,1,00217,India
177020,2023-06-12,504,iron,449,879,430,1,00443,India
177020,2023-06-12,503,mixer,1349,3249,1900,1,00443,India
177020,2023-06-12,505,oven,18490,24000,5510,1,00443,India
177020,2023-06-12,507,washing machine,6990,16490,9500,1,00443,India
177020,2023-06-12,501,iphone 15,60000,80000,20000,1,00443,India
352707,2023-06-12,504,iron,449,879,430,1,00484,India
352707,2023-06-12,507,washing machine,6990,16490,9500,1,00484,India
352707,2023-06-12,506,monitor,3249,8000,4751,1,00484,India
352707,2023-06-12,505,oven,18490,24000,5510,1,00484,India
819198,2023-06-12,505,oven,18490,24000,5510,1,00405,India
819198,2023-06-12,506,monitor,3249,8000,4751,1,00405,India
819198,2023-06-12,507,washing machine,6990,16490,9500,1,00405,India
222987,2023-06-12,507,washing machine,6990,16490,9500,1,00420,India
932756,2023-06-12,505,oven,18490,24000,5510,1,00414,India
357403,2023-06-12,502,iphone 15 pro max,100000,135000,35000,1,00089,India
800864,2023-06-12,503,mixer,1349,3249,1900,1,00330,India
800864,2023-06-12,506,monitor,3249,8000,4751,1,00330,India
800864,2023-06-12,505,oven,18490,24000,5510,1,00330,India
800864,2023-06-12,502,iphone 15 pro max,100000,135000,35000,1,00330,India
191511,2023-06-12,502,iphone 15 pro max,100000,135000,35000,1,00484,India
191511,2023-06-12,501,iphone 15,60000,80000,20000,1,00484,India
191511,2023-06-12,505,oven,18490,24000,5510,1,00484,India
140771,2023-06-12,506,monitor,3249,8000,4751,1,00078,India
140771,2023-06-12,505,oven,18490,24000,5510,1,00078,India
140771,2023-06-12,503,mixer,1349,3249,1900,1,00078,India
140771,2023-06-12,507,washing machine,6990,16490,9500,1,00078,India
140771,2023-06-12,502,iphone 15 pro max,100000,135000,35000,1,00078,India
248080,2023-06-12,506,monitor,3249,8000,4751,1,00499,India
807215,2023-06-12,505,oven,18490,24000,5510,1,00227,India
807215,2023-06-12,502,iphone 15 pro max,100000,135000,35000,1,00227,India
807215,2023-06-12,506,monitor,3249,8000,4751,1,00227,India
807215,2023-06-12,501,iphone 15,60000,80000,20000,1,00227,India
782538,2023-06-12,504,iron,449,879,430,1,00059,India
782538,2023-06-12,506,monitor,3249,8000,4751,1,00059,India
782538,2023-06-12,503,mixer,1349,3249,1900,1,00059,India
497997,2023-06-12,504,iron,449,879,430,1,00358,India
497997,2023-06-12,507,washing machine,6990,16490,9500,1,00358,India
820497,2023-06-12,506,monitor,3249,8000,4751,1,00491,India
820497,2023-06-12,501,iphone 15,60000,80000,20000,1,00491,India
820497,2023-06-12,507,washing machine,6990,16490,9500,1,00491,India
820497,2023-06-12,502,iphone 15 pro max,100000,135000,35000,1,00491,India
215644,2023-06-12,506,monitor,3249,8000,4751,1,00262,India
215644,2023-06-12,502,iphone 15 pro max,100000,135000,35000,1,00262,India
215644,2023-06-12,504,iron,449,879,430,1,00262,India
225532,2023-06-12,504,iron,449,879,430,1,00319,India
333027,2023-06-12,507,washing machine,6990,16490,9500,1,00323,India
333027,2023-06-12,501,iphone 15,60000,80000,20000,1,00323,India
333027,2023-06-12,503,mixer,1349,3249,1900,1,00323,India
991566,2023-06-12,503,mixer,1349,3249,1900,1,00417,India
991566,2023-06-12,506,monitor,3249,8000,4751,1,00417,India
991566,2023-06-12,507,washing machine,6990,16490,9500,1,00417,India
804822,2023-06-12,506,monitor,3249,8000,4751,1,00246,India
804822,2023-06-12,502,iphone 15 pro max,100000,135000,35000,1,00246,India
804822,2023-06-12,503,mixer,1349,3249,1900,1,00246,India
724114,2023-06-12,506,monitor,3249,8000,4751,1,00074,India
724114,2023-06-12,505,oven,18490,24000,5510,1,00074,India
263440,2023-06-12,506,monitor,3249,8000,4751,1,00146,India
263440,2023-06-12,503,mixer,1349,3249,1900,1,00146,India
860741,2023-06-12,504,iron,449,879,430,1,00267,India
660902,2023-06-12,506,monitor,3249,8000,4751,1,00161,India
660902,2023-06-12,503,mixer,1349,3249,1900,1,00161,India
282618,2023-06-12,505,oven,18490,24000,5510,1,00433,India
231912,2023-06-12,505,oven,18490,24000,5510,1,00419,India
231912,2023-06-12,502,iphone 15 pro max,100000,135000,35000,1,00419,India
231912,2023-06-12,504,iron,449,879,430,1,00419,India
895084,2023-06-12,505,oven,18490,24000,5510,1,00057,India
895084,2023-06-12,506,monitor,3249,8000,4751,1,00057,India
895084,2023-06-12,504,iron,449,879,430,1,00057,India
895084,2023-06-12,501,iphone 15,60000,80000,20000,1,00057,India
146810,2023-06-12,504,iron,449,879,430,1,00426,India
456737,2023-06-12,503,mixer,1349,3249,1900,1,00239,India
456737,2023-06-12,502,iphone 15 pro max,100000,135000,35000,1,00239,India
456737,2023-06-12,506,monitor,3249,8000,4751,1,00239,India
456737,2023-06-12,504,iron,449,879,430,1,00239,India
256428,2023-06-12,501,iphone 15,60000,80000,20000,1,00065,India
256428,2023-06-12,505,oven,18490,24000,5510,1,00065,India
766782,2023-06-12,504,iron,449,879,430,1,00249,India
559290,2023-06-12,506,monitor,3249,8000,4751,1,00020,India
559290,2023-06-12,505,oven,18490,24000,5510,1,00020,India
326381,2023-06-12,506,monitor,3249,8000,4751,1,00257,India
326381,2023-06-12,505,oven,18490,24000,5510,1,00257,India
326381,2023-06-12,507,washing machine,6990,16490,9500,1,00257,India
389415,2023-06-12,505,oven,18490,24000,5510,1,00037,India
389415,2023-06-12,503,mixer,1349,3249,1900,1,00037,India
389415,2023-06-12,501,iphone 15,60000,80000,20000,1,00037,India
682739,2023-06-12,502,iphone 15 pro max,100000,135000,35000,1,00373,India
682739,2023-06-12,505,oven,18490,24000,5510,1,00373,India
682739,2023-06-12,503,mixer,1349,3249,1900,1,00373,India
682739,2023-06-12,506,monitor,3249,8000,4751,1,00373,India
632357,2023-06-12,503,mixer,1349,3249,1900,1,00247,India
632357,2023-06-12,502,iphone 15 pro max,100000,135000,35000,1,00247,India
632357,2023-06-12,506,monitor,3249,8000,4751,1,00247,India
632357,2023-06-12,501,iphone 15,60000,80000,20000,1,00247,India
408350,2023-06-12,504,iron,449,879,430,1,00350,India
408350,2023-06-12,502,iphone 15 pro max,100000,135000,35000,1,00350,India
408350,2023-06-12,503,mixer,1349,3249,1900,1,00350,India
408350,2023-06-12,507,washing machine,6990,16490,9500,1,00350,India
363711,2023-06-12,505,oven,18490,24000,5510,1,00467,India
363711,2023-06-12,503,mixer,1349,3249,1900,1,00467,India
745765,2023-06-12,507,washing machine,6990,16490,9500,1,00479,India
745765,2023-06-12,506,monitor,3249,8000,4751,1,00479,India
933212,2023-06-12,507,washing machine,6990,16490,9500,1,00162,India
933212,2023-06-12,505,oven,18490,24000,5510,1,00162,India
792776,2023-06-12,505,oven,18490,24000,5510,1,00120,India
792776,2023-06-12,502,iphone 15 pro max,100000,135000,35000,1,00120,India
792776,2023-06-12,504,iron,449,879,430,1,00120,India
955279,2023-06-12,503,mixer,1349,3249,1900,1,00158,India
955279,2023-06-12,504,iron,449,879,430,1,00158,India
955279,2023-06-12,506,monitor,3249,8000,4751,1,00158,India
955279,2023-06-12,505,oven,18490,24000,5510,1,00158,India
397181,2023-06-12,504,iron,449,879,430,1,00461,India
397181,2023-06-12,507,washing machine,6990,16490,9500,1,00461,India
687084,2023-06-12,503,mixer,1349,3249,1900,1,00249,India
687084,2023-06-12,501,iphone 15,60000,80000,20000,1,00249,India
687084,2023-06-12,506,monitor,3249,8000,4751,1,00249,India
687084,2023-06-12,505,oven,18490,24000,5510,1,00249,India
249076,2023-06-12,505,oven,18490,24000,5510,1,00239,India
284153,2023-06-12,504,iron,449,879,430,1,00392,India
284153,2023-06-12,505,oven,18490,24000,5510,1,00392,India
129466,2023-06-12,502,iphone 15 pro max,100000,135000,35000,1,00366,India
129466,2023-06-12,505,oven,18490,24000,5510,1,00366,India
348713,2023-06-12,507,washing machine,6990,16490,9500,1,00422,India
348713,2023-06-12,501,iphone 15,60000,80000,20000,1,00422,India
733481,2023-06-12,506,monitor,3249,8000,4751,1,00375,India
686584,2023-06-12,505,oven,18490,24000,5510,1,00256,India
686584,2023-06-12,501,iphone 15,60000,80000,20000,1,00256,India
686584,2023-06-12,503,mixer,1349,3249,1900,1,00256,India
603925,2023-06-12,505,oven,18490,24000,5510,1,00282,India
983908,2023-06-12,504,iron,449,879,430,1,00193,India
983908,2023-06-12,507,washing machine,6990,16490,9500,1,00193,India
983908,2023-06-12,505,oven,18490,24000,5510,1,00193,India
501080,2023-06-12,505,oven,18490,24000,5510,1,00251,India
501080,2023-06-12,504,iron,449,879,430,1,00251,India
501080,2023-06-12,506,monitor,3249,8000,4751,1,00251,India
165374,2023-06-12,507,washing machine,6990,16490,9500,1,00222,India
165374,2023-06-12,506,monitor,3249,8000,4751,1,00222,India
165374,2023-06-12,501,iphone 15,60000,80000,20000,1,00222,India
350659,2023-06-12,503,mixer,1349,3249,1900,1,00231,India
350659,2023-06-12,506,monitor,3249,8000,4751,1,00231,India
350659,2023-06-12,505,oven,18490,24000,5510,1,00231,India
497699,2023-06-12,504,iron,449,879,430,1,00473,India
497699,2023-06-12,506,monitor,3249,8000,4751,1,00473,India
793954,2023-06-12,502,iphone 15 pro max,100000,135000,35000,1,00432,India
220163,2023-06-12,502,iphone 15 pro max,100000,135000,35000,1,00246,India
342497,2023-06-12,503,mixer,1349,3249,1900,1,00419,India
342497,2023-06-12,507,washing machine,6990,16490,9500,1,00419,India
671139,2023-06-12,507,washing machine,6990,16490,9500,1,00277,India
949826,2023-06-12,503,mixer,1349,3249,1900,1,00238,India
949826,2023-06-12,505,oven,18490,24000,5510,1,00238,India
949826,2023-06-12,506,monitor,3249,8000,4751,1,00238,India
949826,2023-06-12,501,iphone 15,60000,80000,20000,1,00238,India
949826,2023-06-12,502,iphone 15 pro max,100000,135000,35000,1,00238,India
968386,2023-06-12,507,washing machine,6990,16490,9500,1,00136,India
286590,2023-06-12,504,iron,449,879,430,1,00135,India
286590,2023-06-12,507,washing machine,6990,16490,9500,1,00135,India
286590,2023-06-12,505,oven,18490,24000,5510,1,00135,India
914718,2023-06-12,507,washing machine,6990,16490,9500,1,00363,India
914718,2023-06-12,503,mixer,1349,3249,1900,1,00363,India
302367,2023-06-12,507,washing machine,6990,16490,9500,1,00151,India
302367,2023-06-12,506,monitor,3249,8000,4751,1,00151,India
302367,2023-06-12,504,iron,449,879,430,1,00151,India
578602,2023-06-12,502,iphone 15 pro max,100000,135000,35000,1,00168,India
100718,2023-06-12,507,washing machine,6990,16490,9500,1,00223,India
100718,2023-06-12,506,monitor,3249,8000,4751,1,00223,India
159773,2023-06-12,505,oven,18490,24000,5510,1,00281,India
159773,2023-06-12,506,monitor,3249,8000,4751,1,00281,India
580521,2023-06-12,507,washing machine,6990,16490,9500,1,00433,India
714460,2023-06-12,503,mixer,1349,3249,1900,1,00228,India
714460,2023-06-12,502,iphone 15 pro max,100000,135000,35000,1,00228,India
957983,2023-06-12,506,monitor,3249,8000,4751,1,00500,India
957983,2023-06-12,507,washing machine,6990,16490,9500,1,00500,India
957983,2023-06-12,504,iron,449,879,430,1,00500,India
928014,2023-06-12,505,oven,18490,24000,5510,1,00187,India
307524,2023-06-12,502,iphone 15 pro max,100000,135000,35000,1,00268,India
307524,2023-06-12,501,iphone 15,60000,80000,20000,1,00268,India
307524,2023-06-12,505,oven,18490,24000,5510,1,00268,India
547084,2023-06-12,504,iron,449,879,430,1,00276,India
547084,2023-06-12,505,oven,18490,24000,5510,1,00276,India
128809,2023-06-12,503,mixer,1349,3249,1900,1,00107,India
454963,2023-06-12,502,iphone 15 pro max,100000,135000,35000,1,00070,India
454963,2023-06-12,506,monitor,3249,8000,4751,1,00070,India
662733,2023-06-12,506,monitor,3249,8000,4751,1,00386,India
662733,2023-06-12,501,iphone 15,60000,80000,20000,1,00386,India
691711,2023-06-12,501,iphone 15,60000,80000,20000,1,00082,India
158059,2023-06-12,504,iron,449,879,430,1,00263,India
158059,2023-06-12,505,oven,18490,24000,5510,1,00263,India
158059,2023-06-12,501,iphone 15,60000,80000,20000,1,00263,India
545596,2023-06-12,503,mixer,1349,3249,1900,1,00092,India
545596,2023-06-12,505,oven,18490,24000,5510,1,00092,India
545596,2023-06-12,501,iphone 15,60000,80000,20000,1,00092,India
545596,2023-06-12,506,monitor,3249,8000,4751,1,00092,India
545596,2023-06-12,507,washing machine,6990,16490,9500,1,00092,India
766831,2023-06-12,506,monitor,3249,8000,4751,1,00375,India
766831,2023-06-12,503,mixer,1349,3249,1900,1,00375,India
766831,2023-06-12,504,iron,449,879,430,1,00375,India
766831,2023-06-12,502,iphone 15 pro max,100000,135000,35000,1,00375,India
522010,2023-06-13,502,iphone 15 pro max,100000,135000,35000,1,00500,India
522010,2023-06-13,503,mixer,1349,3249,1900,1,00500,India
204831,2023-06-13,502,iphone 15 pro max,100000,135000,35000,1,00298,India
204831,2023-06-13,506,monitor,3249,8000,4751,1,00298,India
204831,2023-06-13,504,iron,449,879,430,1,00298,India
204831,2023-06-13,507,washing machine,6990,16490,9500,1,00298,India
825132,2023-06-13,505,oven,18490,24000,5510,1,00375,India
371270,2023-06-13,504,iron,449,879,430,1,00054,India
371270,2023-06-13,506,monitor,3249,8000,4751,1,00054,India
426260,2023-06-13,505,oven,18490,24000,5510,1,00229,India
426260,2023-06-13,507,washing machine,6990,16490,9500,1,00229,India
426260,2023-06-13,503,mixer,1349,3249,1900,1,00229,India
902374,2023-06-13,502,iphone 15 pro max,100000,135000,35000,1,00100,India
902374,2023-06-13,506,monitor,3249,8000,4751,1,00100,India
902374,2023-06-13,504,iron,449,879,430,1,00100,India
228190,2023-06-13,504,iron,449,879,430,1,00080,India
228190,2023-06-13,506,monitor,3249,8000,4751,1,00080,India
228190,2023-06-13,501,iphone 15,60000,80000,20000,1,00080,India
228190,2023-06-13,502,iphone 15 pro max,100000,135000,35000,1,00080,India
305626,2023-06-13,501,iphone 15,60000,80000,20000,1,00217,India
305626,2023-06-13,504,iron,449,879,430,1,00217,India
261926,2023-06-13,504,iron,449,879,430,1,00430,India
894294,2023-06-13,504,iron,449,879,430,1,00430,India
894294,2023-06-13,507,washing machine,6990,16490,9500,1,00430,India
894294,2023-06-13,501,iphone 15,60000,80000,20000,1,00430,India
894294,2023-06-13,505,oven,18490,24000,5510,1,00430,India
734252,2023-06-13,502,iphone 15 pro max,100000,135000,35000,1,00462,India
734252,2023-06-13,505,oven,18490,24000,5510,1,00462,India
734252,2023-06-13,503,mixer,1349,3249,1900,1,00462,India
734252,2023-06-13,501,iphone 15,60000,80000,20000,1,00462,India
988750,2023-06-13,502,iphone 15 pro max,100000,135000,35000,1,00206,India
988750,2023-06-13,506,monitor,3249,8000,4751,1,00206,India
216394,2023-06-13,506,monitor,3249,8000,4751,1,00331,India
216394,2023-06-13,501,iphone 15,60000,80000,20000,1,00331,India
102866,2023-06-13,506,monitor,3249,8000,4751,1,00238,India
378564,2023-06-13,505,oven,18490,24000,5510,1,00463,India
378564,2023-06-13,502,iphone 15 pro max,100000,135000,35000,1,00463,India
378564,2023-06-13,506,monitor,3249,8000,4751,1,00463,India
378564,2023-06-13,501,iphone 15,60000,80000,20000,1,00463,India
633741,2023-06-13,505,oven,18490,24000,5510,1,00440,India
633741,2023-06-13,504,iron,449,879,430,1,00440,India
832217,2023-06-13,507,washing machine,6990,16490,9500,1,00005,India
832217,2023-06-13,503,mixer,1349,3249,1900,1,00005,India
832217,2023-06-13,506,monitor,3249,8000,4751,1,00005,India
622021,2023-06-13,503,mixer,1349,3249,1900,1,00162,India
622021,2023-06-13,505,oven,18490,24000,5510,1,00162,India
622021,2023-06-13,506,monitor,3249,8000,4751,1,00162,India
939626,2023-06-13,507,washing machine,6990,16490,9500,1,00442,India
939626,2023-06-13,506,monitor,3249,8000,4751,1,00442,India
939626,2023-06-13,503,mixer,1349,3249,1900,1,00442,India
595648,2023-06-13,507,washing machine,6990,16490,9500,1,00116,India
595648,2023-06-13,502,iphone 15 pro max,100000,135000,35000,1,00116,India
595648,2023-06-13,504,iron,449,879,430,1,00116,India
595648,2023-06-13,501,iphone 15,60000,80000,20000,1,00116,India
595648,2023-06-13,503,mixer,1349,3249,1900,1,00116,India
107303,2023-06-13,506,monitor,3249,8000,4751,1,00316,India
107303,2023-06-13,503,mixer,1349,3249,1900,1,00316,India
934119,2023-06-13,502,iphone 15 pro max,100000,135000,35000,1,00412,India
934119,2023-06-13,507,washing machine,6990,16490,9500,1,00412,India
934119,2023-06-13,503,mixer,1349,3249,1900,1,00412,India
934119,2023-06-13,505,oven,18490,24000,5510,1,00412,India
237064,2023-06-13,502,iphone 15 pro max,100000,135000,35000,1,00060,India
237064,2023-06-13,501,iphone 15,60000,80000,20000,1,00060,India
237064,2023-06-13,506,monitor,3249,8000,4751,1,00060,India
969542,2023-06-13,505,oven,18490,24000,5510,1,00122,India
969542,2023-06-13,507,washing machine,6990,16490,9500,1,00122,India
969542,2023-06-13,504,iron,449,879,430,1,00122,India
969542,2023-06-13,506,monitor,3249,8000,4751,1,00122,India
559739,2023-06-13,502,iphone 15 pro max,100000,135000,35000,1,00207,India
559739,2023-06-13,505,oven,18490,24000,5510,1,00207,India
581678,2023-06-13,501,iphone 15,60000,80000,20000,1,00147,India
379228,2023-06-13,501,iphone 15,60000,80000,20000,1,00054,India
379228,2023-06-13,504,iron,449,879,430,1,00054,India
483533,2023-06-13,502,iphone 15 pro max,100000,135000,35000,1,00491,India
483533,2023-06-13,505,oven,18490,24000,5510,1,00491,India
483533,2023-06-13,506,monitor,3249,8000,4751,1,00491,India
483533,2023-06-13,503,mixer,1349,3249,1900,1,00491,India
540196,2023-06-13,502,iphone 15 pro max,100000,135000,35000,1,00262,India
903705,2023-06-13,502,iphone 15 pro max,100000,135000,35000,1,00333,India
718389,2023-06-13,506,monitor,3249,8000,4751,1,00194,India
634992,2023-06-13,506,monitor,3249,8000,4751,1,00274,India
720586,2023-06-13,506,monitor,3249,8000,4751,1,00416,India
720586,2023-06-13,507,washing machine,6990,16490,9500,1,00416,India
720586,2023-06-13,504,iron,449,879,430,1,00416,India
610819,2023-06-13,507,washing machine,6990,16490,9500,1,00164,India
610819,2023-06-13,502,iphone 15 pro max,100000,135000,35000,1,00164,India
338623,2023-06-13,507,washing machine,6990,16490,9500,1,00433,India
338623,2023-06-13,506,monitor,3249,8000,4751,1,00433,India
338623,2023-06-13,505,oven,18490,24000,5510,1,00433,India
405132,2023-06-13,504,iron,449,879,430,1,00231,India
405132,2023-06-13,507,washing machine,6990,16490,9500,1,00231,India
405132,2023-06-13,501,iphone 15,60000,80000,20000,1,00231,India
417021,2023-06-13,506,monitor,3249,8000,4751,1,00126,India
417021,2023-06-13,505,oven,18490,24000,5510,1,00126,India
417021,2023-06-13,504,iron,449,879,430,1,00126,India
417021,2023-06-13,503,mixer,1349,3249,1900,1,00126,India
128481,2023-06-13,501,iphone 15,60000,80000,20000,1,00269,India
802337,2023-06-13,506,monitor,3249,8000,4751,1,00105,India
802337,2023-06-13,505,oven,18490,24000,5510,1,00105,India
629894,2023-06-13,502,iphone 15 pro max,100000,135000,35000,1,00337,India
629894,2023-06-13,501,iphone 15,60000,80000,20000,1,00337,India
110707,2023-06-13,502,iphone 15 pro max,100000,135000,35000,1,00207,India
110707,2023-06-13,506,monitor,3249,8000,4751,1,00207,India
110707,2023-06-13,505,oven,18490,24000,5510,1,00207,India
327271,2023-06-13,505,oven,18490,24000,5510,1,00445,India
327271,2023-06-13,502,iphone 15 pro max,100000,135000,35000,1,00445,India
327271,2023-06-13,503,mixer,1349,3249,1900,1,00445,India
327271,2023-06-13,504,iron,449,879,430,1,00445,India
338831,2023-06-13,504,iron,449,879,430,1,00473,India
338831,2023-06-13,505,oven,18490,24000,5510,1,00473,India
338831,2023-06-13,506,monitor,3249,8000,4751,1,00473,India
338831,2023-06-13,503,mixer,1349,3249,1900,1,00473,India
831669,2023-06-13,503,mixer,1349,3249,1900,1,00476,India
831669,2023-06-13,506,monitor,3249,8000,4751,1,00476,India
831669,2023-06-13,501,iphone 15,60000,80000,20000,1,00476,India
831669,2023-06-13,507,washing machine,6990,16490,9500,1,00476,India
608984,2023-06-13,501,iphone 15,60000,80000,20000,1,00128,India
608984,2023-06-13,507,washing machine,6990,16490,9500,1,00128,India
821567,2023-06-13,504,iron,449,879,430,1,00393,India
821567,2023-06-13,506,monitor,3249,8000,4751,1,00393,India
821567,2023-06-13,503,mixer,1349,3249,1900,1,00393,India
390080,2023-06-13,503,mixer,1349,3249,1900,1,00029,India
439792,2023-06-13,501,iphone 15,60000,80000,20000,1,00161,India
439792,2023-06-13,503,mixer,1349,3249,1900,1,00161,India
439792,2023-06-13,504,iron,449,879,430,1,00161,India
439792,2023-06-13,507,washing machine,6990,16490,9500,1,00161,India
327289,2023-06-13,503,mixer,1349,3249,1900,1,00372,India
327289,2023-06-13,502,iphone 15 pro max,100000,135000,35000,1,00372,India
327289,2023-06-13,501,iphone 15,60000,80000,20000,1,00372,India
327289,2023-06-13,507,washing machine,6990,16490,9500,1,00372,India
428784,2023-06-13,505,oven,18490,24000,5510,1,00123,India
283130,2023-06-13,503,mixer,1349,3249,1900,1,00314,India
283130,2023-06-13,506,monitor,3249,8000,4751,1,00314,India
635416,2023-06-13,507,washing machine,6990,16490,9500,1,00300,India
635416,2023-06-13,501,iphone 15,60000,80000,20000,1,00300,India
121649,2023-06-13,502,iphone 15 pro max,100000,135000,35000,1,00357,India
121649,2023-06-13,501,iphone 15,60000,80000,20000,1,00357,India
175410,2023-06-13,505,oven,18490,24000,5510,1,00281,India
175410,2023-06-13,504,iron,449,879,430,1,00281,India
758280,2023-06-13,503,mixer,1349,3249,1900,1,00156,India
758280,2023-06-13,501,iphone 15,60000,80000,20000,1,00156,India
758280,2023-06-13,506,monitor,3249,8000,4751,1,00156,India
611659,2023-06-13,501,iphone 15,60000,80000,20000,1,00151,India
611659,2023-06-13,506,monitor,3249,8000,4751,1,00151,India
611659,2023-06-13,504,iron,449,879,430,1,00151,India
611659,2023-06-13,505,oven,18490,24000,5510,1,00151,India
400566,2023-06-13,507,washing machine,6990,16490,9500,1,00395,India
400566,2023-06-13,502,iphone 15 pro max,100000,135000,35000,1,00395,India
400566,2023-06-13,504,iron,449,879,430,1,00395,India
218235,2023-06-13,505,oven,18490,24000,5510,1,00341,India
269852,2023-06-13,501,iphone 15,60000,80000,20000,1,00461,India
720950,2023-06-13,504,iron,449,879,430,1,00053,India
720950,2023-06-13,507,washing machine,6990,16490,9500,1,00053,India
584481,2023-06-13,507,washing machine,6990,16490,9500,1,00053,India
584481,2023-06-13,504,iron,449,879,430,1,00053,India
584481,2023-06-13,501,iphone 15,60000,80000,20000,1,00053,India
616100,2023-06-13,504,iron,449,879,430,1,00131,India
616100,2023-06-13,501,iphone 15,60000,80000,20000,1,00131,India
401680,2023-06-13,501,iphone 15,60000,80000,20000,1,00104,India
401680,2023-06-13,506,monitor,3249,8000,4751,1,00104,India
401680,2023-06-13,503,mixer,1349,3249,1900,1,00104,India
382983,2023-06-13,506,monitor,3249,8000,4751,1,00203,India
382983,2023-06-13,504,iron,449,879,430,1,00203,India
158969,2023-06-13,502,iphone 15 pro max,100000,135000,35000,1,00432,India
238961,2023-06-13,502,iphone 15 pro max,100000,135000,35000,1,00458,India
987063,2023-06-13,505,oven,18490,24000,5510,1,00483,India
987063,2023-06-13,504,iron,449,879,430,1,00483,India
987063,2023-06-13,503,mixer,1349,3249,1900,1,00483,India
186745,2023-06-13,503,mixer,1349,3249,1900,1,00487,India
186745,2023-06-13,507,washing machine,6990,16490,9500,1,00487,India
186745,2023-06-13,502,iphone 15 pro max,100000,135000,35000,1,00487,India
609073,2023-06-13,501,iphone 15,60000,80000,20000,1,00158,India
909378,2023-06-13,502,iphone 15 pro max,100000,135000,35000,1,00273,India
909378,2023-06-13,503,mixer,1349,3249,1900,1,00273,India
909378,2023-06-13,505,oven,18490,24000,5510,1,00273,India
716285,2023-06-13,507,washing machine,6990,16490,9500,1,00029,India
716285,2023-06-13,502,iphone 15 pro max,100000,135000,35000,1,00029,India
103925,2023-06-13,507,washing machine,6990,16490,9500,1,00240,India
103925,2023-06-13,501,iphone 15,60000,80000,20000,1,00240,India
258409,2023-06-13,506,monitor,3249,8000,4751,1,00102,India
856430,2023-06-13,501,iphone 15,60000,80000,20000,1,00424,India
415093,2023-06-13,501,iphone 15,60000,80000,20000,1,00424,India
291805,2023-06-13,506,monitor,3249,8000,4751,1,00192,India
144329,2023-06-13,507,washing machine,6990,16490,9500,1,00171,India
144329,2023-06-13,502,iphone 15 pro max,100000,135000,35000,1,00171,India
144329,2023-06-13,505,oven,18490,24000,5510,1,00171,India
144329,2023-06-13,504,iron,449,879,430,1,00171,India
685097,2023-06-13,507,washing machine,6990,16490,9500,1,00093,India
685097,2023-06-13,506,monitor,3249,8000,4751,1,00093,India
685097,2023-06-13,502,iphone 15 pro max,100000,135000,35000,1,00093,India
683749,2023-06-13,504,iron,449,879,430,1,00134,India
683749,2023-06-13,502,iphone 15 pro max,100000,135000,35000,1,00134,India
683749,2023-06-13,506,monitor,3249,8000,4751,1,00134,India
683749,2023-06-13,507,washing machine,6990,16490,9500,1,00134,India
241373,2023-06-13,502,iphone 15 pro max,100000,135000,35000,1,00435,India
241373,2023-06-13,506,monitor,3249,8000,4751,1,00435,India
551316,2023-06-13,507,washing machine,6990,16490,9500,1,00296,India
551316,2023-06-13,504,iron,449,879,430,1,00296,India
551316,2023-06-13,505,oven,18490,24000,5510,1,00296,India
914734,2023-06-13,507,washing machine,6990,16490,9500,1,00426,India
522431,2023-06-13,507,washing machine,6990,16490,9500,1,00038,India
522431,2023-06-13,504,iron,449,879,430,1,00038,India
522431,2023-06-13,506,monitor,3249,8000,4751,1,00038,India
522431,2023-06-13,502,iphone 15 pro max,100000,135000,35000,1,00038,India
831905,2023-06-13,503,mixer,1349,3249,1900,1,00096,India
831905,2023-06-13,501,iphone 15,60000,80000,20000,1,00096,India
847617,2023-06-13,501,iphone 15,60000,80000,20000,1,00197,India
589365,2023-06-13,505,oven,18490,24000,5510,1,00232,India
589365,2023-06-13,507,washing machine,6990,16490,9500,1,00232,India
729149,2023-06-13,501,iphone 15,60000,80000,20000,1,00127,India
729149,2023-06-13,507,washing machine,6990,16490,9500,1,00127,India
507143,2023-06-13,502,iphone 15 pro max,100000,135000,35000,1,00061,India
264442,2023-06-13,501,iphone 15,60000,80000,20000,1,00323,India
264442,2023-06-13,507,washing machine,6990,16490,9500,1,00323,India
264442,2023-06-13,504,iron,449,879,430,1,00323,India
897906,2023-06-13,507,washing machine,6990,16490,9500,1,00329,India
897906,2023-06-13,502,iphone 15 pro max,100000,135000,35000,1,00329,India
897906,2023-06-13,504,iron,449,879,430,1,00329,India
897906,2023-06-13,505,oven,18490,24000,5510,1,00329,India
897906,2023-06-13,501,iphone 15,60000,80000,20000,1,00329,India
710089,2023-06-13,504,iron,449,879,430,1,00224,India
313658,2023-06-13,506,monitor,3249,8000,4751,1,00385,India
313658,2023-06-13,502,iphone 15 pro max,100000,135000,35000,1,00385,India
995868,2023-06-13,501,iphone 15,60000,80000,20000,1,00365,India
995868,2023-06-13,507,washing machine,6990,16490,9500,1,00365,India
971799,2023-06-13,505,oven,18490,24000,5510,1,00111,India
971799,2023-06-13,504,iron,449,879,430,1,00111,India
971799,2023-06-13,502,iphone 15 pro max,100000,135000,35000,1,00111,India
795976,2023-06-14,505,oven,18490,24000,5510,1,00397,India
493305,2023-06-14,506,monitor,3249,8000,4751,1,00034,India
493305,2023-06-14,501,iphone 15,60000,80000,20000,1,00034,India
176453,2023-06-14,504,iron,449,879,430,1,00309,India
176453,2023-06-14,502,iphone 15 pro max,100000,135000,35000,1,00309,India
176453,2023-06-14,501,iphone 15,60000,80000,20000,1,00309,India
176453,2023-06-14,507,washing machine,6990,16490,9500,1,00309,India
432876,2023-06-14,501,iphone 15,60000,80000,20000,1,00297,India
432876,2023-06-14,507,washing machine,6990,16490,9500,1,00297,India
352068,2023-06-14,506,monitor,3249,8000,4751,1,00435,India
352068,2023-06-14,507,washing machine,6990,16490,9500,1,00435,India
338910,2023-06-14,506,monitor,3249,8000,4751,1,00094,India
338910,2023-06-14,504,iron,449,879,430,1,00094,India
679434,2023-06-14,505,oven,18490,24000,5510,1,00003,India
679434,2023-06-14,507,washing machine,6990,16490,9500,1,00003,India
679434,2023-06-14,503,mixer,1349,3249,1900,1,00003,India
567684,2023-06-14,505,oven,18490,24000,5510,1,00209,India
246866,2023-06-14,506,monitor,3249,8000,4751,1,00425,India
246866,2023-06-14,502,iphone 15 pro max,100000,135000,35000,1,00425,India
246866,2023-06-14,504,iron,449,879,430,1,00425,India
815017,2023-06-14,501,iphone 15,60000,80000,20000,1,00432,India
815017,2023-06-14,502,iphone 15 pro max,100000,135000,35000,1,00432,India
815017,2023-06-14,507,washing machine,6990,16490,9500,1,00432,India
181275,2023-06-14,507,washing machine,6990,16490,9500,1,00222,India
181275,2023-06-14,503,mixer,1349,3249,1900,1,00222,India
423459,2023-06-14,503,mixer,1349,3249,1900,1,00119,India
423459,2023-06-14,507,washing machine,6990,16490,9500,1,00119,India
423459,2023-06-14,501,iphone 15,60000,80000,20000,1,00119,India
285946,2023-06-14,506,monitor,3249,8000,4751,1,00046,India
285946,2023-06-14,505,oven,18490,24000,5510,1,00046,India
285946,2023-06-14,501,iphone 15,60000,80000,20000,1,00046,India
235648,2023-06-14,507,washing machine,6990,16490,9500,1,00463,India
235648,2023-06-14,502,iphone 15 pro max,100000,135000,35000,1,00463,India
235648,2023-06-14,506,monitor,3249,8000,4751,1,00463,India
150960,2023-06-14,506,monitor,3249,8000,4751,1,00119,India
150960,2023-06-14,504,iron,449,879,430,1,00119,India
150960,2023-06-14,503,mixer,1349,3249,1900,1,00119,India
408789,2023-06-14,505,oven,18490,24000,5510,1,00326,India
843488,2023-06-14,503,mixer,1349,3249,1900,1,00008,India
843488,2023-06-14,504,iron,449,879,430,1,00008,India
843488,2023-06-14,501,iphone 15,60000,80000,20000,1,00008,India
448027,2023-06-14,506,monitor,3249,8000,4751,1,00244,India
448027,2023-06-14,504,iron,449,879,430,1,00244,India
185944,2023-06-14,506,monitor,3249,8000,4751,1,00027,India
185944,2023-06-14,503,mixer,1349,3249,1900,1,00027,India
181923,2023-06-14,504,iron,449,879,430,1,00404,India
181923,2023-06-14,502,iphone 15 pro max,100000,135000,35000,1,00404,India
181923,2023-06-14,505,oven,18490,24000,5510,1,00404,India
181923,2023-06-14,503,mixer,1349,3249,1900,1,00404,India
757570,2023-06-14,506,monitor,3249,8000,4751,1,00298,India
757570,2023-06-14,507,washing machine,6990,16490,9500,1,00298,India
757570,2023-06-14,504,iron,449,879,430,1,00298,India
757570,2023-06-14,505,oven,18490,24000,5510,1,00298,India
221483,2023-06-14,503,mixer,1349,3249,1900,1,00411,India
932981,2023-06-14,507,washing machine,6990,16490,9500,1,00006,India
932981,2023-06-14,502,iphone 15 pro max,100000,135000,35000,1,00006,India
990768,2023-06-14,505,oven,18490,24000,5510,1,00390,India
990768,2023-06-14,504,iron,449,879,430,1,00390,India
990768,2023-06-14,506,monitor,3249,8000,4751,1,00390,India
990768,2023-06-14,507,washing machine,6990,16490,9500,1,00390,India
171939,2023-06-14,504,iron,449,879,430,1,00132,India
171939,2023-06-14,507,washing machine,6990,16490,9500,1,00132,India
171939,2023-06-14,501,iphone 15,60000,80000,20000,1,00132,India
886631,2023-06-14,502,iphone 15 pro max,100000,135000,35000,1,00217,India
657001,2023-06-14,507,washing machine,6990,16490,9500,1,00500,India
657001,2023-06-14,503,mixer,1349,3249,1900,1,00500,India
459914,2023-06-14,507,washing machine,6990,16490,9500,1,00005,India
459914,2023-06-14,504,iron,449,879,430,1,00005,India
459914,2023-06-14,501,iphone 15,60000,80000,20000,1,00005,India
616591,2023-06-14,503,mixer,1349,3249,1900,1,00204,India
547712,2023-06-14,502,iphone 15 pro max,100000,135000,35000,1,00318,India
547712,2023-06-14,503,mixer,1349,3249,1900,1,00318,India
547712,2023-06-14,504,iron,449,879,430,1,00318,India
476467,2023-06-14,506,monitor,3249,8000,4751,1,00084,India
476467,2023-06-14,501,iphone 15,60000,80000,20000,1,00084,India
601657,2023-06-14,504,iron,449,879,430,1,00128,India
601657,2023-06-14,505,oven,18490,24000,5510,1,00128,India
116732,2023-06-14,503,mixer,1349,3249,1900,1,00196,India
116732,2023-06-14,505,oven,18490,24000,5510,1,00196,India
116732,2023-06-14,501,iphone 15,60000,80000,20000,1,00196,India
342123,2023-06-14,503,mixer,1349,3249,1900,1,00300,India
342123,2023-06-14,501,iphone 15,60000,80000,20000,1,00300,India
130363,2023-06-14,507,washing machine,6990,16490,9500,1,00370,India
130363,2023-06-14,506,monitor,3249,8000,4751,1,00370,India
130363,2023-06-14,505,oven,18490,24000,5510,1,00370,India
725939,2023-06-14,505,oven,18490,24000,5510,1,00080,India
725939,2023-06-14,506,monitor,3249,8000,4751,1,00080,India
725939,2023-06-14,507,washing machine,6990,16490,9500,1,00080,India
725939,2023-06-14,504,iron,449,879,430,1,00080,India
991440,2023-06-14,507,washing machine,6990,16490,9500,1,00064,India
188769,2023-06-14,507,washing machine,6990,16490,9500,1,00057,India
316208,2023-06-14,507,washing machine,6990,16490,9500,1,00251,India
316208,2023-06-14,506,monitor,3249,8000,4751,1,00251,India
800729,2023-06-14,501,iphone 15,60000,80000,20000,1,00494,India
800729,2023-06-14,504,iron,449,879,430,1,00494,India
800729,2023-06-14,506,monitor,3249,8000,4751,1,00494,India
780318,2023-06-14,503,mixer,1349,3249,1900,1,00269,India
780318,2023-06-14,507,washing machine,6990,16490,9500,1,00269,India
134548,2023-06-14,505,oven,18490,24000,5510,1,00053,India
977162,2023-06-14,504,iron,449,879,430,1,00154,India
977162,2023-06-14,502,iphone 15 pro max,100000,135000,35000,1,00154,India
977162,2023-06-14,503,mixer,1349,3249,1900,1,00154,India
942777,2023-06-14,507,washing machine,6990,16490,9500,1,00445,India
942777,2023-06-14,506,monitor,3249,8000,4751,1,00445,India
942777,2023-06-14,503,mixer,1349,3249,1900,1,00445,India
229308,2023-06-14,504,iron,449,879,430,1,00484,India
229308,2023-06-14,505,oven,18490,24000,5510,1,00484,India
229308,2023-06-14,507,washing machine,6990,16490,9500,1,00484,India
229308,2023-06-14,501,iphone 15,60000,80000,20000,1,00484,India
274185,2023-06-14,507,washing machine,6990,16490,9500,1,00134,India
274185,2023-06-14,504,iron,449,879,430,1,00134,India
274185,2023-06-14,505,oven,18490,24000,5510,1,00134,India
274185,2023-06-14,503,mixer,1349,3249,1900,1,00134,India
560928,2023-06-14,502,iphone 15 pro max,100000,135000,35000,1,00237,India
662788,2023-06-14,504,iron,449,879,430,1,00327,India
662788,2023-06-14,502,iphone 15 pro max,100000,135000,35000,1,00327,India
662788,2023-06-14,503,mixer,1349,3249,1900,1,00327,India
788067,2023-06-14,507,washing machine,6990,16490,9500,1,00321,India
459500,2023-06-14,506,monitor,3249,8000,4751,1,00232,India
550338,2023-06-14,502,iphone 15 pro max,100000,135000,35000,1,00012,India
550338,2023-06-14,501,iphone 15,60000,80000,20000,1,00012,India
550338,2023-06-14,507,washing machine,6990,16490,9500,1,00012,India
521093,2023-06-15,502,iphone 15 pro max,100000,135000,35000,1,00309,India
521093,2023-06-15,505,oven,18490,24000,5510,1,00309,India
521093,2023-06-15,507,washing machine,6990,16490,9500,1,00309,India
521093,2023-06-15,506,monitor,3249,8000,4751,1,00309,India
702227,2023-06-15,505,oven,18490,24000,5510,1,00215,India
557059,2023-06-15,506,monitor,3249,8000,4751,1,00353,India
897276,2023-06-15,501,iphone 15,60000,80000,20000,1,00295,India
897276,2023-06-15,506,monitor,3249,8000,4751,1,00295,India
897276,2023-06-15,504,iron,449,879,430,1,00295,India
748042,2023-06-15,506,monitor,3249,8000,4751,1,00326,India
748042,2023-06-15,503,mixer,1349,3249,1900,1,00326,India
748042,2023-06-15,501,iphone 15,60000,80000,20000,1,00326,India
748042,2023-06-15,507,washing machine,6990,16490,9500,1,00326,India
294549,2023-06-15,507,washing machine,6990,16490,9500,1,00164,India
294549,2023-06-15,502,iphone 15 pro max,100000,135000,35000,1,00164,India
294549,2023-06-15,501,iphone 15,60000,80000,20000,1,00164,India
590207,2023-06-15,506,monitor,3249,8000,4751,1,00474,India
590207,2023-06-15,501,iphone 15,60000,80000,20000,1,00474,India
242220,2023-06-15,505,oven,18490,24000,5510,1,00465,India
242220,2023-06-15,502,iphone 15 pro max,100000,135000,35000,1,00465,India
242220,2023-06-15,503,mixer,1349,3249,1900,1,00465,India
255222,2023-06-15,504,iron,449,879,430,1,00015,India
255222,2023-06-15,501,iphone 15,60000,80000,20000,1,00015,India
255222,2023-06-15,505,oven,18490,24000,5510,1,00015,India
304361,2023-06-15,506,monitor,3249,8000,4751,1,00423,India
304361,2023-06-15,507,washing machine,6990,16490,9500,1,00423,India
180218,2023-06-15,501,iphone 15,60000,80000,20000,1,00203,India
180218,2023-06-15,504,iron,449,879,430,1,00203,India
772042,2023-06-15,505,oven,18490,24000,5510,1,00118,India
982114,2023-06-15,501,iphone 15,60000,80000,20000,1,00120,India
982114,2023-06-15,502,iphone 15 pro max,100000,135000,35000,1,00120,India
982114,2023-06-15,506,monitor,3249,8000,4751,1,00120,India
154633,2023-06-15,501,iphone 15,60000,80000,20000,1,00220,India
701207,2023-06-15,507,washing machine,6990,16490,9500,1,00050,India
861047,2023-06-15,504,iron,449,879,430,1,00397,India
315236,2023-06-15,501,iphone 15,60000,80000,20000,1,00429,India
315236,2023-06-15,502,iphone 15 pro max,100000,135000,35000,1,00429,India
315236,2023-06-15,504,iron,449,879,430,1,00429,India
847390,2023-06-15,507,washing machine,6990,16490,9500,1,00361,India
847390,2023-06-15,505,oven,18490,24000,5510,1,00361,India
847390,2023-06-15,506,monitor,3249,8000,4751,1,00361,India
830287,2023-06-15,503,mixer,1349,3249,1900,1,00271,India
830287,2023-06-15,501,iphone 15,60000,80000,20000,1,00271,India
586196,2023-06-15,505,oven,18490,24000,5510,1,00116,India
175311,2023-06-15,504,iron,449,879,430,1,00164,India
175311,2023-06-15,503,mixer,1349,3249,1900,1,00164,India
175311,2023-06-15,507,washing machine,6990,16490,9500,1,00164,India
175311,2023-06-15,502,iphone 15 pro max,100000,135000,35000,1,00164,India
186881,2023-06-15,505,oven,18490,24000,5510,1,00022,India
186881,2023-06-15,501,iphone 15,60000,80000,20000,1,00022,India
827040,2023-06-15,505,oven,18490,24000,5510,1,00439,India
827040,2023-06-15,503,mixer,1349,3249,1900,1,00439,India
194806,2023-06-15,504,iron,449,879,430,1,00362,India
194806,2023-06-15,506,monitor,3249,8000,4751,1,00362,India
194806,2023-06-15,501,iphone 15,60000,80000,20000,1,00362,India
566434,2023-06-15,507,washing machine,6990,16490,9500,1,00342,India
566434,2023-06-15,502,iphone 15 pro max,100000,135000,35000,1,00342,India
566434,2023-06-15,505,oven,18490,24000,5510,1,00342,India
566434,2023-06-15,501,iphone 15,60000,80000,20000,1,00342,India
980101,2023-06-15,502,iphone 15 pro max,100000,135000,35000,1,00335,India
491242,2023-06-15,504,iron,449,879,430,1,00362,India
518691,2023-06-15,502,iphone 15 pro max,100000,135000,35000,1,00199,India
415735,2023-06-15,507,washing machine,6990,16490,9500,1,00078,India
415735,2023-06-15,505,oven,18490,24000,5510,1,00078,India
308439,2023-06-15,501,iphone 15,60000,80000,20000,1,00188,India
308439,2023-06-15,502,iphone 15 pro max,100000,135000,35000,1,00188,India
543737,2023-06-15,501,iphone 15,60000,80000,20000,1,00285,India
543737,2023-06-15,506,monitor,3249,8000,4751,1,00285,India
543737,2023-06-15,504,iron,449,879,430,1,00285,India
961476,2023-06-15,501,iphone 15,60000,80000,20000,1,00147,India
961476,2023-06-15,507,washing machine,6990,16490,9500,1,00147,India
961476,2023-06-15,504,iron,449,879,430,1,00147,India
249703,2023-06-15,505,oven,18490,24000,5510,1,00017,India
771233,2023-06-15,505,oven,18490,24000,5510,1,00023,India
584323,2023-06-15,506,monitor,3249,8000,4751,1,00254,India
584323,2023-06-15,505,oven,18490,24000,5510,1,00254,India
584323,2023-06-15,507,washing machine,6990,16490,9500,1,00254,India
584323,2023-06-15,502,iphone 15 pro max,100000,135000,35000,1,00254,India
237604,2023-06-15,503,mixer,1349,3249,1900,1,00164,India
237604,2023-06-15,507,washing machine,6990,16490,9500,1,00164,India
237604,2023-06-15,505,oven,18490,24000,5510,1,00164,India
838616,2023-06-15,503,mixer,1349,3249,1900,1,00484,India
838616,2023-06-15,501,iphone 15,60000,80000,20000,1,00484,India
838616,2023-06-15,506,monitor,3249,8000,4751,1,00484,India
838616,2023-06-15,504,iron,449,879,430,1,00484,India
336985,2023-06-15,502,iphone 15 pro max,100000,135000,35000,1,00200,India
336985,2023-06-15,504,iron,449,879,430,1,00200,India
504427,2023-06-15,502,iphone 15 pro max,100000,135000,35000,1,00314,India
204250,2023-06-15,507,washing machine,6990,16490,9500,1,00170,India
204250,2023-06-15,506,monitor,3249,8000,4751,1,00170,India
204250,2023-06-15,502,iphone 15 pro max,100000,135000,35000,1,00170,India
614731,2023-06-15,503,mixer,1349,3249,1900,1,00434,India
614731,2023-06-15,506,monitor,3249,8000,4751,1,00434,India
614731,2023-06-15,507,washing machine,6990,16490,9500,1,00434,India
614731,2023-06-15,502,iphone 15 pro max,100000,135000,35000,1,00434,India
292123,2023-06-15,502,iphone 15 pro max,100000,135000,35000,1,00178,India
292123,2023-06-15,506,monitor,3249,8000,4751,1,00178,India
292123,2023-06-15,504,iron,449,879,430,1,00178,India
866014,2023-06-15,504,iron,449,879,430,1,00192,India
866014,2023-06-15,507,washing machine,6990,16490,9500,1,00192,India
474824,2023-06-15,503,mixer,1349,3249,1900,1,00218,India
539213,2023-06-15,502,iphone 15 pro max,100000,135000,35000,1,00339,India
539213,2023-06-15,503,mixer,1349,3249,1900,1,00339,India
374284,2023-06-15,502,iphone 15 pro max,100000,135000,35000,1,00040,India
758862,2023-06-15,504,iron,449,879,430,1,00128,India
305781,2023-06-15,507,washing machine,6990,16490,9500,1,00312,India
810748,2023-06-15,507,washing machine,6990,16490,9500,1,00377,India
810748,2023-06-15,504,iron,449,879,430,1,00377,India
250253,2023-06-15,502,iphone 15 pro max,100000,135000,35000,1,00365,India
250253,2023-06-15,503,mixer,1349,3249,1900,1,00365,India
250253,2023-06-15,501,iphone 15,60000,80000,20000,1,00365,India
250253,2023-06-15,507,washing machine,6990,16490,9500,1,00365,India
706746,2023-06-15,504,iron,449,879,430,1,00355,India
417850,2023-06-15,504,iron,449,879,430,1,00020,India
672556,2023-06-15,502,iphone 15 pro max,100000,135000,35000,1,00226,India
672556,2023-06-15,506,monitor,3249,8000,4751,1,00226,India
672556,2023-06-15,503,mixer,1349,3249,1900,1,00226,India
909694,2023-06-15,505,oven,18490,24000,5510,1,00499,India
909694,2023-06-15,501,iphone 15,60000,80000,20000,1,00499,India
975857,2023-06-15,507,washing machine,6990,16490,9500,1,00038,India
975857,2023-06-15,505,oven,18490,24000,5510,1,00038,India
930909,2023-06-15,505,oven,18490,24000,5510,1,00373,India
930909,2023-06-15,503,mixer,1349,3249,1900,1,00373,India
410431,2023-06-15,501,iphone 15,60000,80000,20000,1,00405,India
410431,2023-06-15,507,washing machine,6990,16490,9500,1,00405,India
164168,2023-06-15,502,iphone 15 pro max,100000,135000,35000,1,00051,India
164168,2023-06-15,507,washing machine,6990,16490,9500,1,00051,India
402052,2023-06-15,502,iphone 15 pro max,100000,135000,35000,1,00262,India
385129,2023-06-15,503,mixer,1349,3249,1900,1,00143,India
385129,2023-06-15,507,washing machine,6990,16490,9500,1,00143,India
385129,2023-06-15,506,monitor,3249,8000,4751,1,00143,India
839284,2023-06-15,507,washing machine,6990,16490,9500,1,00492,India
839284,2023-06-15,501,iphone 15,60000,80000,20000,1,00492,India
839284,2023-06-15,502,iphone 15 pro max,100000,135000,35000,1,00492,India
839284,2023-06-15,505,oven,18490,24000,5510,1,00492,India
878214,2023-06-15,504,iron,449,879,430,1,00312,India
878214,2023-06-15,503,mixer,1349,3249,1900,1,00312,India
878214,2023-06-15,506,monitor,3249,8000,4751,1,00312,India
878214,2023-06-15,501,iphone 15,60000,80000,20000,1,00312,India
568322,2023-06-15,504,iron,449,879,430,1,00221,India
568322,2023-06-15,503,mixer,1349,3249,1900,1,00221,India
568322,2023-06-15,506,monitor,3249,8000,4751,1,00221,India
568322,2023-06-15,501,iphone 15,60000,80000,20000,1,00221,India
568322,2023-06-15,507,washing machine,6990,16490,9500,1,00221,India
289299,2023-06-15,502,iphone 15 pro max,100000,135000,35000,1,00432,India
917014,2023-06-15,504,iron,449,879,430,1,00218,India
917014,2023-06-15,501,iphone 15,60000,80000,20000,1,00218,India
221479,2023-06-15,504,iron,449,879,430,1,00231,India
571908,2023-06-15,501,iphone 15,60000,80000,20000,1,00330,India
276029,2023-06-15,502,iphone 15 pro max,100000,135000,35000,1,00074,India
276029,2023-06-15,505,oven,18490,24000,5510,1,00074,India
447086,2023-06-15,503,mixer,1349,3249,1900,1,00059,India
447086,2023-06-15,505,oven,18490,24000,5510,1,00059,India
447086,2023-06-15,504,iron,449,879,430,1,00059,India
447086,2023-06-15,502,iphone 15 pro max,100000,135000,35000,1,00059,India
413349,2023-06-16,502,iphone 15 pro max,100000,135000,35000,1,00379,India
413349,2023-06-16,505,oven,18490,24000,5510,1,00379,India
413349,2023-06-16,503,mixer,1349,3249,1900,1,00379,India
491952,2023-06-16,502,iphone 15 pro max,100000,135000,35000,1,00004,India
491952,2023-06-16,501,iphone 15,60000,80000,20000,1,00004,India
803958,2023-06-16,502,iphone 15 pro max,100000,135000,35000,1,00469,India
803958,2023-06-16,507,washing machine,6990,16490,9500,1,00469,India
386651,2023-06-16,506,monitor,3249,8000,4751,1,00273,India
386651,2023-06-16,502,iphone 15 pro max,100000,135000,35000,1,00273,India
386651,2023-06-16,501,iphone 15,60000,80000,20000,1,00273,India
390229,2023-06-16,505,oven,18490,24000,5510,1,00325,India
390229,2023-06-16,503,mixer,1349,3249,1900,1,00325,India
390229,2023-06-16,501,iphone 15,60000,80000,20000,1,00325,India
390229,2023-06-16,502,iphone 15 pro max,100000,135000,35000,1,00325,India
253114,2023-06-16,505,oven,18490,24000,5510,1,00109,India
253114,2023-06-16,501,iphone 15,60000,80000,20000,1,00109,India
253114,2023-06-16,502,iphone 15 pro max,100000,135000,35000,1,00109,India
607701,2023-06-16,504,iron,449,879,430,1,00072,India
273027,2023-06-16,505,oven,18490,24000,5510,1,00477,India
710316,2023-06-16,501,iphone 15,60000,80000,20000,1,00207,India
710316,2023-06-16,505,oven,18490,24000,5510,1,00207,India
710316,2023-06-16,507,washing machine,6990,16490,9500,1,00207,India
589110,2023-06-16,503,mixer,1349,3249,1900,1,00483,India
847605,2023-06-16,504,iron,449,879,430,1,00480,India
847605,2023-06-16,501,iphone 15,60000,80000,20000,1,00480,India
847605,2023-06-16,502,iphone 15 pro max,100000,135000,35000,1,00480,India
847605,2023-06-16,507,washing machine,6990,16490,9500,1,00480,India
129946,2023-06-16,505,oven,18490,24000,5510,1,00387,India
139626,2023-06-16,505,oven,18490,24000,5510,1,00409,India
170980,2023-06-16,503,mixer,1349,3249,1900,1,00453,India
170980,2023-06-16,506,monitor,3249,8000,4751,1,00453,India
170980,2023-06-16,505,oven,18490,24000,5510,1,00453,India
170980,2023-06-16,502,iphone 15 pro max,100000,135000,35000,1,00453,India
463512,2023-06-16,502,iphone 15 pro max,100000,135000,35000,1,00423,India
463512,2023-06-16,507,washing machine,6990,16490,9500,1,00423,India
463512,2023-06-16,504,iron,449,879,430,1,00423,India
465217,2023-06-16,502,iphone 15 pro max,100000,135000,35000,1,00297,India
875175,2023-06-16,504,iron,449,879,430,1,00255,India
875175,2023-06-16,502,iphone 15 pro max,100000,135000,35000,1,00255,India
895646,2023-06-16,505,oven,18490,24000,5510,1,00149,India
895646,2023-06-16,502,iphone 15 pro max,100000,135000,35000,1,00149,India
895646,2023-06-16,507,washing machine,6990,16490,9500,1,00149,India
268249,2023-06-16,503,mixer,1349,3249,1900,1,00178,India
268249,2023-06-16,505,oven,18490,24000,5510,1,00178,India
909320,2023-06-16,504,iron,449,879,430,1,00410,India
909320,2023-06-16,503,mixer,1349,3249,1900,1,00410,India
909320,2023-06-16,507,washing machine,6990,16490,9500,1,00410,India
187853,2023-06-16,504,iron,449,879,430,1,00321,India
187853,2023-06-16,505,oven,18490,24000,5510,1,00321,India
187853,2023-06-16,507,washing machine,6990,16490,9500,1,00321,India
187853,2023-06-16,502,iphone 15 pro max,100000,135000,35000,1,00321,India
832425,2023-06-16,505,oven,18490,24000,5510,1,00285,India
832425,2023-06-16,502,iphone 15 pro max,100000,135000,35000,1,00285,India
832425,2023-06-16,506,monitor,3249,8000,4751,1,00285,India
489554,2023-06-16,501,iphone 15,60000,80000,20000,1,00103,India
489554,2023-06-16,502,iphone 15 pro max,100000,135000,35000,1,00103,India
489554,2023-06-16,507,washing machine,6990,16490,9500,1,00103,India
489554,2023-06-16,504,iron,449,879,430,1,00103,India
432920,2023-06-16,502,iphone 15 pro max,100000,135000,35000,1,00443,India
432920,2023-06-16,505,oven,18490,24000,5510,1,00443,India
212009,2023-06-16,506,monitor,3249,8000,4751,1,00407,India
212009,2023-06-16,503,mixer,1349,3249,1900,1,00407,India
212009,2023-06-16,505,oven,18490,24000,5510,1,00407,India
212009,2023-06-16,502,iphone 15 pro max,100000,135000,35000,1,00407,India
174143,2023-06-16,504,iron,449,879,430,1,00326,India
361832,2023-06-16,505,oven,18490,24000,5510,1,00216,India
332526,2023-06-16,507,washing machine,6990,16490,9500,1,00248,India
332526,2023-06-16,505,oven,18490,24000,5510,1,00248,India
332526,2023-06-16,503,mixer,1349,3249,1900,1,00248,India
956972,2023-06-16,507,washing machine,6990,16490,9500,1,00048,India
932386,2023-06-16,505,oven,18490,24000,5510,1,00159,India
932386,2023-06-16,502,iphone 15 pro max,100000,135000,35000,1,00159,India
761311,2023-06-16,504,iron,449,879,430,1,00251,India
761311,2023-06-16,502,iphone 15 pro max,100000,135000,35000,1,00251,India
241693,2023-06-16,503,mixer,1349,3249,1900,1,00401,India
893791,2023-06-16,503,mixer,1349,3249,1900,1,00354,India
123836,2023-06-16,502,iphone 15 pro max,100000,135000,35000,1,00339,India
123836,2023-06-16,506,monitor,3249,8000,4751,1,00339,India
123836,2023-06-16,505,oven,18490,24000,5510,1,00339,India
977217,2023-06-16,505,oven,18490,24000,5510,1,00052,India
174792,2023-06-16,506,monitor,3249,8000,4751,1,00347,India
174792,2023-06-16,505,oven,18490,24000,5510,1,00347,India
761856,2023-06-16,507,washing machine,6990,16490,9500,1,00484,India
603663,2023-06-16,505,oven,18490,24000,5510,1,00399,India
975442,2023-06-16,505,oven,18490,24000,5510,1,00434,India
975442,2023-06-16,507,washing machine,6990,16490,9500,1,00434,India
975442,2023-06-16,502,iphone 15 pro max,100000,135000,35000,1,00434,India
528355,2023-06-16,501,iphone 15,60000,80000,20000,1,00186,India
528355,2023-06-16,502,iphone 15 pro max,100000,135000,35000,1,00186,India
528355,2023-06-16,503,mixer,1349,3249,1900,1,00186,India
210009,2023-06-16,503,mixer,1349,3249,1900,1,00252,India
210009,2023-06-16,502,iphone 15 pro max,100000,135000,35000,1,00252,India
210009,2023-06-16,506,monitor,3249,8000,4751,1,00252,India
210009,2023-06-16,501,iphone 15,60000,80000,20000,1,00252,India
978532,2023-06-16,503,mixer,1349,3249,1900,1,00168,India
978532,2023-06-16,507,washing machine,6990,16490,9500,1,00168,India
978532,2023-06-16,502,iphone 15 pro max,100000,135000,35000,1,00168,India
279791,2023-06-16,504,iron,449,879,430,1,00411,India
279791,2023-06-16,503,mixer,1349,3249,1900,1,00411,India
279791,2023-06-16,507,washing machine,6990,16490,9500,1,00411,India
279791,2023-06-16,505,oven,18490,24000,5510,1,00411,India
591808,2023-06-16,504,iron,449,879,430,1,00207,India
591808,2023-06-16,501,iphone 15,60000,80000,20000,1,00207,India
591808,2023-06-16,503,mixer,1349,3249,1900,1,00207,India
359535,2023-06-16,502,iphone 15 pro max,100000,135000,35000,1,00454,India
359535,2023-06-16,505,oven,18490,24000,5510,1,00454,India
359535,2023-06-16,504,iron,449,879,430,1,00454,India
359535,2023-06-16,506,monitor,3249,8000,4751,1,00454,India
325634,2023-06-16,504,iron,449,879,430,1,00089,India
325634,2023-06-16,505,oven,18490,24000,5510,1,00089,India
325634,2023-06-16,503,mixer,1349,3249,1900,1,00089,India
325634,2023-06-16,507,washing machine,6990,16490,9500,1,00089,India
733116,2023-06-16,505,oven,18490,24000,5510,1,00076,India
733116,2023-06-16,506,monitor,3249,8000,4751,1,00076,India
733116,2023-06-16,507,washing machine,6990,16490,9500,1,00076,India
949676,2023-06-16,502,iphone 15 pro max,100000,135000,35000,1,00097,India
949676,2023-06-16,507,washing machine,6990,16490,9500,1,00097,India
949676,2023-06-16,501,iphone 15,60000,80000,20000,1,00097,India
197917,2023-06-16,502,iphone 15 pro max,100000,135000,35000,1,00058,India
585544,2023-06-16,505,oven,18490,24000,5510,1,00268,India
585544,2023-06-16,503,mixer,1349,3249,1900,1,00268,India
585544,2023-06-16,501,iphone 15,60000,80000,20000,1,00268,India
839867,2023-06-16,505,oven,18490,24000,5510,1,00274,India
269186,2023-06-16,506,monitor,3249,8000,4751,1,00330,India
269186,2023-06-16,503,mixer,1349,3249,1900,1,00330,India
323180,2023-06-16,501,iphone 15,60000,80000,20000,1,00264,India
323180,2023-06-16,506,monitor,3249,8000,4751,1,00264,India
323180,2023-06-16,503,mixer,1349,3249,1900,1,00264,India
519693,2023-06-16,501,iphone 15,60000,80000,20000,1,00401,India
519693,2023-06-16,502,iphone 15 pro max,100000,135000,35000,1,00401,India
519693,2023-06-16,506,monitor,3249,8000,4751,1,00401,India
519693,2023-06-16,507,washing machine,6990,16490,9500,1,00401,India
770422,2023-06-16,507,washing machine,6990,16490,9500,1,00460,India
770422,2023-06-16,506,monitor,3249,8000,4751,1,00460,India
776236,2023-06-16,505,oven,18490,24000,5510,1,00310,India
776236,2023-06-16,504,iron,449,879,430,1,00310,India
737688,2023-06-17,503,mixer,1349,3249,1900,1,00357,India
737688,2023-06-17,507,washing machine,6990,16490,9500,1,00357,India
737688,2023-06-17,501,iphone 15,60000,80000,20000,1,00357,India
737688,2023-06-17,502,iphone 15 pro max,100000,135000,35000,1,00357,India
652522,2023-06-17,505,oven,18490,24000,5510,1,00422,India
652522,2023-06-17,502,iphone 15 pro max,100000,135000,35000,1,00422,India
814490,2023-06-17,505,oven,18490,24000,5510,1,00422,India
814490,2023-06-17,502,iphone 15 pro max,100000,135000,35000,1,00422,India
814490,2023-06-17,506,monitor,3249,8000,4751,1,00422,India
542819,2023-06-17,504,iron,449,879,430,1,00423,India
542819,2023-06-17,501,iphone 15,60000,80000,20000,1,00423,India
360706,2023-06-17,501,iphone 15,60000,80000,20000,1,00168,India
360706,2023-06-17,502,iphone 15 pro max,100000,135000,35000,1,00168,India
360706,2023-06-17,503,mixer,1349,3249,1900,1,00168,India
360706,2023-06-17,507,washing machine,6990,16490,9500,1,00168,India
747956,2023-06-17,501,iphone 15,60000,80000,20000,1,00292,India
747956,2023-06-17,507,washing machine,6990,16490,9500,1,00292,India
747956,2023-06-17,505,oven,18490,24000,5510,1,00292,India
746963,2023-06-17,502,iphone 15 pro max,100000,135000,35000,1,00257,India
770630,2023-06-17,507,washing machine,6990,16490,9500,1,00240,India
770630,2023-06-17,501,iphone 15,60000,80000,20000,1,00240,India
770630,2023-06-17,506,monitor,3249,8000,4751,1,00240,India
770630,2023-06-17,503,mixer,1349,3249,1900,1,00240,India
553579,2023-06-17,506,monitor,3249,8000,4751,1,00317,India
616934,2023-06-17,506,monitor,3249,8000,4751,1,00417,India
800770,2023-06-17,504,iron,449,879,430,1,00030,India
800770,2023-06-17,505,oven,18490,24000,5510,1,00030,India
717065,2023-06-17,504,iron,449,879,430,1,00361,India
815478,2023-06-17,507,washing machine,6990,16490,9500,1,00297,India
815478,2023-06-17,506,monitor,3249,8000,4751,1,00297,India
815478,2023-06-17,504,iron,449,879,430,1,00297,India
830627,2023-06-17,505,oven,18490,24000,5510,1,00113,India
830627,2023-06-17,502,iphone 15 pro max,100000,135000,35000,1,00113,India
830627,2023-06-17,504,iron,449,879,430,1,00113,India
151693,2023-06-17,504,iron,449,879,430,1,00324,India
151693,2023-06-17,505,oven,18490,24000,5510,1,00324,India
992222,2023-06-17,502,iphone 15 pro max,100000,135000,35000,1,00313,India
992222,2023-06-17,503,mixer,1349,3249,1900,1,00313,India
992222,2023-06-17,506,monitor,3249,8000,4751,1,00313,India
679309,2023-06-17,505,oven,18490,24000,5510,1,00056,India
679309,2023-06-17,504,iron,449,879,430,1,00056,India
679309,2023-06-17,501,iphone 15,60000,80000,20000,1,00056,India
942354,2023-06-17,506,monitor,3249,8000,4751,1,00015,India
942354,2023-06-17,502,iphone 15 pro max,100000,135000,35000,1,00015,India
942354,2023-06-17,501,iphone 15,60000,80000,20000,1,00015,India
942354,2023-06-17,503,mixer,1349,3249,1900,1,00015,India
804374,2023-06-17,503,mixer,1349,3249,1900,1,00194,India
804374,2023-06-17,506,monitor,3249,8000,4751,1,00194,India
804374,2023-06-17,504,iron,449,879,430,1,00194,India
804374,2023-06-17,505,oven,18490,24000,5510,1,00194,India
631795,2023-06-17,504,iron,449,879,430,1,00242,India
631795,2023-06-17,506,monitor,3249,8000,4751,1,00242,India
631795,2023-06-17,505,oven,18490,24000,5510,1,00242,India
252090,2023-06-17,502,iphone 15 pro max,100000,135000,35000,1,00189,India
252090,2023-06-17,505,oven,18490,24000,5510,1,00189,India
252090,2023-06-17,507,washing machine,6990,16490,9500,1,00189,India
435278,2023-06-17,502,iphone 15 pro max,100000,135000,35000,1,00370,India
447158,2023-06-17,507,washing machine,6990,16490,9500,1,00092,India
447158,2023-06-17,504,iron,449,879,430,1,00092,India
447158,2023-06-17,505,oven,18490,24000,5510,1,00092,India
447158,2023-06-17,503,mixer,1349,3249,1900,1,00092,India
663880,2023-06-17,507,washing machine,6990,16490,9500,1,00289,India
663880,2023-06-17,501,iphone 15,60000,80000,20000,1,00289,India
926069,2023-06-17,503,mixer,1349,3249,1900,1,00218,India
926069,2023-06-17,502,iphone 15 pro max,100000,135000,35000,1,00218,India
981722,2023-06-17,501,iphone 15,60000,80000,20000,1,00041,India
981722,2023-06-17,506,monitor,3249,8000,4751,1,00041,India
314511,2023-06-17,505,oven,18490,24000,5510,1,00237,India
314511,2023-06-17,504,iron,449,879,430,1,00237,India
946641,2023-06-17,503,mixer,1349,3249,1900,1,00358,India
369635,2023-06-17,505,oven,18490,24000,5510,1,00398,India
369635,2023-06-17,506,monitor,3249,8000,4751,1,00398,India
889975,2023-06-17,503,mixer,1349,3249,1900,1,00365,India
889975,2023-06-17,507,washing machine,6990,16490,9500,1,00365,India
728757,2023-06-17,507,washing machine,6990,16490,9500,1,00155,India
728757,2023-06-17,503,mixer,1349,3249,1900,1,00155,India
728757,2023-06-17,502,iphone 15 pro max,100000,135000,35000,1,00155,India
728757,2023-06-17,505,oven,18490,24000,5510,1,00155,India
621604,2023-06-17,507,washing machine,6990,16490,9500,1,00498,India
196298,2023-06-17,507,washing machine,6990,16490,9500,1,00079,India
196298,2023-06-17,505,oven,18490,24000,5510,1,00079,India
196298,2023-06-17,504,iron,449,879,430,1,00079,India
252740,2023-06-17,504,iron,449,879,430,1,00498,India
252740,2023-06-17,506,monitor,3249,8000,4751,1,00498,India
252740,2023-06-17,507,washing machine,6990,16490,9500,1,00498,India
153047,2023-06-17,502,iphone 15 pro max,100000,135000,35000,1,00026,India
153047,2023-06-17,504,iron,449,879,430,1,00026,India
158129,2023-06-17,505,oven,18490,24000,5510,1,00091,India
158129,2023-06-17,503,mixer,1349,3249,1900,1,00091,India
346799,2023-06-17,502,iphone 15 pro max,100000,135000,35000,1,00127,India
346799,2023-06-17,506,monitor,3249,8000,4751,1,00127,India
346799,2023-06-17,507,washing machine,6990,16490,9500,1,00127,India
868079,2023-06-17,501,iphone 15,60000,80000,20000,1,00040,India
868079,2023-06-17,504,iron,449,879,430,1,00040,India
891661,2023-06-17,501,iphone 15,60000,80000,20000,1,00252,India
891661,2023-06-17,506,monitor,3249,8000,4751,1,00252,India
891661,2023-06-17,504,iron,449,879,430,1,00252,India
723410,2023-06-17,504,iron,449,879,430,1,00080,India
723410,2023-06-17,506,monitor,3249,8000,4751,1,00080,India
796792,2023-06-17,507,washing machine,6990,16490,9500,1,00193,India
796792,2023-06-17,504,iron,449,879,430,1,00193,India
796792,2023-06-17,505,oven,18490,24000,5510,1,00193,India
190133,2023-06-17,501,iphone 15,60000,80000,20000,1,00296,India
190133,2023-06-17,503,mixer,1349,3249,1900,1,00296,India
190133,2023-06-17,507,washing machine,6990,16490,9500,1,00296,India
190133,2023-06-17,504,iron,449,879,430,1,00296,India
363614,2023-06-17,507,washing machine,6990,16490,9500,1,00385,India
363614,2023-06-17,502,iphone 15 pro max,100000,135000,35000,1,00385,India
562400,2023-06-17,507,washing machine,6990,16490,9500,1,00038,India
562400,2023-06-17,503,mixer,1349,3249,1900,1,00038,India
667206,2023-06-17,507,washing machine,6990,16490,9500,1,00396,India
667206,2023-06-17,503,mixer,1349,3249,1900,1,00396,India
842148,2023-06-17,506,monitor,3249,8000,4751,1,00448,India
180054,2023-06-17,503,mixer,1349,3249,1900,1,00089,India
953580,2023-06-17,504,iron,449,879,430,1,00374,India
953580,2023-06-17,507,washing machine,6990,16490,9500,1,00374,India
953580,2023-06-17,506,monitor,3249,8000,4751,1,00374,India
953580,2023-06-17,503,mixer,1349,3249,1900,1,00374,India
273882,2023-06-17,507,washing machine,6990,16490,9500,1,00480,India
273882,2023-06-17,503,mixer,1349,3249,1900,1,00480,India
583116,2023-06-17,504,iron,449,879,430,1,00243,India
583116,2023-06-17,505,oven,18490,24000,5510,1,00243,India
583116,2023-06-17,501,iphone 15,60000,80000,20000,1,00243,India
539494,2023-06-17,505,oven,18490,24000,5510,1,00339,India
539494,2023-06-17,503,mixer,1349,3249,1900,1,00339,India
197718,2023-06-17,503,mixer,1349,3249,1900,1,00475,India
197718,2023-06-17,505,oven,18490,24000,5510,1,00475,India
197718,2023-06-17,507,washing machine,6990,16490,9500,1,00475,India
943652,2023-06-17,506,monitor,3249,8000,4751,1,00049,India
585227,2023-06-17,505,oven,18490,24000,5510,1,00220,India
585227,2023-06-17,506,monitor,3249,8000,4751,1,00220,India
585227,2023-06-17,504,iron,449,879,430,1,00220,India
986354,2023-06-17,504,iron,449,879,430,1,00285,India
986354,2023-06-17,503,mixer,1349,3249,1900,1,00285,India
107837,2023-06-17,502,iphone 15 pro max,100000,135000,35000,1,00053,India
107837,2023-06-17,504,iron,449,879,430,1,00053,India
107837,2023-06-17,507,washing machine,6990,16490,9500,1,00053,India
179393,2023-06-17,503,mixer,1349,3249,1900,1,00025,India
179393,2023-06-17,505,oven,18490,24000,5510,1,00025,India
889759,2023-06-17,505,oven,18490,24000,5510,1,00500,India
889759,2023-06-17,502,iphone 15 pro max,100000,135000,35000,1,00500,India
746783,2023-06-17,507,washing machine,6990,16490,9500,1,00147,India
746783,2023-06-17,505,oven,18490,24000,5510,1,00147,India
746783,2023-06-17,502,iphone 15 pro max,100000,135000,35000,1,00147,India
746783,2023-06-17,506,monitor,3249,8000,4751,1,00147,India
175980,2023-06-17,505,oven,18490,24000,5510,1,00260,India
463361,2023-06-17,504,iron,449,879,430,1,00419,India
463361,2023-06-17,501,iphone 15,60000,80000,20000,1,00419,India
463361,2023-06-17,505,oven,18490,24000,5510,1,00419,India
610201,2023-06-17,506,monitor,3249,8000,4751,1,00167,India
610201,2023-06-17,504,iron,449,879,430,1,00167,India
610201,2023-06-17,502,iphone 15 pro max,100000,135000,35000,1,00167,India
610201,2023-06-17,507,washing machine,6990,16490,9500,1,00167,India
432454,2023-06-17,505,oven,18490,24000,5510,1,00063,India
432454,2023-06-17,502,iphone 15 pro max,100000,135000,35000,1,00063,India
432454,2023-06-17,507,washing machine,6990,16490,9500,1,00063,India
797680,2023-06-17,507,washing machine,6990,16490,9500,1,00480,India
249166,2023-06-17,507,washing machine,6990,16490,9500,1,00166,India
766907,2023-06-17,505,oven,18490,24000,5510,1,00148,India
766907,2023-06-17,504,iron,449,879,430,1,00148,India
766907,2023-06-17,502,iphone 15 pro max,100000,135000,35000,1,00148,India
333774,2023-06-17,506,monitor,3249,8000,4751,1,00412,India
119475,2023-06-17,501,iphone 15,60000,80000,20000,1,00444,India
119475,2023-06-17,502,iphone 15 pro max,100000,135000,35000,1,00444,India
119475,2023-06-17,506,monitor,3249,8000,4751,1,00444,India
119475,2023-06-17,504,iron,449,879,430,1,00444,India
900238,2023-06-17,502,iphone 15 pro max,100000,135000,35000,1,00230,India
125661,2023-06-17,502,iphone 15 pro max,100000,135000,35000,1,00037,India
125661,2023-06-17,501,iphone 15,60000,80000,20000,1,00037,India
125661,2023-06-17,503,mixer,1349,3249,1900,1,00037,India
674425,2023-06-17,506,monitor,3249,8000,4751,1,00474,India
674425,2023-06-17,505,oven,18490,24000,5510,1,00474,India
674425,2023-06-17,502,iphone 15 pro max,100000,135000,35000,1,00474,India
674425,2023-06-17,504,iron,449,879,430,1,00474,India
222379,2023-06-17,507,washing machine,6990,16490,9500,1,00480,India
222379,2023-06-17,506,monitor,3249,8000,4751,1,00480,India
222379,2023-06-17,502,iphone 15 pro max,100000,135000,35000,1,00480,India
188383,2023-06-18,507,washing machine,6990,16490,9500,1,00310,India
727984,2023-06-18,501,iphone 15,60000,80000,20000,1,00290,India
524093,2023-06-18,503,mixer,1349,3249,1900,1,00164,India
524093,2023-06-18,502,iphone 15 pro max,100000,135000,35000,1,00164,India
415053,2023-06-18,502,iphone 15 pro max,100000,135000,35000,1,00068,India
415053,2023-06-18,506,monitor,3249,8000,4751,1,00068,India
415053,2023-06-18,505,oven,18490,24000,5510,1,00068,India
869533,2023-06-18,503,mixer,1349,3249,1900,1,00354,India
779769,2023-06-18,504,iron,449,879,430,1,00243,India
779769,2023-06-18,502,iphone 15 pro max,100000,135000,35000,1,00243,India
779769,2023-06-18,501,iphone 15,60000,80000,20000,1,00243,India
779769,2023-06-18,505,oven,18490,24000,5510,1,00243,India
464945,2023-06-18,502,iphone 15 pro max,100000,135000,35000,1,00093,India
464945,2023-06-18,503,mixer,1349,3249,1900,1,00093,India
464945,2023-06-18,506,monitor,3249,8000,4751,1,00093,India
571648,2023-06-18,506,monitor,3249,8000,4751,1,00118,India
571648,2023-06-18,502,iphone 15 pro max,100000,135000,35000,1,00118,India
571648,2023-06-18,505,oven,18490,24000,5510,1,00118,India
571648,2023-06-18,503,mixer,1349,3249,1900,1,00118,India
534780,2023-06-18,503,mixer,1349,3249,1900,1,00350,India
534780,2023-06-18,501,iphone 15,60000,80000,20000,1,00350,India
534780,2023-06-18,506,monitor,3249,8000,4751,1,00350,India
534780,2023-06-18,504,iron,449,879,430,1,00350,India
139469,2023-06-18,501,iphone 15,60000,80000,20000,1,00386,India
139469,2023-06-18,502,iphone 15 pro max,100000,135000,35000,1,00386,India
139469,2023-06-18,503,mixer,1349,3249,1900,1,00386,India
161925,2023-06-18,503,mixer,1349,3249,1900,1,00054,India
161925,2023-06-18,501,iphone 15,60000,80000,20000,1,00054,India
161925,2023-06-18,507,washing machine,6990,16490,9500,1,00054,India
835189,2023-06-18,505,oven,18490,24000,5510,1,00349,India
835189,2023-06-18,507,washing machine,6990,16490,9500,1,00349,India
835189,2023-06-18,504,iron,449,879,430,1,00349,India
750189,2023-06-18,504,iron,449,879,430,1,00397,India
750189,2023-06-18,502,iphone 15 pro max,100000,135000,35000,1,00397,India
750189,2023-06-18,503,mixer,1349,3249,1900,1,00397,India
750189,2023-06-18,501,iphone 15,60000,80000,20000,1,00397,India
750189,2023-06-18,507,washing machine,6990,16490,9500,1,00397,India
554259,2023-06-18,501,iphone 15,60000,80000,20000,1,00468,India
554259,2023-06-18,504,iron,449,879,430,1,00468,India
676154,2023-06-18,506,monitor,3249,8000,4751,1,00421,India
676154,2023-06-18,501,iphone 15,60000,80000,20000,1,00421,India
676154,2023-06-18,507,washing machine,6990,16490,9500,1,00421,India
741622,2023-06-18,507,washing machine,6990,16490,9500,1,00027,India
741622,2023-06-18,504,iron,449,879,430,1,00027,India
741622,2023-06-18,505,oven,18490,24000,5510,1,00027,India
189875,2023-06-18,502,iphone 15 pro max,100000,135000,35000,1,00415,India
189875,2023-06-18,504,iron,449,879,430,1,00415,India
115909,2023-06-18,504,iron,449,879,430,1,00141,India
115909,2023-06-18,502,iphone 15 pro max,100000,135000,35000,1,00141,India
115909,2023-06-18,505,oven,18490,24000,5510,1,00141,India
852544,2023-06-18,502,iphone 15 pro max,100000,135000,35000,1,00226,India
852544,2023-06-18,501,iphone 15,60000,80000,20000,1,00226,India
852544,2023-06-18,507,washing machine,6990,16490,9500,1,00226,India
852544,2023-06-18,505,oven,18490,24000,5510,1,00226,India
804802,2023-06-18,501,iphone 15,60000,80000,20000,1,00466,India
804802,2023-06-18,502,iphone 15 pro max,100000,135000,35000,1,00466,India
161684,2023-06-18,507,washing machine,6990,16490,9500,1,00208,India
161684,2023-06-18,503,mixer,1349,3249,1900,1,00208,India
747550,2023-06-18,505,oven,18490,24000,5510,1,00015,India
747550,2023-06-18,501,iphone 15,60000,80000,20000,1,00015,India
747550,2023-06-18,506,monitor,3249,8000,4751,1,00015,India
747550,2023-06-18,503,mixer,1349,3249,1900,1,00015,India
600672,2023-06-18,505,oven,18490,24000,5510,1,00039,India
944390,2023-06-18,506,monitor,3249,8000,4751,1,00121,India
944390,2023-06-18,503,mixer,1349,3249,1900,1,00121,India
302520,2023-06-18,506,monitor,3249,8000,4751,1,00448,India
730272,2023-06-18,501,iphone 15,60000,80000,20000,1,00260,India
354158,2023-06-18,504,iron,449,879,430,1,00483,India
354158,2023-06-18,507,washing machine,6990,16490,9500,1,00483,India
367262,2023-06-18,501,iphone 15,60000,80000,20000,1,00028,India
367262,2023-06-18,507,washing machine,6990,16490,9500,1,00028,India
367262,2023-06-18,502,iphone 15 pro max,100000,135000,35000,1,00028,India
712250,2023-06-18,506,monitor,3249,8000,4751,1,00491,India
712250,2023-06-18,507,washing machine,6990,16490,9500,1,00491,India
712250,2023-06-18,505,oven,18490,24000,5510,1,00491,India
672821,2023-06-18,502,iphone 15 pro max,100000,135000,35000,1,00355,India
672821,2023-06-18,503,mixer,1349,3249,1900,1,00355,India
672821,2023-06-18,501,iphone 15,60000,80000,20000,1,00355,India
672821,2023-06-18,504,iron,449,879,430,1,00355,India
624298,2023-06-18,501,iphone 15,60000,80000,20000,1,00283,India
624298,2023-06-18,502,iphone 15 pro max,100000,135000,35000,1,00283,India
624298,2023-06-18,503,mixer,1349,3249,1900,1,00283,India
871512,2023-06-18,501,iphone 15,60000,80000,20000,1,00016,India
340385,2023-06-18,505,oven,18490,24000,5510,1,00077,India
340385,2023-06-18,504,iron,449,879,430,1,00077,India
559451,2023-06-18,506,monitor,3249,8000,4751,1,00082,India
559451,2023-06-18,507,washing machine,6990,16490,9500,1,00082,India
559451,2023-06-18,502,iphone 15 pro max,100000,135000,35000,1,00082,India
559451,2023-06-18,501,iphone 15,60000,80000,20000,1,00082,India
839258,2023-06-18,502,iphone 15 pro max,100000,135000,35000,1,00451,India
839258,2023-06-18,501,iphone 15,60000,80000,20000,1,00451,India
839258,2023-06-18,507,washing machine,6990,16490,9500,1,00451,India
839258,2023-06-18,503,mixer,1349,3249,1900,1,00451,India
669086,2023-06-18,504,iron,449,879,430,1,00066,India
344396,2023-06-18,503,mixer,1349,3249,1900,1,00075,India
344396,2023-06-18,505,oven,18490,24000,5510,1,00075,India
344396,2023-06-18,502,iphone 15 pro max,100000,135000,35000,1,00075,India
464597,2023-06-18,507,washing machine,6990,16490,9500,1,00249,India
332286,2023-06-18,503,mixer,1349,3249,1900,1,00499,India
827916,2023-06-18,503,mixer,1349,3249,1900,1,00207,India
827916,2023-06-18,501,iphone 15,60000,80000,20000,1,00207,India
827916,2023-06-18,506,monitor,3249,8000,4751,1,00207,India
359157,2023-06-18,506,monitor,3249,8000,4751,1,00297,India
359157,2023-06-18,502,iphone 15 pro max,100000,135000,35000,1,00297,India
359157,2023-06-18,504,iron,449,879,430,1,00297,India
359157,2023-06-18,505,oven,18490,24000,5510,1,00297,India
359157,2023-06-18,507,washing machine,6990,16490,9500,1,00297,India
243515,2023-06-18,505,oven,18490,24000,5510,1,00040,India
243515,2023-06-18,506,monitor,3249,8000,4751,1,00040,India
881448,2023-06-18,503,mixer,1349,3249,1900,1,00244,India
881448,2023-06-18,501,iphone 15,60000,80000,20000,1,00244,India
711916,2023-06-18,507,washing machine,6990,16490,9500,1,00061,India
711916,2023-06-18,503,mixer,1349,3249,1900,1,00061,India
711916,2023-06-18,505,oven,18490,24000,5510,1,00061,India
250971,2023-06-18,505,oven,18490,24000,5510,1,00460,India
250971,2023-06-18,506,monitor,3249,8000,4751,1,00460,India
250971,2023-06-18,504,iron,449,879,430,1,00460,India
385547,2023-06-18,501,iphone 15,60000,80000,20000,1,00010,India
385547,2023-06-18,502,iphone 15 pro max,100000,135000,35000,1,00010,India
385547,2023-06-18,507,washing machine,6990,16490,9500,1,00010,India
385547,2023-06-18,506,monitor,3249,8000,4751,1,00010,India
347139,2023-06-18,501,iphone 15,60000,80000,20000,1,00440,India
933725,2023-06-18,505,oven,18490,24000,5510,1,00138,India
933725,2023-06-18,507,washing machine,6990,16490,9500,1,00138,India
933725,2023-06-18,504,iron,449,879,430,1,00138,India
896570,2023-06-18,507,washing machine,6990,16490,9500,1,00453,India
896570,2023-06-18,501,iphone 15,60000,80000,20000,1,00453,India
896570,2023-06-18,506,monitor,3249,8000,4751,1,00453,India
820413,2023-06-18,502,iphone 15 pro max,100000,135000,35000,1,00395,India
252752,2023-06-18,505,oven,18490,24000,5510,1,00264,India
252752,2023-06-18,502,iphone 15 pro max,100000,135000,35000,1,00264,India
970689,2023-06-18,503,mixer,1349,3249,1900,1,00331,India
153172,2023-06-18,505,oven,18490,24000,5510,1,00331,India
153172,2023-06-18,507,washing machine,6990,16490,9500,1,00331,India
153172,2023-06-18,502,iphone 15 pro max,100000,135000,35000,1,00331,India
665100,2023-06-18,506,monitor,3249,8000,4751,1,00169,India
665100,2023-06-18,502,iphone 15 pro max,100000,135000,35000,1,00169,India
665100,2023-06-18,504,iron,449,879,430,1,00169,India
169198,2023-06-18,503,mixer,1349,3249,1900,1,00420,India
169198,2023-06-18,502,iphone 15 pro max,100000,135000,35000,1,00420,India
621868,2023-06-18,502,iphone 15 pro max,100000,135000,35000,1,00265,India
621868,2023-06-18,504,iron,449,879,430,1,00265,India
621868,2023-06-18,501,iphone 15,60000,80000,20000,1,00265,India
410666,2023-06-18,502,iphone 15 pro max,100000,135000,35000,1,00309,India
410666,2023-06-18,506,monitor,3249,8000,4751,1,00309,India
410666,2023-06-18,501,iphone 15,60000,80000,20000,1,00309,India
847689,2023-06-18,505,oven,18490,24000,5510,1,00181,India
847689,2023-06-18,506,monitor,3249,8000,4751,1,00181,India
847689,2023-06-18,504,iron,449,879,430,1,00181,India
645883,2023-06-18,501,iphone 15,60000,80000,20000,1,00185,India
645883,2023-06-18,502,iphone 15 pro max,100000,135000,35000,1,00185,India
645883,2023-06-18,505,oven,18490,24000,5510,1,00185,India
513937,2023-06-18,504,iron,449,879,430,1,00274,India
959711,2023-06-18,505,oven,18490,24000,5510,1,00082,India
959711,2023-06-18,506,monitor,3249,8000,4751,1,00082,India
959711,2023-06-18,503,mixer,1349,3249,1900,1,00082,India
959711,2023-06-18,507,washing machine,6990,16490,9500,1,00082,India
959711,2023-06-18,502,iphone 15 pro max,100000,135000,35000,1,00082,India
852558,2023-06-18,503,mixer,1349,3249,1900,1,00323,India
852558,2023-06-18,502,iphone 15 pro max,100000,135000,35000,1,00323,India
852558,2023-06-18,504,iron,449,879,430,1,00323,India
852558,2023-06-18,506,monitor,3249,8000,4751,1,00323,India
218761,2023-06-18,501,iphone 15,60000,80000,20000,1,00253,India
900868,2023-06-18,501,iphone 15,60000,80000,20000,1,00497,India
900868,2023-06-18,503,mixer,1349,3249,1900,1,00497,India
900868,2023-06-18,506,monitor,3249,8000,4751,1,00497,India
900868,2023-06-18,507,washing machine,6990,16490,9500,1,00497,India
999045,2023-06-18,501,iphone 15,60000,80000,20000,1,00163,India
999045,2023-06-18,505,oven,18490,24000,5510,1,00163,India
880149,2023-06-18,506,monitor,3249,8000,4751,1,00284,India
880149,2023-06-18,507,washing machine,6990,16490,9500,1,00284,India
880149,2023-06-18,504,iron,449,879,430,1,00284,India
880149,2023-06-18,501,iphone 15,60000,80000,20000,1,00284,India
308866,2023-06-18,502,iphone 15 pro max,100000,135000,35000,1,00413,India
308866,2023-06-18,501,iphone 15,60000,80000,20000,1,00413,India
308866,2023-06-18,506,monitor,3249,8000,4751,1,00413,India
850274,2023-06-18,502,iphone 15 pro max,100000,135000,35000,1,00025,India
850274,2023-06-18,505,oven,18490,24000,5510,1,00025,India
850274,2023-06-18,507,washing machine,6990,16490,9500,1,00025,India
850274,2023-06-18,504,iron,449,879,430,1,00025,India
986229,2023-06-18,503,mixer,1349,3249,1900,1,00056,India
986229,2023-06-18,507,washing machine,6990,16490,9500,1,00056,India
926776,2023-06-18,501,iphone 15,60000,80000,20000,1,00385,India
926776,2023-06-18,506,monitor,3249,8000,4751,1,00385,India
926776,2023-06-18,505,oven,18490,24000,5510,1,00385,India
926776,2023-06-18,507,washing machine,6990,16490,9500,1,00385,India
121489,2023-06-19,506,monitor,3249,8000,4751,1,00063,India
121489,2023-06-19,503,mixer,1349,3249,1900,1,00063,India
605511,2023-06-19,505,oven,18490,24000,5510,1,00134,India
605511,2023-06-19,504,iron,449,879,430,1,00134,India
605511,2023-06-19,503,mixer,1349,3249,1900,1,00134,India
293430,2023-06-19,503,mixer,1349,3249,1900,1,00309,India
293430,2023-06-19,504,iron,449,879,430,1,00309,India
293430,2023-06-19,501,iphone 15,60000,80000,20000,1,00309,India
293430,2023-06-19,507,washing machine,6990,16490,9500,1,00309,India
709904,2023-06-19,504,iron,449,879,430,1,00001,India
395831,2023-06-19,505,oven,18490,24000,5510,1,00220,India
395831,2023-06-19,506,monitor,3249,8000,4751,1,00220,India
395831,2023-06-19,507,washing machine,6990,16490,9500,1,00220,India
622841,2023-06-19,507,washing machine,6990,16490,9500,1,00486,India
958038,2023-06-19,504,iron,449,879,430,1,00116,India
958038,2023-06-19,507,washing machine,6990,16490,9500,1,00116,India
958038,2023-06-19,502,iphone 15 pro max,100000,135000,35000,1,00116,India
958038,2023-06-19,505,oven,18490,24000,5510,1,00116,India
182723,2023-06-19,506,monitor,3249,8000,4751,1,00114,India
148450,2023-06-19,506,monitor,3249,8000,4751,1,00012,India
148450,2023-06-19,505,oven,18490,24000,5510,1,00012,India
432421,2023-06-19,506,monitor,3249,8000,4751,1,00004,India
432421,2023-06-19,502,iphone 15 pro max,100000,135000,35000,1,00004,India
432421,2023-06-19,505,oven,18490,24000,5510,1,00004,India
432421,2023-06-19,507,washing machine,6990,16490,9500,1,00004,India
967399,2023-06-19,506,monitor,3249,8000,4751,1,00402,India
244301,2023-06-19,507,washing machine,6990,16490,9500,1,00226,India
629684,2023-06-19,504,iron,449,879,430,1,00488,India
629684,2023-06-19,503,mixer,1349,3249,1900,1,00488,India
868380,2023-06-19,502,iphone 15 pro max,100000,135000,35000,1,00135,India
868380,2023-06-19,501,iphone 15,60000,80000,20000,1,00135,India
868380,2023-06-19,507,washing machine,6990,16490,9500,1,00135,India
538227,2023-06-19,503,mixer,1349,3249,1900,1,00384,India
538227,2023-06-19,501,iphone 15,60000,80000,20000,1,00384,India
975224,2023-06-19,507,washing machine,6990,16490,9500,1,00215,India
975224,2023-06-19,503,mixer,1349,3249,1900,1,00215,India
975224,2023-06-19,501,iphone 15,60000,80000,20000,1,00215,India
975224,2023-06-19,502,iphone 15 pro max,100000,135000,35000,1,00215,India
148518,2023-06-19,501,iphone 15,60000,80000,20000,1,00290,India
148518,2023-06-19,503,mixer,1349,3249,1900,1,00290,India
175370,2023-06-19,504,iron,449,879,430,1,00122,India
175370,2023-06-19,503,mixer,1349,3249,1900,1,00122,India
175370,2023-06-19,501,iphone 15,60000,80000,20000,1,00122,India
180466,2023-06-19,501,iphone 15,60000,80000,20000,1,00125,India
180466,2023-06-19,505,oven,18490,24000,5510,1,00125,India
180466,2023-06-19,504,iron,449,879,430,1,00125,India
745444,2023-06-19,502,iphone 15 pro max,100000,135000,35000,1,00010,India
745444,2023-06-19,504,iron,449,879,430,1,00010,India
745444,2023-06-19,506,monitor,3249,8000,4751,1,00010,India
678931,2023-06-19,504,iron,449,879,430,1,00070,India
678931,2023-06-19,507,washing machine,6990,16490,9500,1,00070,India
442621,2023-06-19,503,mixer,1349,3249,1900,1,00268,India
442621,2023-06-19,504,iron,449,879,430,1,00268,India
777285,2023-06-19,502,iphone 15 pro max,100000,135000,35000,1,00058,India
777285,2023-06-19,501,iphone 15,60000,80000,20000,1,00058,India
153218,2023-06-19,503,mixer,1349,3249,1900,1,00130,India
153218,2023-06-19,506,monitor,3249,8000,4751,1,00130,India
253330,2023-06-19,502,iphone 15 pro max,100000,135000,35000,1,00493,India
201523,2023-06-19,501,iphone 15,60000,80000,20000,1,00137,India
201523,2023-06-19,505,oven,18490,24000,5510,1,00137,India
201523,2023-06-19,504,iron,449,879,430,1,00137,India
639550,2023-06-19,504,iron,449,879,430,1,00487,India
639550,2023-06-19,507,washing machine,6990,16490,9500,1,00487,India
639550,2023-06-19,501,iphone 15,60000,80000,20000,1,00487,India
639550,2023-06-19,503,mixer,1349,3249,1900,1,00487,India
271402,2023-06-19,507,washing machine,6990,16490,9500,1,00312,India
271402,2023-06-19,505,oven,18490,24000,5510,1,00312,India
271402,2023-06-19,502,iphone 15 pro max,100000,135000,35000,1,00312,India
424864,2023-06-19,501,iphone 15,60000,80000,20000,1,00064,India
424864,2023-06-19,502,iphone 15 pro max,100000,135000,35000,1,00064,India
730182,2023-06-19,502,iphone 15 pro max,100000,135000,35000,1,00350,India
730182,2023-06-19,503,mixer,1349,3249,1900,1,00350,India
730182,2023-06-19,506,monitor,3249,8000,4751,1,00350,India
693050,2023-06-19,501,iphone 15,60000,80000,20000,1,00359,India
693050,2023-06-19,504,iron,449,879,430,1,00359,India
961188,2023-06-19,501,iphone 15,60000,80000,20000,1,00203,India
961188,2023-06-19,507,washing machine,6990,16490,9500,1,00203,India
961188,2023-06-19,503,mixer,1349,3249,1900,1,00203,India
849998,2023-06-19,502,iphone 15 pro max,100000,135000,35000,1,00195,India
849998,2023-06-19,501,iphone 15,60000,80000,20000,1,00195,India
336276,2023-06-19,506,monitor,3249,8000,4751,1,00131,India
336276,2023-06-19,501,iphone 15,60000,80000,20000,1,00131,India
336276,2023-06-19,505,oven,18490,24000,5510,1,00131,India
112962,2023-06-19,503,mixer,1349,3249,1900,1,00391,India
112962,2023-06-19,504,iron,449,879,430,1,00391,India
112962,2023-06-19,502,iphone 15 pro max,100000,135000,35000,1,00391,India
745392,2023-06-19,505,oven,18490,24000,5510,1,00433,India
745392,2023-06-19,501,iphone 15,60000,80000,20000,1,00433,India
745392,2023-06-19,504,iron,449,879,430,1,00433,India
745392,2023-06-19,503,mixer,1349,3249,1900,1,00433,India
745392,2023-06-19,506,monitor,3249,8000,4751,1,00433,India
798945,2023-06-19,507,washing machine,6990,16490,9500,1,00230,India
798945,2023-06-19,505,oven,18490,24000,5510,1,00230,India
798945,2023-06-19,506,monitor,3249,8000,4751,1,00230,India
589738,2023-06-19,507,washing machine,6990,16490,9500,1,00227,India
589738,2023-06-19,505,oven,18490,24000,5510,1,00227,India
589738,2023-06-19,501,iphone 15,60000,80000,20000,1,00227,India
589738,2023-06-19,502,iphone 15 pro max,100000,135000,35000,1,00227,India
589738,2023-06-19,503,mixer,1349,3249,1900,1,00227,India
655707,2023-06-19,501,iphone 15,60000,80000,20000,1,00061,India
655707,2023-06-19,504,iron,449,879,430,1,00061,India
681652,2023-06-19,504,iron,449,879,430,1,00011,India
681652,2023-06-19,502,iphone 15 pro max,100000,135000,35000,1,00011,India
148237,2023-06-19,501,iphone 15,60000,80000,20000,1,00401,India
773758,2023-06-19,503,mixer,1349,3249,1900,1,00242,India
773758,2023-06-19,504,iron,449,879,430,1,00242,India
773758,2023-06-19,507,washing machine,6990,16490,9500,1,00242,India
773758,2023-06-19,501,iphone 15,60000,80000,20000,1,00242,India
773758,2023-06-19,506,monitor,3249,8000,4751,1,00242,India
401799,2023-06-19,502,iphone 15 pro max,100000,135000,35000,1,00431,India
401799,2023-06-19,506,monitor,3249,8000,4751,1,00431,India
401799,2023-06-19,503,mixer,1349,3249,1900,1,00431,India
401799,2023-06-19,501,iphone 15,60000,80000,20000,1,00431,India
121648,2023-06-19,505,oven,18490,24000,5510,1,00405,India
121648,2023-06-19,502,iphone 15 pro max,100000,135000,35000,1,00405,India
121648,2023-06-19,506,monitor,3249,8000,4751,1,00405,India
805045,2023-06-19,503,mixer,1349,3249,1900,1,00077,India
805045,2023-06-19,507,washing machine,6990,16490,9500,1,00077,India
994002,2023-06-19,504,iron,449,879,430,1,00364,India
223696,2023-06-19,505,oven,18490,24000,5510,1,00399,India
223696,2023-06-19,507,washing machine,6990,16490,9500,1,00399,India
510687,2023-06-19,501,iphone 15,60000,80000,20000,1,00250,India
510687,2023-06-19,505,oven,18490,24000,5510,1,00250,India
293906,2023-06-19,501,iphone 15,60000,80000,20000,1,00446,India
862984,2023-06-19,504,iron,449,879,430,1,00163,India
862984,2023-06-19,501,iphone 15,60000,80000,20000,1,00163,India
862984,2023-06-19,503,mixer,1349,3249,1900,1,00163,India
641294,2023-06-19,505,oven,18490,24000,5510,1,00350,India
641294,2023-06-19,502,iphone 15 pro max,100000,135000,35000,1,00350,India
163828,2023-06-19,503,mixer,1349,3249,1900,1,00358,India
939240,2023-06-19,503,mixer,1349,3249,1900,1,00073,India
939240,2023-06-19,504,iron,449,879,430,1,00073,India
161449,2023-06-19,504,iron,449,879,430,1,00405,India
161449,2023-06-19,501,iphone 15,60000,80000,20000,1,00405,India
161449,2023-06-19,503,mixer,1349,3249,1900,1,00405,India
820966,2023-06-19,501,iphone 15,60000,80000,20000,1,00408,India
820966,2023-06-19,503,mixer,1349,3249,1900,1,00408,India
820966,2023-06-19,502,iphone 15 pro max,100000,135000,35000,1,00408,India
475094,2023-06-19,504,iron,449,879,430,1,00145,India
461402,2023-06-19,502,iphone 15 pro max,100000,135000,35000,1,00352,India
774028,2023-06-19,507,washing machine,6990,16490,9500,1,00338,India
774028,2023-06-19,504,iron,449,879,430,1,00338,India
774028,2023-06-19,506,monitor,3249,8000,4751,1,00338,India
672772,2023-06-19,506,monitor,3249,8000,4751,1,00002,India
672772,2023-06-19,503,mixer,1349,3249,1900,1,00002,India
672772,2023-06-19,502,iphone 15 pro max,100000,135000,35000,1,00002,India
333667,2023-06-19,504,iron,449,879,430,1,00447,India
333667,2023-06-19,503,mixer,1349,3249,1900,1,00447,India
333667,2023-06-19,505,oven,18490,24000,5510,1,00447,India
333667,2023-06-19,506,monitor,3249,8000,4751,1,00447,India
246245,2023-06-19,501,iphone 15,60000,80000,20000,1,00092,India
246245,2023-06-19,502,iphone 15 pro max,100000,135000,35000,1,00092,India
985754,2023-06-19,505,oven,18490,24000,5510,1,00444,India
985754,2023-06-19,504,iron,449,879,430,1,00444,India
985754,2023-06-19,501,iphone 15,60000,80000,20000,1,00444,India
985754,2023-06-19,503,mixer,1349,3249,1900,1,00444,India
866244,2023-06-19,507,washing machine,6990,16490,9500,1,00083,India
866244,2023-06-19,501,iphone 15,60000,80000,20000,1,00083,India
844690,2023-06-19,501,iphone 15,60000,80000,20000,1,00426,India
844690,2023-06-19,503,mixer,1349,3249,1900,1,00426,India
911219,2023-06-19,505,oven,18490,24000,5510,1,00428,India
911219,2023-06-19,504,iron,449,879,430,1,00428,India
911219,2023-06-19,501,iphone 15,60000,80000,20000,1,00428,India
911219,2023-06-19,502,iphone 15 pro max,100000,135000,35000,1,00428,India
772914,2023-06-19,507,washing machine,6990,16490,9500,1,00150,India
971505,2023-06-19,506,monitor,3249,8000,4751,1,00124,India
971505,2023-06-19,504,iron,449,879,430,1,00124,India
971505,2023-06-19,501,iphone 15,60000,80000,20000,1,00124,India
971505,2023-06-19,502,iphone 15 pro max,100000,135000,35000,1,00124,India
971505,2023-06-19,503,mixer,1349,3249,1900,1,00124,India
415255,2023-06-19,504,iron,449,879,430,1,00168,India
415255,2023-06-19,502,iphone 15 pro max,100000,135000,35000,1,00168,India
415255,2023-06-19,507,washing machine,6990,16490,9500,1,00168,India
115507,2023-06-19,506,monitor,3249,8000,4751,1,00488,India
115507,2023-06-19,501,iphone 15,60000,80000,20000,1,00488,India
845621,2023-06-19,502,iphone 15 pro max,100000,135000,35000,1,00308,India
845621,2023-06-19,503,mixer,1349,3249,1900,1,00308,India
801231,2023-06-19,503,mixer,1349,3249,1900,1,00172,India
200344,2023-06-19,502,iphone 15 pro max,100000,135000,35000,1,00413,India
417984,2023-06-19,502,iphone 15 pro max,100000,135000,35000,1,00156,India
809619,2023-06-19,507,washing machine,6990,16490,9500,1,00161,India
809619,2023-06-19,502,iphone 15 pro max,100000,135000,35000,1,00161,India
809619,2023-06-19,503,mixer,1349,3249,1900,1,00161,India
787201,2023-06-19,505,oven,18490,24000,5510,1,00499,India
787201,2023-06-19,502,iphone 15 pro max,100000,135000,35000,1,00499,India
787201,2023-06-19,501,iphone 15,60000,80000,20000,1,00499,India
594098,2023-06-19,502,iphone 15 pro max,100000,135000,35000,1,00003,India
594098,2023-06-19,505,oven,18490,24000,5510,1,00003,India
594098,2023-06-19,503,mixer,1349,3249,1900,1,00003,India
663110,2023-06-19,505,oven,18490,24000,5510,1,00500,India
426315,2023-06-19,502,iphone 15 pro max,100000,135000,35000,1,00078,India
426315,2023-06-19,506,monitor,3249,8000,4751,1,00078,India
426315,2023-06-19,505,oven,18490,24000,5510,1,00078,India
426315,2023-06-19,503,mixer,1349,3249,1900,1,00078,India
517074,2023-06-19,503,mixer,1349,3249,1900,1,00445,India
517074,2023-06-19,501,iphone 15,60000,80000,20000,1,00445,India
954188,2023-06-19,506,monitor,3249,8000,4751,1,00180,India
141587,2023-06-19,502,iphone 15 pro max,100000,135000,35000,1,00074,India
141587,2023-06-19,507,washing machine,6990,16490,9500,1,00074,India
141587,2023-06-19,505,oven,18490,24000,5510,1,00074,India
141587,2023-06-19,506,monitor,3249,8000,4751,1,00074,India
682782,2023-06-19,502,iphone 15 pro max,100000,135000,35000,1,00295,India
356527,2023-06-20,506,monitor,3249,8000,4751,1,00273,India
261872,2023-06-20,503,mixer,1349,3249,1900,1,00035,India
261872,2023-06-20,506,monitor,3249,8000,4751,1,00035,India
261872,2023-06-20,507,washing machine,6990,16490,9500,1,00035,India
515965,2023-06-20,506,monitor,3249,8000,4751,1,00051,India
515965,2023-06-20,503,mixer,1349,3249,1900,1,00051,India
515965,2023-06-20,502,iphone 15 pro max,100000,135000,35000,1,00051,India
515965,2023-06-20,501,iphone 15,60000,80000,20000,1,00051,India
634545,2023-06-20,503,mixer,1349,3249,1900,1,00407,India
634545,2023-06-20,504,iron,449,879,430,1,00407,India
634545,2023-06-20,507,washing machine,6990,16490,9500,1,00407,India
634545,2023-06-20,506,monitor,3249,8000,4751,1,00407,India
359243,2023-06-20,501,iphone 15,60000,80000,20000,1,00053,India
359243,2023-06-20,503,mixer,1349,3249,1900,1,00053,India
551125,2023-06-20,505,oven,18490,24000,5510,1,00268,India
551125,2023-06-20,506,monitor,3249,8000,4751,1,00268,India
551125,2023-06-20,503,mixer,1349,3249,1900,1,00268,India
551125,2023-06-20,502,iphone 15 pro max,100000,135000,35000,1,00268,India
317199,2023-06-20,503,mixer,1349,3249,1900,1,00017,India
317199,2023-06-20,502,iphone 15 pro max,100000,135000,35000,1,00017,India
354064,2023-06-20,503,mixer,1349,3249,1900,1,00080,India
354064,2023-06-20,505,oven,18490,24000,5510,1,00080,India
354064,2023-06-20,506,monitor,3249,8000,4751,1,00080,India
354064,2023-06-20,502,iphone 15 pro max,100000,135000,35000,1,00080,India
155669,2023-06-20,504,iron,449,879,430,1,00329,India
155669,2023-06-20,505,oven,18490,24000,5510,1,00329,India
155669,2023-06-20,507,washing machine,6990,16490,9500,1,00329,India
155669,2023-06-20,501,iphone 15,60000,80000,20000,1,00329,India
789080,2023-06-20,503,mixer,1349,3249,1900,1,00324,India
787270,2023-06-20,503,mixer,1349,3249,1900,1,00168,India
547816,2023-06-20,506,monitor,3249,8000,4751,1,00437,India
547816,2023-06-20,507,washing machine,6990,16490,9500,1,00437,India
547816,2023-06-20,504,iron,449,879,430,1,00437,India
593023,2023-06-20,505,oven,18490,24000,5510,1,00221,India
593023,2023-06-20,502,iphone 15 pro max,100000,135000,35000,1,00221,India
593023,2023-06-20,506,monitor,3249,8000,4751,1,00221,India
121656,2023-06-20,501,iphone 15,60000,80000,20000,1,00236,India
121656,2023-06-20,504,iron,449,879,430,1,00236,India
121656,2023-06-20,502,iphone 15 pro max,100000,135000,35000,1,00236,India
121656,2023-06-20,507,washing machine,6990,16490,9500,1,00236,India
629955,2023-06-20,504,iron,449,879,430,1,00093,India
629955,2023-06-20,506,monitor,3249,8000,4751,1,00093,India
629955,2023-06-20,501,iphone 15,60000,80000,20000,1,00093,India
629955,2023-06-20,503,mixer,1349,3249,1900,1,00093,India
565243,2023-06-20,501,iphone 15,60000,80000,20000,1,00361,India
565243,2023-06-20,503,mixer,1349,3249,1900,1,00361,India
565243,2023-06-20,505,oven,18490,24000,5510,1,00361,India
718297,2023-06-20,504,iron,449,879,430,1,00337,India
718297,2023-06-20,507,washing machine,6990,16490,9500,1,00337,India
883989,2023-06-20,505,oven,18490,24000,5510,1,00052,India
592095,2023-06-20,507,washing machine,6990,16490,9500,1,00443,India
592095,2023-06-20,501,iphone 15,60000,80000,20000,1,00443,India
592095,2023-06-20,502,iphone 15 pro max,100000,135000,35000,1,00443,India
888045,2023-06-20,507,washing machine,6990,16490,9500,1,00069,India
888045,2023-06-20,503,mixer,1349,3249,1900,1,00069,India
888045,2023-06-20,505,oven,18490,24000,5510,1,00069,India
888045,2023-06-20,501,iphone 15,60000,80000,20000,1,00069,India
917838,2023-06-20,502,iphone 15 pro max,100000,135000,35000,1,00039,India
917838,2023-06-20,507,washing machine,6990,16490,9500,1,00039,India
917838,2023-06-20,501,iphone 15,60000,80000,20000,1,00039,India
739468,2023-06-20,501,iphone 15,60000,80000,20000,1,00491,India
739468,2023-06-20,506,monitor,3249,8000,4751,1,00491,India
739468,2023-06-20,504,iron,449,879,430,1,00491,India
739468,2023-06-20,503,mixer,1349,3249,1900,1,00491,India
729089,2023-06-20,501,iphone 15,60000,80000,20000,1,00470,India
729089,2023-06-20,503,mixer,1349,3249,1900,1,00470,India
729089,2023-06-20,504,iron,449,879,430,1,00470,India
390761,2023-06-20,505,oven,18490,24000,5510,1,00089,India
390761,2023-06-20,504,iron,449,879,430,1,00089,India
390761,2023-06-20,507,washing machine,6990,16490,9500,1,00089,India
798496,2023-06-20,506,monitor,3249,8000,4751,1,00135,India
798496,2023-06-20,504,iron,449,879,430,1,00135,India
798496,2023-06-20,501,iphone 15,60000,80000,20000,1,00135,India
130016,2023-06-20,503,mixer,1349,3249,1900,1,00248,India
130016,2023-06-20,507,washing machine,6990,16490,9500,1,00248,India
130016,2023-06-20,501,iphone 15,60000,80000,20000,1,00248,India
858799,2023-06-20,503,mixer,1349,3249,1900,1,00058,India
177146,2023-06-20,501,iphone 15,60000,80000,20000,1,00376,India
177146,2023-06-20,502,iphone 15 pro max,100000,135000,35000,1,00376,India
177146,2023-06-20,505,oven,18490,24000,5510,1,00376,India
965299,2023-06-20,501,iphone 15,60000,80000,20000,1,00048,India
824626,2023-06-20,505,oven,18490,24000,5510,1,00072,India
865402,2023-06-20,501,iphone 15,60000,80000,20000,1,00204,India
865402,2023-06-20,507,washing machine,6990,16490,9500,1,00204,India
563498,2023-06-20,502,iphone 15 pro max,100000,135000,35000,1,00353,India
563498,2023-06-20,507,washing machine,6990,16490,9500,1,00353,India
563498,2023-06-20,503,mixer,1349,3249,1900,1,00353,India
728867,2023-06-20,504,iron,449,879,430,1,00328,India
612596,2023-06-20,501,iphone 15,60000,80000,20000,1,00031,India
493051,2023-06-20,504,iron,449,879,430,1,00204,India
493051,2023-06-20,502,iphone 15 pro max,100000,135000,35000,1,00204,India
493051,2023-06-20,507,washing machine,6990,16490,9500,1,00204,India
493051,2023-06-20,506,monitor,3249,8000,4751,1,00204,India
334492,2023-06-20,504,iron,449,879,430,1,00214,India
270324,2023-06-20,505,oven,18490,24000,5510,1,00004,India
270324,2023-06-20,507,washing machine,6990,16490,9500,1,00004,India
270324,2023-06-20,504,iron,449,879,430,1,00004,India
359850,2023-06-20,504,iron,449,879,430,1,00130,India
552594,2023-06-20,503,mixer,1349,3249,1900,1,00099,India
552594,2023-06-20,504,iron,449,879,430,1,00099,India
552594,2023-06-20,502,iphone 15 pro max,100000,135000,35000,1,00099,India
552594,2023-06-20,501,iphone 15,60000,80000,20000,1,00099,India
135609,2023-06-20,503,mixer,1349,3249,1900,1,00179,India
135609,2023-06-20,502,iphone 15 pro max,100000,135000,35000,1,00179,India
135609,2023-06-20,506,monitor,3249,8000,4751,1,00179,India
135609,2023-06-20,507,washing machine,6990,16490,9500,1,00179,India
323735,2023-06-20,503,mixer,1349,3249,1900,1,00059,India
323735,2023-06-20,501,iphone 15,60000,80000,20000,1,00059,India
191472,2023-06-20,502,iphone 15 pro max,100000,135000,35000,1,00036,India
191472,2023-06-20,506,monitor,3249,8000,4751,1,00036,India
191472,2023-06-20,507,washing machine,6990,16490,9500,1,00036,India
191472,2023-06-20,505,oven,18490,24000,5510,1,00036,India
771788,2023-06-20,502,iphone 15 pro max,100000,135000,35000,1,00178,India
771788,2023-06-20,507,washing machine,6990,16490,9500,1,00178,India
771788,2023-06-20,501,iphone 15,60000,80000,20000,1,00178,India
165415,2023-06-20,506,monitor,3249,8000,4751,1,00153,India
165415,2023-06-20,502,iphone 15 pro max,100000,135000,35000,1,00153,India
958139,2023-06-20,502,iphone 15 pro max,100000,135000,35000,1,00348,India
958139,2023-06-20,501,iphone 15,60000,80000,20000,1,00348,India
958139,2023-06-20,507,washing machine,6990,16490,9500,1,00348,India
674579,2023-06-20,503,mixer,1349,3249,1900,1,00421,India
137298,2023-06-20,502,iphone 15 pro max,100000,135000,35000,1,00331,India
137298,2023-06-20,504,iron,449,879,430,1,00331,India
137298,2023-06-20,506,monitor,3249,8000,4751,1,00331,India
157374,2023-06-20,504,iron,449,879,430,1,00285,India
157374,2023-06-20,501,iphone 15,60000,80000,20000,1,00285,India
157374,2023-06-20,502,iphone 15 pro max,100000,135000,35000,1,00285,India
247304,2023-06-20,505,oven,18490,24000,5510,1,00113,India
247304,2023-06-20,503,mixer,1349,3249,1900,1,00113,India
247304,2023-06-20,507,washing machine,6990,16490,9500,1,00113,India
247304,2023-06-20,506,monitor,3249,8000,4751,1,00113,India
445792,2023-06-20,507,washing machine,6990,16490,9500,1,00101,India
445792,2023-06-20,501,iphone 15,60000,80000,20000,1,00101,India
445792,2023-06-20,506,monitor,3249,8000,4751,1,00101,India
445792,2023-06-20,503,mixer,1349,3249,1900,1,00101,India
431556,2023-06-20,505,oven,18490,24000,5510,1,00465,India
431556,2023-06-20,503,mixer,1349,3249,1900,1,00465,India
431556,2023-06-20,504,iron,449,879,430,1,00465,India
431556,2023-06-20,502,iphone 15 pro max,100000,135000,35000,1,00465,India
731250,2023-06-20,505,oven,18490,24000,5510,1,00112,India
731250,2023-06-20,502,iphone 15 pro max,100000,135000,35000,1,00112,India
731250,2023-06-20,507,washing machine,6990,16490,9500,1,00112,India
833084,2023-06-20,502,iphone 15 pro max,100000,135000,35000,1,00368,India
833084,2023-06-20,504,iron,449,879,430,1,00368,India
918304,2023-06-20,507,washing machine,6990,16490,9500,1,00262,India
918304,2023-06-20,503,mixer,1349,3249,1900,1,00262,India
123113,2023-06-20,502,iphone 15 pro max,100000,135000,35000,1,00135,India
590545,2023-06-20,507,washing machine,6990,16490,9500,1,00302,India
590545,2023-06-20,506,monitor,3249,8000,4751,1,00302,India
674172,2023-06-20,502,iphone 15 pro max,100000,135000,35000,1,00369,India
186564,2023-06-20,503,mixer,1349,3249,1900,1,00404,India
186564,2023-06-20,502,iphone 15 pro max,100000,135000,35000,1,00404,India
519247,2023-06-20,502,iphone 15 pro max,100000,135000,35000,1,00209,India
519247,2023-06-20,503,mixer,1349,3249,1900,1,00209,India
543223,2023-06-20,506,monitor,3249,8000,4751,1,00084,India
543223,2023-06-20,507,washing machine,6990,16490,9500,1,00084,India
543223,2023-06-20,505,oven,18490,24000,5510,1,00084,India
604920,2023-06-20,505,oven,18490,24000,5510,1,00213,India
506633,2023-06-20,502,iphone 15 pro max,100000,135000,35000,1,00215,India
249244,2023-06-20,502,iphone 15 pro max,100000,135000,35000,1,00497,India
462352,2023-06-20,501,iphone 15,60000,80000,20000,1,00174,India
462352,2023-06-20,507,washing machine,6990,16490,9500,1,00174,India
462352,2023-06-20,504,iron,449,879,430,1,00174,India
959438,2023-06-20,504,iron,449,879,430,1,00036,India
959438,2023-06-20,503,mixer,1349,3249,1900,1,00036,India
504373,2023-06-20,502,iphone 15 pro max,100000,135000,35000,1,00158,India
504373,2023-06-20,506,monitor,3249,8000,4751,1,00158,India
504373,2023-06-20,501,iphone 15,60000,80000,20000,1,00158,India
619174,2023-06-20,505,oven,18490,24000,5510,1,00174,India
619174,2023-06-20,507,washing machine,6990,16490,9500,1,00174,India
913386,2023-06-20,503,mixer,1349,3249,1900,1,00225,India
736700,2023-06-20,501,iphone 15,60000,80000,20000,1,00497,India
782196,2023-06-20,507,washing machine,6990,16490,9500,1,00070,India
782196,2023-06-20,505,oven,18490,24000,5510,1,00070,India
472514,2023-06-20,507,washing machine,6990,16490,9500,1,00141,India
472514,2023-06-20,504,iron,449,879,430,1,00141,India
472514,2023-06-20,505,oven,18490,24000,5510,1,00141,India
292677,2023-06-20,507,washing machine,6990,16490,9500,1,00374,India
292677,2023-06-20,505,oven,18490,24000,5510,1,00374,India
129189,2023-06-20,501,iphone 15,60000,80000,20000,1,00474,India
129189,2023-06-20,503,mixer,1349,3249,1900,1,00474,India
129189,2023-06-20,506,monitor,3249,8000,4751,1,00474,India
496753,2023-06-20,507,washing machine,6990,16490,9500,1,00362,India
276348,2023-06-20,507,washing machine,6990,16490,9500,1,00044,India
276348,2023-06-20,502,iphone 15 pro max,100000,135000,35000,1,00044,India
276348,2023-06-20,506,monitor,3249,8000,4751,1,00044,India
983075,2023-06-20,507,washing machine,6990,16490,9500,1,00225,India
686877,2023-06-20,504,iron,449,879,430,1,00251,India
686877,2023-06-20,503,mixer,1349,3249,1900,1,00251,India
511737,2023-06-20,502,iphone 15 pro max,100000,135000,35000,1,00130,India
511737,2023-06-20,507,washing machine,6990,16490,9500,1,00130,India
254532,2023-06-20,503,mixer,1349,3249,1900,1,00334,India
254532,2023-06-20,502,iphone 15 pro max,100000,135000,35000,1,00334,India
254532,2023-06-20,505,oven,18490,24000,5510,1,00334,India
107738,2023-06-20,507,washing machine,6990,16490,9500,1,00462,India
427282,2023-06-20,501,iphone 15,60000,80000,20000,1,00373,India
427282,2023-06-20,507,washing machine,6990,16490,9500,1,00373,India
682845,2023-06-20,505,oven,18490,24000,5510,1,00388,India
682845,2023-06-20,507,washing machine,6990,16490,9500,1,00388,India
125625,2023-06-21,507,washing machine,6990,16490,9500,1,00350,India
125625,2023-06-21,501,iphone 15,60000,80000,20000,1,00350,India
125625,2023-06-21,504,iron,449,879,430,1,00350,India
125625,2023-06-21,505,oven,18490,24000,5510,1,00350,India
566663,2023-06-21,507,washing machine,6990,16490,9500,1,00456,India
566663,2023-06-21,503,mixer,1349,3249,1900,1,00456,India
566663,2023-06-21,504,iron,449,879,430,1,00456,India
404969,2023-06-21,503,mixer,1349,3249,1900,1,00324,India
404969,2023-06-21,507,washing machine,6990,16490,9500,1,00324,India
404969,2023-06-21,501,iphone 15,60000,80000,20000,1,00324,India
138113,2023-06-21,507,washing machine,6990,16490,9500,1,00265,India
138113,2023-06-21,503,mixer,1349,3249,1900,1,00265,India
752599,2023-06-21,507,washing machine,6990,16490,9500,1,00028,India
752599,2023-06-21,506,monitor,3249,8000,4751,1,00028,India
752599,2023-06-21,505,oven,18490,24000,5510,1,00028,India
458552,2023-06-21,505,oven,18490,24000,5510,1,00497,India
458552,2023-06-21,504,iron,449,879,430,1,00497,India
458552,2023-06-21,506,monitor,3249,8000,4751,1,00497,India
458552,2023-06-21,503,mixer,1349,3249,1900,1,00497,India
458552,2023-06-21,502,iphone 15 pro max,100000,135000,35000,1,00497,India
641197,2023-06-21,503,mixer,1349,3249,1900,1,00275,India
641197,2023-06-21,505,oven,18490,24000,5510,1,00275,India
591765,2023-06-21,504,iron,449,879,430,1,00115,India
591765,2023-06-21,503,mixer,1349,3249,1900,1,00115,India
591765,2023-06-21,505,oven,18490,24000,5510,1,00115,India
257784,2023-06-21,502,iphone 15 pro max,100000,135000,35000,1,00350,India
437375,2023-06-21,506,monitor,3249,8000,4751,1,00218,India
921326,2023-06-21,505,oven,18490,24000,5510,1,00333,India
143916,2023-06-21,504,iron,449,879,430,1,00469,India
143916,2023-06-21,503,mixer,1349,3249,1900,1,00469,India
859726,2023-06-21,507,washing machine,6990,16490,9500,1,00130,India
859726,2023-06-21,504,iron,449,879,430,1,00130,India
859726,2023-06-21,501,iphone 15,60000,80000,20000,1,00130,India
370877,2023-06-21,505,oven,18490,24000,5510,1,00168,India
370877,2023-06-21,503,mixer,1349,3249,1900,1,00168,India
370877,2023-06-21,501,iphone 15,60000,80000,20000,1,00168,India
370877,2023-06-21,506,monitor,3249,8000,4751,1,00168,India
914820,2023-06-21,504,iron,449,879,430,1,00194,India
616003,2023-06-21,504,iron,449,879,430,1,00082,India
291527,2023-06-21,501,iphone 15,60000,80000,20000,1,00475,India
291527,2023-06-21,502,iphone 15 pro max,100000,135000,35000,1,00475,India
408846,2023-06-21,501,iphone 15,60000,80000,20000,1,00447,India
408846,2023-06-21,503,mixer,1349,3249,1900,1,00447,India
408846,2023-06-21,502,iphone 15 pro max,100000,135000,35000,1,00447,India
408846,2023-06-21,504,iron,449,879,430,1,00447,India
284382,2023-06-21,504,iron,449,879,430,1,00118,India
724125,2023-06-21,501,iphone 15,60000,80000,20000,1,00416,India
869893,2023-06-21,503,mixer,1349,3249,1900,1,00453,India
869893,2023-06-21,506,monitor,3249,8000,4751,1,00453,India
869893,2023-06-21,507,washing machine,6990,16490,9500,1,00453,India
483032,2023-06-21,503,mixer,1349,3249,1900,1,00402,India
483032,2023-06-21,507,washing machine,6990,16490,9500,1,00402,India
987143,2023-06-21,504,iron,449,879,430,1,00483,India
987143,2023-06-21,501,iphone 15,60000,80000,20000,1,00483,India
987143,2023-06-21,503,mixer,1349,3249,1900,1,00483,India
497666,2023-06-21,504,iron,449,879,430,1,00119,India
497666,2023-06-21,507,washing machine,6990,16490,9500,1,00119,India
497666,2023-06-21,502,iphone 15 pro max,100000,135000,35000,1,00119,India
497666,2023-06-21,503,mixer,1349,3249,1900,1,00119,India
587141,2023-06-21,506,monitor,3249,8000,4751,1,00046,India
241544,2023-06-21,504,iron,449,879,430,1,00026,India
241544,2023-06-21,501,iphone 15,60000,80000,20000,1,00026,India
241544,2023-06-21,507,washing machine,6990,16490,9500,1,00026,India
241544,2023-06-21,503,mixer,1349,3249,1900,1,00026,India
571007,2023-06-21,503,mixer,1349,3249,1900,1,00243,India
571007,2023-06-21,502,iphone 15 pro max,100000,135000,35000,1,00243,India
642741,2023-06-21,506,monitor,3249,8000,4751,1,00483,India
642741,2023-06-21,503,mixer,1349,3249,1900,1,00483,India
642741,2023-06-21,501,iphone 15,60000,80000,20000,1,00483,India
669169,2023-06-21,501,iphone 15,60000,80000,20000,1,00487,India
669169,2023-06-21,503,mixer,1349,3249,1900,1,00487,India
669169,2023-06-21,507,washing machine,6990,16490,9500,1,00487,India
750821,2023-06-21,504,iron,449,879,430,1,00030,India
750821,2023-06-21,505,oven,18490,24000,5510,1,00030,India
145336,2023-06-21,504,iron,449,879,430,1,00201,India
145336,2023-06-21,501,iphone 15,60000,80000,20000,1,00201,India
153329,2023-06-21,502,iphone 15 pro max,100000,135000,35000,1,00361,India
376135,2023-06-21,504,iron,449,879,430,1,00391,India
945396,2023-06-21,501,iphone 15,60000,80000,20000,1,00012,India
945396,2023-06-21,506,monitor,3249,8000,4751,1,00012,India
945396,2023-06-21,502,iphone 15 pro max,100000,135000,35000,1,00012,India
183475,2023-06-21,501,iphone 15,60000,80000,20000,1,00478,India
472100,2023-06-21,502,iphone 15 pro max,100000,135000,35000,1,00409,India
472100,2023-06-21,506,monitor,3249,8000,4751,1,00409,India
472100,2023-06-21,501,iphone 15,60000,80000,20000,1,00409,India
150027,2023-06-21,503,mixer,1349,3249,1900,1,00259,India
150027,2023-06-21,502,iphone 15 pro max,100000,135000,35000,1,00259,India
150027,2023-06-21,507,washing machine,6990,16490,9500,1,00259,India
150027,2023-06-21,501,iphone 15,60000,80000,20000,1,00259,India
526633,2023-06-21,504,iron,449,879,430,1,00188,India
526633,2023-06-21,502,iphone 15 pro max,100000,135000,35000,1,00188,India
526633,2023-06-21,506,monitor,3249,8000,4751,1,00188,India
785987,2023-06-21,502,iphone 15 pro max,100000,135000,35000,1,00159,India
283169,2023-06-21,504,iron,449,879,430,1,00030,India
283169,2023-06-21,507,washing machine,6990,16490,9500,1,00030,India
265665,2023-06-21,507,washing machine,6990,16490,9500,1,00343,India
581062,2023-06-21,507,washing machine,6990,16490,9500,1,00084,India
581062,2023-06-21,504,iron,449,879,430,1,00084,India
581062,2023-06-21,505,oven,18490,24000,5510,1,00084,India
581062,2023-06-21,503,mixer,1349,3249,1900,1,00084,India
458908,2023-06-21,506,monitor,3249,8000,4751,1,00396,India
835271,2023-06-21,506,monitor,3249,8000,4751,1,00421,India
835271,2023-06-21,507,washing machine,6990,16490,9500,1,00421,India
835271,2023-06-21,503,mixer,1349,3249,1900,1,00421,India
187179,2023-06-21,506,monitor,3249,8000,4751,1,00155,India
187179,2023-06-21,501,iphone 15,60000,80000,20000,1,00155,India
701671,2023-06-21,502,iphone 15 pro max,100000,135000,35000,1,00110,India
701671,2023-06-21,507,washing machine,6990,16490,9500,1,00110,India
701671,2023-06-21,503,mixer,1349,3249,1900,1,00110,India
758346,2023-06-21,505,oven,18490,24000,5510,1,00157,India
758346,2023-06-21,503,mixer,1349,3249,1900,1,00157,India
758346,2023-06-21,504,iron,449,879,430,1,00157,India
758346,2023-06-21,507,washing machine,6990,16490,9500,1,00157,India
223411,2023-06-21,507,washing machine,6990,16490,9500,1,00167,India
223411,2023-06-21,506,monitor,3249,8000,4751,1,00167,India
223411,2023-06-21,502,iphone 15 pro max,100000,135000,35000,1,00167,India
109392,2023-06-21,506,monitor,3249,8000,4751,1,00039,India
961006,2023-06-21,506,monitor,3249,8000,4751,1,00352,India
961006,2023-06-21,502,iphone 15 pro max,100000,135000,35000,1,00352,India
961006,2023-06-21,503,mixer,1349,3249,1900,1,00352,India
961006,2023-06-21,505,oven,18490,24000,5510,1,00352,India
212377,2023-06-21,502,iphone 15 pro max,100000,135000,35000,1,00237,India
212377,2023-06-21,501,iphone 15,60000,80000,20000,1,00237,India
212377,2023-06-21,507,washing machine,6990,16490,9500,1,00237,India
878372,2023-06-21,504,iron,449,879,430,1,00473,India
878372,2023-06-21,501,iphone 15,60000,80000,20000,1,00473,India
930108,2023-06-21,502,iphone 15 pro max,100000,135000,35000,1,00113,India
930108,2023-06-21,503,mixer,1349,3249,1900,1,00113,India
394055,2023-06-21,502,iphone 15 pro max,100000,135000,35000,1,00118,India
394055,2023-06-21,504,iron,449,879,430,1,00118,India
168277,2023-06-21,504,iron,449,879,430,1,00330,India
804681,2023-06-22,504,iron,449,879,430,1,00116,India
514128,2023-06-22,507,washing machine,6990,16490,9500,1,00106,India
514128,2023-06-22,502,iphone 15 pro max,100000,135000,35000,1,00106,India
856839,2023-06-22,501,iphone 15,60000,80000,20000,1,00056,India
263509,2023-06-22,501,iphone 15,60000,80000,20000,1,00353,India
188365,2023-06-22,507,washing machine,6990,16490,9500,1,00281,India
188365,2023-06-22,501,iphone 15,60000,80000,20000,1,00281,India
882909,2023-06-22,504,iron,449,879,430,1,00042,India
882909,2023-06-22,503,mixer,1349,3249,1900,1,00042,India
882909,2023-06-22,506,monitor,3249,8000,4751,1,00042,India
882909,2023-06-22,501,iphone 15,60000,80000,20000,1,00042,India
672877,2023-06-22,506,monitor,3249,8000,4751,1,00393,India
672877,2023-06-22,505,oven,18490,24000,5510,1,00393,India
334780,2023-06-22,504,iron,449,879,430,1,00387,India
894103,2023-06-22,505,oven,18490,24000,5510,1,00364,India
894103,2023-06-22,501,iphone 15,60000,80000,20000,1,00364,India
894103,2023-06-22,503,mixer,1349,3249,1900,1,00364,India
894103,2023-06-22,502,iphone 15 pro max,100000,135000,35000,1,00364,India
607938,2023-06-22,504,iron,449,879,430,1,00233,India
607938,2023-06-22,501,iphone 15,60000,80000,20000,1,00233,India
618899,2023-06-22,502,iphone 15 pro max,100000,135000,35000,1,00124,India
618899,2023-06-22,504,iron,449,879,430,1,00124,India
618899,2023-06-22,507,washing machine,6990,16490,9500,1,00124,India
159099,2023-06-22,501,iphone 15,60000,80000,20000,1,00316,India
159099,2023-06-22,505,oven,18490,24000,5510,1,00316,India
159099,2023-06-22,506,monitor,3249,8000,4751,1,00316,India
159099,2023-06-22,502,iphone 15 pro max,100000,135000,35000,1,00316,India
555112,2023-06-22,501,iphone 15,60000,80000,20000,1,00219,India
446186,2023-06-22,503,mixer,1349,3249,1900,1,00120,India
763337,2023-06-22,502,iphone 15 pro max,100000,135000,35000,1,00072,India
763337,2023-06-22,504,iron,449,879,430,1,00072,India
763337,2023-06-22,507,washing machine,6990,16490,9500,1,00072,India
638152,2023-06-22,504,iron,449,879,430,1,00297,India
638152,2023-06-22,506,monitor,3249,8000,4751,1,00297,India
638152,2023-06-22,507,washing machine,6990,16490,9500,1,00297,India
638152,2023-06-22,503,mixer,1349,3249,1900,1,00297,India
755325,2023-06-22,501,iphone 15,60000,80000,20000,1,00160,India
755325,2023-06-22,505,oven,18490,24000,5510,1,00160,India
755325,2023-06-22,502,iphone 15 pro max,100000,135000,35000,1,00160,India
481355,2023-06-22,503,mixer,1349,3249,1900,1,00194,India
481355,2023-06-22,507,washing machine,6990,16490,9500,1,00194,India
481355,2023-06-22,506,monitor,3249,8000,4751,1,00194,India
320453,2023-06-22,507,washing machine,6990,16490,9500,1,00142,India
320453,2023-06-22,502,iphone 15 pro max,100000,135000,35000,1,00142,India
161421,2023-06-22,503,mixer,1349,3249,1900,1,00279,India
161421,2023-06-22,501,iphone 15,60000,80000,20000,1,00279,India
161421,2023-06-22,506,monitor,3249,8000,4751,1,00279,India
612479,2023-06-22,501,iphone 15,60000,80000,20000,1,00346,India
612479,2023-06-22,502,iphone 15 pro max,100000,135000,35000,1,00346,India
929924,2023-06-22,502,iphone 15 pro max,100000,135000,35000,1,00184,India
929924,2023-06-22,507,washing machine,6990,16490,9500,1,00184,India
406234,2023-06-22,501,iphone 15,60000,80000,20000,1,00160,India
406234,2023-06-22,504,iron,449,879,430,1,00160,India
414648,2023-06-22,507,washing machine,6990,16490,9500,1,00069,India
159216,2023-06-22,506,monitor,3249,8000,4751,1,00406,India
159216,2023-06-22,504,iron,449,879,430,1,00406,India
159216,2023-06-22,505,oven,18490,24000,5510,1,00406,India
930489,2023-06-22,504,iron,449,879,430,1,00151,India
582765,2023-06-22,506,monitor,3249,8000,4751,1,00279,India
582765,2023-06-22,507,washing machine,6990,16490,9500,1,00279,India
582765,2023-06-22,502,iphone 15 pro max,100000,135000,35000,1,00279,India
582765,2023-06-22,503,mixer,1349,3249,1900,1,00279,India
582765,2023-06-22,505,oven,18490,24000,5510,1,00279,India
496150,2023-06-22,501,iphone 15,60000,80000,20000,1,00458,India
496150,2023-06-22,502,iphone 15 pro max,100000,135000,35000,1,00458,India
291027,2023-06-22,504,iron,449,879,430,1,00010,India
750639,2023-06-22,506,monitor,3249,8000,4751,1,00264,India
401438,2023-06-22,501,iphone 15,60000,80000,20000,1,00201,India
545417,2023-06-22,507,washing machine,6990,16490,9500,1,00036,India
614955,2023-06-22,505,oven,18490,24000,5510,1,00235,India
614955,2023-06-22,503,mixer,1349,3249,1900,1,00235,India
614955,2023-06-22,501,iphone 15,60000,80000,20000,1,00235,India
541299,2023-06-22,501,iphone 15,60000,80000,20000,1,00479,India
541299,2023-06-22,504,iron,449,879,430,1,00479,India
963972,2023-06-22,505,oven,18490,24000,5510,1,00171,India
963972,2023-06-22,507,washing machine,6990,16490,9500,1,00171,India
500339,2023-06-22,502,iphone 15 pro max,100000,135000,35000,1,00277,India
500339,2023-06-22,501,iphone 15,60000,80000,20000,1,00277,India
500339,2023-06-22,504,iron,449,879,430,1,00277,India
242064,2023-06-22,504,iron,449,879,430,1,00322,India
242064,2023-06-22,505,oven,18490,24000,5510,1,00322,India
925921,2023-06-22,502,iphone 15 pro max,100000,135000,35000,1,00251,India
925921,2023-06-22,507,washing machine,6990,16490,9500,1,00251,India
925921,2023-06-22,501,iphone 15,60000,80000,20000,1,00251,India
925921,2023-06-22,506,monitor,3249,8000,4751,1,00251,India
345172,2023-06-22,506,monitor,3249,8000,4751,1,00236,India
172850,2023-06-22,505,oven,18490,24000,5510,1,00111,India
172850,2023-06-22,502,iphone 15 pro max,100000,135000,35000,1,00111,India
172850,2023-06-22,506,monitor,3249,8000,4751,1,00111,India
648486,2023-06-22,507,washing machine,6990,16490,9500,1,00098,India
648486,2023-06-22,504,iron,449,879,430,1,00098,India
247654,2023-06-22,503,mixer,1349,3249,1900,1,00267,India
247654,2023-06-22,507,washing machine,6990,16490,9500,1,00267,India
247654,2023-06-22,505,oven,18490,24000,5510,1,00267,India
713899,2023-06-22,507,washing machine,6990,16490,9500,1,00431,India
713899,2023-06-22,504,iron,449,879,430,1,00431,India
356168,2023-06-22,505,oven,18490,24000,5510,1,00081,India
712879,2023-06-22,507,washing machine,6990,16490,9500,1,00016,India
712879,2023-06-22,502,iphone 15 pro max,100000,135000,35000,1,00016,India
552698,2023-06-22,501,iphone 15,60000,80000,20000,1,00045,India
552698,2023-06-22,506,monitor,3249,8000,4751,1,00045,India
381896,2023-06-22,503,mixer,1349,3249,1900,1,00334,India
381896,2023-06-22,501,iphone 15,60000,80000,20000,1,00334,India
691678,2023-06-22,505,oven,18490,24000,5510,1,00370,India
691678,2023-06-22,503,mixer,1349,3249,1900,1,00370,India
994068,2023-06-22,506,monitor,3249,8000,4751,1,00240,India
994068,2023-06-22,503,mixer,1349,3249,1900,1,00240,India
286710,2023-06-22,505,oven,18490,24000,5510,1,00499,India
286710,2023-06-22,502,iphone 15 pro max,100000,135000,35000,1,00499,India
628781,2023-06-22,502,iphone 15 pro max,100000,135000,35000,1,00423,India
359552,2023-06-22,505,oven,18490,24000,5510,1,00238,India
965614,2023-06-22,503,mixer,1349,3249,1900,1,00073,India
381471,2023-06-22,504,iron,449,879,430,1,00382,India
648262,2023-06-22,502,iphone 15 pro max,100000,135000,35000,1,00148,India
648262,2023-06-22,501,iphone 15,60000,80000,20000,1,00148,India
204923,2023-06-22,505,oven,18490,24000,5510,1,00193,India
204923,2023-06-22,502,iphone 15 pro max,100000,135000,35000,1,00193,India
408312,2023-06-22,502,iphone 15 pro max,100000,135000,35000,1,00284,India
408312,2023-06-22,503,mixer,1349,3249,1900,1,00284,India
408312,2023-06-22,507,washing machine,6990,16490,9500,1,00284,India
511962,2023-06-22,503,mixer,1349,3249,1900,1,00069,India
128890,2023-06-22,502,iphone 15 pro max,100000,135000,35000,1,00372,India
250537,2023-06-22,503,mixer,1349,3249,1900,1,00488,India
262558,2023-06-22,503,mixer,1349,3249,1900,1,00265,India
262558,2023-06-22,501,iphone 15,60000,80000,20000,1,00265,India
262558,2023-06-22,506,monitor,3249,8000,4751,1,00265,India
345935,2023-06-22,506,monitor,3249,8000,4751,1,00417,India
345935,2023-06-22,504,iron,449,879,430,1,00417,India
648564,2023-06-22,505,oven,18490,24000,5510,1,00487,India
622702,2023-06-22,506,monitor,3249,8000,4751,1,00302,India
622702,2023-06-22,503,mixer,1349,3249,1900,1,00302,India
622702,2023-06-22,504,iron,449,879,430,1,00302,India
622702,2023-06-22,507,washing machine,6990,16490,9500,1,00302,India
936021,2023-06-22,504,iron,449,879,430,1,00496,India
936021,2023-06-22,501,iphone 15,60000,80000,20000,1,00496,India
936021,2023-06-22,506,monitor,3249,8000,4751,1,00496,India
901498,2023-06-22,505,oven,18490,24000,5510,1,00496,India
901498,2023-06-22,504,iron,449,879,430,1,00496,India
901498,2023-06-22,503,mixer,1349,3249,1900,1,00496,India
718219,2023-06-22,502,iphone 15 pro max,100000,135000,35000,1,00470,India
661135,2023-06-22,503,mixer,1349,3249,1900,1,00319,India
661135,2023-06-22,501,iphone 15,60000,80000,20000,1,00319,India
661135,2023-06-22,505,oven,18490,24000,5510,1,00319,India
286150,2023-06-22,503,mixer,1349,3249,1900,1,00264,India
286150,2023-06-22,501,iphone 15,60000,80000,20000,1,00264,India
286150,2023-06-22,505,oven,18490,24000,5510,1,00264,India
964043,2023-06-22,507,washing machine,6990,16490,9500,1,00396,India
964043,2023-06-22,504,iron,449,879,430,1,00396,India
964043,2023-06-22,506,monitor,3249,8000,4751,1,00396,India
964043,2023-06-22,503,mixer,1349,3249,1900,1,00396,India
354307,2023-06-22,502,iphone 15 pro max,100000,135000,35000,1,00062,India
578143,2023-06-22,503,mixer,1349,3249,1900,1,00242,India
578143,2023-06-22,504,iron,449,879,430,1,00242,India
578143,2023-06-22,507,washing machine,6990,16490,9500,1,00242,India
370830,2023-06-22,504,iron,449,879,430,1,00416,India
423792,2023-06-22,503,mixer,1349,3249,1900,1,00251,India
897839,2023-06-22,502,iphone 15 pro max,100000,135000,35000,1,00132,India
138811,2023-06-22,505,oven,18490,24000,5510,1,00094,India
138811,2023-06-22,502,iphone 15 pro max,100000,135000,35000,1,00094,India
343690,2023-06-22,502,iphone 15 pro max,100000,135000,35000,1,00399,India
343690,2023-06-22,507,washing machine,6990,16490,9500,1,00399,India
244279,2023-06-22,507,washing machine,6990,16490,9500,1,00435,India
244279,2023-06-22,501,iphone 15,60000,80000,20000,1,00435,India
244279,2023-06-22,505,oven,18490,24000,5510,1,00435,India
718078,2023-06-22,501,iphone 15,60000,80000,20000,1,00398,India
718078,2023-06-22,505,oven,18490,24000,5510,1,00398,India
718078,2023-06-22,504,iron,449,879,430,1,00398,India
490401,2023-06-22,506,monitor,3249,8000,4751,1,00310,India
490401,2023-06-22,505,oven,18490,24000,5510,1,00310,India
490401,2023-06-22,504,iron,449,879,430,1,00310,India
490401,2023-06-22,503,mixer,1349,3249,1900,1,00310,India
269174,2023-06-22,505,oven,18490,24000,5510,1,00291,India
269174,2023-06-22,501,iphone 15,60000,80000,20000,1,00291,India
269174,2023-06-22,507,washing machine,6990,16490,9500,1,00291,India
269174,2023-06-22,503,mixer,1349,3249,1900,1,00291,India
949454,2023-06-22,502,iphone 15 pro max,100000,135000,35000,1,00013,India
949454,2023-06-22,506,monitor,3249,8000,4751,1,00013,India
949454,2023-06-22,507,washing machine,6990,16490,9500,1,00013,India
822292,2023-06-22,503,mixer,1349,3249,1900,1,00318,India
822292,2023-06-22,505,oven,18490,24000,5510,1,00318,India
822292,2023-06-22,504,iron,449,879,430,1,00318,India
822292,2023-06-22,501,iphone 15,60000,80000,20000,1,00318,India
936267,2023-06-22,503,mixer,1349,3249,1900,1,00114,India
936267,2023-06-22,506,monitor,3249,8000,4751,1,00114,India
936267,2023-06-22,504,iron,449,879,430,1,00114,India
504710,2023-06-22,505,oven,18490,24000,5510,1,00276,India
504710,2023-06-22,501,iphone 15,60000,80000,20000,1,00276,India
182535,2023-06-22,506,monitor,3249,8000,4751,1,00198,India
182535,2023-06-22,507,washing machine,6990,16490,9500,1,00198,India
182535,2023-06-22,503,mixer,1349,3249,1900,1,00198,India
521504,2023-06-22,507,washing machine,6990,16490,9500,1,00277,India
521504,2023-06-22,503,mixer,1349,3249,1900,1,00277,India
521504,2023-06-22,504,iron,449,879,430,1,00277,India
521504,2023-06-22,505,oven,18490,24000,5510,1,00277,India
894722,2023-06-23,502,iphone 15 pro max,100000,135000,35000,1,00340,India
894722,2023-06-23,504,iron,449,879,430,1,00340,India
894722,2023-06-23,505,oven,18490,24000,5510,1,00340,India
178960,2023-06-23,505,oven,18490,24000,5510,1,00455,India
178960,2023-06-23,501,iphone 15,60000,80000,20000,1,00455,India
178960,2023-06-23,503,mixer,1349,3249,1900,1,00455,India
178960,2023-06-23,507,washing machine,6990,16490,9500,1,00455,India
974331,2023-06-23,503,mixer,1349,3249,1900,1,00412,India
974331,2023-06-23,504,iron,449,879,430,1,00412,India
974331,2023-06-23,501,iphone 15,60000,80000,20000,1,00412,India
974331,2023-06-23,506,monitor,3249,8000,4751,1,00412,India
974331,2023-06-23,505,oven,18490,24000,5510,1,00412,India
255954,2023-06-23,501,iphone 15,60000,80000,20000,1,00146,India
255954,2023-06-23,507,washing machine,6990,16490,9500,1,00146,India
255954,2023-06-23,504,iron,449,879,430,1,00146,India
387461,2023-06-23,504,iron,449,879,430,1,00436,India
443197,2023-06-23,502,iphone 15 pro max,100000,135000,35000,1,00145,India
273732,2023-06-23,505,oven,18490,24000,5510,1,00104,India
273732,2023-06-23,506,monitor,3249,8000,4751,1,00104,India
388366,2023-06-23,501,iphone 15,60000,80000,20000,1,00243,India
126295,2023-06-23,505,oven,18490,24000,5510,1,00205,India
126295,2023-06-23,502,iphone 15 pro max,100000,135000,35000,1,00205,India
126295,2023-06-23,506,monitor,3249,8000,4751,1,00205,India
809490,2023-06-23,503,mixer,1349,3249,1900,1,00435,India
809490,2023-06-23,505,oven,18490,24000,5510,1,00435,India
809490,2023-06-23,504,iron,449,879,430,1,00435,India
401241,2023-06-23,501,iphone 15,60000,80000,20000,1,00433,India
966372,2023-06-23,504,iron,449,879,430,1,00320,India
966372,2023-06-23,505,oven,18490,24000,5510,1,00320,India
637427,2023-06-23,502,iphone 15 pro max,100000,135000,35000,1,00168,India
224644,2023-06-23,505,oven,18490,24000,5510,1,00116,India
224644,2023-06-23,501,iphone 15,60000,80000,20000,1,00116,India
757476,2023-06-23,507,washing machine,6990,16490,9500,1,00040,India
757476,2023-06-23,501,iphone 15,60000,80000,20000,1,00040,India
757476,2023-06-23,502,iphone 15 pro max,100000,135000,35000,1,00040,India
757476,2023-06-23,505,oven,18490,24000,5510,1,00040,India
757476,2023-06-23,503,mixer,1349,3249,1900,1,00040,India
477492,2023-06-23,503,mixer,1349,3249,1900,1,00414,India
418781,2023-06-23,507,washing machine,6990,16490,9500,1,00363,India
418781,2023-06-23,505,oven,18490,24000,5510,1,00363,India
418781,2023-06-23,502,iphone 15 pro max,100000,135000,35000,1,00363,India
786228,2023-06-23,501,iphone 15,60000,80000,20000,1,00447,India
786228,2023-06-23,504,iron,449,879,430,1,00447,India
631486,2023-06-23,507,washing machine,6990,16490,9500,1,00128,India
631486,2023-06-23,502,iphone 15 pro max,100000,135000,35000,1,00128,India
631486,2023-06-23,505,oven,18490,24000,5510,1,00128,India
843429,2023-06-23,503,mixer,1349,3249,1900,1,00325,India
843429,2023-06-23,502,iphone 15 pro max,100000,135000,35000,1,00325,India
124094,2023-06-23,502,iphone 15 pro max,100000,135000,35000,1,00214,India
124094,2023-06-23,507,washing machine,6990,16490,9500,1,00214,India
124094,2023-06-23,506,monitor,3249,8000,4751,1,00214,India
816312,2023-06-23,506,monitor,3249,8000,4751,1,00220,India
378817,2023-06-23,501,iphone 15,60000,80000,20000,1,00380,India
378817,2023-06-23,506,monitor,3249,8000,4751,1,00380,India
378817,2023-06-23,502,iphone 15 pro max,100000,135000,35000,1,00380,India
155609,2023-06-23,501,iphone 15,60000,80000,20000,1,00293,India
155609,2023-06-23,504,iron,449,879,430,1,00293,India
418523,2023-06-23,503,mixer,1349,3249,1900,1,00096,India
813970,2023-06-23,502,iphone 15 pro max,100000,135000,35000,1,00335,India
640492,2023-06-23,504,iron,449,879,430,1,00353,India
934674,2023-06-23,505,oven,18490,24000,5510,1,00131,India
934674,2023-06-23,503,mixer,1349,3249,1900,1,00131,India
203432,2023-06-23,503,mixer,1349,3249,1900,1,00099,India
203432,2023-06-23,506,monitor,3249,8000,4751,1,00099,India
203432,2023-06-23,501,iphone 15,60000,80000,20000,1,00099,India
816571,2023-06-23,502,iphone 15 pro max,100000,135000,35000,1,00372,India
816571,2023-06-23,505,oven,18490,24000,5510,1,00372,India
816571,2023-06-23,503,mixer,1349,3249,1900,1,00372,India
818150,2023-06-23,501,iphone 15,60000,80000,20000,1,00146,India
818150,2023-06-23,504,iron,449,879,430,1,00146,India
189581,2023-06-23,503,mixer,1349,3249,1900,1,00487,India
189581,2023-06-23,502,iphone 15 pro max,100000,135000,35000,1,00487,India
189581,2023-06-23,501,iphone 15,60000,80000,20000,1,00487,India
884956,2023-06-23,501,iphone 15,60000,80000,20000,1,00039,India
415364,2023-06-23,504,iron,449,879,430,1,00161,India
415364,2023-06-23,503,mixer,1349,3249,1900,1,00161,India
176217,2023-06-23,507,washing machine,6990,16490,9500,1,00410,India
942971,2023-06-23,503,mixer,1349,3249,1900,1,00246,India
942971,2023-06-23,504,iron,449,879,430,1,00246,India
942971,2023-06-23,501,iphone 15,60000,80000,20000,1,00246,India
942971,2023-06-23,506,monitor,3249,8000,4751,1,00246,India
198234,2023-06-23,502,iphone 15 pro max,100000,135000,35000,1,00454,India
541008,2023-06-23,506,monitor,3249,8000,4751,1,00471,India
541008,2023-06-23,501,iphone 15,60000,80000,20000,1,00471,India
541008,2023-06-23,507,washing machine,6990,16490,9500,1,00471,India
541008,2023-06-23,504,iron,449,879,430,1,00471,India
541008,2023-06-23,502,iphone 15 pro max,100000,135000,35000,1,00471,India
924604,2023-06-23,502,iphone 15 pro max,100000,135000,35000,1,00181,India
924604,2023-06-23,504,iron,449,879,430,1,00181,India
868943,2023-06-23,501,iphone 15,60000,80000,20000,1,00197,India
868943,2023-06-23,507,washing machine,6990,16490,9500,1,00197,India
868943,2023-06-23,502,iphone 15 pro max,100000,135000,35000,1,00197,India
895104,2023-06-23,503,mixer,1349,3249,1900,1,00315,India
895104,2023-06-23,504,iron,449,879,430,1,00315,India
895104,2023-06-23,507,washing machine,6990,16490,9500,1,00315,India
658643,2023-06-23,503,mixer,1349,3249,1900,1,00322,India
658643,2023-06-23,504,iron,449,879,430,1,00322,India
174227,2023-06-23,501,iphone 15,60000,80000,20000,1,00116,India
174227,2023-06-23,505,oven,18490,24000,5510,1,00116,India
174227,2023-06-23,503,mixer,1349,3249,1900,1,00116,India
992168,2023-06-23,501,iphone 15,60000,80000,20000,1,00164,India
992168,2023-06-23,503,mixer,1349,3249,1900,1,00164,India
992168,2023-06-23,506,monitor,3249,8000,4751,1,00164,India
992168,2023-06-23,505,oven,18490,24000,5510,1,00164,India
334919,2023-06-23,506,monitor,3249,8000,4751,1,00090,India
334919,2023-06-23,504,iron,449,879,430,1,00090,India
620718,2023-06-23,502,iphone 15 pro max,100000,135000,35000,1,00119,India
620718,2023-06-23,501,iphone 15,60000,80000,20000,1,00119,India
620718,2023-06-23,503,mixer,1349,3249,1900,1,00119,India
369252,2023-06-23,502,iphone 15 pro max,100000,135000,35000,1,00423,India
369252,2023-06-23,503,mixer,1349,3249,1900,1,00423,India
234258,2023-06-23,505,oven,18490,24000,5510,1,00100,India
569533,2023-06-23,507,washing machine,6990,16490,9500,1,00372,India
569533,2023-06-23,504,iron,449,879,430,1,00372,India
569533,2023-06-23,502,iphone 15 pro max,100000,135000,35000,1,00372,India
947162,2023-06-23,504,iron,449,879,430,1,00116,India
795856,2023-06-23,501,iphone 15,60000,80000,20000,1,00170,India
795856,2023-06-23,507,washing machine,6990,16490,9500,1,00170,India
795856,2023-06-23,503,mixer,1349,3249,1900,1,00170,India
965451,2023-06-23,501,iphone 15,60000,80000,20000,1,00482,India
769599,2023-06-23,505,oven,18490,24000,5510,1,00143,India
769599,2023-06-23,506,monitor,3249,8000,4751,1,00143,India
769599,2023-06-23,507,washing machine,6990,16490,9500,1,00143,India
769599,2023-06-23,503,mixer,1349,3249,1900,1,00143,India
765393,2023-06-23,503,mixer,1349,3249,1900,1,00090,India
765393,2023-06-23,504,iron,449,879,430,1,00090,India
765393,2023-06-23,502,iphone 15 pro max,100000,135000,35000,1,00090,India
765393,2023-06-23,507,washing machine,6990,16490,9500,1,00090,India
351848,2023-06-23,507,washing machine,6990,16490,9500,1,00037,India
916759,2023-06-23,504,iron,449,879,430,1,00330,India
916759,2023-06-23,501,iphone 15,60000,80000,20000,1,00330,India
916759,2023-06-23,506,monitor,3249,8000,4751,1,00330,India
916759,2023-06-23,507,washing machine,6990,16490,9500,1,00330,India
567142,2023-06-23,504,iron,449,879,430,1,00371,India
567142,2023-06-23,503,mixer,1349,3249,1900,1,00371,India
907227,2023-06-23,506,monitor,3249,8000,4751,1,00171,India
907227,2023-06-23,507,washing machine,6990,16490,9500,1,00171,India
907227,2023-06-23,501,iphone 15,60000,80000,20000,1,00171,India
907227,2023-06-23,503,mixer,1349,3249,1900,1,00171,India
497152,2023-06-23,501,iphone 15,60000,80000,20000,1,00065,India
497152,2023-06-23,507,washing machine,6990,16490,9500,1,00065,India
633293,2023-06-23,502,iphone 15 pro max,100000,135000,35000,1,00454,India
344272,2023-06-23,503,mixer,1349,3249,1900,1,00214,India
344272,2023-06-23,501,iphone 15,60000,80000,20000,1,00214,India
856959,2023-06-23,507,washing machine,6990,16490,9500,1,00288,India
803407,2023-06-23,503,mixer,1349,3249,1900,1,00308,India
803407,2023-06-23,507,washing machine,6990,16490,9500,1,00308,India
803407,2023-06-23,506,monitor,3249,8000,4751,1,00308,India
803407,2023-06-23,505,oven,18490,24000,5510,1,00308,India
343271,2023-06-23,505,oven,18490,24000,5510,1,00465,India
343271,2023-06-23,503,mixer,1349,3249,1900,1,00465,India
343271,2023-06-23,502,iphone 15 pro max,100000,135000,35000,1,00465,India
343271,2023-06-23,506,monitor,3249,8000,4751,1,00465,India
319450,2023-06-23,506,monitor,3249,8000,4751,1,00367,India
319450,2023-06-23,504,iron,449,879,430,1,00367,India
319450,2023-06-23,507,washing machine,6990,16490,9500,1,00367,India
319450,2023-06-23,505,oven,18490,24000,5510,1,00367,India
839160,2023-06-23,507,washing machine,6990,16490,9500,1,00326,India
839160,2023-06-23,504,iron,449,879,430,1,00326,India
839160,2023-06-23,503,mixer,1349,3249,1900,1,00326,India
540147,2023-06-23,507,washing machine,6990,16490,9500,1,00136,India
540147,2023-06-23,504,iron,449,879,430,1,00136,India
540147,2023-06-23,503,mixer,1349,3249,1900,1,00136,India
269733,2023-06-23,502,iphone 15 pro max,100000,135000,35000,1,00253,India
269733,2023-06-23,501,iphone 15,60000,80000,20000,1,00253,India
269733,2023-06-23,504,iron,449,879,430,1,00253,India
269733,2023-06-23,507,washing machine,6990,16490,9500,1,00253,India
835351,2023-06-23,502,iphone 15 pro max,100000,135000,35000,1,00392,India
835351,2023-06-23,501,iphone 15,60000,80000,20000,1,00392,India
835351,2023-06-23,503,mixer,1349,3249,1900,1,00392,India
835351,2023-06-23,504,iron,449,879,430,1,00392,India
408923,2023-06-23,501,iphone 15,60000,80000,20000,1,00342,India
408923,2023-06-23,502,iphone 15 pro max,100000,135000,35000,1,00342,India
408923,2023-06-23,507,washing machine,6990,16490,9500,1,00342,India
328122,2023-06-23,504,iron,449,879,430,1,00403,India
328122,2023-06-23,503,mixer,1349,3249,1900,1,00403,India
833762,2023-06-23,504,iron,449,879,430,1,00266,India
833762,2023-06-23,502,iphone 15 pro max,100000,135000,35000,1,00266,India
833762,2023-06-23,507,washing machine,6990,16490,9500,1,00266,India
360072,2023-06-23,505,oven,18490,24000,5510,1,00433,India
993978,2023-06-23,507,washing machine,6990,16490,9500,1,00022,India
993978,2023-06-23,506,monitor,3249,8000,4751,1,00022,India
993978,2023-06-23,503,mixer,1349,3249,1900,1,00022,India
993978,2023-06-23,502,iphone 15 pro max,100000,135000,35000,1,00022,India
467423,2023-06-23,503,mixer,1349,3249,1900,1,00285,India
467423,2023-06-23,506,monitor,3249,8000,4751,1,00285,India
586445,2023-06-23,506,monitor,3249,8000,4751,1,00139,India
652365,2023-06-23,504,iron,449,879,430,1,00087,India
652365,2023-06-23,505,oven,18490,24000,5510,1,00087,India
652365,2023-06-23,503,mixer,1349,3249,1900,1,00087,India
652365,2023-06-23,502,iphone 15 pro max,100000,135000,35000,1,00087,India
386260,2023-06-23,503,mixer,1349,3249,1900,1,00144,India
465518,2023-06-23,506,monitor,3249,8000,4751,1,00368,India
465518,2023-06-23,502,iphone 15 pro max,100000,135000,35000,1,00368,India
465518,2023-06-23,503,mixer,1349,3249,1900,1,00368,India
465518,2023-06-23,505,oven,18490,24000,5510,1,00368,India
349966,2023-06-23,504,iron,449,879,430,1,00048,India
349966,2023-06-23,505,oven,18490,24000,5510,1,00048,India
376622,2023-06-23,502,iphone 15 pro max,100000,135000,35000,1,00344,India
376622,2023-06-23,503,mixer,1349,3249,1900,1,00344,India
209577,2023-06-23,507,washing machine,6990,16490,9500,1,00479,India
209577,2023-06-23,503,mixer,1349,3249,1900,1,00479,India
209577,2023-06-23,505,oven,18490,24000,5510,1,00479,India
791371,2023-06-23,503,mixer,1349,3249,1900,1,00319,India
791371,2023-06-23,501,iphone 15,60000,80000,20000,1,00319,India
287377,2023-06-23,506,monitor,3249,8000,4751,1,00378,India
287377,2023-06-23,507,washing machine,6990,16490,9500,1,00378,India
464953,2023-06-23,501,iphone 15,60000,80000,20000,1,00155,India
464953,2023-06-23,507,washing machine,6990,16490,9500,1,00155,India
464953,2023-06-23,502,iphone 15 pro max,100000,135000,35000,1,00155,India
320438,2023-06-23,503,mixer,1349,3249,1900,1,00365,India
206710,2023-06-23,507,washing machine,6990,16490,9500,1,00265,India
275850,2023-06-23,502,iphone 15 pro max,100000,135000,35000,1,00397,India
292977,2023-06-23,505,oven,18490,24000,5510,1,00360,India
292977,2023-06-23,501,iphone 15,60000,80000,20000,1,00360,India
493582,2023-06-23,506,monitor,3249,8000,4751,1,00277,India
394784,2023-06-23,507,washing machine,6990,16490,9500,1,00478,India
394784,2023-06-23,501,iphone 15,60000,80000,20000,1,00478,India
339189,2023-06-23,504,iron,449,879,430,1,00228,India
339189,2023-06-23,505,oven,18490,24000,5510,1,00228,India
417274,2023-06-23,503,mixer,1349,3249,1900,1,00241,India
417274,2023-06-23,504,iron,449,879,430,1,00241,India
417274,2023-06-23,502,iphone 15 pro max,100000,135000,35000,1,00241,India
517941,2023-06-23,507,washing machine,6990,16490,9500,1,00208,India
517941,2023-06-23,502,iphone 15 pro max,100000,135000,35000,1,00208,India
517941,2023-06-23,506,monitor,3249,8000,4751,1,00208,India
866113,2023-06-23,501,iphone 15,60000,80000,20000,1,00342,India
866113,2023-06-23,503,mixer,1349,3249,1900,1,00342,India
866113,2023-06-23,506,monitor,3249,8000,4751,1,00342,India
866113,2023-06-23,505,oven,18490,24000,5510,1,00342,India
290581,2023-06-23,502,iphone 15 pro max,100000,135000,35000,1,00484,India
290581,2023-06-23,506,monitor,3249,8000,4751,1,00484,India
290581,2023-06-23,507,washing machine,6990,16490,9500,1,00484,India
132449,2023-06-23,504,iron,449,879,430,1,00235,India
132449,2023-06-23,505,oven,18490,24000,5510,1,00235,India
132449,2023-06-23,506,monitor,3249,8000,4751,1,00235,India
727422,2023-06-23,502,iphone 15 pro max,100000,135000,35000,1,00294,India
727422,2023-06-23,505,oven,18490,24000,5510,1,00294,India
742867,2023-06-24,503,mixer,1349,3249,1900,1,00158,India
742867,2023-06-24,504,iron,449,879,430,1,00158,India
487770,2023-06-24,504,iron,449,879,430,1,00131,India
487770,2023-06-24,507,washing machine,6990,16490,9500,1,00131,India
995118,2023-06-24,504,iron,449,879,430,1,00310,India
189922,2023-06-24,505,oven,18490,24000,5510,1,00344,India
189922,2023-06-24,501,iphone 15,60000,80000,20000,1,00344,India
189922,2023-06-24,503,mixer,1349,3249,1900,1,00344,India
508860,2023-06-24,506,monitor,3249,8000,4751,1,00342,India
508860,2023-06-24,504,iron,449,879,430,1,00342,India
508860,2023-06-24,502,iphone 15 pro max,100000,135000,35000,1,00342,India
561418,2023-06-24,503,mixer,1349,3249,1900,1,00072,India
561418,2023-06-24,506,monitor,3249,8000,4751,1,00072,India
561418,2023-06-24,505,oven,18490,24000,5510,1,00072,India
561418,2023-06-24,507,washing machine,6990,16490,9500,1,00072,India
361731,2023-06-24,503,mixer,1349,3249,1900,1,00356,India
361731,2023-06-24,505,oven,18490,24000,5510,1,00356,India
381572,2023-06-24,507,washing machine,6990,16490,9500,1,00233,India
381572,2023-06-24,503,mixer,1349,3249,1900,1,00233,India
384447,2023-06-24,507,washing machine,6990,16490,9500,1,00389,India
384447,2023-06-24,506,monitor,3249,8000,4751,1,00389,India
567071,2023-06-24,506,monitor,3249,8000,4751,1,00245,India
567071,2023-06-24,507,washing machine,6990,16490,9500,1,00245,India
567071,2023-06-24,501,iphone 15,60000,80000,20000,1,00245,India
567071,2023-06-24,502,iphone 15 pro max,100000,135000,35000,1,00245,India
389310,2023-06-24,505,oven,18490,24000,5510,1,00013,India
923360,2023-06-24,503,mixer,1349,3249,1900,1,00472,India
306748,2023-06-24,502,iphone 15 pro max,100000,135000,35000,1,00397,India
395394,2023-06-24,504,iron,449,879,430,1,00006,India
376274,2023-06-24,507,washing machine,6990,16490,9500,1,00183,India
376274,2023-06-24,502,iphone 15 pro max,100000,135000,35000,1,00183,India
376274,2023-06-24,503,mixer,1349,3249,1900,1,00183,India
297383,2023-06-24,503,mixer,1349,3249,1900,1,00485,India
297383,2023-06-24,502,iphone 15 pro max,100000,135000,35000,1,00485,India
297383,2023-06-24,501,iphone 15,60000,80000,20000,1,00485,India
297383,2023-06-24,507,washing machine,6990,16490,9500,1,00485,India
960705,2023-06-24,505,oven,18490,24000,5510,1,00296,India
960705,2023-06-24,506,monitor,3249,8000,4751,1,00296,India
829625,2023-06-24,503,mixer,1349,3249,1900,1,00028,India
829625,2023-06-24,501,iphone 15,60000,80000,20000,1,00028,India
493634,2023-06-24,503,mixer,1349,3249,1900,1,00242,India
493634,2023-06-24,507,washing machine,6990,16490,9500,1,00242,India
493634,2023-06-24,506,monitor,3249,8000,4751,1,00242,India
439231,2023-06-24,504,iron,449,879,430,1,00230,India
439231,2023-06-24,502,iphone 15 pro max,100000,135000,35000,1,00230,India
439231,2023-06-24,503,mixer,1349,3249,1900,1,00230,India
439231,2023-06-24,505,oven,18490,24000,5510,1,00230,India
953293,2023-06-24,507,washing machine,6990,16490,9500,1,00052,India
953293,2023-06-24,504,iron,449,879,430,1,00052,India
953293,2023-06-24,505,oven,18490,24000,5510,1,00052,India
782414,2023-06-24,504,iron,449,879,430,1,00109,India
782414,2023-06-24,505,oven,18490,24000,5510,1,00109,India
782414,2023-06-24,507,washing machine,6990,16490,9500,1,00109,India
190722,2023-06-24,505,oven,18490,24000,5510,1,00204,India
202948,2023-06-24,505,oven,18490,24000,5510,1,00033,India
202948,2023-06-24,503,mixer,1349,3249,1900,1,00033,India
202948,2023-06-24,504,iron,449,879,430,1,00033,India
202948,2023-06-24,507,washing machine,6990,16490,9500,1,00033,India
255609,2023-06-24,502,iphone 15 pro max,100000,135000,35000,1,00211,India
255609,2023-06-24,505,oven,18490,24000,5510,1,00211,India
255609,2023-06-24,501,iphone 15,60000,80000,20000,1,00211,India
255609,2023-06-24,507,washing machine,6990,16490,9500,1,00211,India
568219,2023-06-24,507,washing machine,6990,16490,9500,1,00111,India
568219,2023-06-24,501,iphone 15,60000,80000,20000,1,00111,India
568219,2023-06-24,504,iron,449,879,430,1,00111,India
376343,2023-06-24,503,mixer,1349,3249,1900,1,00302,India
662961,2023-06-24,504,iron,449,879,430,1,00404,India
662961,2023-06-24,501,iphone 15,60000,80000,20000,1,00404,India
662961,2023-06-24,502,iphone 15 pro max,100000,135000,35000,1,00404,India
704134,2023-06-24,506,monitor,3249,8000,4751,1,00144,India
704134,2023-06-24,507,washing machine,6990,16490,9500,1,00144,India
704134,2023-06-24,502,iphone 15 pro max,100000,135000,35000,1,00144,India
704134,2023-06-24,501,iphone 15,60000,80000,20000,1,00144,India
704134,2023-06-24,504,iron,449,879,430,1,00144,India
433342,2023-06-24,504,iron,449,879,430,1,00049,India
652454,2023-06-24,507,washing machine,6990,16490,9500,1,00261,India
652454,2023-06-24,503,mixer,1349,3249,1900,1,00261,India
288643,2023-06-24,507,washing machine,6990,16490,9500,1,00339,India
288643,2023-06-24,503,mixer,1349,3249,1900,1,00339,India
288643,2023-06-24,501,iphone 15,60000,80000,20000,1,00339,India
288643,2023-06-24,505,oven,18490,24000,5510,1,00339,India
288643,2023-06-24,506,monitor,3249,8000,4751,1,00339,India
223510,2023-06-24,504,iron,449,879,430,1,00115,India
641689,2023-06-24,502,iphone 15 pro max,100000,135000,35000,1,00284,India
641689,2023-06-24,503,mixer,1349,3249,1900,1,00284,India
262802,2023-06-24,506,monitor,3249,8000,4751,1,00363,India
112860,2023-06-24,503,mixer,1349,3249,1900,1,00311,India
112860,2023-06-24,506,monitor,3249,8000,4751,1,00311,India
112860,2023-06-24,505,oven,18490,24000,5510,1,00311,India
112860,2023-06-24,504,iron,449,879,430,1,00311,India
976001,2023-06-24,502,iphone 15 pro max,100000,135000,35000,1,00048,India
318562,2023-06-24,505,oven,18490,24000,5510,1,00500,India
619183,2023-06-24,505,oven,18490,24000,5510,1,00465,India
619183,2023-06-24,506,monitor,3249,8000,4751,1,00465,India
102438,2023-06-24,506,monitor,3249,8000,4751,1,00053,India
102438,2023-06-24,504,iron,449,879,430,1,00053,India
102438,2023-06-24,505,oven,18490,24000,5510,1,00053,India
459158,2023-06-24,507,washing machine,6990,16490,9500,1,00099,India
459158,2023-06-24,501,iphone 15,60000,80000,20000,1,00099,India
551592,2023-06-24,507,washing machine,6990,16490,9500,1,00163,India
551461,2023-06-24,507,washing machine,6990,16490,9500,1,00335,India
175589,2023-06-24,501,iphone 15,60000,80000,20000,1,00428,India
175589,2023-06-24,506,monitor,3249,8000,4751,1,00428,India
433417,2023-06-24,503,mixer,1349,3249,1900,1,00436,India
433417,2023-06-24,506,monitor,3249,8000,4751,1,00436,India
433417,2023-06-24,504,iron,449,879,430,1,00436,India
177290,2023-06-24,505,oven,18490,24000,5510,1,00128,India
177290,2023-06-24,504,iron,449,879,430,1,00128,India
177290,2023-06-24,506,monitor,3249,8000,4751,1,00128,India
177290,2023-06-24,503,mixer,1349,3249,1900,1,00128,India
933218,2023-06-24,501,iphone 15,60000,80000,20000,1,00039,India
933218,2023-06-24,505,oven,18490,24000,5510,1,00039,India
957128,2023-06-24,502,iphone 15 pro max,100000,135000,35000,1,00005,India
226249,2023-06-24,507,washing machine,6990,16490,9500,1,00214,India
298070,2023-06-24,501,iphone 15,60000,80000,20000,1,00206,India
298070,2023-06-24,504,iron,449,879,430,1,00206,India
200548,2023-06-24,502,iphone 15 pro max,100000,135000,35000,1,00207,India
200548,2023-06-24,505,oven,18490,24000,5510,1,00207,India
200548,2023-06-24,506,monitor,3249,8000,4751,1,00207,India
730501,2023-06-24,502,iphone 15 pro max,100000,135000,35000,1,00438,India
730501,2023-06-24,503,mixer,1349,3249,1900,1,00438,India
730501,2023-06-24,501,iphone 15,60000,80000,20000,1,00438,India
730501,2023-06-24,506,monitor,3249,8000,4751,1,00438,India
532765,2023-06-24,503,mixer,1349,3249,1900,1,00495,India
532765,2023-06-24,507,washing machine,6990,16490,9500,1,00495,India
532765,2023-06-24,504,iron,449,879,430,1,00495,India
813882,2023-06-24,502,iphone 15 pro max,100000,135000,35000,1,00434,India
813882,2023-06-24,505,oven,18490,24000,5510,1,00434,India
583991,2023-06-24,505,oven,18490,24000,5510,1,00332,India
243228,2023-06-24,502,iphone 15 pro max,100000,135000,35000,1,00200,India
243228,2023-06-24,501,iphone 15,60000,80000,20000,1,00200,India
572874,2023-06-24,507,washing machine,6990,16490,9500,1,00179,India
572874,2023-06-24,502,iphone 15 pro max,100000,135000,35000,1,00179,India
572874,2023-06-24,506,monitor,3249,8000,4751,1,00179,India
588862,2023-06-24,506,monitor,3249,8000,4751,1,00099,India
588862,2023-06-24,503,mixer,1349,3249,1900,1,00099,India
588862,2023-06-24,502,iphone 15 pro max,100000,135000,35000,1,00099,India
211141,2023-06-24,503,mixer,1349,3249,1900,1,00315,India
211141,2023-06-24,501,iphone 15,60000,80000,20000,1,00315,India
979773,2023-06-24,507,washing machine,6990,16490,9500,1,00202,India
340617,2023-06-24,501,iphone 15,60000,80000,20000,1,00160,India
340617,2023-06-24,503,mixer,1349,3249,1900,1,00160,India
340617,2023-06-24,504,iron,449,879,430,1,00160,India
340617,2023-06-24,502,iphone 15 pro max,100000,135000,35000,1,00160,India
419005,2023-06-24,501,iphone 15,60000,80000,20000,1,00369,India
104271,2023-06-24,502,iphone 15 pro max,100000,135000,35000,1,00239,India
104271,2023-06-24,501,iphone 15,60000,80000,20000,1,00239,India
466921,2023-06-24,503,mixer,1349,3249,1900,1,00214,India
466921,2023-06-24,502,iphone 15 pro max,100000,135000,35000,1,00214,India
713667,2023-06-24,504,iron,449,879,430,1,00054,India
507839,2023-06-24,502,iphone 15 pro max,100000,135000,35000,1,00238,India
507839,2023-06-24,503,mixer,1349,3249,1900,1,00238,India
984078,2023-06-24,506,monitor,3249,8000,4751,1,00124,India
651804,2023-06-24,501,iphone 15,60000,80000,20000,1,00041,India
651804,2023-06-24,507,washing machine,6990,16490,9500,1,00041,India
272741,2023-06-24,505,oven,18490,24000,5510,1,00013,India
272741,2023-06-24,506,monitor,3249,8000,4751,1,00013,India
272741,2023-06-24,504,iron,449,879,430,1,00013,India
887817,2023-06-24,503,mixer,1349,3249,1900,1,00370,India
303222,2023-06-25,507,washing machine,6990,16490,9500,1,00079,India
303222,2023-06-25,504,iron,449,879,430,1,00079,India
303222,2023-06-25,502,iphone 15 pro max,100000,135000,35000,1,00079,India
303222,2023-06-25,501,iphone 15,60000,80000,20000,1,00079,India
303222,2023-06-25,503,mixer,1349,3249,1900,1,00079,India
291195,2023-06-25,507,washing machine,6990,16490,9500,1,00142,India
291195,2023-06-25,505,oven,18490,24000,5510,1,00142,India
752609,2023-06-25,507,washing machine,6990,16490,9500,1,00296,India
107891,2023-06-25,503,mixer,1349,3249,1900,1,00075,India
107891,2023-06-25,504,iron,449,879,430,1,00075,India
253006,2023-06-25,507,washing machine,6990,16490,9500,1,00496,India
253006,2023-06-25,502,iphone 15 pro max,100000,135000,35000,1,00496,India
253006,2023-06-25,505,oven,18490,24000,5510,1,00496,India
312290,2023-06-25,506,monitor,3249,8000,4751,1,00250,India
491788,2023-06-25,506,monitor,3249,8000,4751,1,00102,India
903739,2023-06-25,505,oven,18490,24000,5510,1,00171,India
903739,2023-06-25,502,iphone 15 pro max,100000,135000,35000,1,00171,India
903739,2023-06-25,504,iron,449,879,430,1,00171,India
903739,2023-06-25,507,washing machine,6990,16490,9500,1,00171,India
499233,2023-06-25,502,iphone 15 pro max,100000,135000,35000,1,00063,India
588212,2023-06-25,505,oven,18490,24000,5510,1,00263,India
588212,2023-06-25,503,mixer,1349,3249,1900,1,00263,India
588212,2023-06-25,507,washing machine,6990,16490,9500,1,00263,India
459091,2023-06-25,507,washing machine,6990,16490,9500,1,00125,India
598141,2023-06-25,506,monitor,3249,8000,4751,1,00174,India
598141,2023-06-25,502,iphone 15 pro max,100000,135000,35000,1,00174,India
598141,2023-06-25,501,iphone 15,60000,80000,20000,1,00174,India
573397,2023-06-25,505,oven,18490,24000,5510,1,00173,India
573397,2023-06-25,501,iphone 15,60000,80000,20000,1,00173,India
573397,2023-06-25,504,iron,449,879,430,1,00173,India
778439,2023-06-25,507,washing machine,6990,16490,9500,1,00310,India
778439,2023-06-25,505,oven,18490,24000,5510,1,00310,India
778439,2023-06-25,502,iphone 15 pro max,100000,135000,35000,1,00310,India
329774,2023-06-25,507,washing machine,6990,16490,9500,1,00289,India
329774,2023-06-25,502,iphone 15 pro max,100000,135000,35000,1,00289,India
847365,2023-06-25,501,iphone 15,60000,80000,20000,1,00294,India
847365,2023-06-25,507,washing machine,6990,16490,9500,1,00294,India
847365,2023-06-25,503,mixer,1349,3249,1900,1,00294,India
376115,2023-06-25,502,iphone 15 pro max,100000,135000,35000,1,00137,India
965300,2023-06-25,507,washing machine,6990,16490,9500,1,00251,India
965300,2023-06-25,503,mixer,1349,3249,1900,1,00251,India
823876,2023-06-25,504,iron,449,879,430,1,00446,India
823876,2023-06-25,505,oven,18490,24000,5510,1,00446,India
823876,2023-06-25,503,mixer,1349,3249,1900,1,00446,India
582759,2023-06-25,507,washing machine,6990,16490,9500,1,00036,India
582759,2023-06-25,502,iphone 15 pro max,100000,135000,35000,1,00036,India
478480,2023-06-25,504,iron,449,879,430,1,00451,India
721580,2023-06-25,504,iron,449,879,430,1,00451,India
721580,2023-06-25,507,washing machine,6990,16490,9500,1,00451,India
228564,2023-06-25,506,monitor,3249,8000,4751,1,00312,India
228564,2023-06-25,507,washing machine,6990,16490,9500,1,00312,India
655176,2023-06-25,503,mixer,1349,3249,1900,1,00157,India
655176,2023-06-25,504,iron,449,879,430,1,00157,India
655176,2023-06-25,506,monitor,3249,8000,4751,1,00157,India
655176,2023-06-25,505,oven,18490,24000,5510,1,00157,India
637659,2023-06-25,502,iphone 15 pro max,100000,135000,35000,1,00442,India
637659,2023-06-25,505,oven,18490,24000,5510,1,00442,India
637659,2023-06-25,504,iron,449,879,430,1,00442,India
637659,2023-06-25,507,washing machine,6990,16490,9500,1,00442,India
637659,2023-06-25,506,monitor,3249,8000,4751,1,00442,India
655413,2023-06-25,507,washing machine,6990,16490,9500,1,00333,India
114016,2023-06-25,505,oven,18490,24000,5510,1,00205,India
114016,2023-06-25,507,washing machine,6990,16490,9500,1,00205,India
114016,2023-06-25,506,monitor,3249,8000,4751,1,00205,India
114016,2023-06-25,502,iphone 15 pro max,100000,135000,35000,1,00205,India
439359,2023-06-25,502,iphone 15 pro max,100000,135000,35000,1,00420,India
439359,2023-06-25,501,iphone 15,60000,80000,20000,1,00420,India
439359,2023-06-25,503,mixer,1349,3249,1900,1,00420,India
668430,2023-06-25,502,iphone 15 pro max,100000,135000,35000,1,00274,India
668430,2023-06-25,507,washing machine,6990,16490,9500,1,00274,India
668430,2023-06-25,501,iphone 15,60000,80000,20000,1,00274,India
668430,2023-06-25,503,mixer,1349,3249,1900,1,00274,India
696982,2023-06-25,506,monitor,3249,8000,4751,1,00191,India
696982,2023-06-25,503,mixer,1349,3249,1900,1,00191,India
696982,2023-06-25,504,iron,449,879,430,1,00191,India
551843,2023-06-25,502,iphone 15 pro max,100000,135000,35000,1,00405,India
551843,2023-06-25,507,washing machine,6990,16490,9500,1,00405,India
143775,2023-06-25,502,iphone 15 pro max,100000,135000,35000,1,00403,India
143775,2023-06-25,501,iphone 15,60000,80000,20000,1,00403,India
232876,2023-06-25,505,oven,18490,24000,5510,1,00382,India
660197,2023-06-25,507,washing machine,6990,16490,9500,1,00217,India
660197,2023-06-25,502,iphone 15 pro max,100000,135000,35000,1,00217,India
660197,2023-06-25,501,iphone 15,60000,80000,20000,1,00217,India
796154,2023-06-25,506,monitor,3249,8000,4751,1,00117,India
796154,2023-06-25,507,washing machine,6990,16490,9500,1,00117,India
861250,2023-06-25,504,iron,449,879,430,1,00058,India
910696,2023-06-25,505,oven,18490,24000,5510,1,00372,India
910696,2023-06-25,507,washing machine,6990,16490,9500,1,00372,India
937442,2023-06-25,501,iphone 15,60000,80000,20000,1,00230,India
937442,2023-06-25,507,washing machine,6990,16490,9500,1,00230,India
367326,2023-06-25,505,oven,18490,24000,5510,1,00126,India
367326,2023-06-25,501,iphone 15,60000,80000,20000,1,00126,India
884988,2023-06-25,502,iphone 15 pro max,100000,135000,35000,1,00447,India
213477,2023-06-25,506,monitor,3249,8000,4751,1,00174,India
213477,2023-06-25,507,washing machine,6990,16490,9500,1,00174,India
213477,2023-06-25,503,mixer,1349,3249,1900,1,00174,India
362724,2023-06-25,504,iron,449,879,430,1,00040,India
362724,2023-06-25,506,monitor,3249,8000,4751,1,00040,India
860585,2023-06-25,505,oven,18490,24000,5510,1,00298,India
874312,2023-06-25,501,iphone 15,60000,80000,20000,1,00276,India
874312,2023-06-25,506,monitor,3249,8000,4751,1,00276,India
816429,2023-06-25,503,mixer,1349,3249,1900,1,00019,India
816429,2023-06-25,505,oven,18490,24000,5510,1,00019,India
816429,2023-06-25,507,washing machine,6990,16490,9500,1,00019,India
390623,2023-06-25,502,iphone 15 pro max,100000,135000,35000,1,00244,India
390623,2023-06-25,506,monitor,3249,8000,4751,1,00244,India
266200,2023-06-25,503,mixer,1349,3249,1900,1,00152,India
266200,2023-06-25,501,iphone 15,60000,80000,20000,1,00152,India
585981,2023-06-25,503,mixer,1349,3249,1900,1,00428,India
750190,2023-06-25,504,iron,449,879,430,1,00304,India
750190,2023-06-25,507,washing machine,6990,16490,9500,1,00304,India
750190,2023-06-25,505,oven,18490,24000,5510,1,00304,India
343064,2023-06-25,505,oven,18490,24000,5510,1,00209,India
838834,2023-06-25,506,monitor,3249,8000,4751,1,00010,India
838834,2023-06-25,507,washing machine,6990,16490,9500,1,00010,India
922543,2023-06-25,502,iphone 15 pro max,100000,135000,35000,1,00444,India
922543,2023-06-25,504,iron,449,879,430,1,00444,India
922543,2023-06-25,507,washing machine,6990,16490,9500,1,00444,India
825509,2023-06-25,504,iron,449,879,430,1,00379,India
825509,2023-06-25,507,washing machine,6990,16490,9500,1,00379,India
825509,2023-06-25,502,iphone 15 pro max,100000,135000,35000,1,00379,India
536836,2023-06-25,505,oven,18490,24000,5510,1,00105,India
536836,2023-06-25,504,iron,449,879,430,1,00105,India
536836,2023-06-25,501,iphone 15,60000,80000,20000,1,00105,India
536836,2023-06-25,506,monitor,3249,8000,4751,1,00105,India
785995,2023-06-25,503,mixer,1349,3249,1900,1,00324,India
785995,2023-06-25,505,oven,18490,24000,5510,1,00324,India
563687,2023-06-25,507,washing machine,6990,16490,9500,1,00267,India
563687,2023-06-25,506,monitor,3249,8000,4751,1,00267,India
563687,2023-06-25,503,mixer,1349,3249,1900,1,00267,India
563687,2023-06-25,505,oven,18490,24000,5510,1,00267,India
650880,2023-06-25,504,iron,449,879,430,1,00465,India
650880,2023-06-25,505,oven,18490,24000,5510,1,00465,India
650880,2023-06-25,506,monitor,3249,8000,4751,1,00465,India
650880,2023-06-25,502,iphone 15 pro max,100000,135000,35000,1,00465,India
823753,2023-06-25,506,monitor,3249,8000,4751,1,00348,India
823753,2023-06-25,507,washing machine,6990,16490,9500,1,00348,India
823753,2023-06-25,504,iron,449,879,430,1,00348,India
823753,2023-06-25,502,iphone 15 pro max,100000,135000,35000,1,00348,India
823753,2023-06-25,503,mixer,1349,3249,1900,1,00348,India
418051,2023-06-25,504,iron,449,879,430,1,00275,India
425288,2023-06-25,504,iron,449,879,430,1,00016,India
425288,2023-06-25,503,mixer,1349,3249,1900,1,00016,India
425288,2023-06-25,501,iphone 15,60000,80000,20000,1,00016,India
425288,2023-06-25,502,iphone 15 pro max,100000,135000,35000,1,00016,India
599979,2023-06-25,507,washing machine,6990,16490,9500,1,00013,India
599979,2023-06-25,504,iron,449,879,430,1,00013,India
599979,2023-06-25,505,oven,18490,24000,5510,1,00013,India
213954,2023-06-25,505,oven,18490,24000,5510,1,00194,India
213954,2023-06-25,502,iphone 15 pro max,100000,135000,35000,1,00194,India
213954,2023-06-25,507,washing machine,6990,16490,9500,1,00194,India
212970,2023-06-25,507,washing machine,6990,16490,9500,1,00439,India
212970,2023-06-25,501,iphone 15,60000,80000,20000,1,00439,India
212970,2023-06-25,503,mixer,1349,3249,1900,1,00439,India
212970,2023-06-25,506,monitor,3249,8000,4751,1,00439,India
404178,2023-06-25,502,iphone 15 pro max,100000,135000,35000,1,00354,India
404178,2023-06-25,507,washing machine,6990,16490,9500,1,00354,India
404178,2023-06-25,503,mixer,1349,3249,1900,1,00354,India
404178,2023-06-25,506,monitor,3249,8000,4751,1,00354,India
896177,2023-06-25,507,washing machine,6990,16490,9500,1,00053,India
896177,2023-06-25,506,monitor,3249,8000,4751,1,00053,India
896177,2023-06-25,503,mixer,1349,3249,1900,1,00053,India
134561,2023-06-25,505,oven,18490,24000,5510,1,00443,India
134561,2023-06-25,502,iphone 15 pro max,100000,135000,35000,1,00443,India
134561,2023-06-25,507,washing machine,6990,16490,9500,1,00443,India
871255,2023-06-25,502,iphone 15 pro max,100000,135000,35000,1,00412,India
871255,2023-06-25,503,mixer,1349,3249,1900,1,00412,India
871255,2023-06-25,505,oven,18490,24000,5510,1,00412,India
535216,2023-06-26,501,iphone 15,60000,80000,20000,1,00045,India
102859,2023-06-26,504,iron,449,879,430,1,00037,India
102859,2023-06-26,505,oven,18490,24000,5510,1,00037,India
102859,2023-06-26,502,iphone 15 pro max,100000,135000,35000,1,00037,India
102859,2023-06-26,507,washing machine,6990,16490,9500,1,00037,India
638593,2023-06-26,504,iron,449,879,430,1,00482,India
638593,2023-06-26,507,washing machine,6990,16490,9500,1,00482,India
638593,2023-06-26,501,iphone 15,60000,80000,20000,1,00482,India
638593,2023-06-26,506,monitor,3249,8000,4751,1,00482,India
327389,2023-06-26,504,iron,449,879,430,1,00110,India
477630,2023-06-26,505,oven,18490,24000,5510,1,00407,India
477630,2023-06-26,504,iron,449,879,430,1,00407,India
617898,2023-06-26,502,iphone 15 pro max,100000,135000,35000,1,00061,India
617898,2023-06-26,506,monitor,3249,8000,4751,1,00061,India
660542,2023-06-26,502,iphone 15 pro max,100000,135000,35000,1,00269,India
660542,2023-06-26,507,washing machine,6990,16490,9500,1,00269,India
884461,2023-06-26,506,monitor,3249,8000,4751,1,00225,India
323546,2023-06-26,503,mixer,1349,3249,1900,1,00100,India
323546,2023-06-26,505,oven,18490,24000,5510,1,00100,India
988895,2023-06-26,503,mixer,1349,3249,1900,1,00452,India
273645,2023-06-26,504,iron,449,879,430,1,00173,India
273645,2023-06-26,502,iphone 15 pro max,100000,135000,35000,1,00173,India
979366,2023-06-26,502,iphone 15 pro max,100000,135000,35000,1,00421,India
979366,2023-06-26,504,iron,449,879,430,1,00421,India
979366,2023-06-26,506,monitor,3249,8000,4751,1,00421,India
841862,2023-06-26,502,iphone 15 pro max,100000,135000,35000,1,00491,India
472798,2023-06-26,506,monitor,3249,8000,4751,1,00365,India
472798,2023-06-26,504,iron,449,879,430,1,00365,India
472798,2023-06-26,502,iphone 15 pro max,100000,135000,35000,1,00365,India
774082,2023-06-26,501,iphone 15,60000,80000,20000,1,00453,India
774082,2023-06-26,506,monitor,3249,8000,4751,1,00453,India
589500,2023-06-26,506,monitor,3249,8000,4751,1,00159,India
589500,2023-06-26,503,mixer,1349,3249,1900,1,00159,India
589500,2023-06-26,505,oven,18490,24000,5510,1,00159,India
627416,2023-06-26,501,iphone 15,60000,80000,20000,1,00219,India
627416,2023-06-26,503,mixer,1349,3249,1900,1,00219,India
627416,2023-06-26,504,iron,449,879,430,1,00219,India
324572,2023-06-26,504,iron,449,879,430,1,00436,India
324572,2023-06-26,501,iphone 15,60000,80000,20000,1,00436,India
983625,2023-06-26,502,iphone 15 pro max,100000,135000,35000,1,00133,India
983625,2023-06-26,501,iphone 15,60000,80000,20000,1,00133,India
983625,2023-06-26,503,mixer,1349,3249,1900,1,00133,India
983625,2023-06-26,505,oven,18490,24000,5510,1,00133,India
263948,2023-06-26,502,iphone 15 pro max,100000,135000,35000,1,00217,India
263948,2023-06-26,507,washing machine,6990,16490,9500,1,00217,India
263948,2023-06-26,505,oven,18490,24000,5510,1,00217,India
994573,2023-06-26,507,washing machine,6990,16490,9500,1,00090,India
625683,2023-06-26,503,mixer,1349,3249,1900,1,00169,India
831030,2023-06-26,506,monitor,3249,8000,4751,1,00233,India
831030,2023-06-26,502,iphone 15 pro max,100000,135000,35000,1,00233,India
118500,2023-06-26,501,iphone 15,60000,80000,20000,1,00434,India
118500,2023-06-26,506,monitor,3249,8000,4751,1,00434,India
141106,2023-06-26,507,washing machine,6990,16490,9500,1,00466,India
141106,2023-06-26,503,mixer,1349,3249,1900,1,00466,India
361593,2023-06-26,507,washing machine,6990,16490,9500,1,00329,India
361593,2023-06-26,506,monitor,3249,8000,4751,1,00329,India
361593,2023-06-26,503,mixer,1349,3249,1900,1,00329,India
361593,2023-06-26,501,iphone 15,60000,80000,20000,1,00329,India
339100,2023-06-26,504,iron,449,879,430,1,00105,India
339100,2023-06-26,501,iphone 15,60000,80000,20000,1,00105,India
339100,2023-06-26,502,iphone 15 pro max,100000,135000,35000,1,00105,India
669555,2023-06-26,503,mixer,1349,3249,1900,1,00226,India
669555,2023-06-26,501,iphone 15,60000,80000,20000,1,00226,India
669555,2023-06-26,506,monitor,3249,8000,4751,1,00226,India
752086,2023-06-26,505,oven,18490,24000,5510,1,00169,India
752086,2023-06-26,502,iphone 15 pro max,100000,135000,35000,1,00169,India
752086,2023-06-26,504,iron,449,879,430,1,00169,India
455252,2023-06-26,505,oven,18490,24000,5510,1,00125,India
455252,2023-06-26,506,monitor,3249,8000,4751,1,00125,India
967348,2023-06-26,501,iphone 15,60000,80000,20000,1,00399,India
967348,2023-06-26,506,monitor,3249,8000,4751,1,00399,India
622659,2023-06-26,501,iphone 15,60000,80000,20000,1,00446,India
622659,2023-06-26,502,iphone 15 pro max,100000,135000,35000,1,00446,India
622659,2023-06-26,507,washing machine,6990,16490,9500,1,00446,India
622659,2023-06-26,505,oven,18490,24000,5510,1,00446,India
971227,2023-06-26,506,monitor,3249,8000,4751,1,00289,India
971227,2023-06-26,504,iron,449,879,430,1,00289,India
971227,2023-06-26,501,iphone 15,60000,80000,20000,1,00289,India
971227,2023-06-26,503,mixer,1349,3249,1900,1,00289,India
794032,2023-06-26,506,monitor,3249,8000,4751,1,00255,India
794032,2023-06-26,502,iphone 15 pro max,100000,135000,35000,1,00255,India
794032,2023-06-26,503,mixer,1349,3249,1900,1,00255,India
794032,2023-06-26,507,washing machine,6990,16490,9500,1,00255,India
447377,2023-06-26,505,oven,18490,24000,5510,1,00012,India
447377,2023-06-26,504,iron,449,879,430,1,00012,India
447377,2023-06-26,506,monitor,3249,8000,4751,1,00012,India
447377,2023-06-26,507,washing machine,6990,16490,9500,1,00012,India
638051,2023-06-26,507,washing machine,6990,16490,9500,1,00440,India
638051,2023-06-26,504,iron,449,879,430,1,00440,India
952163,2023-06-26,504,iron,449,879,430,1,00226,India
952163,2023-06-26,505,oven,18490,24000,5510,1,00226,India
952163,2023-06-26,507,washing machine,6990,16490,9500,1,00226,India
910528,2023-06-26,501,iphone 15,60000,80000,20000,1,00160,India
910528,2023-06-26,503,mixer,1349,3249,1900,1,00160,India
382270,2023-06-26,506,monitor,3249,8000,4751,1,00489,India
382270,2023-06-26,503,mixer,1349,3249,1900,1,00489,India
382270,2023-06-26,501,iphone 15,60000,80000,20000,1,00489,India
382270,2023-06-26,504,iron,449,879,430,1,00489,India
609535,2023-06-26,501,iphone 15,60000,80000,20000,1,00166,India
609535,2023-06-26,507,washing machine,6990,16490,9500,1,00166,India
609535,2023-06-26,503,mixer,1349,3249,1900,1,00166,India
609535,2023-06-26,502,iphone 15 pro max,100000,135000,35000,1,00166,India
145484,2023-06-26,506,monitor,3249,8000,4751,1,00444,India
145484,2023-06-26,501,iphone 15,60000,80000,20000,1,00444,India
145484,2023-06-26,507,washing machine,6990,16490,9500,1,00444,India
275959,2023-06-26,502,iphone 15 pro max,100000,135000,35000,1,00449,India
175944,2023-06-26,507,washing machine,6990,16490,9500,1,00339,India
175944,2023-06-26,503,mixer,1349,3249,1900,1,00339,India
735209,2023-06-26,502,iphone 15 pro max,100000,135000,35000,1,00048,India
735209,2023-06-26,507,washing machine,6990,16490,9500,1,00048,India
735209,2023-06-26,504,iron,449,879,430,1,00048,India
986305,2023-06-26,506,monitor,3249,8000,4751,1,00060,India
986305,2023-06-26,505,oven,18490,24000,5510,1,00060,India
986305,2023-06-26,501,iphone 15,60000,80000,20000,1,00060,India
807567,2023-06-26,506,monitor,3249,8000,4751,1,00496,India
807567,2023-06-26,504,iron,449,879,430,1,00496,India
807567,2023-06-26,503,mixer,1349,3249,1900,1,00496,India
763991,2023-06-26,507,washing machine,6990,16490,9500,1,00179,India
831671,2023-06-26,507,washing machine,6990,16490,9500,1,00190,India
831671,2023-06-26,505,oven,18490,24000,5510,1,00190,India
831671,2023-06-26,503,mixer,1349,3249,1900,1,00190,India
831671,2023-06-26,506,monitor,3249,8000,4751,1,00190,India
718651,2023-06-26,501,iphone 15,60000,80000,20000,1,00496,India
718651,2023-06-26,504,iron,449,879,430,1,00496,India
718651,2023-06-26,507,washing machine,6990,16490,9500,1,00496,India
621609,2023-06-26,502,iphone 15 pro max,100000,135000,35000,1,00374,India
621609,2023-06-26,503,mixer,1349,3249,1900,1,00374,India
623222,2023-06-26,504,iron,449,879,430,1,00168,India
623222,2023-06-26,505,oven,18490,24000,5510,1,00168,India
623222,2023-06-26,502,iphone 15 pro max,100000,135000,35000,1,00168,India
907904,2023-06-26,501,iphone 15,60000,80000,20000,1,00175,India
907904,2023-06-26,503,mixer,1349,3249,1900,1,00175,India
907904,2023-06-26,506,monitor,3249,8000,4751,1,00175,India
907904,2023-06-26,505,oven,18490,24000,5510,1,00175,India
469399,2023-06-26,506,monitor,3249,8000,4751,1,00045,India
469399,2023-06-26,504,iron,449,879,430,1,00045,India
469399,2023-06-26,505,oven,18490,24000,5510,1,00045,India
469399,2023-06-26,503,mixer,1349,3249,1900,1,00045,India
548403,2023-06-26,502,iphone 15 pro max,100000,135000,35000,1,00181,India
548403,2023-06-26,505,oven,18490,24000,5510,1,00181,India
548403,2023-06-26,503,mixer,1349,3249,1900,1,00181,India
592252,2023-06-26,501,iphone 15,60000,80000,20000,1,00439,India
592252,2023-06-26,503,mixer,1349,3249,1900,1,00439,India
592252,2023-06-26,504,iron,449,879,430,1,00439,India
282096,2023-06-26,502,iphone 15 pro max,100000,135000,35000,1,00288,India
282096,2023-06-26,503,mixer,1349,3249,1900,1,00288,India
282096,2023-06-26,507,washing machine,6990,16490,9500,1,00288,India
166018,2023-06-26,501,iphone 15,60000,80000,20000,1,00471,India
166018,2023-06-26,507,washing machine,6990,16490,9500,1,00471,India
166018,2023-06-26,506,monitor,3249,8000,4751,1,00471,India
166018,2023-06-26,503,mixer,1349,3249,1900,1,00471,India
101762,2023-06-26,502,iphone 15 pro max,100000,135000,35000,1,00083,India
101762,2023-06-26,506,monitor,3249,8000,4751,1,00083,India
158701,2023-06-26,506,monitor,3249,8000,4751,1,00032,India
158701,2023-06-26,503,mixer,1349,3249,1900,1,00032,India
397428,2023-06-26,502,iphone 15 pro max,100000,135000,35000,1,00474,India
397428,2023-06-26,507,washing machine,6990,16490,9500,1,00474,India
397428,2023-06-26,505,oven,18490,24000,5510,1,00474,India
476791,2023-06-26,504,iron,449,879,430,1,00448,India
476791,2023-06-26,501,iphone 15,60000,80000,20000,1,00448,India
163066,2023-06-26,503,mixer,1349,3249,1900,1,00459,India
163066,2023-06-26,501,iphone 15,60000,80000,20000,1,00459,India
872157,2023-06-26,506,monitor,3249,8000,4751,1,00201,India
668288,2023-06-26,502,iphone 15 pro max,100000,135000,35000,1,00418,India
668288,2023-06-26,504,iron,449,879,430,1,00418,India
668288,2023-06-26,503,mixer,1349,3249,1900,1,00418,India
514458,2023-06-26,506,monitor,3249,8000,4751,1,00083,India
133276,2023-06-26,504,iron,449,879,430,1,00323,India
133276,2023-06-26,502,iphone 15 pro max,100000,135000,35000,1,00323,India
133276,2023-06-26,507,washing machine,6990,16490,9500,1,00323,India
133276,2023-06-26,506,monitor,3249,8000,4751,1,00323,India
145062,2023-06-26,502,iphone 15 pro max,100000,135000,35000,1,00003,India
145062,2023-06-26,507,washing machine,6990,16490,9500,1,00003,India
477724,2023-06-26,505,oven,18490,24000,5510,1,00350,India
477724,2023-06-26,506,monitor,3249,8000,4751,1,00350,India
477724,2023-06-26,501,iphone 15,60000,80000,20000,1,00350,India
739761,2023-06-26,505,oven,18490,24000,5510,1,00304,India
739761,2023-06-26,506,monitor,3249,8000,4751,1,00304,India
922800,2023-06-26,507,washing machine,6990,16490,9500,1,00300,India
922800,2023-06-26,504,iron,449,879,430,1,00300,India
922800,2023-06-26,503,mixer,1349,3249,1900,1,00300,India
922800,2023-06-26,502,iphone 15 pro max,100000,135000,35000,1,00300,India
922800,2023-06-26,501,iphone 15,60000,80000,20000,1,00300,India
735819,2023-06-26,502,iphone 15 pro max,100000,135000,35000,1,00385,India
735819,2023-06-26,505,oven,18490,24000,5510,1,00385,India
735819,2023-06-26,507,washing machine,6990,16490,9500,1,00385,India
735819,2023-06-26,504,iron,449,879,430,1,00385,India
371228,2023-06-26,505,oven,18490,24000,5510,1,00369,India
153800,2023-06-26,502,iphone 15 pro max,100000,135000,35000,1,00378,India
153800,2023-06-26,507,washing machine,6990,16490,9500,1,00378,India
153800,2023-06-26,503,mixer,1349,3249,1900,1,00378,India
153800,2023-06-26,501,iphone 15,60000,80000,20000,1,00378,India
928520,2023-06-26,501,iphone 15,60000,80000,20000,1,00455,India
928520,2023-06-26,507,washing machine,6990,16490,9500,1,00455,India
928520,2023-06-26,506,monitor,3249,8000,4751,1,00455,India
928520,2023-06-26,504,iron,449,879,430,1,00455,India
127001,2023-06-26,507,washing machine,6990,16490,9500,1,00064,India
127001,2023-06-26,501,iphone 15,60000,80000,20000,1,00064,India
446651,2023-06-26,506,monitor,3249,8000,4751,1,00198,India
214739,2023-06-26,504,iron,449,879,430,1,00464,India
214739,2023-06-26,507,washing machine,6990,16490,9500,1,00464,India
214739,2023-06-26,505,oven,18490,24000,5510,1,00464,India
883759,2023-06-26,506,monitor,3249,8000,4751,1,00355,India
883759,2023-06-26,503,mixer,1349,3249,1900,1,00355,India
883759,2023-06-26,505,oven,18490,24000,5510,1,00355,India
413529,2023-06-27,501,iphone 15,60000,80000,20000,1,00374,India
413529,2023-06-27,506,monitor,3249,8000,4751,1,00374,India
413529,2023-06-27,503,mixer,1349,3249,1900,1,00374,India
143298,2023-06-27,503,mixer,1349,3249,1900,1,00156,India
143298,2023-06-27,504,iron,449,879,430,1,00156,India
143298,2023-06-27,505,oven,18490,24000,5510,1,00156,India
596438,2023-06-27,502,iphone 15 pro max,100000,135000,35000,1,00004,India
596438,2023-06-27,503,mixer,1349,3249,1900,1,00004,India
720404,2023-06-27,506,monitor,3249,8000,4751,1,00237,India
116894,2023-06-27,503,mixer,1349,3249,1900,1,00497,India
116894,2023-06-27,505,oven,18490,24000,5510,1,00497,India
310509,2023-06-27,504,iron,449,879,430,1,00454,India
310509,2023-06-27,503,mixer,1349,3249,1900,1,00454,India
587574,2023-06-27,502,iphone 15 pro max,100000,135000,35000,1,00144,India
587574,2023-06-27,506,monitor,3249,8000,4751,1,00144,India
587574,2023-06-27,504,iron,449,879,430,1,00144,India
645178,2023-06-27,501,iphone 15,60000,80000,20000,1,00357,India
645178,2023-06-27,505,oven,18490,24000,5510,1,00357,India
645178,2023-06-27,504,iron,449,879,430,1,00357,India
965419,2023-06-27,502,iphone 15 pro max,100000,135000,35000,1,00403,India
320129,2023-06-27,507,washing machine,6990,16490,9500,1,00340,India
320129,2023-06-27,501,iphone 15,60000,80000,20000,1,00340,India
320129,2023-06-27,502,iphone 15 pro max,100000,135000,35000,1,00340,India
320129,2023-06-27,505,oven,18490,24000,5510,1,00340,India
418620,2023-06-27,501,iphone 15,60000,80000,20000,1,00454,India
418620,2023-06-27,503,mixer,1349,3249,1900,1,00454,India
418620,2023-06-27,506,monitor,3249,8000,4751,1,00454,India
585791,2023-06-27,506,monitor,3249,8000,4751,1,00499,India
150234,2023-06-27,502,iphone 15 pro max,100000,135000,35000,1,00116,India
150234,2023-06-27,505,oven,18490,24000,5510,1,00116,India
150234,2023-06-27,503,mixer,1349,3249,1900,1,00116,India
451642,2023-06-27,505,oven,18490,24000,5510,1,00335,India
451642,2023-06-27,503,mixer,1349,3249,1900,1,00335,India
451642,2023-06-27,501,iphone 15,60000,80000,20000,1,00335,India
451642,2023-06-27,506,monitor,3249,8000,4751,1,00335,India
375423,2023-06-27,501,iphone 15,60000,80000,20000,1,00372,India
375423,2023-06-27,504,iron,449,879,430,1,00372,India
137125,2023-06-27,507,washing machine,6990,16490,9500,1,00192,India
137125,2023-06-27,501,iphone 15,60000,80000,20000,1,00192,India
137125,2023-06-27,503,mixer,1349,3249,1900,1,00192,India
315981,2023-06-27,507,washing machine,6990,16490,9500,1,00276,India
315981,2023-06-27,503,mixer,1349,3249,1900,1,00276,India
776863,2023-06-27,507,washing machine,6990,16490,9500,1,00096,India
776863,2023-06-27,505,oven,18490,24000,5510,1,00096,India
619242,2023-06-27,506,monitor,3249,8000,4751,1,00270,India
285697,2023-06-27,501,iphone 15,60000,80000,20000,1,00344,India
285697,2023-06-27,505,oven,18490,24000,5510,1,00344,India
285697,2023-06-27,507,washing machine,6990,16490,9500,1,00344,India
285697,2023-06-27,504,iron,449,879,430,1,00344,India
285697,2023-06-27,503,mixer,1349,3249,1900,1,00344,India
403709,2023-06-27,503,mixer,1349,3249,1900,1,00336,India
403709,2023-06-27,506,monitor,3249,8000,4751,1,00336,India
403709,2023-06-27,505,oven,18490,24000,5510,1,00336,India
429366,2023-06-27,503,mixer,1349,3249,1900,1,00071,India
563470,2023-06-27,506,monitor,3249,8000,4751,1,00052,India
563470,2023-06-27,501,iphone 15,60000,80000,20000,1,00052,India
563470,2023-06-27,503,mixer,1349,3249,1900,1,00052,India
563470,2023-06-27,502,iphone 15 pro max,100000,135000,35000,1,00052,India
626862,2023-06-27,501,iphone 15,60000,80000,20000,1,00362,India
215150,2023-06-27,503,mixer,1349,3249,1900,1,00150,India
563258,2023-06-27,502,iphone 15 pro max,100000,135000,35000,1,00105,India
563258,2023-06-27,503,mixer,1349,3249,1900,1,00105,India
563258,2023-06-27,505,oven,18490,24000,5510,1,00105,India
563258,2023-06-27,506,monitor,3249,8000,4751,1,00105,India
557648,2023-06-27,505,oven,18490,24000,5510,1,00422,India
557648,2023-06-27,504,iron,449,879,430,1,00422,India
557648,2023-06-27,501,iphone 15,60000,80000,20000,1,00422,India
763714,2023-06-27,501,iphone 15,60000,80000,20000,1,00172,India
763714,2023-06-27,504,iron,449,879,430,1,00172,India
763714,2023-06-27,506,monitor,3249,8000,4751,1,00172,India
763714,2023-06-27,505,oven,18490,24000,5510,1,00172,India
395536,2023-06-27,501,iphone 15,60000,80000,20000,1,00243,India
395536,2023-06-27,507,washing machine,6990,16490,9500,1,00243,India
128698,2023-06-27,507,washing machine,6990,16490,9500,1,00440,India
128698,2023-06-27,504,iron,449,879,430,1,00440,India
128698,2023-06-27,501,iphone 15,60000,80000,20000,1,00440,India
397413,2023-06-27,502,iphone 15 pro max,100000,135000,35000,1,00459,India
397413,2023-06-27,507,washing machine,6990,16490,9500,1,00459,India
397413,2023-06-27,503,mixer,1349,3249,1900,1,00459,India
617955,2023-06-27,504,iron,449,879,430,1,00362,India
617955,2023-06-27,505,oven,18490,24000,5510,1,00362,India
274545,2023-06-27,501,iphone 15,60000,80000,20000,1,00084,India
274545,2023-06-27,504,iron,449,879,430,1,00084,India
274545,2023-06-27,505,oven,18490,24000,5510,1,00084,India
536202,2023-06-27,501,iphone 15,60000,80000,20000,1,00305,India
536202,2023-06-27,507,washing machine,6990,16490,9500,1,00305,India
536202,2023-06-27,504,iron,449,879,430,1,00305,India
991471,2023-06-27,507,washing machine,6990,16490,9500,1,00344,India
991471,2023-06-27,501,iphone 15,60000,80000,20000,1,00344,India
991471,2023-06-27,505,oven,18490,24000,5510,1,00344,India
906848,2023-06-27,507,washing machine,6990,16490,9500,1,00110,India
906848,2023-06-27,501,iphone 15,60000,80000,20000,1,00110,India
906848,2023-06-27,505,oven,18490,24000,5510,1,00110,India
146715,2023-06-27,501,iphone 15,60000,80000,20000,1,00248,India
146715,2023-06-27,502,iphone 15 pro max,100000,135000,35000,1,00248,India
321525,2023-06-27,506,monitor,3249,8000,4751,1,00139,India
321525,2023-06-27,501,iphone 15,60000,80000,20000,1,00139,India
321525,2023-06-27,503,mixer,1349,3249,1900,1,00139,India
321525,2023-06-27,507,washing machine,6990,16490,9500,1,00139,India
641647,2023-06-27,501,iphone 15,60000,80000,20000,1,00276,India
641647,2023-06-27,506,monitor,3249,8000,4751,1,00276,India
641647,2023-06-27,505,oven,18490,24000,5510,1,00276,India
641647,2023-06-27,504,iron,449,879,430,1,00276,India
688672,2023-06-27,503,mixer,1349,3249,1900,1,00440,India
688672,2023-06-27,502,iphone 15 pro max,100000,135000,35000,1,00440,India
988364,2023-06-27,504,iron,449,879,430,1,00297,India
988364,2023-06-27,501,iphone 15,60000,80000,20000,1,00297,India
988364,2023-06-27,507,washing machine,6990,16490,9500,1,00297,India
229121,2023-06-27,507,washing machine,6990,16490,9500,1,00283,India
229121,2023-06-27,503,mixer,1349,3249,1900,1,00283,India
229121,2023-06-27,505,oven,18490,24000,5510,1,00283,India
384847,2023-06-27,506,monitor,3249,8000,4751,1,00357,India
384847,2023-06-27,503,mixer,1349,3249,1900,1,00357,India
384847,2023-06-27,501,iphone 15,60000,80000,20000,1,00357,India
384847,2023-06-27,507,washing machine,6990,16490,9500,1,00357,India
384847,2023-06-27,502,iphone 15 pro max,100000,135000,35000,1,00357,India
126324,2023-06-27,506,monitor,3249,8000,4751,1,00161,India
548347,2023-06-27,505,oven,18490,24000,5510,1,00177,India
548347,2023-06-27,501,iphone 15,60000,80000,20000,1,00177,India
548347,2023-06-27,503,mixer,1349,3249,1900,1,00177,India
548347,2023-06-27,506,monitor,3249,8000,4751,1,00177,India
248540,2023-06-27,501,iphone 15,60000,80000,20000,1,00206,India
419907,2023-06-27,504,iron,449,879,430,1,00216,India
419907,2023-06-27,507,washing machine,6990,16490,9500,1,00216,India
419907,2023-06-27,502,iphone 15 pro max,100000,135000,35000,1,00216,India
419907,2023-06-27,506,monitor,3249,8000,4751,1,00216,India
838911,2023-06-27,502,iphone 15 pro max,100000,135000,35000,1,00060,India
780826,2023-06-27,501,iphone 15,60000,80000,20000,1,00305,India
780826,2023-06-27,503,mixer,1349,3249,1900,1,00305,India
780826,2023-06-27,507,washing machine,6990,16490,9500,1,00305,India
780826,2023-06-27,505,oven,18490,24000,5510,1,00305,India
353889,2023-06-27,504,iron,449,879,430,1,00357,India
353889,2023-06-27,502,iphone 15 pro max,100000,135000,35000,1,00357,India
353889,2023-06-27,503,mixer,1349,3249,1900,1,00357,India
353889,2023-06-27,507,washing machine,6990,16490,9500,1,00357,India
353889,2023-06-27,505,oven,18490,24000,5510,1,00357,India
647423,2023-06-27,505,oven,18490,24000,5510,1,00059,India
647423,2023-06-27,501,iphone 15,60000,80000,20000,1,00059,India
647423,2023-06-27,507,washing machine,6990,16490,9500,1,00059,India
505536,2023-06-27,507,washing machine,6990,16490,9500,1,00103,India
117254,2023-06-27,503,mixer,1349,3249,1900,1,00169,India
454397,2023-06-27,501,iphone 15,60000,80000,20000,1,00380,India
909218,2023-06-27,504,iron,449,879,430,1,00051,India
909218,2023-06-27,506,monitor,3249,8000,4751,1,00051,India
540579,2023-06-27,507,washing machine,6990,16490,9500,1,00443,India
540579,2023-06-27,503,mixer,1349,3249,1900,1,00443,India
540579,2023-06-27,506,monitor,3249,8000,4751,1,00443,India
540579,2023-06-27,505,oven,18490,24000,5510,1,00443,India
971548,2023-06-27,503,mixer,1349,3249,1900,1,00033,India
971548,2023-06-27,507,washing machine,6990,16490,9500,1,00033,India
117969,2023-06-27,502,iphone 15 pro max,100000,135000,35000,1,00346,India
117969,2023-06-27,505,oven,18490,24000,5510,1,00346,India
833145,2023-06-27,507,washing machine,6990,16490,9500,1,00207,India
833145,2023-06-27,501,iphone 15,60000,80000,20000,1,00207,India
597502,2023-06-27,501,iphone 15,60000,80000,20000,1,00219,India
597502,2023-06-27,506,monitor,3249,8000,4751,1,00219,India
597502,2023-06-27,502,iphone 15 pro max,100000,135000,35000,1,00219,India
597502,2023-06-27,507,washing machine,6990,16490,9500,1,00219,India
267197,2023-06-27,501,iphone 15,60000,80000,20000,1,00060,India
267197,2023-06-27,506,monitor,3249,8000,4751,1,00060,India
267197,2023-06-27,502,iphone 15 pro max,100000,135000,35000,1,00060,India
731064,2023-06-27,504,iron,449,879,430,1,00484,India
731064,2023-06-27,505,oven,18490,24000,5510,1,00484,India
842926,2023-06-27,504,iron,449,879,430,1,00030,India
842926,2023-06-27,505,oven,18490,24000,5510,1,00030,India
842926,2023-06-27,502,iphone 15 pro max,100000,135000,35000,1,00030,India
842926,2023-06-27,507,washing machine,6990,16490,9500,1,00030,India
787815,2023-06-27,502,iphone 15 pro max,100000,135000,35000,1,00355,India
839906,2023-06-27,501,iphone 15,60000,80000,20000,1,00268,India
839906,2023-06-27,506,monitor,3249,8000,4751,1,00268,India
839906,2023-06-27,504,iron,449,879,430,1,00268,India
109028,2023-06-27,503,mixer,1349,3249,1900,1,00327,India
579896,2023-06-27,501,iphone 15,60000,80000,20000,1,00016,India
491505,2023-06-27,501,iphone 15,60000,80000,20000,1,00146,India
373300,2023-06-27,507,washing machine,6990,16490,9500,1,00404,India
373300,2023-06-27,503,mixer,1349,3249,1900,1,00404,India
373300,2023-06-27,504,iron,449,879,430,1,00404,India
373300,2023-06-27,502,iphone 15 pro max,100000,135000,35000,1,00404,India
572228,2023-06-27,504,iron,449,879,430,1,00043,India
219027,2023-06-27,507,washing machine,6990,16490,9500,1,00345,India
219027,2023-06-27,504,iron,449,879,430,1,00345,India
219027,2023-06-27,501,iphone 15,60000,80000,20000,1,00345,India
219027,2023-06-27,503,mixer,1349,3249,1900,1,00345,India
840594,2023-06-27,505,oven,18490,24000,5510,1,00377,India
840594,2023-06-27,506,monitor,3249,8000,4751,1,00377,India
839880,2023-06-27,503,mixer,1349,3249,1900,1,00462,India
839880,2023-06-27,501,iphone 15,60000,80000,20000,1,00462,India
839880,2023-06-27,504,iron,449,879,430,1,00462,India
571612,2023-06-27,505,oven,18490,24000,5510,1,00218,India
571612,2023-06-27,503,mixer,1349,3249,1900,1,00218,India
571612,2023-06-27,506,monitor,3249,8000,4751,1,00218,India
569803,2023-06-27,504,iron,449,879,430,1,00337,India
569803,2023-06-27,501,iphone 15,60000,80000,20000,1,00337,India
365602,2023-06-28,504,iron,449,879,430,1,00413,India
365602,2023-06-28,506,monitor,3249,8000,4751,1,00413,India
365602,2023-06-28,503,mixer,1349,3249,1900,1,00413,India
423350,2023-06-28,501,iphone 15,60000,80000,20000,1,00317,India
423350,2023-06-28,504,iron,449,879,430,1,00317,India
604640,2023-06-28,506,monitor,3249,8000,4751,1,00057,India
604640,2023-06-28,502,iphone 15 pro max,100000,135000,35000,1,00057,India
604640,2023-06-28,503,mixer,1349,3249,1900,1,00057,India
604640,2023-06-28,507,washing machine,6990,16490,9500,1,00057,India
674474,2023-06-28,501,iphone 15,60000,80000,20000,1,00061,India
674474,2023-06-28,507,washing machine,6990,16490,9500,1,00061,India
674474,2023-06-28,505,oven,18490,24000,5510,1,00061,India
721840,2023-06-28,501,iphone 15,60000,80000,20000,1,00248,India
721840,2023-06-28,506,monitor,3249,8000,4751,1,00248,India
742305,2023-06-28,504,iron,449,879,430,1,00232,India
306196,2023-06-28,502,iphone 15 pro max,100000,135000,35000,1,00485,India
306196,2023-06-28,504,iron,449,879,430,1,00485,India
423506,2023-06-28,507,washing machine,6990,16490,9500,1,00201,India
423506,2023-06-28,504,iron,449,879,430,1,00201,India
423506,2023-06-28,506,monitor,3249,8000,4751,1,00201,India
423506,2023-06-28,501,iphone 15,60000,80000,20000,1,00201,India
591778,2023-06-28,504,iron,449,879,430,1,00324,India
591778,2023-06-28,503,mixer,1349,3249,1900,1,00324,India
591778,2023-06-28,502,iphone 15 pro max,100000,135000,35000,1,00324,India
919068,2023-06-28,506,monitor,3249,8000,4751,1,00215,India
579358,2023-06-28,502,iphone 15 pro max,100000,135000,35000,1,00303,India
579358,2023-06-28,506,monitor,3249,8000,4751,1,00303,India
579358,2023-06-28,504,iron,449,879,430,1,00303,India
579358,2023-06-28,505,oven,18490,24000,5510,1,00303,India
292261,2023-06-28,506,monitor,3249,8000,4751,1,00220,India
292261,2023-06-28,502,iphone 15 pro max,100000,135000,35000,1,00220,India
292261,2023-06-28,504,iron,449,879,430,1,00220,India
166830,2023-06-28,503,mixer,1349,3249,1900,1,00248,India
308223,2023-06-28,507,washing machine,6990,16490,9500,1,00492,India
308223,2023-06-28,503,mixer,1349,3249,1900,1,00492,India
221569,2023-06-28,501,iphone 15,60000,80000,20000,1,00414,India
221569,2023-06-28,503,mixer,1349,3249,1900,1,00414,India
221569,2023-06-28,505,oven,18490,24000,5510,1,00414,India
665509,2023-06-28,507,washing machine,6990,16490,9500,1,00283,India
665509,2023-06-28,505,oven,18490,24000,5510,1,00283,India
702932,2023-06-28,503,mixer,1349,3249,1900,1,00202,India
702932,2023-06-28,505,oven,18490,24000,5510,1,00202,India
702932,2023-06-28,506,monitor,3249,8000,4751,1,00202,India
702932,2023-06-28,502,iphone 15 pro max,100000,135000,35000,1,00202,India
380295,2023-06-28,504,iron,449,879,430,1,00109,India
380295,2023-06-28,501,iphone 15,60000,80000,20000,1,00109,India
380295,2023-06-28,502,iphone 15 pro max,100000,135000,35000,1,00109,India
747106,2023-06-28,506,monitor,3249,8000,4751,1,00146,India
747106,2023-06-28,503,mixer,1349,3249,1900,1,00146,India
747106,2023-06-28,507,washing machine,6990,16490,9500,1,00146,India
676757,2023-06-28,507,washing machine,6990,16490,9500,1,00465,India
676757,2023-06-28,506,monitor,3249,8000,4751,1,00465,India
676757,2023-06-28,503,mixer,1349,3249,1900,1,00465,India
458604,2023-06-28,507,washing machine,6990,16490,9500,1,00292,India
458604,2023-06-28,503,mixer,1349,3249,1900,1,00292,India
667597,2023-06-28,503,mixer,1349,3249,1900,1,00232,India
667597,2023-06-28,504,iron,449,879,430,1,00232,India
667597,2023-06-28,501,iphone 15,60000,80000,20000,1,00232,India
667597,2023-06-28,506,monitor,3249,8000,4751,1,00232,India
667597,2023-06-28,502,iphone 15 pro max,100000,135000,35000,1,00232,India
844852,2023-06-28,506,monitor,3249,8000,4751,1,00494,India
844852,2023-06-28,502,iphone 15 pro max,100000,135000,35000,1,00494,India
448071,2023-06-28,505,oven,18490,24000,5510,1,00190,India
448071,2023-06-28,507,washing machine,6990,16490,9500,1,00190,India
448071,2023-06-28,503,mixer,1349,3249,1900,1,00190,India
421456,2023-06-28,501,iphone 15,60000,80000,20000,1,00165,India
248047,2023-06-28,507,washing machine,6990,16490,9500,1,00417,India
248047,2023-06-28,505,oven,18490,24000,5510,1,00417,India
236175,2023-06-28,505,oven,18490,24000,5510,1,00317,India
236175,2023-06-28,504,iron,449,879,430,1,00317,India
236175,2023-06-28,502,iphone 15 pro max,100000,135000,35000,1,00317,India
236175,2023-06-28,507,washing machine,6990,16490,9500,1,00317,India
285952,2023-06-28,504,iron,449,879,430,1,00128,India
285952,2023-06-28,501,iphone 15,60000,80000,20000,1,00128,India
204632,2023-06-28,505,oven,18490,24000,5510,1,00003,India
337133,2023-06-28,503,mixer,1349,3249,1900,1,00340,India
233354,2023-06-28,507,washing machine,6990,16490,9500,1,00042,India
335197,2023-06-28,507,washing machine,6990,16490,9500,1,00202,India
335197,2023-06-28,505,oven,18490,24000,5510,1,00202,India
335197,2023-06-28,501,iphone 15,60000,80000,20000,1,00202,India
490737,2023-06-28,502,iphone 15 pro max,100000,135000,35000,1,00065,India
490737,2023-06-28,501,iphone 15,60000,80000,20000,1,00065,India
374564,2023-06-28,501,iphone 15,60000,80000,20000,1,00188,India
374564,2023-06-28,505,oven,18490,24000,5510,1,00188,India
420333,2023-06-28,501,iphone 15,60000,80000,20000,1,00037,India
420333,2023-06-28,503,mixer,1349,3249,1900,1,00037,India
261560,2023-06-28,505,oven,18490,24000,5510,1,00104,India
261560,2023-06-28,507,washing machine,6990,16490,9500,1,00104,India
911899,2023-06-28,507,washing machine,6990,16490,9500,1,00280,India
911899,2023-06-28,504,iron,449,879,430,1,00280,India
573105,2023-06-28,505,oven,18490,24000,5510,1,00160,India
573105,2023-06-28,507,washing machine,6990,16490,9500,1,00160,India
614323,2023-06-28,507,washing machine,6990,16490,9500,1,00233,India
106650,2023-06-28,505,oven,18490,24000,5510,1,00148,India
106650,2023-06-28,502,iphone 15 pro max,100000,135000,35000,1,00148,India
106650,2023-06-28,501,iphone 15,60000,80000,20000,1,00148,India
106650,2023-06-28,503,mixer,1349,3249,1900,1,00148,India
106650,2023-06-28,506,monitor,3249,8000,4751,1,00148,India
589593,2023-06-28,507,washing machine,6990,16490,9500,1,00142,India
589593,2023-06-28,506,monitor,3249,8000,4751,1,00142,India
392911,2023-06-28,505,oven,18490,24000,5510,1,00379,India
392911,2023-06-28,503,mixer,1349,3249,1900,1,00379,India
392911,2023-06-28,502,iphone 15 pro max,100000,135000,35000,1,00379,India
392911,2023-06-28,506,monitor,3249,8000,4751,1,00379,India
577126,2023-06-28,502,iphone 15 pro max,100000,135000,35000,1,00287,India
898083,2023-06-28,507,washing machine,6990,16490,9500,1,00117,India
898083,2023-06-28,502,iphone 15 pro max,100000,135000,35000,1,00117,India
898083,2023-06-28,503,mixer,1349,3249,1900,1,00117,India
898083,2023-06-28,506,monitor,3249,8000,4751,1,00117,India
135789,2023-06-28,502,iphone 15 pro max,100000,135000,35000,1,00462,India
135789,2023-06-28,507,washing machine,6990,16490,9500,1,00462,India
135789,2023-06-28,505,oven,18490,24000,5510,1,00462,India
135789,2023-06-28,503,mixer,1349,3249,1900,1,00462,India
852517,2023-06-28,507,washing machine,6990,16490,9500,1,00152,India
852517,2023-06-28,501,iphone 15,60000,80000,20000,1,00152,India
852517,2023-06-28,505,oven,18490,24000,5510,1,00152,India
852517,2023-06-28,503,mixer,1349,3249,1900,1,00152,India
801566,2023-06-28,501,iphone 15,60000,80000,20000,1,00218,India
801566,2023-06-28,506,monitor,3249,8000,4751,1,00218,India
801566,2023-06-28,502,iphone 15 pro max,100000,135000,35000,1,00218,India
522930,2023-06-28,502,iphone 15 pro max,100000,135000,35000,1,00308,India
522930,2023-06-28,504,iron,449,879,430,1,00308,India
676502,2023-06-28,504,iron,449,879,430,1,00417,India
676502,2023-06-28,507,washing machine,6990,16490,9500,1,00417,India
331445,2023-06-28,506,monitor,3249,8000,4751,1,00432,India
555884,2023-06-28,505,oven,18490,24000,5510,1,00157,India
555884,2023-06-28,502,iphone 15 pro max,100000,135000,35000,1,00157,India
555884,2023-06-28,507,washing machine,6990,16490,9500,1,00157,India
555884,2023-06-28,503,mixer,1349,3249,1900,1,00157,India
950300,2023-06-28,505,oven,18490,24000,5510,1,00447,India
950300,2023-06-28,503,mixer,1349,3249,1900,1,00447,India
950300,2023-06-28,507,washing machine,6990,16490,9500,1,00447,India
950300,2023-06-28,506,monitor,3249,8000,4751,1,00447,India
853642,2023-06-28,504,iron,449,879,430,1,00405,India
853642,2023-06-28,507,washing machine,6990,16490,9500,1,00405,India
148537,2023-06-28,507,washing machine,6990,16490,9500,1,00023,India
148537,2023-06-28,503,mixer,1349,3249,1900,1,00023,India
315560,2023-06-28,502,iphone 15 pro max,100000,135000,35000,1,00185,India
315560,2023-06-28,504,iron,449,879,430,1,00185,India
315560,2023-06-28,503,mixer,1349,3249,1900,1,00185,India
931700,2023-06-28,501,iphone 15,60000,80000,20000,1,00133,India
931700,2023-06-28,504,iron,449,879,430,1,00133,India
535871,2023-06-28,507,washing machine,6990,16490,9500,1,00209,India
535871,2023-06-28,505,oven,18490,24000,5510,1,00209,India
535871,2023-06-28,506,monitor,3249,8000,4751,1,00209,India
213481,2023-06-28,502,iphone 15 pro max,100000,135000,35000,1,00392,India
213481,2023-06-28,507,washing machine,6990,16490,9500,1,00392,India
245887,2023-06-28,505,oven,18490,24000,5510,1,00163,India
245887,2023-06-28,503,mixer,1349,3249,1900,1,00163,India
245887,2023-06-28,502,iphone 15 pro max,100000,135000,35000,1,00163,India
698175,2023-06-28,504,iron,449,879,430,1,00135,India
698175,2023-06-28,507,washing machine,6990,16490,9500,1,00135,India
812582,2023-06-28,506,monitor,3249,8000,4751,1,00045,India
812582,2023-06-28,504,iron,449,879,430,1,00045,India
812582,2023-06-28,507,washing machine,6990,16490,9500,1,00045,India
894426,2023-06-28,504,iron,449,879,430,1,00402,India
894426,2023-06-28,506,monitor,3249,8000,4751,1,00402,India
894426,2023-06-28,503,mixer,1349,3249,1900,1,00402,India
894426,2023-06-28,502,iphone 15 pro max,100000,135000,35000,1,00402,India
227068,2023-06-28,505,oven,18490,24000,5510,1,00435,India
227068,2023-06-28,503,mixer,1349,3249,1900,1,00435,India
227068,2023-06-28,506,monitor,3249,8000,4751,1,00435,India
227068,2023-06-28,507,washing machine,6990,16490,9500,1,00435,India
750401,2023-06-28,504,iron,449,879,430,1,00025,India
750401,2023-06-28,507,washing machine,6990,16490,9500,1,00025,India
750401,2023-06-28,502,iphone 15 pro max,100000,135000,35000,1,00025,India
185134,2023-06-28,504,iron,449,879,430,1,00486,India
185134,2023-06-28,507,washing machine,6990,16490,9500,1,00486,India
185134,2023-06-28,502,iphone 15 pro max,100000,135000,35000,1,00486,India
185134,2023-06-28,506,monitor,3249,8000,4751,1,00486,India
188857,2023-06-28,501,iphone 15,60000,80000,20000,1,00385,India
188857,2023-06-28,503,mixer,1349,3249,1900,1,00385,India
225960,2023-06-28,505,oven,18490,24000,5510,1,00441,India
331283,2023-06-28,502,iphone 15 pro max,100000,135000,35000,1,00356,India
331283,2023-06-28,504,iron,449,879,430,1,00356,India
331283,2023-06-28,506,monitor,3249,8000,4751,1,00356,India
610525,2023-06-28,507,washing machine,6990,16490,9500,1,00262,India
610525,2023-06-28,506,monitor,3249,8000,4751,1,00262,India
610525,2023-06-28,502,iphone 15 pro max,100000,135000,35000,1,00262,India
263263,2023-06-28,503,mixer,1349,3249,1900,1,00218,India
263263,2023-06-28,502,iphone 15 pro max,100000,135000,35000,1,00218,India
539700,2023-06-28,506,monitor,3249,8000,4751,1,00154,India
539700,2023-06-28,502,iphone 15 pro max,100000,135000,35000,1,00154,India
376276,2023-06-28,503,mixer,1349,3249,1900,1,00042,India
376276,2023-06-28,507,washing machine,6990,16490,9500,1,00042,India
208996,2023-06-29,502,iphone 15 pro max,100000,135000,35000,1,00493,India
208996,2023-06-29,507,washing machine,6990,16490,9500,1,00493,India
256349,2023-06-29,505,oven,18490,24000,5510,1,00079,India
256349,2023-06-29,501,iphone 15,60000,80000,20000,1,00079,India
256349,2023-06-29,503,mixer,1349,3249,1900,1,00079,India
256349,2023-06-29,504,iron,449,879,430,1,00079,India
701274,2023-06-29,504,iron,449,879,430,1,00141,India
701274,2023-06-29,505,oven,18490,24000,5510,1,00141,India
701274,2023-06-29,503,mixer,1349,3249,1900,1,00141,India
701274,2023-06-29,501,iphone 15,60000,80000,20000,1,00141,India
896093,2023-06-29,505,oven,18490,24000,5510,1,00179,India
896093,2023-06-29,503,mixer,1349,3249,1900,1,00179,India
896093,2023-06-29,502,iphone 15 pro max,100000,135000,35000,1,00179,India
896093,2023-06-29,501,iphone 15,60000,80000,20000,1,00179,India
770000,2023-06-29,504,iron,449,879,430,1,00101,India
581105,2023-06-29,504,iron,449,879,430,1,00352,India
581105,2023-06-29,501,iphone 15,60000,80000,20000,1,00352,India
581105,2023-06-29,506,monitor,3249,8000,4751,1,00352,India
457487,2023-06-29,504,iron,449,879,430,1,00189,India
396555,2023-06-29,506,monitor,3249,8000,4751,1,00062,India
557240,2023-06-29,504,iron,449,879,430,1,00148,India
459169,2023-06-29,503,mixer,1349,3249,1900,1,00093,India
459169,2023-06-29,506,monitor,3249,8000,4751,1,00093,India
459169,2023-06-29,505,oven,18490,24000,5510,1,00093,India
866190,2023-06-29,501,iphone 15,60000,80000,20000,1,00458,India
866190,2023-06-29,506,monitor,3249,8000,4751,1,00458,India
866190,2023-06-29,503,mixer,1349,3249,1900,1,00458,India
866190,2023-06-29,507,washing machine,6990,16490,9500,1,00458,India
228478,2023-06-29,502,iphone 15 pro max,100000,135000,35000,1,00428,India
228478,2023-06-29,504,iron,449,879,430,1,00428,India
895304,2023-06-29,505,oven,18490,24000,5510,1,00281,India
895304,2023-06-29,501,iphone 15,60000,80000,20000,1,00281,India
895304,2023-06-29,502,iphone 15 pro max,100000,135000,35000,1,00281,India
278357,2023-06-29,502,iphone 15 pro max,100000,135000,35000,1,00208,India
278357,2023-06-29,505,oven,18490,24000,5510,1,00208,India
675418,2023-06-29,503,mixer,1349,3249,1900,1,00073,India
675418,2023-06-29,504,iron,449,879,430,1,00073,India
675418,2023-06-29,501,iphone 15,60000,80000,20000,1,00073,India
869145,2023-06-29,507,washing machine,6990,16490,9500,1,00051,India
229598,2023-06-29,503,mixer,1349,3249,1900,1,00492,India
229598,2023-06-29,504,iron,449,879,430,1,00492,India
229598,2023-06-29,507,washing machine,6990,16490,9500,1,00492,India
250737,2023-06-29,504,iron,449,879,430,1,00302,India
250737,2023-06-29,501,iphone 15,60000,80000,20000,1,00302,India
367698,2023-06-29,503,mixer,1349,3249,1900,1,00381,India
367698,2023-06-29,507,washing machine,6990,16490,9500,1,00381,India
885117,2023-06-29,502,iphone 15 pro max,100000,135000,35000,1,00220,India
804718,2023-06-29,503,mixer,1349,3249,1900,1,00429,India
804718,2023-06-29,507,washing machine,6990,16490,9500,1,00429,India
804718,2023-06-29,505,oven,18490,24000,5510,1,00429,India
579803,2023-06-29,505,oven,18490,24000,5510,1,00471,India
134464,2023-06-29,502,iphone 15 pro max,100000,135000,35000,1,00460,India
777173,2023-06-29,503,mixer,1349,3249,1900,1,00312,India
777173,2023-06-29,504,iron,449,879,430,1,00312,India
777173,2023-06-29,501,iphone 15,60000,80000,20000,1,00312,India
777173,2023-06-29,506,monitor,3249,8000,4751,1,00312,India
372761,2023-06-29,506,monitor,3249,8000,4751,1,00069,India
372761,2023-06-29,505,oven,18490,24000,5510,1,00069,India
372761,2023-06-29,502,iphone 15 pro max,100000,135000,35000,1,00069,India
372761,2023-06-29,501,iphone 15,60000,80000,20000,1,00069,India
568143,2023-06-29,502,iphone 15 pro max,100000,135000,35000,1,00253,India
102464,2023-06-29,504,iron,449,879,430,1,00461,India
102464,2023-06-29,507,washing machine,6990,16490,9500,1,00461,India
102464,2023-06-29,506,monitor,3249,8000,4751,1,00461,India
102464,2023-06-29,503,mixer,1349,3249,1900,1,00461,India
900197,2023-06-29,507,washing machine,6990,16490,9500,1,00034,India
900197,2023-06-29,505,oven,18490,24000,5510,1,00034,India
651507,2023-06-29,501,iphone 15,60000,80000,20000,1,00098,India
651507,2023-06-29,507,washing machine,6990,16490,9500,1,00098,India
651507,2023-06-29,506,monitor,3249,8000,4751,1,00098,India
854208,2023-06-29,503,mixer,1349,3249,1900,1,00393,India
854208,2023-06-29,506,monitor,3249,8000,4751,1,00393,India
515265,2023-06-29,502,iphone 15 pro max,100000,135000,35000,1,00208,India
515265,2023-06-29,506,monitor,3249,8000,4751,1,00208,India
515265,2023-06-29,503,mixer,1349,3249,1900,1,00208,India
515265,2023-06-29,507,washing machine,6990,16490,9500,1,00208,India
505109,2023-06-29,507,washing machine,6990,16490,9500,1,00312,India
133257,2023-06-29,504,iron,449,879,430,1,00198,India
133257,2023-06-29,502,iphone 15 pro max,100000,135000,35000,1,00198,India
809581,2023-06-29,502,iphone 15 pro max,100000,135000,35000,1,00352,India
809581,2023-06-29,506,monitor,3249,8000,4751,1,00352,India
693722,2023-06-29,507,washing machine,6990,16490,9500,1,00362,India
693722,2023-06-29,501,iphone 15,60000,80000,20000,1,00362,India
491939,2023-06-29,502,iphone 15 pro max,100000,135000,35000,1,00062,India
907370,2023-06-29,501,iphone 15,60000,80000,20000,1,00356,India
907370,2023-06-29,506,monitor,3249,8000,4751,1,00356,India
859097,2023-06-29,506,monitor,3249,8000,4751,1,00301,India
859097,2023-06-29,503,mixer,1349,3249,1900,1,00301,India
583617,2023-06-29,507,washing machine,6990,16490,9500,1,00489,India
583617,2023-06-29,506,monitor,3249,8000,4751,1,00489,India
583617,2023-06-29,505,oven,18490,24000,5510,1,00489,India
583617,2023-06-29,504,iron,449,879,430,1,00489,India
886140,2023-06-29,504,iron,449,879,430,1,00040,India
886140,2023-06-29,501,iphone 15,60000,80000,20000,1,00040,India
886140,2023-06-29,503,mixer,1349,3249,1900,1,00040,India
740849,2023-06-29,507,washing machine,6990,16490,9500,1,00409,India
740849,2023-06-29,503,mixer,1349,3249,1900,1,00409,India
740849,2023-06-29,504,iron,449,879,430,1,00409,India
740849,2023-06-29,506,monitor,3249,8000,4751,1,00409,India
100720,2023-06-29,502,iphone 15 pro max,100000,135000,35000,1,00121,India
100720,2023-06-29,506,monitor,3249,8000,4751,1,00121,India
100720,2023-06-29,501,iphone 15,60000,80000,20000,1,00121,India
100720,2023-06-29,505,oven,18490,24000,5510,1,00121,India
335718,2023-06-29,506,monitor,3249,8000,4751,1,00466,India
335718,2023-06-29,502,iphone 15 pro max,100000,135000,35000,1,00466,India
971848,2023-06-29,501,iphone 15,60000,80000,20000,1,00289,India
971848,2023-06-29,503,mixer,1349,3249,1900,1,00289,India
674561,2023-06-29,504,iron,449,879,430,1,00038,India
674561,2023-06-29,507,washing machine,6990,16490,9500,1,00038,India
674561,2023-06-29,503,mixer,1349,3249,1900,1,00038,India
674561,2023-06-29,506,monitor,3249,8000,4751,1,00038,India
605600,2023-06-29,501,iphone 15,60000,80000,20000,1,00190,India
592783,2023-06-29,504,iron,449,879,430,1,00096,India
592783,2023-06-29,502,iphone 15 pro max,100000,135000,35000,1,00096,India
592783,2023-06-29,506,monitor,3249,8000,4751,1,00096,India
592783,2023-06-29,501,iphone 15,60000,80000,20000,1,00096,India
934384,2023-06-29,503,mixer,1349,3249,1900,1,00200,India
934384,2023-06-29,505,oven,18490,24000,5510,1,00200,India
934384,2023-06-29,506,monitor,3249,8000,4751,1,00200,India
649218,2023-06-29,505,oven,18490,24000,5510,1,00346,India
649218,2023-06-29,501,iphone 15,60000,80000,20000,1,00346,India
649218,2023-06-29,507,washing machine,6990,16490,9500,1,00346,India
118524,2023-06-29,502,iphone 15 pro max,100000,135000,35000,1,00380,India
118524,2023-06-29,505,oven,18490,24000,5510,1,00380,India
628081,2023-06-29,502,iphone 15 pro max,100000,135000,35000,1,00301,India
628081,2023-06-29,506,monitor,3249,8000,4751,1,00301,India
628081,2023-06-29,503,mixer,1349,3249,1900,1,00301,India
628081,2023-06-29,504,iron,449,879,430,1,00301,India
478834,2023-06-29,507,washing machine,6990,16490,9500,1,00373,India
478834,2023-06-29,502,iphone 15 pro max,100000,135000,35000,1,00373,India
663560,2023-06-29,506,monitor,3249,8000,4751,1,00046,India
663560,2023-06-29,501,iphone 15,60000,80000,20000,1,00046,India
722495,2023-06-29,505,oven,18490,24000,5510,1,00077,India
722495,2023-06-29,507,washing machine,6990,16490,9500,1,00077,India
722495,2023-06-29,504,iron,449,879,430,1,00077,India
722495,2023-06-29,502,iphone 15 pro max,100000,135000,35000,1,00077,India
722495,2023-06-29,506,monitor,3249,8000,4751,1,00077,India
614478,2023-06-29,503,mixer,1349,3249,1900,1,00390,India
117391,2023-06-29,507,washing machine,6990,16490,9500,1,00184,India
117391,2023-06-29,504,iron,449,879,430,1,00184,India
534776,2023-06-29,506,monitor,3249,8000,4751,1,00301,India
534776,2023-06-29,504,iron,449,879,430,1,00301,India
912507,2023-06-29,503,mixer,1349,3249,1900,1,00323,India
912507,2023-06-29,502,iphone 15 pro max,100000,135000,35000,1,00323,India
912507,2023-06-29,505,oven,18490,24000,5510,1,00323,India
241868,2023-06-29,507,washing machine,6990,16490,9500,1,00229,India
241868,2023-06-29,503,mixer,1349,3249,1900,1,00229,India
849367,2023-06-30,501,iphone 15,60000,80000,20000,1,00416,India
891813,2023-06-30,504,iron,449,879,430,1,00319,India
891813,2023-06-30,501,iphone 15,60000,80000,20000,1,00319,India
891813,2023-06-30,505,oven,18490,24000,5510,1,00319,India
923772,2023-06-30,507,washing machine,6990,16490,9500,1,00323,India
547171,2023-06-30,506,monitor,3249,8000,4751,1,00482,India
547171,2023-06-30,507,washing machine,6990,16490,9500,1,00482,India
547171,2023-06-30,501,iphone 15,60000,80000,20000,1,00482,India
667394,2023-06-30,507,washing machine,6990,16490,9500,1,00040,India
667394,2023-06-30,504,iron,449,879,430,1,00040,India
667394,2023-06-30,502,iphone 15 pro max,100000,135000,35000,1,00040,India
667394,2023-06-30,505,oven,18490,24000,5510,1,00040,India
494756,2023-06-30,505,oven,18490,24000,5510,1,00066,India
500721,2023-06-30,503,mixer,1349,3249,1900,1,00038,India
182168,2023-06-30,505,oven,18490,24000,5510,1,00139,India
182168,2023-06-30,507,washing machine,6990,16490,9500,1,00139,India
182168,2023-06-30,502,iphone 15 pro max,100000,135000,35000,1,00139,India
182168,2023-06-30,503,mixer,1349,3249,1900,1,00139,India
465375,2023-06-30,504,iron,449,879,430,1,00057,India
465375,2023-06-30,506,monitor,3249,8000,4751,1,00057,India
465375,2023-06-30,501,iphone 15,60000,80000,20000,1,00057,India
465375,2023-06-30,505,oven,18490,24000,5510,1,00057,India
872381,2023-06-30,503,mixer,1349,3249,1900,1,00482,India
872381,2023-06-30,505,oven,18490,24000,5510,1,00482,India
872381,2023-06-30,502,iphone 15 pro max,100000,135000,35000,1,00482,India
417498,2023-06-30,502,iphone 15 pro max,100000,135000,35000,1,00274,India
417498,2023-06-30,507,washing machine,6990,16490,9500,1,00274,India
544280,2023-06-30,507,washing machine,6990,16490,9500,1,00313,India
544280,2023-06-30,501,iphone 15,60000,80000,20000,1,00313,India
544280,2023-06-30,505,oven,18490,24000,5510,1,00313,India
801628,2023-06-30,502,iphone 15 pro max,100000,135000,35000,1,00118,India
698697,2023-06-30,503,mixer,1349,3249,1900,1,00160,India
307174,2023-06-30,501,iphone 15,60000,80000,20000,1,00024,India
307174,2023-06-30,504,iron,449,879,430,1,00024,India
307174,2023-06-30,506,monitor,3249,8000,4751,1,00024,India
307174,2023-06-30,507,washing machine,6990,16490,9500,1,00024,India
189320,2023-06-30,503,mixer,1349,3249,1900,1,00435,India
189320,2023-06-30,505,oven,18490,24000,5510,1,00435,India
605333,2023-06-30,502,iphone 15 pro max,100000,135000,35000,1,00019,India
605333,2023-06-30,506,monitor,3249,8000,4751,1,00019,India
605333,2023-06-30,501,iphone 15,60000,80000,20000,1,00019,India
433222,2023-06-30,504,iron,449,879,430,1,00128,India
433222,2023-06-30,502,iphone 15 pro max,100000,135000,35000,1,00128,India
433222,2023-06-30,501,iphone 15,60000,80000,20000,1,00128,India
433222,2023-06-30,505,oven,18490,24000,5510,1,00128,India
400608,2023-06-30,503,mixer,1349,3249,1900,1,00072,India
400608,2023-06-30,506,monitor,3249,8000,4751,1,00072,India
400608,2023-06-30,501,iphone 15,60000,80000,20000,1,00072,India
495155,2023-06-30,504,iron,449,879,430,1,00286,India
495155,2023-06-30,505,oven,18490,24000,5510,1,00286,India
482945,2023-06-30,502,iphone 15 pro max,100000,135000,35000,1,00289,India
482945,2023-06-30,503,mixer,1349,3249,1900,1,00289,India
109532,2023-06-30,503,mixer,1349,3249,1900,1,00304,India
109532,2023-06-30,507,washing machine,6990,16490,9500,1,00304,India
109532,2023-06-30,505,oven,18490,24000,5510,1,00304,India
434507,2023-06-30,504,iron,449,879,430,1,00442,India
434507,2023-06-30,502,iphone 15 pro max,100000,135000,35000,1,00442,India
434507,2023-06-30,501,iphone 15,60000,80000,20000,1,00442,India
434507,2023-06-30,507,washing machine,6990,16490,9500,1,00442,India
128417,2023-06-30,502,iphone 15 pro max,100000,135000,35000,1,00096,India
128417,2023-06-30,503,mixer,1349,3249,1900,1,00096,India
454786,2023-06-30,506,monitor,3249,8000,4751,1,00490,India
454786,2023-06-30,503,mixer,1349,3249,1900,1,00490,India
454786,2023-06-30,505,oven,18490,24000,5510,1,00490,India
278411,2023-06-30,506,monitor,3249,8000,4751,1,00250,India
577948,2023-06-30,502,iphone 15 pro max,100000,135000,35000,1,00132,India
577948,2023-06-30,504,iron,449,879,430,1,00132,India
577948,2023-06-30,501,iphone 15,60000,80000,20000,1,00132,India
577948,2023-06-30,503,mixer,1349,3249,1900,1,00132,India
755818,2023-06-30,504,iron,449,879,430,1,00001,India
755818,2023-06-30,506,monitor,3249,8000,4751,1,00001,India
671996,2023-06-30,506,monitor,3249,8000,4751,1,00321,India
671996,2023-06-30,503,mixer,1349,3249,1900,1,00321,India
799478,2023-06-30,505,oven,18490,24000,5510,1,00013,India
799478,2023-06-30,502,iphone 15 pro max,100000,135000,35000,1,00013,India
799478,2023-06-30,501,iphone 15,60000,80000,20000,1,00013,India
799478,2023-06-30,503,mixer,1349,3249,1900,1,00013,India
601132,2023-06-30,506,monitor,3249,8000,4751,1,00126,India
601132,2023-06-30,502,iphone 15 pro max,100000,135000,35000,1,00126,India
601132,2023-06-30,505,oven,18490,24000,5510,1,00126,India
500489,2023-06-30,503,mixer,1349,3249,1900,1,00383,India
500489,2023-06-30,502,iphone 15 pro max,100000,135000,35000,1,00383,India
500489,2023-06-30,506,monitor,3249,8000,4751,1,00383,India
280133,2023-06-30,506,monitor,3249,8000,4751,1,00180,India
821056,2023-06-30,504,iron,449,879,430,1,00105,India
821056,2023-06-30,505,oven,18490,24000,5510,1,00105,India
956945,2023-06-30,502,iphone 15 pro max,100000,135000,35000,1,00219,India
956945,2023-06-30,501,iphone 15,60000,80000,20000,1,00219,India
956945,2023-06-30,504,iron,449,879,430,1,00219,India
872044,2023-06-30,504,iron,449,879,430,1,00371,India
872044,2023-06-30,506,monitor,3249,8000,4751,1,00371,India
382382,2023-06-30,507,washing machine,6990,16490,9500,1,00137,India
382382,2023-06-30,503,mixer,1349,3249,1900,1,00137,India
382382,2023-06-30,505,oven,18490,24000,5510,1,00137,India
382382,2023-06-30,501,iphone 15,60000,80000,20000,1,00137,India
382382,2023-06-30,502,iphone 15 pro max,100000,135000,35000,1,00137,India
778708,2023-06-30,506,monitor,3249,8000,4751,1,00460,India
778708,2023-06-30,501,iphone 15,60000,80000,20000,1,00460,India
428589,2023-06-30,502,iphone 15 pro max,100000,135000,35000,1,00244,India
428589,2023-06-30,503,mixer,1349,3249,1900,1,00244,India
889998,2023-06-30,501,iphone 15,60000,80000,20000,1,00095,India
889998,2023-06-30,506,monitor,3249,8000,4751,1,00095,India
963901,2023-06-30,504,iron,449,879,430,1,00467,India
963901,2023-06-30,503,mixer,1349,3249,1900,1,00467,India
963901,2023-06-30,507,washing machine,6990,16490,9500,1,00467,India
579210,2023-06-30,505,oven,18490,24000,5510,1,00062,India
579210,2023-06-30,501,iphone 15,60000,80000,20000,1,00062,India
752491,2023-06-30,504,iron,449,879,430,1,00442,India
575720,2023-06-30,504,iron,449,879,430,1,00131,India
598921,2023-06-30,504,iron,449,879,430,1,00374,India
598921,2023-06-30,501,iphone 15,60000,80000,20000,1,00374,India
964803,2023-06-30,501,iphone 15,60000,80000,20000,1,00363,India
964803,2023-06-30,506,monitor,3249,8000,4751,1,00363,India
964803,2023-06-30,504,iron,449,879,430,1,00363,India
605523,2023-06-30,506,monitor,3249,8000,4751,1,00481,India
504426,2023-06-30,501,iphone 15,60000,80000,20000,1,00087,India
504426,2023-06-30,504,iron,449,879,430,1,00087,India
876827,2023-06-30,504,iron,449,879,430,1,00312,India
876827,2023-06-30,502,iphone 15 pro max,100000,135000,35000,1,00312,India
876827,2023-06-30,505,oven,18490,24000,5510,1,00312,India
876827,2023-06-30,503,mixer,1349,3249,1900,1,00312,India
122128,2023-06-30,505,oven,18490,24000,5510,1,00452,India
122128,2023-06-30,507,washing machine,6990,16490,9500,1,00452,India
122128,2023-06-30,506,monitor,3249,8000,4751,1,00452,India
122128,2023-06-30,502,iphone 15 pro max,100000,135000,35000,1,00452,India
471772,2023-06-30,502,iphone 15 pro max,100000,135000,35000,1,00410,India
471772,2023-06-30,504,iron,449,879,430,1,00410,India
468438,2023-06-30,503,mixer,1349,3249,1900,1,00201,India
468438,2023-06-30,501,iphone 15,60000,80000,20000,1,00201,India
468438,2023-06-30,507,washing machine,6990,16490,9500,1,00201,India
468438,2023-06-30,504,iron,449,879,430,1,00201,India
827407,2023-06-30,505,oven,18490,24000,5510,1,00427,India
198400,2023-06-30,507,washing machine,6990,16490,9500,1,00080,India
198400,2023-06-30,501,iphone 15,60000,80000,20000,1,00080,India
198400,2023-06-30,505,oven,18490,24000,5510,1,00080,India
406484,2023-06-30,505,oven,18490,24000,5510,1,00291,India
406484,2023-06-30,504,iron,449,879,430,1,00291,India
406484,2023-06-30,506,monitor,3249,8000,4751,1,00291,India
536791,2023-07-01,501,iphone 15,60000,80000,20000,1,00426,India
536791,2023-07-01,504,iron,449,879,430,1,00426,India
536791,2023-07-01,502,iphone 15 pro max,100000,135000,35000,1,00426,India
763085,2023-07-01,501,iphone 15,60000,80000,20000,1,00046,India
763085,2023-07-01,503,mixer,1349,3249,1900,1,00046,India
763085,2023-07-01,505,oven,18490,24000,5510,1,00046,India
365040,2023-07-01,506,monitor,3249,8000,4751,1,00323,India
365040,2023-07-01,502,iphone 15 pro max,100000,135000,35000,1,00323,India
754394,2023-07-01,507,washing machine,6990,16490,9500,1,00185,India
623892,2023-07-01,501,iphone 15,60000,80000,20000,1,00289,India
623892,2023-07-01,502,iphone 15 pro max,100000,135000,35000,1,00289,India
623892,2023-07-01,505,oven,18490,24000,5510,1,00289,India
831081,2023-07-01,502,iphone 15 pro max,100000,135000,35000,1,00416,India
831081,2023-07-01,504,iron,449,879,430,1,00416,India
831081,2023-07-01,506,monitor,3249,8000,4751,1,00416,India
184388,2023-07-01,501,iphone 15,60000,80000,20000,1,00304,India
184388,2023-07-01,504,iron,449,879,430,1,00304,India
184388,2023-07-01,507,washing machine,6990,16490,9500,1,00304,India
719360,2023-07-01,507,washing machine,6990,16490,9500,1,00009,India
719360,2023-07-01,506,monitor,3249,8000,4751,1,00009,India
719360,2023-07-01,504,iron,449,879,430,1,00009,India
162233,2023-07-01,507,washing machine,6990,16490,9500,1,00312,India
162233,2023-07-01,505,oven,18490,24000,5510,1,00312,India
199136,2023-07-01,504,iron,449,879,430,1,00134,India
199136,2023-07-01,506,monitor,3249,8000,4751,1,00134,India
172361,2023-07-01,504,iron,449,879,430,1,00329,India
172361,2023-07-01,507,washing machine,6990,16490,9500,1,00329,India
172361,2023-07-01,502,iphone 15 pro max,100000,135000,35000,1,00329,India
290868,2023-07-01,504,iron,449,879,430,1,00452,India
290868,2023-07-01,507,washing machine,6990,16490,9500,1,00452,India
259371,2023-07-01,507,washing machine,6990,16490,9500,1,00275,India
259371,2023-07-01,503,mixer,1349,3249,1900,1,00275,India
368878,2023-07-01,501,iphone 15,60000,80000,20000,1,00283,India
368878,2023-07-01,504,iron,449,879,430,1,00283,India
368878,2023-07-01,503,mixer,1349,3249,1900,1,00283,India
368878,2023-07-01,506,monitor,3249,8000,4751,1,00283,India
349672,2023-07-01,506,monitor,3249,8000,4751,1,00348,India
349672,2023-07-01,504,iron,449,879,430,1,00348,India
349672,2023-07-01,507,washing machine,6990,16490,9500,1,00348,India
349672,2023-07-01,505,oven,18490,24000,5510,1,00348,India
364540,2023-07-01,507,washing machine,6990,16490,9500,1,00434,India
364540,2023-07-01,504,iron,449,879,430,1,00434,India
364540,2023-07-01,502,iphone 15 pro max,100000,135000,35000,1,00434,India
364540,2023-07-01,503,mixer,1349,3249,1900,1,00434,India
884477,2023-07-01,505,oven,18490,24000,5510,1,00326,India
884477,2023-07-01,503,mixer,1349,3249,1900,1,00326,India
884477,2023-07-01,502,iphone 15 pro max,100000,135000,35000,1,00326,India
303723,2023-07-01,504,iron,449,879,430,1,00481,India
303723,2023-07-01,507,washing machine,6990,16490,9500,1,00481,India
303723,2023-07-01,503,mixer,1349,3249,1900,1,00481,India
157603,2023-07-01,504,iron,449,879,430,1,00263,India
157603,2023-07-01,507,washing machine,6990,16490,9500,1,00263,India
759611,2023-07-01,505,oven,18490,24000,5510,1,00301,India
759611,2023-07-01,503,mixer,1349,3249,1900,1,00301,India
263118,2023-07-01,502,iphone 15 pro max,100000,135000,35000,1,00292,India
152452,2023-07-01,501,iphone 15,60000,80000,20000,1,00151,India
152452,2023-07-01,504,iron,449,879,430,1,00151,India
450696,2023-07-01,505,oven,18490,24000,5510,1,00047,India
450696,2023-07-01,506,monitor,3249,8000,4751,1,00047,India
450696,2023-07-01,507,washing machine,6990,16490,9500,1,00047,India
210173,2023-07-01,502,iphone 15 pro max,100000,135000,35000,1,00468,India
210173,2023-07-01,506,monitor,3249,8000,4751,1,00468,India
210173,2023-07-01,504,iron,449,879,430,1,00468,India
210173,2023-07-01,505,oven,18490,24000,5510,1,00468,India
210173,2023-07-01,503,mixer,1349,3249,1900,1,00468,India
470741,2023-07-01,502,iphone 15 pro max,100000,135000,35000,1,00300,India
470741,2023-07-01,507,washing machine,6990,16490,9500,1,00300,India
470741,2023-07-01,505,oven,18490,24000,5510,1,00300,India
219800,2023-07-01,501,iphone 15,60000,80000,20000,1,00387,India
219800,2023-07-01,503,mixer,1349,3249,1900,1,00387,India
219800,2023-07-01,502,iphone 15 pro max,100000,135000,35000,1,00387,India
372404,2023-07-01,502,iphone 15 pro max,100000,135000,35000,1,00010,India
372404,2023-07-01,503,mixer,1349,3249,1900,1,00010,India
923984,2023-07-01,503,mixer,1349,3249,1900,1,00215,India
195538,2023-07-01,505,oven,18490,24000,5510,1,00473,India
195538,2023-07-01,504,iron,449,879,430,1,00473,India
654848,2023-07-01,503,mixer,1349,3249,1900,1,00128,India
654848,2023-07-01,506,monitor,3249,8000,4751,1,00128,India
830227,2023-07-01,502,iphone 15 pro max,100000,135000,35000,1,00331,India
830227,2023-07-01,503,mixer,1349,3249,1900,1,00331,India
830227,2023-07-01,506,monitor,3249,8000,4751,1,00331,India
830227,2023-07-01,501,iphone 15,60000,80000,20000,1,00331,India
232473,2023-07-01,501,iphone 15,60000,80000,20000,1,00371,India
165028,2023-07-01,502,iphone 15 pro max,100000,135000,35000,1,00403,India
429745,2023-07-01,506,monitor,3249,8000,4751,1,00361,India
429745,2023-07-01,501,iphone 15,60000,80000,20000,1,00361,India
429745,2023-07-01,505,oven,18490,24000,5510,1,00361,India
901201,2023-07-01,506,monitor,3249,8000,4751,1,00117,India
901201,2023-07-01,505,oven,18490,24000,5510,1,00117,India
901201,2023-07-01,504,iron,449,879,430,1,00117,India
174838,2023-07-01,501,iphone 15,60000,80000,20000,1,00243,India
174838,2023-07-01,506,monitor,3249,8000,4751,1,00243,India
174838,2023-07-01,505,oven,18490,24000,5510,1,00243,India
271023,2023-07-01,504,iron,449,879,430,1,00184,India
271023,2023-07-01,506,monitor,3249,8000,4751,1,00184,India
271023,2023-07-01,503,mixer,1349,3249,1900,1,00184,India
271023,2023-07-01,502,iphone 15 pro max,100000,135000,35000,1,00184,India
333710,2023-07-01,503,mixer,1349,3249,1900,1,00219,India
333710,2023-07-01,506,monitor,3249,8000,4751,1,00219,India
595142,2023-07-01,501,iphone 15,60000,80000,20000,1,00338,India
595142,2023-07-01,502,iphone 15 pro max,100000,135000,35000,1,00338,India
595142,2023-07-01,503,mixer,1349,3249,1900,1,00338,India
358864,2023-07-01,505,oven,18490,24000,5510,1,00400,India
149925,2023-07-01,503,mixer,1349,3249,1900,1,00041,India
149925,2023-07-01,506,monitor,3249,8000,4751,1,00041,India
149925,2023-07-01,507,washing machine,6990,16490,9500,1,00041,India
876739,2023-07-01,501,iphone 15,60000,80000,20000,1,00498,India
876739,2023-07-01,505,oven,18490,24000,5510,1,00498,India
876739,2023-07-01,503,mixer,1349,3249,1900,1,00498,India
455296,2023-07-01,503,mixer,1349,3249,1900,1,00487,India
455296,2023-07-01,507,washing machine,6990,16490,9500,1,00487,India
882559,2023-07-01,503,mixer,1349,3249,1900,1,00384,India
882559,2023-07-01,504,iron,449,879,430,1,00384,India
882559,2023-07-01,506,monitor,3249,8000,4751,1,00384,India
605693,2023-07-01,507,washing machine,6990,16490,9500,1,00161,India
605693,2023-07-01,506,monitor,3249,8000,4751,1,00161,India
605693,2023-07-01,502,iphone 15 pro max,100000,135000,35000,1,00161,India
605693,2023-07-01,504,iron,449,879,430,1,00161,India
557125,2023-07-01,502,iphone 15 pro max,100000,135000,35000,1,00040,India
381833,2023-07-01,504,iron,449,879,430,1,00235,India
381833,2023-07-01,501,iphone 15,60000,80000,20000,1,00235,India
381833,2023-07-01,506,monitor,3249,8000,4751,1,00235,India
861598,2023-07-01,503,mixer,1349,3249,1900,1,00204,India
988917,2023-07-01,502,iphone 15 pro max,100000,135000,35000,1,00055,India
234028,2023-07-01,502,iphone 15 pro max,100000,135000,35000,1,00377,India
234028,2023-07-01,501,iphone 15,60000,80000,20000,1,00377,India
885369,2023-07-01,507,washing machine,6990,16490,9500,1,00339,India
885369,2023-07-01,506,monitor,3249,8000,4751,1,00339,India
885369,2023-07-01,502,iphone 15 pro max,100000,135000,35000,1,00339,India
748223,2023-07-01,506,monitor,3249,8000,4751,1,00317,India
748223,2023-07-01,505,oven,18490,24000,5510,1,00317,India
467713,2023-07-01,505,oven,18490,24000,5510,1,00381,India
467713,2023-07-01,504,iron,449,879,430,1,00381,India
467713,2023-07-01,503,mixer,1349,3249,1900,1,00381,India
789326,2023-07-01,504,iron,449,879,430,1,00124,India
789326,2023-07-01,505,oven,18490,24000,5510,1,00124,India
789326,2023-07-01,503,mixer,1349,3249,1900,1,00124,India
789326,2023-07-01,501,iphone 15,60000,80000,20000,1,00124,India
789326,2023-07-01,507,washing machine,6990,16490,9500,1,00124,India
168615,2023-07-01,504,iron,449,879,430,1,00263,India
168615,2023-07-01,507,washing machine,6990,16490,9500,1,00263,India
168615,2023-07-01,503,mixer,1349,3249,1900,1,00263,India
444343,2023-07-01,507,washing machine,6990,16490,9500,1,00189,India
444343,2023-07-01,501,iphone 15,60000,80000,20000,1,00189,India
444343,2023-07-01,504,iron,449,879,430,1,00189,India
740301,2023-07-01,502,iphone 15 pro max,100000,135000,35000,1,00156,India
740301,2023-07-01,503,mixer,1349,3249,1900,1,00156,India
768328,2023-07-01,501,iphone 15,60000,80000,20000,1,00455,India
768328,2023-07-01,502,iphone 15 pro max,100000,135000,35000,1,00455,India
768328,2023-07-01,504,iron,449,879,430,1,00455,India
768328,2023-07-01,507,washing machine,6990,16490,9500,1,00455,India
685025,2023-07-01,506,monitor,3249,8000,4751,1,00481,India
685025,2023-07-01,502,iphone 15 pro max,100000,135000,35000,1,00481,India
685025,2023-07-01,503,mixer,1349,3249,1900,1,00481,India
685025,2023-07-01,501,iphone 15,60000,80000,20000,1,00481,India
979231,2023-07-01,506,monitor,3249,8000,4751,1,00306,India
979231,2023-07-01,504,iron,449,879,430,1,00306,India
342238,2023-07-01,505,oven,18490,24000,5510,1,00375,India
342238,2023-07-01,506,monitor,3249,8000,4751,1,00375,India
476910,2023-07-01,503,mixer,1349,3249,1900,1,00325,India
476910,2023-07-01,501,iphone 15,60000,80000,20000,1,00325,India
476910,2023-07-01,502,iphone 15 pro max,100000,135000,35000,1,00325,India
263839,2023-07-01,506,monitor,3249,8000,4751,1,00390,India
263839,2023-07-01,505,oven,18490,24000,5510,1,00390,India
263839,2023-07-01,502,iphone 15 pro max,100000,135000,35000,1,00390,India
666216,2023-07-01,502,iphone 15 pro max,100000,135000,35000,1,00276,India
898641,2023-07-01,507,washing machine,6990,16490,9500,1,00196,India
669541,2023-07-01,503,mixer,1349,3249,1900,1,00137,India
669541,2023-07-01,502,iphone 15 pro max,100000,135000,35000,1,00137,India
669541,2023-07-01,506,monitor,3249,8000,4751,1,00137,India
669541,2023-07-01,505,oven,18490,24000,5510,1,00137,India
648194,2023-07-01,505,oven,18490,24000,5510,1,00404,India
481012,2023-07-01,501,iphone 15,60000,80000,20000,1,00052,India
481012,2023-07-01,503,mixer,1349,3249,1900,1,00052,India
481012,2023-07-01,502,iphone 15 pro max,100000,135000,35000,1,00052,India
481012,2023-07-01,505,oven,18490,24000,5510,1,00052,India
412532,2023-07-01,503,mixer,1349,3249,1900,1,00305,India
412532,2023-07-01,506,monitor,3249,8000,4751,1,00305,India
214564,2023-07-01,504,iron,449,879,430,1,00268,India
214564,2023-07-01,502,iphone 15 pro max,100000,135000,35000,1,00268,India
214564,2023-07-01,503,mixer,1349,3249,1900,1,00268,India
963434,2023-07-01,502,iphone 15 pro max,100000,135000,35000,1,00061,India
963434,2023-07-01,503,mixer,1349,3249,1900,1,00061,India
963434,2023-07-01,505,oven,18490,24000,5510,1,00061,India
188533,2023-07-01,501,iphone 15,60000,80000,20000,1,00407,India
188533,2023-07-01,502,iphone 15 pro max,100000,135000,35000,1,00407,India
188533,2023-07-01,507,washing machine,6990,16490,9500,1,00407,India
188533,2023-07-01,505,oven,18490,24000,5510,1,00407,India
489295,2023-07-01,501,iphone 15,60000,80000,20000,1,00375,India
489295,2023-07-01,505,oven,18490,24000,5510,1,00375,India
703867,2023-07-01,506,monitor,3249,8000,4751,1,00395,India
703867,2023-07-01,503,mixer,1349,3249,1900,1,00395,India
703867,2023-07-01,507,washing machine,6990,16490,9500,1,00395,India
502262,2023-07-01,503,mixer,1349,3249,1900,1,00377,India
502262,2023-07-01,505,oven,18490,24000,5510,1,00377,India
239218,2023-07-01,506,monitor,3249,8000,4751,1,00374,India
239218,2023-07-01,504,iron,449,879,430,1,00374,India
239218,2023-07-01,502,iphone 15 pro max,100000,135000,35000,1,00374,India
180784,2023-07-01,501,iphone 15,60000,80000,20000,1,00083,India
180784,2023-07-01,507,washing machine,6990,16490,9500,1,00083,India
180784,2023-07-01,502,iphone 15 pro max,100000,135000,35000,1,00083,India
375508,2023-07-01,503,mixer,1349,3249,1900,1,00163,India
375508,2023-07-01,505,oven,18490,24000,5510,1,00163,India
192432,2023-07-02,502,iphone 15 pro max,100000,135000,35000,1,00040,India
192432,2023-07-02,505,oven,18490,24000,5510,1,00040,India
192432,2023-07-02,507,washing machine,6990,16490,9500,1,00040,India
192432,2023-07-02,501,iphone 15,60000,80000,20000,1,00040,India
453746,2023-07-02,502,iphone 15 pro max,100000,135000,35000,1,00212,India
453746,2023-07-02,501,iphone 15,60000,80000,20000,1,00212,India
453746,2023-07-02,503,mixer,1349,3249,1900,1,00212,India
450875,2023-07-02,503,mixer,1349,3249,1900,1,00378,India
450875,2023-07-02,506,monitor,3249,8000,4751,1,00378,India
450875,2023-07-02,505,oven,18490,24000,5510,1,00378,India
967782,2023-07-02,505,oven,18490,24000,5510,1,00262,India
967782,2023-07-02,501,iphone 15,60000,80000,20000,1,00262,India
967782,2023-07-02,504,iron,449,879,430,1,00262,India
967782,2023-07-02,506,monitor,3249,8000,4751,1,00262,India
179063,2023-07-02,501,iphone 15,60000,80000,20000,1,00446,India
179063,2023-07-02,507,washing machine,6990,16490,9500,1,00446,India
179063,2023-07-02,502,iphone 15 pro max,100000,135000,35000,1,00446,India
179063,2023-07-02,505,oven,18490,24000,5510,1,00446,India
163677,2023-07-02,501,iphone 15,60000,80000,20000,1,00039,India
586943,2023-07-02,504,iron,449,879,430,1,00221,India
586943,2023-07-02,501,iphone 15,60000,80000,20000,1,00221,India
219897,2023-07-02,502,iphone 15 pro max,100000,135000,35000,1,00448,India
219897,2023-07-02,506,monitor,3249,8000,4751,1,00448,India
219897,2023-07-02,503,mixer,1349,3249,1900,1,00448,India
183565,2023-07-02,503,mixer,1349,3249,1900,1,00330,India
183565,2023-07-02,505,oven,18490,24000,5510,1,00330,India
183565,2023-07-02,506,monitor,3249,8000,4751,1,00330,India
559118,2023-07-02,502,iphone 15 pro max,100000,135000,35000,1,00323,India
559118,2023-07-02,506,monitor,3249,8000,4751,1,00323,India
559118,2023-07-02,503,mixer,1349,3249,1900,1,00323,India
217612,2023-07-02,501,iphone 15,60000,80000,20000,1,00156,India
217612,2023-07-02,507,washing machine,6990,16490,9500,1,00156,India
217612,2023-07-02,506,monitor,3249,8000,4751,1,00156,India
217612,2023-07-02,503,mixer,1349,3249,1900,1,00156,India
260397,2023-07-02,501,iphone 15,60000,80000,20000,1,00270,India
260397,2023-07-02,505,oven,18490,24000,5510,1,00270,India
260397,2023-07-02,502,iphone 15 pro max,100000,135000,35000,1,00270,India
260397,2023-07-02,503,mixer,1349,3249,1900,1,00270,India
324178,2023-07-02,507,washing machine,6990,16490,9500,1,00212,India
324178,2023-07-02,502,iphone 15 pro max,100000,135000,35000,1,00212,India
324178,2023-07-02,505,oven,18490,24000,5510,1,00212,India
446949,2023-07-02,507,washing machine,6990,16490,9500,1,00235,India
446949,2023-07-02,502,iphone 15 pro max,100000,135000,35000,1,00235,India
446949,2023-07-02,504,iron,449,879,430,1,00235,India
446949,2023-07-02,505,oven,18490,24000,5510,1,00235,India
482286,2023-07-02,506,monitor,3249,8000,4751,1,00006,India
482286,2023-07-02,502,iphone 15 pro max,100000,135000,35000,1,00006,India
482286,2023-07-02,501,iphone 15,60000,80000,20000,1,00006,India
675619,2023-07-02,503,mixer,1349,3249,1900,1,00247,India
675619,2023-07-02,505,oven,18490,24000,5510,1,00247,India
240744,2023-07-02,502,iphone 15 pro max,100000,135000,35000,1,00029,India
240744,2023-07-02,506,monitor,3249,8000,4751,1,00029,India
240744,2023-07-02,503,mixer,1349,3249,1900,1,00029,India
240744,2023-07-02,504,iron,449,879,430,1,00029,India
920618,2023-07-02,506,monitor,3249,8000,4751,1,00433,India
920618,2023-07-02,504,iron,449,879,430,1,00433,India
133175,2023-07-02,505,oven,18490,24000,5510,1,00093,India
133175,2023-07-02,507,washing machine,6990,16490,9500,1,00093,India
641557,2023-07-02,501,iphone 15,60000,80000,20000,1,00382,India
672354,2023-07-02,506,monitor,3249,8000,4751,1,00205,India
672354,2023-07-02,503,mixer,1349,3249,1900,1,00205,India
122224,2023-07-02,503,mixer,1349,3249,1900,1,00109,India
122224,2023-07-02,506,monitor,3249,8000,4751,1,00109,India
122224,2023-07-02,505,oven,18490,24000,5510,1,00109,India
996923,2023-07-02,503,mixer,1349,3249,1900,1,00072,India
996923,2023-07-02,504,iron,449,879,430,1,00072,India
996923,2023-07-02,507,washing machine,6990,16490,9500,1,00072,India
996923,2023-07-02,502,iphone 15 pro max,100000,135000,35000,1,00072,India
276700,2023-07-02,504,iron,449,879,430,1,00043,India
276700,2023-07-02,507,washing machine,6990,16490,9500,1,00043,India
276700,2023-07-02,506,monitor,3249,8000,4751,1,00043,India
945846,2023-07-02,506,monitor,3249,8000,4751,1,00190,India
740554,2023-07-02,505,oven,18490,24000,5510,1,00298,India
740554,2023-07-02,507,washing machine,6990,16490,9500,1,00298,India
740554,2023-07-02,502,iphone 15 pro max,100000,135000,35000,1,00298,India
740554,2023-07-02,504,iron,449,879,430,1,00298,India
229466,2023-07-02,501,iphone 15,60000,80000,20000,1,00447,India
271566,2023-07-02,505,oven,18490,24000,5510,1,00447,India
271566,2023-07-02,502,iphone 15 pro max,100000,135000,35000,1,00447,India
584732,2023-07-02,504,iron,449,879,430,1,00057,India
584732,2023-07-02,501,iphone 15,60000,80000,20000,1,00057,India
437391,2023-07-02,501,iphone 15,60000,80000,20000,1,00490,India
437391,2023-07-02,502,iphone 15 pro max,100000,135000,35000,1,00490,India
880171,2023-07-02,501,iphone 15,60000,80000,20000,1,00303,India
830002,2023-07-02,502,iphone 15 pro max,100000,135000,35000,1,00404,India
863115,2023-07-02,503,mixer,1349,3249,1900,1,00353,India
863115,2023-07-02,506,monitor,3249,8000,4751,1,00353,India
751563,2023-07-02,504,iron,449,879,430,1,00268,India
751563,2023-07-02,501,iphone 15,60000,80000,20000,1,00268,India
565651,2023-07-02,505,oven,18490,24000,5510,1,00169,India
565651,2023-07-02,507,washing machine,6990,16490,9500,1,00169,India
670197,2023-07-02,501,iphone 15,60000,80000,20000,1,00211,India
826219,2023-07-02,507,washing machine,6990,16490,9500,1,00386,India
445611,2023-07-02,502,iphone 15 pro max,100000,135000,35000,1,00078,India
445611,2023-07-02,504,iron,449,879,430,1,00078,India
445611,2023-07-02,503,mixer,1349,3249,1900,1,00078,India
445611,2023-07-02,506,monitor,3249,8000,4751,1,00078,India
445611,2023-07-02,501,iphone 15,60000,80000,20000,1,00078,India
437779,2023-07-02,503,mixer,1349,3249,1900,1,00412,India
508305,2023-07-02,501,iphone 15,60000,80000,20000,1,00305,India
508305,2023-07-02,507,washing machine,6990,16490,9500,1,00305,India
446782,2023-07-02,504,iron,449,879,430,1,00087,India
920288,2023-07-02,503,mixer,1349,3249,1900,1,00116,India
626742,2023-07-02,505,oven,18490,24000,5510,1,00022,India
614579,2023-07-02,501,iphone 15,60000,80000,20000,1,00077,India
614579,2023-07-02,503,mixer,1349,3249,1900,1,00077,India
614579,2023-07-02,502,iphone 15 pro max,100000,135000,35000,1,00077,India
614579,2023-07-02,504,iron,449,879,430,1,00077,India
431975,2023-07-02,504,iron,449,879,430,1,00479,India
431975,2023-07-02,507,washing machine,6990,16490,9500,1,00479,India
431975,2023-07-02,501,iphone 15,60000,80000,20000,1,00479,India
431975,2023-07-02,503,mixer,1349,3249,1900,1,00479,India
576856,2023-07-02,507,washing machine,6990,16490,9500,1,00309,India
390511,2023-07-02,503,mixer,1349,3249,1900,1,00471,India
504189,2023-07-02,502,iphone 15 pro max,100000,135000,35000,1,00343,India
504189,2023-07-02,504,iron,449,879,430,1,00343,India
504189,2023-07-02,503,mixer,1349,3249,1900,1,00343,India
334867,2023-07-02,507,washing machine,6990,16490,9500,1,00445,India
243677,2023-07-02,503,mixer,1349,3249,1900,1,00277,India
612415,2023-07-02,505,oven,18490,24000,5510,1,00265,India
612415,2023-07-02,503,mixer,1349,3249,1900,1,00265,India
394177,2023-07-03,507,washing machine,6990,16490,9500,1,00224,India
394177,2023-07-03,503,mixer,1349,3249,1900,1,00224,India
394177,2023-07-03,504,iron,449,879,430,1,00224,India
394177,2023-07-03,502,iphone 15 pro max,100000,135000,35000,1,00224,India
116991,2023-07-03,504,iron,449,879,430,1,00249,India
116991,2023-07-03,506,monitor,3249,8000,4751,1,00249,India
116991,2023-07-03,501,iphone 15,60000,80000,20000,1,00249,India
116991,2023-07-03,505,oven,18490,24000,5510,1,00249,India
538974,2023-07-03,504,iron,449,879,430,1,00089,India
538974,2023-07-03,506,monitor,3249,8000,4751,1,00089,India
303185,2023-07-03,501,iphone 15,60000,80000,20000,1,00439,India
303185,2023-07-03,503,mixer,1349,3249,1900,1,00439,India
303185,2023-07-03,505,oven,18490,24000,5510,1,00439,India
303185,2023-07-03,502,iphone 15 pro max,100000,135000,35000,1,00439,India
896769,2023-07-03,501,iphone 15,60000,80000,20000,1,00105,India
896769,2023-07-03,502,iphone 15 pro max,100000,135000,35000,1,00105,India
896769,2023-07-03,504,iron,449,879,430,1,00105,India
896769,2023-07-03,505,oven,18490,24000,5510,1,00105,India
991751,2023-07-03,506,monitor,3249,8000,4751,1,00270,India
991751,2023-07-03,502,iphone 15 pro max,100000,135000,35000,1,00270,India
991751,2023-07-03,507,washing machine,6990,16490,9500,1,00270,India
991751,2023-07-03,504,iron,449,879,430,1,00270,India
710023,2023-07-03,507,washing machine,6990,16490,9500,1,00174,India
710023,2023-07-03,505,oven,18490,24000,5510,1,00174,India
808595,2023-07-03,506,monitor,3249,8000,4751,1,00058,India
808595,2023-07-03,505,oven,18490,24000,5510,1,00058,India
720817,2023-07-03,502,iphone 15 pro max,100000,135000,35000,1,00323,India
690798,2023-07-03,504,iron,449,879,430,1,00484,India
690798,2023-07-03,501,iphone 15,60000,80000,20000,1,00484,India
690798,2023-07-03,505,oven,18490,24000,5510,1,00484,India
690798,2023-07-03,503,mixer,1349,3249,1900,1,00484,India
543093,2023-07-03,504,iron,449,879,430,1,00065,India
543093,2023-07-03,506,monitor,3249,8000,4751,1,00065,India
616013,2023-07-03,503,mixer,1349,3249,1900,1,00450,India
616013,2023-07-03,502,iphone 15 pro max,100000,135000,35000,1,00450,India
616013,2023-07-03,501,iphone 15,60000,80000,20000,1,00450,India
650407,2023-07-03,501,iphone 15,60000,80000,20000,1,00068,India
650407,2023-07-03,502,iphone 15 pro max,100000,135000,35000,1,00068,India
596974,2023-07-03,507,washing machine,6990,16490,9500,1,00214,India
596974,2023-07-03,502,iphone 15 pro max,100000,135000,35000,1,00214,India
596974,2023-07-03,503,mixer,1349,3249,1900,1,00214,India
596974,2023-07-03,505,oven,18490,24000,5510,1,00214,India
664627,2023-07-03,502,iphone 15 pro max,100000,135000,35000,1,00029,India
121951,2023-07-03,503,mixer,1349,3249,1900,1,00065,India
121951,2023-07-03,506,monitor,3249,8000,4751,1,00065,India
121951,2023-07-03,505,oven,18490,24000,5510,1,00065,India
121951,2023-07-03,501,iphone 15,60000,80000,20000,1,00065,India
121951,2023-07-03,504,iron,449,879,430,1,00065,India
625580,2023-07-03,504,iron,449,879,430,1,00279,India
625580,2023-07-03,503,mixer,1349,3249,1900,1,00279,India
625580,2023-07-03,501,iphone 15,60000,80000,20000,1,00279,India
633301,2023-07-03,505,oven,18490,24000,5510,1,00394,India
633301,2023-07-03,503,mixer,1349,3249,1900,1,00394,India
633301,2023-07-03,501,iphone 15,60000,80000,20000,1,00394,India
686000,2023-07-03,502,iphone 15 pro max,100000,135000,35000,1,00123,India
686000,2023-07-03,504,iron,449,879,430,1,00123,India
686000,2023-07-03,503,mixer,1349,3249,1900,1,00123,India
686000,2023-07-03,501,iphone 15,60000,80000,20000,1,00123,India
686000,2023-07-03,507,washing machine,6990,16490,9500,1,00123,India
787655,2023-07-03,505,oven,18490,24000,5510,1,00212,India
787655,2023-07-03,504,iron,449,879,430,1,00212,India
787655,2023-07-03,501,iphone 15,60000,80000,20000,1,00212,India
787655,2023-07-03,503,mixer,1349,3249,1900,1,00212,India
176294,2023-07-03,502,iphone 15 pro max,100000,135000,35000,1,00228,India
176294,2023-07-03,503,mixer,1349,3249,1900,1,00228,India
176294,2023-07-03,505,oven,18490,24000,5510,1,00228,India
176294,2023-07-03,504,iron,449,879,430,1,00228,India
401663,2023-07-03,505,oven,18490,24000,5510,1,00478,India
401663,2023-07-03,503,mixer,1349,3249,1900,1,00478,India
401663,2023-07-03,504,iron,449,879,430,1,00478,India
811105,2023-07-03,507,washing machine,6990,16490,9500,1,00357,India
811105,2023-07-03,502,iphone 15 pro max,100000,135000,35000,1,00357,India
764279,2023-07-03,505,oven,18490,24000,5510,1,00096,India
984899,2023-07-03,502,iphone 15 pro max,100000,135000,35000,1,00186,India
984899,2023-07-03,504,iron,449,879,430,1,00186,India
200574,2023-07-03,504,iron,449,879,430,1,00437,India
200574,2023-07-03,503,mixer,1349,3249,1900,1,00437,India
200574,2023-07-03,506,monitor,3249,8000,4751,1,00437,India
200574,2023-07-03,505,oven,18490,24000,5510,1,00437,India
175833,2023-07-03,507,washing machine,6990,16490,9500,1,00157,India
175833,2023-07-03,501,iphone 15,60000,80000,20000,1,00157,India
175833,2023-07-03,503,mixer,1349,3249,1900,1,00157,India
800287,2023-07-03,507,washing machine,6990,16490,9500,1,00445,India
800287,2023-07-03,505,oven,18490,24000,5510,1,00445,India
800287,2023-07-03,506,monitor,3249,8000,4751,1,00445,India
858341,2023-07-03,503,mixer,1349,3249,1900,1,00309,India
858341,2023-07-03,506,monitor,3249,8000,4751,1,00309,India
237657,2023-07-03,506,monitor,3249,8000,4751,1,00068,India
237657,2023-07-03,502,iphone 15 pro max,100000,135000,35000,1,00068,India
237657,2023-07-03,507,washing machine,6990,16490,9500,1,00068,India
143146,2023-07-03,503,mixer,1349,3249,1900,1,00361,India
143146,2023-07-03,507,washing machine,6990,16490,9500,1,00361,India
279500,2023-07-03,503,mixer,1349,3249,1900,1,00152,India
279500,2023-07-03,504,iron,449,879,430,1,00152,India
279500,2023-07-03,502,iphone 15 pro max,100000,135000,35000,1,00152,India
173489,2023-07-03,501,iphone 15,60000,80000,20000,1,00280,India
173489,2023-07-03,507,washing machine,6990,16490,9500,1,00280,India
173489,2023-07-03,503,mixer,1349,3249,1900,1,00280,India
173489,2023-07-03,504,iron,449,879,430,1,00280,India
867283,2023-07-03,504,iron,449,879,430,1,00020,India
867283,2023-07-03,507,washing machine,6990,16490,9500,1,00020,India
867283,2023-07-03,502,iphone 15 pro max,100000,135000,35000,1,00020,India
867283,2023-07-03,501,iphone 15,60000,80000,20000,1,00020,India
846131,2023-07-03,505,oven,18490,24000,5510,1,00100,India
846131,2023-07-03,507,washing machine,6990,16490,9500,1,00100,India
846131,2023-07-03,504,iron,449,879,430,1,00100,India
449566,2023-07-03,507,washing machine,6990,16490,9500,1,00483,India
113918,2023-07-03,504,iron,449,879,430,1,00413,India
335024,2023-07-03,503,mixer,1349,3249,1900,1,00226,India
335024,2023-07-03,501,iphone 15,60000,80000,20000,1,00226,India
366698,2023-07-03,501,iphone 15,60000,80000,20000,1,00198,India
366698,2023-07-03,504,iron,449,879,430,1,00198,India
366698,2023-07-03,507,washing machine,6990,16490,9500,1,00198,India
777133,2023-07-03,504,iron,449,879,430,1,00044,India
257204,2023-07-03,506,monitor,3249,8000,4751,1,00219,India
258387,2023-07-03,507,washing machine,6990,16490,9500,1,00064,India
258387,2023-07-03,505,oven,18490,24000,5510,1,00064,India
258387,2023-07-03,504,iron,449,879,430,1,00064,India
258387,2023-07-03,501,iphone 15,60000,80000,20000,1,00064,India
426313,2023-07-03,506,monitor,3249,8000,4751,1,00434,India
426313,2023-07-03,505,oven,18490,24000,5510,1,00434,India
426313,2023-07-03,502,iphone 15 pro max,100000,135000,35000,1,00434,India
340575,2023-07-03,505,oven,18490,24000,5510,1,00478,India
509327,2023-07-03,504,iron,449,879,430,1,00072,India
509327,2023-07-03,503,mixer,1349,3249,1900,1,00072,India
505581,2023-07-03,502,iphone 15 pro max,100000,135000,35000,1,00237,India
953399,2023-07-03,501,iphone 15,60000,80000,20000,1,00016,India
953399,2023-07-03,503,mixer,1349,3249,1900,1,00016,India
953399,2023-07-03,502,iphone 15 pro max,100000,135000,35000,1,00016,India
953399,2023-07-03,504,iron,449,879,430,1,00016,India
953399,2023-07-03,505,oven,18490,24000,5510,1,00016,India
219840,2023-07-03,503,mixer,1349,3249,1900,1,00209,India
219840,2023-07-03,501,iphone 15,60000,80000,20000,1,00209,India
219840,2023-07-03,505,oven,18490,24000,5510,1,00209,India
996007,2023-07-03,505,oven,18490,24000,5510,1,00082,India
775002,2023-07-03,505,oven,18490,24000,5510,1,00238,India
775002,2023-07-03,502,iphone 15 pro max,100000,135000,35000,1,00238,India
775002,2023-07-03,507,washing machine,6990,16490,9500,1,00238,India
775002,2023-07-03,503,mixer,1349,3249,1900,1,00238,India
196823,2023-07-03,506,monitor,3249,8000,4751,1,00479,India
889025,2023-07-03,506,monitor,3249,8000,4751,1,00398,India
889025,2023-07-03,501,iphone 15,60000,80000,20000,1,00398,India
889025,2023-07-03,503,mixer,1349,3249,1900,1,00398,India
889025,2023-07-03,504,iron,449,879,430,1,00398,India
585518,2023-07-03,501,iphone 15,60000,80000,20000,1,00048,India
585518,2023-07-03,504,iron,449,879,430,1,00048,India
698287,2023-07-03,503,mixer,1349,3249,1900,1,00091,India
698287,2023-07-03,501,iphone 15,60000,80000,20000,1,00091,India
698287,2023-07-03,506,monitor,3249,8000,4751,1,00091,India
343347,2023-07-03,506,monitor,3249,8000,4751,1,00185,India
343347,2023-07-03,502,iphone 15 pro max,100000,135000,35000,1,00185,India
343347,2023-07-03,503,mixer,1349,3249,1900,1,00185,India
990741,2023-07-03,504,iron,449,879,430,1,00336,India
990741,2023-07-03,505,oven,18490,24000,5510,1,00336,India
990741,2023-07-03,502,iphone 15 pro max,100000,135000,35000,1,00336,India
789472,2023-07-03,501,iphone 15,60000,80000,20000,1,00060,India
789472,2023-07-03,506,monitor,3249,8000,4751,1,00060,India
789472,2023-07-03,505,oven,18490,24000,5510,1,00060,India
588368,2023-07-03,507,washing machine,6990,16490,9500,1,00322,India
588368,2023-07-03,505,oven,18490,24000,5510,1,00322,India
169033,2023-07-03,502,iphone 15 pro max,100000,135000,35000,1,00379,India
169033,2023-07-03,506,monitor,3249,8000,4751,1,00379,India
452082,2023-07-03,507,washing machine,6990,16490,9500,1,00277,India
452082,2023-07-03,504,iron,449,879,430,1,00277,India
452082,2023-07-03,502,iphone 15 pro max,100000,135000,35000,1,00277,India
609651,2023-07-03,505,oven,18490,24000,5510,1,00043,India
609651,2023-07-03,502,iphone 15 pro max,100000,135000,35000,1,00043,India
609651,2023-07-03,501,iphone 15,60000,80000,20000,1,00043,India
656627,2023-07-03,503,mixer,1349,3249,1900,1,00430,India
656627,2023-07-03,507,washing machine,6990,16490,9500,1,00430,India
656627,2023-07-03,501,iphone 15,60000,80000,20000,1,00430,India
417902,2023-07-03,502,iphone 15 pro max,100000,135000,35000,1,00473,India
417902,2023-07-03,501,iphone 15,60000,80000,20000,1,00473,India
417902,2023-07-03,503,mixer,1349,3249,1900,1,00473,India
417902,2023-07-03,504,iron,449,879,430,1,00473,India
417902,2023-07-03,507,washing machine,6990,16490,9500,1,00473,India
801436,2023-07-03,504,iron,449,879,430,1,00461,India
801436,2023-07-03,502,iphone 15 pro max,100000,135000,35000,1,00461,India
801436,2023-07-03,505,oven,18490,24000,5510,1,00461,India
801436,2023-07-03,503,mixer,1349,3249,1900,1,00461,India
268953,2023-07-03,506,monitor,3249,8000,4751,1,00485,India
268953,2023-07-03,502,iphone 15 pro max,100000,135000,35000,1,00485,India
268953,2023-07-03,501,iphone 15,60000,80000,20000,1,00485,India
137787,2023-07-03,501,iphone 15,60000,80000,20000,1,00034,India
137787,2023-07-03,506,monitor,3249,8000,4751,1,00034,India
137787,2023-07-03,507,washing machine,6990,16490,9500,1,00034,India
137787,2023-07-03,504,iron,449,879,430,1,00034,India
375349,2023-07-03,507,washing machine,6990,16490,9500,1,00318,India
696260,2023-07-03,501,iphone 15,60000,80000,20000,1,00022,India
742688,2023-07-03,501,iphone 15,60000,80000,20000,1,00165,India
742688,2023-07-03,504,iron,449,879,430,1,00165,India
646475,2023-07-03,502,iphone 15 pro max,100000,135000,35000,1,00428,India
255383,2023-07-03,501,iphone 15,60000,80000,20000,1,00076,India
296200,2023-07-03,501,iphone 15,60000,80000,20000,1,00390,India
296200,2023-07-03,502,iphone 15 pro max,100000,135000,35000,1,00390,India
296200,2023-07-03,504,iron,449,879,430,1,00390,India
296200,2023-07-03,507,washing machine,6990,16490,9500,1,00390,India
296200,2023-07-03,503,mixer,1349,3249,1900,1,00390,India
836761,2023-07-03,505,oven,18490,24000,5510,1,00030,India
320173,2023-07-03,507,washing machine,6990,16490,9500,1,00440,India
320173,2023-07-03,505,oven,18490,24000,5510,1,00440,India
269132,2023-07-03,505,oven,18490,24000,5510,1,00086,India
305851,2023-07-03,501,iphone 15,60000,80000,20000,1,00445,India
129354,2023-07-03,503,mixer,1349,3249,1900,1,00069,India
129354,2023-07-03,501,iphone 15,60000,80000,20000,1,00069,India
129354,2023-07-03,505,oven,18490,24000,5510,1,00069,India
232362,2023-07-03,506,monitor,3249,8000,4751,1,00033,India
232362,2023-07-03,505,oven,18490,24000,5510,1,00033,India
232362,2023-07-03,501,iphone 15,60000,80000,20000,1,00033,India
759205,2023-07-03,507,washing machine,6990,16490,9500,1,00493,India
759205,2023-07-03,504,iron,449,879,430,1,00493,India
759205,2023-07-03,505,oven,18490,24000,5510,1,00493,India
388682,2023-07-03,507,washing machine,6990,16490,9500,1,00408,India
388682,2023-07-03,504,iron,449,879,430,1,00408,India
388682,2023-07-03,506,monitor,3249,8000,4751,1,00408,India
383824,2023-07-03,504,iron,449,879,430,1,00380,India
761851,2023-07-03,507,washing machine,6990,16490,9500,1,00085,India
227463,2023-07-04,506,monitor,3249,8000,4751,1,00138,India
227463,2023-07-04,501,iphone 15,60000,80000,20000,1,00138,India
227463,2023-07-04,502,iphone 15 pro max,100000,135000,35000,1,00138,India
140002,2023-07-04,502,iphone 15 pro max,100000,135000,35000,1,00077,India
140002,2023-07-04,505,oven,18490,24000,5510,1,00077,India
140002,2023-07-04,503,mixer,1349,3249,1900,1,00077,India
690881,2023-07-04,503,mixer,1349,3249,1900,1,00054,India
504235,2023-07-04,506,monitor,3249,8000,4751,1,00027,India
540621,2023-07-04,503,mixer,1349,3249,1900,1,00058,India
540621,2023-07-04,504,iron,449,879,430,1,00058,India
343097,2023-07-04,503,mixer,1349,3249,1900,1,00390,India
343097,2023-07-04,501,iphone 15,60000,80000,20000,1,00390,India
343097,2023-07-04,504,iron,449,879,430,1,00390,India
165921,2023-07-04,504,iron,449,879,430,1,00361,India
165921,2023-07-04,506,monitor,3249,8000,4751,1,00361,India
165921,2023-07-04,503,mixer,1349,3249,1900,1,00361,India
494981,2023-07-04,504,iron,449,879,430,1,00341,India
494981,2023-07-04,501,iphone 15,60000,80000,20000,1,00341,India
494981,2023-07-04,505,oven,18490,24000,5510,1,00341,India
494981,2023-07-04,502,iphone 15 pro max,100000,135000,35000,1,00341,India
494981,2023-07-04,503,mixer,1349,3249,1900,1,00341,India
753740,2023-07-04,504,iron,449,879,430,1,00042,India
753740,2023-07-04,502,iphone 15 pro max,100000,135000,35000,1,00042,India
753740,2023-07-04,505,oven,18490,24000,5510,1,00042,India
967741,2023-07-04,501,iphone 15,60000,80000,20000,1,00263,India
967741,2023-07-04,506,monitor,3249,8000,4751,1,00263,India
967741,2023-07-04,504,iron,449,879,430,1,00263,India
979531,2023-07-04,501,iphone 15,60000,80000,20000,1,00404,India
979531,2023-07-04,503,mixer,1349,3249,1900,1,00404,India
979531,2023-07-04,505,oven,18490,24000,5510,1,00404,India
941932,2023-07-04,504,iron,449,879,430,1,00133,India
941932,2023-07-04,506,monitor,3249,8000,4751,1,00133,India
941932,2023-07-04,503,mixer,1349,3249,1900,1,00133,India
552082,2023-07-04,504,iron,449,879,430,1,00420,India
552082,2023-07-04,506,monitor,3249,8000,4751,1,00420,India
690464,2023-07-04,503,mixer,1349,3249,1900,1,00258,India
690464,2023-07-04,504,iron,449,879,430,1,00258,India
690464,2023-07-04,505,oven,18490,24000,5510,1,00258,India
690464,2023-07-04,506,monitor,3249,8000,4751,1,00258,India
101682,2023-07-04,506,monitor,3249,8000,4751,1,00052,India
101682,2023-07-04,507,washing machine,6990,16490,9500,1,00052,India
539374,2023-07-04,505,oven,18490,24000,5510,1,00183,India
511073,2023-07-04,501,iphone 15,60000,80000,20000,1,00142,India
511073,2023-07-04,504,iron,449,879,430,1,00142,India
511073,2023-07-04,503,mixer,1349,3249,1900,1,00142,India
149715,2023-07-04,501,iphone 15,60000,80000,20000,1,00257,India
532023,2023-07-04,501,iphone 15,60000,80000,20000,1,00344,India
532023,2023-07-04,503,mixer,1349,3249,1900,1,00344,India
532023,2023-07-04,507,washing machine,6990,16490,9500,1,00344,India
939109,2023-07-04,504,iron,449,879,430,1,00041,India
939109,2023-07-04,501,iphone 15,60000,80000,20000,1,00041,India
354454,2023-07-04,503,mixer,1349,3249,1900,1,00427,India
354454,2023-07-04,502,iphone 15 pro max,100000,135000,35000,1,00427,India
354454,2023-07-04,504,iron,449,879,430,1,00427,India
977577,2023-07-04,504,iron,449,879,430,1,00265,India
977577,2023-07-04,501,iphone 15,60000,80000,20000,1,00265,India
170598,2023-07-04,502,iphone 15 pro max,100000,135000,35000,1,00302,India
170598,2023-07-04,501,iphone 15,60000,80000,20000,1,00302,India
904767,2023-07-04,503,mixer,1349,3249,1900,1,00471,India
754971,2023-07-04,502,iphone 15 pro max,100000,135000,35000,1,00210,India
754971,2023-07-04,505,oven,18490,24000,5510,1,00210,India
754971,2023-07-04,503,mixer,1349,3249,1900,1,00210,India
754971,2023-07-04,506,monitor,3249,8000,4751,1,00210,India
214511,2023-07-04,507,washing machine,6990,16490,9500,1,00237,India
763277,2023-07-04,507,washing machine,6990,16490,9500,1,00055,India
291176,2023-07-04,505,oven,18490,24000,5510,1,00352,India
291176,2023-07-04,506,monitor,3249,8000,4751,1,00352,India
291176,2023-07-04,501,iphone 15,60000,80000,20000,1,00352,India
108491,2023-07-04,503,mixer,1349,3249,1900,1,00035,India
108491,2023-07-04,506,monitor,3249,8000,4751,1,00035,India
435479,2023-07-04,503,mixer,1349,3249,1900,1,00060,India
435479,2023-07-04,502,iphone 15 pro max,100000,135000,35000,1,00060,India
637048,2023-07-04,502,iphone 15 pro max,100000,135000,35000,1,00477,India
637048,2023-07-04,505,oven,18490,24000,5510,1,00477,India
637048,2023-07-04,504,iron,449,879,430,1,00477,India
974181,2023-07-04,505,oven,18490,24000,5510,1,00021,India
974181,2023-07-04,501,iphone 15,60000,80000,20000,1,00021,India
338024,2023-07-04,507,washing machine,6990,16490,9500,1,00021,India
338024,2023-07-04,504,iron,449,879,430,1,00021,India
572956,2023-07-04,505,oven,18490,24000,5510,1,00083,India
584036,2023-07-04,501,iphone 15,60000,80000,20000,1,00359,India
584036,2023-07-04,504,iron,449,879,430,1,00359,India
584036,2023-07-04,502,iphone 15 pro max,100000,135000,35000,1,00359,India
654522,2023-07-04,504,iron,449,879,430,1,00312,India
924928,2023-07-04,504,iron,449,879,430,1,00037,India
924928,2023-07-04,501,iphone 15,60000,80000,20000,1,00037,India
229887,2023-07-04,505,oven,18490,24000,5510,1,00463,India
229887,2023-07-04,503,mixer,1349,3249,1900,1,00463,India
222917,2023-07-04,503,mixer,1349,3249,1900,1,00291,India
624792,2023-07-04,507,washing machine,6990,16490,9500,1,00196,India
624792,2023-07-04,504,iron,449,879,430,1,00196,India
624792,2023-07-04,506,monitor,3249,8000,4751,1,00196,India
431263,2023-07-04,503,mixer,1349,3249,1900,1,00156,India
431263,2023-07-04,506,monitor,3249,8000,4751,1,00156,India
431263,2023-07-04,502,iphone 15 pro max,100000,135000,35000,1,00156,India
431263,2023-07-04,505,oven,18490,24000,5510,1,00156,India
117486,2023-07-04,501,iphone 15,60000,80000,20000,1,00101,India
117486,2023-07-04,505,oven,18490,24000,5510,1,00101,India
117486,2023-07-04,507,washing machine,6990,16490,9500,1,00101,India
117486,2023-07-04,503,mixer,1349,3249,1900,1,00101,India
201136,2023-07-04,501,iphone 15,60000,80000,20000,1,00054,India
201136,2023-07-04,503,mixer,1349,3249,1900,1,00054,India
201136,2023-07-04,502,iphone 15 pro max,100000,135000,35000,1,00054,India
201136,2023-07-04,506,monitor,3249,8000,4751,1,00054,India
785443,2023-07-04,504,iron,449,879,430,1,00328,India
785443,2023-07-04,502,iphone 15 pro max,100000,135000,35000,1,00328,India
785443,2023-07-04,501,iphone 15,60000,80000,20000,1,00328,India
754982,2023-07-04,507,washing machine,6990,16490,9500,1,00366,India
754982,2023-07-04,506,monitor,3249,8000,4751,1,00366,India
754982,2023-07-04,502,iphone 15 pro max,100000,135000,35000,1,00366,India
298358,2023-07-04,502,iphone 15 pro max,100000,135000,35000,1,00198,India
298358,2023-07-04,503,mixer,1349,3249,1900,1,00198,India
589255,2023-07-04,507,washing machine,6990,16490,9500,1,00410,India
589255,2023-07-04,506,monitor,3249,8000,4751,1,00410,India
589255,2023-07-04,504,iron,449,879,430,1,00410,India
589255,2023-07-04,501,iphone 15,60000,80000,20000,1,00410,India
219179,2023-07-04,501,iphone 15,60000,80000,20000,1,00017,India
419546,2023-07-04,505,oven,18490,24000,5510,1,00096,India
419546,2023-07-04,501,iphone 15,60000,80000,20000,1,00096,India
511231,2023-07-04,504,iron,449,879,430,1,00236,India
511231,2023-07-04,506,monitor,3249,8000,4751,1,00236,India
511231,2023-07-04,503,mixer,1349,3249,1900,1,00236,India
511231,2023-07-04,501,iphone 15,60000,80000,20000,1,00236,India
767291,2023-07-04,502,iphone 15 pro max,100000,135000,35000,1,00313,India
587713,2023-07-04,503,mixer,1349,3249,1900,1,00244,India
587713,2023-07-04,501,iphone 15,60000,80000,20000,1,00244,India
861756,2023-07-04,506,monitor,3249,8000,4751,1,00074,India
299769,2023-07-04,504,iron,449,879,430,1,00344,India
299769,2023-07-04,503,mixer,1349,3249,1900,1,00344,India
584400,2023-07-04,501,iphone 15,60000,80000,20000,1,00492,India
584400,2023-07-04,504,iron,449,879,430,1,00492,India
584400,2023-07-04,502,iphone 15 pro max,100000,135000,35000,1,00492,India
584400,2023-07-04,505,oven,18490,24000,5510,1,00492,India
374308,2023-07-04,507,washing machine,6990,16490,9500,1,00464,India
374308,2023-07-04,505,oven,18490,24000,5510,1,00464,India
374308,2023-07-04,504,iron,449,879,430,1,00464,India
252345,2023-07-04,502,iphone 15 pro max,100000,135000,35000,1,00157,India
252345,2023-07-04,505,oven,18490,24000,5510,1,00157,India
252345,2023-07-04,504,iron,449,879,430,1,00157,India
252345,2023-07-04,501,iphone 15,60000,80000,20000,1,00157,India
896130,2023-07-04,502,iphone 15 pro max,100000,135000,35000,1,00424,India
896130,2023-07-04,503,mixer,1349,3249,1900,1,00424,India
896130,2023-07-04,505,oven,18490,24000,5510,1,00424,India
896130,2023-07-04,507,washing machine,6990,16490,9500,1,00424,India
940209,2023-07-04,507,washing machine,6990,16490,9500,1,00151,India
940209,2023-07-04,504,iron,449,879,430,1,00151,India
940209,2023-07-04,503,mixer,1349,3249,1900,1,00151,India
697211,2023-07-04,505,oven,18490,24000,5510,1,00387,India
697211,2023-07-04,503,mixer,1349,3249,1900,1,00387,India
126966,2023-07-04,507,washing machine,6990,16490,9500,1,00261,India
126966,2023-07-04,505,oven,18490,24000,5510,1,00261,India
126966,2023-07-04,502,iphone 15 pro max,100000,135000,35000,1,00261,India
126966,2023-07-04,503,mixer,1349,3249,1900,1,00261,India
268741,2023-07-04,501,iphone 15,60000,80000,20000,1,00264,India
268741,2023-07-04,506,monitor,3249,8000,4751,1,00264,India
268741,2023-07-04,503,mixer,1349,3249,1900,1,00264,India
990206,2023-07-04,504,iron,449,879,430,1,00190,India
990206,2023-07-04,502,iphone 15 pro max,100000,135000,35000,1,00190,India
990206,2023-07-04,503,mixer,1349,3249,1900,1,00190,India
601824,2023-07-04,504,iron,449,879,430,1,00340,India
601824,2023-07-04,505,oven,18490,24000,5510,1,00340,India
341543,2023-07-04,505,oven,18490,24000,5510,1,00361,India
341543,2023-07-04,501,iphone 15,60000,80000,20000,1,00361,India
341543,2023-07-04,507,washing machine,6990,16490,9500,1,00361,India
341543,2023-07-04,502,iphone 15 pro max,100000,135000,35000,1,00361,India
524330,2023-07-04,505,oven,18490,24000,5510,1,00146,India
524330,2023-07-04,504,iron,449,879,430,1,00146,India
524330,2023-07-04,506,monitor,3249,8000,4751,1,00146,India
212189,2023-07-04,501,iphone 15,60000,80000,20000,1,00183,India
349501,2023-07-04,502,iphone 15 pro max,100000,135000,35000,1,00162,India
817483,2023-07-04,506,monitor,3249,8000,4751,1,00490,India
817483,2023-07-04,502,iphone 15 pro max,100000,135000,35000,1,00490,India
817483,2023-07-04,505,oven,18490,24000,5510,1,00490,India
406849,2023-07-04,505,oven,18490,24000,5510,1,00340,India
406849,2023-07-04,504,iron,449,879,430,1,00340,India
404766,2023-07-04,502,iphone 15 pro max,100000,135000,35000,1,00254,India
404766,2023-07-04,501,iphone 15,60000,80000,20000,1,00254,India
404766,2023-07-04,505,oven,18490,24000,5510,1,00254,India
404766,2023-07-04,507,washing machine,6990,16490,9500,1,00254,India
366600,2023-07-04,505,oven,18490,24000,5510,1,00436,India
366600,2023-07-04,501,iphone 15,60000,80000,20000,1,00436,India
366600,2023-07-04,504,iron,449,879,430,1,00436,India
366600,2023-07-04,502,iphone 15 pro max,100000,135000,35000,1,00436,India
677339,2023-07-04,505,oven,18490,24000,5510,1,00485,India
677339,2023-07-04,504,iron,449,879,430,1,00485,India
482623,2023-07-04,507,washing machine,6990,16490,9500,1,00442,India
482623,2023-07-04,501,iphone 15,60000,80000,20000,1,00442,India
190179,2023-07-04,503,mixer,1349,3249,1900,1,00246,India
659077,2023-07-04,505,oven,18490,24000,5510,1,00322,India
659077,2023-07-04,507,washing machine,6990,16490,9500,1,00322,India
659077,2023-07-04,502,iphone 15 pro max,100000,135000,35000,1,00322,India
156637,2023-07-04,507,washing machine,6990,16490,9500,1,00386,India
156637,2023-07-04,504,iron,449,879,430,1,00386,India
210421,2023-07-04,503,mixer,1349,3249,1900,1,00319,India
210421,2023-07-04,505,oven,18490,24000,5510,1,00319,India
210421,2023-07-04,502,iphone 15 pro max,100000,135000,35000,1,00319,India
225055,2023-07-04,502,iphone 15 pro max,100000,135000,35000,1,00142,India
163559,2023-07-05,502,iphone 15 pro max,100000,135000,35000,1,00399,India
163559,2023-07-05,506,monitor,3249,8000,4751,1,00399,India
332099,2023-07-05,501,iphone 15,60000,80000,20000,1,00298,India
332099,2023-07-05,502,iphone 15 pro max,100000,135000,35000,1,00298,India
332099,2023-07-05,504,iron,449,879,430,1,00298,India
332099,2023-07-05,506,monitor,3249,8000,4751,1,00298,India
981129,2023-07-05,507,washing machine,6990,16490,9500,1,00161,India
245568,2023-07-05,505,oven,18490,24000,5510,1,00084,India
245568,2023-07-05,501,iphone 15,60000,80000,20000,1,00084,India
277785,2023-07-05,502,iphone 15 pro max,100000,135000,35000,1,00495,India
279426,2023-07-05,506,monitor,3249,8000,4751,1,00260,India
401682,2023-07-05,505,oven,18490,24000,5510,1,00319,India
401682,2023-07-05,502,iphone 15 pro max,100000,135000,35000,1,00319,India
401682,2023-07-05,503,mixer,1349,3249,1900,1,00319,India
739095,2023-07-05,502,iphone 15 pro max,100000,135000,35000,1,00094,India
739095,2023-07-05,505,oven,18490,24000,5510,1,00094,India
583672,2023-07-05,504,iron,449,879,430,1,00042,India
583672,2023-07-05,501,iphone 15,60000,80000,20000,1,00042,India
583672,2023-07-05,502,iphone 15 pro max,100000,135000,35000,1,00042,India
692524,2023-07-05,505,oven,18490,24000,5510,1,00484,India
692524,2023-07-05,507,washing machine,6990,16490,9500,1,00484,India
889609,2023-07-05,502,iphone 15 pro max,100000,135000,35000,1,00077,India
894005,2023-07-05,505,oven,18490,24000,5510,1,00149,India
894005,2023-07-05,503,mixer,1349,3249,1900,1,00149,India
894005,2023-07-05,504,iron,449,879,430,1,00149,India
385576,2023-07-05,506,monitor,3249,8000,4751,1,00355,India
385576,2023-07-05,501,iphone 15,60000,80000,20000,1,00355,India
385576,2023-07-05,504,iron,449,879,430,1,00355,India
385576,2023-07-05,505,oven,18490,24000,5510,1,00355,India
341195,2023-07-05,503,mixer,1349,3249,1900,1,00030,India
341195,2023-07-05,507,washing machine,6990,16490,9500,1,00030,India
341195,2023-07-05,504,iron,449,879,430,1,00030,India
492648,2023-07-05,503,mixer,1349,3249,1900,1,00493,India
492648,2023-07-05,504,iron,449,879,430,1,00493,India
492648,2023-07-05,506,monitor,3249,8000,4751,1,00493,India
795703,2023-07-05,503,mixer,1349,3249,1900,1,00336,India
795703,2023-07-05,501,iphone 15,60000,80000,20000,1,00336,India
540987,2023-07-05,501,iphone 15,60000,80000,20000,1,00159,India
540987,2023-07-05,503,mixer,1349,3249,1900,1,00159,India
540987,2023-07-05,507,washing machine,6990,16490,9500,1,00159,India
563601,2023-07-05,504,iron,449,879,430,1,00234,India
563601,2023-07-05,507,washing machine,6990,16490,9500,1,00234,India
308482,2023-07-05,507,washing machine,6990,16490,9500,1,00240,India
308482,2023-07-05,502,iphone 15 pro max,100000,135000,35000,1,00240,India
308482,2023-07-05,506,monitor,3249,8000,4751,1,00240,India
489718,2023-07-05,503,mixer,1349,3249,1900,1,00444,India
489718,2023-07-05,504,iron,449,879,430,1,00444,India
489718,2023-07-05,506,monitor,3249,8000,4751,1,00444,India
333335,2023-07-05,505,oven,18490,24000,5510,1,00106,India
721751,2023-07-05,501,iphone 15,60000,80000,20000,1,00089,India
721751,2023-07-05,506,monitor,3249,8000,4751,1,00089,India
335769,2023-07-05,503,mixer,1349,3249,1900,1,00472,India
335769,2023-07-05,507,washing machine,6990,16490,9500,1,00472,India
335769,2023-07-05,505,oven,18490,24000,5510,1,00472,India
335769,2023-07-05,506,monitor,3249,8000,4751,1,00472,India
140701,2023-07-05,503,mixer,1349,3249,1900,1,00233,India
443743,2023-07-05,504,iron,449,879,430,1,00234,India
443743,2023-07-05,505,oven,18490,24000,5510,1,00234,India
117287,2023-07-05,505,oven,18490,24000,5510,1,00473,India
117287,2023-07-05,502,iphone 15 pro max,100000,135000,35000,1,00473,India
219141,2023-07-05,505,oven,18490,24000,5510,1,00087,India
219141,2023-07-05,502,iphone 15 pro max,100000,135000,35000,1,00087,India
219141,2023-07-05,501,iphone 15,60000,80000,20000,1,00087,India
268532,2023-07-05,502,iphone 15 pro max,100000,135000,35000,1,00047,India
268532,2023-07-05,504,iron,449,879,430,1,00047,India
268532,2023-07-05,505,oven,18490,24000,5510,1,00047,India
268532,2023-07-05,506,monitor,3249,8000,4751,1,00047,India
551136,2023-07-05,505,oven,18490,24000,5510,1,00460,India
551136,2023-07-05,503,mixer,1349,3249,1900,1,00460,India
372742,2023-07-05,502,iphone 15 pro max,100000,135000,35000,1,00408,India
372742,2023-07-05,503,mixer,1349,3249,1900,1,00408,India
487913,2023-07-05,503,mixer,1349,3249,1900,1,00382,India
487913,2023-07-05,501,iphone 15,60000,80000,20000,1,00382,India
487913,2023-07-05,506,monitor,3249,8000,4751,1,00382,India
487913,2023-07-05,502,iphone 15 pro max,100000,135000,35000,1,00382,India
309371,2023-07-05,505,oven,18490,24000,5510,1,00452,India
309371,2023-07-05,501,iphone 15,60000,80000,20000,1,00452,India
309371,2023-07-05,506,monitor,3249,8000,4751,1,00452,India
309371,2023-07-05,504,iron,449,879,430,1,00452,India
939783,2023-07-05,506,monitor,3249,8000,4751,1,00273,India
939783,2023-07-05,502,iphone 15 pro max,100000,135000,35000,1,00273,India
939783,2023-07-05,501,iphone 15,60000,80000,20000,1,00273,India
939783,2023-07-05,507,washing machine,6990,16490,9500,1,00273,India
384826,2023-07-05,504,iron,449,879,430,1,00285,India
755884,2023-07-05,505,oven,18490,24000,5510,1,00472,India
755884,2023-07-05,504,iron,449,879,430,1,00472,India
755884,2023-07-05,503,mixer,1349,3249,1900,1,00472,India
923722,2023-07-05,507,washing machine,6990,16490,9500,1,00364,India
984877,2023-07-05,506,monitor,3249,8000,4751,1,00103,India
984877,2023-07-05,502,iphone 15 pro max,100000,135000,35000,1,00103,India
984877,2023-07-05,503,mixer,1349,3249,1900,1,00103,India
984877,2023-07-05,507,washing machine,6990,16490,9500,1,00103,India
701544,2023-07-05,504,iron,449,879,430,1,00067,India
701544,2023-07-05,503,mixer,1349,3249,1900,1,00067,India
902729,2023-07-05,505,oven,18490,24000,5510,1,00096,India
902729,2023-07-05,502,iphone 15 pro max,100000,135000,35000,1,00096,India
902729,2023-07-05,506,monitor,3249,8000,4751,1,00096,India
984072,2023-07-05,505,oven,18490,24000,5510,1,00377,India
984072,2023-07-05,506,monitor,3249,8000,4751,1,00377,India
699823,2023-07-05,507,washing machine,6990,16490,9500,1,00244,India
699823,2023-07-05,502,iphone 15 pro max,100000,135000,35000,1,00244,India
861738,2023-07-05,505,oven,18490,24000,5510,1,00123,India
861738,2023-07-05,503,mixer,1349,3249,1900,1,00123,India
861738,2023-07-05,506,monitor,3249,8000,4751,1,00123,India
861738,2023-07-05,501,iphone 15,60000,80000,20000,1,00123,India
669318,2023-07-05,501,iphone 15,60000,80000,20000,1,00368,India
669318,2023-07-05,506,monitor,3249,8000,4751,1,00368,India
669318,2023-07-05,507,washing machine,6990,16490,9500,1,00368,India
669318,2023-07-05,502,iphone 15 pro max,100000,135000,35000,1,00368,India
419410,2023-07-05,506,monitor,3249,8000,4751,1,00266,India
325455,2023-07-05,502,iphone 15 pro max,100000,135000,35000,1,00232,India
325455,2023-07-05,504,iron,449,879,430,1,00232,India
325455,2023-07-05,501,iphone 15,60000,80000,20000,1,00232,India
200170,2023-07-05,503,mixer,1349,3249,1900,1,00308,India
200170,2023-07-05,504,iron,449,879,430,1,00308,India
958074,2023-07-05,501,iphone 15,60000,80000,20000,1,00122,India
814647,2023-07-05,501,iphone 15,60000,80000,20000,1,00141,India
814647,2023-07-05,502,iphone 15 pro max,100000,135000,35000,1,00141,India
814647,2023-07-05,505,oven,18490,24000,5510,1,00141,India
814647,2023-07-05,506,monitor,3249,8000,4751,1,00141,India
803962,2023-07-05,507,washing machine,6990,16490,9500,1,00002,India
803962,2023-07-05,501,iphone 15,60000,80000,20000,1,00002,India
929355,2023-07-05,504,iron,449,879,430,1,00038,India
929355,2023-07-05,506,monitor,3249,8000,4751,1,00038,India
328336,2023-07-05,503,mixer,1349,3249,1900,1,00271,India
328336,2023-07-05,502,iphone 15 pro max,100000,135000,35000,1,00271,India
538536,2023-07-05,503,mixer,1349,3249,1900,1,00464,India
538536,2023-07-05,502,iphone 15 pro max,100000,135000,35000,1,00464,India
726269,2023-07-05,505,oven,18490,24000,5510,1,00468,India
232852,2023-07-05,502,iphone 15 pro max,100000,135000,35000,1,00416,India
232852,2023-07-05,505,oven,18490,24000,5510,1,00416,India
232852,2023-07-05,506,monitor,3249,8000,4751,1,00416,India
232852,2023-07-05,501,iphone 15,60000,80000,20000,1,00416,India
185216,2023-07-05,503,mixer,1349,3249,1900,1,00420,India
185216,2023-07-05,505,oven,18490,24000,5510,1,00420,India
185216,2023-07-05,501,iphone 15,60000,80000,20000,1,00420,India
955647,2023-07-05,505,oven,18490,24000,5510,1,00224,India
955647,2023-07-05,506,monitor,3249,8000,4751,1,00224,India
435648,2023-07-05,507,washing machine,6990,16490,9500,1,00417,India
435648,2023-07-05,501,iphone 15,60000,80000,20000,1,00417,India
435648,2023-07-05,506,monitor,3249,8000,4751,1,00417,India
957192,2023-07-05,505,oven,18490,24000,5510,1,00142,India
453439,2023-07-05,505,oven,18490,24000,5510,1,00446,India
453439,2023-07-05,507,washing machine,6990,16490,9500,1,00446,India
453439,2023-07-05,503,mixer,1349,3249,1900,1,00446,India
453439,2023-07-05,506,monitor,3249,8000,4751,1,00446,India
871294,2023-07-05,504,iron,449,879,430,1,00110,India
871294,2023-07-05,505,oven,18490,24000,5510,1,00110,India
161225,2023-07-05,504,iron,449,879,430,1,00014,India
161225,2023-07-05,502,iphone 15 pro max,100000,135000,35000,1,00014,India
161225,2023-07-05,507,washing machine,6990,16490,9500,1,00014,India
222046,2023-07-05,504,iron,449,879,430,1,00290,India
222046,2023-07-05,505,oven,18490,24000,5510,1,00290,India
222046,2023-07-05,503,mixer,1349,3249,1900,1,00290,India
830921,2023-07-05,506,monitor,3249,8000,4751,1,00421,India
830921,2023-07-05,504,iron,449,879,430,1,00421,India
830921,2023-07-05,502,iphone 15 pro max,100000,135000,35000,1,00421,India
641929,2023-07-05,502,iphone 15 pro max,100000,135000,35000,1,00467,India
641929,2023-07-05,506,monitor,3249,8000,4751,1,00467,India
641929,2023-07-05,505,oven,18490,24000,5510,1,00467,India
641929,2023-07-05,504,iron,449,879,430,1,00467,India
632845,2023-07-05,504,iron,449,879,430,1,00416,India
632845,2023-07-05,503,mixer,1349,3249,1900,1,00416,India
571451,2023-07-05,502,iphone 15 pro max,100000,135000,35000,1,00298,India
571451,2023-07-05,506,monitor,3249,8000,4751,1,00298,India
402708,2023-07-05,501,iphone 15,60000,80000,20000,1,00489,India
402708,2023-07-05,507,washing machine,6990,16490,9500,1,00489,India
402708,2023-07-05,504,iron,449,879,430,1,00489,India
782550,2023-07-05,501,iphone 15,60000,80000,20000,1,00048,India
782550,2023-07-05,506,monitor,3249,8000,4751,1,00048,India
330704,2023-07-05,505,oven,18490,24000,5510,1,00222,India
742155,2023-07-05,505,oven,18490,24000,5510,1,00021,India
863393,2023-07-05,501,iphone 15,60000,80000,20000,1,00231,India
863393,2023-07-05,507,washing machine,6990,16490,9500,1,00231,India
863393,2023-07-05,505,oven,18490,24000,5510,1,00231,India
847924,2023-07-06,504,iron,449,879,430,1,00442,India
847924,2023-07-06,506,monitor,3249,8000,4751,1,00442,India
819147,2023-07-06,503,mixer,1349,3249,1900,1,00079,India
819147,2023-07-06,502,iphone 15 pro max,100000,135000,35000,1,00079,India
147324,2023-07-06,507,washing machine,6990,16490,9500,1,00399,India
147324,2023-07-06,503,mixer,1349,3249,1900,1,00399,India
147324,2023-07-06,506,monitor,3249,8000,4751,1,00399,India
879555,2023-07-06,507,washing machine,6990,16490,9500,1,00129,India
879555,2023-07-06,501,iphone 15,60000,80000,20000,1,00129,India
879555,2023-07-06,504,iron,449,879,430,1,00129,India
879555,2023-07-06,506,monitor,3249,8000,4751,1,00129,India
285444,2023-07-06,504,iron,449,879,430,1,00142,India
285444,2023-07-06,501,iphone 15,60000,80000,20000,1,00142,India
285444,2023-07-06,507,washing machine,6990,16490,9500,1,00142,India
285444,2023-07-06,503,mixer,1349,3249,1900,1,00142,India
644909,2023-07-06,501,iphone 15,60000,80000,20000,1,00289,India
861374,2023-07-06,502,iphone 15 pro max,100000,135000,35000,1,00449,India
861374,2023-07-06,507,washing machine,6990,16490,9500,1,00449,India
861374,2023-07-06,505,oven,18490,24000,5510,1,00449,India
745852,2023-07-06,507,washing machine,6990,16490,9500,1,00074,India
745852,2023-07-06,502,iphone 15 pro max,100000,135000,35000,1,00074,India
745852,2023-07-06,504,iron,449,879,430,1,00074,India
745852,2023-07-06,503,mixer,1349,3249,1900,1,00074,India
289740,2023-07-06,504,iron,449,879,430,1,00449,India
849672,2023-07-06,503,mixer,1349,3249,1900,1,00265,India
849672,2023-07-06,502,iphone 15 pro max,100000,135000,35000,1,00265,India
849672,2023-07-06,506,monitor,3249,8000,4751,1,00265,India
849672,2023-07-06,507,washing machine,6990,16490,9500,1,00265,India
525356,2023-07-06,505,oven,18490,24000,5510,1,00226,India
525356,2023-07-06,502,iphone 15 pro max,100000,135000,35000,1,00226,India
525356,2023-07-06,504,iron,449,879,430,1,00226,India
405035,2023-07-06,501,iphone 15,60000,80000,20000,1,00114,India
405035,2023-07-06,505,oven,18490,24000,5510,1,00114,India
405035,2023-07-06,507,washing machine,6990,16490,9500,1,00114,India
405035,2023-07-06,504,iron,449,879,430,1,00114,India
403611,2023-07-06,502,iphone 15 pro max,100000,135000,35000,1,00016,India
403611,2023-07-06,504,iron,449,879,430,1,00016,India
403611,2023-07-06,506,monitor,3249,8000,4751,1,00016,India
403611,2023-07-06,503,mixer,1349,3249,1900,1,00016,India
244215,2023-07-06,505,oven,18490,24000,5510,1,00083,India
363679,2023-07-06,505,oven,18490,24000,5510,1,00198,India
363679,2023-07-06,506,monitor,3249,8000,4751,1,00198,India
363679,2023-07-06,501,iphone 15,60000,80000,20000,1,00198,India
603011,2023-07-06,504,iron,449,879,430,1,00413,India
603011,2023-07-06,502,iphone 15 pro max,100000,135000,35000,1,00413,India
603011,2023-07-06,503,mixer,1349,3249,1900,1,00413,India
144747,2023-07-06,506,monitor,3249,8000,4751,1,00326,India
144747,2023-07-06,502,iphone 15 pro max,100000,135000,35000,1,00326,India
484814,2023-07-06,504,iron,449,879,430,1,00475,India
482992,2023-07-06,504,iron,449,879,430,1,00094,India
482992,2023-07-06,501,iphone 15,60000,80000,20000,1,00094,India
412066,2023-07-06,507,washing machine,6990,16490,9500,1,00466,India
625896,2023-07-06,502,iphone 15 pro max,100000,135000,35000,1,00187,India
625896,2023-07-06,504,iron,449,879,430,1,00187,India
866672,2023-07-06,503,mixer,1349,3249,1900,1,00267,India
866672,2023-07-06,502,iphone 15 pro max,100000,135000,35000,1,00267,India
866672,2023-07-06,505,oven,18490,24000,5510,1,00267,India
866672,2023-07-06,501,iphone 15,60000,80000,20000,1,00267,India
489363,2023-07-06,507,washing machine,6990,16490,9500,1,00034,India
489363,2023-07-06,503,mixer,1349,3249,1900,1,00034,India
256658,2023-07-06,503,mixer,1349,3249,1900,1,00010,India
256658,2023-07-06,501,iphone 15,60000,80000,20000,1,00010,India
437746,2023-07-06,505,oven,18490,24000,5510,1,00124,India
437746,2023-07-06,506,monitor,3249,8000,4751,1,00124,India
447029,2023-07-06,505,oven,18490,24000,5510,1,00444,India
447029,2023-07-06,502,iphone 15 pro max,100000,135000,35000,1,00444,India
447029,2023-07-06,501,iphone 15,60000,80000,20000,1,00444,India
582049,2023-07-06,503,mixer,1349,3249,1900,1,00432,India
582049,2023-07-06,504,iron,449,879,430,1,00432,India
370188,2023-07-06,501,iphone 15,60000,80000,20000,1,00231,India
370188,2023-07-06,504,iron,449,879,430,1,00231,India
813159,2023-07-06,505,oven,18490,24000,5510,1,00149,India
813159,2023-07-06,503,mixer,1349,3249,1900,1,00149,India
633414,2023-07-06,504,iron,449,879,430,1,00290,India
633414,2023-07-06,503,mixer,1349,3249,1900,1,00290,India
633414,2023-07-06,506,monitor,3249,8000,4751,1,00290,India
600717,2023-07-06,502,iphone 15 pro max,100000,135000,35000,1,00464,India
600717,2023-07-06,507,washing machine,6990,16490,9500,1,00464,India
600717,2023-07-06,501,iphone 15,60000,80000,20000,1,00464,India
805082,2023-07-06,505,oven,18490,24000,5510,1,00220,India
248613,2023-07-06,505,oven,18490,24000,5510,1,00135,India
248613,2023-07-06,506,monitor,3249,8000,4751,1,00135,India
248613,2023-07-06,507,washing machine,6990,16490,9500,1,00135,India
248613,2023-07-06,504,iron,449,879,430,1,00135,India
524393,2023-07-06,507,washing machine,6990,16490,9500,1,00135,India
524393,2023-07-06,505,oven,18490,24000,5510,1,00135,India
524393,2023-07-06,502,iphone 15 pro max,100000,135000,35000,1,00135,India
524393,2023-07-06,504,iron,449,879,430,1,00135,India
843662,2023-07-06,507,washing machine,6990,16490,9500,1,00146,India
843662,2023-07-06,505,oven,18490,24000,5510,1,00146,India
843662,2023-07-06,502,iphone 15 pro max,100000,135000,35000,1,00146,India
843662,2023-07-06,501,iphone 15,60000,80000,20000,1,00146,India
850875,2023-07-06,506,monitor,3249,8000,4751,1,00269,India
850875,2023-07-06,501,iphone 15,60000,80000,20000,1,00269,India
850875,2023-07-06,502,iphone 15 pro max,100000,135000,35000,1,00269,India
357253,2023-07-06,504,iron,449,879,430,1,00015,India
357253,2023-07-06,501,iphone 15,60000,80000,20000,1,00015,India
357253,2023-07-06,506,monitor,3249,8000,4751,1,00015,India
870757,2023-07-06,501,iphone 15,60000,80000,20000,1,00134,India
870757,2023-07-06,507,washing machine,6990,16490,9500,1,00134,India
783189,2023-07-06,504,iron,449,879,430,1,00098,India
783189,2023-07-06,503,mixer,1349,3249,1900,1,00098,India
817298,2023-07-06,506,monitor,3249,8000,4751,1,00364,India
817298,2023-07-06,503,mixer,1349,3249,1900,1,00364,India
665217,2023-07-06,505,oven,18490,24000,5510,1,00057,India
964523,2023-07-06,504,iron,449,879,430,1,00155,India
964523,2023-07-06,507,washing machine,6990,16490,9500,1,00155,India
667618,2023-07-06,502,iphone 15 pro max,100000,135000,35000,1,00491,India
684361,2023-07-06,503,mixer,1349,3249,1900,1,00394,India
684361,2023-07-06,504,iron,449,879,430,1,00394,India
684361,2023-07-06,506,monitor,3249,8000,4751,1,00394,India
684361,2023-07-06,505,oven,18490,24000,5510,1,00394,India
530962,2023-07-06,506,monitor,3249,8000,4751,1,00074,India
530962,2023-07-06,504,iron,449,879,430,1,00074,India
586316,2023-07-06,507,washing machine,6990,16490,9500,1,00400,India
586316,2023-07-06,506,monitor,3249,8000,4751,1,00400,India
586316,2023-07-06,505,oven,18490,24000,5510,1,00400,India
586316,2023-07-06,503,mixer,1349,3249,1900,1,00400,India
205752,2023-07-06,503,mixer,1349,3249,1900,1,00387,India
205752,2023-07-06,507,washing machine,6990,16490,9500,1,00387,India
205752,2023-07-06,504,iron,449,879,430,1,00387,India
205752,2023-07-06,501,iphone 15,60000,80000,20000,1,00387,India
786386,2023-07-06,505,oven,18490,24000,5510,1,00210,India
786386,2023-07-06,502,iphone 15 pro max,100000,135000,35000,1,00210,India
567794,2023-07-06,502,iphone 15 pro max,100000,135000,35000,1,00044,India
567794,2023-07-06,503,mixer,1349,3249,1900,1,00044,India
567794,2023-07-06,505,oven,18490,24000,5510,1,00044,India
802161,2023-07-06,507,washing machine,6990,16490,9500,1,00208,India
802161,2023-07-06,503,mixer,1349,3249,1900,1,00208,India
758787,2023-07-06,501,iphone 15,60000,80000,20000,1,00208,India
317560,2023-07-06,503,mixer,1349,3249,1900,1,00025,India
317560,2023-07-06,506,monitor,3249,8000,4751,1,00025,India
317560,2023-07-06,501,iphone 15,60000,80000,20000,1,00025,India
804125,2023-07-06,503,mixer,1349,3249,1900,1,00105,India
804125,2023-07-06,506,monitor,3249,8000,4751,1,00105,India
805992,2023-07-06,503,mixer,1349,3249,1900,1,00290,India
805992,2023-07-06,507,washing machine,6990,16490,9500,1,00290,India
264907,2023-07-06,501,iphone 15,60000,80000,20000,1,00412,India
264907,2023-07-06,506,monitor,3249,8000,4751,1,00412,India
355203,2023-07-06,507,washing machine,6990,16490,9500,1,00494,India
355203,2023-07-06,502,iphone 15 pro max,100000,135000,35000,1,00494,India
355203,2023-07-06,505,oven,18490,24000,5510,1,00494,India
355203,2023-07-06,501,iphone 15,60000,80000,20000,1,00494,India
355203,2023-07-06,506,monitor,3249,8000,4751,1,00494,India
424510,2023-07-06,503,mixer,1349,3249,1900,1,00061,India
424510,2023-07-06,502,iphone 15 pro max,100000,135000,35000,1,00061,India
367688,2023-07-06,503,mixer,1349,3249,1900,1,00060,India
367688,2023-07-06,505,oven,18490,24000,5510,1,00060,India
367688,2023-07-06,507,washing machine,6990,16490,9500,1,00060,India
795422,2023-07-06,504,iron,449,879,430,1,00382,India
795422,2023-07-06,506,monitor,3249,8000,4751,1,00382,India
654868,2023-07-06,503,mixer,1349,3249,1900,1,00181,India
654868,2023-07-06,506,monitor,3249,8000,4751,1,00181,India
654868,2023-07-06,507,washing machine,6990,16490,9500,1,00181,India
602253,2023-07-06,503,mixer,1349,3249,1900,1,00441,India
602253,2023-07-06,504,iron,449,879,430,1,00441,India
602253,2023-07-06,502,iphone 15 pro max,100000,135000,35000,1,00441,India
602253,2023-07-06,507,washing machine,6990,16490,9500,1,00441,India
939125,2023-07-06,506,monitor,3249,8000,4751,1,00239,India
939125,2023-07-06,502,iphone 15 pro max,100000,135000,35000,1,00239,India
939125,2023-07-06,505,oven,18490,24000,5510,1,00239,India
727367,2023-07-06,502,iphone 15 pro max,100000,135000,35000,1,00246,India
575913,2023-07-06,503,mixer,1349,3249,1900,1,00050,India
575913,2023-07-06,507,washing machine,6990,16490,9500,1,00050,India
575913,2023-07-06,501,iphone 15,60000,80000,20000,1,00050,India
575913,2023-07-06,506,monitor,3249,8000,4751,1,00050,India
818331,2023-07-06,502,iphone 15 pro max,100000,135000,35000,1,00092,India
818331,2023-07-06,506,monitor,3249,8000,4751,1,00092,India
578979,2023-07-06,506,monitor,3249,8000,4751,1,00234,India
578979,2023-07-06,505,oven,18490,24000,5510,1,00234,India
612613,2023-07-06,502,iphone 15 pro max,100000,135000,35000,1,00076,India
612613,2023-07-06,501,iphone 15,60000,80000,20000,1,00076,India
124733,2023-07-06,501,iphone 15,60000,80000,20000,1,00211,India
124733,2023-07-06,507,washing machine,6990,16490,9500,1,00211,India
744078,2023-07-06,504,iron,449,879,430,1,00041,India
696663,2023-07-06,502,iphone 15 pro max,100000,135000,35000,1,00301,India
696663,2023-07-06,504,iron,449,879,430,1,00301,India
749606,2023-07-06,507,washing machine,6990,16490,9500,1,00056,India
749606,2023-07-06,506,monitor,3249,8000,4751,1,00056,India
803674,2023-07-06,506,monitor,3249,8000,4751,1,00093,India
803674,2023-07-06,501,iphone 15,60000,80000,20000,1,00093,India
803674,2023-07-06,503,mixer,1349,3249,1900,1,00093,India
803674,2023-07-06,505,oven,18490,24000,5510,1,00093,India
331793,2023-07-06,502,iphone 15 pro max,100000,135000,35000,1,00101,India
331793,2023-07-06,504,iron,449,879,430,1,00101,India
797538,2023-07-06,501,iphone 15,60000,80000,20000,1,00205,India
797538,2023-07-06,507,washing machine,6990,16490,9500,1,00205,India
589468,2023-07-06,503,mixer,1349,3249,1900,1,00442,India
589468,2023-07-06,505,oven,18490,24000,5510,1,00442,India
932309,2023-07-06,506,monitor,3249,8000,4751,1,00030,India
932309,2023-07-06,504,iron,449,879,430,1,00030,India
592250,2023-07-06,506,monitor,3249,8000,4751,1,00048,India
278152,2023-07-06,505,oven,18490,24000,5510,1,00036,India
546823,2023-07-06,505,oven,18490,24000,5510,1,00436,India
546823,2023-07-06,502,iphone 15 pro max,100000,135000,35000,1,00436,India
262596,2023-07-06,504,iron,449,879,430,1,00257,India
262596,2023-07-06,503,mixer,1349,3249,1900,1,00257,India
262596,2023-07-06,501,iphone 15,60000,80000,20000,1,00257,India
262596,2023-07-06,505,oven,18490,24000,5510,1,00257,India
685594,2023-07-06,505,oven,18490,24000,5510,1,00300,India
685594,2023-07-06,501,iphone 15,60000,80000,20000,1,00300,India
685594,2023-07-06,503,mixer,1349,3249,1900,1,00300,India
685594,2023-07-06,502,iphone 15 pro max,100000,135000,35000,1,00300,India
445418,2023-07-06,504,iron,449,879,430,1,00219,India
445418,2023-07-06,505,oven,18490,24000,5510,1,00219,India
866704,2023-07-06,504,iron,449,879,430,1,00401,India
866704,2023-07-06,501,iphone 15,60000,80000,20000,1,00401,India
377449,2023-07-06,507,washing machine,6990,16490,9500,1,00263,India
764037,2023-07-06,504,iron,449,879,430,1,00097,India
764037,2023-07-06,501,iphone 15,60000,80000,20000,1,00097,India
150121,2023-07-06,503,mixer,1349,3249,1900,1,00059,India
150121,2023-07-06,506,monitor,3249,8000,4751,1,00059,India
150121,2023-07-06,507,washing machine,6990,16490,9500,1,00059,India
150121,2023-07-06,504,iron,449,879,430,1,00059,India
150121,2023-07-06,505,oven,18490,24000,5510,1,00059,India
776015,2023-07-06,504,iron,449,879,430,1,00186,India
376595,2023-07-06,505,oven,18490,24000,5510,1,00327,India
551407,2023-07-06,506,monitor,3249,8000,4751,1,00106,India
551407,2023-07-06,502,iphone 15 pro max,100000,135000,35000,1,00106,India
551407,2023-07-06,503,mixer,1349,3249,1900,1,00106,India
551407,2023-07-06,504,iron,449,879,430,1,00106,India
309440,2023-07-06,503,mixer,1349,3249,1900,1,00437,India
309440,2023-07-06,506,monitor,3249,8000,4751,1,00437,India
309440,2023-07-06,505,oven,18490,24000,5510,1,00437,India
624189,2023-07-06,505,oven,18490,24000,5510,1,00291,India
624189,2023-07-06,504,iron,449,879,430,1,00291,India
624189,2023-07-06,502,iphone 15 pro max,100000,135000,35000,1,00291,India
224442,2023-07-06,505,oven,18490,24000,5510,1,00313,India
224442,2023-07-06,507,washing machine,6990,16490,9500,1,00313,India
661444,2023-07-06,503,mixer,1349,3249,1900,1,00041,India
661444,2023-07-06,507,washing machine,6990,16490,9500,1,00041,India
128529,2023-07-06,503,mixer,1349,3249,1900,1,00034,India
128529,2023-07-06,506,monitor,3249,8000,4751,1,00034,India
128529,2023-07-06,507,washing machine,6990,16490,9500,1,00034,India
711401,2023-07-06,505,oven,18490,24000,5510,1,00488,India
711401,2023-07-06,507,washing machine,6990,16490,9500,1,00488,India
421890,2023-07-06,507,washing machine,6990,16490,9500,1,00016,India
124898,2023-07-06,504,iron,449,879,430,1,00474,India
124898,2023-07-06,501,iphone 15,60000,80000,20000,1,00474,India
486051,2023-07-07,504,iron,449,879,430,1,00312,India
486051,2023-07-07,503,mixer,1349,3249,1900,1,00312,India
486051,2023-07-07,502,iphone 15 pro max,100000,135000,35000,1,00312,India
486051,2023-07-07,501,iphone 15,60000,80000,20000,1,00312,India
688233,2023-07-07,502,iphone 15 pro max,100000,135000,35000,1,00185,India
688233,2023-07-07,504,iron,449,879,430,1,00185,India
266116,2023-07-07,504,iron,449,879,430,1,00168,India
168147,2023-07-07,502,iphone 15 pro max,100000,135000,35000,1,00470,India
168147,2023-07-07,503,mixer,1349,3249,1900,1,00470,India
348390,2023-07-07,503,mixer,1349,3249,1900,1,00361,India
241822,2023-07-07,501,iphone 15,60000,80000,20000,1,00406,India
241822,2023-07-07,505,oven,18490,24000,5510,1,00406,India
527734,2023-07-07,505,oven,18490,24000,5510,1,00169,India
519457,2023-07-07,507,washing machine,6990,16490,9500,1,00213,India
519457,2023-07-07,501,iphone 15,60000,80000,20000,1,00213,India
519457,2023-07-07,502,iphone 15 pro max,100000,135000,35000,1,00213,India
558312,2023-07-07,507,washing machine,6990,16490,9500,1,00400,India
558312,2023-07-07,501,iphone 15,60000,80000,20000,1,00400,India
229715,2023-07-07,501,iphone 15,60000,80000,20000,1,00029,India
229715,2023-07-07,506,monitor,3249,8000,4751,1,00029,India
229715,2023-07-07,502,iphone 15 pro max,100000,135000,35000,1,00029,India
139911,2023-07-07,507,washing machine,6990,16490,9500,1,00332,India
139911,2023-07-07,501,iphone 15,60000,80000,20000,1,00332,India
826153,2023-07-07,507,washing machine,6990,16490,9500,1,00151,India
981765,2023-07-07,507,washing machine,6990,16490,9500,1,00143,India
981765,2023-07-07,502,iphone 15 pro max,100000,135000,35000,1,00143,India
981765,2023-07-07,503,mixer,1349,3249,1900,1,00143,India
356830,2023-07-07,506,monitor,3249,8000,4751,1,00362,India
356830,2023-07-07,501,iphone 15,60000,80000,20000,1,00362,India
356830,2023-07-07,504,iron,449,879,430,1,00362,India
660102,2023-07-07,501,iphone 15,60000,80000,20000,1,00378,India
660102,2023-07-07,504,iron,449,879,430,1,00378,India
660102,2023-07-07,505,oven,18490,24000,5510,1,00378,India
660102,2023-07-07,502,iphone 15 pro max,100000,135000,35000,1,00378,India
949531,2023-07-07,503,mixer,1349,3249,1900,1,00256,India
949531,2023-07-07,501,iphone 15,60000,80000,20000,1,00256,India
949531,2023-07-07,505,oven,18490,24000,5510,1,00256,India
949531,2023-07-07,502,iphone 15 pro max,100000,135000,35000,1,00256,India
487323,2023-07-07,502,iphone 15 pro max,100000,135000,35000,1,00330,India
487323,2023-07-07,507,washing machine,6990,16490,9500,1,00330,India
487323,2023-07-07,501,iphone 15,60000,80000,20000,1,00330,India
382537,2023-07-07,502,iphone 15 pro max,100000,135000,35000,1,00083,India
382537,2023-07-07,507,washing machine,6990,16490,9500,1,00083,India
464955,2023-07-07,507,washing machine,6990,16490,9500,1,00382,India
464955,2023-07-07,501,iphone 15,60000,80000,20000,1,00382,India
464955,2023-07-07,502,iphone 15 pro max,100000,135000,35000,1,00382,India
464955,2023-07-07,506,monitor,3249,8000,4751,1,00382,India
735067,2023-07-07,503,mixer,1349,3249,1900,1,00473,India
735067,2023-07-07,501,iphone 15,60000,80000,20000,1,00473,India
735067,2023-07-07,507,washing machine,6990,16490,9500,1,00473,India
735067,2023-07-07,505,oven,18490,24000,5510,1,00473,India
171606,2023-07-07,504,iron,449,879,430,1,00308,India
171606,2023-07-07,501,iphone 15,60000,80000,20000,1,00308,India
427918,2023-07-07,504,iron,449,879,430,1,00085,India
919373,2023-07-07,506,monitor,3249,8000,4751,1,00198,India
919373,2023-07-07,503,mixer,1349,3249,1900,1,00198,India
919373,2023-07-07,504,iron,449,879,430,1,00198,India
919373,2023-07-07,502,iphone 15 pro max,100000,135000,35000,1,00198,India
956287,2023-07-07,504,iron,449,879,430,1,00358,India
210520,2023-07-07,507,washing machine,6990,16490,9500,1,00342,India
210520,2023-07-07,504,iron,449,879,430,1,00342,India
697428,2023-07-07,501,iphone 15,60000,80000,20000,1,00047,India
697428,2023-07-07,503,mixer,1349,3249,1900,1,00047,India
697428,2023-07-07,507,washing machine,6990,16490,9500,1,00047,India
618275,2023-07-07,507,washing machine,6990,16490,9500,1,00082,India
698434,2023-07-07,506,monitor,3249,8000,4751,1,00449,India
698434,2023-07-07,501,iphone 15,60000,80000,20000,1,00449,India
698434,2023-07-07,502,iphone 15 pro max,100000,135000,35000,1,00449,India
184845,2023-07-07,507,washing machine,6990,16490,9500,1,00423,India
184845,2023-07-07,505,oven,18490,24000,5510,1,00423,India
184845,2023-07-07,503,mixer,1349,3249,1900,1,00423,India
791519,2023-07-07,506,monitor,3249,8000,4751,1,00147,India
791519,2023-07-07,507,washing machine,6990,16490,9500,1,00147,India
791519,2023-07-07,502,iphone 15 pro max,100000,135000,35000,1,00147,India
301998,2023-07-07,501,iphone 15,60000,80000,20000,1,00180,India
301998,2023-07-07,504,iron,449,879,430,1,00180,India
301998,2023-07-07,506,monitor,3249,8000,4751,1,00180,India
412539,2023-07-07,502,iphone 15 pro max,100000,135000,35000,1,00169,India
589988,2023-07-07,506,monitor,3249,8000,4751,1,00449,India
326633,2023-07-07,501,iphone 15,60000,80000,20000,1,00262,India
326633,2023-07-07,507,washing machine,6990,16490,9500,1,00262,India
326633,2023-07-07,503,mixer,1349,3249,1900,1,00262,India
326633,2023-07-07,505,oven,18490,24000,5510,1,00262,India
326633,2023-07-07,506,monitor,3249,8000,4751,1,00262,India
136644,2023-07-07,505,oven,18490,24000,5510,1,00457,India
136644,2023-07-07,503,mixer,1349,3249,1900,1,00457,India
218421,2023-07-07,502,iphone 15 pro max,100000,135000,35000,1,00023,India
218421,2023-07-07,503,mixer,1349,3249,1900,1,00023,India
218421,2023-07-07,501,iphone 15,60000,80000,20000,1,00023,India
835942,2023-07-07,504,iron,449,879,430,1,00224,India
835942,2023-07-07,502,iphone 15 pro max,100000,135000,35000,1,00224,India
552825,2023-07-07,506,monitor,3249,8000,4751,1,00017,India
316507,2023-07-07,507,washing machine,6990,16490,9500,1,00319,India
315632,2023-07-07,502,iphone 15 pro max,100000,135000,35000,1,00292,India
315632,2023-07-07,501,iphone 15,60000,80000,20000,1,00292,India
315632,2023-07-07,507,washing machine,6990,16490,9500,1,00292,India
315632,2023-07-07,504,iron,449,879,430,1,00292,India
864943,2023-07-07,502,iphone 15 pro max,100000,135000,35000,1,00483,India
864943,2023-07-07,506,monitor,3249,8000,4751,1,00483,India
536920,2023-07-07,506,monitor,3249,8000,4751,1,00236,India
536920,2023-07-07,507,washing machine,6990,16490,9500,1,00236,India
536920,2023-07-07,502,iphone 15 pro max,100000,135000,35000,1,00236,India
536920,2023-07-07,501,iphone 15,60000,80000,20000,1,00236,India
536920,2023-07-07,503,mixer,1349,3249,1900,1,00236,India
564555,2023-07-07,504,iron,449,879,430,1,00289,India
564555,2023-07-07,502,iphone 15 pro max,100000,135000,35000,1,00289,India
564555,2023-07-07,506,monitor,3249,8000,4751,1,00289,India
564555,2023-07-07,507,washing machine,6990,16490,9500,1,00289,India
375049,2023-07-07,506,monitor,3249,8000,4751,1,00145,India
375049,2023-07-07,502,iphone 15 pro max,100000,135000,35000,1,00145,India
571238,2023-07-07,504,iron,449,879,430,1,00260,India
571238,2023-07-07,503,mixer,1349,3249,1900,1,00260,India
738573,2023-07-07,503,mixer,1349,3249,1900,1,00440,India
694507,2023-07-07,506,monitor,3249,8000,4751,1,00351,India
694507,2023-07-07,505,oven,18490,24000,5510,1,00351,India
966642,2023-07-07,507,washing machine,6990,16490,9500,1,00127,India
966642,2023-07-07,504,iron,449,879,430,1,00127,India
934999,2023-07-07,502,iphone 15 pro max,100000,135000,35000,1,00093,India
934999,2023-07-07,505,oven,18490,24000,5510,1,00093,India
934999,2023-07-07,507,washing machine,6990,16490,9500,1,00093,India
809707,2023-07-07,506,monitor,3249,8000,4751,1,00195,India
809707,2023-07-07,505,oven,18490,24000,5510,1,00195,India
809707,2023-07-07,502,iphone 15 pro max,100000,135000,35000,1,00195,India
441247,2023-07-07,504,iron,449,879,430,1,00408,India
441247,2023-07-07,507,washing machine,6990,16490,9500,1,00408,India
441247,2023-07-07,503,mixer,1349,3249,1900,1,00408,India
421513,2023-07-07,505,oven,18490,24000,5510,1,00247,India
421513,2023-07-07,504,iron,449,879,430,1,00247,India
421513,2023-07-07,501,iphone 15,60000,80000,20000,1,00247,India
417681,2023-07-07,506,monitor,3249,8000,4751,1,00094,India
417681,2023-07-07,502,iphone 15 pro max,100000,135000,35000,1,00094,India
417681,2023-07-07,505,oven,18490,24000,5510,1,00094,India
401614,2023-07-07,504,iron,449,879,430,1,00328,India
401614,2023-07-07,502,iphone 15 pro max,100000,135000,35000,1,00328,India
401614,2023-07-07,503,mixer,1349,3249,1900,1,00328,India
805773,2023-07-07,502,iphone 15 pro max,100000,135000,35000,1,00238,India
805773,2023-07-07,506,monitor,3249,8000,4751,1,00238,India
805773,2023-07-07,507,washing machine,6990,16490,9500,1,00238,India
805773,2023-07-07,505,oven,18490,24000,5510,1,00238,India
386152,2023-07-07,504,iron,449,879,430,1,00121,India
761739,2023-07-07,503,mixer,1349,3249,1900,1,00324,India
761739,2023-07-07,507,washing machine,6990,16490,9500,1,00324,India
761739,2023-07-07,505,oven,18490,24000,5510,1,00324,India
761739,2023-07-07,502,iphone 15 pro max,100000,135000,35000,1,00324,India
670006,2023-07-07,507,washing machine,6990,16490,9500,1,00128,India
670006,2023-07-07,503,mixer,1349,3249,1900,1,00128,India
827879,2023-07-07,504,iron,449,879,430,1,00028,India
827879,2023-07-07,501,iphone 15,60000,80000,20000,1,00028,India
827879,2023-07-07,506,monitor,3249,8000,4751,1,00028,India
827879,2023-07-07,505,oven,18490,24000,5510,1,00028,India
706229,2023-07-08,503,mixer,1349,3249,1900,1,00094,India
706229,2023-07-08,504,iron,449,879,430,1,00094,India
706229,2023-07-08,505,oven,18490,24000,5510,1,00094,India
448302,2023-07-08,503,mixer,1349,3249,1900,1,00058,India
448302,2023-07-08,501,iphone 15,60000,80000,20000,1,00058,India
701940,2023-07-08,507,washing machine,6990,16490,9500,1,00036,India
701940,2023-07-08,504,iron,449,879,430,1,00036,India
623079,2023-07-08,504,iron,449,879,430,1,00170,India
623079,2023-07-08,505,oven,18490,24000,5510,1,00170,India
543072,2023-07-08,505,oven,18490,24000,5510,1,00051,India
543072,2023-07-08,506,monitor,3249,8000,4751,1,00051,India
543072,2023-07-08,503,mixer,1349,3249,1900,1,00051,India
675310,2023-07-08,503,mixer,1349,3249,1900,1,00112,India
675310,2023-07-08,507,washing machine,6990,16490,9500,1,00112,India
927351,2023-07-08,502,iphone 15 pro max,100000,135000,35000,1,00097,India
927351,2023-07-08,507,washing machine,6990,16490,9500,1,00097,India
698800,2023-07-08,503,mixer,1349,3249,1900,1,00450,India
591090,2023-07-08,506,monitor,3249,8000,4751,1,00141,India
591090,2023-07-08,504,iron,449,879,430,1,00141,India
688497,2023-07-08,506,monitor,3249,8000,4751,1,00391,India
688497,2023-07-08,501,iphone 15,60000,80000,20000,1,00391,India
327317,2023-07-08,501,iphone 15,60000,80000,20000,1,00196,India
214448,2023-07-08,503,mixer,1349,3249,1900,1,00389,India
214448,2023-07-08,501,iphone 15,60000,80000,20000,1,00389,India
214448,2023-07-08,505,oven,18490,24000,5510,1,00389,India
409068,2023-07-08,504,iron,449,879,430,1,00087,India
410166,2023-07-08,504,iron,449,879,430,1,00258,India
410166,2023-07-08,502,iphone 15 pro max,100000,135000,35000,1,00258,India
997960,2023-07-08,506,monitor,3249,8000,4751,1,00142,India
997960,2023-07-08,503,mixer,1349,3249,1900,1,00142,India
997960,2023-07-08,502,iphone 15 pro max,100000,135000,35000,1,00142,India
668489,2023-07-08,502,iphone 15 pro max,100000,135000,35000,1,00011,India
668489,2023-07-08,504,iron,449,879,430,1,00011,India
668489,2023-07-08,505,oven,18490,24000,5510,1,00011,India
788628,2023-07-08,503,mixer,1349,3249,1900,1,00211,India
788628,2023-07-08,505,oven,18490,24000,5510,1,00211,India
788628,2023-07-08,506,monitor,3249,8000,4751,1,00211,India
975994,2023-07-08,501,iphone 15,60000,80000,20000,1,00120,India
975994,2023-07-08,504,iron,449,879,430,1,00120,India
975994,2023-07-08,507,washing machine,6990,16490,9500,1,00120,India
137405,2023-07-08,506,monitor,3249,8000,4751,1,00461,India
137405,2023-07-08,501,iphone 15,60000,80000,20000,1,00461,India
740541,2023-07-08,502,iphone 15 pro max,100000,135000,35000,1,00188,India
740541,2023-07-08,507,washing machine,6990,16490,9500,1,00188,India
740541,2023-07-08,503,mixer,1349,3249,1900,1,00188,India
762104,2023-07-08,506,monitor,3249,8000,4751,1,00051,India
762104,2023-07-08,504,iron,449,879,430,1,00051,India
762104,2023-07-08,507,washing machine,6990,16490,9500,1,00051,India
580225,2023-07-08,506,monitor,3249,8000,4751,1,00457,India
580225,2023-07-08,507,washing machine,6990,16490,9500,1,00457,India
580225,2023-07-08,501,iphone 15,60000,80000,20000,1,00457,India
272933,2023-07-08,503,mixer,1349,3249,1900,1,00416,India
272933,2023-07-08,504,iron,449,879,430,1,00416,India
377995,2023-07-08,505,oven,18490,24000,5510,1,00478,India
377995,2023-07-08,504,iron,449,879,430,1,00478,India
377995,2023-07-08,507,washing machine,6990,16490,9500,1,00478,India
304433,2023-07-08,501,iphone 15,60000,80000,20000,1,00116,India
304433,2023-07-08,503,mixer,1349,3249,1900,1,00116,India
304433,2023-07-08,507,washing machine,6990,16490,9500,1,00116,India
281387,2023-07-08,502,iphone 15 pro max,100000,135000,35000,1,00036,India
281387,2023-07-08,507,washing machine,6990,16490,9500,1,00036,India
281387,2023-07-08,501,iphone 15,60000,80000,20000,1,00036,India
890537,2023-07-08,507,washing machine,6990,16490,9500,1,00166,India
519539,2023-07-08,504,iron,449,879,430,1,00244,India
673405,2023-07-08,503,mixer,1349,3249,1900,1,00007,India
197552,2023-07-08,507,washing machine,6990,16490,9500,1,00097,India
197552,2023-07-08,505,oven,18490,24000,5510,1,00097,India
197552,2023-07-08,502,iphone 15 pro max,100000,135000,35000,1,00097,India
197552,2023-07-08,503,mixer,1349,3249,1900,1,00097,India
706385,2023-07-08,501,iphone 15,60000,80000,20000,1,00269,India
706385,2023-07-08,507,washing machine,6990,16490,9500,1,00269,India
706385,2023-07-08,506,monitor,3249,8000,4751,1,00269,India
706385,2023-07-08,502,iphone 15 pro max,100000,135000,35000,1,00269,India
646539,2023-07-08,503,mixer,1349,3249,1900,1,00148,India
713177,2023-07-08,501,iphone 15,60000,80000,20000,1,00017,India
713177,2023-07-08,507,washing machine,6990,16490,9500,1,00017,India
713177,2023-07-08,506,monitor,3249,8000,4751,1,00017,India
103665,2023-07-08,505,oven,18490,24000,5510,1,00217,India
318807,2023-07-08,505,oven,18490,24000,5510,1,00219,India
318807,2023-07-08,506,monitor,3249,8000,4751,1,00219,India
318807,2023-07-08,503,mixer,1349,3249,1900,1,00219,India
981318,2023-07-08,506,monitor,3249,8000,4751,1,00128,India
981318,2023-07-08,504,iron,449,879,430,1,00128,India
756560,2023-07-08,505,oven,18490,24000,5510,1,00451,India
756560,2023-07-08,502,iphone 15 pro max,100000,135000,35000,1,00451,India
756560,2023-07-08,503,mixer,1349,3249,1900,1,00451,India
756560,2023-07-08,504,iron,449,879,430,1,00451,India
756560,2023-07-08,506,monitor,3249,8000,4751,1,00451,India
684140,2023-07-08,504,iron,449,879,430,1,00158,India
684140,2023-07-08,505,oven,18490,24000,5510,1,00158,India
684140,2023-07-08,507,washing machine,6990,16490,9500,1,00158,India
962651,2023-07-08,501,iphone 15,60000,80000,20000,1,00355,India
962651,2023-07-08,507,washing machine,6990,16490,9500,1,00355,India
962651,2023-07-08,503,mixer,1349,3249,1900,1,00355,India
776241,2023-07-08,502,iphone 15 pro max,100000,135000,35000,1,00047,India
776241,2023-07-08,503,mixer,1349,3249,1900,1,00047,India
805749,2023-07-08,503,mixer,1349,3249,1900,1,00060,India
805749,2023-07-08,502,iphone 15 pro max,100000,135000,35000,1,00060,India
805749,2023-07-08,507,washing machine,6990,16490,9500,1,00060,India
805749,2023-07-08,501,iphone 15,60000,80000,20000,1,00060,India
901019,2023-07-08,506,monitor,3249,8000,4751,1,00124,India
901019,2023-07-08,503,mixer,1349,3249,1900,1,00124,India
901019,2023-07-08,502,iphone 15 pro max,100000,135000,35000,1,00124,India
108056,2023-07-08,502,iphone 15 pro max,100000,135000,35000,1,00057,India
108056,2023-07-08,507,washing machine,6990,16490,9500,1,00057,India
108056,2023-07-08,505,oven,18490,24000,5510,1,00057,India
887234,2023-07-08,502,iphone 15 pro max,100000,135000,35000,1,00067,India
887234,2023-07-08,503,mixer,1349,3249,1900,1,00067,India
887234,2023-07-08,507,washing machine,6990,16490,9500,1,00067,India
495290,2023-07-08,506,monitor,3249,8000,4751,1,00391,India
495290,2023-07-08,503,mixer,1349,3249,1900,1,00391,India
495290,2023-07-08,504,iron,449,879,430,1,00391,India
702725,2023-07-08,501,iphone 15,60000,80000,20000,1,00406,India
702725,2023-07-08,503,mixer,1349,3249,1900,1,00406,India
759169,2023-07-08,506,monitor,3249,8000,4751,1,00342,India
759169,2023-07-08,502,iphone 15 pro max,100000,135000,35000,1,00342,India
111825,2023-07-08,505,oven,18490,24000,5510,1,00423,India
111825,2023-07-08,504,iron,449,879,430,1,00423,India
111825,2023-07-08,506,monitor,3249,8000,4751,1,00423,India
503213,2023-07-08,503,mixer,1349,3249,1900,1,00191,India
503213,2023-07-08,506,monitor,3249,8000,4751,1,00191,India
503213,2023-07-08,507,washing machine,6990,16490,9500,1,00191,India
662871,2023-07-08,505,oven,18490,24000,5510,1,00058,India
662871,2023-07-08,504,iron,449,879,430,1,00058,India
953986,2023-07-08,507,washing machine,6990,16490,9500,1,00251,India
953986,2023-07-08,506,monitor,3249,8000,4751,1,00251,India
953986,2023-07-08,505,oven,18490,24000,5510,1,00251,India
284294,2023-07-08,504,iron,449,879,430,1,00059,India
659591,2023-07-08,503,mixer,1349,3249,1900,1,00270,India
653218,2023-07-08,505,oven,18490,24000,5510,1,00168,India
920561,2023-07-08,507,washing machine,6990,16490,9500,1,00424,India
920561,2023-07-08,501,iphone 15,60000,80000,20000,1,00424,India
266824,2023-07-08,505,oven,18490,24000,5510,1,00421,India
695451,2023-07-08,507,washing machine,6990,16490,9500,1,00121,India
695451,2023-07-08,503,mixer,1349,3249,1900,1,00121,India
695451,2023-07-08,501,iphone 15,60000,80000,20000,1,00121,India
695451,2023-07-08,506,monitor,3249,8000,4751,1,00121,India
695451,2023-07-08,502,iphone 15 pro max,100000,135000,35000,1,00121,India
305916,2023-07-08,504,iron,449,879,430,1,00258,India
819391,2023-07-08,504,iron,449,879,430,1,00210,India
819391,2023-07-08,506,monitor,3249,8000,4751,1,00210,India
819391,2023-07-08,501,iphone 15,60000,80000,20000,1,00210,India
819391,2023-07-08,502,iphone 15 pro max,100000,135000,35000,1,00210,India
674530,2023-07-08,502,iphone 15 pro max,100000,135000,35000,1,00236,India
674530,2023-07-08,506,monitor,3249,8000,4751,1,00236,India
674530,2023-07-08,501,iphone 15,60000,80000,20000,1,00236,India
674530,2023-07-08,504,iron,449,879,430,1,00236,India
465517,2023-07-08,504,iron,449,879,430,1,00006,India
465517,2023-07-08,505,oven,18490,24000,5510,1,00006,India
465517,2023-07-08,502,iphone 15 pro max,100000,135000,35000,1,00006,India
735206,2023-07-08,506,monitor,3249,8000,4751,1,00442,India
735206,2023-07-08,504,iron,449,879,430,1,00442,India
795409,2023-07-08,503,mixer,1349,3249,1900,1,00404,India
761874,2023-07-08,501,iphone 15,60000,80000,20000,1,00281,India
294671,2023-07-08,506,monitor,3249,8000,4751,1,00294,India
294671,2023-07-08,503,mixer,1349,3249,1900,1,00294,India
294671,2023-07-08,502,iphone 15 pro max,100000,135000,35000,1,00294,India
506584,2023-07-08,502,iphone 15 pro max,100000,135000,35000,1,00345,India
506584,2023-07-08,506,monitor,3249,8000,4751,1,00345,India
977961,2023-07-08,501,iphone 15,60000,80000,20000,1,00374,India
977961,2023-07-08,504,iron,449,879,430,1,00374,India
995428,2023-07-08,502,iphone 15 pro max,100000,135000,35000,1,00132,India
995428,2023-07-08,506,monitor,3249,8000,4751,1,00132,India
995428,2023-07-08,503,mixer,1349,3249,1900,1,00132,India
203880,2023-07-08,502,iphone 15 pro max,100000,135000,35000,1,00464,India
203880,2023-07-08,506,monitor,3249,8000,4751,1,00464,India
873049,2023-07-08,503,mixer,1349,3249,1900,1,00401,India
873049,2023-07-08,504,iron,449,879,430,1,00401,India
873049,2023-07-08,506,monitor,3249,8000,4751,1,00401,India
657006,2023-07-08,502,iphone 15 pro max,100000,135000,35000,1,00009,India
657006,2023-07-08,506,monitor,3249,8000,4751,1,00009,India
657006,2023-07-08,503,mixer,1349,3249,1900,1,00009,India
854085,2023-07-08,507,washing machine,6990,16490,9500,1,00066,India
245826,2023-07-08,501,iphone 15,60000,80000,20000,1,00193,India
245826,2023-07-08,506,monitor,3249,8000,4751,1,00193,India
245826,2023-07-08,505,oven,18490,24000,5510,1,00193,India
571599,2023-07-08,504,iron,449,879,430,1,00339,India
571599,2023-07-08,502,iphone 15 pro max,100000,135000,35000,1,00339,India
571599,2023-07-08,507,washing machine,6990,16490,9500,1,00339,India
248540,2023-07-08,501,iphone 15,60000,80000,20000,1,00206,India
797745,2023-07-08,506,monitor,3249,8000,4751,1,00452,India
797745,2023-07-08,504,iron,449,879,430,1,00452,India
797745,2023-07-08,505,oven,18490,24000,5510,1,00452,India
797745,2023-07-08,507,washing machine,6990,16490,9500,1,00452,India
797745,2023-07-08,502,iphone 15 pro max,100000,135000,35000,1,00452,India
193168,2023-07-08,504,iron,449,879,430,1,00348,India
193168,2023-07-08,501,iphone 15,60000,80000,20000,1,00348,India
193168,2023-07-08,502,iphone 15 pro max,100000,135000,35000,1,00348,India
823376,2023-07-08,503,mixer,1349,3249,1900,1,00347,India
823376,2023-07-08,504,iron,449,879,430,1,00347,India
823376,2023-07-08,507,washing machine,6990,16490,9500,1,00347,India
380031,2023-07-08,503,mixer,1349,3249,1900,1,00295,India
724017,2023-07-08,501,iphone 15,60000,80000,20000,1,00237,India
724017,2023-07-08,506,monitor,3249,8000,4751,1,00237,India
724017,2023-07-08,504,iron,449,879,430,1,00237,India
724017,2023-07-08,505,oven,18490,24000,5510,1,00237,India
724017,2023-07-08,503,mixer,1349,3249,1900,1,00237,India
612479,2023-07-08,502,iphone 15 pro max,100000,135000,35000,1,00346,India
547534,2023-07-08,501,iphone 15,60000,80000,20000,1,00233,India
547534,2023-07-08,507,washing machine,6990,16490,9500,1,00233,India
547534,2023-07-08,504,iron,449,879,430,1,00233,India
573536,2023-07-08,506,monitor,3249,8000,4751,1,00062,India
573536,2023-07-08,503,mixer,1349,3249,1900,1,00062,India
612102,2023-07-08,501,iphone 15,60000,80000,20000,1,00474,India
612102,2023-07-08,503,mixer,1349,3249,1900,1,00474,India
612102,2023-07-08,507,washing machine,6990,16490,9500,1,00474,India
919873,2023-07-08,504,iron,449,879,430,1,00393,India
919873,2023-07-08,501,iphone 15,60000,80000,20000,1,00393,India
858493,2023-07-08,502,iphone 15 pro max,100000,135000,35000,1,00109,India
858493,2023-07-08,503,mixer,1349,3249,1900,1,00109,India
858493,2023-07-08,504,iron,449,879,430,1,00109,India
883384,2023-07-08,501,iphone 15,60000,80000,20000,1,00372,India
883384,2023-07-08,505,oven,18490,24000,5510,1,00372,India
883384,2023-07-08,503,mixer,1349,3249,1900,1,00372,India
883384,2023-07-08,507,washing machine,6990,16490,9500,1,00372,India
679661,2023-07-08,501,iphone 15,60000,80000,20000,1,00157,India
904412,2023-07-08,503,mixer,1349,3249,1900,1,00287,India
739101,2023-07-08,507,washing machine,6990,16490,9500,1,00495,India
739101,2023-07-08,503,mixer,1349,3249,1900,1,00495,India
739101,2023-07-08,506,monitor,3249,8000,4751,1,00495,India
353495,2023-07-08,501,iphone 15,60000,80000,20000,1,00104,India
353495,2023-07-08,506,monitor,3249,8000,4751,1,00104,India
353495,2023-07-08,507,washing machine,6990,16490,9500,1,00104,India
353495,2023-07-08,503,mixer,1349,3249,1900,1,00104,India
783245,2023-07-08,505,oven,18490,24000,5510,1,00442,India
783245,2023-07-08,507,washing machine,6990,16490,9500,1,00442,India
783245,2023-07-08,506,monitor,3249,8000,4751,1,00442,India
604216,2023-07-08,503,mixer,1349,3249,1900,1,00147,India
604216,2023-07-08,505,oven,18490,24000,5510,1,00147,India
604216,2023-07-08,504,iron,449,879,430,1,00147,India
604216,2023-07-08,506,monitor,3249,8000,4751,1,00147,India
875971,2023-07-08,507,washing machine,6990,16490,9500,1,00179,India
875971,2023-07-08,504,iron,449,879,430,1,00179,India
875971,2023-07-08,505,oven,18490,24000,5510,1,00179,India
359223,2023-07-08,506,monitor,3249,8000,4751,1,00385,India
881955,2023-07-08,506,monitor,3249,8000,4751,1,00229,India
881955,2023-07-08,505,oven,18490,24000,5510,1,00229,India
554914,2023-07-08,507,washing machine,6990,16490,9500,1,00418,India
554914,2023-07-08,506,monitor,3249,8000,4751,1,00418,India
554914,2023-07-08,502,iphone 15 pro max,100000,135000,35000,1,00418,India
801146,2023-07-09,503,mixer,1349,3249,1900,1,00266,India
989865,2023-07-09,507,washing machine,6990,16490,9500,1,00419,India
989865,2023-07-09,503,mixer,1349,3249,1900,1,00419,India
380009,2023-07-09,507,washing machine,6990,16490,9500,1,00013,India
380009,2023-07-09,504,iron,449,879,430,1,00013,India
315430,2023-07-09,506,monitor,3249,8000,4751,1,00110,India
315430,2023-07-09,504,iron,449,879,430,1,00110,India
315430,2023-07-09,503,mixer,1349,3249,1900,1,00110,India
556793,2023-07-09,504,iron,449,879,430,1,00121,India
556793,2023-07-09,502,iphone 15 pro max,100000,135000,35000,1,00121,India
556793,2023-07-09,506,monitor,3249,8000,4751,1,00121,India
556793,2023-07-09,503,mixer,1349,3249,1900,1,00121,India
864027,2023-07-09,503,mixer,1349,3249,1900,1,00251,India
864027,2023-07-09,502,iphone 15 pro max,100000,135000,35000,1,00251,India
864027,2023-07-09,505,oven,18490,24000,5510,1,00251,India
562069,2023-07-09,504,iron,449,879,430,1,00490,India
562069,2023-07-09,502,iphone 15 pro max,100000,135000,35000,1,00490,India
196464,2023-07-09,502,iphone 15 pro max,100000,135000,35000,1,00385,India
196464,2023-07-09,507,washing machine,6990,16490,9500,1,00385,India
196464,2023-07-09,503,mixer,1349,3249,1900,1,00385,India
196464,2023-07-09,505,oven,18490,24000,5510,1,00385,India
575009,2023-07-09,502,iphone 15 pro max,100000,135000,35000,1,00415,India
575009,2023-07-09,503,mixer,1349,3249,1900,1,00415,India
908058,2023-07-09,502,iphone 15 pro max,100000,135000,35000,1,00286,India
292627,2023-07-09,504,iron,449,879,430,1,00498,India
292627,2023-07-09,505,oven,18490,24000,5510,1,00498,India
292627,2023-07-09,501,iphone 15,60000,80000,20000,1,00498,India
292627,2023-07-09,507,washing machine,6990,16490,9500,1,00498,India
153364,2023-07-09,501,iphone 15,60000,80000,20000,1,00234,India
153364,2023-07-09,505,oven,18490,24000,5510,1,00234,India
524647,2023-07-09,505,oven,18490,24000,5510,1,00439,India
524647,2023-07-09,506,monitor,3249,8000,4751,1,00439,India
524647,2023-07-09,502,iphone 15 pro max,100000,135000,35000,1,00439,India
524647,2023-07-09,503,mixer,1349,3249,1900,1,00439,India
737602,2023-07-09,504,iron,449,879,430,1,00048,India
441680,2023-07-09,504,iron,449,879,430,1,00270,India
938589,2023-07-09,506,monitor,3249,8000,4751,1,00157,India
938589,2023-07-09,501,iphone 15,60000,80000,20000,1,00157,India
938589,2023-07-09,503,mixer,1349,3249,1900,1,00157,India
938589,2023-07-09,507,washing machine,6990,16490,9500,1,00157,India
938589,2023-07-09,505,oven,18490,24000,5510,1,00157,India
178524,2023-07-09,501,iphone 15,60000,80000,20000,1,00034,India
178524,2023-07-09,503,mixer,1349,3249,1900,1,00034,India
178524,2023-07-09,507,washing machine,6990,16490,9500,1,00034,India
400501,2023-07-09,503,mixer,1349,3249,1900,1,00386,India
400501,2023-07-09,507,washing machine,6990,16490,9500,1,00386,India
846389,2023-07-09,507,washing machine,6990,16490,9500,1,00032,India
460187,2023-07-09,504,iron,449,879,430,1,00247,India
177668,2023-07-09,503,mixer,1349,3249,1900,1,00457,India
177668,2023-07-09,506,monitor,3249,8000,4751,1,00457,India
177668,2023-07-09,505,oven,18490,24000,5510,1,00457,India
638173,2023-07-09,502,iphone 15 pro max,100000,135000,35000,1,00375,India
638173,2023-07-09,503,mixer,1349,3249,1900,1,00375,India
638173,2023-07-09,504,iron,449,879,430,1,00375,India
638173,2023-07-09,506,monitor,3249,8000,4751,1,00375,India
956053,2023-07-09,502,iphone 15 pro max,100000,135000,35000,1,00428,India
956053,2023-07-09,503,mixer,1349,3249,1900,1,00428,India
956053,2023-07-09,505,oven,18490,24000,5510,1,00428,India
418191,2023-07-09,505,oven,18490,24000,5510,1,00105,India
189600,2023-07-09,507,washing machine,6990,16490,9500,1,00015,India
189600,2023-07-09,506,monitor,3249,8000,4751,1,00015,India
189600,2023-07-09,502,iphone 15 pro max,100000,135000,35000,1,00015,India
189600,2023-07-09,503,mixer,1349,3249,1900,1,00015,India
779786,2023-07-09,502,iphone 15 pro max,100000,135000,35000,1,00228,India
779786,2023-07-09,505,oven,18490,24000,5510,1,00228,India
779786,2023-07-09,506,monitor,3249,8000,4751,1,00228,India
779786,2023-07-09,503,mixer,1349,3249,1900,1,00228,India
718867,2023-07-09,501,iphone 15,60000,80000,20000,1,00393,India
718867,2023-07-09,506,monitor,3249,8000,4751,1,00393,India
718867,2023-07-09,504,iron,449,879,430,1,00393,India
718867,2023-07-09,502,iphone 15 pro max,100000,135000,35000,1,00393,India
243931,2023-07-09,505,oven,18490,24000,5510,1,00054,India
243931,2023-07-09,506,monitor,3249,8000,4751,1,00054,India
243931,2023-07-09,501,iphone 15,60000,80000,20000,1,00054,India
568080,2023-07-09,503,mixer,1349,3249,1900,1,00377,India
568080,2023-07-09,506,monitor,3249,8000,4751,1,00377,India
568080,2023-07-09,501,iphone 15,60000,80000,20000,1,00377,India
272920,2023-07-09,501,iphone 15,60000,80000,20000,1,00168,India
272920,2023-07-09,507,washing machine,6990,16490,9500,1,00168,India
731338,2023-07-09,503,mixer,1349,3249,1900,1,00324,India
731338,2023-07-09,507,washing machine,6990,16490,9500,1,00324,India
601112,2023-07-09,506,monitor,3249,8000,4751,1,00071,India
601112,2023-07-09,505,oven,18490,24000,5510,1,00071,India
153323,2023-07-09,502,iphone 15 pro max,100000,135000,35000,1,00434,India
153323,2023-07-09,504,iron,449,879,430,1,00434,India
343955,2023-07-09,501,iphone 15,60000,80000,20000,1,00174,India
343955,2023-07-09,502,iphone 15 pro max,100000,135000,35000,1,00174,India
343955,2023-07-09,506,monitor,3249,8000,4751,1,00174,India
243444,2023-07-09,506,monitor,3249,8000,4751,1,00315,India
243444,2023-07-09,501,iphone 15,60000,80000,20000,1,00315,India
392355,2023-07-09,504,iron,449,879,430,1,00406,India
392355,2023-07-09,507,washing machine,6990,16490,9500,1,00406,India
392355,2023-07-09,501,iphone 15,60000,80000,20000,1,00406,India
947873,2023-07-09,507,washing machine,6990,16490,9500,1,00391,India
433962,2023-07-09,505,oven,18490,24000,5510,1,00306,India
433962,2023-07-09,504,iron,449,879,430,1,00306,India
433962,2023-07-09,506,monitor,3249,8000,4751,1,00306,India
433962,2023-07-09,502,iphone 15 pro max,100000,135000,35000,1,00306,India
629780,2023-07-09,507,washing machine,6990,16490,9500,1,00388,India
629780,2023-07-09,501,iphone 15,60000,80000,20000,1,00388,India
488058,2023-07-09,506,monitor,3249,8000,4751,1,00200,India
315969,2023-07-09,507,washing machine,6990,16490,9500,1,00216,India
315969,2023-07-09,505,oven,18490,24000,5510,1,00216,India
315969,2023-07-09,504,iron,449,879,430,1,00216,India
109037,2023-07-09,506,monitor,3249,8000,4751,1,00320,India
263161,2023-07-09,504,iron,449,879,430,1,00239,India
995761,2023-07-09,506,monitor,3249,8000,4751,1,00368,India
207223,2023-07-09,502,iphone 15 pro max,100000,135000,35000,1,00060,India
207223,2023-07-09,505,oven,18490,24000,5510,1,00060,India
207223,2023-07-09,504,iron,449,879,430,1,00060,India
821469,2023-07-09,501,iphone 15,60000,80000,20000,1,00440,India
565025,2023-07-09,505,oven,18490,24000,5510,1,00247,India
882795,2023-07-09,503,mixer,1349,3249,1900,1,00114,India
882795,2023-07-09,504,iron,449,879,430,1,00114,India
916688,2023-07-09,507,washing machine,6990,16490,9500,1,00061,India
916688,2023-07-09,502,iphone 15 pro max,100000,135000,35000,1,00061,India
916688,2023-07-09,503,mixer,1349,3249,1900,1,00061,India
557900,2023-07-09,502,iphone 15 pro max,100000,135000,35000,1,00084,India
993104,2023-07-09,506,monitor,3249,8000,4751,1,00233,India
993104,2023-07-09,505,oven,18490,24000,5510,1,00233,India
993104,2023-07-09,507,washing machine,6990,16490,9500,1,00233,India
224517,2023-07-09,502,iphone 15 pro max,100000,135000,35000,1,00125,India
224517,2023-07-09,506,monitor,3249,8000,4751,1,00125,India
224517,2023-07-09,505,oven,18490,24000,5510,1,00125,India
816670,2023-07-10,501,iphone 15,60000,80000,20000,1,00215,India
816670,2023-07-10,502,iphone 15 pro max,100000,135000,35000,1,00215,India
816670,2023-07-10,504,iron,449,879,430,1,00215,India
104119,2023-07-10,502,iphone 15 pro max,100000,135000,35000,1,00477,India
104119,2023-07-10,504,iron,449,879,430,1,00477,India
104119,2023-07-10,505,oven,18490,24000,5510,1,00477,India
104119,2023-07-10,506,monitor,3249,8000,4751,1,00477,India
104119,2023-07-10,501,iphone 15,60000,80000,20000,1,00477,India
849460,2023-07-10,502,iphone 15 pro max,100000,135000,35000,1,00026,India
849460,2023-07-10,504,iron,449,879,430,1,00026,India
849460,2023-07-10,506,monitor,3249,8000,4751,1,00026,India
525970,2023-07-10,503,mixer,1349,3249,1900,1,00176,India
400199,2023-07-10,501,iphone 15,60000,80000,20000,1,00437,India
400199,2023-07-10,503,mixer,1349,3249,1900,1,00437,India
345775,2023-07-10,503,mixer,1349,3249,1900,1,00454,India
345775,2023-07-10,506,monitor,3249,8000,4751,1,00454,India
345775,2023-07-10,505,oven,18490,24000,5510,1,00454,India
455000,2023-07-10,501,iphone 15,60000,80000,20000,1,00393,India
455000,2023-07-10,507,washing machine,6990,16490,9500,1,00393,India
455000,2023-07-10,505,oven,18490,24000,5510,1,00393,India
529923,2023-07-10,506,monitor,3249,8000,4751,1,00153,India
269369,2023-07-10,501,iphone 15,60000,80000,20000,1,00233,India
586351,2023-07-10,507,washing machine,6990,16490,9500,1,00274,India
808479,2023-07-10,504,iron,449,879,430,1,00444,India
808479,2023-07-10,502,iphone 15 pro max,100000,135000,35000,1,00444,India
808479,2023-07-10,503,mixer,1349,3249,1900,1,00444,India
808479,2023-07-10,505,oven,18490,24000,5510,1,00444,India
585070,2023-07-10,502,iphone 15 pro max,100000,135000,35000,1,00158,India
585070,2023-07-10,505,oven,18490,24000,5510,1,00158,India
585070,2023-07-10,506,monitor,3249,8000,4751,1,00158,India
585070,2023-07-10,501,iphone 15,60000,80000,20000,1,00158,India
448045,2023-07-10,506,monitor,3249,8000,4751,1,00238,India
448045,2023-07-10,501,iphone 15,60000,80000,20000,1,00238,India
448045,2023-07-10,507,washing machine,6990,16490,9500,1,00238,India
536087,2023-07-10,506,monitor,3249,8000,4751,1,00415,India
486187,2023-07-10,504,iron,449,879,430,1,00337,India
486187,2023-07-10,502,iphone 15 pro max,100000,135000,35000,1,00337,India
486187,2023-07-10,506,monitor,3249,8000,4751,1,00337,India
486187,2023-07-10,503,mixer,1349,3249,1900,1,00337,India
756736,2023-07-10,503,mixer,1349,3249,1900,1,00241,India
756736,2023-07-10,507,washing machine,6990,16490,9500,1,00241,India
756736,2023-07-10,501,iphone 15,60000,80000,20000,1,00241,India
465378,2023-07-10,503,mixer,1349,3249,1900,1,00231,India
465378,2023-07-10,502,iphone 15 pro max,100000,135000,35000,1,00231,India
445757,2023-07-10,505,oven,18490,24000,5510,1,00393,India
445757,2023-07-10,506,monitor,3249,8000,4751,1,00393,India
445757,2023-07-10,503,mixer,1349,3249,1900,1,00393,India
445757,2023-07-10,501,iphone 15,60000,80000,20000,1,00393,India
664709,2023-07-10,506,monitor,3249,8000,4751,1,00467,India
664709,2023-07-10,503,mixer,1349,3249,1900,1,00467,India
633041,2023-07-10,504,iron,449,879,430,1,00144,India
633041,2023-07-10,506,monitor,3249,8000,4751,1,00144,India
633041,2023-07-10,503,mixer,1349,3249,1900,1,00144,India
140360,2023-07-10,506,monitor,3249,8000,4751,1,00141,India
623429,2023-07-10,502,iphone 15 pro max,100000,135000,35000,1,00300,India
623429,2023-07-10,507,washing machine,6990,16490,9500,1,00300,India
623429,2023-07-10,501,iphone 15,60000,80000,20000,1,00300,India
356332,2023-07-10,506,monitor,3249,8000,4751,1,00369,India
883002,2023-07-10,503,mixer,1349,3249,1900,1,00347,India
883002,2023-07-10,505,oven,18490,24000,5510,1,00347,India
487923,2023-07-10,505,oven,18490,24000,5510,1,00368,India
487923,2023-07-10,504,iron,449,879,430,1,00368,India
487923,2023-07-10,502,iphone 15 pro max,100000,135000,35000,1,00368,India
487923,2023-07-10,503,mixer,1349,3249,1900,1,00368,India
944572,2023-07-10,506,monitor,3249,8000,4751,1,00443,India
944572,2023-07-10,505,oven,18490,24000,5510,1,00443,India
100793,2023-07-10,502,iphone 15 pro max,100000,135000,35000,1,00158,India
100793,2023-07-10,503,mixer,1349,3249,1900,1,00158,India
100793,2023-07-10,501,iphone 15,60000,80000,20000,1,00158,India
653783,2023-07-10,504,iron,449,879,430,1,00222,India
653783,2023-07-10,502,iphone 15 pro max,100000,135000,35000,1,00222,India
653783,2023-07-10,507,washing machine,6990,16490,9500,1,00222,India
192891,2023-07-10,502,iphone 15 pro max,100000,135000,35000,1,00290,India
192891,2023-07-10,506,monitor,3249,8000,4751,1,00290,India
192891,2023-07-10,505,oven,18490,24000,5510,1,00290,India
195343,2023-07-10,507,washing machine,6990,16490,9500,1,00393,India
195343,2023-07-10,504,iron,449,879,430,1,00393,India
195343,2023-07-10,501,iphone 15,60000,80000,20000,1,00393,India
505686,2023-07-10,507,washing machine,6990,16490,9500,1,00469,India
110744,2023-07-10,506,monitor,3249,8000,4751,1,00380,India
744037,2023-07-10,501,iphone 15,60000,80000,20000,1,00152,India
311041,2023-07-10,503,mixer,1349,3249,1900,1,00137,India
311041,2023-07-10,502,iphone 15 pro max,100000,135000,35000,1,00137,India
229736,2023-07-10,505,oven,18490,24000,5510,1,00085,India
229736,2023-07-10,502,iphone 15 pro max,100000,135000,35000,1,00085,India
276604,2023-07-10,501,iphone 15,60000,80000,20000,1,00053,India
652749,2023-07-10,505,oven,18490,24000,5510,1,00338,India
652749,2023-07-10,501,iphone 15,60000,80000,20000,1,00338,India
130728,2023-07-10,503,mixer,1349,3249,1900,1,00229,India
130728,2023-07-10,506,monitor,3249,8000,4751,1,00229,India
130728,2023-07-10,501,iphone 15,60000,80000,20000,1,00229,India
130728,2023-07-10,505,oven,18490,24000,5510,1,00229,India
277382,2023-07-10,502,iphone 15 pro max,100000,135000,35000,1,00055,India
277382,2023-07-10,501,iphone 15,60000,80000,20000,1,00055,India
388065,2023-07-10,501,iphone 15,60000,80000,20000,1,00111,India
388065,2023-07-10,504,iron,449,879,430,1,00111,India
388065,2023-07-10,506,monitor,3249,8000,4751,1,00111,India
157136,2023-07-10,504,iron,449,879,430,1,00418,India
157136,2023-07-10,507,washing machine,6990,16490,9500,1,00418,India
157136,2023-07-10,503,mixer,1349,3249,1900,1,00418,India
736802,2023-07-10,506,monitor,3249,8000,4751,1,00133,India
736802,2023-07-10,501,iphone 15,60000,80000,20000,1,00133,India
736802,2023-07-10,505,oven,18490,24000,5510,1,00133,India
736802,2023-07-10,502,iphone 15 pro max,100000,135000,35000,1,00133,India
543625,2023-07-10,503,mixer,1349,3249,1900,1,00302,India
764270,2023-07-10,507,washing machine,6990,16490,9500,1,00307,India
692596,2023-07-10,502,iphone 15 pro max,100000,135000,35000,1,00080,India
692596,2023-07-10,507,washing machine,6990,16490,9500,1,00080,India
692596,2023-07-10,505,oven,18490,24000,5510,1,00080,India
475213,2023-07-10,502,iphone 15 pro max,100000,135000,35000,1,00238,India
475213,2023-07-10,507,washing machine,6990,16490,9500,1,00238,India
475213,2023-07-10,504,iron,449,879,430,1,00238,India
834915,2023-07-10,503,mixer,1349,3249,1900,1,00243,India
567937,2023-07-10,502,iphone 15 pro max,100000,135000,35000,1,00245,India
511190,2023-07-10,503,mixer,1349,3249,1900,1,00083,India
511190,2023-07-10,501,iphone 15,60000,80000,20000,1,00083,India
511190,2023-07-10,502,iphone 15 pro max,100000,135000,35000,1,00083,India
511190,2023-07-10,507,washing machine,6990,16490,9500,1,00083,India
364420,2023-07-10,501,iphone 15,60000,80000,20000,1,00330,India
364420,2023-07-10,504,iron,449,879,430,1,00330,India
455173,2023-07-10,506,monitor,3249,8000,4751,1,00346,India
455173,2023-07-10,501,iphone 15,60000,80000,20000,1,00346,India
455173,2023-07-10,505,oven,18490,24000,5510,1,00346,India
895219,2023-07-10,507,washing machine,6990,16490,9500,1,00221,India
895219,2023-07-10,501,iphone 15,60000,80000,20000,1,00221,India
124203,2023-07-10,506,monitor,3249,8000,4751,1,00183,India
124203,2023-07-10,505,oven,18490,24000,5510,1,00183,India
124203,2023-07-10,502,iphone 15 pro max,100000,135000,35000,1,00183,India
124203,2023-07-10,501,iphone 15,60000,80000,20000,1,00183,India
591773,2023-07-10,503,mixer,1349,3249,1900,1,00162,India
591773,2023-07-10,506,monitor,3249,8000,4751,1,00162,India
591773,2023-07-10,504,iron,449,879,430,1,00162,India
258300,2023-07-10,504,iron,449,879,430,1,00366,India
258300,2023-07-10,507,washing machine,6990,16490,9500,1,00366,India
549075,2023-07-10,504,iron,449,879,430,1,00019,India
549075,2023-07-10,501,iphone 15,60000,80000,20000,1,00019,India
835423,2023-07-10,501,iphone 15,60000,80000,20000,1,00201,India
835423,2023-07-10,506,monitor,3249,8000,4751,1,00201,India
835423,2023-07-10,507,washing machine,6990,16490,9500,1,00201,India
835423,2023-07-10,502,iphone 15 pro max,100000,135000,35000,1,00201,India
174962,2023-07-10,506,monitor,3249,8000,4751,1,00304,India
174962,2023-07-10,501,iphone 15,60000,80000,20000,1,00304,India
174962,2023-07-10,504,iron,449,879,430,1,00304,India
112780,2023-07-10,503,mixer,1349,3249,1900,1,00462,India
112780,2023-07-10,502,iphone 15 pro max,100000,135000,35000,1,00462,India
985032,2023-07-10,506,monitor,3249,8000,4751,1,00339,India
985032,2023-07-10,501,iphone 15,60000,80000,20000,1,00339,India
985032,2023-07-10,504,iron,449,879,430,1,00339,India
985032,2023-07-10,503,mixer,1349,3249,1900,1,00339,India
451170,2023-07-10,506,monitor,3249,8000,4751,1,00276,India
451170,2023-07-10,503,mixer,1349,3249,1900,1,00276,India
451170,2023-07-10,502,iphone 15 pro max,100000,135000,35000,1,00276,India
451170,2023-07-10,505,oven,18490,24000,5510,1,00276,India
451170,2023-07-10,501,iphone 15,60000,80000,20000,1,00276,India
221296,2023-07-10,507,washing machine,6990,16490,9500,1,00031,India
919765,2023-07-10,506,monitor,3249,8000,4751,1,00129,India
919765,2023-07-10,504,iron,449,879,430,1,00129,India
919765,2023-07-10,503,mixer,1349,3249,1900,1,00129,India
919765,2023-07-10,502,iphone 15 pro max,100000,135000,35000,1,00129,India
461734,2023-07-10,504,iron,449,879,430,1,00441,India
461734,2023-07-10,501,iphone 15,60000,80000,20000,1,00441,India
891045,2023-07-10,506,monitor,3249,8000,4751,1,00337,India
891045,2023-07-10,505,oven,18490,24000,5510,1,00337,India
891045,2023-07-10,504,iron,449,879,430,1,00337,India
741080,2023-07-10,504,iron,449,879,430,1,00248,India
741080,2023-07-10,502,iphone 15 pro max,100000,135000,35000,1,00248,India
741080,2023-07-10,506,monitor,3249,8000,4751,1,00248,India
741080,2023-07-10,501,iphone 15,60000,80000,20000,1,00248,India
741080,2023-07-10,505,oven,18490,24000,5510,1,00248,India
482515,2023-07-10,507,washing machine,6990,16490,9500,1,00279,India
748485,2023-07-10,503,mixer,1349,3249,1900,1,00485,India
748485,2023-07-10,501,iphone 15,60000,80000,20000,1,00485,India
748485,2023-07-10,507,washing machine,6990,16490,9500,1,00485,India
948989,2023-07-10,503,mixer,1349,3249,1900,1,00125,India
264193,2023-07-10,505,oven,18490,24000,5510,1,00006,India
735715,2023-07-10,504,iron,449,879,430,1,00340,India
324915,2023-07-10,506,monitor,3249,8000,4751,1,00247,India
324915,2023-07-10,501,iphone 15,60000,80000,20000,1,00247,India
324915,2023-07-10,505,oven,18490,24000,5510,1,00247,India
160111,2023-07-10,507,washing machine,6990,16490,9500,1,00492,India
416754,2023-07-10,501,iphone 15,60000,80000,20000,1,00209,India
416754,2023-07-10,505,oven,18490,24000,5510,1,00209,India
133953,2023-07-11,503,mixer,1349,3249,1900,1,00227,India
133953,2023-07-11,505,oven,18490,24000,5510,1,00227,India
133953,2023-07-11,502,iphone 15 pro max,100000,135000,35000,1,00227,India
133953,2023-07-11,504,iron,449,879,430,1,00227,India
864907,2023-07-11,503,mixer,1349,3249,1900,1,00465,India
864907,2023-07-11,504,iron,449,879,430,1,00465,India
864907,2023-07-11,502,iphone 15 pro max,100000,135000,35000,1,00465,India
864907,2023-07-11,501,iphone 15,60000,80000,20000,1,00465,India
284600,2023-07-11,501,iphone 15,60000,80000,20000,1,00383,India
284600,2023-07-11,505,oven,18490,24000,5510,1,00383,India
284600,2023-07-11,507,washing machine,6990,16490,9500,1,00383,India
594527,2023-07-11,504,iron,449,879,430,1,00070,India
594527,2023-07-11,502,iphone 15 pro max,100000,135000,35000,1,00070,India
594527,2023-07-11,501,iphone 15,60000,80000,20000,1,00070,India
594527,2023-07-11,505,oven,18490,24000,5510,1,00070,India
965712,2023-07-11,502,iphone 15 pro max,100000,135000,35000,1,00256,India
965712,2023-07-11,506,monitor,3249,8000,4751,1,00256,India
965712,2023-07-11,507,washing machine,6990,16490,9500,1,00256,India
749647,2023-07-11,507,washing machine,6990,16490,9500,1,00459,India
453314,2023-07-11,507,washing machine,6990,16490,9500,1,00300,India
453314,2023-07-11,503,mixer,1349,3249,1900,1,00300,India
790318,2023-07-11,505,oven,18490,24000,5510,1,00361,India
375940,2023-07-11,507,washing machine,6990,16490,9500,1,00179,India
922022,2023-07-11,507,washing machine,6990,16490,9500,1,00306,India
922022,2023-07-11,502,iphone 15 pro max,100000,135000,35000,1,00306,India
779992,2023-07-11,504,iron,449,879,430,1,00157,India
779992,2023-07-11,502,iphone 15 pro max,100000,135000,35000,1,00157,India
779992,2023-07-11,505,oven,18490,24000,5510,1,00157,India
779992,2023-07-11,506,monitor,3249,8000,4751,1,00157,India
595795,2023-07-11,502,iphone 15 pro max,100000,135000,35000,1,00024,India
595795,2023-07-11,507,washing machine,6990,16490,9500,1,00024,India
323765,2023-07-11,503,mixer,1349,3249,1900,1,00046,India
323765,2023-07-11,506,monitor,3249,8000,4751,1,00046,India
323765,2023-07-11,505,oven,18490,24000,5510,1,00046,India
813237,2023-07-11,506,monitor,3249,8000,4751,1,00179,India
813237,2023-07-11,502,iphone 15 pro max,100000,135000,35000,1,00179,India
675779,2023-07-11,502,iphone 15 pro max,100000,135000,35000,1,00325,India
645720,2023-07-11,507,washing machine,6990,16490,9500,1,00141,India
645720,2023-07-11,504,iron,449,879,430,1,00141,India
418863,2023-07-11,504,iron,449,879,430,1,00089,India
418863,2023-07-11,507,washing machine,6990,16490,9500,1,00089,India
678946,2023-07-11,504,iron,449,879,430,1,00378,India
678946,2023-07-11,506,monitor,3249,8000,4751,1,00378,India
678946,2023-07-11,507,washing machine,6990,16490,9500,1,00378,India
678946,2023-07-11,505,oven,18490,24000,5510,1,00378,India
886388,2023-07-11,507,washing machine,6990,16490,9500,1,00461,India
886388,2023-07-11,504,iron,449,879,430,1,00461,India
810947,2023-07-11,505,oven,18490,24000,5510,1,00104,India
810947,2023-07-11,504,iron,449,879,430,1,00104,India
114555,2023-07-11,506,monitor,3249,8000,4751,1,00252,India
443712,2023-07-11,502,iphone 15 pro max,100000,135000,35000,1,00433,India
443712,2023-07-11,504,iron,449,879,430,1,00433,India
443712,2023-07-11,503,mixer,1349,3249,1900,1,00433,India
443712,2023-07-11,505,oven,18490,24000,5510,1,00433,India
720397,2023-07-11,506,monitor,3249,8000,4751,1,00004,India
720397,2023-07-11,502,iphone 15 pro max,100000,135000,35000,1,00004,India
550364,2023-07-11,505,oven,18490,24000,5510,1,00461,India
949191,2023-07-11,505,oven,18490,24000,5510,1,00488,India
949191,2023-07-11,501,iphone 15,60000,80000,20000,1,00488,India
854362,2023-07-11,503,mixer,1349,3249,1900,1,00317,India
854362,2023-07-11,504,iron,449,879,430,1,00317,India
854362,2023-07-11,507,washing machine,6990,16490,9500,1,00317,India
854362,2023-07-11,502,iphone 15 pro max,100000,135000,35000,1,00317,India
263769,2023-07-11,502,iphone 15 pro max,100000,135000,35000,1,00034,India
263769,2023-07-11,503,mixer,1349,3249,1900,1,00034,India
263769,2023-07-11,507,washing machine,6990,16490,9500,1,00034,India
263769,2023-07-11,506,monitor,3249,8000,4751,1,00034,India
263769,2023-07-11,505,oven,18490,24000,5510,1,00034,India
294503,2023-07-11,504,iron,449,879,430,1,00405,India
857652,2023-07-11,504,iron,449,879,430,1,00093,India
857652,2023-07-11,505,oven,18490,24000,5510,1,00093,India
857652,2023-07-11,502,iphone 15 pro max,100000,135000,35000,1,00093,India
926997,2023-07-11,504,iron,449,879,430,1,00445,India
926997,2023-07-11,505,oven,18490,24000,5510,1,00445,India
926997,2023-07-11,501,iphone 15,60000,80000,20000,1,00445,India
943627,2023-07-11,505,oven,18490,24000,5510,1,00189,India
526686,2023-07-11,506,monitor,3249,8000,4751,1,00388,India
526686,2023-07-11,502,iphone 15 pro max,100000,135000,35000,1,00388,India
526686,2023-07-11,505,oven,18490,24000,5510,1,00388,India
526686,2023-07-11,503,mixer,1349,3249,1900,1,00388,India
224671,2023-07-11,505,oven,18490,24000,5510,1,00190,India
224671,2023-07-11,502,iphone 15 pro max,100000,135000,35000,1,00190,India
224671,2023-07-11,506,monitor,3249,8000,4751,1,00190,India
224671,2023-07-11,501,iphone 15,60000,80000,20000,1,00190,India
224671,2023-07-11,507,washing machine,6990,16490,9500,1,00190,India
367678,2023-07-11,505,oven,18490,24000,5510,1,00187,India
367678,2023-07-11,503,mixer,1349,3249,1900,1,00187,India
520457,2023-07-11,505,oven,18490,24000,5510,1,00101,India
520457,2023-07-11,503,mixer,1349,3249,1900,1,00101,India
520457,2023-07-11,502,iphone 15 pro max,100000,135000,35000,1,00101,India
520457,2023-07-11,504,iron,449,879,430,1,00101,India
520457,2023-07-11,506,monitor,3249,8000,4751,1,00101,India
189276,2023-07-11,506,monitor,3249,8000,4751,1,00013,India
189276,2023-07-11,501,iphone 15,60000,80000,20000,1,00013,India
189276,2023-07-11,505,oven,18490,24000,5510,1,00013,India
679691,2023-07-11,502,iphone 15 pro max,100000,135000,35000,1,00018,India
679691,2023-07-11,501,iphone 15,60000,80000,20000,1,00018,India
679691,2023-07-11,505,oven,18490,24000,5510,1,00018,India
679691,2023-07-11,503,mixer,1349,3249,1900,1,00018,India
679691,2023-07-11,506,monitor,3249,8000,4751,1,00018,India
445181,2023-07-11,501,iphone 15,60000,80000,20000,1,00081,India
445181,2023-07-11,504,iron,449,879,430,1,00081,India
445181,2023-07-11,503,mixer,1349,3249,1900,1,00081,India
388994,2023-07-11,507,washing machine,6990,16490,9500,1,00140,India
341747,2023-07-11,501,iphone 15,60000,80000,20000,1,00083,India
341747,2023-07-11,502,iphone 15 pro max,100000,135000,35000,1,00083,India
341747,2023-07-11,507,washing machine,6990,16490,9500,1,00083,India
341747,2023-07-11,503,mixer,1349,3249,1900,1,00083,India
248877,2023-07-11,507,washing machine,6990,16490,9500,1,00310,India
248877,2023-07-11,502,iphone 15 pro max,100000,135000,35000,1,00310,India
408439,2023-07-11,505,oven,18490,24000,5510,1,00319,India
408439,2023-07-11,501,iphone 15,60000,80000,20000,1,00319,India
408439,2023-07-11,504,iron,449,879,430,1,00319,India
408439,2023-07-11,507,washing machine,6990,16490,9500,1,00319,India
752208,2023-07-11,506,monitor,3249,8000,4751,1,00484,India
974686,2023-07-11,504,iron,449,879,430,1,00370,India
974686,2023-07-11,501,iphone 15,60000,80000,20000,1,00370,India
771291,2023-07-11,505,oven,18490,24000,5510,1,00334,India
771291,2023-07-11,503,mixer,1349,3249,1900,1,00334,India
192480,2023-07-11,504,iron,449,879,430,1,00214,India
192480,2023-07-11,506,monitor,3249,8000,4751,1,00214,India
192480,2023-07-11,505,oven,18490,24000,5510,1,00214,India
783621,2023-07-11,507,washing machine,6990,16490,9500,1,00448,India
783621,2023-07-11,506,monitor,3249,8000,4751,1,00448,India
783621,2023-07-11,505,oven,18490,24000,5510,1,00448,India
783621,2023-07-11,503,mixer,1349,3249,1900,1,00448,India
783621,2023-07-11,501,iphone 15,60000,80000,20000,1,00448,India
797193,2023-07-11,502,iphone 15 pro max,100000,135000,35000,1,00380,India
797193,2023-07-11,506,monitor,3249,8000,4751,1,00380,India
966506,2023-07-11,502,iphone 15 pro max,100000,135000,35000,1,00191,India
966506,2023-07-11,504,iron,449,879,430,1,00191,India
329487,2023-07-11,505,oven,18490,24000,5510,1,00015,India
329487,2023-07-11,501,iphone 15,60000,80000,20000,1,00015,India
329487,2023-07-11,506,monitor,3249,8000,4751,1,00015,India
828110,2023-07-11,505,oven,18490,24000,5510,1,00300,India
828110,2023-07-11,504,iron,449,879,430,1,00300,India
828110,2023-07-11,503,mixer,1349,3249,1900,1,00300,India
787824,2023-07-11,501,iphone 15,60000,80000,20000,1,00022,India
787824,2023-07-11,507,washing machine,6990,16490,9500,1,00022,India
787824,2023-07-11,504,iron,449,879,430,1,00022,India
443144,2023-07-11,505,oven,18490,24000,5510,1,00008,India
443144,2023-07-11,506,monitor,3249,8000,4751,1,00008,India
443144,2023-07-11,507,washing machine,6990,16490,9500,1,00008,India
592307,2023-07-11,507,washing machine,6990,16490,9500,1,00208,India
249595,2023-07-11,504,iron,449,879,430,1,00397,India
212455,2023-07-11,501,iphone 15,60000,80000,20000,1,00268,India
212455,2023-07-11,502,iphone 15 pro max,100000,135000,35000,1,00268,India
212455,2023-07-11,504,iron,449,879,430,1,00268,India
212455,2023-07-11,503,mixer,1349,3249,1900,1,00268,India
537413,2023-07-11,506,monitor,3249,8000,4751,1,00348,India
463394,2023-07-11,507,washing machine,6990,16490,9500,1,00297,India
463394,2023-07-11,503,mixer,1349,3249,1900,1,00297,India
463394,2023-07-11,501,iphone 15,60000,80000,20000,1,00297,India
463394,2023-07-11,506,monitor,3249,8000,4751,1,00297,India
743292,2023-07-11,501,iphone 15,60000,80000,20000,1,00016,India
438472,2023-07-11,505,oven,18490,24000,5510,1,00146,India
732578,2023-07-11,507,washing machine,6990,16490,9500,1,00150,India
732578,2023-07-11,506,monitor,3249,8000,4751,1,00150,India
355550,2023-07-11,503,mixer,1349,3249,1900,1,00469,India
868169,2023-07-11,506,monitor,3249,8000,4751,1,00134,India
868169,2023-07-11,503,mixer,1349,3249,1900,1,00134,India
868169,2023-07-11,501,iphone 15,60000,80000,20000,1,00134,India
868169,2023-07-11,507,washing machine,6990,16490,9500,1,00134,India
713778,2023-07-11,502,iphone 15 pro max,100000,135000,35000,1,00009,India
713778,2023-07-11,503,mixer,1349,3249,1900,1,00009,India
515048,2023-07-11,505,oven,18490,24000,5510,1,00091,India
515048,2023-07-11,502,iphone 15 pro max,100000,135000,35000,1,00091,India
515048,2023-07-11,506,monitor,3249,8000,4751,1,00091,India
459158,2023-07-11,506,monitor,3249,8000,4751,1,00099,India
459158,2023-07-11,505,oven,18490,24000,5510,1,00099,India
459158,2023-07-11,507,washing machine,6990,16490,9500,1,00099,India
857765,2023-07-11,507,washing machine,6990,16490,9500,1,00287,India
671098,2023-07-11,505,oven,18490,24000,5510,1,00137,India
671098,2023-07-11,506,monitor,3249,8000,4751,1,00137,India
135570,2023-07-11,507,washing machine,6990,16490,9500,1,00396,India
135570,2023-07-11,503,mixer,1349,3249,1900,1,00396,India
135570,2023-07-11,505,oven,18490,24000,5510,1,00396,India
135570,2023-07-11,501,iphone 15,60000,80000,20000,1,00396,India
441040,2023-07-11,504,iron,449,879,430,1,00076,India
160410,2023-07-11,506,monitor,3249,8000,4751,1,00143,India
160410,2023-07-11,505,oven,18490,24000,5510,1,00143,India
678664,2023-07-11,504,iron,449,879,430,1,00280,India
377883,2023-07-11,504,iron,449,879,430,1,00099,India
737001,2023-07-11,505,oven,18490,24000,5510,1,00472,India
737001,2023-07-11,507,washing machine,6990,16490,9500,1,00472,India
737001,2023-07-11,506,monitor,3249,8000,4751,1,00472,India
737001,2023-07-11,504,iron,449,879,430,1,00472,India
408430,2023-07-11,504,iron,449,879,430,1,00369,India
408430,2023-07-11,503,mixer,1349,3249,1900,1,00369,India
444493,2023-07-11,503,mixer,1349,3249,1900,1,00349,India
388208,2023-07-11,505,oven,18490,24000,5510,1,00460,India
388208,2023-07-11,507,washing machine,6990,16490,9500,1,00460,India
388208,2023-07-11,501,iphone 15,60000,80000,20000,1,00460,India
945914,2023-07-11,503,mixer,1349,3249,1900,1,00076,India
945914,2023-07-11,505,oven,18490,24000,5510,1,00076,India
945914,2023-07-11,507,washing machine,6990,16490,9500,1,00076,India
665882,2023-07-11,503,mixer,1349,3249,1900,1,00388,India
665882,2023-07-11,506,monitor,3249,8000,4751,1,00388,India
665882,2023-07-11,502,iphone 15 pro max,100000,135000,35000,1,00388,India
665882,2023-07-11,504,iron,449,879,430,1,00388,India
665882,2023-07-11,505,oven,18490,24000,5510,1,00388,India
108416,2023-07-11,506,monitor,3249,8000,4751,1,00150,India
108416,2023-07-11,502,iphone 15 pro max,100000,135000,35000,1,00150,India
108416,2023-07-11,503,mixer,1349,3249,1900,1,00150,India
108416,2023-07-11,505,oven,18490,24000,5510,1,00150,India
417343,2023-07-11,501,iphone 15,60000,80000,20000,1,00247,India
417343,2023-07-11,504,iron,449,879,430,1,00247,India
417343,2023-07-11,506,monitor,3249,8000,4751,1,00247,India
579825,2023-07-11,504,iron,449,879,430,1,00456,India
579825,2023-07-11,507,washing machine,6990,16490,9500,1,00456,India
771489,2023-07-11,501,iphone 15,60000,80000,20000,1,00439,India
972986,2023-07-11,506,monitor,3249,8000,4751,1,00199,India
972986,2023-07-11,501,iphone 15,60000,80000,20000,1,00199,India
972986,2023-07-11,502,iphone 15 pro max,100000,135000,35000,1,00199,India
972986,2023-07-11,507,washing machine,6990,16490,9500,1,00199,India
376489,2023-07-11,502,iphone 15 pro max,100000,135000,35000,1,00433,India
376489,2023-07-11,503,mixer,1349,3249,1900,1,00433,India
376489,2023-07-11,507,washing machine,6990,16490,9500,1,00433,India
149153,2023-07-11,502,iphone 15 pro max,100000,135000,35000,1,00008,India
149153,2023-07-11,501,iphone 15,60000,80000,20000,1,00008,India
177498,2023-07-11,505,oven,18490,24000,5510,1,00200,India
177498,2023-07-11,504,iron,449,879,430,1,00200,India
889001,2023-07-11,501,iphone 15,60000,80000,20000,1,00169,India
889001,2023-07-11,506,monitor,3249,8000,4751,1,00169,India
941456,2023-07-11,504,iron,449,879,430,1,00040,India
941456,2023-07-11,506,monitor,3249,8000,4751,1,00040,India
941456,2023-07-11,503,mixer,1349,3249,1900,1,00040,India
941456,2023-07-11,501,iphone 15,60000,80000,20000,1,00040,India
729873,2023-07-11,507,washing machine,6990,16490,9500,1,00274,India
729873,2023-07-11,503,mixer,1349,3249,1900,1,00274,India
729873,2023-07-11,504,iron,449,879,430,1,00274,India
850534,2023-07-11,507,washing machine,6990,16490,9500,1,00134,India
850534,2023-07-11,506,monitor,3249,8000,4751,1,00134,India
580213,2023-07-11,503,mixer,1349,3249,1900,1,00150,India
617816,2023-07-12,503,mixer,1349,3249,1900,1,00137,India
617816,2023-07-12,504,iron,449,879,430,1,00137,India
617816,2023-07-12,506,monitor,3249,8000,4751,1,00137,India
142479,2023-07-12,504,iron,449,879,430,1,00029,India
142479,2023-07-12,501,iphone 15,60000,80000,20000,1,00029,India
142479,2023-07-12,505,oven,18490,24000,5510,1,00029,India
908547,2023-07-12,502,iphone 15 pro max,100000,135000,35000,1,00167,India
908547,2023-07-12,506,monitor,3249,8000,4751,1,00167,India
908547,2023-07-12,507,washing machine,6990,16490,9500,1,00167,India
908547,2023-07-12,504,iron,449,879,430,1,00167,India
654174,2023-07-12,504,iron,449,879,430,1,00135,India
111915,2023-07-12,503,mixer,1349,3249,1900,1,00500,India
467078,2023-07-12,505,oven,18490,24000,5510,1,00066,India
225254,2023-07-12,501,iphone 15,60000,80000,20000,1,00278,India
853285,2023-07-12,504,iron,449,879,430,1,00231,India
724092,2023-07-12,505,oven,18490,24000,5510,1,00490,India
724092,2023-07-12,506,monitor,3249,8000,4751,1,00490,India
861292,2023-07-12,504,iron,449,879,430,1,00360,India
756203,2023-07-12,502,iphone 15 pro max,100000,135000,35000,1,00048,India
756203,2023-07-12,501,iphone 15,60000,80000,20000,1,00048,India
756203,2023-07-12,503,mixer,1349,3249,1900,1,00048,India
668802,2023-07-12,501,iphone 15,60000,80000,20000,1,00031,India
668802,2023-07-12,507,washing machine,6990,16490,9500,1,00031,India
668802,2023-07-12,506,monitor,3249,8000,4751,1,00031,India
713535,2023-07-12,505,oven,18490,24000,5510,1,00174,India
713535,2023-07-12,507,washing machine,6990,16490,9500,1,00174,India
713535,2023-07-12,506,monitor,3249,8000,4751,1,00174,India
713535,2023-07-12,504,iron,449,879,430,1,00174,India
884597,2023-07-12,503,mixer,1349,3249,1900,1,00003,India
884597,2023-07-12,505,oven,18490,24000,5510,1,00003,India
106919,2023-07-12,507,washing machine,6990,16490,9500,1,00405,India
106919,2023-07-12,501,iphone 15,60000,80000,20000,1,00405,India
106919,2023-07-12,504,iron,449,879,430,1,00405,India
233029,2023-07-12,507,washing machine,6990,16490,9500,1,00318,India
233029,2023-07-12,506,monitor,3249,8000,4751,1,00318,India
138005,2023-07-12,503,mixer,1349,3249,1900,1,00359,India
138005,2023-07-12,506,monitor,3249,8000,4751,1,00359,India
138005,2023-07-12,501,iphone 15,60000,80000,20000,1,00359,India
319331,2023-07-12,501,iphone 15,60000,80000,20000,1,00483,India
319331,2023-07-12,502,iphone 15 pro max,100000,135000,35000,1,00483,India
477902,2023-07-12,503,mixer,1349,3249,1900,1,00345,India
477902,2023-07-12,505,oven,18490,24000,5510,1,00345,India
477902,2023-07-12,502,iphone 15 pro max,100000,135000,35000,1,00345,India
417952,2023-07-12,507,washing machine,6990,16490,9500,1,00078,India
417952,2023-07-12,506,monitor,3249,8000,4751,1,00078,India
417952,2023-07-12,503,mixer,1349,3249,1900,1,00078,India
609249,2023-07-12,503,mixer,1349,3249,1900,1,00024,India
609249,2023-07-12,505,oven,18490,24000,5510,1,00024,India
609249,2023-07-12,504,iron,449,879,430,1,00024,India
823086,2023-07-12,506,monitor,3249,8000,4751,1,00279,India
164634,2023-07-12,506,monitor,3249,8000,4751,1,00359,India
164634,2023-07-12,501,iphone 15,60000,80000,20000,1,00359,India
164634,2023-07-12,505,oven,18490,24000,5510,1,00359,India
278589,2023-07-12,504,iron,449,879,430,1,00133,India
278589,2023-07-12,501,iphone 15,60000,80000,20000,1,00133,India
316297,2023-07-12,506,monitor,3249,8000,4751,1,00241,India
316297,2023-07-12,507,washing machine,6990,16490,9500,1,00241,India
305376,2023-07-12,501,iphone 15,60000,80000,20000,1,00336,India
305376,2023-07-12,502,iphone 15 pro max,100000,135000,35000,1,00336,India
305376,2023-07-12,503,mixer,1349,3249,1900,1,00336,India
469059,2023-07-12,503,mixer,1349,3249,1900,1,00213,India
771526,2023-07-12,502,iphone 15 pro max,100000,135000,35000,1,00080,India
932608,2023-07-12,507,washing machine,6990,16490,9500,1,00011,India
786336,2023-07-12,505,oven,18490,24000,5510,1,00321,India
786336,2023-07-12,506,monitor,3249,8000,4751,1,00321,India
786336,2023-07-12,501,iphone 15,60000,80000,20000,1,00321,India
786336,2023-07-12,507,washing machine,6990,16490,9500,1,00321,India
503113,2023-07-12,504,iron,449,879,430,1,00135,India
682212,2023-07-12,507,washing machine,6990,16490,9500,1,00268,India
682212,2023-07-12,502,iphone 15 pro max,100000,135000,35000,1,00268,India
682212,2023-07-12,503,mixer,1349,3249,1900,1,00268,India
877377,2023-07-12,504,iron,449,879,430,1,00312,India
877377,2023-07-12,503,mixer,1349,3249,1900,1,00312,India
448300,2023-07-12,506,monitor,3249,8000,4751,1,00161,India
730952,2023-07-12,502,iphone 15 pro max,100000,135000,35000,1,00080,India
730952,2023-07-12,503,mixer,1349,3249,1900,1,00080,India
730952,2023-07-12,505,oven,18490,24000,5510,1,00080,India
730952,2023-07-12,504,iron,449,879,430,1,00080,India
730952,2023-07-12,507,washing machine,6990,16490,9500,1,00080,India
484927,2023-07-12,502,iphone 15 pro max,100000,135000,35000,1,00193,India
484927,2023-07-12,504,iron,449,879,430,1,00193,India
167987,2023-07-12,501,iphone 15,60000,80000,20000,1,00336,India
167987,2023-07-12,504,iron,449,879,430,1,00336,India
293315,2023-07-12,502,iphone 15 pro max,100000,135000,35000,1,00306,India
293315,2023-07-12,503,mixer,1349,3249,1900,1,00306,India
293315,2023-07-12,504,iron,449,879,430,1,00306,India
293315,2023-07-12,507,washing machine,6990,16490,9500,1,00306,India
816317,2023-07-12,501,iphone 15,60000,80000,20000,1,00280,India
816317,2023-07-12,507,washing machine,6990,16490,9500,1,00280,India
995154,2023-07-12,506,monitor,3249,8000,4751,1,00172,India
995154,2023-07-12,502,iphone 15 pro max,100000,135000,35000,1,00172,India
995154,2023-07-12,504,iron,449,879,430,1,00172,India
995154,2023-07-12,507,washing machine,6990,16490,9500,1,00172,India
908940,2023-07-12,507,washing machine,6990,16490,9500,1,00130,India
629619,2023-07-12,505,oven,18490,24000,5510,1,00153,India
629619,2023-07-12,503,mixer,1349,3249,1900,1,00153,India
188099,2023-07-12,501,iphone 15,60000,80000,20000,1,00125,India
188099,2023-07-12,506,monitor,3249,8000,4751,1,00125,India
188099,2023-07-12,502,iphone 15 pro max,100000,135000,35000,1,00125,India
679127,2023-07-12,506,monitor,3249,8000,4751,1,00141,India
679127,2023-07-12,502,iphone 15 pro max,100000,135000,35000,1,00141,India
679127,2023-07-12,504,iron,449,879,430,1,00141,India
314635,2023-07-12,506,monitor,3249,8000,4751,1,00148,India
314635,2023-07-12,501,iphone 15,60000,80000,20000,1,00148,India
294146,2023-07-12,503,mixer,1349,3249,1900,1,00063,India
294146,2023-07-12,506,monitor,3249,8000,4751,1,00063,India
294146,2023-07-12,504,iron,449,879,430,1,00063,India
294146,2023-07-12,505,oven,18490,24000,5510,1,00063,India
632944,2023-07-12,505,oven,18490,24000,5510,1,00481,India
632944,2023-07-12,504,iron,449,879,430,1,00481,India
632944,2023-07-12,507,washing machine,6990,16490,9500,1,00481,India
632944,2023-07-12,503,mixer,1349,3249,1900,1,00481,India
556213,2023-07-12,503,mixer,1349,3249,1900,1,00054,India
556213,2023-07-12,501,iphone 15,60000,80000,20000,1,00054,India
744420,2023-07-12,507,washing machine,6990,16490,9500,1,00267,India
744420,2023-07-12,506,monitor,3249,8000,4751,1,00267,India
744420,2023-07-12,504,iron,449,879,430,1,00267,India
240703,2023-07-12,502,iphone 15 pro max,100000,135000,35000,1,00141,India
438643,2023-07-12,502,iphone 15 pro max,100000,135000,35000,1,00176,India
438643,2023-07-12,507,washing machine,6990,16490,9500,1,00176,India
438643,2023-07-12,505,oven,18490,24000,5510,1,00176,India
438643,2023-07-12,506,monitor,3249,8000,4751,1,00176,India
325942,2023-07-12,502,iphone 15 pro max,100000,135000,35000,1,00342,India
734720,2023-07-12,502,iphone 15 pro max,100000,135000,35000,1,00211,India
734720,2023-07-12,503,mixer,1349,3249,1900,1,00211,India
734720,2023-07-12,505,oven,18490,24000,5510,1,00211,India
734720,2023-07-12,506,monitor,3249,8000,4751,1,00211,India
900648,2023-07-12,502,iphone 15 pro max,100000,135000,35000,1,00375,India
900648,2023-07-12,507,washing machine,6990,16490,9500,1,00375,India
900648,2023-07-12,505,oven,18490,24000,5510,1,00375,India
900648,2023-07-12,503,mixer,1349,3249,1900,1,00375,India
587466,2023-07-12,507,washing machine,6990,16490,9500,1,00458,India
877261,2023-07-12,504,iron,449,879,430,1,00138,India
529020,2023-07-12,501,iphone 15,60000,80000,20000,1,00290,India
529020,2023-07-12,506,monitor,3249,8000,4751,1,00290,India
551094,2023-07-12,506,monitor,3249,8000,4751,1,00105,India
551094,2023-07-12,507,washing machine,6990,16490,9500,1,00105,India
551094,2023-07-12,503,mixer,1349,3249,1900,1,00105,India
238062,2023-07-12,506,monitor,3249,8000,4751,1,00438,India
238062,2023-07-12,503,mixer,1349,3249,1900,1,00438,India
238062,2023-07-12,505,oven,18490,24000,5510,1,00438,India
730430,2023-07-12,504,iron,449,879,430,1,00500,India
730430,2023-07-12,501,iphone 15,60000,80000,20000,1,00500,India
250390,2023-07-12,505,oven,18490,24000,5510,1,00343,India
250390,2023-07-12,503,mixer,1349,3249,1900,1,00343,India
250390,2023-07-12,502,iphone 15 pro max,100000,135000,35000,1,00343,India
942954,2023-07-12,504,iron,449,879,430,1,00078,India
942954,2023-07-12,507,washing machine,6990,16490,9500,1,00078,India
678182,2023-07-12,504,iron,449,879,430,1,00099,India
678182,2023-07-12,501,iphone 15,60000,80000,20000,1,00099,India
543013,2023-07-12,501,iphone 15,60000,80000,20000,1,00443,India
923559,2023-07-12,506,monitor,3249,8000,4751,1,00200,India
923559,2023-07-12,504,iron,449,879,430,1,00200,India
709534,2023-07-12,503,mixer,1349,3249,1900,1,00104,India
273854,2023-07-12,506,monitor,3249,8000,4751,1,00204,India
273854,2023-07-12,503,mixer,1349,3249,1900,1,00204,India
273854,2023-07-12,502,iphone 15 pro max,100000,135000,35000,1,00204,India
627266,2023-07-12,501,iphone 15,60000,80000,20000,1,00188,India
627266,2023-07-12,503,mixer,1349,3249,1900,1,00188,India
871722,2023-07-12,501,iphone 15,60000,80000,20000,1,00247,India
287141,2023-07-13,501,iphone 15,60000,80000,20000,1,00011,India
155623,2023-07-13,502,iphone 15 pro max,100000,135000,35000,1,00256,India
155623,2023-07-13,507,washing machine,6990,16490,9500,1,00256,India
155623,2023-07-13,505,oven,18490,24000,5510,1,00256,India
155623,2023-07-13,503,mixer,1349,3249,1900,1,00256,India
674334,2023-07-13,506,monitor,3249,8000,4751,1,00150,India
674334,2023-07-13,504,iron,449,879,430,1,00150,India
674334,2023-07-13,507,washing machine,6990,16490,9500,1,00150,India
691411,2023-07-13,505,oven,18490,24000,5510,1,00491,India
691411,2023-07-13,503,mixer,1349,3249,1900,1,00491,India
691411,2023-07-13,504,iron,449,879,430,1,00491,India
608214,2023-07-13,503,mixer,1349,3249,1900,1,00448,India
608214,2023-07-13,507,washing machine,6990,16490,9500,1,00448,India
608214,2023-07-13,501,iphone 15,60000,80000,20000,1,00448,India
603578,2023-07-13,506,monitor,3249,8000,4751,1,00421,India
603578,2023-07-13,502,iphone 15 pro max,100000,135000,35000,1,00421,India
603578,2023-07-13,503,mixer,1349,3249,1900,1,00421,India
603578,2023-07-13,501,iphone 15,60000,80000,20000,1,00421,India
835311,2023-07-13,506,monitor,3249,8000,4751,1,00248,India
835311,2023-07-13,501,iphone 15,60000,80000,20000,1,00248,India
654233,2023-07-13,506,monitor,3249,8000,4751,1,00212,India
654233,2023-07-13,504,iron,449,879,430,1,00212,India
654233,2023-07-13,507,washing machine,6990,16490,9500,1,00212,India
721789,2023-07-13,505,oven,18490,24000,5510,1,00457,India
721789,2023-07-13,502,iphone 15 pro max,100000,135000,35000,1,00457,India
721789,2023-07-13,507,washing machine,6990,16490,9500,1,00457,India
721789,2023-07-13,504,iron,449,879,430,1,00457,India
387208,2023-07-13,505,oven,18490,24000,5510,1,00346,India
387208,2023-07-13,501,iphone 15,60000,80000,20000,1,00346,India
695627,2023-07-13,507,washing machine,6990,16490,9500,1,00073,India
664426,2023-07-13,505,oven,18490,24000,5510,1,00137,India
985510,2023-07-13,505,oven,18490,24000,5510,1,00451,India
985510,2023-07-13,507,washing machine,6990,16490,9500,1,00451,India
985510,2023-07-13,501,iphone 15,60000,80000,20000,1,00451,India
812075,2023-07-13,506,monitor,3249,8000,4751,1,00284,India
812075,2023-07-13,501,iphone 15,60000,80000,20000,1,00284,India
723376,2023-07-13,501,iphone 15,60000,80000,20000,1,00407,India
365789,2023-07-13,507,washing machine,6990,16490,9500,1,00456,India
253535,2023-07-13,504,iron,449,879,430,1,00499,India
991861,2023-07-13,502,iphone 15 pro max,100000,135000,35000,1,00222,India
991861,2023-07-13,506,monitor,3249,8000,4751,1,00222,India
991861,2023-07-13,507,washing machine,6990,16490,9500,1,00222,India
162037,2023-07-13,504,iron,449,879,430,1,00138,India
162037,2023-07-13,503,mixer,1349,3249,1900,1,00138,India
162037,2023-07-13,501,iphone 15,60000,80000,20000,1,00138,India
999483,2023-07-13,505,oven,18490,24000,5510,1,00290,India
999483,2023-07-13,503,mixer,1349,3249,1900,1,00290,India
999483,2023-07-13,506,monitor,3249,8000,4751,1,00290,India
220084,2023-07-13,504,iron,449,879,430,1,00167,India
220084,2023-07-13,505,oven,18490,24000,5510,1,00167,India
524702,2023-07-13,505,oven,18490,24000,5510,1,00205,India
524702,2023-07-13,501,iphone 15,60000,80000,20000,1,00205,India
172362,2023-07-13,503,mixer,1349,3249,1900,1,00258,India
172362,2023-07-13,504,iron,449,879,430,1,00258,India
172362,2023-07-13,506,monitor,3249,8000,4751,1,00258,India
416286,2023-07-13,506,monitor,3249,8000,4751,1,00184,India
416286,2023-07-13,505,oven,18490,24000,5510,1,00184,India
416286,2023-07-13,502,iphone 15 pro max,100000,135000,35000,1,00184,India
416286,2023-07-13,507,washing machine,6990,16490,9500,1,00184,India
832924,2023-07-13,502,iphone 15 pro max,100000,135000,35000,1,00195,India
832924,2023-07-13,507,washing machine,6990,16490,9500,1,00195,India
832924,2023-07-13,504,iron,449,879,430,1,00195,India
832924,2023-07-13,503,mixer,1349,3249,1900,1,00195,India
225426,2023-07-13,503,mixer,1349,3249,1900,1,00277,India
265169,2023-07-13,505,oven,18490,24000,5510,1,00183,India
265169,2023-07-13,506,monitor,3249,8000,4751,1,00183,India
265169,2023-07-13,504,iron,449,879,430,1,00183,India
924425,2023-07-13,502,iphone 15 pro max,100000,135000,35000,1,00431,India
924425,2023-07-13,504,iron,449,879,430,1,00431,India
821606,2023-07-13,501,iphone 15,60000,80000,20000,1,00043,India
821606,2023-07-13,505,oven,18490,24000,5510,1,00043,India
821606,2023-07-13,506,monitor,3249,8000,4751,1,00043,India
523520,2023-07-13,501,iphone 15,60000,80000,20000,1,00068,India
523520,2023-07-13,507,washing machine,6990,16490,9500,1,00068,India
239972,2023-07-13,507,washing machine,6990,16490,9500,1,00496,India
239972,2023-07-13,505,oven,18490,24000,5510,1,00496,India
817437,2023-07-13,505,oven,18490,24000,5510,1,00096,India
817437,2023-07-13,506,monitor,3249,8000,4751,1,00096,India
991266,2023-07-13,507,washing machine,6990,16490,9500,1,00376,India
991266,2023-07-13,505,oven,18490,24000,5510,1,00376,India
791354,2023-07-13,503,mixer,1349,3249,1900,1,00257,India
791354,2023-07-13,501,iphone 15,60000,80000,20000,1,00257,India
861942,2023-07-13,504,iron,449,879,430,1,00112,India
861942,2023-07-13,505,oven,18490,24000,5510,1,00112,India
861942,2023-07-13,503,mixer,1349,3249,1900,1,00112,India
658956,2023-07-13,505,oven,18490,24000,5510,1,00007,India
658956,2023-07-13,504,iron,449,879,430,1,00007,India
658956,2023-07-13,507,washing machine,6990,16490,9500,1,00007,India
658956,2023-07-13,506,monitor,3249,8000,4751,1,00007,India
658956,2023-07-13,502,iphone 15 pro max,100000,135000,35000,1,00007,India
235740,2023-07-13,505,oven,18490,24000,5510,1,00409,India
592084,2023-07-13,504,iron,449,879,430,1,00006,India
592084,2023-07-13,505,oven,18490,24000,5510,1,00006,India
361179,2023-07-13,504,iron,449,879,430,1,00100,India
361179,2023-07-13,506,monitor,3249,8000,4751,1,00100,India
361179,2023-07-13,502,iphone 15 pro max,100000,135000,35000,1,00100,India
361179,2023-07-13,501,iphone 15,60000,80000,20000,1,00100,India
516824,2023-07-13,503,mixer,1349,3249,1900,1,00497,India
516824,2023-07-13,505,oven,18490,24000,5510,1,00497,India
252553,2023-07-13,502,iphone 15 pro max,100000,135000,35000,1,00109,India
252553,2023-07-13,504,iron,449,879,430,1,00109,India
252553,2023-07-13,503,mixer,1349,3249,1900,1,00109,India
252553,2023-07-13,505,oven,18490,24000,5510,1,00109,India
317173,2023-07-13,503,mixer,1349,3249,1900,1,00446,India
472740,2023-07-13,507,washing machine,6990,16490,9500,1,00254,India
472740,2023-07-13,504,iron,449,879,430,1,00254,India
472740,2023-07-13,505,oven,18490,24000,5510,1,00254,India
472740,2023-07-13,503,mixer,1349,3249,1900,1,00254,India
870035,2023-07-13,502,iphone 15 pro max,100000,135000,35000,1,00097,India
870035,2023-07-13,505,oven,18490,24000,5510,1,00097,India
870035,2023-07-13,501,iphone 15,60000,80000,20000,1,00097,India
870035,2023-07-13,506,monitor,3249,8000,4751,1,00097,India
879311,2023-07-13,507,washing machine,6990,16490,9500,1,00250,India
879311,2023-07-13,504,iron,449,879,430,1,00250,India
411052,2023-07-13,503,mixer,1349,3249,1900,1,00197,India
411052,2023-07-13,504,iron,449,879,430,1,00197,India
411052,2023-07-13,507,washing machine,6990,16490,9500,1,00197,India
411052,2023-07-13,506,monitor,3249,8000,4751,1,00197,India
459501,2023-07-13,505,oven,18490,24000,5510,1,00364,India
459501,2023-07-13,506,monitor,3249,8000,4751,1,00364,India
966277,2023-07-13,507,washing machine,6990,16490,9500,1,00254,India
966277,2023-07-13,502,iphone 15 pro max,100000,135000,35000,1,00254,India
966277,2023-07-13,501,iphone 15,60000,80000,20000,1,00254,India
966277,2023-07-13,504,iron,449,879,430,1,00254,India
910003,2023-07-13,505,oven,18490,24000,5510,1,00072,India
608471,2023-07-13,505,oven,18490,24000,5510,1,00099,India
608471,2023-07-13,504,iron,449,879,430,1,00099,India
541290,2023-07-13,502,iphone 15 pro max,100000,135000,35000,1,00418,India
541290,2023-07-13,503,mixer,1349,3249,1900,1,00418,India
541290,2023-07-13,505,oven,18490,24000,5510,1,00418,India
594040,2023-07-13,501,iphone 15,60000,80000,20000,1,00403,India
594040,2023-07-13,502,iphone 15 pro max,100000,135000,35000,1,00403,India
639391,2023-07-13,505,oven,18490,24000,5510,1,00151,India
639391,2023-07-13,502,iphone 15 pro max,100000,135000,35000,1,00151,India
639391,2023-07-13,506,monitor,3249,8000,4751,1,00151,India
721743,2023-07-13,503,mixer,1349,3249,1900,1,00368,India
347247,2023-07-14,501,iphone 15,60000,80000,20000,1,00311,India
347247,2023-07-14,507,washing machine,6990,16490,9500,1,00311,India
347247,2023-07-14,506,monitor,3249,8000,4751,1,00311,India
808786,2023-07-14,505,oven,18490,24000,5510,1,00208,India
808786,2023-07-14,506,monitor,3249,8000,4751,1,00208,India
654955,2023-07-14,501,iphone 15,60000,80000,20000,1,00129,India
654955,2023-07-14,503,mixer,1349,3249,1900,1,00129,India
266021,2023-07-14,501,iphone 15,60000,80000,20000,1,00134,India
266021,2023-07-14,502,iphone 15 pro max,100000,135000,35000,1,00134,India
266021,2023-07-14,506,monitor,3249,8000,4751,1,00134,India
266021,2023-07-14,504,iron,449,879,430,1,00134,India
798367,2023-07-14,507,washing machine,6990,16490,9500,1,00475,India
798367,2023-07-14,506,monitor,3249,8000,4751,1,00475,India
798367,2023-07-14,503,mixer,1349,3249,1900,1,00475,India
446910,2023-07-14,503,mixer,1349,3249,1900,1,00287,India
446910,2023-07-14,507,washing machine,6990,16490,9500,1,00287,India
167504,2023-07-14,503,mixer,1349,3249,1900,1,00120,India
167504,2023-07-14,507,washing machine,6990,16490,9500,1,00120,India
666890,2023-07-14,507,washing machine,6990,16490,9500,1,00393,India
666890,2023-07-14,503,mixer,1349,3249,1900,1,00393,India
666890,2023-07-14,504,iron,449,879,430,1,00393,India
445166,2023-07-14,505,oven,18490,24000,5510,1,00378,India
445166,2023-07-14,502,iphone 15 pro max,100000,135000,35000,1,00378,India
445166,2023-07-14,504,iron,449,879,430,1,00378,India
937497,2023-07-14,504,iron,449,879,430,1,00045,India
937497,2023-07-14,505,oven,18490,24000,5510,1,00045,India
937497,2023-07-14,506,monitor,3249,8000,4751,1,00045,India
951950,2023-07-14,504,iron,449,879,430,1,00244,India
284787,2023-07-14,506,monitor,3249,8000,4751,1,00224,India
284787,2023-07-14,504,iron,449,879,430,1,00224,India
284787,2023-07-14,505,oven,18490,24000,5510,1,00224,India
802274,2023-07-14,504,iron,449,879,430,1,00399,India
570988,2023-07-14,504,iron,449,879,430,1,00372,India
570988,2023-07-14,502,iphone 15 pro max,100000,135000,35000,1,00372,India
570988,2023-07-14,505,oven,18490,24000,5510,1,00372,India
141824,2023-07-14,505,oven,18490,24000,5510,1,00476,India
872703,2023-07-14,505,oven,18490,24000,5510,1,00115,India
872703,2023-07-14,502,iphone 15 pro max,100000,135000,35000,1,00115,India
872703,2023-07-14,501,iphone 15,60000,80000,20000,1,00115,India
804204,2023-07-14,505,oven,18490,24000,5510,1,00112,India
804204,2023-07-14,503,mixer,1349,3249,1900,1,00112,India
428560,2023-07-14,502,iphone 15 pro max,100000,135000,35000,1,00202,India
428560,2023-07-14,506,monitor,3249,8000,4751,1,00202,India
428560,2023-07-14,507,washing machine,6990,16490,9500,1,00202,India
884094,2023-07-14,501,iphone 15,60000,80000,20000,1,00088,India
884094,2023-07-14,503,mixer,1349,3249,1900,1,00088,India
884094,2023-07-14,506,monitor,3249,8000,4751,1,00088,India
139803,2023-07-14,507,washing machine,6990,16490,9500,1,00225,India
139803,2023-07-14,501,iphone 15,60000,80000,20000,1,00225,India
996376,2023-07-14,503,mixer,1349,3249,1900,1,00035,India
996376,2023-07-14,504,iron,449,879,430,1,00035,India
996376,2023-07-14,507,washing machine,6990,16490,9500,1,00035,India
301538,2023-07-14,506,monitor,3249,8000,4751,1,00355,India
301538,2023-07-14,505,oven,18490,24000,5510,1,00355,India
983283,2023-07-14,507,washing machine,6990,16490,9500,1,00407,India
153052,2023-07-14,504,iron,449,879,430,1,00183,India
153052,2023-07-14,507,washing machine,6990,16490,9500,1,00183,India
731303,2023-07-14,501,iphone 15,60000,80000,20000,1,00440,India
234235,2023-07-14,503,mixer,1349,3249,1900,1,00120,India
234235,2023-07-14,505,oven,18490,24000,5510,1,00120,India
234235,2023-07-14,504,iron,449,879,430,1,00120,India
265595,2023-07-14,505,oven,18490,24000,5510,1,00329,India
469404,2023-07-14,503,mixer,1349,3249,1900,1,00412,India
469404,2023-07-14,502,iphone 15 pro max,100000,135000,35000,1,00412,India
611788,2023-07-14,501,iphone 15,60000,80000,20000,1,00322,India
611788,2023-07-14,504,iron,449,879,430,1,00322,India
611788,2023-07-14,505,oven,18490,24000,5510,1,00322,India
212257,2023-07-14,502,iphone 15 pro max,100000,135000,35000,1,00455,India
212257,2023-07-14,501,iphone 15,60000,80000,20000,1,00455,India
212257,2023-07-14,505,oven,18490,24000,5510,1,00455,India
392855,2023-07-14,506,monitor,3249,8000,4751,1,00393,India
392855,2023-07-14,505,oven,18490,24000,5510,1,00393,India
392855,2023-07-14,504,iron,449,879,430,1,00393,India
392855,2023-07-14,503,mixer,1349,3249,1900,1,00393,India
779477,2023-07-14,505,oven,18490,24000,5510,1,00353,India
779477,2023-07-14,507,washing machine,6990,16490,9500,1,00353,India
779477,2023-07-14,502,iphone 15 pro max,100000,135000,35000,1,00353,India
779477,2023-07-14,506,monitor,3249,8000,4751,1,00353,India
801267,2023-07-14,501,iphone 15,60000,80000,20000,1,00470,India
801267,2023-07-14,507,washing machine,6990,16490,9500,1,00470,India
694950,2023-07-14,505,oven,18490,24000,5510,1,00396,India
694950,2023-07-14,504,iron,449,879,430,1,00396,India
694950,2023-07-14,503,mixer,1349,3249,1900,1,00396,India
694950,2023-07-14,502,iphone 15 pro max,100000,135000,35000,1,00396,India
694950,2023-07-14,507,washing machine,6990,16490,9500,1,00396,India
169031,2023-07-14,507,washing machine,6990,16490,9500,1,00422,India
955498,2023-07-14,507,washing machine,6990,16490,9500,1,00306,India
978147,2023-07-14,502,iphone 15 pro max,100000,135000,35000,1,00450,India
598896,2023-07-14,506,monitor,3249,8000,4751,1,00041,India
598896,2023-07-14,501,iphone 15,60000,80000,20000,1,00041,India
598896,2023-07-14,507,washing machine,6990,16490,9500,1,00041,India
522320,2023-07-14,505,oven,18490,24000,5510,1,00313,India
130004,2023-07-14,505,oven,18490,24000,5510,1,00287,India
413855,2023-07-14,506,monitor,3249,8000,4751,1,00333,India
413855,2023-07-14,503,mixer,1349,3249,1900,1,00333,India
413855,2023-07-14,505,oven,18490,24000,5510,1,00333,India
413855,2023-07-14,504,iron,449,879,430,1,00333,India
413855,2023-07-14,502,iphone 15 pro max,100000,135000,35000,1,00333,India
724570,2023-07-14,506,monitor,3249,8000,4751,1,00457,India
724570,2023-07-14,505,oven,18490,24000,5510,1,00457,India
855198,2023-07-14,503,mixer,1349,3249,1900,1,00181,India
855198,2023-07-14,504,iron,449,879,430,1,00181,India
276935,2023-07-14,501,iphone 15,60000,80000,20000,1,00064,India
276935,2023-07-14,505,oven,18490,24000,5510,1,00064,India
685071,2023-07-14,506,monitor,3249,8000,4751,1,00470,India
685071,2023-07-14,507,washing machine,6990,16490,9500,1,00470,India
685071,2023-07-14,501,iphone 15,60000,80000,20000,1,00470,India
816222,2023-07-14,505,oven,18490,24000,5510,1,00234,India
441300,2023-07-14,502,iphone 15 pro max,100000,135000,35000,1,00198,India
215600,2023-07-14,507,washing machine,6990,16490,9500,1,00114,India
215600,2023-07-14,503,mixer,1349,3249,1900,1,00114,India
215600,2023-07-14,504,iron,449,879,430,1,00114,India
932753,2023-07-14,501,iphone 15,60000,80000,20000,1,00242,India
216514,2023-07-14,501,iphone 15,60000,80000,20000,1,00096,India
216514,2023-07-14,503,mixer,1349,3249,1900,1,00096,India
324374,2023-07-14,503,mixer,1349,3249,1900,1,00090,India
841860,2023-07-14,505,oven,18490,24000,5510,1,00010,India
841860,2023-07-14,501,iphone 15,60000,80000,20000,1,00010,India
660453,2023-07-14,507,washing machine,6990,16490,9500,1,00361,India
612780,2023-07-14,502,iphone 15 pro max,100000,135000,35000,1,00445,India
612780,2023-07-14,505,oven,18490,24000,5510,1,00445,India
701608,2023-07-14,505,oven,18490,24000,5510,1,00259,India
701608,2023-07-14,501,iphone 15,60000,80000,20000,1,00259,India
701608,2023-07-14,502,iphone 15 pro max,100000,135000,35000,1,00259,India
865133,2023-07-14,502,iphone 15 pro max,100000,135000,35000,1,00333,India
865133,2023-07-14,505,oven,18490,24000,5510,1,00333,India
356216,2023-07-14,505,oven,18490,24000,5510,1,00429,India
243439,2023-07-14,506,monitor,3249,8000,4751,1,00144,India
243439,2023-07-14,503,mixer,1349,3249,1900,1,00144,India
243439,2023-07-14,507,washing machine,6990,16490,9500,1,00144,India
366486,2023-07-14,505,oven,18490,24000,5510,1,00112,India
366486,2023-07-14,503,mixer,1349,3249,1900,1,00112,India
366486,2023-07-14,507,washing machine,6990,16490,9500,1,00112,India
368360,2023-07-14,505,oven,18490,24000,5510,1,00299,India
368360,2023-07-14,506,monitor,3249,8000,4751,1,00299,India
368360,2023-07-14,501,iphone 15,60000,80000,20000,1,00299,India
368360,2023-07-14,502,iphone 15 pro max,100000,135000,35000,1,00299,India
998061,2023-07-14,507,washing machine,6990,16490,9500,1,00364,India
998061,2023-07-14,501,iphone 15,60000,80000,20000,1,00364,India
998061,2023-07-14,502,iphone 15 pro max,100000,135000,35000,1,00364,India
506269,2023-07-14,504,iron,449,879,430,1,00400,India
506269,2023-07-14,506,monitor,3249,8000,4751,1,00400,India
175819,2023-07-14,504,iron,449,879,430,1,00149,India
175819,2023-07-14,505,oven,18490,24000,5510,1,00149,India
131793,2023-07-14,505,oven,18490,24000,5510,1,00350,India
131793,2023-07-14,507,washing machine,6990,16490,9500,1,00350,India
679526,2023-07-14,505,oven,18490,24000,5510,1,00363,India
679526,2023-07-14,503,mixer,1349,3249,1900,1,00363,India
679526,2023-07-14,502,iphone 15 pro max,100000,135000,35000,1,00363,India
286005,2023-07-14,504,iron,449,879,430,1,00481,India
286005,2023-07-14,501,iphone 15,60000,80000,20000,1,00481,India
395936,2023-07-14,507,washing machine,6990,16490,9500,1,00132,India
352368,2023-07-14,502,iphone 15 pro max,100000,135000,35000,1,00432,India
721750,2023-07-14,504,iron,449,879,430,1,00240,India
721750,2023-07-14,507,washing machine,6990,16490,9500,1,00240,India
721750,2023-07-14,501,iphone 15,60000,80000,20000,1,00240,India
721750,2023-07-14,506,monitor,3249,8000,4751,1,00240,India
435514,2023-07-14,507,washing machine,6990,16490,9500,1,00111,India
435514,2023-07-14,503,mixer,1349,3249,1900,1,00111,India
435514,2023-07-14,502,iphone 15 pro max,100000,135000,35000,1,00111,India
995660,2023-07-14,505,oven,18490,24000,5510,1,00423,India
995660,2023-07-14,506,monitor,3249,8000,4751,1,00423,India
867615,2023-07-14,502,iphone 15 pro max,100000,135000,35000,1,00078,India
867615,2023-07-14,505,oven,18490,24000,5510,1,00078,India
867615,2023-07-14,503,mixer,1349,3249,1900,1,00078,India
235347,2023-07-14,502,iphone 15 pro max,100000,135000,35000,1,00487,India
235347,2023-07-14,505,oven,18490,24000,5510,1,00487,India
235347,2023-07-14,507,washing machine,6990,16490,9500,1,00487,India
890152,2023-07-14,502,iphone 15 pro max,100000,135000,35000,1,00488,India
846643,2023-07-14,502,iphone 15 pro max,100000,135000,35000,1,00115,India
846643,2023-07-14,504,iron,449,879,430,1,00115,India
626154,2023-07-14,502,iphone 15 pro max,100000,135000,35000,1,00463,India
626154,2023-07-14,501,iphone 15,60000,80000,20000,1,00463,India
626154,2023-07-14,503,mixer,1349,3249,1900,1,00463,India
361335,2023-07-14,506,monitor,3249,8000,4751,1,00380,India
361335,2023-07-14,502,iphone 15 pro max,100000,135000,35000,1,00380,India
475124,2023-07-14,507,washing machine,6990,16490,9500,1,00292,India
475124,2023-07-14,504,iron,449,879,430,1,00292,India
776906,2023-07-14,503,mixer,1349,3249,1900,1,00257,India
776906,2023-07-14,506,monitor,3249,8000,4751,1,00257,India
776906,2023-07-14,501,iphone 15,60000,80000,20000,1,00257,India
690943,2023-07-14,505,oven,18490,24000,5510,1,00366,India
690943,2023-07-14,501,iphone 15,60000,80000,20000,1,00366,India
670960,2023-07-14,505,oven,18490,24000,5510,1,00207,India
670960,2023-07-14,501,iphone 15,60000,80000,20000,1,00207,India
670960,2023-07-14,506,monitor,3249,8000,4751,1,00207,India
989320,2023-07-14,504,iron,449,879,430,1,00476,India
324939,2023-07-14,505,oven,18490,24000,5510,1,00146,India
324939,2023-07-14,504,iron,449,879,430,1,00146,India
324939,2023-07-14,502,iphone 15 pro max,100000,135000,35000,1,00146,India
324939,2023-07-14,507,washing machine,6990,16490,9500,1,00146,India
487097,2023-07-14,503,mixer,1349,3249,1900,1,00311,India
552274,2023-07-14,507,washing machine,6990,16490,9500,1,00426,India
552274,2023-07-14,505,oven,18490,24000,5510,1,00426,India
552274,2023-07-14,504,iron,449,879,430,1,00426,India
552274,2023-07-14,506,monitor,3249,8000,4751,1,00426,India
563728,2023-07-14,503,mixer,1349,3249,1900,1,00399,India
563728,2023-07-14,505,oven,18490,24000,5510,1,00399,India
563728,2023-07-14,504,iron,449,879,430,1,00399,India
406898,2023-07-14,502,iphone 15 pro max,100000,135000,35000,1,00416,India
165535,2023-07-14,504,iron,449,879,430,1,00122,India
413795,2023-07-14,507,washing machine,6990,16490,9500,1,00155,India
980399,2023-07-15,503,mixer,1349,3249,1900,1,00421,India
557919,2023-07-15,506,monitor,3249,8000,4751,1,00294,India
557919,2023-07-15,503,mixer,1349,3249,1900,1,00294,India
557919,2023-07-15,504,iron,449,879,430,1,00294,India
313350,2023-07-15,503,mixer,1349,3249,1900,1,00462,India
313350,2023-07-15,504,iron,449,879,430,1,00462,India
313350,2023-07-15,506,monitor,3249,8000,4751,1,00462,India
313350,2023-07-15,501,iphone 15,60000,80000,20000,1,00462,India
855872,2023-07-15,502,iphone 15 pro max,100000,135000,35000,1,00034,India
660621,2023-07-15,504,iron,449,879,430,1,00399,India
660621,2023-07-15,503,mixer,1349,3249,1900,1,00399,India
974622,2023-07-15,502,iphone 15 pro max,100000,135000,35000,1,00245,India
974622,2023-07-15,501,iphone 15,60000,80000,20000,1,00245,India
974622,2023-07-15,505,oven,18490,24000,5510,1,00245,India
255298,2023-07-15,501,iphone 15,60000,80000,20000,1,00384,India
747226,2023-07-15,503,mixer,1349,3249,1900,1,00255,India
227630,2023-07-15,506,monitor,3249,8000,4751,1,00448,India
227630,2023-07-15,504,iron,449,879,430,1,00448,India
227630,2023-07-15,502,iphone 15 pro max,100000,135000,35000,1,00448,India
447318,2023-07-15,502,iphone 15 pro max,100000,135000,35000,1,00394,India
447318,2023-07-15,503,mixer,1349,3249,1900,1,00394,India
447318,2023-07-15,507,washing machine,6990,16490,9500,1,00394,India
467227,2023-07-15,505,oven,18490,24000,5510,1,00331,India
988048,2023-07-15,504,iron,449,879,430,1,00412,India
308000,2023-07-15,505,oven,18490,24000,5510,1,00188,India
308000,2023-07-15,504,iron,449,879,430,1,00188,India
308000,2023-07-15,506,monitor,3249,8000,4751,1,00188,India
658225,2023-07-15,507,washing machine,6990,16490,9500,1,00359,India
658225,2023-07-15,504,iron,449,879,430,1,00359,India
932411,2023-07-15,507,washing machine,6990,16490,9500,1,00217,India
787881,2023-07-15,501,iphone 15,60000,80000,20000,1,00422,India
787881,2023-07-15,503,mixer,1349,3249,1900,1,00422,India
787881,2023-07-15,506,monitor,3249,8000,4751,1,00422,India
762950,2023-07-15,506,monitor,3249,8000,4751,1,00257,India
815405,2023-07-15,503,mixer,1349,3249,1900,1,00258,India
815405,2023-07-15,505,oven,18490,24000,5510,1,00258,India
815405,2023-07-15,507,washing machine,6990,16490,9500,1,00258,India
566465,2023-07-15,501,iphone 15,60000,80000,20000,1,00141,India
566465,2023-07-15,504,iron,449,879,430,1,00141,India
566465,2023-07-15,506,monitor,3249,8000,4751,1,00141,India
566465,2023-07-15,502,iphone 15 pro max,100000,135000,35000,1,00141,India
301072,2023-07-15,506,monitor,3249,8000,4751,1,00029,India
301072,2023-07-15,502,iphone 15 pro max,100000,135000,35000,1,00029,India
301072,2023-07-15,505,oven,18490,24000,5510,1,00029,India
399487,2023-07-15,507,washing machine,6990,16490,9500,1,00330,India
502007,2023-07-15,507,washing machine,6990,16490,9500,1,00324,India
502007,2023-07-15,501,iphone 15,60000,80000,20000,1,00324,India
502007,2023-07-15,506,monitor,3249,8000,4751,1,00324,India
502007,2023-07-15,504,iron,449,879,430,1,00324,India
491797,2023-07-15,501,iphone 15,60000,80000,20000,1,00494,India
491797,2023-07-15,503,mixer,1349,3249,1900,1,00494,India
491797,2023-07-15,506,monitor,3249,8000,4751,1,00494,India
842103,2023-07-15,503,mixer,1349,3249,1900,1,00110,India
842103,2023-07-15,502,iphone 15 pro max,100000,135000,35000,1,00110,India
842103,2023-07-15,504,iron,449,879,430,1,00110,India
842103,2023-07-15,507,washing machine,6990,16490,9500,1,00110,India
202967,2023-07-15,505,oven,18490,24000,5510,1,00207,India
202967,2023-07-15,507,washing machine,6990,16490,9500,1,00207,India
202967,2023-07-15,502,iphone 15 pro max,100000,135000,35000,1,00207,India
307225,2023-07-15,505,oven,18490,24000,5510,1,00191,India
307225,2023-07-15,504,iron,449,879,430,1,00191,India
375251,2023-07-15,503,mixer,1349,3249,1900,1,00222,India
375251,2023-07-15,501,iphone 15,60000,80000,20000,1,00222,India
375251,2023-07-15,504,iron,449,879,430,1,00222,India
375251,2023-07-15,506,monitor,3249,8000,4751,1,00222,India
120766,2023-07-15,502,iphone 15 pro max,100000,135000,35000,1,00409,India
853541,2023-07-15,503,mixer,1349,3249,1900,1,00423,India
674233,2023-07-15,503,mixer,1349,3249,1900,1,00020,India
674233,2023-07-15,502,iphone 15 pro max,100000,135000,35000,1,00020,India
674233,2023-07-15,501,iphone 15,60000,80000,20000,1,00020,India
674233,2023-07-15,507,washing machine,6990,16490,9500,1,00020,India
418129,2023-07-15,505,oven,18490,24000,5510,1,00393,India
770354,2023-07-15,506,monitor,3249,8000,4751,1,00488,India
770354,2023-07-15,502,iphone 15 pro max,100000,135000,35000,1,00488,India
770354,2023-07-15,505,oven,18490,24000,5510,1,00488,India
374513,2023-07-15,501,iphone 15,60000,80000,20000,1,00311,India
202277,2023-07-15,505,oven,18490,24000,5510,1,00106,India
202277,2023-07-15,501,iphone 15,60000,80000,20000,1,00106,India
626002,2023-07-15,504,iron,449,879,430,1,00303,India
626002,2023-07-15,502,iphone 15 pro max,100000,135000,35000,1,00303,India
626002,2023-07-15,507,washing machine,6990,16490,9500,1,00303,India
626002,2023-07-15,501,iphone 15,60000,80000,20000,1,00303,India
669756,2023-07-15,502,iphone 15 pro max,100000,135000,35000,1,00050,India
132025,2023-07-15,505,oven,18490,24000,5510,1,00328,India
132025,2023-07-15,507,washing machine,6990,16490,9500,1,00328,India
596443,2023-07-15,504,iron,449,879,430,1,00327,India
596443,2023-07-15,501,iphone 15,60000,80000,20000,1,00327,India
596443,2023-07-15,507,washing machine,6990,16490,9500,1,00327,India
596443,2023-07-15,503,mixer,1349,3249,1900,1,00327,India
273600,2023-07-15,507,washing machine,6990,16490,9500,1,00012,India
273600,2023-07-15,502,iphone 15 pro max,100000,135000,35000,1,00012,India
698149,2023-07-15,502,iphone 15 pro max,100000,135000,35000,1,00473,India
698149,2023-07-15,501,iphone 15,60000,80000,20000,1,00473,India
923346,2023-07-15,501,iphone 15,60000,80000,20000,1,00194,India
923346,2023-07-15,502,iphone 15 pro max,100000,135000,35000,1,00194,India
469084,2023-07-15,503,mixer,1349,3249,1900,1,00363,India
469084,2023-07-15,501,iphone 15,60000,80000,20000,1,00363,India
622447,2023-07-15,502,iphone 15 pro max,100000,135000,35000,1,00166,India
137491,2023-07-15,501,iphone 15,60000,80000,20000,1,00455,India
137491,2023-07-15,503,mixer,1349,3249,1900,1,00455,India
137491,2023-07-15,504,iron,449,879,430,1,00455,India
137491,2023-07-15,505,oven,18490,24000,5510,1,00455,India
137491,2023-07-15,502,iphone 15 pro max,100000,135000,35000,1,00455,India
793394,2023-07-15,504,iron,449,879,430,1,00275,India
793394,2023-07-15,502,iphone 15 pro max,100000,135000,35000,1,00275,India
123996,2023-07-15,505,oven,18490,24000,5510,1,00158,India
123996,2023-07-15,507,washing machine,6990,16490,9500,1,00158,India
123996,2023-07-15,506,monitor,3249,8000,4751,1,00158,India
282645,2023-07-15,502,iphone 15 pro max,100000,135000,35000,1,00271,India
282645,2023-07-15,501,iphone 15,60000,80000,20000,1,00271,India
282645,2023-07-15,506,monitor,3249,8000,4751,1,00271,India
282645,2023-07-15,504,iron,449,879,430,1,00271,India
282645,2023-07-15,507,washing machine,6990,16490,9500,1,00271,India
271608,2023-07-15,502,iphone 15 pro max,100000,135000,35000,1,00389,India
271608,2023-07-15,505,oven,18490,24000,5510,1,00389,India
271608,2023-07-15,504,iron,449,879,430,1,00389,India
134887,2023-07-15,503,mixer,1349,3249,1900,1,00149,India
134887,2023-07-15,501,iphone 15,60000,80000,20000,1,00149,India
134887,2023-07-15,504,iron,449,879,430,1,00149,India
134887,2023-07-15,505,oven,18490,24000,5510,1,00149,India
668207,2023-07-15,503,mixer,1349,3249,1900,1,00411,India
668207,2023-07-15,501,iphone 15,60000,80000,20000,1,00411,India
668207,2023-07-15,504,iron,449,879,430,1,00411,India
668207,2023-07-15,506,monitor,3249,8000,4751,1,00411,India
953163,2023-07-15,501,iphone 15,60000,80000,20000,1,00287,India
953163,2023-07-15,507,washing machine,6990,16490,9500,1,00287,India
898465,2023-07-15,505,oven,18490,24000,5510,1,00341,India
898465,2023-07-15,501,iphone 15,60000,80000,20000,1,00341,India
898465,2023-07-15,503,mixer,1349,3249,1900,1,00341,India
303053,2023-07-15,504,iron,449,879,430,1,00141,India
534064,2023-07-15,506,monitor,3249,8000,4751,1,00272,India
534064,2023-07-15,507,washing machine,6990,16490,9500,1,00272,India
534064,2023-07-15,505,oven,18490,24000,5510,1,00272,India
369786,2023-07-16,505,oven,18490,24000,5510,1,00207,India
369786,2023-07-16,506,monitor,3249,8000,4751,1,00207,India
182071,2023-07-16,501,iphone 15,60000,80000,20000,1,00420,India
182071,2023-07-16,506,monitor,3249,8000,4751,1,00420,India
182071,2023-07-16,503,mixer,1349,3249,1900,1,00420,India
781624,2023-07-16,505,oven,18490,24000,5510,1,00198,India
781624,2023-07-16,507,washing machine,6990,16490,9500,1,00198,India
781624,2023-07-16,501,iphone 15,60000,80000,20000,1,00198,India
986520,2023-07-16,506,monitor,3249,8000,4751,1,00225,India
986520,2023-07-16,507,washing machine,6990,16490,9500,1,00225,India
565229,2023-07-16,504,iron,449,879,430,1,00062,India
565229,2023-07-16,506,monitor,3249,8000,4751,1,00062,India
565229,2023-07-16,505,oven,18490,24000,5510,1,00062,India
953140,2023-07-16,501,iphone 15,60000,80000,20000,1,00364,India
953140,2023-07-16,506,monitor,3249,8000,4751,1,00364,India
953140,2023-07-16,503,mixer,1349,3249,1900,1,00364,India
361411,2023-07-16,503,mixer,1349,3249,1900,1,00460,India
552217,2023-07-16,501,iphone 15,60000,80000,20000,1,00372,India
552217,2023-07-16,506,monitor,3249,8000,4751,1,00372,India
959911,2023-07-16,503,mixer,1349,3249,1900,1,00239,India
959911,2023-07-16,501,iphone 15,60000,80000,20000,1,00239,India
444345,2023-07-16,506,monitor,3249,8000,4751,1,00353,India
444345,2023-07-16,507,washing machine,6990,16490,9500,1,00353,India
964407,2023-07-16,502,iphone 15 pro max,100000,135000,35000,1,00227,India
989184,2023-07-16,505,oven,18490,24000,5510,1,00009,India
989184,2023-07-16,504,iron,449,879,430,1,00009,India
989184,2023-07-16,502,iphone 15 pro max,100000,135000,35000,1,00009,India
541554,2023-07-16,502,iphone 15 pro max,100000,135000,35000,1,00150,India
541554,2023-07-16,501,iphone 15,60000,80000,20000,1,00150,India
541554,2023-07-16,507,washing machine,6990,16490,9500,1,00150,India
942294,2023-07-16,507,washing machine,6990,16490,9500,1,00031,India
942294,2023-07-16,506,monitor,3249,8000,4751,1,00031,India
294764,2023-07-16,504,iron,449,879,430,1,00216,India
294764,2023-07-16,501,iphone 15,60000,80000,20000,1,00216,India
294764,2023-07-16,503,mixer,1349,3249,1900,1,00216,India
731757,2023-07-16,503,mixer,1349,3249,1900,1,00111,India
731757,2023-07-16,505,oven,18490,24000,5510,1,00111,India
731757,2023-07-16,506,monitor,3249,8000,4751,1,00111,India
785845,2023-07-16,506,monitor,3249,8000,4751,1,00072,India
812276,2023-07-16,506,monitor,3249,8000,4751,1,00378,India
812276,2023-07-16,504,iron,449,879,430,1,00378,India
812276,2023-07-16,507,washing machine,6990,16490,9500,1,00378,India
271475,2023-07-16,503,mixer,1349,3249,1900,1,00319,India
791719,2023-07-16,506,monitor,3249,8000,4751,1,00047,India
791719,2023-07-16,507,washing machine,6990,16490,9500,1,00047,India
765105,2023-07-16,503,mixer,1349,3249,1900,1,00297,India
765105,2023-07-16,505,oven,18490,24000,5510,1,00297,India
765105,2023-07-16,502,iphone 15 pro max,100000,135000,35000,1,00297,India
602050,2023-07-16,503,mixer,1349,3249,1900,1,00435,India
602050,2023-07-16,501,iphone 15,60000,80000,20000,1,00435,India
691450,2023-07-16,501,iphone 15,60000,80000,20000,1,00026,India
691450,2023-07-16,502,iphone 15 pro max,100000,135000,35000,1,00026,India
691450,2023-07-16,504,iron,449,879,430,1,00026,India
583153,2023-07-16,501,iphone 15,60000,80000,20000,1,00072,India
583153,2023-07-16,505,oven,18490,24000,5510,1,00072,India
583153,2023-07-16,506,monitor,3249,8000,4751,1,00072,India
563560,2023-07-16,501,iphone 15,60000,80000,20000,1,00245,India
563560,2023-07-16,505,oven,18490,24000,5510,1,00245,India
563560,2023-07-16,506,monitor,3249,8000,4751,1,00245,India
563560,2023-07-16,503,mixer,1349,3249,1900,1,00245,India
693033,2023-07-16,501,iphone 15,60000,80000,20000,1,00365,India
693033,2023-07-16,507,washing machine,6990,16490,9500,1,00365,India
693033,2023-07-16,505,oven,18490,24000,5510,1,00365,India
557651,2023-07-16,507,washing machine,6990,16490,9500,1,00152,India
557651,2023-07-16,505,oven,18490,24000,5510,1,00152,India
263077,2023-07-16,501,iphone 15,60000,80000,20000,1,00113,India
263077,2023-07-16,503,mixer,1349,3249,1900,1,00113,India
263077,2023-07-16,506,monitor,3249,8000,4751,1,00113,India
827053,2023-07-16,506,monitor,3249,8000,4751,1,00112,India
827053,2023-07-16,507,washing machine,6990,16490,9500,1,00112,India
827053,2023-07-16,505,oven,18490,24000,5510,1,00112,India
761658,2023-07-16,507,washing machine,6990,16490,9500,1,00215,India
761658,2023-07-16,501,iphone 15,60000,80000,20000,1,00215,India
761658,2023-07-16,504,iron,449,879,430,1,00215,India
332241,2023-07-16,502,iphone 15 pro max,100000,135000,35000,1,00121,India
332241,2023-07-16,501,iphone 15,60000,80000,20000,1,00121,India
761204,2023-07-16,501,iphone 15,60000,80000,20000,1,00075,India
761204,2023-07-16,506,monitor,3249,8000,4751,1,00075,India
761204,2023-07-16,505,oven,18490,24000,5510,1,00075,India
334702,2023-07-16,506,monitor,3249,8000,4751,1,00083,India
334702,2023-07-16,504,iron,449,879,430,1,00083,India
715068,2023-07-16,501,iphone 15,60000,80000,20000,1,00112,India
715068,2023-07-16,506,monitor,3249,8000,4751,1,00112,India
623162,2023-07-16,506,monitor,3249,8000,4751,1,00204,India
534892,2023-07-16,505,oven,18490,24000,5510,1,00116,India
534892,2023-07-16,501,iphone 15,60000,80000,20000,1,00116,India
534892,2023-07-16,507,washing machine,6990,16490,9500,1,00116,India
534892,2023-07-16,503,mixer,1349,3249,1900,1,00116,India
773646,2023-07-16,501,iphone 15,60000,80000,20000,1,00391,India
773646,2023-07-16,507,washing machine,6990,16490,9500,1,00391,India
301083,2023-07-16,507,washing machine,6990,16490,9500,1,00308,India
301083,2023-07-16,506,monitor,3249,8000,4751,1,00308,India
200606,2023-07-16,504,iron,449,879,430,1,00211,India
847302,2023-07-16,503,mixer,1349,3249,1900,1,00063,India
847302,2023-07-16,505,oven,18490,24000,5510,1,00063,India
847302,2023-07-16,506,monitor,3249,8000,4751,1,00063,India
847302,2023-07-16,507,washing machine,6990,16490,9500,1,00063,India
535617,2023-07-16,507,washing machine,6990,16490,9500,1,00136,India
535617,2023-07-16,502,iphone 15 pro max,100000,135000,35000,1,00136,India
535617,2023-07-16,504,iron,449,879,430,1,00136,India
697764,2023-07-16,507,washing machine,6990,16490,9500,1,00009,India
697764,2023-07-16,504,iron,449,879,430,1,00009,India
697764,2023-07-16,503,mixer,1349,3249,1900,1,00009,India
662096,2023-07-16,503,mixer,1349,3249,1900,1,00446,India
662096,2023-07-16,506,monitor,3249,8000,4751,1,00446,India
662096,2023-07-16,507,washing machine,6990,16490,9500,1,00446,India
662096,2023-07-16,502,iphone 15 pro max,100000,135000,35000,1,00446,India
109808,2023-07-16,502,iphone 15 pro max,100000,135000,35000,1,00059,India
109808,2023-07-16,504,iron,449,879,430,1,00059,India
109808,2023-07-16,503,mixer,1349,3249,1900,1,00059,India
281420,2023-07-16,501,iphone 15,60000,80000,20000,1,00435,India
954183,2023-07-16,502,iphone 15 pro max,100000,135000,35000,1,00394,India
954183,2023-07-16,506,monitor,3249,8000,4751,1,00394,India
787098,2023-07-16,504,iron,449,879,430,1,00047,India
405103,2023-07-16,507,washing machine,6990,16490,9500,1,00074,India
405103,2023-07-16,503,mixer,1349,3249,1900,1,00074,India
405103,2023-07-16,502,iphone 15 pro max,100000,135000,35000,1,00074,India
340686,2023-07-16,505,oven,18490,24000,5510,1,00151,India
800476,2023-07-16,506,monitor,3249,8000,4751,1,00007,India
915651,2023-07-16,503,mixer,1349,3249,1900,1,00131,India
196141,2023-07-16,507,washing machine,6990,16490,9500,1,00138,India
196141,2023-07-16,501,iphone 15,60000,80000,20000,1,00138,India
196141,2023-07-16,506,monitor,3249,8000,4751,1,00138,India
695995,2023-07-16,505,oven,18490,24000,5510,1,00091,India
695995,2023-07-16,502,iphone 15 pro max,100000,135000,35000,1,00091,India
695995,2023-07-16,507,washing machine,6990,16490,9500,1,00091,India
697545,2023-07-16,507,washing machine,6990,16490,9500,1,00009,India
697545,2023-07-16,505,oven,18490,24000,5510,1,00009,India
697545,2023-07-16,504,iron,449,879,430,1,00009,India
697545,2023-07-16,502,iphone 15 pro max,100000,135000,35000,1,00009,India
971458,2023-07-16,504,iron,449,879,430,1,00178,India
971458,2023-07-16,507,washing machine,6990,16490,9500,1,00178,India
971458,2023-07-16,503,mixer,1349,3249,1900,1,00178,India
861255,2023-07-17,507,washing machine,6990,16490,9500,1,00042,India
861255,2023-07-17,503,mixer,1349,3249,1900,1,00042,India
303110,2023-07-17,503,mixer,1349,3249,1900,1,00092,India
303110,2023-07-17,506,monitor,3249,8000,4751,1,00092,India
303110,2023-07-17,507,washing machine,6990,16490,9500,1,00092,India
789179,2023-07-17,502,iphone 15 pro max,100000,135000,35000,1,00331,India
789179,2023-07-17,506,monitor,3249,8000,4751,1,00331,India
789179,2023-07-17,505,oven,18490,24000,5510,1,00331,India
897654,2023-07-17,503,mixer,1349,3249,1900,1,00311,India
426699,2023-07-17,501,iphone 15,60000,80000,20000,1,00112,India
426699,2023-07-17,506,monitor,3249,8000,4751,1,00112,India
273993,2023-07-17,506,monitor,3249,8000,4751,1,00058,India
839790,2023-07-17,501,iphone 15,60000,80000,20000,1,00062,India
839790,2023-07-17,505,oven,18490,24000,5510,1,00062,India
839790,2023-07-17,504,iron,449,879,430,1,00062,India
839790,2023-07-17,503,mixer,1349,3249,1900,1,00062,India
148664,2023-07-17,507,washing machine,6990,16490,9500,1,00371,India
900374,2023-07-17,503,mixer,1349,3249,1900,1,00062,India
286785,2023-07-17,507,washing machine,6990,16490,9500,1,00128,India
286785,2023-07-17,504,iron,449,879,430,1,00128,India
267251,2023-07-17,504,iron,449,879,430,1,00498,India
267251,2023-07-17,506,monitor,3249,8000,4751,1,00498,India
267251,2023-07-17,505,oven,18490,24000,5510,1,00498,India
130637,2023-07-17,506,monitor,3249,8000,4751,1,00214,India
130637,2023-07-17,505,oven,18490,24000,5510,1,00214,India
285994,2023-07-17,503,mixer,1349,3249,1900,1,00020,India
918366,2023-07-17,505,oven,18490,24000,5510,1,00164,India
918366,2023-07-17,502,iphone 15 pro max,100000,135000,35000,1,00164,India
918366,2023-07-17,504,iron,449,879,430,1,00164,India
461871,2023-07-17,505,oven,18490,24000,5510,1,00050,India
461871,2023-07-17,507,washing machine,6990,16490,9500,1,00050,India
461871,2023-07-17,502,iphone 15 pro max,100000,135000,35000,1,00050,India
688155,2023-07-17,501,iphone 15,60000,80000,20000,1,00014,India
478045,2023-07-17,503,mixer,1349,3249,1900,1,00041,India
478045,2023-07-17,502,iphone 15 pro max,100000,135000,35000,1,00041,India
478045,2023-07-17,501,iphone 15,60000,80000,20000,1,00041,India
838074,2023-07-17,505,oven,18490,24000,5510,1,00024,India
838074,2023-07-17,503,mixer,1349,3249,1900,1,00024,India
277605,2023-07-17,501,iphone 15,60000,80000,20000,1,00118,India
277605,2023-07-17,505,oven,18490,24000,5510,1,00118,India
277605,2023-07-17,504,iron,449,879,430,1,00118,India
465111,2023-07-17,502,iphone 15 pro max,100000,135000,35000,1,00237,India
465111,2023-07-17,504,iron,449,879,430,1,00237,India
685074,2023-07-17,503,mixer,1349,3249,1900,1,00333,India
685074,2023-07-17,502,iphone 15 pro max,100000,135000,35000,1,00333,India
364378,2023-07-17,502,iphone 15 pro max,100000,135000,35000,1,00439,India
364378,2023-07-17,501,iphone 15,60000,80000,20000,1,00439,India
162076,2023-07-17,504,iron,449,879,430,1,00386,India
162076,2023-07-17,502,iphone 15 pro max,100000,135000,35000,1,00386,India
162076,2023-07-17,501,iphone 15,60000,80000,20000,1,00386,India
304608,2023-07-17,501,iphone 15,60000,80000,20000,1,00114,India
304608,2023-07-17,504,iron,449,879,430,1,00114,India
321591,2023-07-17,504,iron,449,879,430,1,00126,India
321591,2023-07-17,501,iphone 15,60000,80000,20000,1,00126,India
321591,2023-07-17,507,washing machine,6990,16490,9500,1,00126,India
321591,2023-07-17,502,iphone 15 pro max,100000,135000,35000,1,00126,India
177082,2023-07-17,503,mixer,1349,3249,1900,1,00065,India
266008,2023-07-17,504,iron,449,879,430,1,00328,India
266008,2023-07-17,501,iphone 15,60000,80000,20000,1,00328,India
266008,2023-07-17,506,monitor,3249,8000,4751,1,00328,India
266008,2023-07-17,502,iphone 15 pro max,100000,135000,35000,1,00328,India
222334,2023-07-17,505,oven,18490,24000,5510,1,00056,India
222334,2023-07-17,504,iron,449,879,430,1,00056,India
490540,2023-07-17,501,iphone 15,60000,80000,20000,1,00410,India
933816,2023-07-17,501,iphone 15,60000,80000,20000,1,00224,India
933816,2023-07-17,503,mixer,1349,3249,1900,1,00224,India
933816,2023-07-17,505,oven,18490,24000,5510,1,00224,India
933816,2023-07-17,506,monitor,3249,8000,4751,1,00224,India
439217,2023-07-17,503,mixer,1349,3249,1900,1,00228,India
451889,2023-07-17,501,iphone 15,60000,80000,20000,1,00143,India
451889,2023-07-17,503,mixer,1349,3249,1900,1,00143,India
451889,2023-07-17,504,iron,449,879,430,1,00143,India
325950,2023-07-17,507,washing machine,6990,16490,9500,1,00193,India
325950,2023-07-17,506,monitor,3249,8000,4751,1,00193,India
325950,2023-07-17,504,iron,449,879,430,1,00193,India
928342,2023-07-17,501,iphone 15,60000,80000,20000,1,00117,India
928342,2023-07-17,507,washing machine,6990,16490,9500,1,00117,India
928342,2023-07-17,503,mixer,1349,3249,1900,1,00117,India
802137,2023-07-17,505,oven,18490,24000,5510,1,00195,India
802137,2023-07-17,502,iphone 15 pro max,100000,135000,35000,1,00195,India
802137,2023-07-17,503,mixer,1349,3249,1900,1,00195,India
802137,2023-07-17,504,iron,449,879,430,1,00195,India
910266,2023-07-17,507,washing machine,6990,16490,9500,1,00125,India
910266,2023-07-17,505,oven,18490,24000,5510,1,00125,India
245906,2023-07-17,503,mixer,1349,3249,1900,1,00347,India
245906,2023-07-17,507,washing machine,6990,16490,9500,1,00347,India
273400,2023-07-17,504,iron,449,879,430,1,00219,India
273400,2023-07-17,501,iphone 15,60000,80000,20000,1,00219,India
273400,2023-07-17,503,mixer,1349,3249,1900,1,00219,India
738271,2023-07-17,507,washing machine,6990,16490,9500,1,00266,India
975704,2023-07-17,502,iphone 15 pro max,100000,135000,35000,1,00382,India
975704,2023-07-17,501,iphone 15,60000,80000,20000,1,00382,India
975704,2023-07-17,503,mixer,1349,3249,1900,1,00382,India
639035,2023-07-17,501,iphone 15,60000,80000,20000,1,00428,India
639035,2023-07-17,503,mixer,1349,3249,1900,1,00428,India
639035,2023-07-17,502,iphone 15 pro max,100000,135000,35000,1,00428,India
477276,2023-07-17,506,monitor,3249,8000,4751,1,00048,India
477276,2023-07-17,505,oven,18490,24000,5510,1,00048,India
477276,2023-07-17,503,mixer,1349,3249,1900,1,00048,India
679189,2023-07-17,502,iphone 15 pro max,100000,135000,35000,1,00408,India
808031,2023-07-17,505,oven,18490,24000,5510,1,00291,India
808031,2023-07-17,503,mixer,1349,3249,1900,1,00291,India
231928,2023-07-17,501,iphone 15,60000,80000,20000,1,00485,India
534084,2023-07-17,505,oven,18490,24000,5510,1,00057,India
313378,2023-07-17,502,iphone 15 pro max,100000,135000,35000,1,00221,India
313378,2023-07-17,506,monitor,3249,8000,4751,1,00221,India
313378,2023-07-17,503,mixer,1349,3249,1900,1,00221,India
313378,2023-07-17,501,iphone 15,60000,80000,20000,1,00221,India
313378,2023-07-17,507,washing machine,6990,16490,9500,1,00221,India
952055,2023-07-17,502,iphone 15 pro max,100000,135000,35000,1,00038,India
952055,2023-07-17,504,iron,449,879,430,1,00038,India
952055,2023-07-17,501,iphone 15,60000,80000,20000,1,00038,India
952055,2023-07-17,507,washing machine,6990,16490,9500,1,00038,India
148473,2023-07-17,505,oven,18490,24000,5510,1,00063,India
305230,2023-07-17,507,washing machine,6990,16490,9500,1,00494,India
305230,2023-07-17,503,mixer,1349,3249,1900,1,00494,India
882647,2023-07-17,503,mixer,1349,3249,1900,1,00359,India
686659,2023-07-17,501,iphone 15,60000,80000,20000,1,00172,India
686659,2023-07-17,505,oven,18490,24000,5510,1,00172,India
484302,2023-07-17,505,oven,18490,24000,5510,1,00187,India
484302,2023-07-17,503,mixer,1349,3249,1900,1,00187,India
484302,2023-07-17,507,washing machine,6990,16490,9500,1,00187,India
241631,2023-07-17,504,iron,449,879,430,1,00424,India
241631,2023-07-17,505,oven,18490,24000,5510,1,00424,India
241631,2023-07-17,501,iphone 15,60000,80000,20000,1,00424,India
804691,2023-07-17,501,iphone 15,60000,80000,20000,1,00152,India
804691,2023-07-17,506,monitor,3249,8000,4751,1,00152,India
720691,2023-07-17,502,iphone 15 pro max,100000,135000,35000,1,00388,India
720691,2023-07-17,504,iron,449,879,430,1,00388,India
720691,2023-07-17,505,oven,18490,24000,5510,1,00388,India
659115,2023-07-17,502,iphone 15 pro max,100000,135000,35000,1,00310,India
999079,2023-07-17,503,mixer,1349,3249,1900,1,00194,India
999079,2023-07-17,506,monitor,3249,8000,4751,1,00194,India
999079,2023-07-17,502,iphone 15 pro max,100000,135000,35000,1,00194,India
999079,2023-07-17,504,iron,449,879,430,1,00194,India
999079,2023-07-17,501,iphone 15,60000,80000,20000,1,00194,India
645528,2023-07-17,505,oven,18490,24000,5510,1,00142,India
296715,2023-07-17,506,monitor,3249,8000,4751,1,00417,India
296715,2023-07-17,501,iphone 15,60000,80000,20000,1,00417,India
296715,2023-07-17,504,iron,449,879,430,1,00417,India
296715,2023-07-17,507,washing machine,6990,16490,9500,1,00417,India
108248,2023-07-17,502,iphone 15 pro max,100000,135000,35000,1,00336,India
108248,2023-07-17,504,iron,449,879,430,1,00336,India
108248,2023-07-17,507,washing machine,6990,16490,9500,1,00336,India
108248,2023-07-17,501,iphone 15,60000,80000,20000,1,00336,India
863062,2023-07-17,504,iron,449,879,430,1,00217,India
863062,2023-07-17,501,iphone 15,60000,80000,20000,1,00217,India
261481,2023-07-17,502,iphone 15 pro max,100000,135000,35000,1,00330,India
501932,2023-07-17,501,iphone 15,60000,80000,20000,1,00420,India
501932,2023-07-17,507,washing machine,6990,16490,9500,1,00420,India
501932,2023-07-17,504,iron,449,879,430,1,00420,India
275066,2023-07-17,502,iphone 15 pro max,100000,135000,35000,1,00097,India
275066,2023-07-17,505,oven,18490,24000,5510,1,00097,India
194936,2023-07-17,506,monitor,3249,8000,4751,1,00421,India
194936,2023-07-17,504,iron,449,879,430,1,00421,India
843114,2023-07-17,503,mixer,1349,3249,1900,1,00202,India
843114,2023-07-17,502,iphone 15 pro max,100000,135000,35000,1,00202,India
112890,2023-07-17,502,iphone 15 pro max,100000,135000,35000,1,00317,India
112890,2023-07-17,507,washing machine,6990,16490,9500,1,00317,India
376097,2023-07-17,504,iron,449,879,430,1,00465,India
376097,2023-07-17,505,oven,18490,24000,5510,1,00465,India
376097,2023-07-17,502,iphone 15 pro max,100000,135000,35000,1,00465,India
254517,2023-07-17,505,oven,18490,24000,5510,1,00233,India
254517,2023-07-17,502,iphone 15 pro max,100000,135000,35000,1,00233,India
138964,2023-07-17,505,oven,18490,24000,5510,1,00039,India
429335,2023-07-17,505,oven,18490,24000,5510,1,00141,India
828627,2023-07-17,502,iphone 15 pro max,100000,135000,35000,1,00378,India
828627,2023-07-17,505,oven,18490,24000,5510,1,00378,India
469512,2023-07-17,504,iron,449,879,430,1,00199,India
469512,2023-07-17,506,monitor,3249,8000,4751,1,00199,India
100277,2023-07-17,506,monitor,3249,8000,4751,1,00227,India
100277,2023-07-17,502,iphone 15 pro max,100000,135000,35000,1,00227,India
110204,2023-07-17,507,washing machine,6990,16490,9500,1,00330,India
110204,2023-07-17,501,iphone 15,60000,80000,20000,1,00330,India
702490,2023-07-17,506,monitor,3249,8000,4751,1,00309,India
702490,2023-07-17,507,washing machine,6990,16490,9500,1,00309,India
702490,2023-07-17,501,iphone 15,60000,80000,20000,1,00309,India
702490,2023-07-17,504,iron,449,879,430,1,00309,India
314006,2023-07-17,505,oven,18490,24000,5510,1,00179,India
314006,2023-07-17,504,iron,449,879,430,1,00179,India
314006,2023-07-17,506,monitor,3249,8000,4751,1,00179,India
896228,2023-07-17,506,monitor,3249,8000,4751,1,00088,India
896228,2023-07-17,505,oven,18490,24000,5510,1,00088,India
255875,2023-07-17,503,mixer,1349,3249,1900,1,00174,India
255875,2023-07-17,507,washing machine,6990,16490,9500,1,00174,India
255875,2023-07-17,506,monitor,3249,8000,4751,1,00174,India
223244,2023-07-17,507,washing machine,6990,16490,9500,1,00364,India
223244,2023-07-17,504,iron,449,879,430,1,00364,India
223244,2023-07-17,506,monitor,3249,8000,4751,1,00364,India
223244,2023-07-17,502,iphone 15 pro max,100000,135000,35000,1,00364,India
404129,2023-07-17,505,oven,18490,24000,5510,1,00421,India
404129,2023-07-17,507,washing machine,6990,16490,9500,1,00421,India
404129,2023-07-17,502,iphone 15 pro max,100000,135000,35000,1,00421,India
404129,2023-07-17,503,mixer,1349,3249,1900,1,00421,India
845224,2023-07-17,501,iphone 15,60000,80000,20000,1,00245,India
845224,2023-07-17,504,iron,449,879,430,1,00245,India
526553,2023-07-17,503,mixer,1349,3249,1900,1,00163,India
602161,2023-07-17,506,monitor,3249,8000,4751,1,00152,India
602161,2023-07-17,502,iphone 15 pro max,100000,135000,35000,1,00152,India
975781,2023-07-17,503,mixer,1349,3249,1900,1,00006,India
975781,2023-07-17,507,washing machine,6990,16490,9500,1,00006,India
975781,2023-07-17,505,oven,18490,24000,5510,1,00006,India
975781,2023-07-17,502,iphone 15 pro max,100000,135000,35000,1,00006,India
279572,2023-07-17,505,oven,18490,24000,5510,1,00366,India
279572,2023-07-17,507,washing machine,6990,16490,9500,1,00366,India
279572,2023-07-17,503,mixer,1349,3249,1900,1,00366,India
279572,2023-07-17,506,monitor,3249,8000,4751,1,00366,India
666268,2023-07-17,504,iron,449,879,430,1,00009,India
666268,2023-07-17,507,washing machine,6990,16490,9500,1,00009,India
949850,2023-07-17,505,oven,18490,24000,5510,1,00412,India
949850,2023-07-17,501,iphone 15,60000,80000,20000,1,00412,India
584798,2023-07-17,507,washing machine,6990,16490,9500,1,00478,India
584798,2023-07-17,503,mixer,1349,3249,1900,1,00478,India
584798,2023-07-17,504,iron,449,879,430,1,00478,India
321027,2023-07-18,503,mixer,1349,3249,1900,1,00012,India
321027,2023-07-18,502,iphone 15 pro max,100000,135000,35000,1,00012,India
321027,2023-07-18,504,iron,449,879,430,1,00012,India
199157,2023-07-18,504,iron,449,879,430,1,00160,India
199157,2023-07-18,507,washing machine,6990,16490,9500,1,00160,India
199157,2023-07-18,503,mixer,1349,3249,1900,1,00160,India
442079,2023-07-18,507,washing machine,6990,16490,9500,1,00308,India
442079,2023-07-18,506,monitor,3249,8000,4751,1,00308,India
442079,2023-07-18,503,mixer,1349,3249,1900,1,00308,India
543974,2023-07-18,505,oven,18490,24000,5510,1,00186,India
543974,2023-07-18,503,mixer,1349,3249,1900,1,00186,India
942191,2023-07-18,502,iphone 15 pro max,100000,135000,35000,1,00452,India
942191,2023-07-18,501,iphone 15,60000,80000,20000,1,00452,India
386322,2023-07-18,505,oven,18490,24000,5510,1,00189,India
389614,2023-07-18,505,oven,18490,24000,5510,1,00157,India
389614,2023-07-18,502,iphone 15 pro max,100000,135000,35000,1,00157,India
601558,2023-07-18,507,washing machine,6990,16490,9500,1,00084,India
601558,2023-07-18,502,iphone 15 pro max,100000,135000,35000,1,00084,India
601558,2023-07-18,506,monitor,3249,8000,4751,1,00084,India
311037,2023-07-18,502,iphone 15 pro max,100000,135000,35000,1,00356,India
311037,2023-07-18,505,oven,18490,24000,5510,1,00356,India
581546,2023-07-18,507,washing machine,6990,16490,9500,1,00070,India
581546,2023-07-18,502,iphone 15 pro max,100000,135000,35000,1,00070,India
581546,2023-07-18,503,mixer,1349,3249,1900,1,00070,India
220942,2023-07-18,505,oven,18490,24000,5510,1,00374,India
224280,2023-07-18,506,monitor,3249,8000,4751,1,00093,India
224280,2023-07-18,501,iphone 15,60000,80000,20000,1,00093,India
150450,2023-07-18,506,monitor,3249,8000,4751,1,00464,India
138356,2023-07-18,506,monitor,3249,8000,4751,1,00070,India
138356,2023-07-18,501,iphone 15,60000,80000,20000,1,00070,India
138356,2023-07-18,505,oven,18490,24000,5510,1,00070,India
434037,2023-07-18,503,mixer,1349,3249,1900,1,00056,India
434037,2023-07-18,506,monitor,3249,8000,4751,1,00056,India
434037,2023-07-18,502,iphone 15 pro max,100000,135000,35000,1,00056,India
630109,2023-07-18,502,iphone 15 pro max,100000,135000,35000,1,00010,India
630109,2023-07-18,504,iron,449,879,430,1,00010,India
630109,2023-07-18,501,iphone 15,60000,80000,20000,1,00010,India
999127,2023-07-18,507,washing machine,6990,16490,9500,1,00153,India
999127,2023-07-18,506,monitor,3249,8000,4751,1,00153,India
922630,2023-07-18,502,iphone 15 pro max,100000,135000,35000,1,00100,India
922630,2023-07-18,504,iron,449,879,430,1,00100,India
980477,2023-07-18,506,monitor,3249,8000,4751,1,00299,India
980477,2023-07-18,507,washing machine,6990,16490,9500,1,00299,India
980477,2023-07-18,502,iphone 15 pro max,100000,135000,35000,1,00299,India
806946,2023-07-18,507,washing machine,6990,16490,9500,1,00232,India
806946,2023-07-18,504,iron,449,879,430,1,00232,India
588497,2023-07-18,507,washing machine,6990,16490,9500,1,00152,India
588497,2023-07-18,505,oven,18490,24000,5510,1,00152,India
588497,2023-07-18,503,mixer,1349,3249,1900,1,00152,India
479569,2023-07-18,503,mixer,1349,3249,1900,1,00105,India
479569,2023-07-18,501,iphone 15,60000,80000,20000,1,00105,India
641025,2023-07-18,504,iron,449,879,430,1,00405,India
641025,2023-07-18,505,oven,18490,24000,5510,1,00405,India
641025,2023-07-18,503,mixer,1349,3249,1900,1,00405,India
641025,2023-07-18,502,iphone 15 pro max,100000,135000,35000,1,00405,India
455541,2023-07-18,507,washing machine,6990,16490,9500,1,00370,India
455541,2023-07-18,503,mixer,1349,3249,1900,1,00370,India
925392,2023-07-18,505,oven,18490,24000,5510,1,00491,India
925392,2023-07-18,506,monitor,3249,8000,4751,1,00491,India
925392,2023-07-18,501,iphone 15,60000,80000,20000,1,00491,India
925392,2023-07-18,502,iphone 15 pro max,100000,135000,35000,1,00491,India
903187,2023-07-18,506,monitor,3249,8000,4751,1,00496,India
903187,2023-07-18,507,washing machine,6990,16490,9500,1,00496,India
903187,2023-07-18,501,iphone 15,60000,80000,20000,1,00496,India
929263,2023-07-18,501,iphone 15,60000,80000,20000,1,00473,India
929263,2023-07-18,504,iron,449,879,430,1,00473,India
929263,2023-07-18,507,washing machine,6990,16490,9500,1,00473,India
443301,2023-07-18,503,mixer,1349,3249,1900,1,00280,India
429061,2023-07-18,504,iron,449,879,430,1,00172,India
429061,2023-07-18,501,iphone 15,60000,80000,20000,1,00172,India
429061,2023-07-18,503,mixer,1349,3249,1900,1,00172,India
337431,2023-07-18,505,oven,18490,24000,5510,1,00035,India
337431,2023-07-18,507,washing machine,6990,16490,9500,1,00035,India
337431,2023-07-18,504,iron,449,879,430,1,00035,India
797442,2023-07-18,507,washing machine,6990,16490,9500,1,00077,India
797442,2023-07-18,502,iphone 15 pro max,100000,135000,35000,1,00077,India
797442,2023-07-18,506,monitor,3249,8000,4751,1,00077,India
797442,2023-07-18,505,oven,18490,24000,5510,1,00077,India
797442,2023-07-18,503,mixer,1349,3249,1900,1,00077,India
947117,2023-07-18,503,mixer,1349,3249,1900,1,00038,India
947117,2023-07-18,507,washing machine,6990,16490,9500,1,00038,India
947117,2023-07-18,505,oven,18490,24000,5510,1,00038,India
947117,2023-07-18,501,iphone 15,60000,80000,20000,1,00038,India
854849,2023-07-18,502,iphone 15 pro max,100000,135000,35000,1,00439,India
854849,2023-07-18,507,washing machine,6990,16490,9500,1,00439,India
854849,2023-07-18,506,monitor,3249,8000,4751,1,00439,India
548955,2023-07-18,505,oven,18490,24000,5510,1,00164,India
548955,2023-07-18,502,iphone 15 pro max,100000,135000,35000,1,00164,India
548955,2023-07-18,507,washing machine,6990,16490,9500,1,00164,India
548955,2023-07-18,501,iphone 15,60000,80000,20000,1,00164,India
560751,2023-07-18,501,iphone 15,60000,80000,20000,1,00462,India
560751,2023-07-18,506,monitor,3249,8000,4751,1,00462,India
560751,2023-07-18,503,mixer,1349,3249,1900,1,00462,India
604562,2023-07-18,506,monitor,3249,8000,4751,1,00246,India
448727,2023-07-18,503,mixer,1349,3249,1900,1,00332,India
389187,2023-07-18,504,iron,449,879,430,1,00380,India
389187,2023-07-18,506,monitor,3249,8000,4751,1,00380,India
660763,2023-07-18,501,iphone 15,60000,80000,20000,1,00315,India
660763,2023-07-18,505,oven,18490,24000,5510,1,00315,India
660763,2023-07-18,504,iron,449,879,430,1,00315,India
554071,2023-07-18,504,iron,449,879,430,1,00260,India
554071,2023-07-18,501,iphone 15,60000,80000,20000,1,00260,India
554071,2023-07-18,505,oven,18490,24000,5510,1,00260,India
234044,2023-07-18,502,iphone 15 pro max,100000,135000,35000,1,00089,India
234044,2023-07-18,504,iron,449,879,430,1,00089,India
234044,2023-07-18,505,oven,18490,24000,5510,1,00089,India
519820,2023-07-18,505,oven,18490,24000,5510,1,00261,India
154083,2023-07-18,501,iphone 15,60000,80000,20000,1,00122,India
154083,2023-07-18,506,monitor,3249,8000,4751,1,00122,India
154083,2023-07-18,507,washing machine,6990,16490,9500,1,00122,India
154083,2023-07-18,503,mixer,1349,3249,1900,1,00122,India
403239,2023-07-18,503,mixer,1349,3249,1900,1,00488,India
403239,2023-07-18,505,oven,18490,24000,5510,1,00488,India
403239,2023-07-18,502,iphone 15 pro max,100000,135000,35000,1,00488,India
403239,2023-07-18,501,iphone 15,60000,80000,20000,1,00488,India
201768,2023-07-18,507,washing machine,6990,16490,9500,1,00227,India
563562,2023-07-18,504,iron,449,879,430,1,00237,India
678401,2023-07-18,503,mixer,1349,3249,1900,1,00229,India
678401,2023-07-18,502,iphone 15 pro max,100000,135000,35000,1,00229,India
829654,2023-07-18,506,monitor,3249,8000,4751,1,00180,India
829654,2023-07-18,504,iron,449,879,430,1,00180,India
271562,2023-07-18,501,iphone 15,60000,80000,20000,1,00297,India
840997,2023-07-18,502,iphone 15 pro max,100000,135000,35000,1,00283,India
580020,2023-07-18,501,iphone 15,60000,80000,20000,1,00273,India
580020,2023-07-18,507,washing machine,6990,16490,9500,1,00273,India
580020,2023-07-18,505,oven,18490,24000,5510,1,00273,India
239650,2023-07-18,505,oven,18490,24000,5510,1,00150,India
239650,2023-07-18,502,iphone 15 pro max,100000,135000,35000,1,00150,India
239650,2023-07-18,504,iron,449,879,430,1,00150,India
239650,2023-07-18,506,monitor,3249,8000,4751,1,00150,India
723922,2023-07-18,501,iphone 15,60000,80000,20000,1,00003,India
723922,2023-07-18,507,washing machine,6990,16490,9500,1,00003,India
723922,2023-07-18,505,oven,18490,24000,5510,1,00003,India
723922,2023-07-18,503,mixer,1349,3249,1900,1,00003,India
698570,2023-07-18,507,washing machine,6990,16490,9500,1,00304,India
698570,2023-07-18,502,iphone 15 pro max,100000,135000,35000,1,00304,India
698570,2023-07-18,505,oven,18490,24000,5510,1,00304,India
698570,2023-07-18,503,mixer,1349,3249,1900,1,00304,India
751826,2023-07-18,502,iphone 15 pro max,100000,135000,35000,1,00115,India
751826,2023-07-18,505,oven,18490,24000,5510,1,00115,India
751826,2023-07-18,507,washing machine,6990,16490,9500,1,00115,India
751826,2023-07-18,506,monitor,3249,8000,4751,1,00115,India
908258,2023-07-18,503,mixer,1349,3249,1900,1,00490,India
908258,2023-07-18,506,monitor,3249,8000,4751,1,00490,India
624719,2023-07-18,506,monitor,3249,8000,4751,1,00255,India
624719,2023-07-18,504,iron,449,879,430,1,00255,India
624719,2023-07-18,501,iphone 15,60000,80000,20000,1,00255,India
374640,2023-07-18,507,washing machine,6990,16490,9500,1,00152,India
374640,2023-07-18,504,iron,449,879,430,1,00152,India
688028,2023-07-18,507,washing machine,6990,16490,9500,1,00256,India
688028,2023-07-18,506,monitor,3249,8000,4751,1,00256,India
304129,2023-07-18,502,iphone 15 pro max,100000,135000,35000,1,00441,India
304129,2023-07-18,505,oven,18490,24000,5510,1,00441,India
576578,2023-07-18,506,monitor,3249,8000,4751,1,00098,India
576578,2023-07-18,507,washing machine,6990,16490,9500,1,00098,India
576578,2023-07-18,501,iphone 15,60000,80000,20000,1,00098,India
958666,2023-07-18,504,iron,449,879,430,1,00279,India
958666,2023-07-18,507,washing machine,6990,16490,9500,1,00279,India
540645,2023-07-18,504,iron,449,879,430,1,00067,India
540645,2023-07-18,503,mixer,1349,3249,1900,1,00067,India
540645,2023-07-18,502,iphone 15 pro max,100000,135000,35000,1,00067,India
540645,2023-07-18,501,iphone 15,60000,80000,20000,1,00067,India
480997,2023-07-18,505,oven,18490,24000,5510,1,00145,India
546151,2023-07-18,502,iphone 15 pro max,100000,135000,35000,1,00176,India
546151,2023-07-18,505,oven,18490,24000,5510,1,00176,India
546151,2023-07-18,503,mixer,1349,3249,1900,1,00176,India
377258,2023-07-18,502,iphone 15 pro max,100000,135000,35000,1,00083,India
377258,2023-07-18,504,iron,449,879,430,1,00083,India
678971,2023-07-18,506,monitor,3249,8000,4751,1,00271,India
678971,2023-07-18,507,washing machine,6990,16490,9500,1,00271,India
678971,2023-07-18,501,iphone 15,60000,80000,20000,1,00271,India
663312,2023-07-18,507,washing machine,6990,16490,9500,1,00036,India
663312,2023-07-18,505,oven,18490,24000,5510,1,00036,India
405309,2023-07-18,502,iphone 15 pro max,100000,135000,35000,1,00198,India
405309,2023-07-18,506,monitor,3249,8000,4751,1,00198,India
215621,2023-07-18,502,iphone 15 pro max,100000,135000,35000,1,00004,India
215621,2023-07-18,507,washing machine,6990,16490,9500,1,00004,India
215621,2023-07-18,504,iron,449,879,430,1,00004,India
378242,2023-07-18,506,monitor,3249,8000,4751,1,00118,India
825230,2023-07-18,504,iron,449,879,430,1,00191,India
825230,2023-07-18,503,mixer,1349,3249,1900,1,00191,India
845853,2023-07-18,503,mixer,1349,3249,1900,1,00413,India
845853,2023-07-18,504,iron,449,879,430,1,00413,India
845853,2023-07-18,506,monitor,3249,8000,4751,1,00413,India
845853,2023-07-18,502,iphone 15 pro max,100000,135000,35000,1,00413,India
845853,2023-07-18,501,iphone 15,60000,80000,20000,1,00413,India
677125,2023-07-18,502,iphone 15 pro max,100000,135000,35000,1,00364,India
677125,2023-07-18,507,washing machine,6990,16490,9500,1,00364,India
677125,2023-07-18,501,iphone 15,60000,80000,20000,1,00364,India
353955,2023-07-18,502,iphone 15 pro max,100000,135000,35000,1,00248,India
370659,2023-07-18,505,oven,18490,24000,5510,1,00232,India
370659,2023-07-18,503,mixer,1349,3249,1900,1,00232,India
422341,2023-07-18,506,monitor,3249,8000,4751,1,00374,India
422341,2023-07-18,503,mixer,1349,3249,1900,1,00374,India
422341,2023-07-18,501,iphone 15,60000,80000,20000,1,00374,India
422341,2023-07-18,502,iphone 15 pro max,100000,135000,35000,1,00374,India
140835,2023-07-18,502,iphone 15 pro max,100000,135000,35000,1,00274,India
140835,2023-07-18,507,washing machine,6990,16490,9500,1,00274,India
140835,2023-07-18,504,iron,449,879,430,1,00274,India
140835,2023-07-18,505,oven,18490,24000,5510,1,00274,India
355251,2023-07-18,501,iphone 15,60000,80000,20000,1,00203,India
355251,2023-07-18,507,washing machine,6990,16490,9500,1,00203,India
721510,2023-07-18,503,mixer,1349,3249,1900,1,00439,India
318967,2023-07-18,506,monitor,3249,8000,4751,1,00323,India
637981,2023-07-18,503,mixer,1349,3249,1900,1,00086,India
965344,2023-07-18,507,washing machine,6990,16490,9500,1,00142,India
965344,2023-07-18,504,iron,449,879,430,1,00142,India
965344,2023-07-18,502,iphone 15 pro max,100000,135000,35000,1,00142,India
965344,2023-07-18,501,iphone 15,60000,80000,20000,1,00142,India
566838,2023-07-18,501,iphone 15,60000,80000,20000,1,00376,India
231590,2023-07-18,505,oven,18490,24000,5510,1,00367,India
361988,2023-07-18,501,iphone 15,60000,80000,20000,1,00364,India
361988,2023-07-18,506,monitor,3249,8000,4751,1,00364,India
361988,2023-07-18,504,iron,449,879,430,1,00364,India
361988,2023-07-18,503,mixer,1349,3249,1900,1,00364,India
269719,2023-07-18,506,monitor,3249,8000,4751,1,00449,India
269719,2023-07-18,504,iron,449,879,430,1,00449,India
689660,2023-07-18,504,iron,449,879,430,1,00068,India
689660,2023-07-18,507,washing machine,6990,16490,9500,1,00068,India
689660,2023-07-18,505,oven,18490,24000,5510,1,00068,India
689660,2023-07-18,502,iphone 15 pro max,100000,135000,35000,1,00068,India
994366,2023-07-18,505,oven,18490,24000,5510,1,00330,India
994366,2023-07-18,502,iphone 15 pro max,100000,135000,35000,1,00330,India
402490,2023-07-18,501,iphone 15,60000,80000,20000,1,00498,India
402490,2023-07-18,503,mixer,1349,3249,1900,1,00498,India
221823,2023-07-18,505,oven,18490,24000,5510,1,00448,India
221823,2023-07-18,506,monitor,3249,8000,4751,1,00448,India
602827,2023-07-18,503,mixer,1349,3249,1900,1,00056,India
602827,2023-07-18,506,monitor,3249,8000,4751,1,00056,India
164959,2023-07-18,502,iphone 15 pro max,100000,135000,35000,1,00192,India
164959,2023-07-18,507,washing machine,6990,16490,9500,1,00192,India
164959,2023-07-18,504,iron,449,879,430,1,00192,India
144110,2023-07-19,501,iphone 15,60000,80000,20000,1,00337,India
458855,2023-07-19,504,iron,449,879,430,1,00213,India
458855,2023-07-19,501,iphone 15,60000,80000,20000,1,00213,India
458855,2023-07-19,507,washing machine,6990,16490,9500,1,00213,India
882553,2023-07-19,505,oven,18490,24000,5510,1,00261,India
882553,2023-07-19,507,washing machine,6990,16490,9500,1,00261,India
121681,2023-07-19,504,iron,449,879,430,1,00113,India
121681,2023-07-19,505,oven,18490,24000,5510,1,00113,India
121681,2023-07-19,503,mixer,1349,3249,1900,1,00113,India
273746,2023-07-19,506,monitor,3249,8000,4751,1,00120,India
273746,2023-07-19,507,washing machine,6990,16490,9500,1,00120,India
273746,2023-07-19,504,iron,449,879,430,1,00120,India
273746,2023-07-19,503,mixer,1349,3249,1900,1,00120,India
194793,2023-07-19,502,iphone 15 pro max,100000,135000,35000,1,00189,India
194793,2023-07-19,507,washing machine,6990,16490,9500,1,00189,India
194793,2023-07-19,504,iron,449,879,430,1,00189,India
943529,2023-07-19,506,monitor,3249,8000,4751,1,00305,India
943529,2023-07-19,507,washing machine,6990,16490,9500,1,00305,India
943529,2023-07-19,503,mixer,1349,3249,1900,1,00305,India
951531,2023-07-19,506,monitor,3249,8000,4751,1,00369,India
951531,2023-07-19,501,iphone 15,60000,80000,20000,1,00369,India
951531,2023-07-19,505,oven,18490,24000,5510,1,00369,India
415416,2023-07-19,502,iphone 15 pro max,100000,135000,35000,1,00016,India
415416,2023-07-19,507,washing machine,6990,16490,9500,1,00016,India
415416,2023-07-19,503,mixer,1349,3249,1900,1,00016,India
807993,2023-07-19,503,mixer,1349,3249,1900,1,00099,India
354400,2023-07-19,507,washing machine,6990,16490,9500,1,00466,India
109303,2023-07-19,507,washing machine,6990,16490,9500,1,00292,India
680551,2023-07-19,501,iphone 15,60000,80000,20000,1,00369,India
680551,2023-07-19,504,iron,449,879,430,1,00369,India
386312,2023-07-19,501,iphone 15,60000,80000,20000,1,00200,India
386312,2023-07-19,504,iron,449,879,430,1,00200,India
386312,2023-07-19,503,mixer,1349,3249,1900,1,00200,India
386312,2023-07-19,502,iphone 15 pro max,100000,135000,35000,1,00200,India
961022,2023-07-19,503,mixer,1349,3249,1900,1,00085,India
961022,2023-07-19,505,oven,18490,24000,5510,1,00085,India
961022,2023-07-19,507,washing machine,6990,16490,9500,1,00085,India
614621,2023-07-19,505,oven,18490,24000,5510,1,00383,India
614621,2023-07-19,503,mixer,1349,3249,1900,1,00383,India
972705,2023-07-19,507,washing machine,6990,16490,9500,1,00492,India
972705,2023-07-19,503,mixer,1349,3249,1900,1,00492,India
972705,2023-07-19,505,oven,18490,24000,5510,1,00492,India
972705,2023-07-19,502,iphone 15 pro max,100000,135000,35000,1,00492,India
972705,2023-07-19,501,iphone 15,60000,80000,20000,1,00492,India
107592,2023-07-19,501,iphone 15,60000,80000,20000,1,00040,India
107592,2023-07-19,504,iron,449,879,430,1,00040,India
618181,2023-07-19,502,iphone 15 pro max,100000,135000,35000,1,00370,India
806714,2023-07-19,506,monitor,3249,8000,4751,1,00179,India
303654,2023-07-19,505,oven,18490,24000,5510,1,00480,India
303654,2023-07-19,506,monitor,3249,8000,4751,1,00480,India
303654,2023-07-19,501,iphone 15,60000,80000,20000,1,00480,India
581589,2023-07-19,503,mixer,1349,3249,1900,1,00468,India
293398,2023-07-19,503,mixer,1349,3249,1900,1,00445,India
683394,2023-07-19,507,washing machine,6990,16490,9500,1,00127,India
683394,2023-07-19,502,iphone 15 pro max,100000,135000,35000,1,00127,India
683394,2023-07-19,505,oven,18490,24000,5510,1,00127,India
923645,2023-07-19,504,iron,449,879,430,1,00072,India
923645,2023-07-19,501,iphone 15,60000,80000,20000,1,00072,India
234714,2023-07-19,501,iphone 15,60000,80000,20000,1,00017,India
234714,2023-07-19,506,monitor,3249,8000,4751,1,00017,India
431213,2023-07-19,504,iron,449,879,430,1,00229,India
926301,2023-07-19,507,washing machine,6990,16490,9500,1,00029,India
932415,2023-07-19,506,monitor,3249,8000,4751,1,00255,India
932415,2023-07-19,507,washing machine,6990,16490,9500,1,00255,India
437664,2023-07-19,505,oven,18490,24000,5510,1,00221,India
211975,2023-07-19,504,iron,449,879,430,1,00278,India
211975,2023-07-19,507,washing machine,6990,16490,9500,1,00278,India
285042,2023-07-19,502,iphone 15 pro max,100000,135000,35000,1,00445,India
183314,2023-07-19,502,iphone 15 pro max,100000,135000,35000,1,00003,India
183314,2023-07-19,507,washing machine,6990,16490,9500,1,00003,India
367530,2023-07-19,507,washing machine,6990,16490,9500,1,00396,India
367530,2023-07-19,501,iphone 15,60000,80000,20000,1,00396,India
395620,2023-07-19,506,monitor,3249,8000,4751,1,00017,India
395620,2023-07-19,507,washing machine,6990,16490,9500,1,00017,India
395620,2023-07-19,503,mixer,1349,3249,1900,1,00017,India
377263,2023-07-19,505,oven,18490,24000,5510,1,00215,India
377263,2023-07-19,502,iphone 15 pro max,100000,135000,35000,1,00215,India
419452,2023-07-19,506,monitor,3249,8000,4751,1,00421,India
419452,2023-07-19,507,washing machine,6990,16490,9500,1,00421,India
211778,2023-07-19,503,mixer,1349,3249,1900,1,00099,India
332453,2023-07-19,504,iron,449,879,430,1,00347,India
332453,2023-07-19,506,monitor,3249,8000,4751,1,00347,India
332453,2023-07-19,501,iphone 15,60000,80000,20000,1,00347,India
332453,2023-07-19,502,iphone 15 pro max,100000,135000,35000,1,00347,India
435433,2023-07-19,501,iphone 15,60000,80000,20000,1,00299,India
435433,2023-07-19,502,iphone 15 pro max,100000,135000,35000,1,00299,India
462269,2023-07-19,506,monitor,3249,8000,4751,1,00011,India
462269,2023-07-19,501,iphone 15,60000,80000,20000,1,00011,India
250977,2023-07-19,503,mixer,1349,3249,1900,1,00206,India
250977,2023-07-19,504,iron,449,879,430,1,00206,India
506616,2023-07-19,506,monitor,3249,8000,4751,1,00028,India
506616,2023-07-19,505,oven,18490,24000,5510,1,00028,India
439603,2023-07-19,502,iphone 15 pro max,100000,135000,35000,1,00191,India
439603,2023-07-19,503,mixer,1349,3249,1900,1,00191,India
169130,2023-07-19,502,iphone 15 pro max,100000,135000,35000,1,00006,India
169130,2023-07-19,506,monitor,3249,8000,4751,1,00006,India
659792,2023-07-19,504,iron,449,879,430,1,00326,India
659792,2023-07-19,505,oven,18490,24000,5510,1,00326,India
879297,2023-07-19,504,iron,449,879,430,1,00107,India
485987,2023-07-19,503,mixer,1349,3249,1900,1,00200,India
485987,2023-07-19,505,oven,18490,24000,5510,1,00200,India
485987,2023-07-19,507,washing machine,6990,16490,9500,1,00200,India
607815,2023-07-19,506,monitor,3249,8000,4751,1,00273,India
607815,2023-07-19,504,iron,449,879,430,1,00273,India
607815,2023-07-19,502,iphone 15 pro max,100000,135000,35000,1,00273,India
435266,2023-07-19,502,iphone 15 pro max,100000,135000,35000,1,00360,India
435266,2023-07-19,506,monitor,3249,8000,4751,1,00360,India
435266,2023-07-19,504,iron,449,879,430,1,00360,India
517213,2023-07-19,502,iphone 15 pro max,100000,135000,35000,1,00423,India
517213,2023-07-19,505,oven,18490,24000,5510,1,00423,India
517213,2023-07-19,507,washing machine,6990,16490,9500,1,00423,India
918722,2023-07-19,507,washing machine,6990,16490,9500,1,00248,India
918722,2023-07-19,503,mixer,1349,3249,1900,1,00248,India
918722,2023-07-19,505,oven,18490,24000,5510,1,00248,India
894512,2023-07-19,507,washing machine,6990,16490,9500,1,00321,India
171223,2023-07-19,505,oven,18490,24000,5510,1,00422,India
898411,2023-07-19,507,washing machine,6990,16490,9500,1,00348,India
898411,2023-07-19,502,iphone 15 pro max,100000,135000,35000,1,00348,India
598911,2023-07-19,507,washing machine,6990,16490,9500,1,00285,India
598911,2023-07-19,502,iphone 15 pro max,100000,135000,35000,1,00285,India
598911,2023-07-19,505,oven,18490,24000,5510,1,00285,India
243859,2023-07-19,504,iron,449,879,430,1,00002,India
243859,2023-07-19,505,oven,18490,24000,5510,1,00002,India
243859,2023-07-19,506,monitor,3249,8000,4751,1,00002,India
243859,2023-07-19,501,iphone 15,60000,80000,20000,1,00002,India
107540,2023-07-19,503,mixer,1349,3249,1900,1,00007,India
107540,2023-07-19,506,monitor,3249,8000,4751,1,00007,India
107540,2023-07-19,504,iron,449,879,430,1,00007,India
107540,2023-07-19,502,iphone 15 pro max,100000,135000,35000,1,00007,India
586107,2023-07-19,507,washing machine,6990,16490,9500,1,00147,India
586107,2023-07-19,506,monitor,3249,8000,4751,1,00147,India
586107,2023-07-19,504,iron,449,879,430,1,00147,India
964141,2023-07-19,505,oven,18490,24000,5510,1,00407,India
964141,2023-07-19,501,iphone 15,60000,80000,20000,1,00407,India
964141,2023-07-19,502,iphone 15 pro max,100000,135000,35000,1,00407,India
498833,2023-07-19,501,iphone 15,60000,80000,20000,1,00360,India
498833,2023-07-19,505,oven,18490,24000,5510,1,00360,India
498833,2023-07-19,503,mixer,1349,3249,1900,1,00360,India
498833,2023-07-19,506,monitor,3249,8000,4751,1,00360,India
584029,2023-07-19,503,mixer,1349,3249,1900,1,00023,India
801304,2023-07-19,506,monitor,3249,8000,4751,1,00356,India
801304,2023-07-19,505,oven,18490,24000,5510,1,00356,India
801304,2023-07-19,501,iphone 15,60000,80000,20000,1,00356,India
471691,2023-07-19,506,monitor,3249,8000,4751,1,00136,India
471691,2023-07-19,503,mixer,1349,3249,1900,1,00136,India
471691,2023-07-19,507,washing machine,6990,16490,9500,1,00136,India
549746,2023-07-19,501,iphone 15,60000,80000,20000,1,00021,India
317133,2023-07-19,504,iron,449,879,430,1,00012,India
783702,2023-07-19,505,oven,18490,24000,5510,1,00235,India
783702,2023-07-19,502,iphone 15 pro max,100000,135000,35000,1,00235,India
783702,2023-07-19,507,washing machine,6990,16490,9500,1,00235,India
783702,2023-07-19,501,iphone 15,60000,80000,20000,1,00235,India
967705,2023-07-19,507,washing machine,6990,16490,9500,1,00398,India
967705,2023-07-19,504,iron,449,879,430,1,00398,India
967705,2023-07-19,502,iphone 15 pro max,100000,135000,35000,1,00398,India
899439,2023-07-19,507,washing machine,6990,16490,9500,1,00437,India
899439,2023-07-19,501,iphone 15,60000,80000,20000,1,00437,India
899439,2023-07-19,502,iphone 15 pro max,100000,135000,35000,1,00437,India
376423,2023-07-19,502,iphone 15 pro max,100000,135000,35000,1,00397,India
424756,2023-07-19,501,iphone 15,60000,80000,20000,1,00332,India
424756,2023-07-19,506,monitor,3249,8000,4751,1,00332,India
424756,2023-07-19,504,iron,449,879,430,1,00332,India
424756,2023-07-19,503,mixer,1349,3249,1900,1,00332,India
760414,2023-07-19,501,iphone 15,60000,80000,20000,1,00395,India
760414,2023-07-19,506,monitor,3249,8000,4751,1,00395,India
276981,2023-07-19,503,mixer,1349,3249,1900,1,00447,India
276981,2023-07-19,507,washing machine,6990,16490,9500,1,00447,India
276981,2023-07-19,501,iphone 15,60000,80000,20000,1,00447,India
123781,2023-07-19,505,oven,18490,24000,5510,1,00480,India
123781,2023-07-19,502,iphone 15 pro max,100000,135000,35000,1,00480,India
419591,2023-07-19,502,iphone 15 pro max,100000,135000,35000,1,00463,India
403211,2023-07-19,504,iron,449,879,430,1,00304,India
403211,2023-07-19,507,washing machine,6990,16490,9500,1,00304,India
599847,2023-07-19,505,oven,18490,24000,5510,1,00184,India
112046,2023-07-19,504,iron,449,879,430,1,00480,India
112046,2023-07-19,503,mixer,1349,3249,1900,1,00480,India
112046,2023-07-19,501,iphone 15,60000,80000,20000,1,00480,India
144058,2023-07-19,506,monitor,3249,8000,4751,1,00004,India
242858,2023-07-19,503,mixer,1349,3249,1900,1,00270,India
242858,2023-07-19,507,washing machine,6990,16490,9500,1,00270,India
242858,2023-07-19,501,iphone 15,60000,80000,20000,1,00270,India
242858,2023-07-19,504,iron,449,879,430,1,00270,India
634840,2023-07-19,503,mixer,1349,3249,1900,1,00215,India
161007,2023-07-19,505,oven,18490,24000,5510,1,00044,India
161007,2023-07-19,501,iphone 15,60000,80000,20000,1,00044,India
161007,2023-07-19,502,iphone 15 pro max,100000,135000,35000,1,00044,India
671947,2023-07-19,504,iron,449,879,430,1,00351,India
271840,2023-07-19,505,oven,18490,24000,5510,1,00209,India
746365,2023-07-19,505,oven,18490,24000,5510,1,00381,India
746365,2023-07-19,502,iphone 15 pro max,100000,135000,35000,1,00381,India
400016,2023-07-20,505,oven,18490,24000,5510,1,00021,India
400016,2023-07-20,504,iron,449,879,430,1,00021,India
559761,2023-07-20,501,iphone 15,60000,80000,20000,1,00041,India
559761,2023-07-20,502,iphone 15 pro max,100000,135000,35000,1,00041,India
123697,2023-07-20,504,iron,449,879,430,1,00117,India
123697,2023-07-20,507,washing machine,6990,16490,9500,1,00117,India
340667,2023-07-20,504,iron,449,879,430,1,00101,India
340667,2023-07-20,501,iphone 15,60000,80000,20000,1,00101,India
941847,2023-07-20,503,mixer,1349,3249,1900,1,00133,India
960643,2023-07-20,507,washing machine,6990,16490,9500,1,00164,India
959002,2023-07-20,502,iphone 15 pro max,100000,135000,35000,1,00001,India
959002,2023-07-20,503,mixer,1349,3249,1900,1,00001,India
690000,2023-07-20,503,mixer,1349,3249,1900,1,00479,India
690000,2023-07-20,504,iron,449,879,430,1,00479,India
451444,2023-07-20,506,monitor,3249,8000,4751,1,00152,India
451444,2023-07-20,502,iphone 15 pro max,100000,135000,35000,1,00152,India
451444,2023-07-20,507,washing machine,6990,16490,9500,1,00152,India
434057,2023-07-20,507,washing machine,6990,16490,9500,1,00131,India
434057,2023-07-20,506,monitor,3249,8000,4751,1,00131,India
902753,2023-07-20,504,iron,449,879,430,1,00424,India
412187,2023-07-20,503,mixer,1349,3249,1900,1,00280,India
412187,2023-07-20,504,iron,449,879,430,1,00280,India
412187,2023-07-20,502,iphone 15 pro max,100000,135000,35000,1,00280,India
392495,2023-07-20,502,iphone 15 pro max,100000,135000,35000,1,00113,India
392495,2023-07-20,505,oven,18490,24000,5510,1,00113,India
392495,2023-07-20,506,monitor,3249,8000,4751,1,00113,India
871881,2023-07-20,503,mixer,1349,3249,1900,1,00045,India
978057,2023-07-20,501,iphone 15,60000,80000,20000,1,00082,India
586101,2023-07-20,502,iphone 15 pro max,100000,135000,35000,1,00274,India
586101,2023-07-20,506,monitor,3249,8000,4751,1,00274,India
586101,2023-07-20,501,iphone 15,60000,80000,20000,1,00274,India
586101,2023-07-20,503,mixer,1349,3249,1900,1,00274,India
135843,2023-07-20,504,iron,449,879,430,1,00495,India
135843,2023-07-20,501,iphone 15,60000,80000,20000,1,00495,India
613776,2023-07-20,502,iphone 15 pro max,100000,135000,35000,1,00263,India
613776,2023-07-20,504,iron,449,879,430,1,00263,India
902306,2023-07-20,505,oven,18490,24000,5510,1,00385,India
902306,2023-07-20,501,iphone 15,60000,80000,20000,1,00385,India
717293,2023-07-20,501,iphone 15,60000,80000,20000,1,00001,India
571096,2023-07-20,501,iphone 15,60000,80000,20000,1,00371,India
960488,2023-07-20,501,iphone 15,60000,80000,20000,1,00220,India
960488,2023-07-20,504,iron,449,879,430,1,00220,India
960488,2023-07-20,506,monitor,3249,8000,4751,1,00220,India
960488,2023-07-20,503,mixer,1349,3249,1900,1,00220,India
960488,2023-07-20,505,oven,18490,24000,5510,1,00220,India
166298,2023-07-20,507,washing machine,6990,16490,9500,1,00037,India
166298,2023-07-20,506,monitor,3249,8000,4751,1,00037,India
244247,2023-07-20,501,iphone 15,60000,80000,20000,1,00101,India
244247,2023-07-20,507,washing machine,6990,16490,9500,1,00101,India
244247,2023-07-20,503,mixer,1349,3249,1900,1,00101,India
179686,2023-07-20,501,iphone 15,60000,80000,20000,1,00095,India
179686,2023-07-20,507,washing machine,6990,16490,9500,1,00095,India
852077,2023-07-20,502,iphone 15 pro max,100000,135000,35000,1,00275,India
750877,2023-07-20,503,mixer,1349,3249,1900,1,00210,India
750877,2023-07-20,506,monitor,3249,8000,4751,1,00210,India
750877,2023-07-20,502,iphone 15 pro max,100000,135000,35000,1,00210,India
788485,2023-07-20,506,monitor,3249,8000,4751,1,00091,India
788485,2023-07-20,507,washing machine,6990,16490,9500,1,00091,India
788485,2023-07-20,504,iron,449,879,430,1,00091,India
181442,2023-07-20,504,iron,449,879,430,1,00042,India
181442,2023-07-20,507,washing machine,6990,16490,9500,1,00042,India
181442,2023-07-20,502,iphone 15 pro max,100000,135000,35000,1,00042,India
181442,2023-07-20,505,oven,18490,24000,5510,1,00042,India
891232,2023-07-20,505,oven,18490,24000,5510,1,00120,India
891232,2023-07-20,503,mixer,1349,3249,1900,1,00120,India
891232,2023-07-20,502,iphone 15 pro max,100000,135000,35000,1,00120,India
891232,2023-07-20,506,monitor,3249,8000,4751,1,00120,India
519301,2023-07-20,502,iphone 15 pro max,100000,135000,35000,1,00321,India
519301,2023-07-20,503,mixer,1349,3249,1900,1,00321,India
519301,2023-07-20,504,iron,449,879,430,1,00321,India
690658,2023-07-20,503,mixer,1349,3249,1900,1,00463,India
690658,2023-07-20,504,iron,449,879,430,1,00463,India
690658,2023-07-20,506,monitor,3249,8000,4751,1,00463,India
883331,2023-07-20,505,oven,18490,24000,5510,1,00092,India
883331,2023-07-20,501,iphone 15,60000,80000,20000,1,00092,India
883331,2023-07-20,506,monitor,3249,8000,4751,1,00092,India
883331,2023-07-20,503,mixer,1349,3249,1900,1,00092,India
810377,2023-07-20,507,washing machine,6990,16490,9500,1,00341,India
810377,2023-07-20,504,iron,449,879,430,1,00341,India
810377,2023-07-20,503,mixer,1349,3249,1900,1,00341,India
810377,2023-07-20,502,iphone 15 pro max,100000,135000,35000,1,00341,India
255097,2023-07-20,501,iphone 15,60000,80000,20000,1,00168,India
703884,2023-07-20,506,monitor,3249,8000,4751,1,00393,India
703884,2023-07-20,503,mixer,1349,3249,1900,1,00393,India
703884,2023-07-20,507,washing machine,6990,16490,9500,1,00393,India
811746,2023-07-20,504,iron,449,879,430,1,00289,India
811746,2023-07-20,507,washing machine,6990,16490,9500,1,00289,India
150675,2023-07-20,501,iphone 15,60000,80000,20000,1,00323,India
218948,2023-07-20,506,monitor,3249,8000,4751,1,00142,India
218948,2023-07-20,507,washing machine,6990,16490,9500,1,00142,India
271059,2023-07-20,506,monitor,3249,8000,4751,1,00454,India
271059,2023-07-20,507,washing machine,6990,16490,9500,1,00454,India
750737,2023-07-20,507,washing machine,6990,16490,9500,1,00472,India
750737,2023-07-20,501,iphone 15,60000,80000,20000,1,00472,India
750737,2023-07-20,502,iphone 15 pro max,100000,135000,35000,1,00472,India
199035,2023-07-20,503,mixer,1349,3249,1900,1,00110,India
199035,2023-07-20,501,iphone 15,60000,80000,20000,1,00110,India
199035,2023-07-20,506,monitor,3249,8000,4751,1,00110,India
684197,2023-07-20,502,iphone 15 pro max,100000,135000,35000,1,00346,India
684197,2023-07-20,503,mixer,1349,3249,1900,1,00346,India
684197,2023-07-20,504,iron,449,879,430,1,00346,India
684197,2023-07-20,507,washing machine,6990,16490,9500,1,00346,India
123013,2023-07-20,504,iron,449,879,430,1,00077,India
677057,2023-07-20,507,washing machine,6990,16490,9500,1,00455,India
546967,2023-07-20,505,oven,18490,24000,5510,1,00472,India
546967,2023-07-20,503,mixer,1349,3249,1900,1,00472,India
303588,2023-07-20,503,mixer,1349,3249,1900,1,00389,India
303588,2023-07-20,506,monitor,3249,8000,4751,1,00389,India
755679,2023-07-20,503,mixer,1349,3249,1900,1,00264,India
635148,2023-07-20,502,iphone 15 pro max,100000,135000,35000,1,00151,India
635148,2023-07-20,507,washing machine,6990,16490,9500,1,00151,India
635148,2023-07-20,503,mixer,1349,3249,1900,1,00151,India
908669,2023-07-20,504,iron,449,879,430,1,00230,India
908669,2023-07-20,503,mixer,1349,3249,1900,1,00230,India
231890,2023-07-20,504,iron,449,879,430,1,00132,India
400110,2023-07-20,501,iphone 15,60000,80000,20000,1,00469,India
400110,2023-07-20,507,washing machine,6990,16490,9500,1,00469,India
931056,2023-07-20,501,iphone 15,60000,80000,20000,1,00348,India
896158,2023-07-20,505,oven,18490,24000,5510,1,00199,India
896158,2023-07-20,507,washing machine,6990,16490,9500,1,00199,India
896158,2023-07-20,506,monitor,3249,8000,4751,1,00199,India
896158,2023-07-20,502,iphone 15 pro max,100000,135000,35000,1,00199,India
791351,2023-07-20,505,oven,18490,24000,5510,1,00128,India
791351,2023-07-20,507,washing machine,6990,16490,9500,1,00128,India
791351,2023-07-20,504,iron,449,879,430,1,00128,India
791351,2023-07-20,506,monitor,3249,8000,4751,1,00128,India
791080,2023-07-20,505,oven,18490,24000,5510,1,00051,India
791080,2023-07-20,506,monitor,3249,8000,4751,1,00051,India
791080,2023-07-20,502,iphone 15 pro max,100000,135000,35000,1,00051,India
791080,2023-07-20,501,iphone 15,60000,80000,20000,1,00051,India
518332,2023-07-20,506,monitor,3249,8000,4751,1,00292,India
583222,2023-07-20,501,iphone 15,60000,80000,20000,1,00050,India
583222,2023-07-20,504,iron,449,879,430,1,00050,India
583222,2023-07-20,505,oven,18490,24000,5510,1,00050,India
868583,2023-07-20,503,mixer,1349,3249,1900,1,00399,India
287199,2023-07-20,503,mixer,1349,3249,1900,1,00217,India
320139,2023-07-20,506,monitor,3249,8000,4751,1,00335,India
320139,2023-07-20,505,oven,18490,24000,5510,1,00335,India
304307,2023-07-20,507,washing machine,6990,16490,9500,1,00264,India
304307,2023-07-20,506,monitor,3249,8000,4751,1,00264,India
304307,2023-07-20,502,iphone 15 pro max,100000,135000,35000,1,00264,India
415423,2023-07-20,501,iphone 15,60000,80000,20000,1,00064,India
639274,2023-07-20,503,mixer,1349,3249,1900,1,00455,India
639274,2023-07-20,501,iphone 15,60000,80000,20000,1,00455,India
639274,2023-07-20,502,iphone 15 pro max,100000,135000,35000,1,00455,India
202119,2023-07-20,502,iphone 15 pro max,100000,135000,35000,1,00216,India
810946,2023-07-20,507,washing machine,6990,16490,9500,1,00467,India
810946,2023-07-20,505,oven,18490,24000,5510,1,00467,India
555387,2023-07-20,501,iphone 15,60000,80000,20000,1,00228,India
555387,2023-07-20,506,monitor,3249,8000,4751,1,00228,India
555387,2023-07-20,503,mixer,1349,3249,1900,1,00228,India
555387,2023-07-20,502,iphone 15 pro max,100000,135000,35000,1,00228,India
555387,2023-07-20,505,oven,18490,24000,5510,1,00228,India
729471,2023-07-20,504,iron,449,879,430,1,00362,India
729471,2023-07-20,501,iphone 15,60000,80000,20000,1,00362,India
729471,2023-07-20,507,washing machine,6990,16490,9500,1,00362,India
150190,2023-07-20,502,iphone 15 pro max,100000,135000,35000,1,00082,India
150190,2023-07-20,505,oven,18490,24000,5510,1,00082,India
150190,2023-07-20,504,iron,449,879,430,1,00082,India
591099,2023-07-20,502,iphone 15 pro max,100000,135000,35000,1,00333,India
591099,2023-07-20,503,mixer,1349,3249,1900,1,00333,India
591099,2023-07-20,507,washing machine,6990,16490,9500,1,00333,India
374226,2023-07-20,507,washing machine,6990,16490,9500,1,00328,India
374226,2023-07-20,502,iphone 15 pro max,100000,135000,35000,1,00328,India
374226,2023-07-20,506,monitor,3249,8000,4751,1,00328,India
323685,2023-07-21,503,mixer,1349,3249,1900,1,00160,India
960103,2023-07-21,505,oven,18490,24000,5510,1,00354,India
960103,2023-07-21,502,iphone 15 pro max,100000,135000,35000,1,00354,India
960103,2023-07-21,503,mixer,1349,3249,1900,1,00354,India
960103,2023-07-21,507,washing machine,6990,16490,9500,1,00354,India
962620,2023-07-21,504,iron,449,879,430,1,00444,India
962620,2023-07-21,507,washing machine,6990,16490,9500,1,00444,India
628954,2023-07-21,501,iphone 15,60000,80000,20000,1,00481,India
628954,2023-07-21,502,iphone 15 pro max,100000,135000,35000,1,00481,India
628954,2023-07-21,504,iron,449,879,430,1,00481,India
628954,2023-07-21,506,monitor,3249,8000,4751,1,00481,India
628954,2023-07-21,507,washing machine,6990,16490,9500,1,00481,India
334188,2023-07-21,504,iron,449,879,430,1,00319,India
334188,2023-07-21,503,mixer,1349,3249,1900,1,00319,India
334188,2023-07-21,502,iphone 15 pro max,100000,135000,35000,1,00319,India
334188,2023-07-21,506,monitor,3249,8000,4751,1,00319,India
395046,2023-07-21,504,iron,449,879,430,1,00434,India
757449,2023-07-21,501,iphone 15,60000,80000,20000,1,00402,India
757449,2023-07-21,504,iron,449,879,430,1,00402,India
757449,2023-07-21,503,mixer,1349,3249,1900,1,00402,India
369018,2023-07-21,504,iron,449,879,430,1,00291,India
369018,2023-07-21,502,iphone 15 pro max,100000,135000,35000,1,00291,India
697343,2023-07-21,501,iphone 15,60000,80000,20000,1,00244,India
697343,2023-07-21,503,mixer,1349,3249,1900,1,00244,India
832976,2023-07-21,507,washing machine,6990,16490,9500,1,00106,India
832976,2023-07-21,505,oven,18490,24000,5510,1,00106,India
832976,2023-07-21,506,monitor,3249,8000,4751,1,00106,India
832976,2023-07-21,502,iphone 15 pro max,100000,135000,35000,1,00106,India
163955,2023-07-21,504,iron,449,879,430,1,00363,India
170356,2023-07-21,502,iphone 15 pro max,100000,135000,35000,1,00450,India
170356,2023-07-21,506,monitor,3249,8000,4751,1,00450,India
906473,2023-07-21,507,washing machine,6990,16490,9500,1,00091,India
373492,2023-07-21,502,iphone 15 pro max,100000,135000,35000,1,00093,India
373492,2023-07-21,507,washing machine,6990,16490,9500,1,00093,India
373492,2023-07-21,506,monitor,3249,8000,4751,1,00093,India
373492,2023-07-21,504,iron,449,879,430,1,00093,India
944529,2023-07-21,504,iron,449,879,430,1,00456,India
944529,2023-07-21,505,oven,18490,24000,5510,1,00456,India
944529,2023-07-21,507,washing machine,6990,16490,9500,1,00456,India
944529,2023-07-21,503,mixer,1349,3249,1900,1,00456,India
602067,2023-07-21,502,iphone 15 pro max,100000,135000,35000,1,00487,India
602067,2023-07-21,501,iphone 15,60000,80000,20000,1,00487,India
602067,2023-07-21,507,washing machine,6990,16490,9500,1,00487,India
518884,2023-07-21,507,washing machine,6990,16490,9500,1,00432,India
205188,2023-07-21,507,washing machine,6990,16490,9500,1,00398,India
548773,2023-07-21,501,iphone 15,60000,80000,20000,1,00105,India
548773,2023-07-21,507,washing machine,6990,16490,9500,1,00105,India
987813,2023-07-21,507,washing machine,6990,16490,9500,1,00165,India
987813,2023-07-21,505,oven,18490,24000,5510,1,00165,India
218885,2023-07-21,505,oven,18490,24000,5510,1,00056,India
218885,2023-07-21,504,iron,449,879,430,1,00056,India
218885,2023-07-21,506,monitor,3249,8000,4751,1,00056,India
218885,2023-07-21,503,mixer,1349,3249,1900,1,00056,India
500871,2023-07-21,505,oven,18490,24000,5510,1,00187,India
500871,2023-07-21,507,washing machine,6990,16490,9500,1,00187,India
500871,2023-07-21,506,monitor,3249,8000,4751,1,00187,India
500871,2023-07-21,503,mixer,1349,3249,1900,1,00187,India
311483,2023-07-21,505,oven,18490,24000,5510,1,00119,India
311483,2023-07-21,501,iphone 15,60000,80000,20000,1,00119,India
311483,2023-07-21,504,iron,449,879,430,1,00119,India
428750,2023-07-21,501,iphone 15,60000,80000,20000,1,00298,India
428750,2023-07-21,506,monitor,3249,8000,4751,1,00298,India
932345,2023-07-21,503,mixer,1349,3249,1900,1,00367,India
932345,2023-07-21,502,iphone 15 pro max,100000,135000,35000,1,00367,India
932345,2023-07-21,507,washing machine,6990,16490,9500,1,00367,India
932345,2023-07-21,501,iphone 15,60000,80000,20000,1,00367,India
909272,2023-07-21,501,iphone 15,60000,80000,20000,1,00095,India
833573,2023-07-21,504,iron,449,879,430,1,00006,India
833573,2023-07-21,506,monitor,3249,8000,4751,1,00006,India
833573,2023-07-21,502,iphone 15 pro max,100000,135000,35000,1,00006,India
833573,2023-07-21,503,mixer,1349,3249,1900,1,00006,India
221039,2023-07-21,505,oven,18490,24000,5510,1,00249,India
221039,2023-07-21,507,washing machine,6990,16490,9500,1,00249,India
221039,2023-07-21,501,iphone 15,60000,80000,20000,1,00249,India
414347,2023-07-21,505,oven,18490,24000,5510,1,00102,India
414347,2023-07-21,506,monitor,3249,8000,4751,1,00102,India
414347,2023-07-21,501,iphone 15,60000,80000,20000,1,00102,India
414347,2023-07-21,507,washing machine,6990,16490,9500,1,00102,India
506339,2023-07-21,501,iphone 15,60000,80000,20000,1,00141,India
506339,2023-07-21,507,washing machine,6990,16490,9500,1,00141,India
506339,2023-07-21,505,oven,18490,24000,5510,1,00141,India
461844,2023-07-21,507,washing machine,6990,16490,9500,1,00177,India
461844,2023-07-21,506,monitor,3249,8000,4751,1,00177,India
461844,2023-07-21,502,iphone 15 pro max,100000,135000,35000,1,00177,India
461844,2023-07-21,501,iphone 15,60000,80000,20000,1,00177,India
962717,2023-07-21,506,monitor,3249,8000,4751,1,00019,India
325225,2023-07-21,504,iron,449,879,430,1,00210,India
325225,2023-07-21,506,monitor,3249,8000,4751,1,00210,India
325225,2023-07-21,503,mixer,1349,3249,1900,1,00210,India
183232,2023-07-21,506,monitor,3249,8000,4751,1,00217,India
584180,2023-07-21,503,mixer,1349,3249,1900,1,00464,India
584180,2023-07-21,501,iphone 15,60000,80000,20000,1,00464,India
584180,2023-07-21,504,iron,449,879,430,1,00464,India
584180,2023-07-21,507,washing machine,6990,16490,9500,1,00464,India
844540,2023-07-21,505,oven,18490,24000,5510,1,00100,India
243709,2023-07-21,501,iphone 15,60000,80000,20000,1,00093,India
243709,2023-07-21,502,iphone 15 pro max,100000,135000,35000,1,00093,India
243709,2023-07-21,507,washing machine,6990,16490,9500,1,00093,India
243709,2023-07-21,504,iron,449,879,430,1,00093,India
531423,2023-07-21,507,washing machine,6990,16490,9500,1,00254,India
458062,2023-07-21,503,mixer,1349,3249,1900,1,00323,India
458062,2023-07-21,505,oven,18490,24000,5510,1,00323,India
458062,2023-07-21,507,washing machine,6990,16490,9500,1,00323,India
458062,2023-07-21,504,iron,449,879,430,1,00323,India
458062,2023-07-21,502,iphone 15 pro max,100000,135000,35000,1,00323,India
181862,2023-07-21,504,iron,449,879,430,1,00046,India
181862,2023-07-21,506,monitor,3249,8000,4751,1,00046,India
648541,2023-07-21,502,iphone 15 pro max,100000,135000,35000,1,00369,India
269284,2023-07-21,507,washing machine,6990,16490,9500,1,00482,India
269284,2023-07-21,501,iphone 15,60000,80000,20000,1,00482,India
757273,2023-07-21,505,oven,18490,24000,5510,1,00473,India
757273,2023-07-21,504,iron,449,879,430,1,00473,India
734178,2023-07-21,503,mixer,1349,3249,1900,1,00027,India
207634,2023-07-21,503,mixer,1349,3249,1900,1,00389,India
207634,2023-07-21,507,washing machine,6990,16490,9500,1,00389,India
207634,2023-07-21,502,iphone 15 pro max,100000,135000,35000,1,00389,India
207634,2023-07-21,506,monitor,3249,8000,4751,1,00389,India
207634,2023-07-21,505,oven,18490,24000,5510,1,00389,India
644731,2023-07-21,503,mixer,1349,3249,1900,1,00222,India
626176,2023-07-21,507,washing machine,6990,16490,9500,1,00114,India
608684,2023-07-21,501,iphone 15,60000,80000,20000,1,00010,India
608684,2023-07-21,507,washing machine,6990,16490,9500,1,00010,India
608684,2023-07-21,502,iphone 15 pro max,100000,135000,35000,1,00010,India
608684,2023-07-21,503,mixer,1349,3249,1900,1,00010,India
908010,2023-07-21,501,iphone 15,60000,80000,20000,1,00147,India
908010,2023-07-21,505,oven,18490,24000,5510,1,00147,India
355923,2023-07-21,506,monitor,3249,8000,4751,1,00421,India
355923,2023-07-21,503,mixer,1349,3249,1900,1,00421,India
507653,2023-07-21,504,iron,449,879,430,1,00126,India
507653,2023-07-21,506,monitor,3249,8000,4751,1,00126,India
507653,2023-07-21,502,iphone 15 pro max,100000,135000,35000,1,00126,India
507653,2023-07-21,501,iphone 15,60000,80000,20000,1,00126,India
818441,2023-07-21,504,iron,449,879,430,1,00258,India
735316,2023-07-21,503,mixer,1349,3249,1900,1,00294,India
735316,2023-07-21,502,iphone 15 pro max,100000,135000,35000,1,00294,India
706285,2023-07-21,507,washing machine,6990,16490,9500,1,00414,India
706285,2023-07-21,502,iphone 15 pro max,100000,135000,35000,1,00414,India
706285,2023-07-21,501,iphone 15,60000,80000,20000,1,00414,India
706285,2023-07-21,505,oven,18490,24000,5510,1,00414,India
706285,2023-07-21,503,mixer,1349,3249,1900,1,00414,India
546048,2023-07-21,505,oven,18490,24000,5510,1,00093,India
546048,2023-07-21,501,iphone 15,60000,80000,20000,1,00093,India
546048,2023-07-21,504,iron,449,879,430,1,00093,India
991359,2023-07-21,505,oven,18490,24000,5510,1,00392,India
991359,2023-07-21,506,monitor,3249,8000,4751,1,00392,India
991359,2023-07-21,501,iphone 15,60000,80000,20000,1,00392,India
184489,2023-07-21,502,iphone 15 pro max,100000,135000,35000,1,00344,India
184489,2023-07-21,503,mixer,1349,3249,1900,1,00344,India
184489,2023-07-21,506,monitor,3249,8000,4751,1,00344,India
476273,2023-07-21,503,mixer,1349,3249,1900,1,00138,India
476273,2023-07-21,502,iphone 15 pro max,100000,135000,35000,1,00138,India
592276,2023-07-21,502,iphone 15 pro max,100000,135000,35000,1,00258,India
592276,2023-07-21,506,monitor,3249,8000,4751,1,00258,India
280951,2023-07-21,505,oven,18490,24000,5510,1,00474,India
280951,2023-07-21,507,washing machine,6990,16490,9500,1,00474,India
195968,2023-07-21,504,iron,449,879,430,1,00266,India
195968,2023-07-21,507,washing machine,6990,16490,9500,1,00266,India
399846,2023-07-21,502,iphone 15 pro max,100000,135000,35000,1,00123,India
399846,2023-07-21,507,washing machine,6990,16490,9500,1,00123,India
722567,2023-07-21,502,iphone 15 pro max,100000,135000,35000,1,00165,India
722567,2023-07-21,501,iphone 15,60000,80000,20000,1,00165,India
722567,2023-07-21,503,mixer,1349,3249,1900,1,00165,India
722567,2023-07-21,506,monitor,3249,8000,4751,1,00165,India
994104,2023-07-21,505,oven,18490,24000,5510,1,00083,India
994104,2023-07-21,506,monitor,3249,8000,4751,1,00083,India
388951,2023-07-21,501,iphone 15,60000,80000,20000,1,00465,India
388951,2023-07-21,507,washing machine,6990,16490,9500,1,00465,India
984892,2023-07-21,502,iphone 15 pro max,100000,135000,35000,1,00443,India
893102,2023-07-21,507,washing machine,6990,16490,9500,1,00206,India
893102,2023-07-21,503,mixer,1349,3249,1900,1,00206,India
210877,2023-07-21,506,monitor,3249,8000,4751,1,00330,India
210877,2023-07-21,503,mixer,1349,3249,1900,1,00330,India
210877,2023-07-21,504,iron,449,879,430,1,00330,India
210877,2023-07-21,507,washing machine,6990,16490,9500,1,00330,India
163845,2023-07-21,502,iphone 15 pro max,100000,135000,35000,1,00339,India
163845,2023-07-21,505,oven,18490,24000,5510,1,00339,India
163845,2023-07-21,501,iphone 15,60000,80000,20000,1,00339,India
779891,2023-07-21,504,iron,449,879,430,1,00305,India
779891,2023-07-21,502,iphone 15 pro max,100000,135000,35000,1,00305,India
779891,2023-07-21,505,oven,18490,24000,5510,1,00305,India
779891,2023-07-21,501,iphone 15,60000,80000,20000,1,00305,India
312387,2023-07-21,507,washing machine,6990,16490,9500,1,00368,India
312387,2023-07-21,505,oven,18490,24000,5510,1,00368,India
692590,2023-07-21,507,washing machine,6990,16490,9500,1,00200,India
692590,2023-07-21,505,oven,18490,24000,5510,1,00200,India
692590,2023-07-21,502,iphone 15 pro max,100000,135000,35000,1,00200,India
338318,2023-07-21,503,mixer,1349,3249,1900,1,00089,India
338318,2023-07-21,502,iphone 15 pro max,100000,135000,35000,1,00089,India
891813,2023-07-21,503,mixer,1349,3249,1900,1,00319,India
891813,2023-07-21,504,iron,449,879,430,1,00319,India
891813,2023-07-21,501,iphone 15,60000,80000,20000,1,00319,India
161032,2023-07-21,506,monitor,3249,8000,4751,1,00283,India
161032,2023-07-21,507,washing machine,6990,16490,9500,1,00283,India
161032,2023-07-21,504,iron,449,879,430,1,00283,India
717286,2023-07-21,507,washing machine,6990,16490,9500,1,00375,India
943360,2023-07-21,507,washing machine,6990,16490,9500,1,00172,India
943360,2023-07-21,505,oven,18490,24000,5510,1,00172,India
949635,2023-07-21,505,oven,18490,24000,5510,1,00455,India
949635,2023-07-21,506,monitor,3249,8000,4751,1,00455,India
949635,2023-07-21,502,iphone 15 pro max,100000,135000,35000,1,00455,India
949635,2023-07-21,504,iron,449,879,430,1,00455,India
466315,2023-07-21,504,iron,449,879,430,1,00324,India
466315,2023-07-21,505,oven,18490,24000,5510,1,00324,India
466315,2023-07-21,506,monitor,3249,8000,4751,1,00324,India
466315,2023-07-21,503,mixer,1349,3249,1900,1,00324,India
368795,2023-07-21,504,iron,449,879,430,1,00093,India
827765,2023-07-21,501,iphone 15,60000,80000,20000,1,00208,India
947678,2023-07-21,502,iphone 15 pro max,100000,135000,35000,1,00078,India
754821,2023-07-21,507,washing machine,6990,16490,9500,1,00270,India
754821,2023-07-21,506,monitor,3249,8000,4751,1,00270,India
754821,2023-07-21,503,mixer,1349,3249,1900,1,00270,India
359549,2023-07-21,504,iron,449,879,430,1,00202,India
359549,2023-07-21,501,iphone 15,60000,80000,20000,1,00202,India
387204,2023-07-21,502,iphone 15 pro max,100000,135000,35000,1,00082,India
387204,2023-07-21,505,oven,18490,24000,5510,1,00082,India
387204,2023-07-21,507,washing machine,6990,16490,9500,1,00082,India
387204,2023-07-21,504,iron,449,879,430,1,00082,India
387204,2023-07-21,503,mixer,1349,3249,1900,1,00082,India
697008,2023-07-21,501,iphone 15,60000,80000,20000,1,00211,India
697008,2023-07-21,505,oven,18490,24000,5510,1,00211,India
233859,2023-07-22,506,monitor,3249,8000,4751,1,00138,India
233859,2023-07-22,502,iphone 15 pro max,100000,135000,35000,1,00138,India
499786,2023-07-22,504,iron,449,879,430,1,00292,India
203282,2023-07-22,501,iphone 15,60000,80000,20000,1,00123,India
203282,2023-07-22,506,monitor,3249,8000,4751,1,00123,India
203282,2023-07-22,502,iphone 15 pro max,100000,135000,35000,1,00123,India
465832,2023-07-22,507,washing machine,6990,16490,9500,1,00163,India
465832,2023-07-22,504,iron,449,879,430,1,00163,India
465832,2023-07-22,503,mixer,1349,3249,1900,1,00163,India
560322,2023-07-22,505,oven,18490,24000,5510,1,00341,India
560322,2023-07-22,503,mixer,1349,3249,1900,1,00341,India
560322,2023-07-22,506,monitor,3249,8000,4751,1,00341,India
560322,2023-07-22,501,iphone 15,60000,80000,20000,1,00341,India
406160,2023-07-22,504,iron,449,879,430,1,00306,India
891718,2023-07-22,505,oven,18490,24000,5510,1,00433,India
891718,2023-07-22,504,iron,449,879,430,1,00433,India
891718,2023-07-22,501,iphone 15,60000,80000,20000,1,00433,India
627785,2023-07-22,503,mixer,1349,3249,1900,1,00135,India
627785,2023-07-22,501,iphone 15,60000,80000,20000,1,00135,India
627785,2023-07-22,504,iron,449,879,430,1,00135,India
505456,2023-07-22,501,iphone 15,60000,80000,20000,1,00328,India
505456,2023-07-22,506,monitor,3249,8000,4751,1,00328,India
505456,2023-07-22,505,oven,18490,24000,5510,1,00328,India
724523,2023-07-22,503,mixer,1349,3249,1900,1,00026,India
639877,2023-07-22,507,washing machine,6990,16490,9500,1,00081,India
172717,2023-07-22,505,oven,18490,24000,5510,1,00031,India
172717,2023-07-22,502,iphone 15 pro max,100000,135000,35000,1,00031,India
243496,2023-07-22,507,washing machine,6990,16490,9500,1,00271,India
853370,2023-07-22,507,washing machine,6990,16490,9500,1,00386,India
107624,2023-07-22,506,monitor,3249,8000,4751,1,00200,India
107624,2023-07-22,502,iphone 15 pro max,100000,135000,35000,1,00200,India
608319,2023-07-22,506,monitor,3249,8000,4751,1,00320,India
608319,2023-07-22,503,mixer,1349,3249,1900,1,00320,India
608319,2023-07-22,505,oven,18490,24000,5510,1,00320,India
965731,2023-07-22,503,mixer,1349,3249,1900,1,00480,India
965731,2023-07-22,505,oven,18490,24000,5510,1,00480,India
231691,2023-07-22,505,oven,18490,24000,5510,1,00465,India
231691,2023-07-22,504,iron,449,879,430,1,00465,India
231691,2023-07-22,503,mixer,1349,3249,1900,1,00465,India
939938,2023-07-22,507,washing machine,6990,16490,9500,1,00415,India
939938,2023-07-22,502,iphone 15 pro max,100000,135000,35000,1,00415,India
515764,2023-07-22,506,monitor,3249,8000,4751,1,00419,India
515764,2023-07-22,503,mixer,1349,3249,1900,1,00419,India
515764,2023-07-22,501,iphone 15,60000,80000,20000,1,00419,India
515764,2023-07-22,507,washing machine,6990,16490,9500,1,00419,India
411272,2023-07-22,503,mixer,1349,3249,1900,1,00137,India
411272,2023-07-22,501,iphone 15,60000,80000,20000,1,00137,India
411272,2023-07-22,505,oven,18490,24000,5510,1,00137,India
365979,2023-07-22,505,oven,18490,24000,5510,1,00031,India
365979,2023-07-22,506,monitor,3249,8000,4751,1,00031,India
365979,2023-07-22,502,iphone 15 pro max,100000,135000,35000,1,00031,India
365979,2023-07-22,507,washing machine,6990,16490,9500,1,00031,India
378717,2023-07-22,502,iphone 15 pro max,100000,135000,35000,1,00463,India
378717,2023-07-22,507,washing machine,6990,16490,9500,1,00463,India
378717,2023-07-22,501,iphone 15,60000,80000,20000,1,00463,India
378717,2023-07-22,505,oven,18490,24000,5510,1,00463,India
312984,2023-07-22,505,oven,18490,24000,5510,1,00447,India
312984,2023-07-22,504,iron,449,879,430,1,00447,India
874059,2023-07-22,502,iphone 15 pro max,100000,135000,35000,1,00416,India
874059,2023-07-22,504,iron,449,879,430,1,00416,India
439166,2023-07-22,502,iphone 15 pro max,100000,135000,35000,1,00272,India
378261,2023-07-22,503,mixer,1349,3249,1900,1,00109,India
180380,2023-07-22,506,monitor,3249,8000,4751,1,00362,India
180380,2023-07-22,501,iphone 15,60000,80000,20000,1,00362,India
180380,2023-07-22,502,iphone 15 pro max,100000,135000,35000,1,00362,India
905350,2023-07-22,502,iphone 15 pro max,100000,135000,35000,1,00278,India
905350,2023-07-22,503,mixer,1349,3249,1900,1,00278,India
205981,2023-07-22,507,washing machine,6990,16490,9500,1,00223,India
205981,2023-07-22,503,mixer,1349,3249,1900,1,00223,India
455026,2023-07-22,504,iron,449,879,430,1,00209,India
455026,2023-07-22,502,iphone 15 pro max,100000,135000,35000,1,00209,India
455026,2023-07-22,505,oven,18490,24000,5510,1,00209,India
455026,2023-07-22,506,monitor,3249,8000,4751,1,00209,India
763352,2023-07-22,505,oven,18490,24000,5510,1,00154,India
763352,2023-07-22,506,monitor,3249,8000,4751,1,00154,India
814572,2023-07-22,501,iphone 15,60000,80000,20000,1,00389,India
814572,2023-07-22,506,monitor,3249,8000,4751,1,00389,India
814572,2023-07-22,504,iron,449,879,430,1,00389,India
578628,2023-07-22,503,mixer,1349,3249,1900,1,00342,India
578628,2023-07-22,504,iron,449,879,430,1,00342,India
578628,2023-07-22,507,washing machine,6990,16490,9500,1,00342,India
578628,2023-07-22,502,iphone 15 pro max,100000,135000,35000,1,00342,India
365718,2023-07-22,507,washing machine,6990,16490,9500,1,00346,India
365718,2023-07-22,504,iron,449,879,430,1,00346,India
406186,2023-07-22,501,iphone 15,60000,80000,20000,1,00345,India
406186,2023-07-22,507,washing machine,6990,16490,9500,1,00345,India
406186,2023-07-22,506,monitor,3249,8000,4751,1,00345,India
978177,2023-07-22,507,washing machine,6990,16490,9500,1,00186,India
978177,2023-07-22,504,iron,449,879,430,1,00186,India
249487,2023-07-22,501,iphone 15,60000,80000,20000,1,00222,India
249487,2023-07-22,502,iphone 15 pro max,100000,135000,35000,1,00222,India
249487,2023-07-22,505,oven,18490,24000,5510,1,00222,India
741465,2023-07-22,501,iphone 15,60000,80000,20000,1,00459,India
680466,2023-07-22,506,monitor,3249,8000,4751,1,00026,India
680466,2023-07-22,507,washing machine,6990,16490,9500,1,00026,India
680466,2023-07-22,505,oven,18490,24000,5510,1,00026,India
680466,2023-07-22,504,iron,449,879,430,1,00026,India
796017,2023-07-22,506,monitor,3249,8000,4751,1,00021,India
796017,2023-07-22,504,iron,449,879,430,1,00021,India
796017,2023-07-22,501,iphone 15,60000,80000,20000,1,00021,India
286264,2023-07-22,503,mixer,1349,3249,1900,1,00232,India
286264,2023-07-22,502,iphone 15 pro max,100000,135000,35000,1,00232,India
119152,2023-07-22,503,mixer,1349,3249,1900,1,00470,India
119152,2023-07-22,507,washing machine,6990,16490,9500,1,00470,India
119152,2023-07-22,506,monitor,3249,8000,4751,1,00470,India
803122,2023-07-22,505,oven,18490,24000,5510,1,00140,India
803122,2023-07-22,501,iphone 15,60000,80000,20000,1,00140,India
701209,2023-07-22,504,iron,449,879,430,1,00408,India
382716,2023-07-22,504,iron,449,879,430,1,00102,India
802043,2023-07-22,504,iron,449,879,430,1,00020,India
377177,2023-07-22,501,iphone 15,60000,80000,20000,1,00218,India
377177,2023-07-22,505,oven,18490,24000,5510,1,00218,India
352763,2023-07-22,504,iron,449,879,430,1,00061,India
352763,2023-07-22,507,washing machine,6990,16490,9500,1,00061,India
352763,2023-07-22,505,oven,18490,24000,5510,1,00061,India
352763,2023-07-22,506,monitor,3249,8000,4751,1,00061,India
605341,2023-07-22,505,oven,18490,24000,5510,1,00182,India
605341,2023-07-22,507,washing machine,6990,16490,9500,1,00182,India
323128,2023-07-22,507,washing machine,6990,16490,9500,1,00214,India
821513,2023-07-22,503,mixer,1349,3249,1900,1,00213,India
821513,2023-07-22,502,iphone 15 pro max,100000,135000,35000,1,00213,India
821513,2023-07-22,506,monitor,3249,8000,4751,1,00213,India
821513,2023-07-22,504,iron,449,879,430,1,00213,India
198182,2023-07-22,506,monitor,3249,8000,4751,1,00177,India
198182,2023-07-22,503,mixer,1349,3249,1900,1,00177,India
198182,2023-07-22,507,washing machine,6990,16490,9500,1,00177,India
914174,2023-07-22,503,mixer,1349,3249,1900,1,00115,India
609058,2023-07-22,506,monitor,3249,8000,4751,1,00173,India
609058,2023-07-22,507,washing machine,6990,16490,9500,1,00173,India
609058,2023-07-22,501,iphone 15,60000,80000,20000,1,00173,India
349964,2023-07-22,503,mixer,1349,3249,1900,1,00429,India
533232,2023-07-22,502,iphone 15 pro max,100000,135000,35000,1,00338,India
533232,2023-07-22,504,iron,449,879,430,1,00338,India
533232,2023-07-22,506,monitor,3249,8000,4751,1,00338,India
809695,2023-07-22,507,washing machine,6990,16490,9500,1,00033,India
809695,2023-07-22,506,monitor,3249,8000,4751,1,00033,India
809695,2023-07-22,501,iphone 15,60000,80000,20000,1,00033,India
809695,2023-07-22,504,iron,449,879,430,1,00033,India
100326,2023-07-22,501,iphone 15,60000,80000,20000,1,00441,India
702420,2023-07-22,507,washing machine,6990,16490,9500,1,00001,India
702420,2023-07-22,502,iphone 15 pro max,100000,135000,35000,1,00001,India
702420,2023-07-22,504,iron,449,879,430,1,00001,India
536579,2023-07-22,505,oven,18490,24000,5510,1,00482,India
536579,2023-07-22,503,mixer,1349,3249,1900,1,00482,India
968835,2023-07-22,501,iphone 15,60000,80000,20000,1,00221,India
968835,2023-07-22,502,iphone 15 pro max,100000,135000,35000,1,00221,India
968835,2023-07-22,506,monitor,3249,8000,4751,1,00221,India
148749,2023-07-22,502,iphone 15 pro max,100000,135000,35000,1,00202,India
801915,2023-07-22,506,monitor,3249,8000,4751,1,00438,India
801915,2023-07-22,505,oven,18490,24000,5510,1,00438,India
801915,2023-07-22,503,mixer,1349,3249,1900,1,00438,India
801915,2023-07-22,507,washing machine,6990,16490,9500,1,00438,India
801915,2023-07-22,502,iphone 15 pro max,100000,135000,35000,1,00438,India
151690,2023-07-22,502,iphone 15 pro max,100000,135000,35000,1,00459,India
917457,2023-07-22,502,iphone 15 pro max,100000,135000,35000,1,00021,India
917457,2023-07-22,506,monitor,3249,8000,4751,1,00021,India
917457,2023-07-22,507,washing machine,6990,16490,9500,1,00021,India
602674,2023-07-22,501,iphone 15,60000,80000,20000,1,00320,India
691132,2023-07-22,503,mixer,1349,3249,1900,1,00499,India
691132,2023-07-22,507,washing machine,6990,16490,9500,1,00499,India
691132,2023-07-22,501,iphone 15,60000,80000,20000,1,00499,India
284446,2023-07-23,504,iron,449,879,430,1,00101,India
284446,2023-07-23,502,iphone 15 pro max,100000,135000,35000,1,00101,India
906688,2023-07-23,502,iphone 15 pro max,100000,135000,35000,1,00409,India
376257,2023-07-23,501,iphone 15,60000,80000,20000,1,00013,India
376257,2023-07-23,502,iphone 15 pro max,100000,135000,35000,1,00013,India
376257,2023-07-23,507,washing machine,6990,16490,9500,1,00013,India
664644,2023-07-23,506,monitor,3249,8000,4751,1,00163,India
664644,2023-07-23,504,iron,449,879,430,1,00163,India
867951,2023-07-23,506,monitor,3249,8000,4751,1,00426,India
867951,2023-07-23,503,mixer,1349,3249,1900,1,00426,India
742829,2023-07-23,503,mixer,1349,3249,1900,1,00109,India
742829,2023-07-23,505,oven,18490,24000,5510,1,00109,India
742829,2023-07-23,507,washing machine,6990,16490,9500,1,00109,India
201034,2023-07-23,502,iphone 15 pro max,100000,135000,35000,1,00332,India
201034,2023-07-23,505,oven,18490,24000,5510,1,00332,India
201034,2023-07-23,503,mixer,1349,3249,1900,1,00332,India
201034,2023-07-23,501,iphone 15,60000,80000,20000,1,00332,India
175054,2023-07-23,507,washing machine,6990,16490,9500,1,00046,India
175054,2023-07-23,503,mixer,1349,3249,1900,1,00046,India
175054,2023-07-23,506,monitor,3249,8000,4751,1,00046,India
175054,2023-07-23,504,iron,449,879,430,1,00046,India
294212,2023-07-23,504,iron,449,879,430,1,00432,India
750187,2023-07-23,503,mixer,1349,3249,1900,1,00201,India
750187,2023-07-23,502,iphone 15 pro max,100000,135000,35000,1,00201,India
750187,2023-07-23,504,iron,449,879,430,1,00201,India
522442,2023-07-23,504,iron,449,879,430,1,00182,India
522442,2023-07-23,503,mixer,1349,3249,1900,1,00182,India
522442,2023-07-23,505,oven,18490,24000,5510,1,00182,India
882098,2023-07-23,506,monitor,3249,8000,4751,1,00232,India
882098,2023-07-23,501,iphone 15,60000,80000,20000,1,00232,India
448849,2023-07-23,504,iron,449,879,430,1,00028,India
746415,2023-07-23,507,washing machine,6990,16490,9500,1,00387,India
746415,2023-07-23,504,iron,449,879,430,1,00387,India
746415,2023-07-23,502,iphone 15 pro max,100000,135000,35000,1,00387,India
746415,2023-07-23,503,mixer,1349,3249,1900,1,00387,India
162308,2023-07-23,507,washing machine,6990,16490,9500,1,00093,India
799131,2023-07-23,507,washing machine,6990,16490,9500,1,00239,India
799131,2023-07-23,502,iphone 15 pro max,100000,135000,35000,1,00239,India
132180,2023-07-23,506,monitor,3249,8000,4751,1,00307,India
132180,2023-07-23,503,mixer,1349,3249,1900,1,00307,India
971833,2023-07-23,502,iphone 15 pro max,100000,135000,35000,1,00208,India
971833,2023-07-23,504,iron,449,879,430,1,00208,India
971833,2023-07-23,503,mixer,1349,3249,1900,1,00208,India
971833,2023-07-23,507,washing machine,6990,16490,9500,1,00208,India
410754,2023-07-23,503,mixer,1349,3249,1900,1,00207,India
410754,2023-07-23,504,iron,449,879,430,1,00207,India
410754,2023-07-23,507,washing machine,6990,16490,9500,1,00207,India
203269,2023-07-23,501,iphone 15,60000,80000,20000,1,00344,India
203269,2023-07-23,506,monitor,3249,8000,4751,1,00344,India
203269,2023-07-23,504,iron,449,879,430,1,00344,India
203269,2023-07-23,502,iphone 15 pro max,100000,135000,35000,1,00344,India
552512,2023-07-23,506,monitor,3249,8000,4751,1,00246,India
552512,2023-07-23,505,oven,18490,24000,5510,1,00246,India
552512,2023-07-23,507,washing machine,6990,16490,9500,1,00246,India
552512,2023-07-23,501,iphone 15,60000,80000,20000,1,00246,India
230166,2023-07-23,502,iphone 15 pro max,100000,135000,35000,1,00333,India
230166,2023-07-23,501,iphone 15,60000,80000,20000,1,00333,India
230166,2023-07-23,503,mixer,1349,3249,1900,1,00333,India
800992,2023-07-23,502,iphone 15 pro max,100000,135000,35000,1,00191,India
800992,2023-07-23,501,iphone 15,60000,80000,20000,1,00191,India
102308,2023-07-23,501,iphone 15,60000,80000,20000,1,00173,India
102308,2023-07-23,503,mixer,1349,3249,1900,1,00173,India
332529,2023-07-23,506,monitor,3249,8000,4751,1,00017,India
332529,2023-07-23,503,mixer,1349,3249,1900,1,00017,India
673075,2023-07-23,504,iron,449,879,430,1,00193,India
371036,2023-07-23,502,iphone 15 pro max,100000,135000,35000,1,00039,India
371036,2023-07-23,507,washing machine,6990,16490,9500,1,00039,India
371036,2023-07-23,505,oven,18490,24000,5510,1,00039,India
136352,2023-07-23,504,iron,449,879,430,1,00297,India
397295,2023-07-23,505,oven,18490,24000,5510,1,00303,India
397295,2023-07-23,507,washing machine,6990,16490,9500,1,00303,India
397295,2023-07-23,503,mixer,1349,3249,1900,1,00303,India
397295,2023-07-23,506,monitor,3249,8000,4751,1,00303,India
521797,2023-07-23,502,iphone 15 pro max,100000,135000,35000,1,00164,India
521797,2023-07-23,507,washing machine,6990,16490,9500,1,00164,India
521797,2023-07-23,503,mixer,1349,3249,1900,1,00164,India
236179,2023-07-23,507,washing machine,6990,16490,9500,1,00042,India
236179,2023-07-23,505,oven,18490,24000,5510,1,00042,India
236179,2023-07-23,502,iphone 15 pro max,100000,135000,35000,1,00042,India
306134,2023-07-23,506,monitor,3249,8000,4751,1,00209,India
306134,2023-07-23,503,mixer,1349,3249,1900,1,00209,India
306134,2023-07-23,507,washing machine,6990,16490,9500,1,00209,India
814451,2023-07-23,501,iphone 15,60000,80000,20000,1,00438,India
814451,2023-07-23,504,iron,449,879,430,1,00438,India
814451,2023-07-23,507,washing machine,6990,16490,9500,1,00438,India
814451,2023-07-23,505,oven,18490,24000,5510,1,00438,India
814451,2023-07-23,506,monitor,3249,8000,4751,1,00438,India
597656,2023-07-23,502,iphone 15 pro max,100000,135000,35000,1,00377,India
875662,2023-07-23,507,washing machine,6990,16490,9500,1,00069,India
875662,2023-07-23,502,iphone 15 pro max,100000,135000,35000,1,00069,India
875662,2023-07-23,505,oven,18490,24000,5510,1,00069,India
875662,2023-07-23,506,monitor,3249,8000,4751,1,00069,India
126938,2023-07-23,505,oven,18490,24000,5510,1,00022,India
126938,2023-07-23,506,monitor,3249,8000,4751,1,00022,India
352656,2023-07-23,503,mixer,1349,3249,1900,1,00323,India
352656,2023-07-23,501,iphone 15,60000,80000,20000,1,00323,India
352656,2023-07-23,502,iphone 15 pro max,100000,135000,35000,1,00323,India
397214,2023-07-23,507,washing machine,6990,16490,9500,1,00084,India
710776,2023-07-23,505,oven,18490,24000,5510,1,00414,India
710776,2023-07-23,504,iron,449,879,430,1,00414,India
376469,2023-07-23,506,monitor,3249,8000,4751,1,00446,India
376469,2023-07-23,501,iphone 15,60000,80000,20000,1,00446,India
556002,2023-07-23,505,oven,18490,24000,5510,1,00157,India
556002,2023-07-23,506,monitor,3249,8000,4751,1,00157,India
556002,2023-07-23,502,iphone 15 pro max,100000,135000,35000,1,00157,India
556002,2023-07-23,504,iron,449,879,430,1,00157,India
320071,2023-07-23,501,iphone 15,60000,80000,20000,1,00342,India
320071,2023-07-23,504,iron,449,879,430,1,00342,India
320071,2023-07-23,506,monitor,3249,8000,4751,1,00342,India
485153,2023-07-23,503,mixer,1349,3249,1900,1,00188,India
485153,2023-07-23,504,iron,449,879,430,1,00188,India
485153,2023-07-23,502,iphone 15 pro max,100000,135000,35000,1,00188,India
485153,2023-07-23,505,oven,18490,24000,5510,1,00188,India
485153,2023-07-23,501,iphone 15,60000,80000,20000,1,00188,India
198901,2023-07-23,502,iphone 15 pro max,100000,135000,35000,1,00135,India
546759,2023-07-23,505,oven,18490,24000,5510,1,00154,India
546759,2023-07-23,501,iphone 15,60000,80000,20000,1,00154,India
787692,2023-07-23,505,oven,18490,24000,5510,1,00290,India
787692,2023-07-23,506,monitor,3249,8000,4751,1,00290,India
787692,2023-07-23,507,washing machine,6990,16490,9500,1,00290,India
474484,2023-07-23,501,iphone 15,60000,80000,20000,1,00230,India
474484,2023-07-23,502,iphone 15 pro max,100000,135000,35000,1,00230,India
658643,2023-07-23,506,monitor,3249,8000,4751,1,00322,India
658643,2023-07-23,504,iron,449,879,430,1,00322,India
450541,2023-07-23,504,iron,449,879,430,1,00343,India
365093,2023-07-23,506,monitor,3249,8000,4751,1,00471,India
365093,2023-07-23,502,iphone 15 pro max,100000,135000,35000,1,00471,India
365093,2023-07-23,501,iphone 15,60000,80000,20000,1,00471,India
691250,2023-07-23,501,iphone 15,60000,80000,20000,1,00112,India
691250,2023-07-23,502,iphone 15 pro max,100000,135000,35000,1,00112,India
980906,2023-07-23,505,oven,18490,24000,5510,1,00074,India
980906,2023-07-23,504,iron,449,879,430,1,00074,India
980906,2023-07-23,502,iphone 15 pro max,100000,135000,35000,1,00074,India
980906,2023-07-23,503,mixer,1349,3249,1900,1,00074,India
961048,2023-07-23,507,washing machine,6990,16490,9500,1,00181,India
961048,2023-07-23,502,iphone 15 pro max,100000,135000,35000,1,00181,India
961048,2023-07-23,503,mixer,1349,3249,1900,1,00181,India
302753,2023-07-23,502,iphone 15 pro max,100000,135000,35000,1,00063,India
302753,2023-07-23,501,iphone 15,60000,80000,20000,1,00063,India
302753,2023-07-23,507,washing machine,6990,16490,9500,1,00063,India
880542,2023-07-23,507,washing machine,6990,16490,9500,1,00084,India
880542,2023-07-23,503,mixer,1349,3249,1900,1,00084,India
880542,2023-07-23,504,iron,449,879,430,1,00084,India
944229,2023-07-23,505,oven,18490,24000,5510,1,00219,India
944229,2023-07-23,502,iphone 15 pro max,100000,135000,35000,1,00219,India
944229,2023-07-23,507,washing machine,6990,16490,9500,1,00219,India
944229,2023-07-23,504,iron,449,879,430,1,00219,India
452772,2023-07-23,506,monitor,3249,8000,4751,1,00476,India
452772,2023-07-23,502,iphone 15 pro max,100000,135000,35000,1,00476,India
525999,2023-07-23,506,monitor,3249,8000,4751,1,00176,India
525999,2023-07-23,501,iphone 15,60000,80000,20000,1,00176,India
525999,2023-07-23,502,iphone 15 pro max,100000,135000,35000,1,00176,India
525999,2023-07-23,503,mixer,1349,3249,1900,1,00176,India
525999,2023-07-23,504,iron,449,879,430,1,00176,India
588672,2023-07-23,503,mixer,1349,3249,1900,1,00111,India
588672,2023-07-23,501,iphone 15,60000,80000,20000,1,00111,India
940495,2023-07-23,503,mixer,1349,3249,1900,1,00273,India
933997,2023-07-23,501,iphone 15,60000,80000,20000,1,00275,India
933997,2023-07-23,506,monitor,3249,8000,4751,1,00275,India
564570,2023-07-23,501,iphone 15,60000,80000,20000,1,00432,India
564570,2023-07-23,502,iphone 15 pro max,100000,135000,35000,1,00432,India
808139,2023-07-23,507,washing machine,6990,16490,9500,1,00122,India
808139,2023-07-23,501,iphone 15,60000,80000,20000,1,00122,India
808139,2023-07-23,505,oven,18490,24000,5510,1,00122,India
634070,2023-07-23,501,iphone 15,60000,80000,20000,1,00077,India
687545,2023-07-23,501,iphone 15,60000,80000,20000,1,00478,India
687545,2023-07-23,502,iphone 15 pro max,100000,135000,35000,1,00478,India
687545,2023-07-23,505,oven,18490,24000,5510,1,00478,India
687545,2023-07-23,507,washing machine,6990,16490,9500,1,00478,India
598207,2023-07-23,503,mixer,1349,3249,1900,1,00335,India
598207,2023-07-23,504,iron,449,879,430,1,00335,India
371256,2023-07-23,504,iron,449,879,430,1,00035,India
626212,2023-07-23,506,monitor,3249,8000,4751,1,00125,India
626212,2023-07-23,501,iphone 15,60000,80000,20000,1,00125,India
626212,2023-07-23,504,iron,449,879,430,1,00125,India
263708,2023-07-23,502,iphone 15 pro max,100000,135000,35000,1,00180,India
263708,2023-07-23,503,mixer,1349,3249,1900,1,00180,India
263708,2023-07-23,504,iron,449,879,430,1,00180,India
849999,2023-07-23,506,monitor,3249,8000,4751,1,00309,India
849999,2023-07-23,507,washing machine,6990,16490,9500,1,00309,India
849999,2023-07-23,502,iphone 15 pro max,100000,135000,35000,1,00309,India
849999,2023-07-23,504,iron,449,879,430,1,00309,India
849999,2023-07-23,501,iphone 15,60000,80000,20000,1,00309,India
640576,2023-07-23,505,oven,18490,24000,5510,1,00483,India
640576,2023-07-23,501,iphone 15,60000,80000,20000,1,00483,India
640576,2023-07-23,507,washing machine,6990,16490,9500,1,00483,India
385994,2023-07-23,505,oven,18490,24000,5510,1,00204,India
385994,2023-07-23,507,washing machine,6990,16490,9500,1,00204,India
253053,2023-07-23,503,mixer,1349,3249,1900,1,00139,India
170914,2023-07-23,502,iphone 15 pro max,100000,135000,35000,1,00380,India
874107,2023-07-23,502,iphone 15 pro max,100000,135000,35000,1,00055,India
619172,2023-07-23,503,mixer,1349,3249,1900,1,00189,India
619172,2023-07-23,504,iron,449,879,430,1,00189,India
415614,2023-07-23,503,mixer,1349,3249,1900,1,00148,India
415614,2023-07-23,505,oven,18490,24000,5510,1,00148,India
983270,2023-07-24,502,iphone 15 pro max,100000,135000,35000,1,00053,India
983270,2023-07-24,503,mixer,1349,3249,1900,1,00053,India
983270,2023-07-24,507,washing machine,6990,16490,9500,1,00053,India
992493,2023-07-24,504,iron,449,879,430,1,00200,India
992493,2023-07-24,501,iphone 15,60000,80000,20000,1,00200,India
992493,2023-07-24,507,washing machine,6990,16490,9500,1,00200,India
992493,2023-07-24,506,monitor,3249,8000,4751,1,00200,India
313248,2023-07-24,502,iphone 15 pro max,100000,135000,35000,1,00393,India
843942,2023-07-24,507,washing machine,6990,16490,9500,1,00441,India
843942,2023-07-24,505,oven,18490,24000,5510,1,00441,India
606998,2023-07-24,501,iphone 15,60000,80000,20000,1,00191,India
606998,2023-07-24,505,oven,18490,24000,5510,1,00191,India
606998,2023-07-24,502,iphone 15 pro max,100000,135000,35000,1,00191,India
946022,2023-07-24,505,oven,18490,24000,5510,1,00034,India
946022,2023-07-24,507,washing machine,6990,16490,9500,1,00034,India
679250,2023-07-24,502,iphone 15 pro max,100000,135000,35000,1,00014,India
679250,2023-07-24,504,iron,449,879,430,1,00014,India
679250,2023-07-24,503,mixer,1349,3249,1900,1,00014,India
679250,2023-07-24,507,washing machine,6990,16490,9500,1,00014,India
181106,2023-07-24,505,oven,18490,24000,5510,1,00291,India
181106,2023-07-24,502,iphone 15 pro max,100000,135000,35000,1,00291,India
510147,2023-07-24,505,oven,18490,24000,5510,1,00352,India
510147,2023-07-24,501,iphone 15,60000,80000,20000,1,00352,India
510147,2023-07-24,502,iphone 15 pro max,100000,135000,35000,1,00352,India
708607,2023-07-24,506,monitor,3249,8000,4751,1,00397,India
708607,2023-07-24,504,iron,449,879,430,1,00397,India
708607,2023-07-24,505,oven,18490,24000,5510,1,00397,India
262024,2023-07-24,506,monitor,3249,8000,4751,1,00300,India
262024,2023-07-24,501,iphone 15,60000,80000,20000,1,00300,India
262024,2023-07-24,503,mixer,1349,3249,1900,1,00300,India
830322,2023-07-24,503,mixer,1349,3249,1900,1,00164,India
904238,2023-07-24,506,monitor,3249,8000,4751,1,00278,India
252196,2023-07-24,502,iphone 15 pro max,100000,135000,35000,1,00060,India
252196,2023-07-24,507,washing machine,6990,16490,9500,1,00060,India
252196,2023-07-24,505,oven,18490,24000,5510,1,00060,India
262055,2023-07-24,503,mixer,1349,3249,1900,1,00241,India
262055,2023-07-24,506,monitor,3249,8000,4751,1,00241,India
262055,2023-07-24,505,oven,18490,24000,5510,1,00241,India
495031,2023-07-24,506,monitor,3249,8000,4751,1,00439,India
495031,2023-07-24,503,mixer,1349,3249,1900,1,00439,India
495031,2023-07-24,504,iron,449,879,430,1,00439,India
674258,2023-07-24,502,iphone 15 pro max,100000,135000,35000,1,00377,India
674258,2023-07-24,506,monitor,3249,8000,4751,1,00377,India
237897,2023-07-24,507,washing machine,6990,16490,9500,1,00145,India
460227,2023-07-24,502,iphone 15 pro max,100000,135000,35000,1,00397,India
460227,2023-07-24,507,washing machine,6990,16490,9500,1,00397,India
784084,2023-07-24,503,mixer,1349,3249,1900,1,00497,India
420446,2023-07-24,505,oven,18490,24000,5510,1,00181,India
158442,2023-07-24,507,washing machine,6990,16490,9500,1,00401,India
889525,2023-07-24,507,washing machine,6990,16490,9500,1,00119,India
889525,2023-07-24,504,iron,449,879,430,1,00119,India
891605,2023-07-24,505,oven,18490,24000,5510,1,00214,India
891605,2023-07-24,504,iron,449,879,430,1,00214,India
891605,2023-07-24,506,monitor,3249,8000,4751,1,00214,India
263686,2023-07-24,505,oven,18490,24000,5510,1,00303,India
263686,2023-07-24,501,iphone 15,60000,80000,20000,1,00303,India
263686,2023-07-24,506,monitor,3249,8000,4751,1,00303,India
177632,2023-07-24,502,iphone 15 pro max,100000,135000,35000,1,00480,India
177632,2023-07-24,501,iphone 15,60000,80000,20000,1,00480,India
652232,2023-07-24,506,monitor,3249,8000,4751,1,00271,India
652232,2023-07-24,501,iphone 15,60000,80000,20000,1,00271,India
402747,2023-07-24,504,iron,449,879,430,1,00174,India
402747,2023-07-24,503,mixer,1349,3249,1900,1,00174,India
432590,2023-07-24,505,oven,18490,24000,5510,1,00064,India
432590,2023-07-24,501,iphone 15,60000,80000,20000,1,00064,India
270303,2023-07-24,504,iron,449,879,430,1,00165,India
270303,2023-07-24,506,monitor,3249,8000,4751,1,00165,India
270303,2023-07-24,502,iphone 15 pro max,100000,135000,35000,1,00165,India
910671,2023-07-24,504,iron,449,879,430,1,00369,India
910671,2023-07-24,506,monitor,3249,8000,4751,1,00369,India
497768,2023-07-24,501,iphone 15,60000,80000,20000,1,00330,India
497768,2023-07-24,507,washing machine,6990,16490,9500,1,00330,India
602106,2023-07-24,503,mixer,1349,3249,1900,1,00212,India
602106,2023-07-24,502,iphone 15 pro max,100000,135000,35000,1,00212,India
602106,2023-07-24,507,washing machine,6990,16490,9500,1,00212,India
602106,2023-07-24,504,iron,449,879,430,1,00212,India
166186,2023-07-24,501,iphone 15,60000,80000,20000,1,00477,India
166186,2023-07-24,505,oven,18490,24000,5510,1,00477,India
166186,2023-07-24,506,monitor,3249,8000,4751,1,00477,India
166186,2023-07-24,507,washing machine,6990,16490,9500,1,00477,India
166186,2023-07-24,502,iphone 15 pro max,100000,135000,35000,1,00477,India
154297,2023-07-24,501,iphone 15,60000,80000,20000,1,00432,India
154297,2023-07-24,504,iron,449,879,430,1,00432,India
154297,2023-07-24,507,washing machine,6990,16490,9500,1,00432,India
380972,2023-07-24,506,monitor,3249,8000,4751,1,00343,India
380972,2023-07-24,505,oven,18490,24000,5510,1,00343,India
380972,2023-07-24,501,iphone 15,60000,80000,20000,1,00343,India
380972,2023-07-24,504,iron,449,879,430,1,00343,India
746718,2023-07-24,507,washing machine,6990,16490,9500,1,00495,India
746718,2023-07-24,503,mixer,1349,3249,1900,1,00495,India
746718,2023-07-24,501,iphone 15,60000,80000,20000,1,00495,India
746718,2023-07-24,502,iphone 15 pro max,100000,135000,35000,1,00495,India
975903,2023-07-24,504,iron,449,879,430,1,00202,India
975903,2023-07-24,501,iphone 15,60000,80000,20000,1,00202,India
975903,2023-07-24,505,oven,18490,24000,5510,1,00202,India
552894,2023-07-24,503,mixer,1349,3249,1900,1,00099,India
839323,2023-07-24,504,iron,449,879,430,1,00438,India
839323,2023-07-24,501,iphone 15,60000,80000,20000,1,00438,India
375890,2023-07-24,507,washing machine,6990,16490,9500,1,00246,India
695577,2023-07-24,505,oven,18490,24000,5510,1,00452,India
695577,2023-07-24,501,iphone 15,60000,80000,20000,1,00452,India
695577,2023-07-24,503,mixer,1349,3249,1900,1,00452,India
606581,2023-07-24,502,iphone 15 pro max,100000,135000,35000,1,00292,India
606581,2023-07-24,503,mixer,1349,3249,1900,1,00292,India
606581,2023-07-24,504,iron,449,879,430,1,00292,India
606581,2023-07-24,507,washing machine,6990,16490,9500,1,00292,India
528431,2023-07-24,507,washing machine,6990,16490,9500,1,00390,India
151824,2023-07-24,504,iron,449,879,430,1,00101,India
151824,2023-07-24,503,mixer,1349,3249,1900,1,00101,India
151824,2023-07-24,505,oven,18490,24000,5510,1,00101,India
194401,2023-07-24,501,iphone 15,60000,80000,20000,1,00055,India
194401,2023-07-24,507,washing machine,6990,16490,9500,1,00055,India
194401,2023-07-24,506,monitor,3249,8000,4751,1,00055,India
790632,2023-07-24,503,mixer,1349,3249,1900,1,00036,India
790632,2023-07-24,501,iphone 15,60000,80000,20000,1,00036,India
790632,2023-07-24,502,iphone 15 pro max,100000,135000,35000,1,00036,India
790632,2023-07-24,507,washing machine,6990,16490,9500,1,00036,India
790632,2023-07-24,505,oven,18490,24000,5510,1,00036,India
800000,2023-07-24,505,oven,18490,24000,5510,1,00254,India
800000,2023-07-24,503,mixer,1349,3249,1900,1,00254,India
800000,2023-07-24,507,washing machine,6990,16490,9500,1,00254,India
800000,2023-07-24,502,iphone 15 pro max,100000,135000,35000,1,00254,India
215393,2023-07-24,506,monitor,3249,8000,4751,1,00222,India
215393,2023-07-24,503,mixer,1349,3249,1900,1,00222,India
124867,2023-07-24,505,oven,18490,24000,5510,1,00420,India
124867,2023-07-24,501,iphone 15,60000,80000,20000,1,00420,India
124867,2023-07-24,503,mixer,1349,3249,1900,1,00420,India
124867,2023-07-24,507,washing machine,6990,16490,9500,1,00420,India
978498,2023-07-24,503,mixer,1349,3249,1900,1,00234,India
580375,2023-07-24,505,oven,18490,24000,5510,1,00027,India
580375,2023-07-24,501,iphone 15,60000,80000,20000,1,00027,India
580375,2023-07-24,502,iphone 15 pro max,100000,135000,35000,1,00027,India
195053,2023-07-24,502,iphone 15 pro max,100000,135000,35000,1,00315,India
195053,2023-07-24,503,mixer,1349,3249,1900,1,00315,India
195053,2023-07-24,506,monitor,3249,8000,4751,1,00315,India
918104,2023-07-24,502,iphone 15 pro max,100000,135000,35000,1,00070,India
918104,2023-07-24,507,washing machine,6990,16490,9500,1,00070,India
918104,2023-07-24,506,monitor,3249,8000,4751,1,00070,India
918104,2023-07-24,505,oven,18490,24000,5510,1,00070,India
362374,2023-07-24,506,monitor,3249,8000,4751,1,00377,India
362374,2023-07-24,504,iron,449,879,430,1,00377,India
362374,2023-07-24,503,mixer,1349,3249,1900,1,00377,India
362374,2023-07-24,505,oven,18490,24000,5510,1,00377,India
139720,2023-07-24,505,oven,18490,24000,5510,1,00059,India
139720,2023-07-24,502,iphone 15 pro max,100000,135000,35000,1,00059,India
176216,2023-07-24,504,iron,449,879,430,1,00411,India
176216,2023-07-24,502,iphone 15 pro max,100000,135000,35000,1,00411,India
176216,2023-07-24,503,mixer,1349,3249,1900,1,00411,India
271931,2023-07-24,507,washing machine,6990,16490,9500,1,00423,India
271931,2023-07-24,501,iphone 15,60000,80000,20000,1,00423,India
676778,2023-07-24,507,washing machine,6990,16490,9500,1,00194,India
676778,2023-07-24,504,iron,449,879,430,1,00194,India
676778,2023-07-24,506,monitor,3249,8000,4751,1,00194,India
241084,2023-07-24,506,monitor,3249,8000,4751,1,00114,India
241084,2023-07-24,502,iphone 15 pro max,100000,135000,35000,1,00114,India
241084,2023-07-24,507,washing machine,6990,16490,9500,1,00114,India
924934,2023-07-24,501,iphone 15,60000,80000,20000,1,00371,India
924934,2023-07-24,504,iron,449,879,430,1,00371,India
924934,2023-07-24,506,monitor,3249,8000,4751,1,00371,India
649106,2023-07-24,503,mixer,1349,3249,1900,1,00316,India
649106,2023-07-24,501,iphone 15,60000,80000,20000,1,00316,India
195147,2023-07-24,504,iron,449,879,430,1,00289,India
195147,2023-07-24,501,iphone 15,60000,80000,20000,1,00289,India
195147,2023-07-24,503,mixer,1349,3249,1900,1,00289,India
195147,2023-07-24,502,iphone 15 pro max,100000,135000,35000,1,00289,India
159161,2023-07-24,506,monitor,3249,8000,4751,1,00051,India
421301,2023-07-24,505,oven,18490,24000,5510,1,00382,India
421301,2023-07-24,504,iron,449,879,430,1,00382,India
849131,2023-07-24,506,monitor,3249,8000,4751,1,00058,India
849131,2023-07-24,505,oven,18490,24000,5510,1,00058,India
849131,2023-07-24,503,mixer,1349,3249,1900,1,00058,India
555380,2023-07-24,507,washing machine,6990,16490,9500,1,00490,India
857941,2023-07-24,503,mixer,1349,3249,1900,1,00079,India
857941,2023-07-24,504,iron,449,879,430,1,00079,India
857941,2023-07-24,507,washing machine,6990,16490,9500,1,00079,India
857941,2023-07-24,501,iphone 15,60000,80000,20000,1,00079,India
983866,2023-07-24,507,washing machine,6990,16490,9500,1,00178,India
983866,2023-07-24,502,iphone 15 pro max,100000,135000,35000,1,00178,India
983866,2023-07-24,506,monitor,3249,8000,4751,1,00178,India
219309,2023-07-24,506,monitor,3249,8000,4751,1,00257,India
219309,2023-07-24,501,iphone 15,60000,80000,20000,1,00257,India
826625,2023-07-24,501,iphone 15,60000,80000,20000,1,00166,India
101495,2023-07-24,505,oven,18490,24000,5510,1,00190,India
101495,2023-07-24,501,iphone 15,60000,80000,20000,1,00190,India
101495,2023-07-24,503,mixer,1349,3249,1900,1,00190,India
555073,2023-07-24,505,oven,18490,24000,5510,1,00141,India
555073,2023-07-24,503,mixer,1349,3249,1900,1,00141,India
555073,2023-07-24,501,iphone 15,60000,80000,20000,1,00141,India
886505,2023-07-24,507,washing machine,6990,16490,9500,1,00112,India
886505,2023-07-24,503,mixer,1349,3249,1900,1,00112,India
886505,2023-07-24,506,monitor,3249,8000,4751,1,00112,India
886505,2023-07-24,501,iphone 15,60000,80000,20000,1,00112,India
891308,2023-07-24,503,mixer,1349,3249,1900,1,00273,India
891308,2023-07-24,502,iphone 15 pro max,100000,135000,35000,1,00273,India
551106,2023-07-24,502,iphone 15 pro max,100000,135000,35000,1,00058,India
551106,2023-07-24,503,mixer,1349,3249,1900,1,00058,India
551106,2023-07-24,505,oven,18490,24000,5510,1,00058,India
103194,2023-07-24,505,oven,18490,24000,5510,1,00356,India
103194,2023-07-24,507,washing machine,6990,16490,9500,1,00356,India
103194,2023-07-24,506,monitor,3249,8000,4751,1,00356,India
103194,2023-07-24,501,iphone 15,60000,80000,20000,1,00356,India
936081,2023-07-24,501,iphone 15,60000,80000,20000,1,00140,India
936081,2023-07-24,503,mixer,1349,3249,1900,1,00140,India
161182,2023-07-24,507,washing machine,6990,16490,9500,1,00244,India
855626,2023-07-24,505,oven,18490,24000,5510,1,00498,India
694082,2023-07-24,503,mixer,1349,3249,1900,1,00170,India
694082,2023-07-24,502,iphone 15 pro max,100000,135000,35000,1,00170,India
694082,2023-07-24,506,monitor,3249,8000,4751,1,00170,India
694082,2023-07-24,507,washing machine,6990,16490,9500,1,00170,India
694082,2023-07-24,501,iphone 15,60000,80000,20000,1,00170,India
819874,2023-07-24,501,iphone 15,60000,80000,20000,1,00273,India
819874,2023-07-24,507,washing machine,6990,16490,9500,1,00273,India
819874,2023-07-24,505,oven,18490,24000,5510,1,00273,India
819874,2023-07-24,503,mixer,1349,3249,1900,1,00273,India
442320,2023-07-24,504,iron,449,879,430,1,00474,India
318477,2023-07-24,506,monitor,3249,8000,4751,1,00208,India
198203,2023-07-24,506,monitor,3249,8000,4751,1,00042,India
851109,2023-07-24,505,oven,18490,24000,5510,1,00059,India
851109,2023-07-24,501,iphone 15,60000,80000,20000,1,00059,India
851109,2023-07-24,502,iphone 15 pro max,100000,135000,35000,1,00059,India
851109,2023-07-24,503,mixer,1349,3249,1900,1,00059,India
479294,2023-07-24,505,oven,18490,24000,5510,1,00001,India
479294,2023-07-24,501,iphone 15,60000,80000,20000,1,00001,India
757646,2023-07-24,507,washing machine,6990,16490,9500,1,00085,India
757646,2023-07-24,503,mixer,1349,3249,1900,1,00085,India
757646,2023-07-24,501,iphone 15,60000,80000,20000,1,00085,India
757646,2023-07-24,505,oven,18490,24000,5510,1,00085,India
757646,2023-07-24,502,iphone 15 pro max,100000,135000,35000,1,00085,India
785001,2023-07-24,503,mixer,1349,3249,1900,1,00255,India
430497,2023-07-24,502,iphone 15 pro max,100000,135000,35000,1,00341,India
430497,2023-07-24,503,mixer,1349,3249,1900,1,00341,India
697675,2023-07-24,505,oven,18490,24000,5510,1,00453,India
697675,2023-07-24,501,iphone 15,60000,80000,20000,1,00453,India
697675,2023-07-24,504,iron,449,879,430,1,00453,India
760074,2023-07-24,503,mixer,1349,3249,1900,1,00459,India
760074,2023-07-24,505,oven,18490,24000,5510,1,00459,India
760074,2023-07-24,504,iron,449,879,430,1,00459,India
609948,2023-07-24,503,mixer,1349,3249,1900,1,00360,India
609948,2023-07-24,505,oven,18490,24000,5510,1,00360,India
486211,2023-07-24,506,monitor,3249,8000,4751,1,00262,India
486211,2023-07-24,502,iphone 15 pro max,100000,135000,35000,1,00262,India
486211,2023-07-24,504,iron,449,879,430,1,00262,India
480276,2023-07-24,502,iphone 15 pro max,100000,135000,35000,1,00103,India
480276,2023-07-24,507,washing machine,6990,16490,9500,1,00103,India
480276,2023-07-24,505,oven,18490,24000,5510,1,00103,India
480276,2023-07-24,503,mixer,1349,3249,1900,1,00103,India
480276,2023-07-24,506,monitor,3249,8000,4751,1,00103,India
848346,2023-07-24,504,iron,449,879,430,1,00189,India
848346,2023-07-24,507,washing machine,6990,16490,9500,1,00189,India
848346,2023-07-24,505,oven,18490,24000,5510,1,00189,India
848346,2023-07-24,503,mixer,1349,3249,1900,1,00189,India
704179,2023-07-24,506,monitor,3249,8000,4751,1,00020,India
704179,2023-07-24,501,iphone 15,60000,80000,20000,1,00020,India
704179,2023-07-24,504,iron,449,879,430,1,00020,India
591337,2023-07-24,503,mixer,1349,3249,1900,1,00136,India
591337,2023-07-24,505,oven,18490,24000,5510,1,00136,India
185905,2023-07-24,502,iphone 15 pro max,100000,135000,35000,1,00101,India
185905,2023-07-24,507,washing machine,6990,16490,9500,1,00101,India
724777,2023-07-24,502,iphone 15 pro max,100000,135000,35000,1,00327,India
724777,2023-07-24,504,iron,449,879,430,1,00327,India
724777,2023-07-24,501,iphone 15,60000,80000,20000,1,00327,India
724777,2023-07-24,505,oven,18490,24000,5510,1,00327,India
703805,2023-07-25,501,iphone 15,60000,80000,20000,1,00396,India
703805,2023-07-25,507,washing machine,6990,16490,9500,1,00396,India
703805,2023-07-25,505,oven,18490,24000,5510,1,00396,India
988587,2023-07-25,505,oven,18490,24000,5510,1,00387,India
988587,2023-07-25,506,monitor,3249,8000,4751,1,00387,India
988587,2023-07-25,503,mixer,1349,3249,1900,1,00387,India
988587,2023-07-25,501,iphone 15,60000,80000,20000,1,00387,India
948363,2023-07-25,507,washing machine,6990,16490,9500,1,00451,India
283603,2023-07-25,501,iphone 15,60000,80000,20000,1,00280,India
283603,2023-07-25,505,oven,18490,24000,5510,1,00280,India
283603,2023-07-25,502,iphone 15 pro max,100000,135000,35000,1,00280,India
283603,2023-07-25,507,washing machine,6990,16490,9500,1,00280,India
283603,2023-07-25,504,iron,449,879,430,1,00280,India
319475,2023-07-25,506,monitor,3249,8000,4751,1,00340,India
319475,2023-07-25,505,oven,18490,24000,5510,1,00340,India
319475,2023-07-25,501,iphone 15,60000,80000,20000,1,00340,India
973042,2023-07-25,504,iron,449,879,430,1,00041,India
973042,2023-07-25,501,iphone 15,60000,80000,20000,1,00041,India
374841,2023-07-25,506,monitor,3249,8000,4751,1,00294,India
374841,2023-07-25,501,iphone 15,60000,80000,20000,1,00294,India
374841,2023-07-25,505,oven,18490,24000,5510,1,00294,India
374841,2023-07-25,502,iphone 15 pro max,100000,135000,35000,1,00294,India
374841,2023-07-25,504,iron,449,879,430,1,00294,India
470576,2023-07-25,501,iphone 15,60000,80000,20000,1,00095,India
470576,2023-07-25,505,oven,18490,24000,5510,1,00095,India
470576,2023-07-25,502,iphone 15 pro max,100000,135000,35000,1,00095,India
801454,2023-07-25,504,iron,449,879,430,1,00151,India
801454,2023-07-25,505,oven,18490,24000,5510,1,00151,India
609830,2023-07-25,504,iron,449,879,430,1,00403,India
609830,2023-07-25,503,mixer,1349,3249,1900,1,00403,India
217311,2023-07-25,505,oven,18490,24000,5510,1,00424,India
217311,2023-07-25,507,washing machine,6990,16490,9500,1,00424,India
217311,2023-07-25,502,iphone 15 pro max,100000,135000,35000,1,00424,India
639392,2023-07-25,505,oven,18490,24000,5510,1,00446,India
639392,2023-07-25,506,monitor,3249,8000,4751,1,00446,India
639392,2023-07-25,502,iphone 15 pro max,100000,135000,35000,1,00446,India
839617,2023-07-25,501,iphone 15,60000,80000,20000,1,00267,India
839617,2023-07-25,507,washing machine,6990,16490,9500,1,00267,India
839617,2023-07-25,503,mixer,1349,3249,1900,1,00267,India
994375,2023-07-25,503,mixer,1349,3249,1900,1,00257,India
994375,2023-07-25,506,monitor,3249,8000,4751,1,00257,India
966403,2023-07-25,503,mixer,1349,3249,1900,1,00322,India
966403,2023-07-25,506,monitor,3249,8000,4751,1,00322,India
966403,2023-07-25,505,oven,18490,24000,5510,1,00322,India
482472,2023-07-25,503,mixer,1349,3249,1900,1,00451,India
482472,2023-07-25,505,oven,18490,24000,5510,1,00451,India
482472,2023-07-25,502,iphone 15 pro max,100000,135000,35000,1,00451,India
482472,2023-07-25,504,iron,449,879,430,1,00451,India
482472,2023-07-25,506,monitor,3249,8000,4751,1,00451,India
140941,2023-07-25,503,mixer,1349,3249,1900,1,00320,India
140941,2023-07-25,502,iphone 15 pro max,100000,135000,35000,1,00320,India
990612,2023-07-25,504,iron,449,879,430,1,00348,India
990612,2023-07-25,506,monitor,3249,8000,4751,1,00348,India
990612,2023-07-25,501,iphone 15,60000,80000,20000,1,00348,India
990612,2023-07-25,507,washing machine,6990,16490,9500,1,00348,India
893966,2023-07-25,503,mixer,1349,3249,1900,1,00142,India
893966,2023-07-25,504,iron,449,879,430,1,00142,India
128011,2023-07-25,504,iron,449,879,430,1,00170,India
128011,2023-07-25,505,oven,18490,24000,5510,1,00170,India
128011,2023-07-25,502,iphone 15 pro max,100000,135000,35000,1,00170,India
587597,2023-07-25,505,oven,18490,24000,5510,1,00162,India
587597,2023-07-25,506,monitor,3249,8000,4751,1,00162,India
587597,2023-07-25,503,mixer,1349,3249,1900,1,00162,India
800627,2023-07-25,506,monitor,3249,8000,4751,1,00111,India
800627,2023-07-25,505,oven,18490,24000,5510,1,00111,India
800627,2023-07-25,501,iphone 15,60000,80000,20000,1,00111,India
259898,2023-07-25,507,washing machine,6990,16490,9500,1,00453,India
699211,2023-07-25,505,oven,18490,24000,5510,1,00310,India
699211,2023-07-25,502,iphone 15 pro max,100000,135000,35000,1,00310,India
699211,2023-07-25,507,washing machine,6990,16490,9500,1,00310,India
454624,2023-07-25,505,oven,18490,24000,5510,1,00385,India
454624,2023-07-25,502,iphone 15 pro max,100000,135000,35000,1,00385,India
454624,2023-07-25,506,monitor,3249,8000,4751,1,00385,India
454624,2023-07-25,503,mixer,1349,3249,1900,1,00385,India
941924,2023-07-25,504,iron,449,879,430,1,00301,India
484584,2023-07-25,503,mixer,1349,3249,1900,1,00416,India
484584,2023-07-25,505,oven,18490,24000,5510,1,00416,India
484584,2023-07-25,502,iphone 15 pro max,100000,135000,35000,1,00416,India
786151,2023-07-25,506,monitor,3249,8000,4751,1,00066,India
786151,2023-07-25,504,iron,449,879,430,1,00066,India
300218,2023-07-25,503,mixer,1349,3249,1900,1,00145,India
300218,2023-07-25,506,monitor,3249,8000,4751,1,00145,India
148230,2023-07-25,507,washing machine,6990,16490,9500,1,00390,India
148230,2023-07-25,505,oven,18490,24000,5510,1,00390,India
698893,2023-07-25,505,oven,18490,24000,5510,1,00225,India
698893,2023-07-25,507,washing machine,6990,16490,9500,1,00225,India
698893,2023-07-25,506,monitor,3249,8000,4751,1,00225,India
698893,2023-07-25,502,iphone 15 pro max,100000,135000,35000,1,00225,India
662834,2023-07-25,505,oven,18490,24000,5510,1,00005,India
789371,2023-07-25,502,iphone 15 pro max,100000,135000,35000,1,00160,India
347644,2023-07-25,503,mixer,1349,3249,1900,1,00031,India
347644,2023-07-25,502,iphone 15 pro max,100000,135000,35000,1,00031,India
347644,2023-07-25,507,washing machine,6990,16490,9500,1,00031,India
347644,2023-07-25,505,oven,18490,24000,5510,1,00031,India
378006,2023-07-25,507,washing machine,6990,16490,9500,1,00448,India
378006,2023-07-25,503,mixer,1349,3249,1900,1,00448,India
378006,2023-07-25,506,monitor,3249,8000,4751,1,00448,India
246322,2023-07-25,502,iphone 15 pro max,100000,135000,35000,1,00235,India
246322,2023-07-25,501,iphone 15,60000,80000,20000,1,00235,India
926494,2023-07-25,504,iron,449,879,430,1,00057,India
926494,2023-07-25,506,monitor,3249,8000,4751,1,00057,India
926494,2023-07-25,507,washing machine,6990,16490,9500,1,00057,India
506135,2023-07-25,506,monitor,3249,8000,4751,1,00345,India
506135,2023-07-25,505,oven,18490,24000,5510,1,00345,India
743881,2023-07-25,501,iphone 15,60000,80000,20000,1,00091,India
743881,2023-07-25,503,mixer,1349,3249,1900,1,00091,India
815409,2023-07-25,502,iphone 15 pro max,100000,135000,35000,1,00216,India
554467,2023-07-25,502,iphone 15 pro max,100000,135000,35000,1,00116,India
554467,2023-07-25,507,washing machine,6990,16490,9500,1,00116,India
100395,2023-07-25,507,washing machine,6990,16490,9500,1,00277,India
100395,2023-07-25,503,mixer,1349,3249,1900,1,00277,India
100395,2023-07-25,501,iphone 15,60000,80000,20000,1,00277,India
100395,2023-07-25,504,iron,449,879,430,1,00277,India
100395,2023-07-25,505,oven,18490,24000,5510,1,00277,India
813478,2023-07-25,506,monitor,3249,8000,4751,1,00333,India
813478,2023-07-25,505,oven,18490,24000,5510,1,00333,India
136922,2023-07-25,506,monitor,3249,8000,4751,1,00077,India
136922,2023-07-25,502,iphone 15 pro max,100000,135000,35000,1,00077,India
136922,2023-07-25,501,iphone 15,60000,80000,20000,1,00077,India
136922,2023-07-25,507,washing machine,6990,16490,9500,1,00077,India
569518,2023-07-25,501,iphone 15,60000,80000,20000,1,00162,India
856849,2023-07-25,503,mixer,1349,3249,1900,1,00262,India
252510,2023-07-25,504,iron,449,879,430,1,00411,India
252510,2023-07-25,502,iphone 15 pro max,100000,135000,35000,1,00411,India
252510,2023-07-25,506,monitor,3249,8000,4751,1,00411,India
125769,2023-07-25,504,iron,449,879,430,1,00238,India
125769,2023-07-25,507,washing machine,6990,16490,9500,1,00238,India
228859,2023-07-25,502,iphone 15 pro max,100000,135000,35000,1,00419,India
228859,2023-07-25,504,iron,449,879,430,1,00419,India
228859,2023-07-25,506,monitor,3249,8000,4751,1,00419,India
228859,2023-07-25,503,mixer,1349,3249,1900,1,00419,India
421403,2023-07-25,505,oven,18490,24000,5510,1,00311,India
189047,2023-07-25,505,oven,18490,24000,5510,1,00226,India
189047,2023-07-25,501,iphone 15,60000,80000,20000,1,00226,India
189047,2023-07-25,502,iphone 15 pro max,100000,135000,35000,1,00226,India
939632,2023-07-25,504,iron,449,879,430,1,00330,India
939632,2023-07-25,505,oven,18490,24000,5510,1,00330,India
939632,2023-07-25,503,mixer,1349,3249,1900,1,00330,India
542615,2023-07-25,507,washing machine,6990,16490,9500,1,00094,India
542615,2023-07-25,504,iron,449,879,430,1,00094,India
683517,2023-07-25,503,mixer,1349,3249,1900,1,00449,India
902912,2023-07-25,501,iphone 15,60000,80000,20000,1,00017,India
925525,2023-07-25,505,oven,18490,24000,5510,1,00490,India
697038,2023-07-25,504,iron,449,879,430,1,00168,India
697038,2023-07-25,507,washing machine,6990,16490,9500,1,00168,India
697038,2023-07-25,503,mixer,1349,3249,1900,1,00168,India
697038,2023-07-25,501,iphone 15,60000,80000,20000,1,00168,India
919610,2023-07-25,502,iphone 15 pro max,100000,135000,35000,1,00105,India
919610,2023-07-25,506,monitor,3249,8000,4751,1,00105,India
919610,2023-07-25,504,iron,449,879,430,1,00105,India
749879,2023-07-25,506,monitor,3249,8000,4751,1,00052,India
749879,2023-07-25,502,iphone 15 pro max,100000,135000,35000,1,00052,India
749879,2023-07-25,505,oven,18490,24000,5510,1,00052,India
525056,2023-07-25,503,mixer,1349,3249,1900,1,00435,India
525056,2023-07-25,502,iphone 15 pro max,100000,135000,35000,1,00435,India
525056,2023-07-25,504,iron,449,879,430,1,00435,India
525056,2023-07-25,501,iphone 15,60000,80000,20000,1,00435,India
436972,2023-07-25,506,monitor,3249,8000,4751,1,00341,India
436972,2023-07-25,501,iphone 15,60000,80000,20000,1,00341,India
840180,2023-07-25,503,mixer,1349,3249,1900,1,00240,India
840180,2023-07-25,504,iron,449,879,430,1,00240,India
840180,2023-07-25,505,oven,18490,24000,5510,1,00240,India
350830,2023-07-25,502,iphone 15 pro max,100000,135000,35000,1,00438,India
350830,2023-07-25,501,iphone 15,60000,80000,20000,1,00438,India
306029,2023-07-25,502,iphone 15 pro max,100000,135000,35000,1,00216,India
403988,2023-07-25,501,iphone 15,60000,80000,20000,1,00128,India
403988,2023-07-25,502,iphone 15 pro max,100000,135000,35000,1,00128,India
403988,2023-07-25,504,iron,449,879,430,1,00128,India
964669,2023-07-25,501,iphone 15,60000,80000,20000,1,00296,India
964669,2023-07-25,505,oven,18490,24000,5510,1,00296,India
964669,2023-07-25,506,monitor,3249,8000,4751,1,00296,India
964669,2023-07-25,507,washing machine,6990,16490,9500,1,00296,India
376172,2023-07-25,504,iron,449,879,430,1,00037,India
376172,2023-07-25,503,mixer,1349,3249,1900,1,00037,India
376172,2023-07-25,505,oven,18490,24000,5510,1,00037,India
977059,2023-07-25,507,washing machine,6990,16490,9500,1,00178,India
977059,2023-07-25,504,iron,449,879,430,1,00178,India
977059,2023-07-25,503,mixer,1349,3249,1900,1,00178,India
603796,2023-07-25,507,washing machine,6990,16490,9500,1,00278,India
603796,2023-07-25,505,oven,18490,24000,5510,1,00278,India
603796,2023-07-25,506,monitor,3249,8000,4751,1,00278,India
406196,2023-07-25,504,iron,449,879,430,1,00066,India
406196,2023-07-25,505,oven,18490,24000,5510,1,00066,India
298693,2023-07-25,503,mixer,1349,3249,1900,1,00369,India
298693,2023-07-25,505,oven,18490,24000,5510,1,00369,India
119460,2023-07-25,507,washing machine,6990,16490,9500,1,00225,India
119460,2023-07-25,503,mixer,1349,3249,1900,1,00225,India
160478,2023-07-25,505,oven,18490,24000,5510,1,00297,India
160478,2023-07-25,506,monitor,3249,8000,4751,1,00297,India
850065,2023-07-25,504,iron,449,879,430,1,00494,India
850065,2023-07-25,501,iphone 15,60000,80000,20000,1,00494,India
850065,2023-07-25,506,monitor,3249,8000,4751,1,00494,India
850065,2023-07-25,505,oven,18490,24000,5510,1,00494,India
532717,2023-07-25,507,washing machine,6990,16490,9500,1,00409,India
879099,2023-07-25,505,oven,18490,24000,5510,1,00272,India
743867,2023-07-25,504,iron,449,879,430,1,00065,India
695543,2023-07-25,507,washing machine,6990,16490,9500,1,00478,India
695543,2023-07-25,505,oven,18490,24000,5510,1,00478,India
695543,2023-07-25,501,iphone 15,60000,80000,20000,1,00478,India
695543,2023-07-25,504,iron,449,879,430,1,00478,India
890382,2023-07-25,503,mixer,1349,3249,1900,1,00168,India
890382,2023-07-25,507,washing machine,6990,16490,9500,1,00168,India
117913,2023-07-25,507,washing machine,6990,16490,9500,1,00019,India
456684,2023-07-25,501,iphone 15,60000,80000,20000,1,00039,India
456684,2023-07-25,504,iron,449,879,430,1,00039,India
174932,2023-07-25,501,iphone 15,60000,80000,20000,1,00164,India
174932,2023-07-25,502,iphone 15 pro max,100000,135000,35000,1,00164,India
174932,2023-07-25,507,washing machine,6990,16490,9500,1,00164,India
516916,2023-07-25,507,washing machine,6990,16490,9500,1,00286,India
516916,2023-07-25,505,oven,18490,24000,5510,1,00286,India
516916,2023-07-25,506,monitor,3249,8000,4751,1,00286,India
916258,2023-07-25,507,washing machine,6990,16490,9500,1,00012,India
916258,2023-07-25,503,mixer,1349,3249,1900,1,00012,India
916258,2023-07-25,501,iphone 15,60000,80000,20000,1,00012,India
360713,2023-07-25,506,monitor,3249,8000,4751,1,00112,India
360713,2023-07-25,501,iphone 15,60000,80000,20000,1,00112,India
360713,2023-07-25,505,oven,18490,24000,5510,1,00112,India
360713,2023-07-25,507,washing machine,6990,16490,9500,1,00112,India
271114,2023-07-25,507,washing machine,6990,16490,9500,1,00258,India
271114,2023-07-25,501,iphone 15,60000,80000,20000,1,00258,India
271114,2023-07-25,503,mixer,1349,3249,1900,1,00258,India
124311,2023-07-25,503,mixer,1349,3249,1900,1,00119,India
124311,2023-07-25,505,oven,18490,24000,5510,1,00119,India
837440,2023-07-26,506,monitor,3249,8000,4751,1,00023,India
837440,2023-07-26,505,oven,18490,24000,5510,1,00023,India
557677,2023-07-26,503,mixer,1349,3249,1900,1,00489,India
936115,2023-07-26,506,monitor,3249,8000,4751,1,00256,India
936115,2023-07-26,501,iphone 15,60000,80000,20000,1,00256,India
936115,2023-07-26,505,oven,18490,24000,5510,1,00256,India
564666,2023-07-26,503,mixer,1349,3249,1900,1,00420,India
564666,2023-07-26,505,oven,18490,24000,5510,1,00420,India
417113,2023-07-26,503,mixer,1349,3249,1900,1,00375,India
189890,2023-07-26,507,washing machine,6990,16490,9500,1,00441,India
189890,2023-07-26,503,mixer,1349,3249,1900,1,00441,India
189890,2023-07-26,505,oven,18490,24000,5510,1,00441,India
852086,2023-07-26,502,iphone 15 pro max,100000,135000,35000,1,00025,India
852086,2023-07-26,507,washing machine,6990,16490,9500,1,00025,India
852086,2023-07-26,506,monitor,3249,8000,4751,1,00025,India
359214,2023-07-26,503,mixer,1349,3249,1900,1,00081,India
220137,2023-07-26,501,iphone 15,60000,80000,20000,1,00078,India
220137,2023-07-26,502,iphone 15 pro max,100000,135000,35000,1,00078,India
220137,2023-07-26,505,oven,18490,24000,5510,1,00078,India
259005,2023-07-26,506,monitor,3249,8000,4751,1,00163,India
514177,2023-07-26,506,monitor,3249,8000,4751,1,00303,India
514177,2023-07-26,507,washing machine,6990,16490,9500,1,00303,India
366939,2023-07-26,507,washing machine,6990,16490,9500,1,00179,India
366939,2023-07-26,505,oven,18490,24000,5510,1,00179,India
366939,2023-07-26,503,mixer,1349,3249,1900,1,00179,India
366939,2023-07-26,502,iphone 15 pro max,100000,135000,35000,1,00179,India
879287,2023-07-26,506,monitor,3249,8000,4751,1,00038,India
879287,2023-07-26,503,mixer,1349,3249,1900,1,00038,India
879287,2023-07-26,505,oven,18490,24000,5510,1,00038,India
601785,2023-07-26,502,iphone 15 pro max,100000,135000,35000,1,00255,India
547924,2023-07-26,501,iphone 15,60000,80000,20000,1,00421,India
547924,2023-07-26,505,oven,18490,24000,5510,1,00421,India
547924,2023-07-26,507,washing machine,6990,16490,9500,1,00421,India
547924,2023-07-26,503,mixer,1349,3249,1900,1,00421,India
297007,2023-07-26,502,iphone 15 pro max,100000,135000,35000,1,00209,India
969990,2023-07-26,503,mixer,1349,3249,1900,1,00492,India
969990,2023-07-26,506,monitor,3249,8000,4751,1,00492,India
969990,2023-07-26,505,oven,18490,24000,5510,1,00492,India
498963,2023-07-26,504,iron,449,879,430,1,00369,India
498963,2023-07-26,507,washing machine,6990,16490,9500,1,00369,India
498963,2023-07-26,506,monitor,3249,8000,4751,1,00369,India
834665,2023-07-26,507,washing machine,6990,16490,9500,1,00017,India
479564,2023-07-26,506,monitor,3249,8000,4751,1,00067,India
479564,2023-07-26,502,iphone 15 pro max,100000,135000,35000,1,00067,India
337866,2023-07-26,502,iphone 15 pro max,100000,135000,35000,1,00156,India
337866,2023-07-26,506,monitor,3249,8000,4751,1,00156,India
478686,2023-07-26,505,oven,18490,24000,5510,1,00266,India
478686,2023-07-26,502,iphone 15 pro max,100000,135000,35000,1,00266,India
646294,2023-07-26,505,oven,18490,24000,5510,1,00146,India
646294,2023-07-26,506,monitor,3249,8000,4751,1,00146,India
710376,2023-07-26,506,monitor,3249,8000,4751,1,00193,India
710376,2023-07-26,507,washing machine,6990,16490,9500,1,00193,India
954461,2023-07-26,502,iphone 15 pro max,100000,135000,35000,1,00130,India
954461,2023-07-26,506,monitor,3249,8000,4751,1,00130,India
954461,2023-07-26,507,washing machine,6990,16490,9500,1,00130,India
954461,2023-07-26,501,iphone 15,60000,80000,20000,1,00130,India
954461,2023-07-26,504,iron,449,879,430,1,00130,India
582763,2023-07-26,506,monitor,3249,8000,4751,1,00471,India
582763,2023-07-26,505,oven,18490,24000,5510,1,00471,India
582763,2023-07-26,504,iron,449,879,430,1,00471,India
582763,2023-07-26,501,iphone 15,60000,80000,20000,1,00471,India
743194,2023-07-26,502,iphone 15 pro max,100000,135000,35000,1,00258,India
743194,2023-07-26,505,oven,18490,24000,5510,1,00258,India
749043,2023-07-26,503,mixer,1349,3249,1900,1,00122,India
749043,2023-07-26,502,iphone 15 pro max,100000,135000,35000,1,00122,India
478855,2023-07-26,505,oven,18490,24000,5510,1,00015,India
478855,2023-07-26,503,mixer,1349,3249,1900,1,00015,India
368516,2023-07-26,505,oven,18490,24000,5510,1,00001,India
368516,2023-07-26,501,iphone 15,60000,80000,20000,1,00001,India
368516,2023-07-26,507,washing machine,6990,16490,9500,1,00001,India
368516,2023-07-26,502,iphone 15 pro max,100000,135000,35000,1,00001,India
239004,2023-07-26,503,mixer,1349,3249,1900,1,00146,India
239004,2023-07-26,502,iphone 15 pro max,100000,135000,35000,1,00146,India
239004,2023-07-26,501,iphone 15,60000,80000,20000,1,00146,India
239004,2023-07-26,506,monitor,3249,8000,4751,1,00146,India
212999,2023-07-26,502,iphone 15 pro max,100000,135000,35000,1,00188,India
212999,2023-07-26,501,iphone 15,60000,80000,20000,1,00188,India
212999,2023-07-26,507,washing machine,6990,16490,9500,1,00188,India
212999,2023-07-26,503,mixer,1349,3249,1900,1,00188,India
212999,2023-07-26,505,oven,18490,24000,5510,1,00188,India
110407,2023-07-26,503,mixer,1349,3249,1900,1,00382,India
110407,2023-07-26,502,iphone 15 pro max,100000,135000,35000,1,00382,India
552036,2023-07-26,505,oven,18490,24000,5510,1,00023,India
552036,2023-07-26,502,iphone 15 pro max,100000,135000,35000,1,00023,India
552036,2023-07-26,506,monitor,3249,8000,4751,1,00023,India
800255,2023-07-26,502,iphone 15 pro max,100000,135000,35000,1,00394,India
300114,2023-07-26,503,mixer,1349,3249,1900,1,00277,India
300114,2023-07-26,507,washing machine,6990,16490,9500,1,00277,India
300114,2023-07-26,501,iphone 15,60000,80000,20000,1,00277,India
872147,2023-07-26,505,oven,18490,24000,5510,1,00132,India
872147,2023-07-26,502,iphone 15 pro max,100000,135000,35000,1,00132,India
872147,2023-07-26,501,iphone 15,60000,80000,20000,1,00132,India
872147,2023-07-26,506,monitor,3249,8000,4751,1,00132,India
872147,2023-07-26,504,iron,449,879,430,1,00132,India
262738,2023-07-26,503,mixer,1349,3249,1900,1,00133,India
262738,2023-07-26,502,iphone 15 pro max,100000,135000,35000,1,00133,India
262738,2023-07-26,507,washing machine,6990,16490,9500,1,00133,India
262738,2023-07-26,506,monitor,3249,8000,4751,1,00133,India
795692,2023-07-26,501,iphone 15,60000,80000,20000,1,00484,India
795692,2023-07-26,505,oven,18490,24000,5510,1,00484,India
795692,2023-07-26,506,monitor,3249,8000,4751,1,00484,India
795692,2023-07-26,503,mixer,1349,3249,1900,1,00484,India
382871,2023-07-26,503,mixer,1349,3249,1900,1,00214,India
945259,2023-07-26,506,monitor,3249,8000,4751,1,00286,India
945259,2023-07-26,507,washing machine,6990,16490,9500,1,00286,India
945259,2023-07-26,502,iphone 15 pro max,100000,135000,35000,1,00286,India
945259,2023-07-26,505,oven,18490,24000,5510,1,00286,India
945259,2023-07-26,501,iphone 15,60000,80000,20000,1,00286,India
360508,2023-07-26,504,iron,449,879,430,1,00050,India
360508,2023-07-26,502,iphone 15 pro max,100000,135000,35000,1,00050,India
597867,2023-07-26,501,iphone 15,60000,80000,20000,1,00446,India
597867,2023-07-26,502,iphone 15 pro max,100000,135000,35000,1,00446,India
597867,2023-07-26,507,washing machine,6990,16490,9500,1,00446,India
521932,2023-07-26,503,mixer,1349,3249,1900,1,00371,India
521932,2023-07-26,505,oven,18490,24000,5510,1,00371,India
521932,2023-07-26,506,monitor,3249,8000,4751,1,00371,India
521932,2023-07-26,502,iphone 15 pro max,100000,135000,35000,1,00371,India
958624,2023-07-26,504,iron,449,879,430,1,00386,India
958624,2023-07-26,506,monitor,3249,8000,4751,1,00386,India
958624,2023-07-26,502,iphone 15 pro max,100000,135000,35000,1,00386,India
261187,2023-07-26,507,washing machine,6990,16490,9500,1,00024,India
336881,2023-07-26,505,oven,18490,24000,5510,1,00232,India
676882,2023-07-26,505,oven,18490,24000,5510,1,00336,India
676882,2023-07-26,502,iphone 15 pro max,100000,135000,35000,1,00336,India
676882,2023-07-26,507,washing machine,6990,16490,9500,1,00336,India
394756,2023-07-26,505,oven,18490,24000,5510,1,00436,India
629748,2023-07-26,505,oven,18490,24000,5510,1,00169,India
629748,2023-07-26,506,monitor,3249,8000,4751,1,00169,India
548341,2023-07-26,506,monitor,3249,8000,4751,1,00396,India
548341,2023-07-26,504,iron,449,879,430,1,00396,India
548341,2023-07-26,507,washing machine,6990,16490,9500,1,00396,India
124634,2023-07-26,502,iphone 15 pro max,100000,135000,35000,1,00217,India
124634,2023-07-26,506,monitor,3249,8000,4751,1,00217,India
200286,2023-07-26,502,iphone 15 pro max,100000,135000,35000,1,00409,India
200286,2023-07-26,501,iphone 15,60000,80000,20000,1,00409,India
200286,2023-07-26,503,mixer,1349,3249,1900,1,00409,India
144803,2023-07-26,506,monitor,3249,8000,4751,1,00029,India
144803,2023-07-26,501,iphone 15,60000,80000,20000,1,00029,India
938871,2023-07-26,501,iphone 15,60000,80000,20000,1,00038,India
938871,2023-07-26,507,washing machine,6990,16490,9500,1,00038,India
938871,2023-07-26,502,iphone 15 pro max,100000,135000,35000,1,00038,India
864550,2023-07-26,505,oven,18490,24000,5510,1,00029,India
864550,2023-07-26,504,iron,449,879,430,1,00029,India
801098,2023-07-26,502,iphone 15 pro max,100000,135000,35000,1,00496,India
549007,2023-07-26,507,washing machine,6990,16490,9500,1,00148,India
351618,2023-07-26,501,iphone 15,60000,80000,20000,1,00114,India
351618,2023-07-26,505,oven,18490,24000,5510,1,00114,India
351618,2023-07-26,503,mixer,1349,3249,1900,1,00114,India
351618,2023-07-26,506,monitor,3249,8000,4751,1,00114,India
417340,2023-07-26,503,mixer,1349,3249,1900,1,00083,India
417340,2023-07-26,505,oven,18490,24000,5510,1,00083,India
133156,2023-07-26,506,monitor,3249,8000,4751,1,00334,India
133156,2023-07-26,503,mixer,1349,3249,1900,1,00334,India
133156,2023-07-26,505,oven,18490,24000,5510,1,00334,India
285685,2023-07-26,507,washing machine,6990,16490,9500,1,00427,India
285685,2023-07-26,501,iphone 15,60000,80000,20000,1,00427,India
285685,2023-07-26,506,monitor,3249,8000,4751,1,00427,India
127853,2023-07-26,506,monitor,3249,8000,4751,1,00071,India
127853,2023-07-26,502,iphone 15 pro max,100000,135000,35000,1,00071,India
127853,2023-07-26,504,iron,449,879,430,1,00071,India
127853,2023-07-26,507,washing machine,6990,16490,9500,1,00071,India
171444,2023-07-26,501,iphone 15,60000,80000,20000,1,00408,India
171444,2023-07-26,504,iron,449,879,430,1,00408,India
171444,2023-07-26,507,washing machine,6990,16490,9500,1,00408,India
443861,2023-07-26,502,iphone 15 pro max,100000,135000,35000,1,00158,India
443861,2023-07-26,506,monitor,3249,8000,4751,1,00158,India
443861,2023-07-26,501,iphone 15,60000,80000,20000,1,00158,India
443861,2023-07-26,503,mixer,1349,3249,1900,1,00158,India
443861,2023-07-26,505,oven,18490,24000,5510,1,00158,India
973309,2023-07-26,506,monitor,3249,8000,4751,1,00086,India
973309,2023-07-26,505,oven,18490,24000,5510,1,00086,India
973309,2023-07-26,507,washing machine,6990,16490,9500,1,00086,India
973309,2023-07-26,502,iphone 15 pro max,100000,135000,35000,1,00086,India
960719,2023-07-26,506,monitor,3249,8000,4751,1,00134,India
960719,2023-07-26,502,iphone 15 pro max,100000,135000,35000,1,00134,India
185858,2023-07-26,506,monitor,3249,8000,4751,1,00096,India
185858,2023-07-26,505,oven,18490,24000,5510,1,00096,India
185858,2023-07-26,502,iphone 15 pro max,100000,135000,35000,1,00096,India
567794,2023-07-26,502,iphone 15 pro max,100000,135000,35000,1,00044,India
706304,2023-07-26,503,mixer,1349,3249,1900,1,00459,India
299943,2023-07-26,502,iphone 15 pro max,100000,135000,35000,1,00388,India
299943,2023-07-26,504,iron,449,879,430,1,00388,India
299943,2023-07-26,501,iphone 15,60000,80000,20000,1,00388,India
299943,2023-07-26,506,monitor,3249,8000,4751,1,00388,India
299943,2023-07-26,507,washing machine,6990,16490,9500,1,00388,India
772754,2023-07-26,502,iphone 15 pro max,100000,135000,35000,1,00001,India
772754,2023-07-26,505,oven,18490,24000,5510,1,00001,India
772754,2023-07-26,501,iphone 15,60000,80000,20000,1,00001,India
818655,2023-07-26,502,iphone 15 pro max,100000,135000,35000,1,00265,India
818655,2023-07-26,507,washing machine,6990,16490,9500,1,00265,India
818655,2023-07-26,504,iron,449,879,430,1,00265,India
436851,2023-07-26,502,iphone 15 pro max,100000,135000,35000,1,00048,India
436851,2023-07-26,507,washing machine,6990,16490,9500,1,00048,India
399061,2023-07-26,506,monitor,3249,8000,4751,1,00375,India
399061,2023-07-26,505,oven,18490,24000,5510,1,00375,India
399061,2023-07-26,503,mixer,1349,3249,1900,1,00375,India
399061,2023-07-26,507,washing machine,6990,16490,9500,1,00375,India
983275,2023-07-26,507,washing machine,6990,16490,9500,1,00359,India
190657,2023-07-26,504,iron,449,879,430,1,00048,India
190657,2023-07-26,501,iphone 15,60000,80000,20000,1,00048,India
198355,2023-07-26,507,washing machine,6990,16490,9500,1,00101,India
198355,2023-07-26,502,iphone 15 pro max,100000,135000,35000,1,00101,India
198355,2023-07-26,504,iron,449,879,430,1,00101,India
198355,2023-07-26,505,oven,18490,24000,5510,1,00101,India
771423,2023-07-26,505,oven,18490,24000,5510,1,00334,India
236609,2023-07-26,505,oven,18490,24000,5510,1,00452,India
236609,2023-07-26,501,iphone 15,60000,80000,20000,1,00452,India
236609,2023-07-26,502,iphone 15 pro max,100000,135000,35000,1,00452,India
970362,2023-07-26,501,iphone 15,60000,80000,20000,1,00296,India
970362,2023-07-26,507,washing machine,6990,16490,9500,1,00296,India
970362,2023-07-26,504,iron,449,879,430,1,00296,India
232115,2023-07-27,505,oven,18490,24000,5510,1,00476,India
232115,2023-07-27,504,iron,449,879,430,1,00476,India
600983,2023-07-27,507,washing machine,6990,16490,9500,1,00002,India
418427,2023-07-27,502,iphone 15 pro max,100000,135000,35000,1,00260,India
103086,2023-07-27,506,monitor,3249,8000,4751,1,00460,India
965559,2023-07-27,507,washing machine,6990,16490,9500,1,00456,India
533327,2023-07-27,507,washing machine,6990,16490,9500,1,00254,India
533327,2023-07-27,503,mixer,1349,3249,1900,1,00254,India
533327,2023-07-27,501,iphone 15,60000,80000,20000,1,00254,India
289401,2023-07-27,501,iphone 15,60000,80000,20000,1,00003,India
974654,2023-07-27,505,oven,18490,24000,5510,1,00208,India
759546,2023-07-27,505,oven,18490,24000,5510,1,00388,India
759546,2023-07-27,507,washing machine,6990,16490,9500,1,00388,India
759546,2023-07-27,501,iphone 15,60000,80000,20000,1,00388,India
759546,2023-07-27,504,iron,449,879,430,1,00388,India
533055,2023-07-27,504,iron,449,879,430,1,00016,India
165804,2023-07-27,501,iphone 15,60000,80000,20000,1,00366,India
813961,2023-07-27,504,iron,449,879,430,1,00457,India
813961,2023-07-27,501,iphone 15,60000,80000,20000,1,00457,India
533227,2023-07-27,505,oven,18490,24000,5510,1,00187,India
533227,2023-07-27,504,iron,449,879,430,1,00187,India
609824,2023-07-27,505,oven,18490,24000,5510,1,00466,India
609824,2023-07-27,501,iphone 15,60000,80000,20000,1,00466,India
609824,2023-07-27,502,iphone 15 pro max,100000,135000,35000,1,00466,India
609824,2023-07-27,504,iron,449,879,430,1,00466,India
145822,2023-07-27,505,oven,18490,24000,5510,1,00377,India
145822,2023-07-27,504,iron,449,879,430,1,00377,India
433083,2023-07-27,502,iphone 15 pro max,100000,135000,35000,1,00433,India
433083,2023-07-27,505,oven,18490,24000,5510,1,00433,India
234031,2023-07-27,504,iron,449,879,430,1,00343,India
234031,2023-07-27,502,iphone 15 pro max,100000,135000,35000,1,00343,India
234031,2023-07-27,507,washing machine,6990,16490,9500,1,00343,India
440999,2023-07-27,504,iron,449,879,430,1,00058,India
440999,2023-07-27,501,iphone 15,60000,80000,20000,1,00058,India
480834,2023-07-27,505,oven,18490,24000,5510,1,00186,India
480834,2023-07-27,506,monitor,3249,8000,4751,1,00186,India
480834,2023-07-27,502,iphone 15 pro max,100000,135000,35000,1,00186,India
480834,2023-07-27,504,iron,449,879,430,1,00186,India
480834,2023-07-27,503,mixer,1349,3249,1900,1,00186,India
209615,2023-07-27,506,monitor,3249,8000,4751,1,00235,India
209615,2023-07-27,507,washing machine,6990,16490,9500,1,00235,India
209615,2023-07-27,505,oven,18490,24000,5510,1,00235,India
154967,2023-07-27,505,oven,18490,24000,5510,1,00478,India
154967,2023-07-27,502,iphone 15 pro max,100000,135000,35000,1,00478,India
154967,2023-07-27,503,mixer,1349,3249,1900,1,00478,India
154967,2023-07-27,506,monitor,3249,8000,4751,1,00478,India
225324,2023-07-27,505,oven,18490,24000,5510,1,00178,India
463298,2023-07-27,503,mixer,1349,3249,1900,1,00419,India
679721,2023-07-27,503,mixer,1349,3249,1900,1,00024,India
679721,2023-07-27,501,iphone 15,60000,80000,20000,1,00024,India
679721,2023-07-27,505,oven,18490,24000,5510,1,00024,India
111455,2023-07-27,506,monitor,3249,8000,4751,1,00494,India
111455,2023-07-27,502,iphone 15 pro max,100000,135000,35000,1,00494,India
111455,2023-07-27,505,oven,18490,24000,5510,1,00494,India
111455,2023-07-27,507,washing machine,6990,16490,9500,1,00494,India
808488,2023-07-27,503,mixer,1349,3249,1900,1,00064,India
808488,2023-07-27,506,monitor,3249,8000,4751,1,00064,India
123420,2023-07-27,501,iphone 15,60000,80000,20000,1,00225,India
123420,2023-07-27,503,mixer,1349,3249,1900,1,00225,India
567588,2023-07-27,506,monitor,3249,8000,4751,1,00380,India
567588,2023-07-27,502,iphone 15 pro max,100000,135000,35000,1,00380,India
567588,2023-07-27,504,iron,449,879,430,1,00380,India
567588,2023-07-27,503,mixer,1349,3249,1900,1,00380,India
737225,2023-07-27,502,iphone 15 pro max,100000,135000,35000,1,00381,India
737225,2023-07-27,506,monitor,3249,8000,4751,1,00381,India
856284,2023-07-27,507,washing machine,6990,16490,9500,1,00439,India
856284,2023-07-27,502,iphone 15 pro max,100000,135000,35000,1,00439,India
856284,2023-07-27,505,oven,18490,24000,5510,1,00439,India
298221,2023-07-27,506,monitor,3249,8000,4751,1,00112,India
298221,2023-07-27,503,mixer,1349,3249,1900,1,00112,India
298221,2023-07-27,501,iphone 15,60000,80000,20000,1,00112,India
956718,2023-07-27,502,iphone 15 pro max,100000,135000,35000,1,00081,India
956718,2023-07-27,505,oven,18490,24000,5510,1,00081,India
956718,2023-07-27,503,mixer,1349,3249,1900,1,00081,India
895245,2023-07-27,507,washing machine,6990,16490,9500,1,00313,India
895245,2023-07-27,501,iphone 15,60000,80000,20000,1,00313,India
895245,2023-07-27,502,iphone 15 pro max,100000,135000,35000,1,00313,India
895245,2023-07-27,503,mixer,1349,3249,1900,1,00313,India
467449,2023-07-27,505,oven,18490,24000,5510,1,00352,India
953571,2023-07-27,506,monitor,3249,8000,4751,1,00160,India
953571,2023-07-27,501,iphone 15,60000,80000,20000,1,00160,India
953571,2023-07-27,505,oven,18490,24000,5510,1,00160,India
102072,2023-07-27,504,iron,449,879,430,1,00016,India
102072,2023-07-27,502,iphone 15 pro max,100000,135000,35000,1,00016,India
962143,2023-07-27,506,monitor,3249,8000,4751,1,00132,India
962143,2023-07-27,502,iphone 15 pro max,100000,135000,35000,1,00132,India
492014,2023-07-27,504,iron,449,879,430,1,00443,India
492014,2023-07-27,506,monitor,3249,8000,4751,1,00443,India
492014,2023-07-27,502,iphone 15 pro max,100000,135000,35000,1,00443,India
191252,2023-07-27,507,washing machine,6990,16490,9500,1,00499,India
191252,2023-07-27,501,iphone 15,60000,80000,20000,1,00499,India
191252,2023-07-27,504,iron,449,879,430,1,00499,India
191252,2023-07-27,505,oven,18490,24000,5510,1,00499,India
319076,2023-07-27,502,iphone 15 pro max,100000,135000,35000,1,00355,India
319076,2023-07-27,503,mixer,1349,3249,1900,1,00355,India
180470,2023-07-27,504,iron,449,879,430,1,00160,India
180470,2023-07-27,503,mixer,1349,3249,1900,1,00160,India
534671,2023-07-27,503,mixer,1349,3249,1900,1,00465,India
167624,2023-07-27,505,oven,18490,24000,5510,1,00204,India
167624,2023-07-27,501,iphone 15,60000,80000,20000,1,00204,India
167624,2023-07-27,503,mixer,1349,3249,1900,1,00204,India
765840,2023-07-27,507,washing machine,6990,16490,9500,1,00018,India
765840,2023-07-27,506,monitor,3249,8000,4751,1,00018,India
765840,2023-07-27,504,iron,449,879,430,1,00018,India
765840,2023-07-27,505,oven,18490,24000,5510,1,00018,India
288214,2023-07-27,503,mixer,1349,3249,1900,1,00057,India
288214,2023-07-27,506,monitor,3249,8000,4751,1,00057,India
288214,2023-07-27,504,iron,449,879,430,1,00057,India
825712,2023-07-27,503,mixer,1349,3249,1900,1,00259,India
825712,2023-07-27,504,iron,449,879,430,1,00259,India
376393,2023-07-27,504,iron,449,879,430,1,00442,India
376393,2023-07-27,506,monitor,3249,8000,4751,1,00442,India
376393,2023-07-27,505,oven,18490,24000,5510,1,00442,India
696909,2023-07-27,507,washing machine,6990,16490,9500,1,00481,India
696909,2023-07-27,504,iron,449,879,430,1,00481,India
696909,2023-07-27,506,monitor,3249,8000,4751,1,00481,India
490847,2023-07-27,503,mixer,1349,3249,1900,1,00432,India
490847,2023-07-27,501,iphone 15,60000,80000,20000,1,00432,India
490847,2023-07-27,504,iron,449,879,430,1,00432,India
636087,2023-07-27,506,monitor,3249,8000,4751,1,00161,India
636087,2023-07-27,507,washing machine,6990,16490,9500,1,00161,India
376754,2023-07-27,505,oven,18490,24000,5510,1,00338,India
376754,2023-07-27,502,iphone 15 pro max,100000,135000,35000,1,00338,India
376754,2023-07-27,501,iphone 15,60000,80000,20000,1,00338,India
376754,2023-07-27,507,washing machine,6990,16490,9500,1,00338,India
983252,2023-07-27,502,iphone 15 pro max,100000,135000,35000,1,00378,India
983252,2023-07-27,507,washing machine,6990,16490,9500,1,00378,India
983252,2023-07-27,506,monitor,3249,8000,4751,1,00378,India
983252,2023-07-27,503,mixer,1349,3249,1900,1,00378,India
115053,2023-07-27,501,iphone 15,60000,80000,20000,1,00065,India
533646,2023-07-27,502,iphone 15 pro max,100000,135000,35000,1,00299,India
533646,2023-07-27,506,monitor,3249,8000,4751,1,00299,India
125690,2023-07-27,501,iphone 15,60000,80000,20000,1,00139,India
125690,2023-07-27,503,mixer,1349,3249,1900,1,00139,India
125690,2023-07-27,504,iron,449,879,430,1,00139,India
300476,2023-07-27,506,monitor,3249,8000,4751,1,00312,India
300476,2023-07-27,503,mixer,1349,3249,1900,1,00312,India
663725,2023-07-27,502,iphone 15 pro max,100000,135000,35000,1,00080,India
556731,2023-07-27,503,mixer,1349,3249,1900,1,00049,India
556731,2023-07-27,507,washing machine,6990,16490,9500,1,00049,India
647647,2023-07-27,502,iphone 15 pro max,100000,135000,35000,1,00028,India
486109,2023-07-27,503,mixer,1349,3249,1900,1,00388,India
251776,2023-07-27,501,iphone 15,60000,80000,20000,1,00342,India
251776,2023-07-27,503,mixer,1349,3249,1900,1,00342,India
263006,2023-07-27,506,monitor,3249,8000,4751,1,00224,India
263006,2023-07-27,504,iron,449,879,430,1,00224,India
263006,2023-07-27,501,iphone 15,60000,80000,20000,1,00224,India
523478,2023-07-27,503,mixer,1349,3249,1900,1,00234,India
523478,2023-07-27,501,iphone 15,60000,80000,20000,1,00234,India
523478,2023-07-27,505,oven,18490,24000,5510,1,00234,India
495863,2023-07-27,502,iphone 15 pro max,100000,135000,35000,1,00439,India
495863,2023-07-27,506,monitor,3249,8000,4751,1,00439,India
495863,2023-07-27,507,washing machine,6990,16490,9500,1,00439,India
806688,2023-07-27,507,washing machine,6990,16490,9500,1,00378,India
806688,2023-07-27,501,iphone 15,60000,80000,20000,1,00378,India
418743,2023-07-27,502,iphone 15 pro max,100000,135000,35000,1,00017,India
530745,2023-07-27,505,oven,18490,24000,5510,1,00370,India
530745,2023-07-27,501,iphone 15,60000,80000,20000,1,00370,India
710673,2023-07-27,503,mixer,1349,3249,1900,1,00159,India
710673,2023-07-27,502,iphone 15 pro max,100000,135000,35000,1,00159,India
710673,2023-07-27,504,iron,449,879,430,1,00159,India
710673,2023-07-27,501,iphone 15,60000,80000,20000,1,00159,India
710673,2023-07-27,506,monitor,3249,8000,4751,1,00159,India
481080,2023-07-27,504,iron,449,879,430,1,00345,India
481080,2023-07-27,507,washing machine,6990,16490,9500,1,00345,India
486464,2023-07-27,504,iron,449,879,430,1,00245,India
486464,2023-07-27,503,mixer,1349,3249,1900,1,00245,India
599244,2023-07-27,504,iron,449,879,430,1,00105,India
599244,2023-07-27,503,mixer,1349,3249,1900,1,00105,India
174188,2023-07-27,503,mixer,1349,3249,1900,1,00059,India
174188,2023-07-27,502,iphone 15 pro max,100000,135000,35000,1,00059,India
174188,2023-07-27,504,iron,449,879,430,1,00059,India
174188,2023-07-27,507,washing machine,6990,16490,9500,1,00059,India
125237,2023-07-27,504,iron,449,879,430,1,00174,India
125237,2023-07-27,502,iphone 15 pro max,100000,135000,35000,1,00174,India
125237,2023-07-27,501,iphone 15,60000,80000,20000,1,00174,India
125237,2023-07-27,507,washing machine,6990,16490,9500,1,00174,India
931447,2023-07-27,503,mixer,1349,3249,1900,1,00081,India
931447,2023-07-27,507,washing machine,6990,16490,9500,1,00081,India
931447,2023-07-27,504,iron,449,879,430,1,00081,India
931447,2023-07-27,505,oven,18490,24000,5510,1,00081,India
148413,2023-07-27,501,iphone 15,60000,80000,20000,1,00214,India
148413,2023-07-27,506,monitor,3249,8000,4751,1,00214,India
920608,2023-07-27,507,washing machine,6990,16490,9500,1,00470,India
588274,2023-07-27,502,iphone 15 pro max,100000,135000,35000,1,00352,India
588274,2023-07-27,506,monitor,3249,8000,4751,1,00352,India
588274,2023-07-27,501,iphone 15,60000,80000,20000,1,00352,India
727840,2023-07-27,502,iphone 15 pro max,100000,135000,35000,1,00058,India
903902,2023-07-27,505,oven,18490,24000,5510,1,00149,India
889038,2023-07-27,507,washing machine,6990,16490,9500,1,00263,India
889038,2023-07-27,504,iron,449,879,430,1,00263,India
889038,2023-07-27,503,mixer,1349,3249,1900,1,00263,India
584377,2023-07-27,501,iphone 15,60000,80000,20000,1,00182,India
584377,2023-07-27,503,mixer,1349,3249,1900,1,00182,India
699450,2023-07-27,504,iron,449,879,430,1,00435,India
705041,2023-07-27,506,monitor,3249,8000,4751,1,00231,India
705041,2023-07-27,505,oven,18490,24000,5510,1,00231,India
435185,2023-07-27,503,mixer,1349,3249,1900,1,00110,India
435185,2023-07-27,506,monitor,3249,8000,4751,1,00110,India
435185,2023-07-27,502,iphone 15 pro max,100000,135000,35000,1,00110,India
771371,2023-07-27,503,mixer,1349,3249,1900,1,00445,India
771371,2023-07-27,501,iphone 15,60000,80000,20000,1,00445,India
248120,2023-07-27,505,oven,18490,24000,5510,1,00287,India
248120,2023-07-27,501,iphone 15,60000,80000,20000,1,00287,India
248120,2023-07-27,507,washing machine,6990,16490,9500,1,00287,India
843516,2023-07-27,506,monitor,3249,8000,4751,1,00476,India
843516,2023-07-27,505,oven,18490,24000,5510,1,00476,India
843516,2023-07-27,502,iphone 15 pro max,100000,135000,35000,1,00476,India
286256,2023-07-27,501,iphone 15,60000,80000,20000,1,00322,India
286256,2023-07-27,507,washing machine,6990,16490,9500,1,00322,India
286256,2023-07-27,502,iphone 15 pro max,100000,135000,35000,1,00322,India
887025,2023-07-27,504,iron,449,879,430,1,00392,India
852057,2023-07-27,506,monitor,3249,8000,4751,1,00028,India
852057,2023-07-27,503,mixer,1349,3249,1900,1,00028,India
446096,2023-07-27,507,washing machine,6990,16490,9500,1,00037,India
446096,2023-07-27,503,mixer,1349,3249,1900,1,00037,India
446096,2023-07-27,506,monitor,3249,8000,4751,1,00037,India
162904,2023-07-27,504,iron,449,879,430,1,00440,India
162904,2023-07-27,505,oven,18490,24000,5510,1,00440,India
162904,2023-07-27,502,iphone 15 pro max,100000,135000,35000,1,00440,India
162904,2023-07-27,503,mixer,1349,3249,1900,1,00440,India
838773,2023-07-27,502,iphone 15 pro max,100000,135000,35000,1,00202,India
838773,2023-07-27,507,washing machine,6990,16490,9500,1,00202,India
916560,2023-07-27,501,iphone 15,60000,80000,20000,1,00209,India
916560,2023-07-27,505,oven,18490,24000,5510,1,00209,India
916560,2023-07-27,504,iron,449,879,430,1,00209,India
916560,2023-07-27,507,washing machine,6990,16490,9500,1,00209,India
336727,2023-07-27,503,mixer,1349,3249,1900,1,00175,India
336727,2023-07-27,506,monitor,3249,8000,4751,1,00175,India
984570,2023-07-27,503,mixer,1349,3249,1900,1,00240,India
984570,2023-07-27,506,monitor,3249,8000,4751,1,00240,India
520141,2023-07-27,501,iphone 15,60000,80000,20000,1,00482,India
520141,2023-07-27,505,oven,18490,24000,5510,1,00482,India
853954,2023-07-27,507,washing machine,6990,16490,9500,1,00046,India
853954,2023-07-27,505,oven,18490,24000,5510,1,00046,India
446977,2023-07-27,504,iron,449,879,430,1,00238,India
446977,2023-07-27,503,mixer,1349,3249,1900,1,00238,India
741145,2023-07-27,504,iron,449,879,430,1,00388,India
741145,2023-07-27,502,iphone 15 pro max,100000,135000,35000,1,00388,India
741145,2023-07-27,503,mixer,1349,3249,1900,1,00388,India
957613,2023-07-28,501,iphone 15,60000,80000,20000,1,00031,India
957613,2023-07-28,503,mixer,1349,3249,1900,1,00031,India
957613,2023-07-28,504,iron,449,879,430,1,00031,India
957613,2023-07-28,502,iphone 15 pro max,100000,135000,35000,1,00031,India
223181,2023-07-28,501,iphone 15,60000,80000,20000,1,00257,India
525436,2023-07-28,507,washing machine,6990,16490,9500,1,00032,India
525436,2023-07-28,502,iphone 15 pro max,100000,135000,35000,1,00032,India
525436,2023-07-28,503,mixer,1349,3249,1900,1,00032,India
525436,2023-07-28,505,oven,18490,24000,5510,1,00032,India
525436,2023-07-28,501,iphone 15,60000,80000,20000,1,00032,India
620770,2023-07-28,504,iron,449,879,430,1,00021,India
620770,2023-07-28,507,washing machine,6990,16490,9500,1,00021,India
620770,2023-07-28,502,iphone 15 pro max,100000,135000,35000,1,00021,India
620770,2023-07-28,501,iphone 15,60000,80000,20000,1,00021,India
729888,2023-07-28,501,iphone 15,60000,80000,20000,1,00434,India
729888,2023-07-28,506,monitor,3249,8000,4751,1,00434,India
729888,2023-07-28,504,iron,449,879,430,1,00434,India
463272,2023-07-28,504,iron,449,879,430,1,00345,India
463272,2023-07-28,501,iphone 15,60000,80000,20000,1,00345,India
466744,2023-07-28,502,iphone 15 pro max,100000,135000,35000,1,00236,India
466744,2023-07-28,507,washing machine,6990,16490,9500,1,00236,India
423889,2023-07-28,503,mixer,1349,3249,1900,1,00493,India
423889,2023-07-28,507,washing machine,6990,16490,9500,1,00493,India
423889,2023-07-28,502,iphone 15 pro max,100000,135000,35000,1,00493,India
886301,2023-07-28,501,iphone 15,60000,80000,20000,1,00042,India
886301,2023-07-28,503,mixer,1349,3249,1900,1,00042,India
888175,2023-07-28,505,oven,18490,24000,5510,1,00214,India
888175,2023-07-28,503,mixer,1349,3249,1900,1,00214,India
888175,2023-07-28,506,monitor,3249,8000,4751,1,00214,India
888175,2023-07-28,502,iphone 15 pro max,100000,135000,35000,1,00214,India
291008,2023-07-28,502,iphone 15 pro max,100000,135000,35000,1,00025,India
291008,2023-07-28,504,iron,449,879,430,1,00025,India
233473,2023-07-28,503,mixer,1349,3249,1900,1,00415,India
233473,2023-07-28,507,washing machine,6990,16490,9500,1,00415,India
233473,2023-07-28,505,oven,18490,24000,5510,1,00415,India
233473,2023-07-28,502,iphone 15 pro max,100000,135000,35000,1,00415,India
533030,2023-07-28,501,iphone 15,60000,80000,20000,1,00136,India
533030,2023-07-28,503,mixer,1349,3249,1900,1,00136,India
527054,2023-07-28,501,iphone 15,60000,80000,20000,1,00356,India
527054,2023-07-28,506,monitor,3249,8000,4751,1,00356,India
527054,2023-07-28,505,oven,18490,24000,5510,1,00356,India
527054,2023-07-28,502,iphone 15 pro max,100000,135000,35000,1,00356,India
527054,2023-07-28,504,iron,449,879,430,1,00356,India
271191,2023-07-28,501,iphone 15,60000,80000,20000,1,00073,India
271191,2023-07-28,503,mixer,1349,3249,1900,1,00073,India
209313,2023-07-28,502,iphone 15 pro max,100000,135000,35000,1,00143,India
581099,2023-07-28,506,monitor,3249,8000,4751,1,00094,India
581099,2023-07-28,501,iphone 15,60000,80000,20000,1,00094,India
581099,2023-07-28,502,iphone 15 pro max,100000,135000,35000,1,00094,India
581099,2023-07-28,503,mixer,1349,3249,1900,1,00094,India
833480,2023-07-28,503,mixer,1349,3249,1900,1,00128,India
833480,2023-07-28,507,washing machine,6990,16490,9500,1,00128,India
833480,2023-07-28,506,monitor,3249,8000,4751,1,00128,India
317194,2023-07-28,505,oven,18490,24000,5510,1,00107,India
317194,2023-07-28,501,iphone 15,60000,80000,20000,1,00107,India
875246,2023-07-28,506,monitor,3249,8000,4751,1,00309,India
875246,2023-07-28,502,iphone 15 pro max,100000,135000,35000,1,00309,India
875246,2023-07-28,501,iphone 15,60000,80000,20000,1,00309,India
232825,2023-07-28,501,iphone 15,60000,80000,20000,1,00018,India
232825,2023-07-28,502,iphone 15 pro max,100000,135000,35000,1,00018,India
665188,2023-07-28,507,washing machine,6990,16490,9500,1,00368,India
665188,2023-07-28,501,iphone 15,60000,80000,20000,1,00368,India
665188,2023-07-28,505,oven,18490,24000,5510,1,00368,India
665188,2023-07-28,503,mixer,1349,3249,1900,1,00368,India
587241,2023-07-28,505,oven,18490,24000,5510,1,00385,India
257816,2023-07-28,502,iphone 15 pro max,100000,135000,35000,1,00356,India
257816,2023-07-28,501,iphone 15,60000,80000,20000,1,00356,India
174439,2023-07-28,501,iphone 15,60000,80000,20000,1,00175,India
174439,2023-07-28,506,monitor,3249,8000,4751,1,00175,India
174439,2023-07-28,507,washing machine,6990,16490,9500,1,00175,India
385030,2023-07-28,502,iphone 15 pro max,100000,135000,35000,1,00359,India
385030,2023-07-28,504,iron,449,879,430,1,00359,India
438663,2023-07-28,506,monitor,3249,8000,4751,1,00371,India
438663,2023-07-28,503,mixer,1349,3249,1900,1,00371,India
438663,2023-07-28,505,oven,18490,24000,5510,1,00371,India
438663,2023-07-28,501,iphone 15,60000,80000,20000,1,00371,India
485396,2023-07-28,501,iphone 15,60000,80000,20000,1,00179,India
840209,2023-07-28,503,mixer,1349,3249,1900,1,00458,India
124312,2023-07-28,507,washing machine,6990,16490,9500,1,00322,India
227330,2023-07-28,504,iron,449,879,430,1,00327,India
227330,2023-07-28,502,iphone 15 pro max,100000,135000,35000,1,00327,India
227330,2023-07-28,503,mixer,1349,3249,1900,1,00327,India
516551,2023-07-28,503,mixer,1349,3249,1900,1,00414,India
516551,2023-07-28,506,monitor,3249,8000,4751,1,00414,India
774428,2023-07-28,503,mixer,1349,3249,1900,1,00131,India
774428,2023-07-28,507,washing machine,6990,16490,9500,1,00131,India
771152,2023-07-28,503,mixer,1349,3249,1900,1,00127,India
877569,2023-07-28,504,iron,449,879,430,1,00214,India
877569,2023-07-28,501,iphone 15,60000,80000,20000,1,00214,India
242461,2023-07-28,505,oven,18490,24000,5510,1,00268,India
935288,2023-07-28,506,monitor,3249,8000,4751,1,00154,India
935288,2023-07-28,503,mixer,1349,3249,1900,1,00154,India
935288,2023-07-28,505,oven,18490,24000,5510,1,00154,India
277662,2023-07-28,501,iphone 15,60000,80000,20000,1,00472,India
277662,2023-07-28,504,iron,449,879,430,1,00472,India
277662,2023-07-28,506,monitor,3249,8000,4751,1,00472,India
249051,2023-07-28,507,washing machine,6990,16490,9500,1,00073,India
249051,2023-07-28,505,oven,18490,24000,5510,1,00073,India
249051,2023-07-28,506,monitor,3249,8000,4751,1,00073,India
423650,2023-07-28,502,iphone 15 pro max,100000,135000,35000,1,00348,India
423650,2023-07-28,507,washing machine,6990,16490,9500,1,00348,India
650676,2023-07-28,505,oven,18490,24000,5510,1,00491,India
650676,2023-07-28,503,mixer,1349,3249,1900,1,00491,India
650676,2023-07-28,506,monitor,3249,8000,4751,1,00491,India
540819,2023-07-28,507,washing machine,6990,16490,9500,1,00235,India
366756,2023-07-28,501,iphone 15,60000,80000,20000,1,00446,India
366756,2023-07-28,502,iphone 15 pro max,100000,135000,35000,1,00446,India
382911,2023-07-28,502,iphone 15 pro max,100000,135000,35000,1,00116,India
382911,2023-07-28,506,monitor,3249,8000,4751,1,00116,India
934872,2023-07-28,503,mixer,1349,3249,1900,1,00446,India
934872,2023-07-28,507,washing machine,6990,16490,9500,1,00446,India
934872,2023-07-28,505,oven,18490,24000,5510,1,00446,India
786123,2023-07-28,505,oven,18490,24000,5510,1,00342,India
786123,2023-07-28,503,mixer,1349,3249,1900,1,00342,India
986578,2023-07-28,502,iphone 15 pro max,100000,135000,35000,1,00096,India
986578,2023-07-28,505,oven,18490,24000,5510,1,00096,India
986578,2023-07-28,507,washing machine,6990,16490,9500,1,00096,India
986578,2023-07-28,504,iron,449,879,430,1,00096,India
241477,2023-07-28,506,monitor,3249,8000,4751,1,00434,India
233909,2023-07-28,501,iphone 15,60000,80000,20000,1,00453,India
233909,2023-07-28,506,monitor,3249,8000,4751,1,00453,India
506007,2023-07-28,506,monitor,3249,8000,4751,1,00078,India
506007,2023-07-28,505,oven,18490,24000,5510,1,00078,India
506007,2023-07-28,504,iron,449,879,430,1,00078,India
636192,2023-07-28,503,mixer,1349,3249,1900,1,00047,India
636192,2023-07-28,502,iphone 15 pro max,100000,135000,35000,1,00047,India
759191,2023-07-28,501,iphone 15,60000,80000,20000,1,00024,India
759191,2023-07-28,504,iron,449,879,430,1,00024,India
813309,2023-07-28,504,iron,449,879,430,1,00035,India
207745,2023-07-28,507,washing machine,6990,16490,9500,1,00248,India
207745,2023-07-28,501,iphone 15,60000,80000,20000,1,00248,India
207745,2023-07-28,506,monitor,3249,8000,4751,1,00248,India
554388,2023-07-28,505,oven,18490,24000,5510,1,00414,India
554388,2023-07-28,504,iron,449,879,430,1,00414,India
750756,2023-07-28,502,iphone 15 pro max,100000,135000,35000,1,00112,India
750756,2023-07-28,503,mixer,1349,3249,1900,1,00112,India
750756,2023-07-28,507,washing machine,6990,16490,9500,1,00112,India
750756,2023-07-28,504,iron,449,879,430,1,00112,India
317974,2023-07-28,504,iron,449,879,430,1,00265,India
317974,2023-07-28,502,iphone 15 pro max,100000,135000,35000,1,00265,India
454149,2023-07-28,502,iphone 15 pro max,100000,135000,35000,1,00059,India
454149,2023-07-28,503,mixer,1349,3249,1900,1,00059,India
454149,2023-07-28,504,iron,449,879,430,1,00059,India
667987,2023-07-28,501,iphone 15,60000,80000,20000,1,00267,India
667987,2023-07-28,505,oven,18490,24000,5510,1,00267,India
473408,2023-07-28,507,washing machine,6990,16490,9500,1,00413,India
317143,2023-07-28,505,oven,18490,24000,5510,1,00462,India
238281,2023-07-28,506,monitor,3249,8000,4751,1,00347,India
238281,2023-07-28,501,iphone 15,60000,80000,20000,1,00347,India
238281,2023-07-28,507,washing machine,6990,16490,9500,1,00347,India
696420,2023-07-28,503,mixer,1349,3249,1900,1,00032,India
696420,2023-07-28,504,iron,449,879,430,1,00032,India
696420,2023-07-28,502,iphone 15 pro max,100000,135000,35000,1,00032,India
833326,2023-07-28,501,iphone 15,60000,80000,20000,1,00233,India
833326,2023-07-28,503,mixer,1349,3249,1900,1,00233,India
833326,2023-07-28,502,iphone 15 pro max,100000,135000,35000,1,00233,India
511777,2023-07-28,502,iphone 15 pro max,100000,135000,35000,1,00050,India
511777,2023-07-28,506,monitor,3249,8000,4751,1,00050,India
429101,2023-07-28,505,oven,18490,24000,5510,1,00144,India
429101,2023-07-28,501,iphone 15,60000,80000,20000,1,00144,India
429101,2023-07-28,502,iphone 15 pro max,100000,135000,35000,1,00144,India
814166,2023-07-28,502,iphone 15 pro max,100000,135000,35000,1,00154,India
658918,2023-07-28,503,mixer,1349,3249,1900,1,00408,India
658918,2023-07-28,502,iphone 15 pro max,100000,135000,35000,1,00408,India
658918,2023-07-28,501,iphone 15,60000,80000,20000,1,00408,India
870377,2023-07-28,506,monitor,3249,8000,4751,1,00422,India
840754,2023-07-28,503,mixer,1349,3249,1900,1,00389,India
840754,2023-07-28,506,monitor,3249,8000,4751,1,00389,India
840754,2023-07-28,507,washing machine,6990,16490,9500,1,00389,India
103327,2023-07-28,507,washing machine,6990,16490,9500,1,00180,India
103327,2023-07-28,504,iron,449,879,430,1,00180,India
510597,2023-07-28,503,mixer,1349,3249,1900,1,00497,India
192307,2023-07-28,506,monitor,3249,8000,4751,1,00193,India
786987,2023-07-28,501,iphone 15,60000,80000,20000,1,00041,India
140474,2023-07-28,504,iron,449,879,430,1,00258,India
140474,2023-07-28,505,oven,18490,24000,5510,1,00258,India
140474,2023-07-28,506,monitor,3249,8000,4751,1,00258,India
140474,2023-07-28,507,washing machine,6990,16490,9500,1,00258,India
839799,2023-07-28,505,oven,18490,24000,5510,1,00076,India
839799,2023-07-28,502,iphone 15 pro max,100000,135000,35000,1,00076,India
467096,2023-07-28,507,washing machine,6990,16490,9500,1,00453,India
467096,2023-07-28,501,iphone 15,60000,80000,20000,1,00453,India
356788,2023-07-28,503,mixer,1349,3249,1900,1,00398,India
960938,2023-07-28,504,iron,449,879,430,1,00098,India
960938,2023-07-28,502,iphone 15 pro max,100000,135000,35000,1,00098,India
960938,2023-07-28,506,monitor,3249,8000,4751,1,00098,India
516836,2023-07-28,504,iron,449,879,430,1,00166,India
516836,2023-07-28,507,washing machine,6990,16490,9500,1,00166,India
516836,2023-07-28,503,mixer,1349,3249,1900,1,00166,India
908524,2023-07-28,507,washing machine,6990,16490,9500,1,00122,India
908524,2023-07-28,506,monitor,3249,8000,4751,1,00122,India
784345,2023-07-28,502,iphone 15 pro max,100000,135000,35000,1,00278,India
784345,2023-07-28,501,iphone 15,60000,80000,20000,1,00278,India
784345,2023-07-28,506,monitor,3249,8000,4751,1,00278,India
901083,2023-07-28,506,monitor,3249,8000,4751,1,00353,India
792976,2023-07-28,504,iron,449,879,430,1,00178,India
650733,2023-07-28,504,iron,449,879,430,1,00288,India
650733,2023-07-28,506,monitor,3249,8000,4751,1,00288,India
650733,2023-07-28,507,washing machine,6990,16490,9500,1,00288,India
543943,2023-07-28,504,iron,449,879,430,1,00136,India
543943,2023-07-28,502,iphone 15 pro max,100000,135000,35000,1,00136,India
205895,2023-07-28,504,iron,449,879,430,1,00015,India
205895,2023-07-28,503,mixer,1349,3249,1900,1,00015,India
205895,2023-07-28,502,iphone 15 pro max,100000,135000,35000,1,00015,India
298688,2023-07-28,506,monitor,3249,8000,4751,1,00378,India
298688,2023-07-28,507,washing machine,6990,16490,9500,1,00378,India
298688,2023-07-28,505,oven,18490,24000,5510,1,00378,India
298688,2023-07-28,502,iphone 15 pro max,100000,135000,35000,1,00378,India
298688,2023-07-28,503,mixer,1349,3249,1900,1,00378,India
592852,2023-07-28,505,oven,18490,24000,5510,1,00265,India
592852,2023-07-28,506,monitor,3249,8000,4751,1,00265,India
592852,2023-07-28,503,mixer,1349,3249,1900,1,00265,India
592852,2023-07-28,501,iphone 15,60000,80000,20000,1,00265,India
736506,2023-07-28,504,iron,449,879,430,1,00034,India
792706,2023-07-29,501,iphone 15,60000,80000,20000,1,00088,India
906922,2023-07-29,506,monitor,3249,8000,4751,1,00224,India
906922,2023-07-29,504,iron,449,879,430,1,00224,India
644310,2023-07-29,502,iphone 15 pro max,100000,135000,35000,1,00488,India
644310,2023-07-29,504,iron,449,879,430,1,00488,India
469729,2023-07-29,503,mixer,1349,3249,1900,1,00296,India
469729,2023-07-29,501,iphone 15,60000,80000,20000,1,00296,India
469729,2023-07-29,504,iron,449,879,430,1,00296,India
411592,2023-07-29,503,mixer,1349,3249,1900,1,00128,India
411592,2023-07-29,507,washing machine,6990,16490,9500,1,00128,India
411592,2023-07-29,504,iron,449,879,430,1,00128,India
411592,2023-07-29,501,iphone 15,60000,80000,20000,1,00128,India
271021,2023-07-29,506,monitor,3249,8000,4751,1,00462,India
678797,2023-07-29,505,oven,18490,24000,5510,1,00276,India
678797,2023-07-29,506,monitor,3249,8000,4751,1,00276,India
287952,2023-07-29,502,iphone 15 pro max,100000,135000,35000,1,00345,India
480811,2023-07-29,503,mixer,1349,3249,1900,1,00498,India
480811,2023-07-29,505,oven,18490,24000,5510,1,00498,India
480811,2023-07-29,506,monitor,3249,8000,4751,1,00498,India
208230,2023-07-29,502,iphone 15 pro max,100000,135000,35000,1,00429,India
113413,2023-07-29,507,washing machine,6990,16490,9500,1,00488,India
113413,2023-07-29,505,oven,18490,24000,5510,1,00488,India
113413,2023-07-29,501,iphone 15,60000,80000,20000,1,00488,India
823023,2023-07-29,504,iron,449,879,430,1,00012,India
823023,2023-07-29,505,oven,18490,24000,5510,1,00012,India
823023,2023-07-29,506,monitor,3249,8000,4751,1,00012,India
491705,2023-07-29,503,mixer,1349,3249,1900,1,00442,India
847683,2023-07-29,503,mixer,1349,3249,1900,1,00407,India
847683,2023-07-29,504,iron,449,879,430,1,00407,India
847683,2023-07-29,502,iphone 15 pro max,100000,135000,35000,1,00407,India
732755,2023-07-29,504,iron,449,879,430,1,00240,India
732755,2023-07-29,507,washing machine,6990,16490,9500,1,00240,India
860256,2023-07-29,502,iphone 15 pro max,100000,135000,35000,1,00262,India
860256,2023-07-29,506,monitor,3249,8000,4751,1,00262,India
860256,2023-07-29,504,iron,449,879,430,1,00262,India
860256,2023-07-29,503,mixer,1349,3249,1900,1,00262,India
860256,2023-07-29,507,washing machine,6990,16490,9500,1,00262,India
862255,2023-07-29,501,iphone 15,60000,80000,20000,1,00429,India
862255,2023-07-29,506,monitor,3249,8000,4751,1,00429,India
779501,2023-07-29,502,iphone 15 pro max,100000,135000,35000,1,00478,India
779501,2023-07-29,507,washing machine,6990,16490,9500,1,00478,India
779501,2023-07-29,501,iphone 15,60000,80000,20000,1,00478,India
730008,2023-07-29,505,oven,18490,24000,5510,1,00087,India
730008,2023-07-29,507,washing machine,6990,16490,9500,1,00087,India
730008,2023-07-29,506,monitor,3249,8000,4751,1,00087,India
292218,2023-07-29,502,iphone 15 pro max,100000,135000,35000,1,00186,India
292218,2023-07-29,504,iron,449,879,430,1,00186,India
292218,2023-07-29,506,monitor,3249,8000,4751,1,00186,India
136027,2023-07-29,503,mixer,1349,3249,1900,1,00231,India
136027,2023-07-29,504,iron,449,879,430,1,00231,India
136027,2023-07-29,506,monitor,3249,8000,4751,1,00231,India
584902,2023-07-29,506,monitor,3249,8000,4751,1,00364,India
584902,2023-07-29,503,mixer,1349,3249,1900,1,00364,India
584902,2023-07-29,501,iphone 15,60000,80000,20000,1,00364,India
584902,2023-07-29,505,oven,18490,24000,5510,1,00364,India
584902,2023-07-29,502,iphone 15 pro max,100000,135000,35000,1,00364,India
529269,2023-07-29,504,iron,449,879,430,1,00054,India
529269,2023-07-29,507,washing machine,6990,16490,9500,1,00054,India
529269,2023-07-29,505,oven,18490,24000,5510,1,00054,India
529269,2023-07-29,501,iphone 15,60000,80000,20000,1,00054,India
375413,2023-07-29,507,washing machine,6990,16490,9500,1,00315,India
375413,2023-07-29,501,iphone 15,60000,80000,20000,1,00315,India
375413,2023-07-29,506,monitor,3249,8000,4751,1,00315,India
384483,2023-07-29,503,mixer,1349,3249,1900,1,00070,India
384483,2023-07-29,504,iron,449,879,430,1,00070,India
489609,2023-07-29,506,monitor,3249,8000,4751,1,00018,India
778656,2023-07-29,504,iron,449,879,430,1,00032,India
216530,2023-07-29,501,iphone 15,60000,80000,20000,1,00488,India
216530,2023-07-29,505,oven,18490,24000,5510,1,00488,India
469026,2023-07-29,504,iron,449,879,430,1,00172,India
469026,2023-07-29,505,oven,18490,24000,5510,1,00172,India
469026,2023-07-29,506,monitor,3249,8000,4751,1,00172,India
275085,2023-07-29,504,iron,449,879,430,1,00128,India
375882,2023-07-29,504,iron,449,879,430,1,00258,India
613039,2023-07-29,507,washing machine,6990,16490,9500,1,00453,India
333480,2023-07-29,506,monitor,3249,8000,4751,1,00162,India
732844,2023-07-29,503,mixer,1349,3249,1900,1,00450,India
732844,2023-07-29,501,iphone 15,60000,80000,20000,1,00450,India
732844,2023-07-29,504,iron,449,879,430,1,00450,India
718123,2023-07-29,501,iphone 15,60000,80000,20000,1,00258,India
718123,2023-07-29,504,iron,449,879,430,1,00258,India
718123,2023-07-29,503,mixer,1349,3249,1900,1,00258,India
129745,2023-07-29,505,oven,18490,24000,5510,1,00105,India
129745,2023-07-29,503,mixer,1349,3249,1900,1,00105,India
129745,2023-07-29,504,iron,449,879,430,1,00105,India
171188,2023-07-29,502,iphone 15 pro max,100000,135000,35000,1,00088,India
980384,2023-07-29,507,washing machine,6990,16490,9500,1,00303,India
346059,2023-07-29,504,iron,449,879,430,1,00484,India
346059,2023-07-29,501,iphone 15,60000,80000,20000,1,00484,India
673789,2023-07-29,503,mixer,1349,3249,1900,1,00060,India
673789,2023-07-29,506,monitor,3249,8000,4751,1,00060,India
673789,2023-07-29,501,iphone 15,60000,80000,20000,1,00060,India
430825,2023-07-29,501,iphone 15,60000,80000,20000,1,00455,India
430825,2023-07-29,502,iphone 15 pro max,100000,135000,35000,1,00455,India
430825,2023-07-29,506,monitor,3249,8000,4751,1,00455,India
454960,2023-07-29,505,oven,18490,24000,5510,1,00104,India
454960,2023-07-29,503,mixer,1349,3249,1900,1,00104,India
377806,2023-07-29,507,washing machine,6990,16490,9500,1,00001,India
430281,2023-07-29,505,oven,18490,24000,5510,1,00389,India
430281,2023-07-29,507,washing machine,6990,16490,9500,1,00389,India
430281,2023-07-29,504,iron,449,879,430,1,00389,India
115698,2023-07-29,504,iron,449,879,430,1,00431,India
115698,2023-07-29,506,monitor,3249,8000,4751,1,00431,India
115698,2023-07-29,507,washing machine,6990,16490,9500,1,00431,India
115698,2023-07-29,501,iphone 15,60000,80000,20000,1,00431,India
317636,2023-07-29,507,washing machine,6990,16490,9500,1,00111,India
317636,2023-07-29,504,iron,449,879,430,1,00111,India
439811,2023-07-29,507,washing machine,6990,16490,9500,1,00171,India
997419,2023-07-29,501,iphone 15,60000,80000,20000,1,00382,India
997419,2023-07-29,506,monitor,3249,8000,4751,1,00382,India
997419,2023-07-29,505,oven,18490,24000,5510,1,00382,India
997419,2023-07-29,502,iphone 15 pro max,100000,135000,35000,1,00382,India
624968,2023-07-29,507,washing machine,6990,16490,9500,1,00382,India
624968,2023-07-29,504,iron,449,879,430,1,00382,India
624968,2023-07-29,501,iphone 15,60000,80000,20000,1,00382,India
624968,2023-07-29,503,mixer,1349,3249,1900,1,00382,India
770985,2023-07-29,501,iphone 15,60000,80000,20000,1,00044,India
770985,2023-07-29,502,iphone 15 pro max,100000,135000,35000,1,00044,India
770985,2023-07-29,507,washing machine,6990,16490,9500,1,00044,India
770985,2023-07-29,504,iron,449,879,430,1,00044,India
238103,2023-07-29,503,mixer,1349,3249,1900,1,00211,India
238103,2023-07-29,507,washing machine,6990,16490,9500,1,00211,India
309748,2023-07-29,505,oven,18490,24000,5510,1,00201,India
309748,2023-07-29,503,mixer,1349,3249,1900,1,00201,India
309748,2023-07-29,504,iron,449,879,430,1,00201,India
309748,2023-07-29,507,washing machine,6990,16490,9500,1,00201,India
957761,2023-07-29,506,monitor,3249,8000,4751,1,00161,India
957761,2023-07-29,504,iron,449,879,430,1,00161,India
117840,2023-07-29,505,oven,18490,24000,5510,1,00069,India
117840,2023-07-29,507,washing machine,6990,16490,9500,1,00069,India
117840,2023-07-29,504,iron,449,879,430,1,00069,India
117840,2023-07-29,503,mixer,1349,3249,1900,1,00069,India
835180,2023-07-29,504,iron,449,879,430,1,00043,India
835180,2023-07-29,502,iphone 15 pro max,100000,135000,35000,1,00043,India
835180,2023-07-29,505,oven,18490,24000,5510,1,00043,India
835180,2023-07-29,503,mixer,1349,3249,1900,1,00043,India
217364,2023-07-29,504,iron,449,879,430,1,00247,India
217364,2023-07-29,506,monitor,3249,8000,4751,1,00247,India
436803,2023-07-29,503,mixer,1349,3249,1900,1,00215,India
673095,2023-07-29,502,iphone 15 pro max,100000,135000,35000,1,00337,India
673095,2023-07-29,507,washing machine,6990,16490,9500,1,00337,India
673095,2023-07-29,501,iphone 15,60000,80000,20000,1,00337,India
957082,2023-07-29,503,mixer,1349,3249,1900,1,00170,India
957082,2023-07-29,504,iron,449,879,430,1,00170,India
957082,2023-07-29,501,iphone 15,60000,80000,20000,1,00170,India
957082,2023-07-29,505,oven,18490,24000,5510,1,00170,India
483699,2023-07-29,504,iron,449,879,430,1,00090,India
483699,2023-07-29,501,iphone 15,60000,80000,20000,1,00090,India
745983,2023-07-29,501,iphone 15,60000,80000,20000,1,00287,India
745983,2023-07-29,505,oven,18490,24000,5510,1,00287,India
745983,2023-07-29,504,iron,449,879,430,1,00287,India
745983,2023-07-29,502,iphone 15 pro max,100000,135000,35000,1,00287,India
883553,2023-07-29,506,monitor,3249,8000,4751,1,00421,India
883553,2023-07-29,502,iphone 15 pro max,100000,135000,35000,1,00421,India
883553,2023-07-29,504,iron,449,879,430,1,00421,India
750388,2023-07-29,502,iphone 15 pro max,100000,135000,35000,1,00403,India
750388,2023-07-29,501,iphone 15,60000,80000,20000,1,00403,India
750388,2023-07-29,505,oven,18490,24000,5510,1,00403,India
750388,2023-07-29,503,mixer,1349,3249,1900,1,00403,India
553359,2023-07-29,507,washing machine,6990,16490,9500,1,00170,India
553359,2023-07-29,501,iphone 15,60000,80000,20000,1,00170,India
553359,2023-07-29,504,iron,449,879,430,1,00170,India
985285,2023-07-29,507,washing machine,6990,16490,9500,1,00488,India
870151,2023-07-29,506,monitor,3249,8000,4751,1,00196,India
870151,2023-07-29,502,iphone 15 pro max,100000,135000,35000,1,00196,India
870151,2023-07-29,501,iphone 15,60000,80000,20000,1,00196,India
870151,2023-07-29,503,mixer,1349,3249,1900,1,00196,India
752693,2023-07-29,502,iphone 15 pro max,100000,135000,35000,1,00123,India
752693,2023-07-29,504,iron,449,879,430,1,00123,India
444052,2023-07-29,506,monitor,3249,8000,4751,1,00167,India
444052,2023-07-29,507,washing machine,6990,16490,9500,1,00167,India
587879,2023-07-29,502,iphone 15 pro max,100000,135000,35000,1,00372,India
587879,2023-07-29,506,monitor,3249,8000,4751,1,00372,India
587879,2023-07-29,501,iphone 15,60000,80000,20000,1,00372,India
636047,2023-07-29,505,oven,18490,24000,5510,1,00425,India
978487,2023-07-29,506,monitor,3249,8000,4751,1,00027,India
749023,2023-07-29,505,oven,18490,24000,5510,1,00469,India
749023,2023-07-29,506,monitor,3249,8000,4751,1,00469,India
335636,2023-07-29,506,monitor,3249,8000,4751,1,00165,India
335636,2023-07-29,501,iphone 15,60000,80000,20000,1,00165,India
335636,2023-07-29,504,iron,449,879,430,1,00165,India
930474,2023-07-29,507,washing machine,6990,16490,9500,1,00280,India
638741,2023-07-29,502,iphone 15 pro max,100000,135000,35000,1,00393,India
638741,2023-07-29,504,iron,449,879,430,1,00393,India
638741,2023-07-29,505,oven,18490,24000,5510,1,00393,India
638741,2023-07-29,503,mixer,1349,3249,1900,1,00393,India
112440,2023-07-29,505,oven,18490,24000,5510,1,00220,India
179723,2023-07-29,501,iphone 15,60000,80000,20000,1,00464,India
179723,2023-07-29,504,iron,449,879,430,1,00464,India
862011,2023-07-29,507,washing machine,6990,16490,9500,1,00425,India
862011,2023-07-29,504,iron,449,879,430,1,00425,India
223332,2023-07-29,505,oven,18490,24000,5510,1,00083,India
223332,2023-07-29,502,iphone 15 pro max,100000,135000,35000,1,00083,India
223332,2023-07-29,506,monitor,3249,8000,4751,1,00083,India
196606,2023-07-29,504,iron,449,879,430,1,00185,India
196606,2023-07-29,503,mixer,1349,3249,1900,1,00185,India
479426,2023-07-29,503,mixer,1349,3249,1900,1,00492,India
479426,2023-07-29,505,oven,18490,24000,5510,1,00492,India
479426,2023-07-29,507,washing machine,6990,16490,9500,1,00492,India
170227,2023-07-29,502,iphone 15 pro max,100000,135000,35000,1,00040,India
170227,2023-07-29,507,washing machine,6990,16490,9500,1,00040,India
170227,2023-07-29,503,mixer,1349,3249,1900,1,00040,India
127936,2023-07-29,503,mixer,1349,3249,1900,1,00006,India
127936,2023-07-29,501,iphone 15,60000,80000,20000,1,00006,India
736571,2023-07-29,504,iron,449,879,430,1,00077,India
736571,2023-07-29,503,mixer,1349,3249,1900,1,00077,India
736571,2023-07-29,506,monitor,3249,8000,4751,1,00077,India
736571,2023-07-29,505,oven,18490,24000,5510,1,00077,India
617567,2023-07-29,502,iphone 15 pro max,100000,135000,35000,1,00296,India
617567,2023-07-29,503,mixer,1349,3249,1900,1,00296,India
617567,2023-07-29,507,washing machine,6990,16490,9500,1,00296,India
425915,2023-07-29,503,mixer,1349,3249,1900,1,00483,India
902737,2023-07-29,506,monitor,3249,8000,4751,1,00169,India
902737,2023-07-29,502,iphone 15 pro max,100000,135000,35000,1,00169,India
902737,2023-07-29,504,iron,449,879,430,1,00169,India
902737,2023-07-29,507,washing machine,6990,16490,9500,1,00169,India
803529,2023-07-29,507,washing machine,6990,16490,9500,1,00388,India
803529,2023-07-29,501,iphone 15,60000,80000,20000,1,00388,India
803529,2023-07-29,505,oven,18490,24000,5510,1,00388,India
803529,2023-07-29,502,iphone 15 pro max,100000,135000,35000,1,00388,India
803529,2023-07-29,506,monitor,3249,8000,4751,1,00388,India
155239,2023-07-29,502,iphone 15 pro max,100000,135000,35000,1,00429,India
358396,2023-07-30,503,mixer,1349,3249,1900,1,00156,India
358396,2023-07-30,507,washing machine,6990,16490,9500,1,00156,India
358396,2023-07-30,504,iron,449,879,430,1,00156,India
993120,2023-07-30,504,iron,449,879,430,1,00038,India
821051,2023-07-30,507,washing machine,6990,16490,9500,1,00491,India
821051,2023-07-30,504,iron,449,879,430,1,00491,India
821051,2023-07-30,505,oven,18490,24000,5510,1,00491,India
622027,2023-07-30,507,washing machine,6990,16490,9500,1,00429,India
622027,2023-07-30,506,monitor,3249,8000,4751,1,00429,India
622027,2023-07-30,502,iphone 15 pro max,100000,135000,35000,1,00429,India
622027,2023-07-30,501,iphone 15,60000,80000,20000,1,00429,India
140107,2023-07-30,505,oven,18490,24000,5510,1,00077,India
140107,2023-07-30,504,iron,449,879,430,1,00077,India
122326,2023-07-30,502,iphone 15 pro max,100000,135000,35000,1,00051,India
122326,2023-07-30,507,washing machine,6990,16490,9500,1,00051,India
928679,2023-07-30,502,iphone 15 pro max,100000,135000,35000,1,00371,India
928679,2023-07-30,505,oven,18490,24000,5510,1,00371,India
928679,2023-07-30,506,monitor,3249,8000,4751,1,00371,India
173155,2023-07-30,502,iphone 15 pro max,100000,135000,35000,1,00366,India
173155,2023-07-30,503,mixer,1349,3249,1900,1,00366,India
173155,2023-07-30,504,iron,449,879,430,1,00366,India
366451,2023-07-30,506,monitor,3249,8000,4751,1,00097,India
200326,2023-07-30,507,washing machine,6990,16490,9500,1,00126,India
200326,2023-07-30,501,iphone 15,60000,80000,20000,1,00126,India
200326,2023-07-30,503,mixer,1349,3249,1900,1,00126,India
140300,2023-07-30,503,mixer,1349,3249,1900,1,00331,India
140300,2023-07-30,504,iron,449,879,430,1,00331,India
709687,2023-07-30,503,mixer,1349,3249,1900,1,00211,India
762363,2023-07-30,505,oven,18490,24000,5510,1,00269,India
762363,2023-07-30,503,mixer,1349,3249,1900,1,00269,India
885641,2023-07-30,501,iphone 15,60000,80000,20000,1,00500,India
885641,2023-07-30,506,monitor,3249,8000,4751,1,00500,India
427315,2023-07-30,505,oven,18490,24000,5510,1,00353,India
351826,2023-07-30,506,monitor,3249,8000,4751,1,00144,India
406288,2023-07-30,503,mixer,1349,3249,1900,1,00064,India
406288,2023-07-30,504,iron,449,879,430,1,00064,India
406288,2023-07-30,507,washing machine,6990,16490,9500,1,00064,India
431962,2023-07-30,506,monitor,3249,8000,4751,1,00441,India
431962,2023-07-30,504,iron,449,879,430,1,00441,India
314484,2023-07-30,503,mixer,1349,3249,1900,1,00169,India
911717,2023-07-30,507,washing machine,6990,16490,9500,1,00195,India
235675,2023-07-30,502,iphone 15 pro max,100000,135000,35000,1,00091,India
675885,2023-07-30,503,mixer,1349,3249,1900,1,00422,India
753856,2023-07-30,505,oven,18490,24000,5510,1,00248,India
753856,2023-07-30,507,washing machine,6990,16490,9500,1,00248,India
776122,2023-07-30,505,oven,18490,24000,5510,1,00111,India
362935,2023-07-30,504,iron,449,879,430,1,00393,India
362935,2023-07-30,506,monitor,3249,8000,4751,1,00393,India
362935,2023-07-30,501,iphone 15,60000,80000,20000,1,00393,India
916764,2023-07-30,502,iphone 15 pro max,100000,135000,35000,1,00190,India
916764,2023-07-30,504,iron,449,879,430,1,00190,India
916764,2023-07-30,501,iphone 15,60000,80000,20000,1,00190,India
916764,2023-07-30,505,oven,18490,24000,5510,1,00190,India
269962,2023-07-30,503,mixer,1349,3249,1900,1,00194,India
662166,2023-07-30,507,washing machine,6990,16490,9500,1,00390,India
662166,2023-07-30,501,iphone 15,60000,80000,20000,1,00390,India
709536,2023-07-30,503,mixer,1349,3249,1900,1,00116,India
709536,2023-07-30,505,oven,18490,24000,5510,1,00116,India
224261,2023-07-30,502,iphone 15 pro max,100000,135000,35000,1,00137,India
224261,2023-07-30,504,iron,449,879,430,1,00137,India
224261,2023-07-30,506,monitor,3249,8000,4751,1,00137,India
224261,2023-07-30,507,washing machine,6990,16490,9500,1,00137,India
678245,2023-07-30,504,iron,449,879,430,1,00220,India
678245,2023-07-30,505,oven,18490,24000,5510,1,00220,India
678245,2023-07-30,502,iphone 15 pro max,100000,135000,35000,1,00220,India
163730,2023-07-30,503,mixer,1349,3249,1900,1,00190,India
163730,2023-07-30,505,oven,18490,24000,5510,1,00190,India
163730,2023-07-30,502,iphone 15 pro max,100000,135000,35000,1,00190,India
163730,2023-07-30,507,washing machine,6990,16490,9500,1,00190,India
404940,2023-07-30,501,iphone 15,60000,80000,20000,1,00154,India
404940,2023-07-30,502,iphone 15 pro max,100000,135000,35000,1,00154,India
138091,2023-07-30,505,oven,18490,24000,5510,1,00281,India
321615,2023-07-30,502,iphone 15 pro max,100000,135000,35000,1,00011,India
321615,2023-07-30,507,washing machine,6990,16490,9500,1,00011,India
623657,2023-07-30,505,oven,18490,24000,5510,1,00451,India
680516,2023-07-30,501,iphone 15,60000,80000,20000,1,00363,India
680516,2023-07-30,505,oven,18490,24000,5510,1,00363,India
191619,2023-07-30,505,oven,18490,24000,5510,1,00282,India
191619,2023-07-30,503,mixer,1349,3249,1900,1,00282,India
191619,2023-07-30,504,iron,449,879,430,1,00282,India
183643,2023-07-30,501,iphone 15,60000,80000,20000,1,00203,India
834097,2023-07-30,502,iphone 15 pro max,100000,135000,35000,1,00384,India
834097,2023-07-30,506,monitor,3249,8000,4751,1,00384,India
897234,2023-07-30,502,iphone 15 pro max,100000,135000,35000,1,00277,India
119644,2023-07-30,504,iron,449,879,430,1,00250,India
119644,2023-07-30,503,mixer,1349,3249,1900,1,00250,India
645302,2023-07-30,507,washing machine,6990,16490,9500,1,00392,India
645302,2023-07-30,505,oven,18490,24000,5510,1,00392,India
753697,2023-07-30,502,iphone 15 pro max,100000,135000,35000,1,00140,India
403446,2023-07-30,501,iphone 15,60000,80000,20000,1,00075,India
194019,2023-07-30,504,iron,449,879,430,1,00012,India
194019,2023-07-30,505,oven,18490,24000,5510,1,00012,India
263038,2023-07-30,502,iphone 15 pro max,100000,135000,35000,1,00383,India
263038,2023-07-30,505,oven,18490,24000,5510,1,00383,India
263038,2023-07-30,506,monitor,3249,8000,4751,1,00383,India
263038,2023-07-30,503,mixer,1349,3249,1900,1,00383,India
173342,2023-07-30,504,iron,449,879,430,1,00103,India
984518,2023-07-30,506,monitor,3249,8000,4751,1,00024,India
984518,2023-07-30,502,iphone 15 pro max,100000,135000,35000,1,00024,India
302310,2023-07-30,502,iphone 15 pro max,100000,135000,35000,1,00496,India
302310,2023-07-30,501,iphone 15,60000,80000,20000,1,00496,India
549749,2023-07-30,507,washing machine,6990,16490,9500,1,00443,India
922493,2023-07-30,505,oven,18490,24000,5510,1,00484,India
922493,2023-07-30,506,monitor,3249,8000,4751,1,00484,India
156672,2023-07-30,503,mixer,1349,3249,1900,1,00460,India
156672,2023-07-30,506,monitor,3249,8000,4751,1,00460,India
156672,2023-07-30,505,oven,18490,24000,5510,1,00460,India
104565,2023-07-30,503,mixer,1349,3249,1900,1,00028,India
104565,2023-07-30,502,iphone 15 pro max,100000,135000,35000,1,00028,India
640715,2023-07-30,501,iphone 15,60000,80000,20000,1,00174,India
640715,2023-07-30,507,washing machine,6990,16490,9500,1,00174,India
640715,2023-07-30,504,iron,449,879,430,1,00174,India
640715,2023-07-30,505,oven,18490,24000,5510,1,00174,India
640715,2023-07-30,502,iphone 15 pro max,100000,135000,35000,1,00174,India
157128,2023-07-30,507,washing machine,6990,16490,9500,1,00458,India
157128,2023-07-30,505,oven,18490,24000,5510,1,00458,India
508355,2023-07-30,502,iphone 15 pro max,100000,135000,35000,1,00129,India
508355,2023-07-30,507,washing machine,6990,16490,9500,1,00129,India
508355,2023-07-30,501,iphone 15,60000,80000,20000,1,00129,India
949797,2023-07-30,503,mixer,1349,3249,1900,1,00244,India
731739,2023-07-30,505,oven,18490,24000,5510,1,00428,India
731739,2023-07-30,504,iron,449,879,430,1,00428,India
986882,2023-07-30,505,oven,18490,24000,5510,1,00257,India
747727,2023-07-30,505,oven,18490,24000,5510,1,00361,India
747727,2023-07-30,506,monitor,3249,8000,4751,1,00361,India
747727,2023-07-30,501,iphone 15,60000,80000,20000,1,00361,India
517781,2023-07-30,501,iphone 15,60000,80000,20000,1,00262,India
517781,2023-07-30,503,mixer,1349,3249,1900,1,00262,India
517781,2023-07-30,506,monitor,3249,8000,4751,1,00262,India
517781,2023-07-30,504,iron,449,879,430,1,00262,India
841920,2023-07-30,507,washing machine,6990,16490,9500,1,00164,India
841920,2023-07-30,503,mixer,1349,3249,1900,1,00164,India
739436,2023-07-30,507,washing machine,6990,16490,9500,1,00050,India
739436,2023-07-30,502,iphone 15 pro max,100000,135000,35000,1,00050,India
739436,2023-07-30,503,mixer,1349,3249,1900,1,00050,India
739436,2023-07-30,504,iron,449,879,430,1,00050,India
228675,2023-07-30,502,iphone 15 pro max,100000,135000,35000,1,00266,India
228675,2023-07-30,504,iron,449,879,430,1,00266,India
228675,2023-07-30,507,washing machine,6990,16490,9500,1,00266,India
463194,2023-07-30,503,mixer,1349,3249,1900,1,00131,India
463194,2023-07-30,501,iphone 15,60000,80000,20000,1,00131,India
515043,2023-07-30,507,washing machine,6990,16490,9500,1,00465,India
515043,2023-07-30,502,iphone 15 pro max,100000,135000,35000,1,00465,India
515043,2023-07-30,501,iphone 15,60000,80000,20000,1,00465,India
366269,2023-07-30,505,oven,18490,24000,5510,1,00446,India
606617,2023-07-30,502,iphone 15 pro max,100000,135000,35000,1,00104,India
606617,2023-07-30,506,monitor,3249,8000,4751,1,00104,India
941102,2023-07-30,506,monitor,3249,8000,4751,1,00032,India
941102,2023-07-30,504,iron,449,879,430,1,00032,India
941102,2023-07-30,503,mixer,1349,3249,1900,1,00032,India
941102,2023-07-30,502,iphone 15 pro max,100000,135000,35000,1,00032,India
409342,2023-07-30,502,iphone 15 pro max,100000,135000,35000,1,00082,India
409342,2023-07-30,503,mixer,1349,3249,1900,1,00082,India
409342,2023-07-30,504,iron,449,879,430,1,00082,India
409342,2023-07-30,507,washing machine,6990,16490,9500,1,00082,India
212256,2023-07-30,503,mixer,1349,3249,1900,1,00006,India
212256,2023-07-30,506,monitor,3249,8000,4751,1,00006,India
462412,2023-07-30,506,monitor,3249,8000,4751,1,00126,India
462412,2023-07-30,507,washing machine,6990,16490,9500,1,00126,India
254503,2023-07-30,503,mixer,1349,3249,1900,1,00227,India
254503,2023-07-30,504,iron,449,879,430,1,00227,India
254503,2023-07-30,506,monitor,3249,8000,4751,1,00227,India
154193,2023-07-30,505,oven,18490,24000,5510,1,00096,India
154193,2023-07-30,507,washing machine,6990,16490,9500,1,00096,India
512220,2023-07-30,504,iron,449,879,430,1,00323,India
512220,2023-07-30,505,oven,18490,24000,5510,1,00323,India
703748,2023-07-30,503,mixer,1349,3249,1900,1,00308,India
934782,2023-07-30,507,washing machine,6990,16490,9500,1,00282,India
934782,2023-07-30,503,mixer,1349,3249,1900,1,00282,India
608897,2023-07-30,505,oven,18490,24000,5510,1,00241,India
566783,2023-07-30,505,oven,18490,24000,5510,1,00470,India
566783,2023-07-30,502,iphone 15 pro max,100000,135000,35000,1,00470,India
566783,2023-07-30,507,washing machine,6990,16490,9500,1,00470,India
629826,2023-07-30,503,mixer,1349,3249,1900,1,00379,India
629826,2023-07-30,501,iphone 15,60000,80000,20000,1,00379,India
629826,2023-07-30,504,iron,449,879,430,1,00379,India
934131,2023-07-30,504,iron,449,879,430,1,00445,India
934131,2023-07-30,502,iphone 15 pro max,100000,135000,35000,1,00445,India
934131,2023-07-30,503,mixer,1349,3249,1900,1,00445,India
934131,2023-07-30,505,oven,18490,24000,5510,1,00445,India
122703,2023-07-30,501,iphone 15,60000,80000,20000,1,00236,India
122703,2023-07-30,506,monitor,3249,8000,4751,1,00236,India
781044,2023-07-31,502,iphone 15 pro max,100000,135000,35000,1,00380,India
781044,2023-07-31,507,washing machine,6990,16490,9500,1,00380,India
781044,2023-07-31,501,iphone 15,60000,80000,20000,1,00380,India
487688,2023-07-31,505,oven,18490,24000,5510,1,00033,India
487688,2023-07-31,504,iron,449,879,430,1,00033,India
487688,2023-07-31,502,iphone 15 pro max,100000,135000,35000,1,00033,India
487688,2023-07-31,506,monitor,3249,8000,4751,1,00033,India
591577,2023-07-31,507,washing machine,6990,16490,9500,1,00342,India
591577,2023-07-31,504,iron,449,879,430,1,00342,India
762007,2023-07-31,504,iron,449,879,430,1,00114,India
762007,2023-07-31,506,monitor,3249,8000,4751,1,00114,India
762007,2023-07-31,507,washing machine,6990,16490,9500,1,00114,India
979359,2023-07-31,507,washing machine,6990,16490,9500,1,00420,India
979359,2023-07-31,502,iphone 15 pro max,100000,135000,35000,1,00420,India
979359,2023-07-31,506,monitor,3249,8000,4751,1,00420,India
285103,2023-07-31,507,washing machine,6990,16490,9500,1,00374,India
285103,2023-07-31,504,iron,449,879,430,1,00374,India
285103,2023-07-31,501,iphone 15,60000,80000,20000,1,00374,India
278172,2023-07-31,502,iphone 15 pro max,100000,135000,35000,1,00096,India
278172,2023-07-31,505,oven,18490,24000,5510,1,00096,India
278172,2023-07-31,506,monitor,3249,8000,4751,1,00096,India
278172,2023-07-31,504,iron,449,879,430,1,00096,India
278172,2023-07-31,501,iphone 15,60000,80000,20000,1,00096,India
628721,2023-07-31,505,oven,18490,24000,5510,1,00355,India
628721,2023-07-31,501,iphone 15,60000,80000,20000,1,00355,India
628721,2023-07-31,507,washing machine,6990,16490,9500,1,00355,India
628721,2023-07-31,503,mixer,1349,3249,1900,1,00355,India
475999,2023-07-31,503,mixer,1349,3249,1900,1,00350,India
475999,2023-07-31,506,monitor,3249,8000,4751,1,00350,India
312079,2023-07-31,507,washing machine,6990,16490,9500,1,00243,India
312079,2023-07-31,502,iphone 15 pro max,100000,135000,35000,1,00243,India
312079,2023-07-31,506,monitor,3249,8000,4751,1,00243,India
312079,2023-07-31,501,iphone 15,60000,80000,20000,1,00243,India
440042,2023-07-31,505,oven,18490,24000,5510,1,00224,India
440042,2023-07-31,504,iron,449,879,430,1,00224,India
297576,2023-07-31,506,monitor,3249,8000,4751,1,00479,India
297576,2023-07-31,507,washing machine,6990,16490,9500,1,00479,India
297576,2023-07-31,502,iphone 15 pro max,100000,135000,35000,1,00479,India
297576,2023-07-31,501,iphone 15,60000,80000,20000,1,00479,India
297576,2023-07-31,505,oven,18490,24000,5510,1,00479,India
992348,2023-07-31,503,mixer,1349,3249,1900,1,00346,India
992348,2023-07-31,504,iron,449,879,430,1,00346,India
992348,2023-07-31,507,washing machine,6990,16490,9500,1,00346,India
379545,2023-07-31,505,oven,18490,24000,5510,1,00433,India
379545,2023-07-31,502,iphone 15 pro max,100000,135000,35000,1,00433,India
878696,2023-07-31,504,iron,449,879,430,1,00473,India
878696,2023-07-31,505,oven,18490,24000,5510,1,00473,India
878696,2023-07-31,502,iphone 15 pro max,100000,135000,35000,1,00473,India
577264,2023-07-31,505,oven,18490,24000,5510,1,00341,India
230430,2023-07-31,503,mixer,1349,3249,1900,1,00462,India
230430,2023-07-31,501,iphone 15,60000,80000,20000,1,00462,India
142528,2023-07-31,502,iphone 15 pro max,100000,135000,35000,1,00288,India
687715,2023-07-31,504,iron,449,879,430,1,00352,India
950922,2023-07-31,504,iron,449,879,430,1,00432,India
950922,2023-07-31,501,iphone 15,60000,80000,20000,1,00432,India
950922,2023-07-31,502,iphone 15 pro max,100000,135000,35000,1,00432,India
950922,2023-07-31,505,oven,18490,24000,5510,1,00432,India
143147,2023-07-31,505,oven,18490,24000,5510,1,00362,India
143147,2023-07-31,504,iron,449,879,430,1,00362,India
143147,2023-07-31,502,iphone 15 pro max,100000,135000,35000,1,00362,India
917885,2023-07-31,501,iphone 15,60000,80000,20000,1,00009,India
571412,2023-07-31,507,washing machine,6990,16490,9500,1,00348,India
571412,2023-07-31,505,oven,18490,24000,5510,1,00348,India
571412,2023-07-31,501,iphone 15,60000,80000,20000,1,00348,India
688567,2023-07-31,506,monitor,3249,8000,4751,1,00435,India
688567,2023-07-31,504,iron,449,879,430,1,00435,India
688567,2023-07-31,503,mixer,1349,3249,1900,1,00435,India
220886,2023-07-31,507,washing machine,6990,16490,9500,1,00139,India
220886,2023-07-31,502,iphone 15 pro max,100000,135000,35000,1,00139,India
220886,2023-07-31,505,oven,18490,24000,5510,1,00139,India
147412,2023-07-31,506,monitor,3249,8000,4751,1,00372,India
432621,2023-07-31,503,mixer,1349,3249,1900,1,00120,India
432621,2023-07-31,506,monitor,3249,8000,4751,1,00120,India
432621,2023-07-31,502,iphone 15 pro max,100000,135000,35000,1,00120,India
603169,2023-07-31,502,iphone 15 pro max,100000,135000,35000,1,00007,India
276958,2023-07-31,503,mixer,1349,3249,1900,1,00428,India
276958,2023-07-31,501,iphone 15,60000,80000,20000,1,00428,India
935988,2023-07-31,505,oven,18490,24000,5510,1,00269,India
935988,2023-07-31,503,mixer,1349,3249,1900,1,00269,India
855661,2023-07-31,502,iphone 15 pro max,100000,135000,35000,1,00067,India
855661,2023-07-31,504,iron,449,879,430,1,00067,India
855661,2023-07-31,503,mixer,1349,3249,1900,1,00067,India
744012,2023-07-31,502,iphone 15 pro max,100000,135000,35000,1,00033,India
744012,2023-07-31,504,iron,449,879,430,1,00033,India
744012,2023-07-31,507,washing machine,6990,16490,9500,1,00033,India
127432,2023-07-31,504,iron,449,879,430,1,00347,India
127432,2023-07-31,502,iphone 15 pro max,100000,135000,35000,1,00347,India
127432,2023-07-31,507,washing machine,6990,16490,9500,1,00347,India
553676,2023-07-31,507,washing machine,6990,16490,9500,1,00100,India
553676,2023-07-31,503,mixer,1349,3249,1900,1,00100,India
366507,2023-07-31,505,oven,18490,24000,5510,1,00445,India
366507,2023-07-31,503,mixer,1349,3249,1900,1,00445,India
469327,2023-07-31,502,iphone 15 pro max,100000,135000,35000,1,00156,India
469327,2023-07-31,506,monitor,3249,8000,4751,1,00156,India
469327,2023-07-31,503,mixer,1349,3249,1900,1,00156,India
134619,2023-07-31,503,mixer,1349,3249,1900,1,00062,India
134619,2023-07-31,502,iphone 15 pro max,100000,135000,35000,1,00062,India
134619,2023-07-31,506,monitor,3249,8000,4751,1,00062,India
933982,2023-07-31,503,mixer,1349,3249,1900,1,00277,India
933982,2023-07-31,506,monitor,3249,8000,4751,1,00277,India
741982,2023-07-31,503,mixer,1349,3249,1900,1,00055,India
975451,2023-07-31,506,monitor,3249,8000,4751,1,00016,India
670401,2023-07-31,502,iphone 15 pro max,100000,135000,35000,1,00354,India
670401,2023-07-31,501,iphone 15,60000,80000,20000,1,00354,India
670401,2023-07-31,503,mixer,1349,3249,1900,1,00354,India
670401,2023-07-31,505,oven,18490,24000,5510,1,00354,India
136294,2023-07-31,501,iphone 15,60000,80000,20000,1,00230,India
845529,2023-07-31,505,oven,18490,24000,5510,1,00369,India
845529,2023-07-31,507,washing machine,6990,16490,9500,1,00369,India
845529,2023-07-31,503,mixer,1349,3249,1900,1,00369,India
845529,2023-07-31,504,iron,449,879,430,1,00369,India
159546,2023-07-31,505,oven,18490,24000,5510,1,00315,India
159546,2023-07-31,503,mixer,1349,3249,1900,1,00315,India
159546,2023-07-31,506,monitor,3249,8000,4751,1,00315,India
159546,2023-07-31,504,iron,449,879,430,1,00315,India
981045,2023-07-31,505,oven,18490,24000,5510,1,00062,India
981045,2023-07-31,506,monitor,3249,8000,4751,1,00062,India
981045,2023-07-31,501,iphone 15,60000,80000,20000,1,00062,India
564373,2023-07-31,501,iphone 15,60000,80000,20000,1,00192,India
564373,2023-07-31,506,monitor,3249,8000,4751,1,00192,India
564373,2023-07-31,502,iphone 15 pro max,100000,135000,35000,1,00192,India
251094,2023-07-31,504,iron,449,879,430,1,00302,India
251094,2023-07-31,505,oven,18490,24000,5510,1,00302,India
251094,2023-07-31,501,iphone 15,60000,80000,20000,1,00302,India
404662,2023-07-31,501,iphone 15,60000,80000,20000,1,00298,India
394663,2023-07-31,505,oven,18490,24000,5510,1,00237,India
394663,2023-07-31,507,washing machine,6990,16490,9500,1,00237,India
394663,2023-07-31,504,iron,449,879,430,1,00237,India
394663,2023-07-31,502,iphone 15 pro max,100000,135000,35000,1,00237,India
121396,2023-07-31,502,iphone 15 pro max,100000,135000,35000,1,00442,India
861456,2023-07-31,502,iphone 15 pro max,100000,135000,35000,1,00035,India
861456,2023-07-31,504,iron,449,879,430,1,00035,India
861456,2023-07-31,505,oven,18490,24000,5510,1,00035,India
861456,2023-07-31,501,iphone 15,60000,80000,20000,1,00035,India
141405,2023-07-31,507,washing machine,6990,16490,9500,1,00375,India
141405,2023-07-31,503,mixer,1349,3249,1900,1,00375,India
141405,2023-07-31,504,iron,449,879,430,1,00375,India
141405,2023-07-31,502,iphone 15 pro max,100000,135000,35000,1,00375,India
141405,2023-07-31,506,monitor,3249,8000,4751,1,00375,India
868323,2023-07-31,504,iron,449,879,430,1,00005,India
868323,2023-07-31,507,washing machine,6990,16490,9500,1,00005,India
868323,2023-07-31,503,mixer,1349,3249,1900,1,00005,India
518231,2023-07-31,505,oven,18490,24000,5510,1,00387,India
518231,2023-07-31,501,iphone 15,60000,80000,20000,1,00387,India
605542,2023-07-31,507,washing machine,6990,16490,9500,1,00315,India
605542,2023-07-31,506,monitor,3249,8000,4751,1,00315,India
605542,2023-07-31,503,mixer,1349,3249,1900,1,00315,India
941747,2023-07-31,502,iphone 15 pro max,100000,135000,35000,1,00174,India
941747,2023-07-31,503,mixer,1349,3249,1900,1,00174,India
941747,2023-07-31,501,iphone 15,60000,80000,20000,1,00174,India
941747,2023-07-31,504,iron,449,879,430,1,00174,India
693367,2023-07-31,502,iphone 15 pro max,100000,135000,35000,1,00049,India
693367,2023-07-31,503,mixer,1349,3249,1900,1,00049,India
693367,2023-07-31,506,monitor,3249,8000,4751,1,00049,India
693367,2023-07-31,505,oven,18490,24000,5510,1,00049,India
693367,2023-07-31,507,washing machine,6990,16490,9500,1,00049,India
114761,2023-07-31,507,washing machine,6990,16490,9500,1,00357,India
114761,2023-07-31,501,iphone 15,60000,80000,20000,1,00357,India
114761,2023-07-31,505,oven,18490,24000,5510,1,00357,India
648884,2023-07-31,506,monitor,3249,8000,4751,1,00301,India
648884,2023-07-31,504,iron,449,879,430,1,00301,India
638514,2023-07-31,502,iphone 15 pro max,100000,135000,35000,1,00469,India
106068,2023-07-31,502,iphone 15 pro max,100000,135000,35000,1,00135,India
106068,2023-07-31,501,iphone 15,60000,80000,20000,1,00135,India
235033,2023-07-31,502,iphone 15 pro max,100000,135000,35000,1,00181,India
235033,2023-07-31,507,washing machine,6990,16490,9500,1,00181,India
515899,2023-07-31,503,mixer,1349,3249,1900,1,00044,India
515899,2023-07-31,505,oven,18490,24000,5510,1,00044,India
515899,2023-07-31,507,washing machine,6990,16490,9500,1,00044,India
250386,2023-07-31,503,mixer,1349,3249,1900,1,00058,India
250386,2023-07-31,505,oven,18490,24000,5510,1,00058,India
922382,2023-07-31,503,mixer,1349,3249,1900,1,00020,India
922382,2023-07-31,502,iphone 15 pro max,100000,135000,35000,1,00020,India
922382,2023-07-31,501,iphone 15,60000,80000,20000,1,00020,India
108509,2023-07-31,507,washing machine,6990,16490,9500,1,00141,India
682293,2023-07-31,506,monitor,3249,8000,4751,1,00320,India
682293,2023-07-31,505,oven,18490,24000,5510,1,00320,India
682293,2023-07-31,501,iphone 15,60000,80000,20000,1,00320,India
517043,2023-07-31,503,mixer,1349,3249,1900,1,00177,India
517043,2023-07-31,505,oven,18490,24000,5510,1,00177,India
517043,2023-07-31,506,monitor,3249,8000,4751,1,00177,India
517043,2023-07-31,507,washing machine,6990,16490,9500,1,00177,India
673339,2023-07-31,507,washing machine,6990,16490,9500,1,00256,India
673339,2023-07-31,506,monitor,3249,8000,4751,1,00256,India
673339,2023-07-31,501,iphone 15,60000,80000,20000,1,00256,India
660706,2023-07-31,506,monitor,3249,8000,4751,1,00313,India
660706,2023-07-31,504,iron,449,879,430,1,00313,India
660706,2023-07-31,503,mixer,1349,3249,1900,1,00313,India
660706,2023-07-31,505,oven,18490,24000,5510,1,00313,India
384048,2023-07-31,506,monitor,3249,8000,4751,1,00091,India
409802,2023-07-31,501,iphone 15,60000,80000,20000,1,00068,India
255730,2023-07-31,505,oven,18490,24000,5510,1,00080,India
255730,2023-07-31,504,iron,449,879,430,1,00080,India
542127,2023-07-31,503,mixer,1349,3249,1900,1,00091,India
997900,2023-07-31,503,mixer,1349,3249,1900,1,00376,India
997900,2023-07-31,506,monitor,3249,8000,4751,1,00376,India
997900,2023-07-31,504,iron,449,879,430,1,00376,India
997900,2023-07-31,507,washing machine,6990,16490,9500,1,00376,India
806745,2023-07-31,507,washing machine,6990,16490,9500,1,00280,India
806745,2023-07-31,503,mixer,1349,3249,1900,1,00280,India
946458,2023-07-31,506,monitor,3249,8000,4751,1,00242,India
946458,2023-07-31,503,mixer,1349,3249,1900,1,00242,India
946458,2023-07-31,502,iphone 15 pro max,100000,135000,35000,1,00242,India
448329,2023-07-31,503,mixer,1349,3249,1900,1,00197,India
448329,2023-07-31,505,oven,18490,24000,5510,1,00197,India
512693,2023-07-31,505,oven,18490,24000,5510,1,00471,India
512693,2023-07-31,506,monitor,3249,8000,4751,1,00471,India
512693,2023-07-31,501,iphone 15,60000,80000,20000,1,00471,India
665774,2023-07-31,501,iphone 15,60000,80000,20000,1,00308,India
665774,2023-07-31,506,monitor,3249,8000,4751,1,00308,India
665774,2023-07-31,502,iphone 15 pro max,100000,135000,35000,1,00308,India
410973,2023-07-31,502,iphone 15 pro max,100000,135000,35000,1,00067,India
410973,2023-07-31,501,iphone 15,60000,80000,20000,1,00067,India
410973,2023-07-31,504,iron,449,879,430,1,00067,India
410973,2023-07-31,505,oven,18490,24000,5510,1,00067,India
264019,2023-07-31,505,oven,18490,24000,5510,1,00187,India
264019,2023-07-31,507,washing machine,6990,16490,9500,1,00187,India
264019,2023-07-31,501,iphone 15,60000,80000,20000,1,00187,India
140351,2023-07-31,506,monitor,3249,8000,4751,1,00236,India
140351,2023-07-31,504,iron,449,879,430,1,00236,India
140351,2023-07-31,503,mixer,1349,3249,1900,1,00236,India
140351,2023-07-31,507,washing machine,6990,16490,9500,1,00236,India
140351,2023-07-31,505,oven,18490,24000,5510,1,00236,India
551165,2023-07-31,504,iron,449,879,430,1,00105,India
118291,2023-07-31,507,washing machine,6990,16490,9500,1,00375,India
118291,2023-07-31,501,iphone 15,60000,80000,20000,1,00375,India
118291,2023-07-31,503,mixer,1349,3249,1900,1,00375,India
493056,2023-07-31,507,washing machine,6990,16490,9500,1,00231,India
493056,2023-07-31,506,monitor,3249,8000,4751,1,00231,India
493056,2023-07-31,504,iron,449,879,430,1,00231,India
493056,2023-07-31,501,iphone 15,60000,80000,20000,1,00231,India
335942,2023-07-31,503,mixer,1349,3249,1900,1,00358,India
335942,2023-07-31,504,iron,449,879,430,1,00358,India
767419,2023-07-31,504,iron,449,879,430,1,00071,India
767419,2023-07-31,502,iphone 15 pro max,100000,135000,35000,1,00071,India
767419,2023-07-31,505,oven,18490,24000,5510,1,00071,India
403335,2023-07-31,502,iphone 15 pro max,100000,135000,35000,1,00380,India
403335,2023-07-31,505,oven,18490,24000,5510,1,00380,India
403335,2023-07-31,507,washing machine,6990,16490,9500,1,00380,India
998306,2023-07-31,504,iron,449,879,430,1,00471,India
998306,2023-07-31,502,iphone 15 pro max,100000,135000,35000,1,00471,India
998306,2023-07-31,507,washing machine,6990,16490,9500,1,00471,India
702562,2023-07-31,501,iphone 15,60000,80000,20000,1,00194,India
702562,2023-07-31,506,monitor,3249,8000,4751,1,00194,India
702562,2023-07-31,503,mixer,1349,3249,1900,1,00194,India
702562,2023-07-31,504,iron,449,879,430,1,00194,India
360220,2023-07-31,506,monitor,3249,8000,4751,1,00469,India
360220,2023-07-31,503,mixer,1349,3249,1900,1,00469,India
360220,2023-07-31,505,oven,18490,24000,5510,1,00469,India
379077,2023-07-31,503,mixer,1349,3249,1900,1,00009,India
379077,2023-07-31,505,oven,18490,24000,5510,1,00009,India
804725,2023-07-31,502,iphone 15 pro max,100000,135000,35000,1,00271,India
397149,2023-07-31,507,washing machine,6990,16490,9500,1,00007,India
397149,2023-07-31,501,iphone 15,60000,80000,20000,1,00007,India
622122,2023-07-31,506,monitor,3249,8000,4751,1,00058,India
622122,2023-07-31,507,washing machine,6990,16490,9500,1,00058,India
704473,2023-07-31,507,washing machine,6990,16490,9500,1,00062,India
704473,2023-07-31,505,oven,18490,24000,5510,1,00062,India
228903,2023-07-31,506,monitor,3249,8000,4751,1,00071,India
428323,2023-07-31,503,mixer,1349,3249,1900,1,00499,India
428323,2023-07-31,502,iphone 15 pro max,100000,135000,35000,1,00499,India
428323,2023-07-31,507,washing machine,6990,16490,9500,1,00499,India
408466,2023-07-31,505,oven,18490,24000,5510,1,00036,India
408466,2023-07-31,506,monitor,3249,8000,4751,1,00036,India
617408,2023-08-01,501,iphone 15,60000,80000,20000,1,00422,India
617408,2023-08-01,507,washing machine,6990,16490,9500,1,00422,India
360597,2023-08-01,506,monitor,3249,8000,4751,1,00370,India
360597,2023-08-01,501,iphone 15,60000,80000,20000,1,00370,India
360597,2023-08-01,504,iron,449,879,430,1,00370,India
360597,2023-08-01,502,iphone 15 pro max,100000,135000,35000,1,00370,India
589570,2023-08-01,504,iron,449,879,430,1,00329,India
589570,2023-08-01,502,iphone 15 pro max,100000,135000,35000,1,00329,India
589570,2023-08-01,501,iphone 15,60000,80000,20000,1,00329,India
987673,2023-08-01,507,washing machine,6990,16490,9500,1,00132,India
384994,2023-08-01,504,iron,449,879,430,1,00473,India
511287,2023-08-01,506,monitor,3249,8000,4751,1,00475,India
511287,2023-08-01,503,mixer,1349,3249,1900,1,00475,India
637291,2023-08-01,506,monitor,3249,8000,4751,1,00333,India
320114,2023-08-01,505,oven,18490,24000,5510,1,00012,India
320114,2023-08-01,501,iphone 15,60000,80000,20000,1,00012,India
156592,2023-08-01,505,oven,18490,24000,5510,1,00411,India
156592,2023-08-01,506,monitor,3249,8000,4751,1,00411,India
824744,2023-08-01,502,iphone 15 pro max,100000,135000,35000,1,00357,India
824744,2023-08-01,504,iron,449,879,430,1,00357,India
824744,2023-08-01,505,oven,18490,24000,5510,1,00357,India
824744,2023-08-01,501,iphone 15,60000,80000,20000,1,00357,India
449887,2023-08-01,507,washing machine,6990,16490,9500,1,00143,India
449887,2023-08-01,502,iphone 15 pro max,100000,135000,35000,1,00143,India
215087,2023-08-01,504,iron,449,879,430,1,00335,India
495964,2023-08-01,505,oven,18490,24000,5510,1,00038,India
216476,2023-08-01,502,iphone 15 pro max,100000,135000,35000,1,00065,India
216476,2023-08-01,505,oven,18490,24000,5510,1,00065,India
216476,2023-08-01,503,mixer,1349,3249,1900,1,00065,India
216476,2023-08-01,501,iphone 15,60000,80000,20000,1,00065,India
459145,2023-08-01,504,iron,449,879,430,1,00286,India
459145,2023-08-01,502,iphone 15 pro max,100000,135000,35000,1,00286,India
459145,2023-08-01,506,monitor,3249,8000,4751,1,00286,India
739624,2023-08-01,502,iphone 15 pro max,100000,135000,35000,1,00445,India
739624,2023-08-01,505,oven,18490,24000,5510,1,00445,India
390594,2023-08-01,501,iphone 15,60000,80000,20000,1,00262,India
390594,2023-08-01,504,iron,449,879,430,1,00262,India
390594,2023-08-01,503,mixer,1349,3249,1900,1,00262,India
270542,2023-08-01,506,monitor,3249,8000,4751,1,00460,India
270542,2023-08-01,501,iphone 15,60000,80000,20000,1,00460,India
270542,2023-08-01,505,oven,18490,24000,5510,1,00460,India
149985,2023-08-01,502,iphone 15 pro max,100000,135000,35000,1,00078,India
149985,2023-08-01,504,iron,449,879,430,1,00078,India
149985,2023-08-01,505,oven,18490,24000,5510,1,00078,India
727367,2023-08-01,503,mixer,1349,3249,1900,1,00246,India
727367,2023-08-01,502,iphone 15 pro max,100000,135000,35000,1,00246,India
727367,2023-08-01,506,monitor,3249,8000,4751,1,00246,India
247500,2023-08-01,503,mixer,1349,3249,1900,1,00178,India
666288,2023-08-01,507,washing machine,6990,16490,9500,1,00257,India
743656,2023-08-01,501,iphone 15,60000,80000,20000,1,00450,India
743656,2023-08-01,502,iphone 15 pro max,100000,135000,35000,1,00450,India
817064,2023-08-01,506,monitor,3249,8000,4751,1,00256,India
817064,2023-08-01,504,iron,449,879,430,1,00256,India
817064,2023-08-01,503,mixer,1349,3249,1900,1,00256,India
144780,2023-08-01,502,iphone 15 pro max,100000,135000,35000,1,00173,India
144780,2023-08-01,506,monitor,3249,8000,4751,1,00173,India
144780,2023-08-01,507,washing machine,6990,16490,9500,1,00173,India
144780,2023-08-01,505,oven,18490,24000,5510,1,00173,India
144780,2023-08-01,503,mixer,1349,3249,1900,1,00173,India
500285,2023-08-01,503,mixer,1349,3249,1900,1,00145,India
500285,2023-08-01,505,oven,18490,24000,5510,1,00145,India
601585,2023-08-01,507,washing machine,6990,16490,9500,1,00483,India
601585,2023-08-01,504,iron,449,879,430,1,00483,India
451336,2023-08-01,503,mixer,1349,3249,1900,1,00441,India
451336,2023-08-01,501,iphone 15,60000,80000,20000,1,00441,India
271770,2023-08-01,505,oven,18490,24000,5510,1,00338,India
271770,2023-08-01,504,iron,449,879,430,1,00338,India
271770,2023-08-01,501,iphone 15,60000,80000,20000,1,00338,India
865245,2023-08-01,502,iphone 15 pro max,100000,135000,35000,1,00360,India
353594,2023-08-01,501,iphone 15,60000,80000,20000,1,00159,India
353594,2023-08-01,507,washing machine,6990,16490,9500,1,00159,India
447745,2023-08-01,507,washing machine,6990,16490,9500,1,00226,India
447745,2023-08-01,506,monitor,3249,8000,4751,1,00226,India
170849,2023-08-01,503,mixer,1349,3249,1900,1,00023,India
170849,2023-08-01,504,iron,449,879,430,1,00023,India
613659,2023-08-01,507,washing machine,6990,16490,9500,1,00020,India
613659,2023-08-01,504,iron,449,879,430,1,00020,India
613659,2023-08-01,502,iphone 15 pro max,100000,135000,35000,1,00020,India
613659,2023-08-01,503,mixer,1349,3249,1900,1,00020,India
106787,2023-08-01,504,iron,449,879,430,1,00455,India
106787,2023-08-01,502,iphone 15 pro max,100000,135000,35000,1,00455,India
106787,2023-08-01,507,washing machine,6990,16490,9500,1,00455,India
106787,2023-08-01,503,mixer,1349,3249,1900,1,00455,India
106787,2023-08-01,501,iphone 15,60000,80000,20000,1,00455,India
440305,2023-08-01,507,washing machine,6990,16490,9500,1,00385,India
673124,2023-08-01,506,monitor,3249,8000,4751,1,00365,India
673124,2023-08-01,501,iphone 15,60000,80000,20000,1,00365,India
673124,2023-08-01,505,oven,18490,24000,5510,1,00365,India
673124,2023-08-01,503,mixer,1349,3249,1900,1,00365,India
183260,2023-08-01,505,oven,18490,24000,5510,1,00212,India
183260,2023-08-01,501,iphone 15,60000,80000,20000,1,00212,India
183260,2023-08-01,507,washing machine,6990,16490,9500,1,00212,India
183260,2023-08-01,503,mixer,1349,3249,1900,1,00212,India
748446,2023-08-01,501,iphone 15,60000,80000,20000,1,00015,India
748446,2023-08-01,504,iron,449,879,430,1,00015,India
748446,2023-08-01,506,monitor,3249,8000,4751,1,00015,India
331831,2023-08-01,503,mixer,1349,3249,1900,1,00499,India
331831,2023-08-01,506,monitor,3249,8000,4751,1,00499,India
331831,2023-08-01,502,iphone 15 pro max,100000,135000,35000,1,00499,India
331831,2023-08-01,507,washing machine,6990,16490,9500,1,00499,India
848356,2023-08-01,503,mixer,1349,3249,1900,1,00191,India
657483,2023-08-01,504,iron,449,879,430,1,00101,India
474439,2023-08-01,505,oven,18490,24000,5510,1,00172,India
316543,2023-08-01,506,monitor,3249,8000,4751,1,00136,India
316543,2023-08-01,503,mixer,1349,3249,1900,1,00136,India
779098,2023-08-01,505,oven,18490,24000,5510,1,00263,India
279355,2023-08-01,502,iphone 15 pro max,100000,135000,35000,1,00369,India
279355,2023-08-01,506,monitor,3249,8000,4751,1,00369,India
279355,2023-08-01,504,iron,449,879,430,1,00369,India
145868,2023-08-01,501,iphone 15,60000,80000,20000,1,00331,India
145868,2023-08-01,505,oven,18490,24000,5510,1,00331,India
145868,2023-08-01,504,iron,449,879,430,1,00331,India
248776,2023-08-01,503,mixer,1349,3249,1900,1,00342,India
248776,2023-08-01,505,oven,18490,24000,5510,1,00342,India
248776,2023-08-01,507,washing machine,6990,16490,9500,1,00342,India
957446,2023-08-01,502,iphone 15 pro max,100000,135000,35000,1,00027,India
957446,2023-08-01,503,mixer,1349,3249,1900,1,00027,India
957446,2023-08-01,504,iron,449,879,430,1,00027,India
957446,2023-08-01,507,washing machine,6990,16490,9500,1,00027,India
942611,2023-08-01,507,washing machine,6990,16490,9500,1,00298,India
955314,2023-08-01,505,oven,18490,24000,5510,1,00414,India
137594,2023-08-01,503,mixer,1349,3249,1900,1,00449,India
137594,2023-08-01,504,iron,449,879,430,1,00449,India
192789,2023-08-01,505,oven,18490,24000,5510,1,00059,India
192789,2023-08-01,503,mixer,1349,3249,1900,1,00059,India
192789,2023-08-01,504,iron,449,879,430,1,00059,India
192789,2023-08-01,507,washing machine,6990,16490,9500,1,00059,India
780131,2023-08-01,507,washing machine,6990,16490,9500,1,00355,India
780131,2023-08-01,502,iphone 15 pro max,100000,135000,35000,1,00355,India
778412,2023-08-01,504,iron,449,879,430,1,00273,India
778412,2023-08-01,505,oven,18490,24000,5510,1,00273,India
874148,2023-08-01,501,iphone 15,60000,80000,20000,1,00451,India
874148,2023-08-01,502,iphone 15 pro max,100000,135000,35000,1,00451,India
874148,2023-08-01,507,washing machine,6990,16490,9500,1,00451,India
981329,2023-08-01,504,iron,449,879,430,1,00176,India
469543,2023-08-01,502,iphone 15 pro max,100000,135000,35000,1,00425,India
984688,2023-08-01,504,iron,449,879,430,1,00328,India
317026,2023-08-01,503,mixer,1349,3249,1900,1,00121,India
317026,2023-08-01,504,iron,449,879,430,1,00121,India
875190,2023-08-01,501,iphone 15,60000,80000,20000,1,00372,India
875190,2023-08-01,506,monitor,3249,8000,4751,1,00372,India
875190,2023-08-01,507,washing machine,6990,16490,9500,1,00372,India
798335,2023-08-01,501,iphone 15,60000,80000,20000,1,00164,India
798335,2023-08-01,504,iron,449,879,430,1,00164,India
798335,2023-08-01,505,oven,18490,24000,5510,1,00164,India
608169,2023-08-01,506,monitor,3249,8000,4751,1,00249,India
608169,2023-08-01,505,oven,18490,24000,5510,1,00249,India
252452,2023-08-01,502,iphone 15 pro max,100000,135000,35000,1,00353,India
252452,2023-08-01,507,washing machine,6990,16490,9500,1,00353,India
252452,2023-08-01,504,iron,449,879,430,1,00353,India
864922,2023-08-01,504,iron,449,879,430,1,00406,India
864922,2023-08-01,507,washing machine,6990,16490,9500,1,00406,India
864922,2023-08-01,506,monitor,3249,8000,4751,1,00406,India
333922,2023-08-01,501,iphone 15,60000,80000,20000,1,00086,India
333922,2023-08-01,505,oven,18490,24000,5510,1,00086,India
333922,2023-08-01,502,iphone 15 pro max,100000,135000,35000,1,00086,India
964592,2023-08-01,507,washing machine,6990,16490,9500,1,00215,India
964592,2023-08-01,504,iron,449,879,430,1,00215,India
938166,2023-08-01,504,iron,449,879,430,1,00101,India
938166,2023-08-01,505,oven,18490,24000,5510,1,00101,India
115063,2023-08-01,502,iphone 15 pro max,100000,135000,35000,1,00197,India
115063,2023-08-01,501,iphone 15,60000,80000,20000,1,00197,India
496848,2023-08-01,506,monitor,3249,8000,4751,1,00092,India
496848,2023-08-01,504,iron,449,879,430,1,00092,India
496848,2023-08-01,503,mixer,1349,3249,1900,1,00092,India
496848,2023-08-01,505,oven,18490,24000,5510,1,00092,India
496848,2023-08-01,507,washing machine,6990,16490,9500,1,00092,India
882348,2023-08-01,503,mixer,1349,3249,1900,1,00279,India
882348,2023-08-01,507,washing machine,6990,16490,9500,1,00279,India
649278,2023-08-01,501,iphone 15,60000,80000,20000,1,00418,India
649278,2023-08-01,507,washing machine,6990,16490,9500,1,00418,India
649278,2023-08-01,503,mixer,1349,3249,1900,1,00418,India
649278,2023-08-01,505,oven,18490,24000,5510,1,00418,India
420148,2023-08-01,507,washing machine,6990,16490,9500,1,00388,India
420148,2023-08-01,503,mixer,1349,3249,1900,1,00388,India
420148,2023-08-01,505,oven,18490,24000,5510,1,00388,India
967144,2023-08-01,501,iphone 15,60000,80000,20000,1,00249,India
967144,2023-08-01,502,iphone 15 pro max,100000,135000,35000,1,00249,India
967144,2023-08-01,503,mixer,1349,3249,1900,1,00249,India
790777,2023-08-01,502,iphone 15 pro max,100000,135000,35000,1,00356,India
790777,2023-08-01,507,washing machine,6990,16490,9500,1,00356,India
790777,2023-08-01,504,iron,449,879,430,1,00356,India
133358,2023-08-01,504,iron,449,879,430,1,00353,India
133358,2023-08-01,501,iphone 15,60000,80000,20000,1,00353,India
397633,2023-08-01,502,iphone 15 pro max,100000,135000,35000,1,00170,India
397633,2023-08-01,501,iphone 15,60000,80000,20000,1,00170,India
223031,2023-08-01,504,iron,449,879,430,1,00113,India
223031,2023-08-01,503,mixer,1349,3249,1900,1,00113,India
171128,2023-08-01,507,washing machine,6990,16490,9500,1,00423,India
789532,2023-08-01,505,oven,18490,24000,5510,1,00265,India
789532,2023-08-01,507,washing machine,6990,16490,9500,1,00265,India
789532,2023-08-01,504,iron,449,879,430,1,00265,India
380235,2023-08-01,506,monitor,3249,8000,4751,1,00435,India
380235,2023-08-01,505,oven,18490,24000,5510,1,00435,India
799245,2023-08-01,503,mixer,1349,3249,1900,1,00117,India
671789,2023-08-01,503,mixer,1349,3249,1900,1,00377,India
671789,2023-08-01,505,oven,18490,24000,5510,1,00377,India
268020,2023-08-01,502,iphone 15 pro max,100000,135000,35000,1,00161,India
268020,2023-08-01,503,mixer,1349,3249,1900,1,00161,India
724832,2023-08-01,506,monitor,3249,8000,4751,1,00337,India
724832,2023-08-01,507,washing machine,6990,16490,9500,1,00337,India
724832,2023-08-01,501,iphone 15,60000,80000,20000,1,00337,India
680285,2023-08-01,504,iron,449,879,430,1,00412,India
680285,2023-08-01,501,iphone 15,60000,80000,20000,1,00412,India
680285,2023-08-01,502,iphone 15 pro max,100000,135000,35000,1,00412,India
319444,2023-08-01,501,iphone 15,60000,80000,20000,1,00081,India
319444,2023-08-01,504,iron,449,879,430,1,00081,India
319444,2023-08-01,503,mixer,1349,3249,1900,1,00081,India
537469,2023-08-01,503,mixer,1349,3249,1900,1,00125,India
537469,2023-08-01,501,iphone 15,60000,80000,20000,1,00125,India
381144,2023-08-01,504,iron,449,879,430,1,00448,India
381144,2023-08-01,506,monitor,3249,8000,4751,1,00448,India
381144,2023-08-01,505,oven,18490,24000,5510,1,00448,India
381144,2023-08-01,507,washing machine,6990,16490,9500,1,00448,India
472548,2023-08-01,501,iphone 15,60000,80000,20000,1,00463,India
513273,2023-08-01,502,iphone 15 pro max,100000,135000,35000,1,00490,India
513273,2023-08-01,507,washing machine,6990,16490,9500,1,00490,India
513273,2023-08-01,506,monitor,3249,8000,4751,1,00490,India
513273,2023-08-01,504,iron,449,879,430,1,00490,India
941367,2023-08-01,501,iphone 15,60000,80000,20000,1,00489,India
941367,2023-08-01,503,mixer,1349,3249,1900,1,00489,India
941367,2023-08-01,505,oven,18490,24000,5510,1,00489,India
152559,2023-08-01,507,washing machine,6990,16490,9500,1,00372,India
152559,2023-08-01,501,iphone 15,60000,80000,20000,1,00372,India
152559,2023-08-01,505,oven,18490,24000,5510,1,00372,India
896643,2023-08-01,504,iron,449,879,430,1,00339,India
896643,2023-08-01,501,iphone 15,60000,80000,20000,1,00339,India
896643,2023-08-01,506,monitor,3249,8000,4751,1,00339,India
896643,2023-08-01,507,washing machine,6990,16490,9500,1,00339,India
453682,2023-08-02,507,washing machine,6990,16490,9500,1,00369,India
412290,2023-08-02,507,washing machine,6990,16490,9500,1,00285,India
980723,2023-08-02,506,monitor,3249,8000,4751,1,00176,India
980723,2023-08-02,507,washing machine,6990,16490,9500,1,00176,India
515605,2023-08-02,506,monitor,3249,8000,4751,1,00328,India
902189,2023-08-02,507,washing machine,6990,16490,9500,1,00207,India
902189,2023-08-02,506,monitor,3249,8000,4751,1,00207,India
902189,2023-08-02,505,oven,18490,24000,5510,1,00207,India
902189,2023-08-02,503,mixer,1349,3249,1900,1,00207,India
902189,2023-08-02,501,iphone 15,60000,80000,20000,1,00207,India
741656,2023-08-02,507,washing machine,6990,16490,9500,1,00307,India
741656,2023-08-02,505,oven,18490,24000,5510,1,00307,India
991827,2023-08-02,504,iron,449,879,430,1,00326,India
991827,2023-08-02,501,iphone 15,60000,80000,20000,1,00326,India
991827,2023-08-02,506,monitor,3249,8000,4751,1,00326,India
991827,2023-08-02,505,oven,18490,24000,5510,1,00326,India
657377,2023-08-02,504,iron,449,879,430,1,00469,India
657377,2023-08-02,501,iphone 15,60000,80000,20000,1,00469,India
886228,2023-08-02,506,monitor,3249,8000,4751,1,00449,India
886228,2023-08-02,503,mixer,1349,3249,1900,1,00449,India
886228,2023-08-02,504,iron,449,879,430,1,00449,India
185619,2023-08-02,506,monitor,3249,8000,4751,1,00453,India
185619,2023-08-02,502,iphone 15 pro max,100000,135000,35000,1,00453,India
195558,2023-08-02,504,iron,449,879,430,1,00010,India
195558,2023-08-02,501,iphone 15,60000,80000,20000,1,00010,India
195558,2023-08-02,502,iphone 15 pro max,100000,135000,35000,1,00010,India
195558,2023-08-02,506,monitor,3249,8000,4751,1,00010,India
754421,2023-08-02,505,oven,18490,24000,5510,1,00438,India
250213,2023-08-02,504,iron,449,879,430,1,00144,India
250213,2023-08-02,503,mixer,1349,3249,1900,1,00144,India
250213,2023-08-02,506,monitor,3249,8000,4751,1,00144,India
607942,2023-08-02,503,mixer,1349,3249,1900,1,00470,India
607942,2023-08-02,501,iphone 15,60000,80000,20000,1,00470,India
607942,2023-08-02,505,oven,18490,24000,5510,1,00470,India
119036,2023-08-02,506,monitor,3249,8000,4751,1,00358,India
119036,2023-08-02,502,iphone 15 pro max,100000,135000,35000,1,00358,India
974034,2023-08-02,506,monitor,3249,8000,4751,1,00203,India
974034,2023-08-02,501,iphone 15,60000,80000,20000,1,00203,India
974034,2023-08-02,507,washing machine,6990,16490,9500,1,00203,India
505500,2023-08-02,506,monitor,3249,8000,4751,1,00331,India
505500,2023-08-02,507,washing machine,6990,16490,9500,1,00331,India
648093,2023-08-02,502,iphone 15 pro max,100000,135000,35000,1,00056,India
648093,2023-08-02,501,iphone 15,60000,80000,20000,1,00056,India
648093,2023-08-02,505,oven,18490,24000,5510,1,00056,India
773536,2023-08-02,507,washing machine,6990,16490,9500,1,00273,India
773536,2023-08-02,505,oven,18490,24000,5510,1,00273,India
773536,2023-08-02,503,mixer,1349,3249,1900,1,00273,India
162242,2023-08-02,502,iphone 15 pro max,100000,135000,35000,1,00070,India
373869,2023-08-02,506,monitor,3249,8000,4751,1,00103,India
373869,2023-08-02,503,mixer,1349,3249,1900,1,00103,India
373869,2023-08-02,504,iron,449,879,430,1,00103,India
373869,2023-08-02,501,iphone 15,60000,80000,20000,1,00103,India
759935,2023-08-02,507,washing machine,6990,16490,9500,1,00148,India
759935,2023-08-02,501,iphone 15,60000,80000,20000,1,00148,India
759935,2023-08-02,502,iphone 15 pro max,100000,135000,35000,1,00148,India
759935,2023-08-02,503,mixer,1349,3249,1900,1,00148,India
819614,2023-08-02,501,iphone 15,60000,80000,20000,1,00316,India
819614,2023-08-02,507,washing machine,6990,16490,9500,1,00316,India
819614,2023-08-02,506,monitor,3249,8000,4751,1,00316,India
819614,2023-08-02,502,iphone 15 pro max,100000,135000,35000,1,00316,India
176914,2023-08-02,506,monitor,3249,8000,4751,1,00089,India
176914,2023-08-02,505,oven,18490,24000,5510,1,00089,India
454275,2023-08-02,506,monitor,3249,8000,4751,1,00323,India
454275,2023-08-02,505,oven,18490,24000,5510,1,00323,India
998663,2023-08-02,504,iron,449,879,430,1,00449,India
998663,2023-08-02,507,washing machine,6990,16490,9500,1,00449,India
859767,2023-08-02,501,iphone 15,60000,80000,20000,1,00261,India
859767,2023-08-02,503,mixer,1349,3249,1900,1,00261,India
626872,2023-08-02,502,iphone 15 pro max,100000,135000,35000,1,00221,India
626872,2023-08-02,503,mixer,1349,3249,1900,1,00221,India
626872,2023-08-02,504,iron,449,879,430,1,00221,India
752712,2023-08-02,504,iron,449,879,430,1,00351,India
752712,2023-08-02,505,oven,18490,24000,5510,1,00351,India
752712,2023-08-02,502,iphone 15 pro max,100000,135000,35000,1,00351,India
905199,2023-08-02,506,monitor,3249,8000,4751,1,00492,India
949364,2023-08-02,502,iphone 15 pro max,100000,135000,35000,1,00410,India
244959,2023-08-02,503,mixer,1349,3249,1900,1,00123,India
244959,2023-08-02,502,iphone 15 pro max,100000,135000,35000,1,00123,India
948260,2023-08-02,507,washing machine,6990,16490,9500,1,00413,India
432858,2023-08-02,505,oven,18490,24000,5510,1,00151,India
432858,2023-08-02,504,iron,449,879,430,1,00151,India
600913,2023-08-02,507,washing machine,6990,16490,9500,1,00061,India
782661,2023-08-02,506,monitor,3249,8000,4751,1,00023,India
782661,2023-08-02,507,washing machine,6990,16490,9500,1,00023,India
131660,2023-08-02,504,iron,449,879,430,1,00184,India
131660,2023-08-02,501,iphone 15,60000,80000,20000,1,00184,India
131660,2023-08-02,506,monitor,3249,8000,4751,1,00184,India
150021,2023-08-02,504,iron,449,879,430,1,00498,India
150021,2023-08-02,505,oven,18490,24000,5510,1,00498,India
150021,2023-08-02,503,mixer,1349,3249,1900,1,00498,India
150021,2023-08-02,501,iphone 15,60000,80000,20000,1,00498,India
829855,2023-08-02,503,mixer,1349,3249,1900,1,00355,India
829855,2023-08-02,505,oven,18490,24000,5510,1,00355,India
972146,2023-08-02,502,iphone 15 pro max,100000,135000,35000,1,00039,India
972146,2023-08-02,504,iron,449,879,430,1,00039,India
283154,2023-08-02,501,iphone 15,60000,80000,20000,1,00224,India
283154,2023-08-02,507,washing machine,6990,16490,9500,1,00224,India
671386,2023-08-02,504,iron,449,879,430,1,00154,India
671386,2023-08-02,501,iphone 15,60000,80000,20000,1,00154,India
671386,2023-08-02,503,mixer,1349,3249,1900,1,00154,India
671386,2023-08-02,502,iphone 15 pro max,100000,135000,35000,1,00154,India
387990,2023-08-02,506,monitor,3249,8000,4751,1,00473,India
387990,2023-08-02,502,iphone 15 pro max,100000,135000,35000,1,00473,India
771444,2023-08-02,502,iphone 15 pro max,100000,135000,35000,1,00022,India
834831,2023-08-02,506,monitor,3249,8000,4751,1,00223,India
491225,2023-08-02,503,mixer,1349,3249,1900,1,00444,India
491225,2023-08-02,502,iphone 15 pro max,100000,135000,35000,1,00444,India
491225,2023-08-02,507,washing machine,6990,16490,9500,1,00444,India
999337,2023-08-02,505,oven,18490,24000,5510,1,00494,India
710733,2023-08-02,501,iphone 15,60000,80000,20000,1,00311,India
710733,2023-08-02,507,washing machine,6990,16490,9500,1,00311,India
710733,2023-08-02,503,mixer,1349,3249,1900,1,00311,India
670121,2023-08-02,505,oven,18490,24000,5510,1,00205,India
670121,2023-08-02,507,washing machine,6990,16490,9500,1,00205,India
741205,2023-08-02,506,monitor,3249,8000,4751,1,00439,India
320112,2023-08-02,502,iphone 15 pro max,100000,135000,35000,1,00420,India
412516,2023-08-02,505,oven,18490,24000,5510,1,00134,India
412516,2023-08-02,506,monitor,3249,8000,4751,1,00134,India
228544,2023-08-02,501,iphone 15,60000,80000,20000,1,00459,India
228544,2023-08-02,502,iphone 15 pro max,100000,135000,35000,1,00459,India
228544,2023-08-02,507,washing machine,6990,16490,9500,1,00459,India
775125,2023-08-02,504,iron,449,879,430,1,00434,India
775125,2023-08-02,505,oven,18490,24000,5510,1,00434,India
775125,2023-08-02,502,iphone 15 pro max,100000,135000,35000,1,00434,India
912706,2023-08-02,507,washing machine,6990,16490,9500,1,00017,India
912706,2023-08-02,501,iphone 15,60000,80000,20000,1,00017,India
501467,2023-08-02,502,iphone 15 pro max,100000,135000,35000,1,00008,India
317103,2023-08-02,504,iron,449,879,430,1,00162,India
317103,2023-08-02,501,iphone 15,60000,80000,20000,1,00162,India
317103,2023-08-02,507,washing machine,6990,16490,9500,1,00162,India
317103,2023-08-02,503,mixer,1349,3249,1900,1,00162,India
205537,2023-08-02,501,iphone 15,60000,80000,20000,1,00415,India
205537,2023-08-02,504,iron,449,879,430,1,00415,India
205537,2023-08-02,506,monitor,3249,8000,4751,1,00415,India
754811,2023-08-02,503,mixer,1349,3249,1900,1,00347,India
754811,2023-08-02,504,iron,449,879,430,1,00347,India
754811,2023-08-02,501,iphone 15,60000,80000,20000,1,00347,India
754811,2023-08-02,502,iphone 15 pro max,100000,135000,35000,1,00347,India
697734,2023-08-02,506,monitor,3249,8000,4751,1,00040,India
697734,2023-08-02,501,iphone 15,60000,80000,20000,1,00040,India
697734,2023-08-02,502,iphone 15 pro max,100000,135000,35000,1,00040,India
697734,2023-08-02,505,oven,18490,24000,5510,1,00040,India
142520,2023-08-02,502,iphone 15 pro max,100000,135000,35000,1,00468,India
142520,2023-08-02,507,washing machine,6990,16490,9500,1,00468,India
142520,2023-08-02,503,mixer,1349,3249,1900,1,00468,India
990592,2023-08-02,504,iron,449,879,430,1,00476,India
990592,2023-08-02,502,iphone 15 pro max,100000,135000,35000,1,00476,India
990592,2023-08-02,505,oven,18490,24000,5510,1,00476,India
973314,2023-08-02,501,iphone 15,60000,80000,20000,1,00157,India
973314,2023-08-02,507,washing machine,6990,16490,9500,1,00157,India
714662,2023-08-02,506,monitor,3249,8000,4751,1,00372,India
714662,2023-08-02,503,mixer,1349,3249,1900,1,00372,India
714662,2023-08-02,502,iphone 15 pro max,100000,135000,35000,1,00372,India
738166,2023-08-02,507,washing machine,6990,16490,9500,1,00280,India
738166,2023-08-02,504,iron,449,879,430,1,00280,India
738166,2023-08-02,502,iphone 15 pro max,100000,135000,35000,1,00280,India
738166,2023-08-02,503,mixer,1349,3249,1900,1,00280,India
738166,2023-08-02,501,iphone 15,60000,80000,20000,1,00280,India
136243,2023-08-02,506,monitor,3249,8000,4751,1,00183,India
664568,2023-08-02,505,oven,18490,24000,5510,1,00491,India
664568,2023-08-02,503,mixer,1349,3249,1900,1,00491,India
664568,2023-08-02,504,iron,449,879,430,1,00491,India
282046,2023-08-02,505,oven,18490,24000,5510,1,00358,India
282046,2023-08-02,501,iphone 15,60000,80000,20000,1,00358,India
282046,2023-08-02,506,monitor,3249,8000,4751,1,00358,India
895650,2023-08-02,503,mixer,1349,3249,1900,1,00272,India
895650,2023-08-02,502,iphone 15 pro max,100000,135000,35000,1,00272,India
895650,2023-08-02,505,oven,18490,24000,5510,1,00272,India
144907,2023-08-02,504,iron,449,879,430,1,00298,India
144907,2023-08-02,502,iphone 15 pro max,100000,135000,35000,1,00298,India
144907,2023-08-02,501,iphone 15,60000,80000,20000,1,00298,India
725976,2023-08-02,501,iphone 15,60000,80000,20000,1,00010,India
725976,2023-08-02,506,monitor,3249,8000,4751,1,00010,India
725976,2023-08-02,505,oven,18490,24000,5510,1,00010,India
725976,2023-08-02,507,washing machine,6990,16490,9500,1,00010,India
856513,2023-08-02,507,washing machine,6990,16490,9500,1,00162,India
805975,2023-08-02,503,mixer,1349,3249,1900,1,00401,India
805975,2023-08-02,507,washing machine,6990,16490,9500,1,00401,India
805975,2023-08-02,501,iphone 15,60000,80000,20000,1,00401,India
805975,2023-08-02,502,iphone 15 pro max,100000,135000,35000,1,00401,India
164111,2023-08-02,505,oven,18490,24000,5510,1,00374,India
164111,2023-08-02,506,monitor,3249,8000,4751,1,00374,India
164111,2023-08-02,504,iron,449,879,430,1,00374,India
444122,2023-08-02,505,oven,18490,24000,5510,1,00288,India
274815,2023-08-02,502,iphone 15 pro max,100000,135000,35000,1,00074,India
274815,2023-08-02,505,oven,18490,24000,5510,1,00074,India
274815,2023-08-02,506,monitor,3249,8000,4751,1,00074,India
769076,2023-08-02,507,washing machine,6990,16490,9500,1,00271,India
769076,2023-08-02,505,oven,18490,24000,5510,1,00271,India
805369,2023-08-02,507,washing machine,6990,16490,9500,1,00152,India
805369,2023-08-02,505,oven,18490,24000,5510,1,00152,India
310721,2023-08-02,507,washing machine,6990,16490,9500,1,00264,India
310721,2023-08-02,503,mixer,1349,3249,1900,1,00264,India
310721,2023-08-02,505,oven,18490,24000,5510,1,00264,India
310721,2023-08-02,506,monitor,3249,8000,4751,1,00264,India
859519,2023-08-02,507,washing machine,6990,16490,9500,1,00284,India
689488,2023-08-02,503,mixer,1349,3249,1900,1,00213,India
689488,2023-08-02,504,iron,449,879,430,1,00213,India
689488,2023-08-02,507,washing machine,6990,16490,9500,1,00213,India
689488,2023-08-02,502,iphone 15 pro max,100000,135000,35000,1,00213,India
638044,2023-08-02,505,oven,18490,24000,5510,1,00123,India
638044,2023-08-02,507,washing machine,6990,16490,9500,1,00123,India
930682,2023-08-02,502,iphone 15 pro max,100000,135000,35000,1,00114,India
740320,2023-08-03,506,monitor,3249,8000,4751,1,00454,India
709192,2023-08-03,501,iphone 15,60000,80000,20000,1,00424,India
709192,2023-08-03,505,oven,18490,24000,5510,1,00424,India
783818,2023-08-03,501,iphone 15,60000,80000,20000,1,00027,India
783818,2023-08-03,502,iphone 15 pro max,100000,135000,35000,1,00027,India
213669,2023-08-03,502,iphone 15 pro max,100000,135000,35000,1,00244,India
213669,2023-08-03,507,washing machine,6990,16490,9500,1,00244,India
213669,2023-08-03,505,oven,18490,24000,5510,1,00244,India
213669,2023-08-03,501,iphone 15,60000,80000,20000,1,00244,India
119354,2023-08-03,501,iphone 15,60000,80000,20000,1,00228,India
119354,2023-08-03,505,oven,18490,24000,5510,1,00228,India
485832,2023-08-03,501,iphone 15,60000,80000,20000,1,00239,India
485832,2023-08-03,503,mixer,1349,3249,1900,1,00239,India
191435,2023-08-03,502,iphone 15 pro max,100000,135000,35000,1,00210,India
191435,2023-08-03,501,iphone 15,60000,80000,20000,1,00210,India
285100,2023-08-03,505,oven,18490,24000,5510,1,00069,India
285100,2023-08-03,504,iron,449,879,430,1,00069,India
206302,2023-08-03,506,monitor,3249,8000,4751,1,00038,India
206302,2023-08-03,504,iron,449,879,430,1,00038,India
306234,2023-08-03,504,iron,449,879,430,1,00234,India
118157,2023-08-03,506,monitor,3249,8000,4751,1,00386,India
118157,2023-08-03,501,iphone 15,60000,80000,20000,1,00386,India
118157,2023-08-03,507,washing machine,6990,16490,9500,1,00386,India
845171,2023-08-03,501,iphone 15,60000,80000,20000,1,00297,India
845171,2023-08-03,503,mixer,1349,3249,1900,1,00297,India
845171,2023-08-03,502,iphone 15 pro max,100000,135000,35000,1,00297,India
403053,2023-08-03,505,oven,18490,24000,5510,1,00011,India
811011,2023-08-03,506,monitor,3249,8000,4751,1,00361,India
811011,2023-08-03,505,oven,18490,24000,5510,1,00361,India
811011,2023-08-03,504,iron,449,879,430,1,00361,India
945170,2023-08-03,505,oven,18490,24000,5510,1,00111,India
945170,2023-08-03,502,iphone 15 pro max,100000,135000,35000,1,00111,India
945170,2023-08-03,506,monitor,3249,8000,4751,1,00111,India
822475,2023-08-03,504,iron,449,879,430,1,00061,India
822475,2023-08-03,506,monitor,3249,8000,4751,1,00061,India
822475,2023-08-03,503,mixer,1349,3249,1900,1,00061,India
225886,2023-08-03,503,mixer,1349,3249,1900,1,00395,India
225886,2023-08-03,501,iphone 15,60000,80000,20000,1,00395,India
225886,2023-08-03,505,oven,18490,24000,5510,1,00395,India
148854,2023-08-03,502,iphone 15 pro max,100000,135000,35000,1,00109,India
148854,2023-08-03,506,monitor,3249,8000,4751,1,00109,India
284194,2023-08-03,501,iphone 15,60000,80000,20000,1,00286,India
527519,2023-08-03,504,iron,449,879,430,1,00282,India
527519,2023-08-03,503,mixer,1349,3249,1900,1,00282,India
527519,2023-08-03,506,monitor,3249,8000,4751,1,00282,India
101243,2023-08-03,501,iphone 15,60000,80000,20000,1,00095,India
101243,2023-08-03,507,washing machine,6990,16490,9500,1,00095,India
909694,2023-08-03,505,oven,18490,24000,5510,1,00499,India
909694,2023-08-03,503,mixer,1349,3249,1900,1,00499,India
909694,2023-08-03,504,iron,449,879,430,1,00499,India
909694,2023-08-03,507,washing machine,6990,16490,9500,1,00499,India
127274,2023-08-03,503,mixer,1349,3249,1900,1,00488,India
127274,2023-08-03,502,iphone 15 pro max,100000,135000,35000,1,00488,India
834604,2023-08-03,506,monitor,3249,8000,4751,1,00330,India
834604,2023-08-03,503,mixer,1349,3249,1900,1,00330,India
834604,2023-08-03,502,iphone 15 pro max,100000,135000,35000,1,00330,India
272254,2023-08-03,501,iphone 15,60000,80000,20000,1,00290,India
261125,2023-08-03,503,mixer,1349,3249,1900,1,00113,India
416690,2023-08-03,502,iphone 15 pro max,100000,135000,35000,1,00479,India
624675,2023-08-03,505,oven,18490,24000,5510,1,00205,India
747545,2023-08-03,506,monitor,3249,8000,4751,1,00477,India
747545,2023-08-03,505,oven,18490,24000,5510,1,00477,India
747545,2023-08-03,503,mixer,1349,3249,1900,1,00477,India
620576,2023-08-03,504,iron,449,879,430,1,00413,India
620576,2023-08-03,503,mixer,1349,3249,1900,1,00413,India
620576,2023-08-03,502,iphone 15 pro max,100000,135000,35000,1,00413,India
460495,2023-08-03,505,oven,18490,24000,5510,1,00259,India
460495,2023-08-03,502,iphone 15 pro max,100000,135000,35000,1,00259,India
460495,2023-08-03,503,mixer,1349,3249,1900,1,00259,India
460495,2023-08-03,501,iphone 15,60000,80000,20000,1,00259,India
432390,2023-08-03,501,iphone 15,60000,80000,20000,1,00263,India
432390,2023-08-03,506,monitor,3249,8000,4751,1,00263,India
432390,2023-08-03,507,washing machine,6990,16490,9500,1,00263,India
387267,2023-08-03,503,mixer,1349,3249,1900,1,00355,India
387267,2023-08-03,504,iron,449,879,430,1,00355,India
388791,2023-08-03,506,monitor,3249,8000,4751,1,00117,India
325537,2023-08-03,507,washing machine,6990,16490,9500,1,00500,India
325537,2023-08-03,502,iphone 15 pro max,100000,135000,35000,1,00500,India
598972,2023-08-03,507,washing machine,6990,16490,9500,1,00034,India
164928,2023-08-03,506,monitor,3249,8000,4751,1,00045,India
164928,2023-08-03,503,mixer,1349,3249,1900,1,00045,India
164928,2023-08-03,507,washing machine,6990,16490,9500,1,00045,India
164928,2023-08-03,502,iphone 15 pro max,100000,135000,35000,1,00045,India
125106,2023-08-03,502,iphone 15 pro max,100000,135000,35000,1,00320,India
125106,2023-08-03,505,oven,18490,24000,5510,1,00320,India
125106,2023-08-03,501,iphone 15,60000,80000,20000,1,00320,India
125106,2023-08-03,504,iron,449,879,430,1,00320,India
125106,2023-08-03,503,mixer,1349,3249,1900,1,00320,India
804776,2023-08-03,501,iphone 15,60000,80000,20000,1,00407,India
804776,2023-08-03,502,iphone 15 pro max,100000,135000,35000,1,00407,India
360714,2023-08-03,502,iphone 15 pro max,100000,135000,35000,1,00247,India
360714,2023-08-03,501,iphone 15,60000,80000,20000,1,00247,India
360714,2023-08-03,506,monitor,3249,8000,4751,1,00247,India
360714,2023-08-03,504,iron,449,879,430,1,00247,India
862167,2023-08-03,503,mixer,1349,3249,1900,1,00330,India
757659,2023-08-03,502,iphone 15 pro max,100000,135000,35000,1,00368,India
757659,2023-08-03,506,monitor,3249,8000,4751,1,00368,India
757659,2023-08-03,505,oven,18490,24000,5510,1,00368,India
484592,2023-08-03,505,oven,18490,24000,5510,1,00019,India
873753,2023-08-03,502,iphone 15 pro max,100000,135000,35000,1,00376,India
873753,2023-08-03,507,washing machine,6990,16490,9500,1,00376,India
873753,2023-08-03,503,mixer,1349,3249,1900,1,00376,India
873753,2023-08-03,501,iphone 15,60000,80000,20000,1,00376,India
507628,2023-08-03,506,monitor,3249,8000,4751,1,00009,India
507628,2023-08-03,502,iphone 15 pro max,100000,135000,35000,1,00009,India
395631,2023-08-03,501,iphone 15,60000,80000,20000,1,00133,India
395631,2023-08-03,506,monitor,3249,8000,4751,1,00133,India
211738,2023-08-03,501,iphone 15,60000,80000,20000,1,00435,India
211738,2023-08-03,505,oven,18490,24000,5510,1,00435,India
211738,2023-08-03,506,monitor,3249,8000,4751,1,00435,India
211738,2023-08-03,503,mixer,1349,3249,1900,1,00435,India
802393,2023-08-03,507,washing machine,6990,16490,9500,1,00372,India
184051,2023-08-03,506,monitor,3249,8000,4751,1,00288,India
184051,2023-08-03,505,oven,18490,24000,5510,1,00288,India
184051,2023-08-03,504,iron,449,879,430,1,00288,India
184051,2023-08-03,501,iphone 15,60000,80000,20000,1,00288,India
236749,2023-08-03,507,washing machine,6990,16490,9500,1,00442,India
236749,2023-08-03,502,iphone 15 pro max,100000,135000,35000,1,00442,India
844982,2023-08-03,507,washing machine,6990,16490,9500,1,00267,India
632183,2023-08-03,506,monitor,3249,8000,4751,1,00430,India
632183,2023-08-03,505,oven,18490,24000,5510,1,00430,India
661613,2023-08-03,506,monitor,3249,8000,4751,1,00381,India
661613,2023-08-03,504,iron,449,879,430,1,00381,India
661613,2023-08-03,503,mixer,1349,3249,1900,1,00381,India
661613,2023-08-03,502,iphone 15 pro max,100000,135000,35000,1,00381,India
661613,2023-08-03,501,iphone 15,60000,80000,20000,1,00381,India
793010,2023-08-03,504,iron,449,879,430,1,00086,India
793010,2023-08-03,506,monitor,3249,8000,4751,1,00086,India
793010,2023-08-03,502,iphone 15 pro max,100000,135000,35000,1,00086,India
535746,2023-08-03,506,monitor,3249,8000,4751,1,00415,India
279468,2023-08-03,506,monitor,3249,8000,4751,1,00484,India
885499,2023-08-03,506,monitor,3249,8000,4751,1,00371,India
885499,2023-08-03,502,iphone 15 pro max,100000,135000,35000,1,00371,India
816169,2023-08-03,505,oven,18490,24000,5510,1,00118,India
816169,2023-08-03,502,iphone 15 pro max,100000,135000,35000,1,00118,India
816169,2023-08-03,504,iron,449,879,430,1,00118,India
473780,2023-08-03,503,mixer,1349,3249,1900,1,00468,India
473780,2023-08-03,504,iron,449,879,430,1,00468,India
473780,2023-08-03,502,iphone 15 pro max,100000,135000,35000,1,00468,India
214249,2023-08-03,501,iphone 15,60000,80000,20000,1,00307,India
214249,2023-08-03,506,monitor,3249,8000,4751,1,00307,India
214249,2023-08-03,502,iphone 15 pro max,100000,135000,35000,1,00307,India
565843,2023-08-03,505,oven,18490,24000,5510,1,00480,India
565843,2023-08-03,507,washing machine,6990,16490,9500,1,00480,India
565843,2023-08-03,502,iphone 15 pro max,100000,135000,35000,1,00480,India
344532,2023-08-03,504,iron,449,879,430,1,00011,India
344532,2023-08-03,505,oven,18490,24000,5510,1,00011,India
344532,2023-08-03,501,iphone 15,60000,80000,20000,1,00011,India
805096,2023-08-03,505,oven,18490,24000,5510,1,00427,India
805096,2023-08-03,502,iphone 15 pro max,100000,135000,35000,1,00427,India
805096,2023-08-03,503,mixer,1349,3249,1900,1,00427,India
805096,2023-08-03,504,iron,449,879,430,1,00427,India
805096,2023-08-03,506,monitor,3249,8000,4751,1,00427,India
149175,2023-08-03,502,iphone 15 pro max,100000,135000,35000,1,00349,India
946606,2023-08-03,504,iron,449,879,430,1,00315,India
946606,2023-08-03,506,monitor,3249,8000,4751,1,00315,India
946606,2023-08-03,503,mixer,1349,3249,1900,1,00315,India
946606,2023-08-03,507,washing machine,6990,16490,9500,1,00315,India
946606,2023-08-03,505,oven,18490,24000,5510,1,00315,India
760636,2023-08-03,503,mixer,1349,3249,1900,1,00005,India
760636,2023-08-03,504,iron,449,879,430,1,00005,India
490998,2023-08-03,501,iphone 15,60000,80000,20000,1,00461,India
877599,2023-08-03,504,iron,449,879,430,1,00148,India
877599,2023-08-03,501,iphone 15,60000,80000,20000,1,00148,India
877599,2023-08-03,503,mixer,1349,3249,1900,1,00148,India
877599,2023-08-03,502,iphone 15 pro max,100000,135000,35000,1,00148,India
680214,2023-08-03,502,iphone 15 pro max,100000,135000,35000,1,00233,India
680214,2023-08-03,506,monitor,3249,8000,4751,1,00233,India
680214,2023-08-03,501,iphone 15,60000,80000,20000,1,00233,India
680214,2023-08-03,507,washing machine,6990,16490,9500,1,00233,India
680214,2023-08-03,505,oven,18490,24000,5510,1,00233,India
807735,2023-08-03,505,oven,18490,24000,5510,1,00340,India
807735,2023-08-03,502,iphone 15 pro max,100000,135000,35000,1,00340,India
793100,2023-08-03,507,washing machine,6990,16490,9500,1,00271,India
793100,2023-08-03,501,iphone 15,60000,80000,20000,1,00271,India
793100,2023-08-03,502,iphone 15 pro max,100000,135000,35000,1,00271,India
793100,2023-08-03,506,monitor,3249,8000,4751,1,00271,India
655721,2023-08-03,505,oven,18490,24000,5510,1,00022,India
425402,2023-08-03,502,iphone 15 pro max,100000,135000,35000,1,00352,India
425402,2023-08-03,504,iron,449,879,430,1,00352,India
425402,2023-08-03,507,washing machine,6990,16490,9500,1,00352,India
425402,2023-08-03,505,oven,18490,24000,5510,1,00352,India
425402,2023-08-03,501,iphone 15,60000,80000,20000,1,00352,India
992961,2023-08-03,505,oven,18490,24000,5510,1,00123,India
786258,2023-08-03,501,iphone 15,60000,80000,20000,1,00436,India
786258,2023-08-03,503,mixer,1349,3249,1900,1,00436,India
786258,2023-08-03,507,washing machine,6990,16490,9500,1,00436,India
786258,2023-08-03,506,monitor,3249,8000,4751,1,00436,India
484898,2023-08-03,504,iron,449,879,430,1,00224,India
484898,2023-08-03,507,washing machine,6990,16490,9500,1,00224,India
484898,2023-08-03,502,iphone 15 pro max,100000,135000,35000,1,00224,India
484898,2023-08-03,505,oven,18490,24000,5510,1,00224,India
552462,2023-08-04,506,monitor,3249,8000,4751,1,00057,India
552462,2023-08-04,501,iphone 15,60000,80000,20000,1,00057,India
867773,2023-08-04,503,mixer,1349,3249,1900,1,00175,India
867773,2023-08-04,501,iphone 15,60000,80000,20000,1,00175,India
911054,2023-08-04,506,monitor,3249,8000,4751,1,00154,India
911054,2023-08-04,505,oven,18490,24000,5510,1,00154,India
911054,2023-08-04,507,washing machine,6990,16490,9500,1,00154,India
382291,2023-08-04,504,iron,449,879,430,1,00118,India
382291,2023-08-04,506,monitor,3249,8000,4751,1,00118,India
382291,2023-08-04,507,washing machine,6990,16490,9500,1,00118,India
382291,2023-08-04,503,mixer,1349,3249,1900,1,00118,India
488954,2023-08-04,502,iphone 15 pro max,100000,135000,35000,1,00164,India
488954,2023-08-04,505,oven,18490,24000,5510,1,00164,India
488954,2023-08-04,504,iron,449,879,430,1,00164,India
924807,2023-08-04,504,iron,449,879,430,1,00004,India
924807,2023-08-04,503,mixer,1349,3249,1900,1,00004,India
269965,2023-08-04,503,mixer,1349,3249,1900,1,00206,India
269965,2023-08-04,506,monitor,3249,8000,4751,1,00206,India
269965,2023-08-04,505,oven,18490,24000,5510,1,00206,India
269965,2023-08-04,502,iphone 15 pro max,100000,135000,35000,1,00206,India
472516,2023-08-04,505,oven,18490,24000,5510,1,00150,India
472516,2023-08-04,501,iphone 15,60000,80000,20000,1,00150,India
994239,2023-08-04,502,iphone 15 pro max,100000,135000,35000,1,00020,India
994239,2023-08-04,505,oven,18490,24000,5510,1,00020,India
994239,2023-08-04,506,monitor,3249,8000,4751,1,00020,India
994239,2023-08-04,504,iron,449,879,430,1,00020,India
681866,2023-08-04,501,iphone 15,60000,80000,20000,1,00019,India
681866,2023-08-04,505,oven,18490,24000,5510,1,00019,India
681866,2023-08-04,503,mixer,1349,3249,1900,1,00019,India
681866,2023-08-04,502,iphone 15 pro max,100000,135000,35000,1,00019,India
356665,2023-08-04,501,iphone 15,60000,80000,20000,1,00414,India
356665,2023-08-04,503,mixer,1349,3249,1900,1,00414,India
356665,2023-08-04,505,oven,18490,24000,5510,1,00414,India
356665,2023-08-04,502,iphone 15 pro max,100000,135000,35000,1,00414,India
356665,2023-08-04,506,monitor,3249,8000,4751,1,00414,India
579698,2023-08-04,501,iphone 15,60000,80000,20000,1,00317,India
689555,2023-08-04,505,oven,18490,24000,5510,1,00122,India
881280,2023-08-04,506,monitor,3249,8000,4751,1,00267,India
780276,2023-08-04,505,oven,18490,24000,5510,1,00359,India
108828,2023-08-04,507,washing machine,6990,16490,9500,1,00330,India
108828,2023-08-04,501,iphone 15,60000,80000,20000,1,00330,India
140205,2023-08-04,503,mixer,1349,3249,1900,1,00406,India
140205,2023-08-04,504,iron,449,879,430,1,00406,India
140205,2023-08-04,501,iphone 15,60000,80000,20000,1,00406,India
621316,2023-08-04,504,iron,449,879,430,1,00025,India
467755,2023-08-04,502,iphone 15 pro max,100000,135000,35000,1,00202,India
523275,2023-08-04,504,iron,449,879,430,1,00028,India
523275,2023-08-04,507,washing machine,6990,16490,9500,1,00028,India
868338,2023-08-04,507,washing machine,6990,16490,9500,1,00031,India
868338,2023-08-04,503,mixer,1349,3249,1900,1,00031,India
522957,2023-08-04,504,iron,449,879,430,1,00404,India
730649,2023-08-04,501,iphone 15,60000,80000,20000,1,00224,India
785952,2023-08-04,505,oven,18490,24000,5510,1,00294,India
290301,2023-08-04,504,iron,449,879,430,1,00021,India
290301,2023-08-04,502,iphone 15 pro max,100000,135000,35000,1,00021,India
729836,2023-08-04,504,iron,449,879,430,1,00002,India
729836,2023-08-04,502,iphone 15 pro max,100000,135000,35000,1,00002,India
729836,2023-08-04,503,mixer,1349,3249,1900,1,00002,India
110846,2023-08-04,503,mixer,1349,3249,1900,1,00411,India
110846,2023-08-04,502,iphone 15 pro max,100000,135000,35000,1,00411,India
110846,2023-08-04,504,iron,449,879,430,1,00411,India
334841,2023-08-04,505,oven,18490,24000,5510,1,00191,India
334841,2023-08-04,501,iphone 15,60000,80000,20000,1,00191,India
334841,2023-08-04,506,monitor,3249,8000,4751,1,00191,India
334841,2023-08-04,502,iphone 15 pro max,100000,135000,35000,1,00191,India
496930,2023-08-04,505,oven,18490,24000,5510,1,00353,India
496930,2023-08-04,502,iphone 15 pro max,100000,135000,35000,1,00353,India
496930,2023-08-04,504,iron,449,879,430,1,00353,India
565021,2023-08-04,505,oven,18490,24000,5510,1,00032,India
565021,2023-08-04,502,iphone 15 pro max,100000,135000,35000,1,00032,India
565021,2023-08-04,501,iphone 15,60000,80000,20000,1,00032,India
333990,2023-08-04,506,monitor,3249,8000,4751,1,00221,India
333990,2023-08-04,504,iron,449,879,430,1,00221,India
333990,2023-08-04,505,oven,18490,24000,5510,1,00221,India
171941,2023-08-04,505,oven,18490,24000,5510,1,00022,India
171941,2023-08-04,502,iphone 15 pro max,100000,135000,35000,1,00022,India
148951,2023-08-04,504,iron,449,879,430,1,00039,India
148951,2023-08-04,506,monitor,3249,8000,4751,1,00039,India
148951,2023-08-04,502,iphone 15 pro max,100000,135000,35000,1,00039,India
839795,2023-08-04,503,mixer,1349,3249,1900,1,00094,India
271642,2023-08-04,502,iphone 15 pro max,100000,135000,35000,1,00332,India
271642,2023-08-04,505,oven,18490,24000,5510,1,00332,India
968494,2023-08-04,501,iphone 15,60000,80000,20000,1,00082,India
968494,2023-08-04,506,monitor,3249,8000,4751,1,00082,India
968494,2023-08-04,503,mixer,1349,3249,1900,1,00082,India
417805,2023-08-04,503,mixer,1349,3249,1900,1,00391,India
996171,2023-08-04,505,oven,18490,24000,5510,1,00193,India
996171,2023-08-04,506,monitor,3249,8000,4751,1,00193,India
996171,2023-08-04,503,mixer,1349,3249,1900,1,00193,India
794122,2023-08-04,507,washing machine,6990,16490,9500,1,00117,India
401652,2023-08-04,502,iphone 15 pro max,100000,135000,35000,1,00083,India
247762,2023-08-04,504,iron,449,879,430,1,00134,India
247762,2023-08-04,502,iphone 15 pro max,100000,135000,35000,1,00134,India
679704,2023-08-04,505,oven,18490,24000,5510,1,00025,India
151706,2023-08-04,502,iphone 15 pro max,100000,135000,35000,1,00085,India
894940,2023-08-04,502,iphone 15 pro max,100000,135000,35000,1,00482,India
594529,2023-08-04,506,monitor,3249,8000,4751,1,00126,India
594529,2023-08-04,504,iron,449,879,430,1,00126,India
594529,2023-08-04,507,washing machine,6990,16490,9500,1,00126,India
495120,2023-08-04,501,iphone 15,60000,80000,20000,1,00462,India
495120,2023-08-04,504,iron,449,879,430,1,00462,India
428437,2023-08-04,506,monitor,3249,8000,4751,1,00310,India
428437,2023-08-04,503,mixer,1349,3249,1900,1,00310,India
582689,2023-08-04,506,monitor,3249,8000,4751,1,00442,India
424154,2023-08-04,506,monitor,3249,8000,4751,1,00314,India
424154,2023-08-04,502,iphone 15 pro max,100000,135000,35000,1,00314,India
424154,2023-08-04,505,oven,18490,24000,5510,1,00314,India
424154,2023-08-04,501,iphone 15,60000,80000,20000,1,00314,India
394725,2023-08-04,505,oven,18490,24000,5510,1,00024,India
394725,2023-08-04,504,iron,449,879,430,1,00024,India
394725,2023-08-04,506,monitor,3249,8000,4751,1,00024,India
500712,2023-08-04,502,iphone 15 pro max,100000,135000,35000,1,00270,India
500712,2023-08-04,504,iron,449,879,430,1,00270,India
500712,2023-08-04,505,oven,18490,24000,5510,1,00270,India
887453,2023-08-04,501,iphone 15,60000,80000,20000,1,00256,India
887453,2023-08-04,506,monitor,3249,8000,4751,1,00256,India
887453,2023-08-04,503,mixer,1349,3249,1900,1,00256,India
828228,2023-08-04,507,washing machine,6990,16490,9500,1,00106,India
596443,2023-08-04,502,iphone 15 pro max,100000,135000,35000,1,00327,India
596443,2023-08-04,506,monitor,3249,8000,4751,1,00327,India
596443,2023-08-04,501,iphone 15,60000,80000,20000,1,00327,India
596443,2023-08-04,504,iron,449,879,430,1,00327,India
596443,2023-08-04,507,washing machine,6990,16490,9500,1,00327,India
118306,2023-08-05,505,oven,18490,24000,5510,1,00392,India
118306,2023-08-05,504,iron,449,879,430,1,00392,India
118306,2023-08-05,506,monitor,3249,8000,4751,1,00392,India
118306,2023-08-05,501,iphone 15,60000,80000,20000,1,00392,India
245012,2023-08-05,507,washing machine,6990,16490,9500,1,00400,India
245012,2023-08-05,505,oven,18490,24000,5510,1,00400,India
932683,2023-08-05,505,oven,18490,24000,5510,1,00053,India
199484,2023-08-05,504,iron,449,879,430,1,00494,India
369945,2023-08-05,502,iphone 15 pro max,100000,135000,35000,1,00311,India
369945,2023-08-05,507,washing machine,6990,16490,9500,1,00311,India
369945,2023-08-05,503,mixer,1349,3249,1900,1,00311,India
369945,2023-08-05,504,iron,449,879,430,1,00311,India
495982,2023-08-05,504,iron,449,879,430,1,00378,India
495982,2023-08-05,505,oven,18490,24000,5510,1,00378,India
495982,2023-08-05,506,monitor,3249,8000,4751,1,00378,India
988941,2023-08-05,504,iron,449,879,430,1,00397,India
988941,2023-08-05,502,iphone 15 pro max,100000,135000,35000,1,00397,India
988941,2023-08-05,507,washing machine,6990,16490,9500,1,00397,India
988941,2023-08-05,506,monitor,3249,8000,4751,1,00397,India
815234,2023-08-05,507,washing machine,6990,16490,9500,1,00162,India
815234,2023-08-05,501,iphone 15,60000,80000,20000,1,00162,India
287266,2023-08-05,506,monitor,3249,8000,4751,1,00335,India
287266,2023-08-05,502,iphone 15 pro max,100000,135000,35000,1,00335,India
301123,2023-08-05,503,mixer,1349,3249,1900,1,00401,India
301123,2023-08-05,504,iron,449,879,430,1,00401,India
301123,2023-08-05,501,iphone 15,60000,80000,20000,1,00401,India
641674,2023-08-05,507,washing machine,6990,16490,9500,1,00345,India
715172,2023-08-05,506,monitor,3249,8000,4751,1,00418,India
715172,2023-08-05,502,iphone 15 pro max,100000,135000,35000,1,00418,India
262682,2023-08-05,504,iron,449,879,430,1,00254,India
262682,2023-08-05,501,iphone 15,60000,80000,20000,1,00254,India
262682,2023-08-05,506,monitor,3249,8000,4751,1,00254,India
182721,2023-08-05,505,oven,18490,24000,5510,1,00200,India
895981,2023-08-05,505,oven,18490,24000,5510,1,00120,India
895981,2023-08-05,503,mixer,1349,3249,1900,1,00120,India
895981,2023-08-05,504,iron,449,879,430,1,00120,India
895981,2023-08-05,506,monitor,3249,8000,4751,1,00120,India
527688,2023-08-05,503,mixer,1349,3249,1900,1,00227,India
799498,2023-08-05,505,oven,18490,24000,5510,1,00362,India
799498,2023-08-05,502,iphone 15 pro max,100000,135000,35000,1,00362,India
799498,2023-08-05,504,iron,449,879,430,1,00362,India
882902,2023-08-05,502,iphone 15 pro max,100000,135000,35000,1,00087,India
882902,2023-08-05,501,iphone 15,60000,80000,20000,1,00087,India
951706,2023-08-05,502,iphone 15 pro max,100000,135000,35000,1,00053,India
951706,2023-08-05,503,mixer,1349,3249,1900,1,00053,India
627321,2023-08-05,505,oven,18490,24000,5510,1,00107,India
627321,2023-08-05,507,washing machine,6990,16490,9500,1,00107,India
627321,2023-08-05,502,iphone 15 pro max,100000,135000,35000,1,00107,India
627321,2023-08-05,506,monitor,3249,8000,4751,1,00107,India
627321,2023-08-05,503,mixer,1349,3249,1900,1,00107,India
583512,2023-08-05,503,mixer,1349,3249,1900,1,00479,India
583512,2023-08-05,505,oven,18490,24000,5510,1,00479,India
793742,2023-08-05,505,oven,18490,24000,5510,1,00479,India
546283,2023-08-05,507,washing machine,6990,16490,9500,1,00384,India
546283,2023-08-05,504,iron,449,879,430,1,00384,India
546283,2023-08-05,505,oven,18490,24000,5510,1,00384,India
298234,2023-08-05,505,oven,18490,24000,5510,1,00225,India
370772,2023-08-05,503,mixer,1349,3249,1900,1,00113,India
370772,2023-08-05,506,monitor,3249,8000,4751,1,00113,India
370772,2023-08-05,502,iphone 15 pro max,100000,135000,35000,1,00113,India
370772,2023-08-05,505,oven,18490,24000,5510,1,00113,India
829748,2023-08-05,501,iphone 15,60000,80000,20000,1,00034,India
829748,2023-08-05,507,washing machine,6990,16490,9500,1,00034,India
829748,2023-08-05,506,monitor,3249,8000,4751,1,00034,India
188038,2023-08-05,505,oven,18490,24000,5510,1,00300,India
188038,2023-08-05,503,mixer,1349,3249,1900,1,00300,India
188038,2023-08-05,506,monitor,3249,8000,4751,1,00300,India
229433,2023-08-05,503,mixer,1349,3249,1900,1,00066,India
229433,2023-08-05,502,iphone 15 pro max,100000,135000,35000,1,00066,India
958340,2023-08-05,504,iron,449,879,430,1,00098,India
766262,2023-08-05,507,washing machine,6990,16490,9500,1,00016,India
766262,2023-08-05,503,mixer,1349,3249,1900,1,00016,India
622462,2023-08-05,506,monitor,3249,8000,4751,1,00306,India
622462,2023-08-05,502,iphone 15 pro max,100000,135000,35000,1,00306,India
158525,2023-08-05,507,washing machine,6990,16490,9500,1,00054,India
158525,2023-08-05,502,iphone 15 pro max,100000,135000,35000,1,00054,India
158525,2023-08-05,503,mixer,1349,3249,1900,1,00054,India
797316,2023-08-05,502,iphone 15 pro max,100000,135000,35000,1,00156,India
797316,2023-08-05,503,mixer,1349,3249,1900,1,00156,India
797316,2023-08-05,501,iphone 15,60000,80000,20000,1,00156,India
435531,2023-08-05,502,iphone 15 pro max,100000,135000,35000,1,00308,India
435531,2023-08-05,507,washing machine,6990,16490,9500,1,00308,India
435531,2023-08-05,506,monitor,3249,8000,4751,1,00308,India
592640,2023-08-05,504,iron,449,879,430,1,00308,India
439626,2023-08-05,504,iron,449,879,430,1,00497,India
439626,2023-08-05,506,monitor,3249,8000,4751,1,00497,India
209404,2023-08-05,507,washing machine,6990,16490,9500,1,00312,India
209404,2023-08-05,503,mixer,1349,3249,1900,1,00312,India
936175,2023-08-05,502,iphone 15 pro max,100000,135000,35000,1,00307,India
161781,2023-08-05,504,iron,449,879,430,1,00013,India
577890,2023-08-05,504,iron,449,879,430,1,00070,India
577890,2023-08-05,507,washing machine,6990,16490,9500,1,00070,India
577890,2023-08-05,505,oven,18490,24000,5510,1,00070,India
577890,2023-08-05,503,mixer,1349,3249,1900,1,00070,India
525137,2023-08-05,502,iphone 15 pro max,100000,135000,35000,1,00151,India
525137,2023-08-05,505,oven,18490,24000,5510,1,00151,India
385131,2023-08-05,503,mixer,1349,3249,1900,1,00001,India
202461,2023-08-05,504,iron,449,879,430,1,00051,India
391124,2023-08-05,501,iphone 15,60000,80000,20000,1,00072,India
391124,2023-08-05,502,iphone 15 pro max,100000,135000,35000,1,00072,India
850364,2023-08-05,506,monitor,3249,8000,4751,1,00465,India
850364,2023-08-05,505,oven,18490,24000,5510,1,00465,India
850364,2023-08-05,504,iron,449,879,430,1,00465,India
355955,2023-08-05,503,mixer,1349,3249,1900,1,00293,India
355955,2023-08-05,502,iphone 15 pro max,100000,135000,35000,1,00293,India
834379,2023-08-05,506,monitor,3249,8000,4751,1,00102,India
834379,2023-08-05,502,iphone 15 pro max,100000,135000,35000,1,00102,India
834379,2023-08-05,507,washing machine,6990,16490,9500,1,00102,India
526878,2023-08-05,505,oven,18490,24000,5510,1,00060,India
777789,2023-08-05,504,iron,449,879,430,1,00258,India
777789,2023-08-05,501,iphone 15,60000,80000,20000,1,00258,India
777789,2023-08-05,503,mixer,1349,3249,1900,1,00258,India
393395,2023-08-05,507,washing machine,6990,16490,9500,1,00477,India
393395,2023-08-05,505,oven,18490,24000,5510,1,00477,India
247116,2023-08-05,504,iron,449,879,430,1,00068,India
247116,2023-08-05,505,oven,18490,24000,5510,1,00068,India
247116,2023-08-05,501,iphone 15,60000,80000,20000,1,00068,India
247116,2023-08-05,507,washing machine,6990,16490,9500,1,00068,India
247116,2023-08-05,503,mixer,1349,3249,1900,1,00068,India
918043,2023-08-05,504,iron,449,879,430,1,00067,India
918043,2023-08-05,507,washing machine,6990,16490,9500,1,00067,India
910688,2023-08-06,501,iphone 15,60000,80000,20000,1,00414,India
910688,2023-08-06,503,mixer,1349,3249,1900,1,00414,India
910688,2023-08-06,507,washing machine,6990,16490,9500,1,00414,India
548042,2023-08-06,502,iphone 15 pro max,100000,135000,35000,1,00175,India
548042,2023-08-06,505,oven,18490,24000,5510,1,00175,India
100845,2023-08-06,504,iron,449,879,430,1,00245,India
100845,2023-08-06,507,washing machine,6990,16490,9500,1,00245,India
546378,2023-08-06,505,oven,18490,24000,5510,1,00129,India
546378,2023-08-06,502,iphone 15 pro max,100000,135000,35000,1,00129,India
250633,2023-08-06,502,iphone 15 pro max,100000,135000,35000,1,00267,India
250633,2023-08-06,504,iron,449,879,430,1,00267,India
250940,2023-08-06,504,iron,449,879,430,1,00067,India
250940,2023-08-06,507,washing machine,6990,16490,9500,1,00067,India
250940,2023-08-06,505,oven,18490,24000,5510,1,00067,India
888422,2023-08-06,505,oven,18490,24000,5510,1,00336,India
888422,2023-08-06,506,monitor,3249,8000,4751,1,00336,India
499340,2023-08-06,504,iron,449,879,430,1,00301,India
499340,2023-08-06,505,oven,18490,24000,5510,1,00301,India
499340,2023-08-06,502,iphone 15 pro max,100000,135000,35000,1,00301,India
392447,2023-08-06,503,mixer,1349,3249,1900,1,00485,India
392447,2023-08-06,504,iron,449,879,430,1,00485,India
392447,2023-08-06,501,iphone 15,60000,80000,20000,1,00485,India
392447,2023-08-06,506,monitor,3249,8000,4751,1,00485,India
644182,2023-08-06,505,oven,18490,24000,5510,1,00048,India
644182,2023-08-06,502,iphone 15 pro max,100000,135000,35000,1,00048,India
644182,2023-08-06,501,iphone 15,60000,80000,20000,1,00048,India
312836,2023-08-06,505,oven,18490,24000,5510,1,00137,India
312836,2023-08-06,503,mixer,1349,3249,1900,1,00137,India
312836,2023-08-06,507,washing machine,6990,16490,9500,1,00137,India
312836,2023-08-06,502,iphone 15 pro max,100000,135000,35000,1,00137,India
845807,2023-08-06,504,iron,449,879,430,1,00442,India
845807,2023-08-06,506,monitor,3249,8000,4751,1,00442,India
551690,2023-08-06,507,washing machine,6990,16490,9500,1,00315,India
551690,2023-08-06,501,iphone 15,60000,80000,20000,1,00315,India
551690,2023-08-06,506,monitor,3249,8000,4751,1,00315,India
744745,2023-08-06,504,iron,449,879,430,1,00108,India
744745,2023-08-06,506,monitor,3249,8000,4751,1,00108,India
744745,2023-08-06,501,iphone 15,60000,80000,20000,1,00108,India
199537,2023-08-06,505,oven,18490,24000,5510,1,00013,India
199537,2023-08-06,503,mixer,1349,3249,1900,1,00013,India
199537,2023-08-06,506,monitor,3249,8000,4751,1,00013,India
600919,2023-08-06,507,washing machine,6990,16490,9500,1,00262,India
600919,2023-08-06,504,iron,449,879,430,1,00262,India
600919,2023-08-06,502,iphone 15 pro max,100000,135000,35000,1,00262,India
563931,2023-08-06,501,iphone 15,60000,80000,20000,1,00312,India
563931,2023-08-06,504,iron,449,879,430,1,00312,India
816416,2023-08-06,503,mixer,1349,3249,1900,1,00322,India
816416,2023-08-06,502,iphone 15 pro max,100000,135000,35000,1,00322,India
216480,2023-08-06,501,iphone 15,60000,80000,20000,1,00032,India
216480,2023-08-06,506,monitor,3249,8000,4751,1,00032,India
752651,2023-08-06,504,iron,449,879,430,1,00213,India
752651,2023-08-06,506,monitor,3249,8000,4751,1,00213,India
752651,2023-08-06,507,washing machine,6990,16490,9500,1,00213,India
752651,2023-08-06,502,iphone 15 pro max,100000,135000,35000,1,00213,India
677789,2023-08-06,504,iron,449,879,430,1,00326,India
677789,2023-08-06,502,iphone 15 pro max,100000,135000,35000,1,00326,India
677789,2023-08-06,501,iphone 15,60000,80000,20000,1,00326,India
677789,2023-08-06,503,mixer,1349,3249,1900,1,00326,India
510987,2023-08-06,505,oven,18490,24000,5510,1,00018,India
510987,2023-08-06,507,washing machine,6990,16490,9500,1,00018,India
510987,2023-08-06,502,iphone 15 pro max,100000,135000,35000,1,00018,India
510987,2023-08-06,506,monitor,3249,8000,4751,1,00018,India
251605,2023-08-06,503,mixer,1349,3249,1900,1,00145,India
251605,2023-08-06,506,monitor,3249,8000,4751,1,00145,India
251605,2023-08-06,507,washing machine,6990,16490,9500,1,00145,India
251605,2023-08-06,502,iphone 15 pro max,100000,135000,35000,1,00145,India
223633,2023-08-06,502,iphone 15 pro max,100000,135000,35000,1,00217,India
223633,2023-08-06,501,iphone 15,60000,80000,20000,1,00217,India
448259,2023-08-06,503,mixer,1349,3249,1900,1,00489,India
448259,2023-08-06,501,iphone 15,60000,80000,20000,1,00489,India
448259,2023-08-06,506,monitor,3249,8000,4751,1,00489,India
448259,2023-08-06,504,iron,449,879,430,1,00489,India
931943,2023-08-06,506,monitor,3249,8000,4751,1,00477,India
931943,2023-08-06,505,oven,18490,24000,5510,1,00477,India
856546,2023-08-06,502,iphone 15 pro max,100000,135000,35000,1,00233,India
856546,2023-08-06,505,oven,18490,24000,5510,1,00233,India
856546,2023-08-06,503,mixer,1349,3249,1900,1,00233,India
554275,2023-08-06,504,iron,449,879,430,1,00128,India
554275,2023-08-06,507,washing machine,6990,16490,9500,1,00128,India
155622,2023-08-06,507,washing machine,6990,16490,9500,1,00154,India
818956,2023-08-06,507,washing machine,6990,16490,9500,1,00163,India
818956,2023-08-06,505,oven,18490,24000,5510,1,00163,India
818956,2023-08-06,501,iphone 15,60000,80000,20000,1,00163,India
818956,2023-08-06,504,iron,449,879,430,1,00163,India
106629,2023-08-06,502,iphone 15 pro max,100000,135000,35000,1,00055,India
106629,2023-08-06,503,mixer,1349,3249,1900,1,00055,India
106629,2023-08-06,507,washing machine,6990,16490,9500,1,00055,India
106629,2023-08-06,506,monitor,3249,8000,4751,1,00055,India
527408,2023-08-06,502,iphone 15 pro max,100000,135000,35000,1,00391,India
768946,2023-08-06,505,oven,18490,24000,5510,1,00366,India
768946,2023-08-06,501,iphone 15,60000,80000,20000,1,00366,India
768946,2023-08-06,504,iron,449,879,430,1,00366,India
220679,2023-08-06,506,monitor,3249,8000,4751,1,00319,India
220679,2023-08-06,504,iron,449,879,430,1,00319,India
673027,2023-08-06,502,iphone 15 pro max,100000,135000,35000,1,00471,India
673027,2023-08-06,504,iron,449,879,430,1,00471,India
430924,2023-08-06,504,iron,449,879,430,1,00113,India
430924,2023-08-06,502,iphone 15 pro max,100000,135000,35000,1,00113,India
430924,2023-08-06,503,mixer,1349,3249,1900,1,00113,India
430924,2023-08-06,507,washing machine,6990,16490,9500,1,00113,India
366919,2023-08-06,505,oven,18490,24000,5510,1,00373,India
366919,2023-08-06,501,iphone 15,60000,80000,20000,1,00373,India
877871,2023-08-06,503,mixer,1349,3249,1900,1,00195,India
921168,2023-08-06,505,oven,18490,24000,5510,1,00476,India
921168,2023-08-06,501,iphone 15,60000,80000,20000,1,00476,India
878241,2023-08-06,507,washing machine,6990,16490,9500,1,00383,India
878241,2023-08-06,504,iron,449,879,430,1,00383,India
878241,2023-08-06,503,mixer,1349,3249,1900,1,00383,India
103981,2023-08-06,505,oven,18490,24000,5510,1,00057,India
249280,2023-08-06,506,monitor,3249,8000,4751,1,00494,India
249280,2023-08-06,502,iphone 15 pro max,100000,135000,35000,1,00494,India
249280,2023-08-06,503,mixer,1349,3249,1900,1,00494,India
996925,2023-08-06,507,washing machine,6990,16490,9500,1,00002,India
996925,2023-08-06,503,mixer,1349,3249,1900,1,00002,India
985702,2023-08-06,503,mixer,1349,3249,1900,1,00475,India
807221,2023-08-06,502,iphone 15 pro max,100000,135000,35000,1,00302,India
807221,2023-08-06,507,washing machine,6990,16490,9500,1,00302,India
807221,2023-08-06,504,iron,449,879,430,1,00302,India
807221,2023-08-06,503,mixer,1349,3249,1900,1,00302,India
465487,2023-08-06,501,iphone 15,60000,80000,20000,1,00239,India
465487,2023-08-06,502,iphone 15 pro max,100000,135000,35000,1,00239,India
465487,2023-08-06,503,mixer,1349,3249,1900,1,00239,India
807675,2023-08-06,505,oven,18490,24000,5510,1,00124,India
749042,2023-08-06,502,iphone 15 pro max,100000,135000,35000,1,00105,India
951846,2023-08-06,505,oven,18490,24000,5510,1,00375,India
836766,2023-08-06,501,iphone 15,60000,80000,20000,1,00441,India
836766,2023-08-06,505,oven,18490,24000,5510,1,00441,India
180413,2023-08-06,507,washing machine,6990,16490,9500,1,00079,India
180413,2023-08-06,503,mixer,1349,3249,1900,1,00079,India
228991,2023-08-06,502,iphone 15 pro max,100000,135000,35000,1,00409,India
451147,2023-08-06,503,mixer,1349,3249,1900,1,00101,India
451147,2023-08-06,505,oven,18490,24000,5510,1,00101,India
373321,2023-08-06,504,iron,449,879,430,1,00036,India
373321,2023-08-06,505,oven,18490,24000,5510,1,00036,India
373321,2023-08-06,506,monitor,3249,8000,4751,1,00036,India
848829,2023-08-06,501,iphone 15,60000,80000,20000,1,00291,India
555029,2023-08-06,507,washing machine,6990,16490,9500,1,00086,India
555029,2023-08-06,504,iron,449,879,430,1,00086,India
355855,2023-08-06,506,monitor,3249,8000,4751,1,00486,India
417946,2023-08-06,504,iron,449,879,430,1,00014,India
509892,2023-08-06,507,washing machine,6990,16490,9500,1,00048,India
509892,2023-08-06,502,iphone 15 pro max,100000,135000,35000,1,00048,India
509892,2023-08-06,503,mixer,1349,3249,1900,1,00048,India
509892,2023-08-06,505,oven,18490,24000,5510,1,00048,India
910713,2023-08-06,501,iphone 15,60000,80000,20000,1,00347,India
910713,2023-08-06,507,washing machine,6990,16490,9500,1,00347,India
910713,2023-08-06,506,monitor,3249,8000,4751,1,00347,India
910713,2023-08-06,502,iphone 15 pro max,100000,135000,35000,1,00347,India
910713,2023-08-06,505,oven,18490,24000,5510,1,00347,India
707700,2023-08-06,501,iphone 15,60000,80000,20000,1,00240,India
276402,2023-08-06,505,oven,18490,24000,5510,1,00340,India
276402,2023-08-06,507,washing machine,6990,16490,9500,1,00340,India
276402,2023-08-06,503,mixer,1349,3249,1900,1,00340,India
276402,2023-08-06,504,iron,449,879,430,1,00340,India
461662,2023-08-06,504,iron,449,879,430,1,00124,India
461662,2023-08-06,502,iphone 15 pro max,100000,135000,35000,1,00124,India
461662,2023-08-06,503,mixer,1349,3249,1900,1,00124,India
461662,2023-08-06,505,oven,18490,24000,5510,1,00124,India
619660,2023-08-06,507,washing machine,6990,16490,9500,1,00307,India
619660,2023-08-06,505,oven,18490,24000,5510,1,00307,India
275297,2023-08-06,505,oven,18490,24000,5510,1,00318,India
275297,2023-08-06,504,iron,449,879,430,1,00318,India
275297,2023-08-06,501,iphone 15,60000,80000,20000,1,00318,India
558208,2023-08-06,502,iphone 15 pro max,100000,135000,35000,1,00099,India
558208,2023-08-06,507,washing machine,6990,16490,9500,1,00099,India
282095,2023-08-06,505,oven,18490,24000,5510,1,00448,India
282095,2023-08-06,502,iphone 15 pro max,100000,135000,35000,1,00448,India
561462,2023-08-06,503,mixer,1349,3249,1900,1,00057,India
561462,2023-08-06,507,washing machine,6990,16490,9500,1,00057,India
561462,2023-08-06,501,iphone 15,60000,80000,20000,1,00057,India
479025,2023-08-06,506,monitor,3249,8000,4751,1,00235,India
479025,2023-08-06,504,iron,449,879,430,1,00235,India
479025,2023-08-06,501,iphone 15,60000,80000,20000,1,00235,India
318051,2023-08-06,505,oven,18490,24000,5510,1,00231,India
318051,2023-08-06,501,iphone 15,60000,80000,20000,1,00231,India
318051,2023-08-06,507,washing machine,6990,16490,9500,1,00231,India
318051,2023-08-06,502,iphone 15 pro max,100000,135000,35000,1,00231,India
562455,2023-08-06,503,mixer,1349,3249,1900,1,00089,India
562455,2023-08-06,507,washing machine,6990,16490,9500,1,00089,India
562455,2023-08-06,505,oven,18490,24000,5510,1,00089,India
562455,2023-08-06,504,iron,449,879,430,1,00089,India
473599,2023-08-06,506,monitor,3249,8000,4751,1,00278,India
473599,2023-08-06,501,iphone 15,60000,80000,20000,1,00278,India
473599,2023-08-06,505,oven,18490,24000,5510,1,00278,India
537274,2023-08-06,505,oven,18490,24000,5510,1,00462,India
537274,2023-08-06,501,iphone 15,60000,80000,20000,1,00462,India
537274,2023-08-06,502,iphone 15 pro max,100000,135000,35000,1,00462,India
789657,2023-08-06,502,iphone 15 pro max,100000,135000,35000,1,00324,India
285460,2023-08-06,507,washing machine,6990,16490,9500,1,00179,India
576376,2023-08-06,506,monitor,3249,8000,4751,1,00094,India
576376,2023-08-06,504,iron,449,879,430,1,00094,India
576376,2023-08-06,501,iphone 15,60000,80000,20000,1,00094,India
133349,2023-08-06,503,mixer,1349,3249,1900,1,00412,India
133349,2023-08-06,504,iron,449,879,430,1,00412,India
133349,2023-08-06,507,washing machine,6990,16490,9500,1,00412,India
477092,2023-08-06,506,monitor,3249,8000,4751,1,00483,India
477092,2023-08-06,502,iphone 15 pro max,100000,135000,35000,1,00483,India
477092,2023-08-06,507,washing machine,6990,16490,9500,1,00483,India
426834,2023-08-06,504,iron,449,879,430,1,00275,India
426834,2023-08-06,502,iphone 15 pro max,100000,135000,35000,1,00275,India
426834,2023-08-06,501,iphone 15,60000,80000,20000,1,00275,India
457380,2023-08-06,503,mixer,1349,3249,1900,1,00431,India
726531,2023-08-06,502,iphone 15 pro max,100000,135000,35000,1,00270,India
726531,2023-08-06,503,mixer,1349,3249,1900,1,00270,India
726531,2023-08-06,506,monitor,3249,8000,4751,1,00270,India
599053,2023-08-06,507,washing machine,6990,16490,9500,1,00166,India
418105,2023-08-06,503,mixer,1349,3249,1900,1,00085,India
418105,2023-08-06,502,iphone 15 pro max,100000,135000,35000,1,00085,India
518871,2023-08-06,502,iphone 15 pro max,100000,135000,35000,1,00076,India
518871,2023-08-06,507,washing machine,6990,16490,9500,1,00076,India
486833,2023-08-07,506,monitor,3249,8000,4751,1,00136,India
486833,2023-08-07,503,mixer,1349,3249,1900,1,00136,India
486833,2023-08-07,502,iphone 15 pro max,100000,135000,35000,1,00136,India
723555,2023-08-07,507,washing machine,6990,16490,9500,1,00426,India
723555,2023-08-07,505,oven,18490,24000,5510,1,00426,India
723555,2023-08-07,502,iphone 15 pro max,100000,135000,35000,1,00426,India
723555,2023-08-07,503,mixer,1349,3249,1900,1,00426,India
671818,2023-08-07,505,oven,18490,24000,5510,1,00186,India
671818,2023-08-07,507,washing machine,6990,16490,9500,1,00186,India
415049,2023-08-07,506,monitor,3249,8000,4751,1,00384,India
415049,2023-08-07,502,iphone 15 pro max,100000,135000,35000,1,00384,India
415049,2023-08-07,501,iphone 15,60000,80000,20000,1,00384,India
817339,2023-08-07,505,oven,18490,24000,5510,1,00263,India
817339,2023-08-07,504,iron,449,879,430,1,00263,India
230019,2023-08-07,502,iphone 15 pro max,100000,135000,35000,1,00121,India
197795,2023-08-07,501,iphone 15,60000,80000,20000,1,00083,India
197795,2023-08-07,506,monitor,3249,8000,4751,1,00083,India
197795,2023-08-07,504,iron,449,879,430,1,00083,India
579177,2023-08-07,505,oven,18490,24000,5510,1,00258,India
579177,2023-08-07,503,mixer,1349,3249,1900,1,00258,India
469374,2023-08-07,503,mixer,1349,3249,1900,1,00396,India
469374,2023-08-07,502,iphone 15 pro max,100000,135000,35000,1,00396,India
469374,2023-08-07,507,washing machine,6990,16490,9500,1,00396,India
825285,2023-08-07,502,iphone 15 pro max,100000,135000,35000,1,00412,India
577647,2023-08-07,503,mixer,1349,3249,1900,1,00301,India
577647,2023-08-07,501,iphone 15,60000,80000,20000,1,00301,India
577647,2023-08-07,502,iphone 15 pro max,100000,135000,35000,1,00301,India
334293,2023-08-07,506,monitor,3249,8000,4751,1,00025,India
334293,2023-08-07,504,iron,449,879,430,1,00025,India
695368,2023-08-07,501,iphone 15,60000,80000,20000,1,00408,India
695368,2023-08-07,502,iphone 15 pro max,100000,135000,35000,1,00408,India
695368,2023-08-07,505,oven,18490,24000,5510,1,00408,India
610965,2023-08-07,505,oven,18490,24000,5510,1,00265,India
610965,2023-08-07,504,iron,449,879,430,1,00265,India
610965,2023-08-07,503,mixer,1349,3249,1900,1,00265,India
610965,2023-08-07,506,monitor,3249,8000,4751,1,00265,India
766199,2023-08-07,502,iphone 15 pro max,100000,135000,35000,1,00172,India
766199,2023-08-07,501,iphone 15,60000,80000,20000,1,00172,India
766199,2023-08-07,504,iron,449,879,430,1,00172,India
766199,2023-08-07,505,oven,18490,24000,5510,1,00172,India
766199,2023-08-07,506,monitor,3249,8000,4751,1,00172,India
386717,2023-08-07,506,monitor,3249,8000,4751,1,00029,India
386717,2023-08-07,505,oven,18490,24000,5510,1,00029,India
656336,2023-08-07,503,mixer,1349,3249,1900,1,00199,India
562837,2023-08-07,504,iron,449,879,430,1,00088,India
562837,2023-08-07,501,iphone 15,60000,80000,20000,1,00088,India
562837,2023-08-07,503,mixer,1349,3249,1900,1,00088,India
544015,2023-08-07,505,oven,18490,24000,5510,1,00230,India
444819,2023-08-07,506,monitor,3249,8000,4751,1,00424,India
444819,2023-08-07,502,iphone 15 pro max,100000,135000,35000,1,00424,India
444819,2023-08-07,507,washing machine,6990,16490,9500,1,00424,India
985666,2023-08-07,505,oven,18490,24000,5510,1,00364,India
710996,2023-08-07,507,washing machine,6990,16490,9500,1,00357,India
597747,2023-08-07,502,iphone 15 pro max,100000,135000,35000,1,00300,India
597747,2023-08-07,503,mixer,1349,3249,1900,1,00300,India
597747,2023-08-07,507,washing machine,6990,16490,9500,1,00300,India
698954,2023-08-07,501,iphone 15,60000,80000,20000,1,00410,India
698954,2023-08-07,503,mixer,1349,3249,1900,1,00410,India
698954,2023-08-07,506,monitor,3249,8000,4751,1,00410,India
698954,2023-08-07,505,oven,18490,24000,5510,1,00410,India
496301,2023-08-07,502,iphone 15 pro max,100000,135000,35000,1,00075,India
496301,2023-08-07,501,iphone 15,60000,80000,20000,1,00075,India
824745,2023-08-07,503,mixer,1349,3249,1900,1,00054,India
824745,2023-08-07,504,iron,449,879,430,1,00054,India
824745,2023-08-07,502,iphone 15 pro max,100000,135000,35000,1,00054,India
792812,2023-08-07,505,oven,18490,24000,5510,1,00446,India
792812,2023-08-07,504,iron,449,879,430,1,00446,India
676429,2023-08-07,507,washing machine,6990,16490,9500,1,00302,India
676429,2023-08-07,503,mixer,1349,3249,1900,1,00302,India
676429,2023-08-07,506,monitor,3249,8000,4751,1,00302,India
941963,2023-08-07,502,iphone 15 pro max,100000,135000,35000,1,00270,India
941963,2023-08-07,501,iphone 15,60000,80000,20000,1,00270,India
941963,2023-08-07,504,iron,449,879,430,1,00270,India
208122,2023-08-07,506,monitor,3249,8000,4751,1,00350,India
208122,2023-08-07,504,iron,449,879,430,1,00350,India
208122,2023-08-07,503,mixer,1349,3249,1900,1,00350,India
208122,2023-08-07,501,iphone 15,60000,80000,20000,1,00350,India
596442,2023-08-07,501,iphone 15,60000,80000,20000,1,00017,India
596442,2023-08-07,505,oven,18490,24000,5510,1,00017,India
584043,2023-08-07,506,monitor,3249,8000,4751,1,00131,India
376283,2023-08-07,502,iphone 15 pro max,100000,135000,35000,1,00116,India
376283,2023-08-07,506,monitor,3249,8000,4751,1,00116,India
376283,2023-08-07,504,iron,449,879,430,1,00116,India
204354,2023-08-07,503,mixer,1349,3249,1900,1,00452,India
204354,2023-08-07,506,monitor,3249,8000,4751,1,00452,India
447628,2023-08-07,505,oven,18490,24000,5510,1,00152,India
447628,2023-08-07,507,washing machine,6990,16490,9500,1,00152,India
838180,2023-08-07,507,washing machine,6990,16490,9500,1,00465,India
838180,2023-08-07,503,mixer,1349,3249,1900,1,00465,India
838180,2023-08-07,505,oven,18490,24000,5510,1,00465,India
851876,2023-08-07,503,mixer,1349,3249,1900,1,00091,India
851876,2023-08-07,501,iphone 15,60000,80000,20000,1,00091,India
851876,2023-08-07,504,iron,449,879,430,1,00091,India
282465,2023-08-07,507,washing machine,6990,16490,9500,1,00475,India
282465,2023-08-07,505,oven,18490,24000,5510,1,00475,India
465789,2023-08-07,505,oven,18490,24000,5510,1,00295,India
465789,2023-08-07,501,iphone 15,60000,80000,20000,1,00295,India
465789,2023-08-07,507,washing machine,6990,16490,9500,1,00295,India
465789,2023-08-07,504,iron,449,879,430,1,00295,India
465789,2023-08-07,502,iphone 15 pro max,100000,135000,35000,1,00295,India
152676,2023-08-07,501,iphone 15,60000,80000,20000,1,00110,India
714049,2023-08-07,503,mixer,1349,3249,1900,1,00180,India
714049,2023-08-07,502,iphone 15 pro max,100000,135000,35000,1,00180,India
714049,2023-08-07,506,monitor,3249,8000,4751,1,00180,India
360513,2023-08-07,503,mixer,1349,3249,1900,1,00184,India
360513,2023-08-07,504,iron,449,879,430,1,00184,India
360513,2023-08-07,505,oven,18490,24000,5510,1,00184,India
502710,2023-08-07,501,iphone 15,60000,80000,20000,1,00003,India
502710,2023-08-07,502,iphone 15 pro max,100000,135000,35000,1,00003,India
502710,2023-08-07,507,washing machine,6990,16490,9500,1,00003,India
502710,2023-08-07,506,monitor,3249,8000,4751,1,00003,India
846482,2023-08-07,504,iron,449,879,430,1,00134,India
846482,2023-08-07,507,washing machine,6990,16490,9500,1,00134,India
846482,2023-08-07,502,iphone 15 pro max,100000,135000,35000,1,00134,India
463625,2023-08-07,506,monitor,3249,8000,4751,1,00465,India
463625,2023-08-07,502,iphone 15 pro max,100000,135000,35000,1,00465,India
463625,2023-08-07,507,washing machine,6990,16490,9500,1,00465,India
562192,2023-08-07,503,mixer,1349,3249,1900,1,00465,India
562192,2023-08-07,506,monitor,3249,8000,4751,1,00465,India
562192,2023-08-07,507,washing machine,6990,16490,9500,1,00465,India
972552,2023-08-07,501,iphone 15,60000,80000,20000,1,00323,India
972552,2023-08-07,506,monitor,3249,8000,4751,1,00323,India
187780,2023-08-07,503,mixer,1349,3249,1900,1,00181,India
187780,2023-08-07,501,iphone 15,60000,80000,20000,1,00181,India
187780,2023-08-07,507,washing machine,6990,16490,9500,1,00181,India
237152,2023-08-07,504,iron,449,879,430,1,00215,India
237152,2023-08-07,507,washing machine,6990,16490,9500,1,00215,India
190351,2023-08-07,503,mixer,1349,3249,1900,1,00234,India
190351,2023-08-07,502,iphone 15 pro max,100000,135000,35000,1,00234,India
867744,2023-08-07,502,iphone 15 pro max,100000,135000,35000,1,00314,India
867744,2023-08-07,503,mixer,1349,3249,1900,1,00314,India
867744,2023-08-07,501,iphone 15,60000,80000,20000,1,00314,India
831885,2023-08-07,502,iphone 15 pro max,100000,135000,35000,1,00206,India
831885,2023-08-07,504,iron,449,879,430,1,00206,India
831885,2023-08-07,507,washing machine,6990,16490,9500,1,00206,India
881441,2023-08-07,502,iphone 15 pro max,100000,135000,35000,1,00476,India
598624,2023-08-07,506,monitor,3249,8000,4751,1,00151,India
598624,2023-08-07,503,mixer,1349,3249,1900,1,00151,India
598624,2023-08-07,501,iphone 15,60000,80000,20000,1,00151,India
598624,2023-08-07,505,oven,18490,24000,5510,1,00151,India
633773,2023-08-07,501,iphone 15,60000,80000,20000,1,00418,India
633773,2023-08-07,506,monitor,3249,8000,4751,1,00418,India
633773,2023-08-07,505,oven,18490,24000,5510,1,00418,India
633773,2023-08-07,503,mixer,1349,3249,1900,1,00418,India
633773,2023-08-07,504,iron,449,879,430,1,00418,India
968107,2023-08-07,507,washing machine,6990,16490,9500,1,00017,India
968107,2023-08-07,501,iphone 15,60000,80000,20000,1,00017,India
968107,2023-08-07,504,iron,449,879,430,1,00017,India
457173,2023-08-07,503,mixer,1349,3249,1900,1,00083,India
457173,2023-08-07,505,oven,18490,24000,5510,1,00083,India
408636,2023-08-07,505,oven,18490,24000,5510,1,00282,India
408636,2023-08-07,507,washing machine,6990,16490,9500,1,00282,India
609382,2023-08-07,504,iron,449,879,430,1,00249,India
609382,2023-08-07,503,mixer,1349,3249,1900,1,00249,India
183349,2023-08-07,504,iron,449,879,430,1,00278,India
183349,2023-08-07,506,monitor,3249,8000,4751,1,00278,India
267845,2023-08-07,507,washing machine,6990,16490,9500,1,00428,India
267845,2023-08-07,502,iphone 15 pro max,100000,135000,35000,1,00428,India
267845,2023-08-07,503,mixer,1349,3249,1900,1,00428,India
534059,2023-08-07,506,monitor,3249,8000,4751,1,00042,India
534059,2023-08-07,503,mixer,1349,3249,1900,1,00042,India
534059,2023-08-07,502,iphone 15 pro max,100000,135000,35000,1,00042,India
686817,2023-08-07,503,mixer,1349,3249,1900,1,00260,India
686817,2023-08-07,501,iphone 15,60000,80000,20000,1,00260,India
598485,2023-08-07,506,monitor,3249,8000,4751,1,00303,India
598485,2023-08-07,504,iron,449,879,430,1,00303,India
598485,2023-08-07,507,washing machine,6990,16490,9500,1,00303,India
598485,2023-08-07,501,iphone 15,60000,80000,20000,1,00303,India
598485,2023-08-07,503,mixer,1349,3249,1900,1,00303,India
110986,2023-08-07,503,mixer,1349,3249,1900,1,00169,India
110986,2023-08-07,506,monitor,3249,8000,4751,1,00169,India
110986,2023-08-07,502,iphone 15 pro max,100000,135000,35000,1,00169,India
216330,2023-08-07,505,oven,18490,24000,5510,1,00279,India
216330,2023-08-07,502,iphone 15 pro max,100000,135000,35000,1,00279,India
216330,2023-08-07,501,iphone 15,60000,80000,20000,1,00279,India
216330,2023-08-07,503,mixer,1349,3249,1900,1,00279,India
728333,2023-08-07,501,iphone 15,60000,80000,20000,1,00300,India
728333,2023-08-07,504,iron,449,879,430,1,00300,India
728333,2023-08-07,507,washing machine,6990,16490,9500,1,00300,India
728333,2023-08-07,505,oven,18490,24000,5510,1,00300,India
118487,2023-08-07,501,iphone 15,60000,80000,20000,1,00253,India
697097,2023-08-07,506,monitor,3249,8000,4751,1,00154,India
697097,2023-08-07,505,oven,18490,24000,5510,1,00154,India
540832,2023-08-07,502,iphone 15 pro max,100000,135000,35000,1,00297,India
540832,2023-08-07,507,washing machine,6990,16490,9500,1,00297,India
540832,2023-08-07,505,oven,18490,24000,5510,1,00297,India
540832,2023-08-07,501,iphone 15,60000,80000,20000,1,00297,India
526294,2023-08-07,505,oven,18490,24000,5510,1,00079,India
526294,2023-08-07,504,iron,449,879,430,1,00079,India
526294,2023-08-07,501,iphone 15,60000,80000,20000,1,00079,India
526294,2023-08-07,506,monitor,3249,8000,4751,1,00079,India
758483,2023-08-07,504,iron,449,879,430,1,00106,India
624309,2023-08-07,505,oven,18490,24000,5510,1,00157,India
624309,2023-08-07,501,iphone 15,60000,80000,20000,1,00157,India
765147,2023-08-08,501,iphone 15,60000,80000,20000,1,00286,India
765147,2023-08-08,506,monitor,3249,8000,4751,1,00286,India
765147,2023-08-08,502,iphone 15 pro max,100000,135000,35000,1,00286,India
765147,2023-08-08,503,mixer,1349,3249,1900,1,00286,India
331873,2023-08-08,505,oven,18490,24000,5510,1,00126,India
331873,2023-08-08,506,monitor,3249,8000,4751,1,00126,India
331873,2023-08-08,502,iphone 15 pro max,100000,135000,35000,1,00126,India
331873,2023-08-08,507,washing machine,6990,16490,9500,1,00126,India
709135,2023-08-08,507,washing machine,6990,16490,9500,1,00336,India
709135,2023-08-08,505,oven,18490,24000,5510,1,00336,India
709135,2023-08-08,504,iron,449,879,430,1,00336,India
709135,2023-08-08,502,iphone 15 pro max,100000,135000,35000,1,00336,India
769970,2023-08-08,504,iron,449,879,430,1,00255,India
769970,2023-08-08,507,washing machine,6990,16490,9500,1,00255,India
769970,2023-08-08,503,mixer,1349,3249,1900,1,00255,India
769970,2023-08-08,506,monitor,3249,8000,4751,1,00255,India
769970,2023-08-08,505,oven,18490,24000,5510,1,00255,India
775139,2023-08-08,502,iphone 15 pro max,100000,135000,35000,1,00489,India
775139,2023-08-08,501,iphone 15,60000,80000,20000,1,00489,India
790237,2023-08-08,504,iron,449,879,430,1,00044,India
565693,2023-08-08,507,washing machine,6990,16490,9500,1,00378,India
565693,2023-08-08,501,iphone 15,60000,80000,20000,1,00378,India
319665,2023-08-08,507,washing machine,6990,16490,9500,1,00077,India
319665,2023-08-08,502,iphone 15 pro max,100000,135000,35000,1,00077,India
319665,2023-08-08,506,monitor,3249,8000,4751,1,00077,India
319665,2023-08-08,505,oven,18490,24000,5510,1,00077,India
423033,2023-08-08,505,oven,18490,24000,5510,1,00114,India
423033,2023-08-08,507,washing machine,6990,16490,9500,1,00114,India
423033,2023-08-08,502,iphone 15 pro max,100000,135000,35000,1,00114,India
619042,2023-08-08,501,iphone 15,60000,80000,20000,1,00160,India
406533,2023-08-08,506,monitor,3249,8000,4751,1,00041,India
406533,2023-08-08,502,iphone 15 pro max,100000,135000,35000,1,00041,India
440154,2023-08-08,505,oven,18490,24000,5510,1,00196,India
440154,2023-08-08,507,washing machine,6990,16490,9500,1,00196,India
440154,2023-08-08,506,monitor,3249,8000,4751,1,00196,India
418612,2023-08-08,503,mixer,1349,3249,1900,1,00039,India
418612,2023-08-08,507,washing machine,6990,16490,9500,1,00039,India
969493,2023-08-08,502,iphone 15 pro max,100000,135000,35000,1,00434,India
969493,2023-08-08,506,monitor,3249,8000,4751,1,00434,India
969493,2023-08-08,505,oven,18490,24000,5510,1,00434,India
945444,2023-08-08,506,monitor,3249,8000,4751,1,00388,India
107117,2023-08-08,504,iron,449,879,430,1,00019,India
107117,2023-08-08,507,washing machine,6990,16490,9500,1,00019,India
107117,2023-08-08,502,iphone 15 pro max,100000,135000,35000,1,00019,India
187311,2023-08-08,507,washing machine,6990,16490,9500,1,00328,India
640842,2023-08-08,503,mixer,1349,3249,1900,1,00445,India
640842,2023-08-08,506,monitor,3249,8000,4751,1,00445,India
640842,2023-08-08,507,washing machine,6990,16490,9500,1,00445,India
389636,2023-08-08,504,iron,449,879,430,1,00202,India
725990,2023-08-08,504,iron,449,879,430,1,00495,India
725990,2023-08-08,505,oven,18490,24000,5510,1,00495,India
830891,2023-08-08,501,iphone 15,60000,80000,20000,1,00042,India
830891,2023-08-08,504,iron,449,879,430,1,00042,India
830891,2023-08-08,505,oven,18490,24000,5510,1,00042,India
690294,2023-08-08,505,oven,18490,24000,5510,1,00282,India
690294,2023-08-08,503,mixer,1349,3249,1900,1,00282,India
184588,2023-08-08,502,iphone 15 pro max,100000,135000,35000,1,00242,India
184588,2023-08-08,507,washing machine,6990,16490,9500,1,00242,India
184588,2023-08-08,505,oven,18490,24000,5510,1,00242,India
184588,2023-08-08,506,monitor,3249,8000,4751,1,00242,India
184588,2023-08-08,501,iphone 15,60000,80000,20000,1,00242,India
165713,2023-08-08,502,iphone 15 pro max,100000,135000,35000,1,00008,India
784238,2023-08-08,501,iphone 15,60000,80000,20000,1,00236,India
931859,2023-08-08,504,iron,449,879,430,1,00413,India
931859,2023-08-08,501,iphone 15,60000,80000,20000,1,00413,India
931859,2023-08-08,507,washing machine,6990,16490,9500,1,00413,India
940589,2023-08-08,506,monitor,3249,8000,4751,1,00167,India
940589,2023-08-08,502,iphone 15 pro max,100000,135000,35000,1,00167,India
940589,2023-08-08,505,oven,18490,24000,5510,1,00167,India
940589,2023-08-08,503,mixer,1349,3249,1900,1,00167,India
819768,2023-08-08,505,oven,18490,24000,5510,1,00205,India
819768,2023-08-08,506,monitor,3249,8000,4751,1,00205,India
540468,2023-08-08,507,washing machine,6990,16490,9500,1,00300,India
540468,2023-08-08,501,iphone 15,60000,80000,20000,1,00300,India
540468,2023-08-08,502,iphone 15 pro max,100000,135000,35000,1,00300,India
540468,2023-08-08,504,iron,449,879,430,1,00300,India
993761,2023-08-08,501,iphone 15,60000,80000,20000,1,00392,India
847060,2023-08-08,507,washing machine,6990,16490,9500,1,00296,India
847761,2023-08-08,507,washing machine,6990,16490,9500,1,00228,India
847761,2023-08-08,501,iphone 15,60000,80000,20000,1,00228,India
847761,2023-08-08,505,oven,18490,24000,5510,1,00228,India
847761,2023-08-08,504,iron,449,879,430,1,00228,India
160528,2023-08-08,507,washing machine,6990,16490,9500,1,00262,India
160528,2023-08-08,505,oven,18490,24000,5510,1,00262,India
531639,2023-08-08,501,iphone 15,60000,80000,20000,1,00363,India
531639,2023-08-08,507,washing machine,6990,16490,9500,1,00363,India
531639,2023-08-08,503,mixer,1349,3249,1900,1,00363,India
531639,2023-08-08,505,oven,18490,24000,5510,1,00363,India
159075,2023-08-08,504,iron,449,879,430,1,00321,India
159075,2023-08-08,507,washing machine,6990,16490,9500,1,00321,India
978928,2023-08-08,502,iphone 15 pro max,100000,135000,35000,1,00454,India
978928,2023-08-08,501,iphone 15,60000,80000,20000,1,00454,India
306436,2023-08-08,506,monitor,3249,8000,4751,1,00059,India
553451,2023-08-08,503,mixer,1349,3249,1900,1,00343,India
553451,2023-08-08,507,washing machine,6990,16490,9500,1,00343,India
553451,2023-08-08,504,iron,449,879,430,1,00343,India
712445,2023-08-08,505,oven,18490,24000,5510,1,00464,India
712445,2023-08-08,501,iphone 15,60000,80000,20000,1,00464,India
795646,2023-08-08,505,oven,18490,24000,5510,1,00008,India
795646,2023-08-08,504,iron,449,879,430,1,00008,India
795646,2023-08-08,501,iphone 15,60000,80000,20000,1,00008,India
795646,2023-08-08,506,monitor,3249,8000,4751,1,00008,India
427717,2023-08-08,504,iron,449,879,430,1,00240,India
427717,2023-08-08,506,monitor,3249,8000,4751,1,00240,India
427717,2023-08-08,503,mixer,1349,3249,1900,1,00240,India
243413,2023-08-08,501,iphone 15,60000,80000,20000,1,00015,India
243413,2023-08-08,506,monitor,3249,8000,4751,1,00015,India
848045,2023-08-08,507,washing machine,6990,16490,9500,1,00021,India
848045,2023-08-08,502,iphone 15 pro max,100000,135000,35000,1,00021,India
886764,2023-08-08,505,oven,18490,24000,5510,1,00206,India
886764,2023-08-08,503,mixer,1349,3249,1900,1,00206,India
886764,2023-08-08,502,iphone 15 pro max,100000,135000,35000,1,00206,India
830225,2023-08-08,507,washing machine,6990,16490,9500,1,00067,India
830225,2023-08-08,501,iphone 15,60000,80000,20000,1,00067,India
751245,2023-08-08,502,iphone 15 pro max,100000,135000,35000,1,00469,India
751245,2023-08-08,505,oven,18490,24000,5510,1,00469,India
169194,2023-08-08,506,monitor,3249,8000,4751,1,00135,India
168910,2023-08-08,502,iphone 15 pro max,100000,135000,35000,1,00085,India
168910,2023-08-08,507,washing machine,6990,16490,9500,1,00085,India
168910,2023-08-08,505,oven,18490,24000,5510,1,00085,India
168910,2023-08-08,506,monitor,3249,8000,4751,1,00085,India
505978,2023-08-08,503,mixer,1349,3249,1900,1,00064,India
505978,2023-08-08,501,iphone 15,60000,80000,20000,1,00064,India
488520,2023-08-08,501,iphone 15,60000,80000,20000,1,00362,India
488520,2023-08-08,503,mixer,1349,3249,1900,1,00362,India
488520,2023-08-08,504,iron,449,879,430,1,00362,India
488520,2023-08-08,505,oven,18490,24000,5510,1,00362,India
946191,2023-08-08,503,mixer,1349,3249,1900,1,00389,India
946191,2023-08-08,504,iron,449,879,430,1,00389,India
946191,2023-08-08,501,iphone 15,60000,80000,20000,1,00389,India
447514,2023-08-08,505,oven,18490,24000,5510,1,00099,India
447514,2023-08-08,503,mixer,1349,3249,1900,1,00099,India
637182,2023-08-08,503,mixer,1349,3249,1900,1,00378,India
637182,2023-08-08,501,iphone 15,60000,80000,20000,1,00378,India
159065,2023-08-08,505,oven,18490,24000,5510,1,00043,India
159065,2023-08-08,506,monitor,3249,8000,4751,1,00043,India
159065,2023-08-08,501,iphone 15,60000,80000,20000,1,00043,India
541086,2023-08-08,504,iron,449,879,430,1,00081,India
541086,2023-08-08,503,mixer,1349,3249,1900,1,00081,India
541086,2023-08-08,505,oven,18490,24000,5510,1,00081,India
541086,2023-08-08,502,iphone 15 pro max,100000,135000,35000,1,00081,India
541086,2023-08-08,501,iphone 15,60000,80000,20000,1,00081,India
792119,2023-08-08,503,mixer,1349,3249,1900,1,00048,India
792119,2023-08-08,505,oven,18490,24000,5510,1,00048,India
699948,2023-08-08,507,washing machine,6990,16490,9500,1,00450,India
699948,2023-08-08,503,mixer,1349,3249,1900,1,00450,India
699948,2023-08-08,504,iron,449,879,430,1,00450,India
829656,2023-08-08,503,mixer,1349,3249,1900,1,00149,India
630999,2023-08-08,504,iron,449,879,430,1,00452,India
508683,2023-08-08,506,monitor,3249,8000,4751,1,00188,India
508683,2023-08-08,505,oven,18490,24000,5510,1,00188,India
508683,2023-08-08,502,iphone 15 pro max,100000,135000,35000,1,00188,India
508683,2023-08-08,507,washing machine,6990,16490,9500,1,00188,India
745683,2023-08-08,506,monitor,3249,8000,4751,1,00344,India
745683,2023-08-08,502,iphone 15 pro max,100000,135000,35000,1,00344,India
861752,2023-08-08,502,iphone 15 pro max,100000,135000,35000,1,00161,India
861752,2023-08-08,505,oven,18490,24000,5510,1,00161,India
861752,2023-08-08,504,iron,449,879,430,1,00161,India
761502,2023-08-08,504,iron,449,879,430,1,00324,India
761502,2023-08-08,507,washing machine,6990,16490,9500,1,00324,India
902088,2023-08-08,506,monitor,3249,8000,4751,1,00146,India
902088,2023-08-08,501,iphone 15,60000,80000,20000,1,00146,India
902088,2023-08-08,502,iphone 15 pro max,100000,135000,35000,1,00146,India
791765,2023-08-08,502,iphone 15 pro max,100000,135000,35000,1,00332,India
168460,2023-08-08,505,oven,18490,24000,5510,1,00301,India
168460,2023-08-08,501,iphone 15,60000,80000,20000,1,00301,India
168460,2023-08-08,504,iron,449,879,430,1,00301,India
168460,2023-08-08,507,washing machine,6990,16490,9500,1,00301,India
510921,2023-08-08,507,washing machine,6990,16490,9500,1,00282,India
510921,2023-08-08,501,iphone 15,60000,80000,20000,1,00282,India
510921,2023-08-08,505,oven,18490,24000,5510,1,00282,India
473264,2023-08-08,507,washing machine,6990,16490,9500,1,00400,India
473264,2023-08-08,504,iron,449,879,430,1,00400,India
603062,2023-08-08,504,iron,449,879,430,1,00498,India
603062,2023-08-08,501,iphone 15,60000,80000,20000,1,00498,India
611217,2023-08-08,501,iphone 15,60000,80000,20000,1,00492,India
249125,2023-08-08,504,iron,449,879,430,1,00096,India
249125,2023-08-08,502,iphone 15 pro max,100000,135000,35000,1,00096,India
169317,2023-08-08,503,mixer,1349,3249,1900,1,00303,India
152904,2023-08-08,504,iron,449,879,430,1,00321,India
152904,2023-08-08,503,mixer,1349,3249,1900,1,00321,India
244645,2023-08-08,502,iphone 15 pro max,100000,135000,35000,1,00150,India
937423,2023-08-09,503,mixer,1349,3249,1900,1,00225,India
937423,2023-08-09,501,iphone 15,60000,80000,20000,1,00225,India
937423,2023-08-09,507,washing machine,6990,16490,9500,1,00225,India
887006,2023-08-09,505,oven,18490,24000,5510,1,00479,India
848171,2023-08-09,503,mixer,1349,3249,1900,1,00365,India
848171,2023-08-09,507,washing machine,6990,16490,9500,1,00365,India
848171,2023-08-09,501,iphone 15,60000,80000,20000,1,00365,India
904961,2023-08-09,505,oven,18490,24000,5510,1,00256,India
904961,2023-08-09,503,mixer,1349,3249,1900,1,00256,India
815633,2023-08-09,505,oven,18490,24000,5510,1,00399,India
815633,2023-08-09,507,washing machine,6990,16490,9500,1,00399,India
815633,2023-08-09,502,iphone 15 pro max,100000,135000,35000,1,00399,India
815633,2023-08-09,503,mixer,1349,3249,1900,1,00399,India
874012,2023-08-09,502,iphone 15 pro max,100000,135000,35000,1,00245,India
104514,2023-08-09,501,iphone 15,60000,80000,20000,1,00108,India
596133,2023-08-09,506,monitor,3249,8000,4751,1,00322,India
134879,2023-08-09,501,iphone 15,60000,80000,20000,1,00014,India
134879,2023-08-09,505,oven,18490,24000,5510,1,00014,India
763510,2023-08-09,501,iphone 15,60000,80000,20000,1,00419,India
763510,2023-08-09,504,iron,449,879,430,1,00419,India
763510,2023-08-09,505,oven,18490,24000,5510,1,00419,India
847939,2023-08-09,507,washing machine,6990,16490,9500,1,00232,India
847939,2023-08-09,503,mixer,1349,3249,1900,1,00232,India
847939,2023-08-09,501,iphone 15,60000,80000,20000,1,00232,India
606050,2023-08-09,507,washing machine,6990,16490,9500,1,00026,India
533636,2023-08-09,507,washing machine,6990,16490,9500,1,00139,India
533636,2023-08-09,506,monitor,3249,8000,4751,1,00139,India
551156,2023-08-09,501,iphone 15,60000,80000,20000,1,00447,India
551156,2023-08-09,507,washing machine,6990,16490,9500,1,00447,India
551156,2023-08-09,505,oven,18490,24000,5510,1,00447,India
467235,2023-08-09,504,iron,449,879,430,1,00305,India
666537,2023-08-09,507,washing machine,6990,16490,9500,1,00349,India
838148,2023-08-09,501,iphone 15,60000,80000,20000,1,00457,India
838148,2023-08-09,506,monitor,3249,8000,4751,1,00457,India
632486,2023-08-09,503,mixer,1349,3249,1900,1,00319,India
632486,2023-08-09,504,iron,449,879,430,1,00319,India
826011,2023-08-09,506,monitor,3249,8000,4751,1,00200,India
826011,2023-08-09,505,oven,18490,24000,5510,1,00200,India
826011,2023-08-09,503,mixer,1349,3249,1900,1,00200,India
826011,2023-08-09,502,iphone 15 pro max,100000,135000,35000,1,00200,India
178396,2023-08-09,504,iron,449,879,430,1,00432,India
862890,2023-08-09,505,oven,18490,24000,5510,1,00117,India
862890,2023-08-09,503,mixer,1349,3249,1900,1,00117,India
313594,2023-08-09,506,monitor,3249,8000,4751,1,00225,India
313594,2023-08-09,502,iphone 15 pro max,100000,135000,35000,1,00225,India
313594,2023-08-09,504,iron,449,879,430,1,00225,India
713805,2023-08-09,504,iron,449,879,430,1,00363,India
866849,2023-08-09,503,mixer,1349,3249,1900,1,00392,India
866849,2023-08-09,504,iron,449,879,430,1,00392,India
866849,2023-08-09,502,iphone 15 pro max,100000,135000,35000,1,00392,India
995866,2023-08-09,504,iron,449,879,430,1,00217,India
995866,2023-08-09,502,iphone 15 pro max,100000,135000,35000,1,00217,India
291934,2023-08-09,507,washing machine,6990,16490,9500,1,00044,India
291934,2023-08-09,503,mixer,1349,3249,1900,1,00044,India
291934,2023-08-09,506,monitor,3249,8000,4751,1,00044,India
920733,2023-08-09,501,iphone 15,60000,80000,20000,1,00104,India
920733,2023-08-09,504,iron,449,879,430,1,00104,India
920733,2023-08-09,505,oven,18490,24000,5510,1,00104,India
448566,2023-08-09,501,iphone 15,60000,80000,20000,1,00288,India
427033,2023-08-09,503,mixer,1349,3249,1900,1,00448,India
427033,2023-08-09,501,iphone 15,60000,80000,20000,1,00448,India
347431,2023-08-09,502,iphone 15 pro max,100000,135000,35000,1,00448,India
785094,2023-08-09,502,iphone 15 pro max,100000,135000,35000,1,00282,India
785094,2023-08-09,503,mixer,1349,3249,1900,1,00282,India
785094,2023-08-09,507,washing machine,6990,16490,9500,1,00282,India
785094,2023-08-09,506,monitor,3249,8000,4751,1,00282,India
199439,2023-08-09,504,iron,449,879,430,1,00143,India
199439,2023-08-09,502,iphone 15 pro max,100000,135000,35000,1,00143,India
199439,2023-08-09,503,mixer,1349,3249,1900,1,00143,India
199439,2023-08-09,501,iphone 15,60000,80000,20000,1,00143,India
696556,2023-08-09,504,iron,449,879,430,1,00260,India
696556,2023-08-09,503,mixer,1349,3249,1900,1,00260,India
696556,2023-08-09,506,monitor,3249,8000,4751,1,00260,India
221637,2023-08-09,504,iron,449,879,430,1,00273,India
221637,2023-08-09,502,iphone 15 pro max,100000,135000,35000,1,00273,India
221637,2023-08-09,503,mixer,1349,3249,1900,1,00273,India
414285,2023-08-09,504,iron,449,879,430,1,00063,India
875150,2023-08-09,502,iphone 15 pro max,100000,135000,35000,1,00205,India
875150,2023-08-09,503,mixer,1349,3249,1900,1,00205,India
875150,2023-08-09,505,oven,18490,24000,5510,1,00205,India
875150,2023-08-09,506,monitor,3249,8000,4751,1,00205,India
374975,2023-08-09,504,iron,449,879,430,1,00180,India
167307,2023-08-09,505,oven,18490,24000,5510,1,00241,India
167307,2023-08-09,501,iphone 15,60000,80000,20000,1,00241,India
507682,2023-08-09,502,iphone 15 pro max,100000,135000,35000,1,00480,India
507682,2023-08-09,507,washing machine,6990,16490,9500,1,00480,India
507682,2023-08-09,506,monitor,3249,8000,4751,1,00480,India
196757,2023-08-09,505,oven,18490,24000,5510,1,00215,India
196757,2023-08-09,503,mixer,1349,3249,1900,1,00215,India
196757,2023-08-09,507,washing machine,6990,16490,9500,1,00215,India
156140,2023-08-09,502,iphone 15 pro max,100000,135000,35000,1,00334,India
255418,2023-08-09,502,iphone 15 pro max,100000,135000,35000,1,00474,India
496925,2023-08-09,503,mixer,1349,3249,1900,1,00390,India
496925,2023-08-09,501,iphone 15,60000,80000,20000,1,00390,India
193388,2023-08-09,507,washing machine,6990,16490,9500,1,00019,India
193388,2023-08-09,504,iron,449,879,430,1,00019,India
193388,2023-08-09,503,mixer,1349,3249,1900,1,00019,India
656299,2023-08-09,503,mixer,1349,3249,1900,1,00011,India
656299,2023-08-09,505,oven,18490,24000,5510,1,00011,India
196040,2023-08-09,506,monitor,3249,8000,4751,1,00326,India
196040,2023-08-09,504,iron,449,879,430,1,00326,India
908735,2023-08-09,506,monitor,3249,8000,4751,1,00256,India
908735,2023-08-09,507,washing machine,6990,16490,9500,1,00256,India
908735,2023-08-09,504,iron,449,879,430,1,00256,India
908735,2023-08-09,505,oven,18490,24000,5510,1,00256,India
346148,2023-08-09,503,mixer,1349,3249,1900,1,00318,India
850007,2023-08-09,501,iphone 15,60000,80000,20000,1,00123,India
850007,2023-08-09,505,oven,18490,24000,5510,1,00123,India
850007,2023-08-09,506,monitor,3249,8000,4751,1,00123,India
130941,2023-08-09,501,iphone 15,60000,80000,20000,1,00167,India
130941,2023-08-09,503,mixer,1349,3249,1900,1,00167,India
130941,2023-08-09,502,iphone 15 pro max,100000,135000,35000,1,00167,India
666889,2023-08-09,507,washing machine,6990,16490,9500,1,00181,India
666889,2023-08-09,505,oven,18490,24000,5510,1,00181,India
666889,2023-08-09,501,iphone 15,60000,80000,20000,1,00181,India
573269,2023-08-09,501,iphone 15,60000,80000,20000,1,00406,India
573269,2023-08-09,502,iphone 15 pro max,100000,135000,35000,1,00406,India
573269,2023-08-09,505,oven,18490,24000,5510,1,00406,India
875057,2023-08-09,503,mixer,1349,3249,1900,1,00394,India
875057,2023-08-09,502,iphone 15 pro max,100000,135000,35000,1,00394,India
304836,2023-08-09,504,iron,449,879,430,1,00355,India
388317,2023-08-09,502,iphone 15 pro max,100000,135000,35000,1,00189,India
600120,2023-08-09,501,iphone 15,60000,80000,20000,1,00103,India
600120,2023-08-09,502,iphone 15 pro max,100000,135000,35000,1,00103,India
600120,2023-08-09,503,mixer,1349,3249,1900,1,00103,India
600120,2023-08-09,507,washing machine,6990,16490,9500,1,00103,India
600120,2023-08-09,504,iron,449,879,430,1,00103,India
883784,2023-08-09,506,monitor,3249,8000,4751,1,00387,India
110942,2023-08-09,504,iron,449,879,430,1,00418,India
110942,2023-08-09,505,oven,18490,24000,5510,1,00418,India
110942,2023-08-09,503,mixer,1349,3249,1900,1,00418,India
925156,2023-08-09,507,washing machine,6990,16490,9500,1,00462,India
925156,2023-08-09,503,mixer,1349,3249,1900,1,00462,India
925156,2023-08-09,506,monitor,3249,8000,4751,1,00462,India
925156,2023-08-09,505,oven,18490,24000,5510,1,00462,India
526013,2023-08-09,503,mixer,1349,3249,1900,1,00178,India
526013,2023-08-09,501,iphone 15,60000,80000,20000,1,00178,India
526013,2023-08-09,504,iron,449,879,430,1,00178,India
526013,2023-08-09,506,monitor,3249,8000,4751,1,00178,India
691923,2023-08-09,501,iphone 15,60000,80000,20000,1,00049,India
691923,2023-08-09,507,washing machine,6990,16490,9500,1,00049,India
538465,2023-08-09,505,oven,18490,24000,5510,1,00234,India
799523,2023-08-09,504,iron,449,879,430,1,00226,India
799523,2023-08-09,501,iphone 15,60000,80000,20000,1,00226,India
799523,2023-08-09,506,monitor,3249,8000,4751,1,00226,India
620428,2023-08-10,502,iphone 15 pro max,100000,135000,35000,1,00158,India
620428,2023-08-10,506,monitor,3249,8000,4751,1,00158,India
620428,2023-08-10,507,washing machine,6990,16490,9500,1,00158,India
620428,2023-08-10,504,iron,449,879,430,1,00158,India
850641,2023-08-10,504,iron,449,879,430,1,00436,India
850641,2023-08-10,505,oven,18490,24000,5510,1,00436,India
850641,2023-08-10,503,mixer,1349,3249,1900,1,00436,India
850641,2023-08-10,502,iphone 15 pro max,100000,135000,35000,1,00436,India
199408,2023-08-10,504,iron,449,879,430,1,00278,India
199408,2023-08-10,506,monitor,3249,8000,4751,1,00278,India
199408,2023-08-10,503,mixer,1349,3249,1900,1,00278,India
199408,2023-08-10,502,iphone 15 pro max,100000,135000,35000,1,00278,India
636414,2023-08-10,502,iphone 15 pro max,100000,135000,35000,1,00086,India
636414,2023-08-10,503,mixer,1349,3249,1900,1,00086,India
636414,2023-08-10,504,iron,449,879,430,1,00086,India
636414,2023-08-10,506,monitor,3249,8000,4751,1,00086,India
874092,2023-08-10,503,mixer,1349,3249,1900,1,00358,India
874092,2023-08-10,505,oven,18490,24000,5510,1,00358,India
874092,2023-08-10,502,iphone 15 pro max,100000,135000,35000,1,00358,India
140656,2023-08-10,503,mixer,1349,3249,1900,1,00482,India
140656,2023-08-10,505,oven,18490,24000,5510,1,00482,India
518940,2023-08-10,505,oven,18490,24000,5510,1,00229,India
518940,2023-08-10,507,washing machine,6990,16490,9500,1,00229,India
518940,2023-08-10,504,iron,449,879,430,1,00229,India
518940,2023-08-10,502,iphone 15 pro max,100000,135000,35000,1,00229,India
805942,2023-08-10,505,oven,18490,24000,5510,1,00322,India
805942,2023-08-10,506,monitor,3249,8000,4751,1,00322,India
805942,2023-08-10,501,iphone 15,60000,80000,20000,1,00322,India
333135,2023-08-10,501,iphone 15,60000,80000,20000,1,00104,India
333135,2023-08-10,504,iron,449,879,430,1,00104,India
333135,2023-08-10,507,washing machine,6990,16490,9500,1,00104,India
333135,2023-08-10,506,monitor,3249,8000,4751,1,00104,India
238576,2023-08-10,505,oven,18490,24000,5510,1,00152,India
257308,2023-08-10,502,iphone 15 pro max,100000,135000,35000,1,00048,India
257308,2023-08-10,501,iphone 15,60000,80000,20000,1,00048,India
257308,2023-08-10,504,iron,449,879,430,1,00048,India
257308,2023-08-10,506,monitor,3249,8000,4751,1,00048,India
901504,2023-08-10,506,monitor,3249,8000,4751,1,00364,India
313440,2023-08-10,507,washing machine,6990,16490,9500,1,00411,India
313440,2023-08-10,502,iphone 15 pro max,100000,135000,35000,1,00411,India
313440,2023-08-10,506,monitor,3249,8000,4751,1,00411,India
313440,2023-08-10,504,iron,449,879,430,1,00411,India
980193,2023-08-10,501,iphone 15,60000,80000,20000,1,00262,India
298333,2023-08-10,502,iphone 15 pro max,100000,135000,35000,1,00093,India
298333,2023-08-10,506,monitor,3249,8000,4751,1,00093,India
176774,2023-08-10,506,monitor,3249,8000,4751,1,00087,India
176774,2023-08-10,503,mixer,1349,3249,1900,1,00087,India
176774,2023-08-10,502,iphone 15 pro max,100000,135000,35000,1,00087,India
460847,2023-08-10,505,oven,18490,24000,5510,1,00232,India
385555,2023-08-10,507,washing machine,6990,16490,9500,1,00390,India
385555,2023-08-10,506,monitor,3249,8000,4751,1,00390,India
243618,2023-08-10,506,monitor,3249,8000,4751,1,00137,India
243618,2023-08-10,501,iphone 15,60000,80000,20000,1,00137,India
913325,2023-08-10,501,iphone 15,60000,80000,20000,1,00308,India
156708,2023-08-10,505,oven,18490,24000,5510,1,00186,India
156708,2023-08-10,504,iron,449,879,430,1,00186,India
156708,2023-08-10,502,iphone 15 pro max,100000,135000,35000,1,00186,India
563290,2023-08-10,506,monitor,3249,8000,4751,1,00247,India
563290,2023-08-10,501,iphone 15,60000,80000,20000,1,00247,India
563290,2023-08-10,505,oven,18490,24000,5510,1,00247,India
563290,2023-08-10,507,washing machine,6990,16490,9500,1,00247,India
395538,2023-08-10,504,iron,449,879,430,1,00365,India
395538,2023-08-10,502,iphone 15 pro max,100000,135000,35000,1,00365,India
395538,2023-08-10,506,monitor,3249,8000,4751,1,00365,India
678780,2023-08-10,506,monitor,3249,8000,4751,1,00081,India
678780,2023-08-10,504,iron,449,879,430,1,00081,India
653683,2023-08-10,504,iron,449,879,430,1,00131,India
653683,2023-08-10,503,mixer,1349,3249,1900,1,00131,India
653683,2023-08-10,501,iphone 15,60000,80000,20000,1,00131,India
220993,2023-08-10,502,iphone 15 pro max,100000,135000,35000,1,00420,India
220993,2023-08-10,504,iron,449,879,430,1,00420,India
220993,2023-08-10,503,mixer,1349,3249,1900,1,00420,India
386996,2023-08-10,503,mixer,1349,3249,1900,1,00022,India
386996,2023-08-10,501,iphone 15,60000,80000,20000,1,00022,India
386996,2023-08-10,506,monitor,3249,8000,4751,1,00022,India
634053,2023-08-10,504,iron,449,879,430,1,00155,India
634053,2023-08-10,502,iphone 15 pro max,100000,135000,35000,1,00155,India
378006,2023-08-10,503,mixer,1349,3249,1900,1,00448,India
464691,2023-08-10,506,monitor,3249,8000,4751,1,00222,India
464691,2023-08-10,503,mixer,1349,3249,1900,1,00222,India
960969,2023-08-10,507,washing machine,6990,16490,9500,1,00282,India
960969,2023-08-10,505,oven,18490,24000,5510,1,00282,India
960969,2023-08-10,502,iphone 15 pro max,100000,135000,35000,1,00282,India
110417,2023-08-10,503,mixer,1349,3249,1900,1,00215,India
110417,2023-08-10,502,iphone 15 pro max,100000,135000,35000,1,00215,India
443665,2023-08-10,507,washing machine,6990,16490,9500,1,00456,India
443665,2023-08-10,502,iphone 15 pro max,100000,135000,35000,1,00456,India
358054,2023-08-10,503,mixer,1349,3249,1900,1,00231,India
358054,2023-08-10,505,oven,18490,24000,5510,1,00231,India
358054,2023-08-10,504,iron,449,879,430,1,00231,India
358054,2023-08-10,502,iphone 15 pro max,100000,135000,35000,1,00231,India
138289,2023-08-10,501,iphone 15,60000,80000,20000,1,00459,India
138289,2023-08-10,503,mixer,1349,3249,1900,1,00459,India
138289,2023-08-10,506,monitor,3249,8000,4751,1,00459,India
237146,2023-08-10,506,monitor,3249,8000,4751,1,00022,India
237146,2023-08-10,505,oven,18490,24000,5510,1,00022,India
725964,2023-08-10,506,monitor,3249,8000,4751,1,00484,India
725964,2023-08-10,502,iphone 15 pro max,100000,135000,35000,1,00484,India
998189,2023-08-10,502,iphone 15 pro max,100000,135000,35000,1,00375,India
998189,2023-08-10,506,monitor,3249,8000,4751,1,00375,India
998189,2023-08-10,505,oven,18490,24000,5510,1,00375,India
550988,2023-08-10,502,iphone 15 pro max,100000,135000,35000,1,00422,India
550988,2023-08-10,504,iron,449,879,430,1,00422,India
550988,2023-08-10,503,mixer,1349,3249,1900,1,00422,India
550988,2023-08-10,501,iphone 15,60000,80000,20000,1,00422,India
383900,2023-08-10,507,washing machine,6990,16490,9500,1,00222,India
703750,2023-08-10,504,iron,449,879,430,1,00025,India
703750,2023-08-10,507,washing machine,6990,16490,9500,1,00025,India
703750,2023-08-10,502,iphone 15 pro max,100000,135000,35000,1,00025,India
703750,2023-08-10,501,iphone 15,60000,80000,20000,1,00025,India
918831,2023-08-10,505,oven,18490,24000,5510,1,00407,India
918831,2023-08-10,501,iphone 15,60000,80000,20000,1,00407,India
962553,2023-08-10,506,monitor,3249,8000,4751,1,00428,India
962553,2023-08-10,503,mixer,1349,3249,1900,1,00428,India
320727,2023-08-10,502,iphone 15 pro max,100000,135000,35000,1,00235,India
320727,2023-08-10,507,washing machine,6990,16490,9500,1,00235,India
320727,2023-08-10,505,oven,18490,24000,5510,1,00235,India
576148,2023-08-10,503,mixer,1349,3249,1900,1,00023,India
768792,2023-08-10,507,washing machine,6990,16490,9500,1,00437,India
602305,2023-08-10,501,iphone 15,60000,80000,20000,1,00386,India
602305,2023-08-10,504,iron,449,879,430,1,00386,India
116990,2023-08-10,502,iphone 15 pro max,100000,135000,35000,1,00062,India
116990,2023-08-10,505,oven,18490,24000,5510,1,00062,India
116990,2023-08-10,504,iron,449,879,430,1,00062,India
982517,2023-08-10,504,iron,449,879,430,1,00125,India
982517,2023-08-10,505,oven,18490,24000,5510,1,00125,India
982517,2023-08-10,506,monitor,3249,8000,4751,1,00125,India
505959,2023-08-10,502,iphone 15 pro max,100000,135000,35000,1,00022,India
542378,2023-08-10,501,iphone 15,60000,80000,20000,1,00035,India
542378,2023-08-10,502,iphone 15 pro max,100000,135000,35000,1,00035,India
542378,2023-08-10,506,monitor,3249,8000,4751,1,00035,India
863344,2023-08-10,506,monitor,3249,8000,4751,1,00467,India
863344,2023-08-10,501,iphone 15,60000,80000,20000,1,00467,India
863344,2023-08-10,507,washing machine,6990,16490,9500,1,00467,India
398155,2023-08-10,502,iphone 15 pro max,100000,135000,35000,1,00271,India
398155,2023-08-10,503,mixer,1349,3249,1900,1,00271,India
620884,2023-08-10,507,washing machine,6990,16490,9500,1,00269,India
620884,2023-08-10,506,monitor,3249,8000,4751,1,00269,India
620884,2023-08-10,503,mixer,1349,3249,1900,1,00269,India
620884,2023-08-10,501,iphone 15,60000,80000,20000,1,00269,India
620884,2023-08-10,502,iphone 15 pro max,100000,135000,35000,1,00269,India
220561,2023-08-10,503,mixer,1349,3249,1900,1,00401,India
220561,2023-08-10,505,oven,18490,24000,5510,1,00401,India
648101,2023-08-10,501,iphone 15,60000,80000,20000,1,00120,India
648101,2023-08-10,503,mixer,1349,3249,1900,1,00120,India
648101,2023-08-10,506,monitor,3249,8000,4751,1,00120,India
254006,2023-08-10,501,iphone 15,60000,80000,20000,1,00083,India
254006,2023-08-10,504,iron,449,879,430,1,00083,India
254006,2023-08-10,502,iphone 15 pro max,100000,135000,35000,1,00083,India
475374,2023-08-10,501,iphone 15,60000,80000,20000,1,00001,India
475374,2023-08-10,504,iron,449,879,430,1,00001,India
260519,2023-08-10,503,mixer,1349,3249,1900,1,00229,India
260519,2023-08-10,502,iphone 15 pro max,100000,135000,35000,1,00229,India
260519,2023-08-10,505,oven,18490,24000,5510,1,00229,India
260519,2023-08-10,506,monitor,3249,8000,4751,1,00229,India
401152,2023-08-10,507,washing machine,6990,16490,9500,1,00094,India
893689,2023-08-10,506,monitor,3249,8000,4751,1,00382,India
893689,2023-08-10,504,iron,449,879,430,1,00382,India
893689,2023-08-10,505,oven,18490,24000,5510,1,00382,India
755014,2023-08-10,501,iphone 15,60000,80000,20000,1,00145,India
755014,2023-08-10,503,mixer,1349,3249,1900,1,00145,India
755014,2023-08-10,504,iron,449,879,430,1,00145,India
803524,2023-08-10,503,mixer,1349,3249,1900,1,00282,India
416886,2023-08-10,507,washing machine,6990,16490,9500,1,00384,India
416886,2023-08-10,501,iphone 15,60000,80000,20000,1,00384,India
416886,2023-08-10,505,oven,18490,24000,5510,1,00384,India
416886,2023-08-10,502,iphone 15 pro max,100000,135000,35000,1,00384,India
394922,2023-08-10,503,mixer,1349,3249,1900,1,00267,India
394922,2023-08-10,501,iphone 15,60000,80000,20000,1,00267,India
643329,2023-08-10,504,iron,449,879,430,1,00064,India
643329,2023-08-10,506,monitor,3249,8000,4751,1,00064,India
643329,2023-08-10,502,iphone 15 pro max,100000,135000,35000,1,00064,India
439630,2023-08-10,507,washing machine,6990,16490,9500,1,00163,India
439630,2023-08-10,506,monitor,3249,8000,4751,1,00163,India
439630,2023-08-10,502,iphone 15 pro max,100000,135000,35000,1,00163,India
439630,2023-08-10,504,iron,449,879,430,1,00163,India
439630,2023-08-10,505,oven,18490,24000,5510,1,00163,India
846024,2023-08-10,502,iphone 15 pro max,100000,135000,35000,1,00302,India
846024,2023-08-10,506,monitor,3249,8000,4751,1,00302,India
685663,2023-08-10,504,iron,449,879,430,1,00324,India
659698,2023-08-10,501,iphone 15,60000,80000,20000,1,00118,India
659698,2023-08-10,503,mixer,1349,3249,1900,1,00118,India
659698,2023-08-10,504,iron,449,879,430,1,00118,India
659698,2023-08-10,502,iphone 15 pro max,100000,135000,35000,1,00118,India
433595,2023-08-10,502,iphone 15 pro max,100000,135000,35000,1,00306,India
433595,2023-08-10,501,iphone 15,60000,80000,20000,1,00306,India
433595,2023-08-10,506,monitor,3249,8000,4751,1,00306,India
433595,2023-08-10,503,mixer,1349,3249,1900,1,00306,India
433595,2023-08-10,505,oven,18490,24000,5510,1,00306,India
146339,2023-08-10,501,iphone 15,60000,80000,20000,1,00362,India
146339,2023-08-10,506,monitor,3249,8000,4751,1,00362,India
146339,2023-08-10,504,iron,449,879,430,1,00362,India
552899,2023-08-10,507,washing machine,6990,16490,9500,1,00400,India
552899,2023-08-10,501,iphone 15,60000,80000,20000,1,00400,India
417444,2023-08-10,504,iron,449,879,430,1,00408,India
417444,2023-08-10,506,monitor,3249,8000,4751,1,00408,India
417444,2023-08-10,507,washing machine,6990,16490,9500,1,00408,India
735528,2023-08-10,502,iphone 15 pro max,100000,135000,35000,1,00249,India
735528,2023-08-10,504,iron,449,879,430,1,00249,India
735528,2023-08-10,501,iphone 15,60000,80000,20000,1,00249,India
735528,2023-08-10,507,washing machine,6990,16490,9500,1,00249,India
322673,2023-08-10,502,iphone 15 pro max,100000,135000,35000,1,00208,India
753870,2023-08-10,501,iphone 15,60000,80000,20000,1,00257,India
753870,2023-08-10,502,iphone 15 pro max,100000,135000,35000,1,00257,India
952775,2023-08-10,507,washing machine,6990,16490,9500,1,00477,India
952775,2023-08-10,503,mixer,1349,3249,1900,1,00477,India
873514,2023-08-10,507,washing machine,6990,16490,9500,1,00311,India
873514,2023-08-10,502,iphone 15 pro max,100000,135000,35000,1,00311,India
873514,2023-08-10,501,iphone 15,60000,80000,20000,1,00311,India
545498,2023-08-10,507,washing machine,6990,16490,9500,1,00005,India
545498,2023-08-10,503,mixer,1349,3249,1900,1,00005,India
545498,2023-08-10,504,iron,449,879,430,1,00005,India
839998,2023-08-10,502,iphone 15 pro max,100000,135000,35000,1,00357,India
839998,2023-08-10,504,iron,449,879,430,1,00357,India
496761,2023-08-10,505,oven,18490,24000,5510,1,00392,India
297059,2023-08-10,502,iphone 15 pro max,100000,135000,35000,1,00283,India
297059,2023-08-10,504,iron,449,879,430,1,00283,India
297059,2023-08-10,506,monitor,3249,8000,4751,1,00283,India
217952,2023-08-10,503,mixer,1349,3249,1900,1,00177,India
314526,2023-08-10,505,oven,18490,24000,5510,1,00256,India
314526,2023-08-10,501,iphone 15,60000,80000,20000,1,00256,India
719474,2023-08-10,504,iron,449,879,430,1,00074,India
488375,2023-08-10,502,iphone 15 pro max,100000,135000,35000,1,00340,India
566203,2023-08-10,501,iphone 15,60000,80000,20000,1,00134,India
566203,2023-08-10,502,iphone 15 pro max,100000,135000,35000,1,00134,India
890103,2023-08-10,504,iron,449,879,430,1,00071,India
890103,2023-08-10,506,monitor,3249,8000,4751,1,00071,India
762179,2023-08-10,507,washing machine,6990,16490,9500,1,00258,India
762179,2023-08-10,504,iron,449,879,430,1,00258,India
762179,2023-08-10,501,iphone 15,60000,80000,20000,1,00258,India
303203,2023-08-10,504,iron,449,879,430,1,00437,India
303203,2023-08-10,506,monitor,3249,8000,4751,1,00437,India
817056,2023-08-10,505,oven,18490,24000,5510,1,00363,India
176399,2023-08-10,504,iron,449,879,430,1,00381,India
555769,2023-08-10,507,washing machine,6990,16490,9500,1,00360,India
555769,2023-08-10,501,iphone 15,60000,80000,20000,1,00360,India
555769,2023-08-10,504,iron,449,879,430,1,00360,India
555769,2023-08-10,505,oven,18490,24000,5510,1,00360,India
723547,2023-08-11,502,iphone 15 pro max,100000,135000,35000,1,00297,India
723547,2023-08-11,503,mixer,1349,3249,1900,1,00297,India
171939,2023-08-11,501,iphone 15,60000,80000,20000,1,00132,India
171939,2023-08-11,505,oven,18490,24000,5510,1,00132,India
255138,2023-08-11,504,iron,449,879,430,1,00107,India
255138,2023-08-11,501,iphone 15,60000,80000,20000,1,00107,India
255138,2023-08-11,502,iphone 15 pro max,100000,135000,35000,1,00107,India
255138,2023-08-11,506,monitor,3249,8000,4751,1,00107,India
423576,2023-08-11,506,monitor,3249,8000,4751,1,00027,India
423576,2023-08-11,504,iron,449,879,430,1,00027,India
962648,2023-08-11,504,iron,449,879,430,1,00116,India
294824,2023-08-11,501,iphone 15,60000,80000,20000,1,00094,India
294824,2023-08-11,503,mixer,1349,3249,1900,1,00094,India
294824,2023-08-11,502,iphone 15 pro max,100000,135000,35000,1,00094,India
924739,2023-08-11,505,oven,18490,24000,5510,1,00021,India
924739,2023-08-11,506,monitor,3249,8000,4751,1,00021,India
426315,2023-08-11,503,mixer,1349,3249,1900,1,00078,India
426315,2023-08-11,507,washing machine,6990,16490,9500,1,00078,India
460496,2023-08-11,504,iron,449,879,430,1,00193,India
460496,2023-08-11,506,monitor,3249,8000,4751,1,00193,India
460496,2023-08-11,501,iphone 15,60000,80000,20000,1,00193,India
460496,2023-08-11,502,iphone 15 pro max,100000,135000,35000,1,00193,India
343480,2023-08-11,501,iphone 15,60000,80000,20000,1,00124,India
343480,2023-08-11,502,iphone 15 pro max,100000,135000,35000,1,00124,India
343480,2023-08-11,504,iron,449,879,430,1,00124,India
373925,2023-08-11,501,iphone 15,60000,80000,20000,1,00017,India
932512,2023-08-11,501,iphone 15,60000,80000,20000,1,00453,India
932512,2023-08-11,505,oven,18490,24000,5510,1,00453,India
932512,2023-08-11,502,iphone 15 pro max,100000,135000,35000,1,00453,India
378212,2023-08-11,504,iron,449,879,430,1,00392,India
785700,2023-08-11,506,monitor,3249,8000,4751,1,00299,India
793600,2023-08-11,501,iphone 15,60000,80000,20000,1,00473,India
793600,2023-08-11,503,mixer,1349,3249,1900,1,00473,India
793600,2023-08-11,504,iron,449,879,430,1,00473,India
793600,2023-08-11,502,iphone 15 pro max,100000,135000,35000,1,00473,India
256330,2023-08-11,504,iron,449,879,430,1,00047,India
587651,2023-08-11,506,monitor,3249,8000,4751,1,00169,India
587651,2023-08-11,504,iron,449,879,430,1,00169,India
587651,2023-08-11,505,oven,18490,24000,5510,1,00169,India
587651,2023-08-11,503,mixer,1349,3249,1900,1,00169,India
891001,2023-08-11,504,iron,449,879,430,1,00100,India
891001,2023-08-11,505,oven,18490,24000,5510,1,00100,India
891001,2023-08-11,501,iphone 15,60000,80000,20000,1,00100,India
891001,2023-08-11,502,iphone 15 pro max,100000,135000,35000,1,00100,India
574667,2023-08-11,507,washing machine,6990,16490,9500,1,00485,India
574667,2023-08-11,501,iphone 15,60000,80000,20000,1,00485,India
574667,2023-08-11,504,iron,449,879,430,1,00485,India
574667,2023-08-11,506,monitor,3249,8000,4751,1,00485,India
574667,2023-08-11,503,mixer,1349,3249,1900,1,00485,India
507405,2023-08-11,507,washing machine,6990,16490,9500,1,00464,India
640743,2023-08-11,506,monitor,3249,8000,4751,1,00106,India
640743,2023-08-11,503,mixer,1349,3249,1900,1,00106,India
640743,2023-08-11,505,oven,18490,24000,5510,1,00106,India
778860,2023-08-11,507,washing machine,6990,16490,9500,1,00196,India
778860,2023-08-11,502,iphone 15 pro max,100000,135000,35000,1,00196,India
778860,2023-08-11,501,iphone 15,60000,80000,20000,1,00196,India
778860,2023-08-11,504,iron,449,879,430,1,00196,India
456348,2023-08-11,506,monitor,3249,8000,4751,1,00062,India
134348,2023-08-11,503,mixer,1349,3249,1900,1,00144,India
134348,2023-08-11,507,washing machine,6990,16490,9500,1,00144,India
134348,2023-08-11,501,iphone 15,60000,80000,20000,1,00144,India
716443,2023-08-11,507,washing machine,6990,16490,9500,1,00474,India
716443,2023-08-11,504,iron,449,879,430,1,00474,India
481128,2023-08-11,503,mixer,1349,3249,1900,1,00258,India
481128,2023-08-11,501,iphone 15,60000,80000,20000,1,00258,India
296258,2023-08-11,504,iron,449,879,430,1,00126,India
296258,2023-08-11,507,washing machine,6990,16490,9500,1,00126,India
296258,2023-08-11,501,iphone 15,60000,80000,20000,1,00126,India
943779,2023-08-11,502,iphone 15 pro max,100000,135000,35000,1,00290,India
943779,2023-08-11,505,oven,18490,24000,5510,1,00290,India
943779,2023-08-11,506,monitor,3249,8000,4751,1,00290,India
943779,2023-08-11,503,mixer,1349,3249,1900,1,00290,India
943779,2023-08-11,504,iron,449,879,430,1,00290,India
287275,2023-08-11,504,iron,449,879,430,1,00066,India
107415,2023-08-11,504,iron,449,879,430,1,00332,India
107415,2023-08-11,505,oven,18490,24000,5510,1,00332,India
795735,2023-08-11,501,iphone 15,60000,80000,20000,1,00205,India
795735,2023-08-11,506,monitor,3249,8000,4751,1,00205,India
795735,2023-08-11,507,washing machine,6990,16490,9500,1,00205,India
121056,2023-08-11,502,iphone 15 pro max,100000,135000,35000,1,00422,India
121056,2023-08-11,507,washing machine,6990,16490,9500,1,00422,India
158241,2023-08-11,507,washing machine,6990,16490,9500,1,00348,India
158241,2023-08-11,506,monitor,3249,8000,4751,1,00348,India
158241,2023-08-11,505,oven,18490,24000,5510,1,00348,India
158241,2023-08-11,501,iphone 15,60000,80000,20000,1,00348,India
125054,2023-08-11,501,iphone 15,60000,80000,20000,1,00406,India
125054,2023-08-11,505,oven,18490,24000,5510,1,00406,India
125054,2023-08-11,504,iron,449,879,430,1,00406,India
832231,2023-08-11,506,monitor,3249,8000,4751,1,00236,India
569887,2023-08-11,503,mixer,1349,3249,1900,1,00432,India
569887,2023-08-11,502,iphone 15 pro max,100000,135000,35000,1,00432,India
569887,2023-08-11,501,iphone 15,60000,80000,20000,1,00432,India
498225,2023-08-11,502,iphone 15 pro max,100000,135000,35000,1,00289,India
498225,2023-08-11,505,oven,18490,24000,5510,1,00289,India
723913,2023-08-11,501,iphone 15,60000,80000,20000,1,00060,India
723913,2023-08-11,505,oven,18490,24000,5510,1,00060,India
723913,2023-08-11,503,mixer,1349,3249,1900,1,00060,India
163865,2023-08-11,504,iron,449,879,430,1,00022,India
163865,2023-08-11,503,mixer,1349,3249,1900,1,00022,India
163865,2023-08-11,507,washing machine,6990,16490,9500,1,00022,India
125447,2023-08-11,506,monitor,3249,8000,4751,1,00304,India
711208,2023-08-11,502,iphone 15 pro max,100000,135000,35000,1,00158,India
711208,2023-08-11,505,oven,18490,24000,5510,1,00158,India
859132,2023-08-11,504,iron,449,879,430,1,00042,India
859132,2023-08-11,507,washing machine,6990,16490,9500,1,00042,India
509588,2023-08-11,503,mixer,1349,3249,1900,1,00364,India
509588,2023-08-11,507,washing machine,6990,16490,9500,1,00364,India
845336,2023-08-11,507,washing machine,6990,16490,9500,1,00335,India
358318,2023-08-11,501,iphone 15,60000,80000,20000,1,00386,India
358318,2023-08-11,503,mixer,1349,3249,1900,1,00386,India
358318,2023-08-11,506,monitor,3249,8000,4751,1,00386,India
539895,2023-08-11,503,mixer,1349,3249,1900,1,00030,India
563461,2023-08-11,503,mixer,1349,3249,1900,1,00152,India
563461,2023-08-11,501,iphone 15,60000,80000,20000,1,00152,India
563461,2023-08-11,507,washing machine,6990,16490,9500,1,00152,India
881099,2023-08-11,501,iphone 15,60000,80000,20000,1,00435,India
140875,2023-08-11,504,iron,449,879,430,1,00159,India
140875,2023-08-11,506,monitor,3249,8000,4751,1,00159,India
140875,2023-08-11,507,washing machine,6990,16490,9500,1,00159,India
754043,2023-08-11,504,iron,449,879,430,1,00079,India
994891,2023-08-11,505,oven,18490,24000,5510,1,00157,India
994891,2023-08-11,502,iphone 15 pro max,100000,135000,35000,1,00157,India
427773,2023-08-11,502,iphone 15 pro max,100000,135000,35000,1,00427,India
427773,2023-08-11,507,washing machine,6990,16490,9500,1,00427,India
352647,2023-08-11,505,oven,18490,24000,5510,1,00217,India
352647,2023-08-11,502,iphone 15 pro max,100000,135000,35000,1,00217,India
352647,2023-08-11,507,washing machine,6990,16490,9500,1,00217,India
749846,2023-08-11,507,washing machine,6990,16490,9500,1,00149,India
621943,2023-08-11,506,monitor,3249,8000,4751,1,00028,India
621943,2023-08-11,507,washing machine,6990,16490,9500,1,00028,India
818906,2023-08-11,504,iron,449,879,430,1,00397,India
155096,2023-08-11,502,iphone 15 pro max,100000,135000,35000,1,00223,India
155096,2023-08-11,507,washing machine,6990,16490,9500,1,00223,India
601321,2023-08-11,501,iphone 15,60000,80000,20000,1,00089,India
835413,2023-08-11,507,washing machine,6990,16490,9500,1,00174,India
835413,2023-08-11,503,mixer,1349,3249,1900,1,00174,India
835413,2023-08-11,502,iphone 15 pro max,100000,135000,35000,1,00174,India
835413,2023-08-11,504,iron,449,879,430,1,00174,India
133275,2023-08-11,504,iron,449,879,430,1,00410,India
133275,2023-08-11,501,iphone 15,60000,80000,20000,1,00410,India
477884,2023-08-11,506,monitor,3249,8000,4751,1,00417,India
107633,2023-08-11,502,iphone 15 pro max,100000,135000,35000,1,00012,India
107633,2023-08-11,504,iron,449,879,430,1,00012,India
281254,2023-08-11,507,washing machine,6990,16490,9500,1,00430,India
281254,2023-08-11,506,monitor,3249,8000,4751,1,00430,India
981517,2023-08-11,501,iphone 15,60000,80000,20000,1,00289,India
154307,2023-08-11,507,washing machine,6990,16490,9500,1,00462,India
527927,2023-08-11,507,washing machine,6990,16490,9500,1,00326,India
359338,2023-08-11,503,mixer,1349,3249,1900,1,00119,India
359338,2023-08-11,502,iphone 15 pro max,100000,135000,35000,1,00119,India
359338,2023-08-11,506,monitor,3249,8000,4751,1,00119,India
359338,2023-08-11,501,iphone 15,60000,80000,20000,1,00119,India
582014,2023-08-11,507,washing machine,6990,16490,9500,1,00489,India
582014,2023-08-11,501,iphone 15,60000,80000,20000,1,00489,India
582014,2023-08-11,506,monitor,3249,8000,4751,1,00489,India
537317,2023-08-11,501,iphone 15,60000,80000,20000,1,00053,India
330926,2023-08-11,507,washing machine,6990,16490,9500,1,00445,India
330926,2023-08-11,504,iron,449,879,430,1,00445,India
604015,2023-08-11,503,mixer,1349,3249,1900,1,00066,India
521030,2023-08-11,502,iphone 15 pro max,100000,135000,35000,1,00078,India
198966,2023-08-11,501,iphone 15,60000,80000,20000,1,00187,India
198966,2023-08-11,506,monitor,3249,8000,4751,1,00187,India
198966,2023-08-11,502,iphone 15 pro max,100000,135000,35000,1,00187,India
198966,2023-08-11,504,iron,449,879,430,1,00187,India
214681,2023-08-11,505,oven,18490,24000,5510,1,00500,India
214681,2023-08-11,501,iphone 15,60000,80000,20000,1,00500,India
960854,2023-08-11,503,mixer,1349,3249,1900,1,00220,India
484756,2023-08-11,507,washing machine,6990,16490,9500,1,00438,India
132942,2023-08-11,504,iron,449,879,430,1,00442,India
132942,2023-08-11,502,iphone 15 pro max,100000,135000,35000,1,00442,India
132942,2023-08-11,507,washing machine,6990,16490,9500,1,00442,India
712878,2023-08-11,502,iphone 15 pro max,100000,135000,35000,1,00079,India
712878,2023-08-11,506,monitor,3249,8000,4751,1,00079,India
712878,2023-08-11,507,washing machine,6990,16490,9500,1,00079,India
229373,2023-08-11,506,monitor,3249,8000,4751,1,00451,India
971726,2023-08-11,502,iphone 15 pro max,100000,135000,35000,1,00435,India
971726,2023-08-11,504,iron,449,879,430,1,00435,India
971726,2023-08-11,507,washing machine,6990,16490,9500,1,00435,India
971726,2023-08-11,503,mixer,1349,3249,1900,1,00435,India
197586,2023-08-11,505,oven,18490,24000,5510,1,00347,India
197586,2023-08-11,503,mixer,1349,3249,1900,1,00347,India
977906,2023-08-11,504,iron,449,879,430,1,00302,India
977906,2023-08-11,505,oven,18490,24000,5510,1,00302,India
977906,2023-08-11,503,mixer,1349,3249,1900,1,00302,India
877852,2023-08-11,504,iron,449,879,430,1,00498,India
877852,2023-08-11,507,washing machine,6990,16490,9500,1,00498,India
877852,2023-08-11,502,iphone 15 pro max,100000,135000,35000,1,00498,India
197455,2023-08-11,507,washing machine,6990,16490,9500,1,00017,India
197455,2023-08-11,505,oven,18490,24000,5510,1,00017,India
559443,2023-08-11,505,oven,18490,24000,5510,1,00069,India
380857,2023-08-11,507,washing machine,6990,16490,9500,1,00453,India
380857,2023-08-11,505,oven,18490,24000,5510,1,00453,India
380857,2023-08-11,506,monitor,3249,8000,4751,1,00453,India
380857,2023-08-11,504,iron,449,879,430,1,00453,India
830389,2023-08-11,506,monitor,3249,8000,4751,1,00195,India
131065,2023-08-11,504,iron,449,879,430,1,00369,India
261643,2023-08-11,505,oven,18490,24000,5510,1,00174,India
261643,2023-08-11,503,mixer,1349,3249,1900,1,00174,India
312251,2023-08-11,504,iron,449,879,430,1,00119,India
312251,2023-08-11,505,oven,18490,24000,5510,1,00119,India
312251,2023-08-11,503,mixer,1349,3249,1900,1,00119,India
417976,2023-08-12,504,iron,449,879,430,1,00474,India
417976,2023-08-12,507,washing machine,6990,16490,9500,1,00474,India
417976,2023-08-12,501,iphone 15,60000,80000,20000,1,00474,India
466558,2023-08-12,505,oven,18490,24000,5510,1,00423,India
466558,2023-08-12,506,monitor,3249,8000,4751,1,00423,India
466558,2023-08-12,503,mixer,1349,3249,1900,1,00423,India
210775,2023-08-12,502,iphone 15 pro max,100000,135000,35000,1,00065,India
210775,2023-08-12,506,monitor,3249,8000,4751,1,00065,India
210775,2023-08-12,507,washing machine,6990,16490,9500,1,00065,India
452985,2023-08-12,507,washing machine,6990,16490,9500,1,00093,India
452985,2023-08-12,505,oven,18490,24000,5510,1,00093,India
452985,2023-08-12,506,monitor,3249,8000,4751,1,00093,India
566638,2023-08-12,502,iphone 15 pro max,100000,135000,35000,1,00393,India
566638,2023-08-12,507,washing machine,6990,16490,9500,1,00393,India
566638,2023-08-12,501,iphone 15,60000,80000,20000,1,00393,India
566638,2023-08-12,504,iron,449,879,430,1,00393,India
986509,2023-08-12,505,oven,18490,24000,5510,1,00347,India
986509,2023-08-12,501,iphone 15,60000,80000,20000,1,00347,India
986509,2023-08-12,507,washing machine,6990,16490,9500,1,00347,India
986509,2023-08-12,506,monitor,3249,8000,4751,1,00347,India
147609,2023-08-12,505,oven,18490,24000,5510,1,00130,India
734629,2023-08-12,504,iron,449,879,430,1,00428,India
734629,2023-08-12,501,iphone 15,60000,80000,20000,1,00428,India
284637,2023-08-12,501,iphone 15,60000,80000,20000,1,00471,India
284637,2023-08-12,506,monitor,3249,8000,4751,1,00471,India
733081,2023-08-12,504,iron,449,879,430,1,00488,India
733081,2023-08-12,503,mixer,1349,3249,1900,1,00488,India
733081,2023-08-12,502,iphone 15 pro max,100000,135000,35000,1,00488,India
733081,2023-08-12,501,iphone 15,60000,80000,20000,1,00488,India
865167,2023-08-12,505,oven,18490,24000,5510,1,00274,India
865167,2023-08-12,503,mixer,1349,3249,1900,1,00274,India
865167,2023-08-12,507,washing machine,6990,16490,9500,1,00274,India
247221,2023-08-12,507,washing machine,6990,16490,9500,1,00496,India
588585,2023-08-12,505,oven,18490,24000,5510,1,00162,India
588585,2023-08-12,507,washing machine,6990,16490,9500,1,00162,India
588585,2023-08-12,502,iphone 15 pro max,100000,135000,35000,1,00162,India
471906,2023-08-12,501,iphone 15,60000,80000,20000,1,00420,India
471906,2023-08-12,505,oven,18490,24000,5510,1,00420,India
471906,2023-08-12,502,iphone 15 pro max,100000,135000,35000,1,00420,India
142192,2023-08-12,501,iphone 15,60000,80000,20000,1,00310,India
126716,2023-08-12,502,iphone 15 pro max,100000,135000,35000,1,00411,India
126716,2023-08-12,503,mixer,1349,3249,1900,1,00411,India
126716,2023-08-12,505,oven,18490,24000,5510,1,00411,India
789132,2023-08-12,505,oven,18490,24000,5510,1,00358,India
789132,2023-08-12,501,iphone 15,60000,80000,20000,1,00358,India
789132,2023-08-12,502,iphone 15 pro max,100000,135000,35000,1,00358,India
789132,2023-08-12,507,washing machine,6990,16490,9500,1,00358,India
789132,2023-08-12,504,iron,449,879,430,1,00358,India
158961,2023-08-12,505,oven,18490,24000,5510,1,00269,India
158961,2023-08-12,504,iron,449,879,430,1,00269,India
158961,2023-08-12,503,mixer,1349,3249,1900,1,00269,India
789858,2023-08-12,507,washing machine,6990,16490,9500,1,00154,India
789858,2023-08-12,502,iphone 15 pro max,100000,135000,35000,1,00154,India
772306,2023-08-12,503,mixer,1349,3249,1900,1,00341,India
819449,2023-08-12,503,mixer,1349,3249,1900,1,00310,India
819449,2023-08-12,507,washing machine,6990,16490,9500,1,00310,India
819449,2023-08-12,506,monitor,3249,8000,4751,1,00310,India
853938,2023-08-12,507,washing machine,6990,16490,9500,1,00489,India
853938,2023-08-12,501,iphone 15,60000,80000,20000,1,00489,India
853938,2023-08-12,506,monitor,3249,8000,4751,1,00489,India
853938,2023-08-12,504,iron,449,879,430,1,00489,India
639592,2023-08-12,505,oven,18490,24000,5510,1,00156,India
639592,2023-08-12,501,iphone 15,60000,80000,20000,1,00156,India
639592,2023-08-12,503,mixer,1349,3249,1900,1,00156,India
890813,2023-08-12,502,iphone 15 pro max,100000,135000,35000,1,00272,India
890813,2023-08-12,501,iphone 15,60000,80000,20000,1,00272,India
890813,2023-08-12,507,washing machine,6990,16490,9500,1,00272,India
201403,2023-08-12,502,iphone 15 pro max,100000,135000,35000,1,00399,India
201403,2023-08-12,501,iphone 15,60000,80000,20000,1,00399,India
201403,2023-08-12,506,monitor,3249,8000,4751,1,00399,India
696758,2023-08-12,501,iphone 15,60000,80000,20000,1,00227,India
696758,2023-08-12,505,oven,18490,24000,5510,1,00227,India
724417,2023-08-12,504,iron,449,879,430,1,00452,India
201292,2023-08-12,502,iphone 15 pro max,100000,135000,35000,1,00286,India
328784,2023-08-12,506,monitor,3249,8000,4751,1,00301,India
328784,2023-08-12,501,iphone 15,60000,80000,20000,1,00301,India
328784,2023-08-12,502,iphone 15 pro max,100000,135000,35000,1,00301,India
873765,2023-08-12,506,monitor,3249,8000,4751,1,00098,India
873765,2023-08-12,507,washing machine,6990,16490,9500,1,00098,India
743366,2023-08-12,503,mixer,1349,3249,1900,1,00433,India
743366,2023-08-12,502,iphone 15 pro max,100000,135000,35000,1,00433,India
630808,2023-08-12,504,iron,449,879,430,1,00191,India
630808,2023-08-12,505,oven,18490,24000,5510,1,00191,India
630808,2023-08-12,503,mixer,1349,3249,1900,1,00191,India
630808,2023-08-12,502,iphone 15 pro max,100000,135000,35000,1,00191,India
630808,2023-08-12,501,iphone 15,60000,80000,20000,1,00191,India
764269,2023-08-12,501,iphone 15,60000,80000,20000,1,00094,India
764269,2023-08-12,505,oven,18490,24000,5510,1,00094,India
614510,2023-08-12,503,mixer,1349,3249,1900,1,00370,India
614510,2023-08-12,502,iphone 15 pro max,100000,135000,35000,1,00370,India
614510,2023-08-12,501,iphone 15,60000,80000,20000,1,00370,India
614510,2023-08-12,504,iron,449,879,430,1,00370,India
748090,2023-08-12,501,iphone 15,60000,80000,20000,1,00356,India
748090,2023-08-12,505,oven,18490,24000,5510,1,00356,India
748090,2023-08-12,506,monitor,3249,8000,4751,1,00356,India
748090,2023-08-12,502,iphone 15 pro max,100000,135000,35000,1,00356,India
838519,2023-08-12,504,iron,449,879,430,1,00183,India
602575,2023-08-12,502,iphone 15 pro max,100000,135000,35000,1,00481,India
602575,2023-08-12,505,oven,18490,24000,5510,1,00481,India
755053,2023-08-12,501,iphone 15,60000,80000,20000,1,00474,India
342701,2023-08-12,507,washing machine,6990,16490,9500,1,00115,India
342701,2023-08-12,501,iphone 15,60000,80000,20000,1,00115,India
631253,2023-08-12,506,monitor,3249,8000,4751,1,00089,India
631253,2023-08-12,507,washing machine,6990,16490,9500,1,00089,India
217840,2023-08-12,505,oven,18490,24000,5510,1,00065,India
653882,2023-08-12,504,iron,449,879,430,1,00418,India
653882,2023-08-12,506,monitor,3249,8000,4751,1,00418,India
653882,2023-08-12,503,mixer,1349,3249,1900,1,00418,India
653882,2023-08-12,501,iphone 15,60000,80000,20000,1,00418,India
139355,2023-08-12,507,washing machine,6990,16490,9500,1,00266,India
163101,2023-08-12,506,monitor,3249,8000,4751,1,00132,India
163101,2023-08-12,502,iphone 15 pro max,100000,135000,35000,1,00132,India
163101,2023-08-12,507,washing machine,6990,16490,9500,1,00132,India
665315,2023-08-12,507,washing machine,6990,16490,9500,1,00180,India
265540,2023-08-12,507,washing machine,6990,16490,9500,1,00015,India
244146,2023-08-12,502,iphone 15 pro max,100000,135000,35000,1,00435,India
244146,2023-08-12,501,iphone 15,60000,80000,20000,1,00435,India
244146,2023-08-12,506,monitor,3249,8000,4751,1,00435,India
644391,2023-08-12,502,iphone 15 pro max,100000,135000,35000,1,00229,India
513645,2023-08-12,505,oven,18490,24000,5510,1,00046,India
513645,2023-08-12,502,iphone 15 pro max,100000,135000,35000,1,00046,India
683620,2023-08-12,502,iphone 15 pro max,100000,135000,35000,1,00486,India
683620,2023-08-12,504,iron,449,879,430,1,00486,India
911778,2023-08-12,501,iphone 15,60000,80000,20000,1,00096,India
911778,2023-08-12,505,oven,18490,24000,5510,1,00096,India
911778,2023-08-12,507,washing machine,6990,16490,9500,1,00096,India
911778,2023-08-12,502,iphone 15 pro max,100000,135000,35000,1,00096,India
432438,2023-08-12,503,mixer,1349,3249,1900,1,00342,India
432438,2023-08-12,505,oven,18490,24000,5510,1,00342,India
432438,2023-08-12,501,iphone 15,60000,80000,20000,1,00342,India
432438,2023-08-12,504,iron,449,879,430,1,00342,India
432438,2023-08-12,502,iphone 15 pro max,100000,135000,35000,1,00342,India
751308,2023-08-12,507,washing machine,6990,16490,9500,1,00071,India
751308,2023-08-12,506,monitor,3249,8000,4751,1,00071,India
311267,2023-08-12,501,iphone 15,60000,80000,20000,1,00152,India
585549,2023-08-12,503,mixer,1349,3249,1900,1,00024,India
585549,2023-08-12,507,washing machine,6990,16490,9500,1,00024,India
585549,2023-08-12,501,iphone 15,60000,80000,20000,1,00024,India
572117,2023-08-13,502,iphone 15 pro max,100000,135000,35000,1,00242,India
572117,2023-08-13,503,mixer,1349,3249,1900,1,00242,India
467338,2023-08-13,506,monitor,3249,8000,4751,1,00165,India
640134,2023-08-13,505,oven,18490,24000,5510,1,00006,India
127752,2023-08-13,501,iphone 15,60000,80000,20000,1,00458,India
432444,2023-08-13,504,iron,449,879,430,1,00465,India
432444,2023-08-13,501,iphone 15,60000,80000,20000,1,00465,India
432444,2023-08-13,502,iphone 15 pro max,100000,135000,35000,1,00465,India
432444,2023-08-13,505,oven,18490,24000,5510,1,00465,India
644430,2023-08-13,507,washing machine,6990,16490,9500,1,00436,India
644430,2023-08-13,502,iphone 15 pro max,100000,135000,35000,1,00436,India
644430,2023-08-13,503,mixer,1349,3249,1900,1,00436,India
644430,2023-08-13,501,iphone 15,60000,80000,20000,1,00436,India
513294,2023-08-13,505,oven,18490,24000,5510,1,00174,India
513294,2023-08-13,501,iphone 15,60000,80000,20000,1,00174,India
513294,2023-08-13,503,mixer,1349,3249,1900,1,00174,India
152362,2023-08-13,501,iphone 15,60000,80000,20000,1,00145,India
152362,2023-08-13,506,monitor,3249,8000,4751,1,00145,India
152362,2023-08-13,504,iron,449,879,430,1,00145,India
152362,2023-08-13,503,mixer,1349,3249,1900,1,00145,India
420049,2023-08-13,501,iphone 15,60000,80000,20000,1,00337,India
420049,2023-08-13,507,washing machine,6990,16490,9500,1,00337,India
420049,2023-08-13,506,monitor,3249,8000,4751,1,00337,India
850859,2023-08-13,502,iphone 15 pro max,100000,135000,35000,1,00082,India
850859,2023-08-13,501,iphone 15,60000,80000,20000,1,00082,India
850859,2023-08-13,507,washing machine,6990,16490,9500,1,00082,India
807414,2023-08-13,505,oven,18490,24000,5510,1,00345,India
807414,2023-08-13,501,iphone 15,60000,80000,20000,1,00345,India
807414,2023-08-13,503,mixer,1349,3249,1900,1,00345,India
807414,2023-08-13,507,washing machine,6990,16490,9500,1,00345,India
271075,2023-08-13,502,iphone 15 pro max,100000,135000,35000,1,00201,India
271075,2023-08-13,505,oven,18490,24000,5510,1,00201,India
370049,2023-08-13,501,iphone 15,60000,80000,20000,1,00483,India
370049,2023-08-13,506,monitor,3249,8000,4751,1,00483,India
370049,2023-08-13,505,oven,18490,24000,5510,1,00483,India
682674,2023-08-13,502,iphone 15 pro max,100000,135000,35000,1,00271,India
682674,2023-08-13,507,washing machine,6990,16490,9500,1,00271,India
867874,2023-08-13,503,mixer,1349,3249,1900,1,00020,India
867874,2023-08-13,502,iphone 15 pro max,100000,135000,35000,1,00020,India
867874,2023-08-13,501,iphone 15,60000,80000,20000,1,00020,India
660387,2023-08-13,504,iron,449,879,430,1,00471,India
323586,2023-08-13,502,iphone 15 pro max,100000,135000,35000,1,00269,India
323586,2023-08-13,503,mixer,1349,3249,1900,1,00269,India
323586,2023-08-13,501,iphone 15,60000,80000,20000,1,00269,India
554960,2023-08-13,506,monitor,3249,8000,4751,1,00464,India
554960,2023-08-13,502,iphone 15 pro max,100000,135000,35000,1,00464,India
711413,2023-08-13,507,washing machine,6990,16490,9500,1,00043,India
711413,2023-08-13,506,monitor,3249,8000,4751,1,00043,India
206994,2023-08-13,503,mixer,1349,3249,1900,1,00227,India
338272,2023-08-13,507,washing machine,6990,16490,9500,1,00163,India
338272,2023-08-13,506,monitor,3249,8000,4751,1,00163,India
338272,2023-08-13,504,iron,449,879,430,1,00163,India
338272,2023-08-13,503,mixer,1349,3249,1900,1,00163,India
535877,2023-08-13,501,iphone 15,60000,80000,20000,1,00483,India
535877,2023-08-13,503,mixer,1349,3249,1900,1,00483,India
535877,2023-08-13,504,iron,449,879,430,1,00483,India
192894,2023-08-13,507,washing machine,6990,16490,9500,1,00325,India
192894,2023-08-13,504,iron,449,879,430,1,00325,India
593312,2023-08-13,503,mixer,1349,3249,1900,1,00117,India
621417,2023-08-13,505,oven,18490,24000,5510,1,00223,India
774044,2023-08-13,505,oven,18490,24000,5510,1,00145,India
774044,2023-08-13,507,washing machine,6990,16490,9500,1,00145,India
337501,2023-08-13,502,iphone 15 pro max,100000,135000,35000,1,00143,India
337501,2023-08-13,503,mixer,1349,3249,1900,1,00143,India
337501,2023-08-13,505,oven,18490,24000,5510,1,00143,India
314353,2023-08-13,504,iron,449,879,430,1,00494,India
223309,2023-08-13,507,washing machine,6990,16490,9500,1,00344,India
223309,2023-08-13,505,oven,18490,24000,5510,1,00344,India
451602,2023-08-13,505,oven,18490,24000,5510,1,00298,India
447935,2023-08-13,507,washing machine,6990,16490,9500,1,00046,India
447935,2023-08-13,501,iphone 15,60000,80000,20000,1,00046,India
447935,2023-08-13,506,monitor,3249,8000,4751,1,00046,India
447935,2023-08-13,505,oven,18490,24000,5510,1,00046,India
244288,2023-08-13,502,iphone 15 pro max,100000,135000,35000,1,00211,India
244288,2023-08-13,503,mixer,1349,3249,1900,1,00211,India
280937,2023-08-13,501,iphone 15,60000,80000,20000,1,00017,India
736782,2023-08-13,503,mixer,1349,3249,1900,1,00151,India
736782,2023-08-13,505,oven,18490,24000,5510,1,00151,India
651376,2023-08-13,501,iphone 15,60000,80000,20000,1,00332,India
705878,2023-08-13,506,monitor,3249,8000,4751,1,00360,India
705878,2023-08-13,503,mixer,1349,3249,1900,1,00360,India
705878,2023-08-13,504,iron,449,879,430,1,00360,India
627980,2023-08-13,504,iron,449,879,430,1,00073,India
627980,2023-08-13,501,iphone 15,60000,80000,20000,1,00073,India
627980,2023-08-13,502,iphone 15 pro max,100000,135000,35000,1,00073,India
658858,2023-08-13,501,iphone 15,60000,80000,20000,1,00172,India
658858,2023-08-13,507,washing machine,6990,16490,9500,1,00172,India
658858,2023-08-13,505,oven,18490,24000,5510,1,00172,India
658858,2023-08-13,502,iphone 15 pro max,100000,135000,35000,1,00172,India
403909,2023-08-13,503,mixer,1349,3249,1900,1,00422,India
403909,2023-08-13,507,washing machine,6990,16490,9500,1,00422,India
403909,2023-08-13,505,oven,18490,24000,5510,1,00422,India
403909,2023-08-13,506,monitor,3249,8000,4751,1,00422,India
829534,2023-08-13,501,iphone 15,60000,80000,20000,1,00176,India
829534,2023-08-13,502,iphone 15 pro max,100000,135000,35000,1,00176,India
829534,2023-08-13,507,washing machine,6990,16490,9500,1,00176,India
108534,2023-08-13,507,washing machine,6990,16490,9500,1,00049,India
108534,2023-08-13,502,iphone 15 pro max,100000,135000,35000,1,00049,India
108534,2023-08-13,506,monitor,3249,8000,4751,1,00049,India
108534,2023-08-13,504,iron,449,879,430,1,00049,India
108534,2023-08-13,501,iphone 15,60000,80000,20000,1,00049,India
248244,2023-08-13,505,oven,18490,24000,5510,1,00085,India
248244,2023-08-13,501,iphone 15,60000,80000,20000,1,00085,India
248244,2023-08-13,507,washing machine,6990,16490,9500,1,00085,India
248244,2023-08-13,506,monitor,3249,8000,4751,1,00085,India
182716,2023-08-13,505,oven,18490,24000,5510,1,00367,India
182716,2023-08-13,503,mixer,1349,3249,1900,1,00367,India
182716,2023-08-13,502,iphone 15 pro max,100000,135000,35000,1,00367,India
182716,2023-08-13,507,washing machine,6990,16490,9500,1,00367,India
519311,2023-08-13,506,monitor,3249,8000,4751,1,00150,India
573036,2023-08-13,502,iphone 15 pro max,100000,135000,35000,1,00085,India
573036,2023-08-13,505,oven,18490,24000,5510,1,00085,India
364205,2023-08-13,505,oven,18490,24000,5510,1,00476,India
364205,2023-08-13,502,iphone 15 pro max,100000,135000,35000,1,00476,India
364205,2023-08-13,506,monitor,3249,8000,4751,1,00476,India
364205,2023-08-13,501,iphone 15,60000,80000,20000,1,00476,India
364205,2023-08-13,503,mixer,1349,3249,1900,1,00476,India
639433,2023-08-13,505,oven,18490,24000,5510,1,00046,India
639433,2023-08-13,506,monitor,3249,8000,4751,1,00046,India
156016,2023-08-13,506,monitor,3249,8000,4751,1,00483,India
156016,2023-08-13,507,washing machine,6990,16490,9500,1,00483,India
156016,2023-08-13,503,mixer,1349,3249,1900,1,00483,India
156016,2023-08-13,504,iron,449,879,430,1,00483,India
395165,2023-08-13,501,iphone 15,60000,80000,20000,1,00050,India
395165,2023-08-13,506,monitor,3249,8000,4751,1,00050,India
530503,2023-08-13,502,iphone 15 pro max,100000,135000,35000,1,00069,India
530503,2023-08-13,505,oven,18490,24000,5510,1,00069,India
530503,2023-08-13,504,iron,449,879,430,1,00069,India
165424,2023-08-13,504,iron,449,879,430,1,00385,India
165424,2023-08-13,501,iphone 15,60000,80000,20000,1,00385,India
412272,2023-08-13,503,mixer,1349,3249,1900,1,00189,India
412272,2023-08-13,501,iphone 15,60000,80000,20000,1,00189,India
412272,2023-08-13,507,washing machine,6990,16490,9500,1,00189,India
418252,2023-08-13,503,mixer,1349,3249,1900,1,00161,India
418252,2023-08-13,505,oven,18490,24000,5510,1,00161,India
418252,2023-08-13,507,washing machine,6990,16490,9500,1,00161,India
592626,2023-08-13,502,iphone 15 pro max,100000,135000,35000,1,00074,India
592626,2023-08-13,506,monitor,3249,8000,4751,1,00074,India
592626,2023-08-13,507,washing machine,6990,16490,9500,1,00074,India
592626,2023-08-13,505,oven,18490,24000,5510,1,00074,India
327093,2023-08-13,504,iron,449,879,430,1,00226,India
327093,2023-08-13,502,iphone 15 pro max,100000,135000,35000,1,00226,India
296094,2023-08-13,501,iphone 15,60000,80000,20000,1,00036,India
296094,2023-08-13,505,oven,18490,24000,5510,1,00036,India
296094,2023-08-13,502,iphone 15 pro max,100000,135000,35000,1,00036,India
296094,2023-08-13,507,washing machine,6990,16490,9500,1,00036,India
497544,2023-08-13,502,iphone 15 pro max,100000,135000,35000,1,00252,India
497544,2023-08-13,504,iron,449,879,430,1,00252,India
985489,2023-08-13,503,mixer,1349,3249,1900,1,00375,India
985489,2023-08-13,502,iphone 15 pro max,100000,135000,35000,1,00375,India
462143,2023-08-13,502,iphone 15 pro max,100000,135000,35000,1,00264,India
462143,2023-08-13,507,washing machine,6990,16490,9500,1,00264,India
462143,2023-08-13,504,iron,449,879,430,1,00264,India
462143,2023-08-13,501,iphone 15,60000,80000,20000,1,00264,India
755984,2023-08-13,501,iphone 15,60000,80000,20000,1,00144,India
755984,2023-08-13,506,monitor,3249,8000,4751,1,00144,India
730534,2023-08-13,507,washing machine,6990,16490,9500,1,00131,India
730534,2023-08-13,502,iphone 15 pro max,100000,135000,35000,1,00131,India
601730,2023-08-13,507,washing machine,6990,16490,9500,1,00041,India
601730,2023-08-13,501,iphone 15,60000,80000,20000,1,00041,India
601730,2023-08-13,506,monitor,3249,8000,4751,1,00041,India
601730,2023-08-13,502,iphone 15 pro max,100000,135000,35000,1,00041,India
769607,2023-08-13,502,iphone 15 pro max,100000,135000,35000,1,00278,India
769607,2023-08-13,501,iphone 15,60000,80000,20000,1,00278,India
769607,2023-08-13,505,oven,18490,24000,5510,1,00278,India
418467,2023-08-13,501,iphone 15,60000,80000,20000,1,00223,India
137929,2023-08-13,504,iron,449,879,430,1,00496,India
227891,2023-08-13,501,iphone 15,60000,80000,20000,1,00486,India
795678,2023-08-13,504,iron,449,879,430,1,00219,India
795678,2023-08-13,507,washing machine,6990,16490,9500,1,00219,India
135141,2023-08-13,506,monitor,3249,8000,4751,1,00144,India
135141,2023-08-13,507,washing machine,6990,16490,9500,1,00144,India
135141,2023-08-13,504,iron,449,879,430,1,00144,India
788003,2023-08-13,507,washing machine,6990,16490,9500,1,00364,India
972162,2023-08-13,503,mixer,1349,3249,1900,1,00186,India
972162,2023-08-13,505,oven,18490,24000,5510,1,00186,India
938437,2023-08-14,507,washing machine,6990,16490,9500,1,00418,India
938437,2023-08-14,501,iphone 15,60000,80000,20000,1,00418,India
938437,2023-08-14,502,iphone 15 pro max,100000,135000,35000,1,00418,India
436277,2023-08-14,504,iron,449,879,430,1,00107,India
436277,2023-08-14,506,monitor,3249,8000,4751,1,00107,India
436277,2023-08-14,503,mixer,1349,3249,1900,1,00107,India
436277,2023-08-14,505,oven,18490,24000,5510,1,00107,India
772748,2023-08-14,502,iphone 15 pro max,100000,135000,35000,1,00233,India
772748,2023-08-14,501,iphone 15,60000,80000,20000,1,00233,India
772748,2023-08-14,505,oven,18490,24000,5510,1,00233,India
772748,2023-08-14,504,iron,449,879,430,1,00233,India
557787,2023-08-14,501,iphone 15,60000,80000,20000,1,00206,India
557787,2023-08-14,506,monitor,3249,8000,4751,1,00206,India
557787,2023-08-14,502,iphone 15 pro max,100000,135000,35000,1,00206,India
781021,2023-08-14,501,iphone 15,60000,80000,20000,1,00459,India
781021,2023-08-14,507,washing machine,6990,16490,9500,1,00459,India
781021,2023-08-14,504,iron,449,879,430,1,00459,India
166957,2023-08-14,506,monitor,3249,8000,4751,1,00025,India
166957,2023-08-14,503,mixer,1349,3249,1900,1,00025,India
166957,2023-08-14,504,iron,449,879,430,1,00025,India
166957,2023-08-14,505,oven,18490,24000,5510,1,00025,India
349019,2023-08-14,502,iphone 15 pro max,100000,135000,35000,1,00357,India
349019,2023-08-14,501,iphone 15,60000,80000,20000,1,00357,India
587251,2023-08-14,502,iphone 15 pro max,100000,135000,35000,1,00230,India
587251,2023-08-14,507,washing machine,6990,16490,9500,1,00230,India
587251,2023-08-14,505,oven,18490,24000,5510,1,00230,India
389028,2023-08-14,501,iphone 15,60000,80000,20000,1,00401,India
769114,2023-08-14,502,iphone 15 pro max,100000,135000,35000,1,00395,India
769114,2023-08-14,505,oven,18490,24000,5510,1,00395,India
251933,2023-08-14,504,iron,449,879,430,1,00100,India
251933,2023-08-14,503,mixer,1349,3249,1900,1,00100,India
251933,2023-08-14,501,iphone 15,60000,80000,20000,1,00100,India
341800,2023-08-14,503,mixer,1349,3249,1900,1,00192,India
341800,2023-08-14,507,washing machine,6990,16490,9500,1,00192,India
860674,2023-08-14,501,iphone 15,60000,80000,20000,1,00071,India
853953,2023-08-14,504,iron,449,879,430,1,00491,India
853953,2023-08-14,502,iphone 15 pro max,100000,135000,35000,1,00491,India
904659,2023-08-14,507,washing machine,6990,16490,9500,1,00251,India
904659,2023-08-14,504,iron,449,879,430,1,00251,India
904659,2023-08-14,505,oven,18490,24000,5510,1,00251,India
904659,2023-08-14,503,mixer,1349,3249,1900,1,00251,India
751505,2023-08-14,506,monitor,3249,8000,4751,1,00398,India
751505,2023-08-14,501,iphone 15,60000,80000,20000,1,00398,India
821834,2023-08-14,504,iron,449,879,430,1,00357,India
821834,2023-08-14,503,mixer,1349,3249,1900,1,00357,India
821834,2023-08-14,505,oven,18490,24000,5510,1,00357,India
623805,2023-08-14,505,oven,18490,24000,5510,1,00180,India
623805,2023-08-14,504,iron,449,879,430,1,00180,India
623805,2023-08-14,502,iphone 15 pro max,100000,135000,35000,1,00180,India
623805,2023-08-14,503,mixer,1349,3249,1900,1,00180,India
249969,2023-08-14,506,monitor,3249,8000,4751,1,00179,India
952876,2023-08-14,506,monitor,3249,8000,4751,1,00406,India
532127,2023-08-14,505,oven,18490,24000,5510,1,00350,India
532127,2023-08-14,503,mixer,1349,3249,1900,1,00350,India
532127,2023-08-14,501,iphone 15,60000,80000,20000,1,00350,India
532127,2023-08-14,502,iphone 15 pro max,100000,135000,35000,1,00350,India
914816,2023-08-14,505,oven,18490,24000,5510,1,00457,India
914816,2023-08-14,504,iron,449,879,430,1,00457,India
914816,2023-08-14,507,washing machine,6990,16490,9500,1,00457,India
773225,2023-08-14,503,mixer,1349,3249,1900,1,00360,India
773225,2023-08-14,502,iphone 15 pro max,100000,135000,35000,1,00360,India
773225,2023-08-14,507,washing machine,6990,16490,9500,1,00360,India
773225,2023-08-14,505,oven,18490,24000,5510,1,00360,India
592902,2023-08-14,505,oven,18490,24000,5510,1,00146,India
592902,2023-08-14,506,monitor,3249,8000,4751,1,00146,India
592902,2023-08-14,507,washing machine,6990,16490,9500,1,00146,India
199690,2023-08-14,502,iphone 15 pro max,100000,135000,35000,1,00298,India
199690,2023-08-14,504,iron,449,879,430,1,00298,India
199690,2023-08-14,506,monitor,3249,8000,4751,1,00298,India
444489,2023-08-14,503,mixer,1349,3249,1900,1,00309,India
444489,2023-08-14,501,iphone 15,60000,80000,20000,1,00309,India
444489,2023-08-14,502,iphone 15 pro max,100000,135000,35000,1,00309,India
364990,2023-08-14,502,iphone 15 pro max,100000,135000,35000,1,00320,India
500086,2023-08-14,501,iphone 15,60000,80000,20000,1,00421,India
500086,2023-08-14,503,mixer,1349,3249,1900,1,00421,India
161882,2023-08-14,502,iphone 15 pro max,100000,135000,35000,1,00066,India
161882,2023-08-14,504,iron,449,879,430,1,00066,India
862101,2023-08-14,505,oven,18490,24000,5510,1,00497,India
401023,2023-08-14,507,washing machine,6990,16490,9500,1,00479,India
691595,2023-08-14,505,oven,18490,24000,5510,1,00443,India
691595,2023-08-14,507,washing machine,6990,16490,9500,1,00443,India
691595,2023-08-14,506,monitor,3249,8000,4751,1,00443,India
691595,2023-08-14,504,iron,449,879,430,1,00443,India
330321,2023-08-14,503,mixer,1349,3249,1900,1,00340,India
572334,2023-08-14,506,monitor,3249,8000,4751,1,00444,India
572334,2023-08-14,505,oven,18490,24000,5510,1,00444,India
572334,2023-08-14,502,iphone 15 pro max,100000,135000,35000,1,00444,India
436935,2023-08-14,505,oven,18490,24000,5510,1,00430,India
436935,2023-08-14,502,iphone 15 pro max,100000,135000,35000,1,00430,India
436935,2023-08-14,507,washing machine,6990,16490,9500,1,00430,India
247796,2023-08-14,504,iron,449,879,430,1,00265,India
763310,2023-08-14,506,monitor,3249,8000,4751,1,00118,India
763310,2023-08-14,507,washing machine,6990,16490,9500,1,00118,India
763310,2023-08-14,505,oven,18490,24000,5510,1,00118,India
763310,2023-08-14,504,iron,449,879,430,1,00118,India
112986,2023-08-14,505,oven,18490,24000,5510,1,00349,India
454692,2023-08-14,504,iron,449,879,430,1,00375,India
454692,2023-08-14,506,monitor,3249,8000,4751,1,00375,India
454692,2023-08-14,505,oven,18490,24000,5510,1,00375,India
655402,2023-08-14,505,oven,18490,24000,5510,1,00096,India
655402,2023-08-14,504,iron,449,879,430,1,00096,India
130849,2023-08-14,504,iron,449,879,430,1,00301,India
130849,2023-08-14,502,iphone 15 pro max,100000,135000,35000,1,00301,India
832730,2023-08-14,507,washing machine,6990,16490,9500,1,00134,India
832730,2023-08-14,501,iphone 15,60000,80000,20000,1,00134,India
832730,2023-08-14,503,mixer,1349,3249,1900,1,00134,India
832730,2023-08-14,506,monitor,3249,8000,4751,1,00134,India
270514,2023-08-14,503,mixer,1349,3249,1900,1,00352,India
270514,2023-08-14,507,washing machine,6990,16490,9500,1,00352,India
916903,2023-08-14,506,monitor,3249,8000,4751,1,00328,India
481149,2023-08-14,501,iphone 15,60000,80000,20000,1,00125,India
481149,2023-08-14,504,iron,449,879,430,1,00125,India
481149,2023-08-14,505,oven,18490,24000,5510,1,00125,India
605130,2023-08-14,501,iphone 15,60000,80000,20000,1,00225,India
605130,2023-08-14,506,monitor,3249,8000,4751,1,00225,India
605130,2023-08-14,502,iphone 15 pro max,100000,135000,35000,1,00225,India
535487,2023-08-14,504,iron,449,879,430,1,00466,India
524610,2023-08-14,503,mixer,1349,3249,1900,1,00019,India
524610,2023-08-14,504,iron,449,879,430,1,00019,India
502033,2023-08-14,507,washing machine,6990,16490,9500,1,00455,India
502033,2023-08-14,506,monitor,3249,8000,4751,1,00455,India
502033,2023-08-14,503,mixer,1349,3249,1900,1,00455,India
502033,2023-08-14,505,oven,18490,24000,5510,1,00455,India
930754,2023-08-14,506,monitor,3249,8000,4751,1,00269,India
930754,2023-08-14,501,iphone 15,60000,80000,20000,1,00269,India
297523,2023-08-14,501,iphone 15,60000,80000,20000,1,00408,India
939694,2023-08-14,504,iron,449,879,430,1,00209,India
312910,2023-08-14,501,iphone 15,60000,80000,20000,1,00270,India
312910,2023-08-14,504,iron,449,879,430,1,00270,India
312910,2023-08-14,503,mixer,1349,3249,1900,1,00270,India
913281,2023-08-14,503,mixer,1349,3249,1900,1,00021,India
913281,2023-08-14,501,iphone 15,60000,80000,20000,1,00021,India
231154,2023-08-14,505,oven,18490,24000,5510,1,00079,India
231154,2023-08-14,507,washing machine,6990,16490,9500,1,00079,India
231154,2023-08-14,503,mixer,1349,3249,1900,1,00079,India
493139,2023-08-14,507,washing machine,6990,16490,9500,1,00252,India
493139,2023-08-14,505,oven,18490,24000,5510,1,00252,India
493139,2023-08-14,503,mixer,1349,3249,1900,1,00252,India
940612,2023-08-14,501,iphone 15,60000,80000,20000,1,00231,India
940612,2023-08-14,505,oven,18490,24000,5510,1,00231,India
940612,2023-08-14,506,monitor,3249,8000,4751,1,00231,India
974901,2023-08-14,505,oven,18490,24000,5510,1,00219,India
974901,2023-08-14,502,iphone 15 pro max,100000,135000,35000,1,00219,India
974901,2023-08-14,506,monitor,3249,8000,4751,1,00219,India
974901,2023-08-14,501,iphone 15,60000,80000,20000,1,00219,India
974901,2023-08-14,504,iron,449,879,430,1,00219,India
298408,2023-08-14,503,mixer,1349,3249,1900,1,00481,India
795506,2023-08-14,506,monitor,3249,8000,4751,1,00311,India
171390,2023-08-14,501,iphone 15,60000,80000,20000,1,00443,India
171390,2023-08-14,502,iphone 15 pro max,100000,135000,35000,1,00443,India
171390,2023-08-14,505,oven,18490,24000,5510,1,00443,India
947052,2023-08-14,504,iron,449,879,430,1,00155,India
147990,2023-08-14,502,iphone 15 pro max,100000,135000,35000,1,00079,India
147990,2023-08-14,506,monitor,3249,8000,4751,1,00079,India
535511,2023-08-14,507,washing machine,6990,16490,9500,1,00379,India
535511,2023-08-14,503,mixer,1349,3249,1900,1,00379,India
535511,2023-08-14,502,iphone 15 pro max,100000,135000,35000,1,00379,India
889052,2023-08-14,502,iphone 15 pro max,100000,135000,35000,1,00356,India
712949,2023-08-14,502,iphone 15 pro max,100000,135000,35000,1,00175,India
712949,2023-08-14,504,iron,449,879,430,1,00175,India
712949,2023-08-14,505,oven,18490,24000,5510,1,00175,India
764774,2023-08-14,504,iron,449,879,430,1,00375,India
764774,2023-08-14,502,iphone 15 pro max,100000,135000,35000,1,00375,India
764774,2023-08-14,501,iphone 15,60000,80000,20000,1,00375,India
764774,2023-08-14,503,mixer,1349,3249,1900,1,00375,India
700783,2023-08-14,505,oven,18490,24000,5510,1,00240,India
700783,2023-08-14,506,monitor,3249,8000,4751,1,00240,India
998994,2023-08-14,504,iron,449,879,430,1,00049,India
996301,2023-08-14,502,iphone 15 pro max,100000,135000,35000,1,00016,India
996301,2023-08-14,506,monitor,3249,8000,4751,1,00016,India
450312,2023-08-14,505,oven,18490,24000,5510,1,00024,India
450312,2023-08-14,506,monitor,3249,8000,4751,1,00024,India
450312,2023-08-14,503,mixer,1349,3249,1900,1,00024,India
450312,2023-08-14,501,iphone 15,60000,80000,20000,1,00024,India
764784,2023-08-14,507,washing machine,6990,16490,9500,1,00194,India
764784,2023-08-14,503,mixer,1349,3249,1900,1,00194,India
764784,2023-08-14,504,iron,449,879,430,1,00194,India
764784,2023-08-14,501,iphone 15,60000,80000,20000,1,00194,India
984509,2023-08-14,501,iphone 15,60000,80000,20000,1,00030,India
530756,2023-08-14,505,oven,18490,24000,5510,1,00404,India
317261,2023-08-14,505,oven,18490,24000,5510,1,00230,India
317261,2023-08-14,503,mixer,1349,3249,1900,1,00230,India
317261,2023-08-14,501,iphone 15,60000,80000,20000,1,00230,India
317261,2023-08-14,506,monitor,3249,8000,4751,1,00230,India
772491,2023-08-14,501,iphone 15,60000,80000,20000,1,00395,India
104160,2023-08-14,507,washing machine,6990,16490,9500,1,00112,India
104160,2023-08-14,504,iron,449,879,430,1,00112,India
104160,2023-08-14,501,iphone 15,60000,80000,20000,1,00112,India
426818,2023-08-14,504,iron,449,879,430,1,00185,India
426818,2023-08-14,502,iphone 15 pro max,100000,135000,35000,1,00185,India
969062,2023-08-14,501,iphone 15,60000,80000,20000,1,00451,India
969062,2023-08-14,504,iron,449,879,430,1,00451,India
817258,2023-08-14,504,iron,449,879,430,1,00117,India
817258,2023-08-14,507,washing machine,6990,16490,9500,1,00117,India
817258,2023-08-14,503,mixer,1349,3249,1900,1,00117,India
441747,2023-08-14,505,oven,18490,24000,5510,1,00294,India
918854,2023-08-14,505,oven,18490,24000,5510,1,00169,India
918854,2023-08-14,502,iphone 15 pro max,100000,135000,35000,1,00169,India
918854,2023-08-14,504,iron,449,879,430,1,00169,India
918854,2023-08-14,501,iphone 15,60000,80000,20000,1,00169,India
179608,2023-08-14,504,iron,449,879,430,1,00449,India
179608,2023-08-14,506,monitor,3249,8000,4751,1,00449,India
250735,2023-08-14,507,washing machine,6990,16490,9500,1,00060,India
250735,2023-08-14,505,oven,18490,24000,5510,1,00060,India
250735,2023-08-14,506,monitor,3249,8000,4751,1,00060,India
915038,2023-08-14,507,washing machine,6990,16490,9500,1,00216,India
841423,2023-08-14,505,oven,18490,24000,5510,1,00069,India
841423,2023-08-14,507,washing machine,6990,16490,9500,1,00069,India
841423,2023-08-14,504,iron,449,879,430,1,00069,India
841423,2023-08-14,501,iphone 15,60000,80000,20000,1,00069,India
117269,2023-08-14,501,iphone 15,60000,80000,20000,1,00280,India
117269,2023-08-14,504,iron,449,879,430,1,00280,India
117269,2023-08-14,506,monitor,3249,8000,4751,1,00280,India
317533,2023-08-14,501,iphone 15,60000,80000,20000,1,00034,India
317533,2023-08-14,502,iphone 15 pro max,100000,135000,35000,1,00034,India
723325,2023-08-14,503,mixer,1349,3249,1900,1,00463,India
723325,2023-08-14,501,iphone 15,60000,80000,20000,1,00463,India
723325,2023-08-14,505,oven,18490,24000,5510,1,00463,India
908135,2023-08-14,506,monitor,3249,8000,4751,1,00008,India
908135,2023-08-14,505,oven,18490,24000,5510,1,00008,India
934076,2023-08-14,507,washing machine,6990,16490,9500,1,00319,India
167608,2023-08-14,503,mixer,1349,3249,1900,1,00034,India
167608,2023-08-14,507,washing machine,6990,16490,9500,1,00034,India
167608,2023-08-14,506,monitor,3249,8000,4751,1,00034,India
387455,2023-08-14,505,oven,18490,24000,5510,1,00478,India
387455,2023-08-14,504,iron,449,879,430,1,00478,India
387455,2023-08-14,501,iphone 15,60000,80000,20000,1,00478,India
256514,2023-08-14,505,oven,18490,24000,5510,1,00333,India
256514,2023-08-14,506,monitor,3249,8000,4751,1,00333,India
256514,2023-08-14,507,washing machine,6990,16490,9500,1,00333,India
256514,2023-08-14,503,mixer,1349,3249,1900,1,00333,India
143444,2023-08-14,503,mixer,1349,3249,1900,1,00223,India
490866,2023-08-15,504,iron,449,879,430,1,00216,India
233445,2023-08-15,506,monitor,3249,8000,4751,1,00001,India
233445,2023-08-15,503,mixer,1349,3249,1900,1,00001,India
233445,2023-08-15,504,iron,449,879,430,1,00001,India
419339,2023-08-15,504,iron,449,879,430,1,00410,India
419339,2023-08-15,507,washing machine,6990,16490,9500,1,00410,India
419339,2023-08-15,503,mixer,1349,3249,1900,1,00410,India
431139,2023-08-15,503,mixer,1349,3249,1900,1,00251,India
431139,2023-08-15,504,iron,449,879,430,1,00251,India
597904,2023-08-15,502,iphone 15 pro max,100000,135000,35000,1,00296,India
597904,2023-08-15,507,washing machine,6990,16490,9500,1,00296,India
509609,2023-08-15,502,iphone 15 pro max,100000,135000,35000,1,00361,India
509609,2023-08-15,504,iron,449,879,430,1,00361,India
837764,2023-08-15,503,mixer,1349,3249,1900,1,00402,India
837764,2023-08-15,501,iphone 15,60000,80000,20000,1,00402,India
837764,2023-08-15,507,washing machine,6990,16490,9500,1,00402,India
855252,2023-08-15,502,iphone 15 pro max,100000,135000,35000,1,00145,India
855252,2023-08-15,503,mixer,1349,3249,1900,1,00145,India
855252,2023-08-15,507,washing machine,6990,16490,9500,1,00145,India
745769,2023-08-15,502,iphone 15 pro max,100000,135000,35000,1,00437,India
745769,2023-08-15,507,washing machine,6990,16490,9500,1,00437,India
745769,2023-08-15,505,oven,18490,24000,5510,1,00437,India
685083,2023-08-15,502,iphone 15 pro max,100000,135000,35000,1,00425,India
685083,2023-08-15,504,iron,449,879,430,1,00425,India
685083,2023-08-15,503,mixer,1349,3249,1900,1,00425,India
266508,2023-08-15,503,mixer,1349,3249,1900,1,00066,India
266508,2023-08-15,504,iron,449,879,430,1,00066,India
602847,2023-08-15,502,iphone 15 pro max,100000,135000,35000,1,00468,India
602847,2023-08-15,505,oven,18490,24000,5510,1,00468,India
602847,2023-08-15,501,iphone 15,60000,80000,20000,1,00468,India
751239,2023-08-15,502,iphone 15 pro max,100000,135000,35000,1,00113,India
751239,2023-08-15,501,iphone 15,60000,80000,20000,1,00113,India
751239,2023-08-15,503,mixer,1349,3249,1900,1,00113,India
174135,2023-08-15,504,iron,449,879,430,1,00257,India
691333,2023-08-15,504,iron,449,879,430,1,00425,India
691333,2023-08-15,501,iphone 15,60000,80000,20000,1,00425,India
691333,2023-08-15,507,washing machine,6990,16490,9500,1,00425,India
691333,2023-08-15,502,iphone 15 pro max,100000,135000,35000,1,00425,India
589513,2023-08-15,503,mixer,1349,3249,1900,1,00453,India
589513,2023-08-15,505,oven,18490,24000,5510,1,00453,India
589513,2023-08-15,507,washing machine,6990,16490,9500,1,00453,India
639833,2023-08-15,505,oven,18490,24000,5510,1,00254,India
639833,2023-08-15,503,mixer,1349,3249,1900,1,00254,India
639833,2023-08-15,506,monitor,3249,8000,4751,1,00254,India
370679,2023-08-15,507,washing machine,6990,16490,9500,1,00411,India
370679,2023-08-15,504,iron,449,879,430,1,00411,India
370679,2023-08-15,501,iphone 15,60000,80000,20000,1,00411,India
370679,2023-08-15,505,oven,18490,24000,5510,1,00411,India
961819,2023-08-15,504,iron,449,879,430,1,00261,India
961819,2023-08-15,501,iphone 15,60000,80000,20000,1,00261,India
209072,2023-08-15,504,iron,449,879,430,1,00016,India
209072,2023-08-15,501,iphone 15,60000,80000,20000,1,00016,India
544975,2023-08-15,506,monitor,3249,8000,4751,1,00187,India
544975,2023-08-15,505,oven,18490,24000,5510,1,00187,India
544975,2023-08-15,502,iphone 15 pro max,100000,135000,35000,1,00187,India
655331,2023-08-15,506,monitor,3249,8000,4751,1,00047,India
655331,2023-08-15,507,washing machine,6990,16490,9500,1,00047,India
655331,2023-08-15,504,iron,449,879,430,1,00047,India
536978,2023-08-15,507,washing machine,6990,16490,9500,1,00306,India
536978,2023-08-15,502,iphone 15 pro max,100000,135000,35000,1,00306,India
375189,2023-08-15,502,iphone 15 pro max,100000,135000,35000,1,00125,India
375189,2023-08-15,507,washing machine,6990,16490,9500,1,00125,India
375189,2023-08-15,505,oven,18490,24000,5510,1,00125,India
335920,2023-08-15,504,iron,449,879,430,1,00495,India
335920,2023-08-15,502,iphone 15 pro max,100000,135000,35000,1,00495,India
237416,2023-08-15,504,iron,449,879,430,1,00381,India
400699,2023-08-15,503,mixer,1349,3249,1900,1,00004,India
400699,2023-08-15,502,iphone 15 pro max,100000,135000,35000,1,00004,India
400699,2023-08-15,501,iphone 15,60000,80000,20000,1,00004,India
650470,2023-08-15,502,iphone 15 pro max,100000,135000,35000,1,00411,India
650470,2023-08-15,506,monitor,3249,8000,4751,1,00411,India
650470,2023-08-15,501,iphone 15,60000,80000,20000,1,00411,India
650470,2023-08-15,503,mixer,1349,3249,1900,1,00411,India
979311,2023-08-15,502,iphone 15 pro max,100000,135000,35000,1,00341,India
979311,2023-08-15,503,mixer,1349,3249,1900,1,00341,India
979311,2023-08-15,504,iron,449,879,430,1,00341,India
537858,2023-08-15,501,iphone 15,60000,80000,20000,1,00138,India
537858,2023-08-15,503,mixer,1349,3249,1900,1,00138,India
537858,2023-08-15,507,washing machine,6990,16490,9500,1,00138,India
309622,2023-08-15,502,iphone 15 pro max,100000,135000,35000,1,00240,India
309622,2023-08-15,505,oven,18490,24000,5510,1,00240,India
309622,2023-08-15,504,iron,449,879,430,1,00240,India
101298,2023-08-15,507,washing machine,6990,16490,9500,1,00484,India
659822,2023-08-15,502,iphone 15 pro max,100000,135000,35000,1,00132,India
659822,2023-08-15,501,iphone 15,60000,80000,20000,1,00132,India
400197,2023-08-15,504,iron,449,879,430,1,00129,India
400197,2023-08-15,505,oven,18490,24000,5510,1,00129,India
121351,2023-08-15,506,monitor,3249,8000,4751,1,00200,India
121351,2023-08-15,507,washing machine,6990,16490,9500,1,00200,India
121351,2023-08-15,501,iphone 15,60000,80000,20000,1,00200,India
852585,2023-08-15,503,mixer,1349,3249,1900,1,00248,India
852585,2023-08-15,501,iphone 15,60000,80000,20000,1,00248,India
852585,2023-08-15,507,washing machine,6990,16490,9500,1,00248,India
852585,2023-08-15,505,oven,18490,24000,5510,1,00248,India
299900,2023-08-15,502,iphone 15 pro max,100000,135000,35000,1,00005,India
299900,2023-08-15,506,monitor,3249,8000,4751,1,00005,India
470631,2023-08-15,505,oven,18490,24000,5510,1,00220,India
470631,2023-08-15,503,mixer,1349,3249,1900,1,00220,India
470631,2023-08-15,504,iron,449,879,430,1,00220,India
470631,2023-08-15,506,monitor,3249,8000,4751,1,00220,India
470631,2023-08-15,507,washing machine,6990,16490,9500,1,00220,India
768406,2023-08-15,502,iphone 15 pro max,100000,135000,35000,1,00343,India
768406,2023-08-15,505,oven,18490,24000,5510,1,00343,India
768406,2023-08-15,507,washing machine,6990,16490,9500,1,00343,India
768406,2023-08-15,504,iron,449,879,430,1,00343,India
249627,2023-08-15,504,iron,449,879,430,1,00115,India
359748,2023-08-15,501,iphone 15,60000,80000,20000,1,00183,India
591516,2023-08-15,504,iron,449,879,430,1,00097,India
591516,2023-08-15,502,iphone 15 pro max,100000,135000,35000,1,00097,India
524144,2023-08-15,503,mixer,1349,3249,1900,1,00492,India
524144,2023-08-15,501,iphone 15,60000,80000,20000,1,00492,India
524144,2023-08-15,504,iron,449,879,430,1,00492,India
524144,2023-08-15,502,iphone 15 pro max,100000,135000,35000,1,00492,India
805861,2023-08-15,503,mixer,1349,3249,1900,1,00040,India
805861,2023-08-15,502,iphone 15 pro max,100000,135000,35000,1,00040,India
184002,2023-08-15,505,oven,18490,24000,5510,1,00059,India
184002,2023-08-15,504,iron,449,879,430,1,00059,India
184002,2023-08-15,506,monitor,3249,8000,4751,1,00059,India
184002,2023-08-15,501,iphone 15,60000,80000,20000,1,00059,India
525338,2023-08-15,507,washing machine,6990,16490,9500,1,00170,India
525338,2023-08-15,506,monitor,3249,8000,4751,1,00170,India
525338,2023-08-15,502,iphone 15 pro max,100000,135000,35000,1,00170,India
986480,2023-08-15,503,mixer,1349,3249,1900,1,00208,India
986480,2023-08-15,502,iphone 15 pro max,100000,135000,35000,1,00208,India
986480,2023-08-15,504,iron,449,879,430,1,00208,India
600921,2023-08-15,504,iron,449,879,430,1,00446,India
587401,2023-08-15,504,iron,449,879,430,1,00097,India
587401,2023-08-15,506,monitor,3249,8000,4751,1,00097,India
587401,2023-08-15,502,iphone 15 pro max,100000,135000,35000,1,00097,India
351199,2023-08-15,506,monitor,3249,8000,4751,1,00006,India
351199,2023-08-15,503,mixer,1349,3249,1900,1,00006,India
351199,2023-08-15,502,iphone 15 pro max,100000,135000,35000,1,00006,India
538048,2023-08-15,502,iphone 15 pro max,100000,135000,35000,1,00061,India
538048,2023-08-15,505,oven,18490,24000,5510,1,00061,India
538048,2023-08-15,507,washing machine,6990,16490,9500,1,00061,India
403314,2023-08-15,503,mixer,1349,3249,1900,1,00420,India
715784,2023-08-15,505,oven,18490,24000,5510,1,00366,India
715784,2023-08-15,503,mixer,1349,3249,1900,1,00366,India
458396,2023-08-15,505,oven,18490,24000,5510,1,00417,India
458396,2023-08-15,502,iphone 15 pro max,100000,135000,35000,1,00417,India
458396,2023-08-15,506,monitor,3249,8000,4751,1,00417,India
334737,2023-08-15,506,monitor,3249,8000,4751,1,00387,India
334737,2023-08-15,505,oven,18490,24000,5510,1,00387,India
334737,2023-08-15,502,iphone 15 pro max,100000,135000,35000,1,00387,India
581690,2023-08-15,506,monitor,3249,8000,4751,1,00445,India
581690,2023-08-15,502,iphone 15 pro max,100000,135000,35000,1,00445,India
229851,2023-08-15,501,iphone 15,60000,80000,20000,1,00438,India
154186,2023-08-16,507,washing machine,6990,16490,9500,1,00318,India
154186,2023-08-16,502,iphone 15 pro max,100000,135000,35000,1,00318,India
154186,2023-08-16,506,monitor,3249,8000,4751,1,00318,India
169331,2023-08-16,502,iphone 15 pro max,100000,135000,35000,1,00130,India
169331,2023-08-16,504,iron,449,879,430,1,00130,India
169331,2023-08-16,503,mixer,1349,3249,1900,1,00130,India
835582,2023-08-16,503,mixer,1349,3249,1900,1,00239,India
835582,2023-08-16,505,oven,18490,24000,5510,1,00239,India
835582,2023-08-16,501,iphone 15,60000,80000,20000,1,00239,India
523342,2023-08-16,507,washing machine,6990,16490,9500,1,00488,India
523342,2023-08-16,503,mixer,1349,3249,1900,1,00488,India
163179,2023-08-16,506,monitor,3249,8000,4751,1,00009,India
163179,2023-08-16,505,oven,18490,24000,5510,1,00009,India
188639,2023-08-16,501,iphone 15,60000,80000,20000,1,00118,India
188639,2023-08-16,507,washing machine,6990,16490,9500,1,00118,India
188639,2023-08-16,506,monitor,3249,8000,4751,1,00118,India
104621,2023-08-16,503,mixer,1349,3249,1900,1,00454,India
104621,2023-08-16,504,iron,449,879,430,1,00454,India
104621,2023-08-16,502,iphone 15 pro max,100000,135000,35000,1,00454,India
729145,2023-08-16,502,iphone 15 pro max,100000,135000,35000,1,00253,India
729145,2023-08-16,506,monitor,3249,8000,4751,1,00253,India
729145,2023-08-16,505,oven,18490,24000,5510,1,00253,India
974163,2023-08-16,503,mixer,1349,3249,1900,1,00368,India
214291,2023-08-16,505,oven,18490,24000,5510,1,00127,India
296644,2023-08-16,506,monitor,3249,8000,4751,1,00104,India
296644,2023-08-16,504,iron,449,879,430,1,00104,India
619619,2023-08-16,505,oven,18490,24000,5510,1,00465,India
700800,2023-08-16,505,oven,18490,24000,5510,1,00246,India
700800,2023-08-16,501,iphone 15,60000,80000,20000,1,00246,India
700800,2023-08-16,502,iphone 15 pro max,100000,135000,35000,1,00246,India
615566,2023-08-16,501,iphone 15,60000,80000,20000,1,00110,India
615566,2023-08-16,506,monitor,3249,8000,4751,1,00110,India
615566,2023-08-16,505,oven,18490,24000,5510,1,00110,India
615566,2023-08-16,507,washing machine,6990,16490,9500,1,00110,India
179308,2023-08-16,502,iphone 15 pro max,100000,135000,35000,1,00310,India
179308,2023-08-16,501,iphone 15,60000,80000,20000,1,00310,India
179308,2023-08-16,503,mixer,1349,3249,1900,1,00310,India
179308,2023-08-16,506,monitor,3249,8000,4751,1,00310,India
253332,2023-08-16,503,mixer,1349,3249,1900,1,00124,India
854392,2023-08-16,504,iron,449,879,430,1,00443,India
854392,2023-08-16,507,washing machine,6990,16490,9500,1,00443,India
854392,2023-08-16,503,mixer,1349,3249,1900,1,00443,India
854392,2023-08-16,505,oven,18490,24000,5510,1,00443,India
221874,2023-08-16,503,mixer,1349,3249,1900,1,00104,India
221874,2023-08-16,502,iphone 15 pro max,100000,135000,35000,1,00104,India
964263,2023-08-16,501,iphone 15,60000,80000,20000,1,00117,India
964263,2023-08-16,505,oven,18490,24000,5510,1,00117,India
378611,2023-08-16,504,iron,449,879,430,1,00333,India
378611,2023-08-16,503,mixer,1349,3249,1900,1,00333,India
668079,2023-08-16,507,washing machine,6990,16490,9500,1,00442,India
118250,2023-08-16,505,oven,18490,24000,5510,1,00029,India
118250,2023-08-16,504,iron,449,879,430,1,00029,India
399208,2023-08-16,505,oven,18490,24000,5510,1,00215,India
399208,2023-08-16,503,mixer,1349,3249,1900,1,00215,India
399208,2023-08-16,501,iphone 15,60000,80000,20000,1,00215,India
998930,2023-08-16,501,iphone 15,60000,80000,20000,1,00184,India
998930,2023-08-16,505,oven,18490,24000,5510,1,00184,India
998930,2023-08-16,506,monitor,3249,8000,4751,1,00184,India
998930,2023-08-16,503,mixer,1349,3249,1900,1,00184,India
116445,2023-08-16,503,mixer,1349,3249,1900,1,00478,India
553249,2023-08-16,505,oven,18490,24000,5510,1,00396,India
553249,2023-08-16,501,iphone 15,60000,80000,20000,1,00396,India
740912,2023-08-16,502,iphone 15 pro max,100000,135000,35000,1,00002,India
740912,2023-08-16,505,oven,18490,24000,5510,1,00002,India
644104,2023-08-16,505,oven,18490,24000,5510,1,00041,India
644104,2023-08-16,504,iron,449,879,430,1,00041,India
644104,2023-08-16,506,monitor,3249,8000,4751,1,00041,India
644104,2023-08-16,501,iphone 15,60000,80000,20000,1,00041,India
576821,2023-08-16,507,washing machine,6990,16490,9500,1,00336,India
576821,2023-08-16,506,monitor,3249,8000,4751,1,00336,India
576821,2023-08-16,505,oven,18490,24000,5510,1,00336,India
880731,2023-08-16,507,washing machine,6990,16490,9500,1,00351,India
994633,2023-08-16,504,iron,449,879,430,1,00330,India
502422,2023-08-16,505,oven,18490,24000,5510,1,00034,India
490565,2023-08-16,505,oven,18490,24000,5510,1,00413,India
490565,2023-08-16,506,monitor,3249,8000,4751,1,00413,India
490565,2023-08-16,504,iron,449,879,430,1,00413,India
490565,2023-08-16,507,washing machine,6990,16490,9500,1,00413,India
772111,2023-08-16,506,monitor,3249,8000,4751,1,00193,India
772111,2023-08-16,502,iphone 15 pro max,100000,135000,35000,1,00193,India
188227,2023-08-16,505,oven,18490,24000,5510,1,00014,India
954822,2023-08-16,503,mixer,1349,3249,1900,1,00389,India
954822,2023-08-16,504,iron,449,879,430,1,00389,India
954822,2023-08-16,505,oven,18490,24000,5510,1,00389,India
146430,2023-08-16,502,iphone 15 pro max,100000,135000,35000,1,00168,India
146430,2023-08-16,501,iphone 15,60000,80000,20000,1,00168,India
146430,2023-08-16,503,mixer,1349,3249,1900,1,00168,India
146430,2023-08-16,506,monitor,3249,8000,4751,1,00168,India
802535,2023-08-16,505,oven,18490,24000,5510,1,00306,India
802535,2023-08-16,501,iphone 15,60000,80000,20000,1,00306,India
802535,2023-08-16,507,washing machine,6990,16490,9500,1,00306,India
802535,2023-08-16,503,mixer,1349,3249,1900,1,00306,India
346473,2023-08-16,502,iphone 15 pro max,100000,135000,35000,1,00065,India
346473,2023-08-16,507,washing machine,6990,16490,9500,1,00065,India
922785,2023-08-16,502,iphone 15 pro max,100000,135000,35000,1,00265,India
313386,2023-08-16,502,iphone 15 pro max,100000,135000,35000,1,00424,India
313386,2023-08-16,505,oven,18490,24000,5510,1,00424,India
979004,2023-08-16,505,oven,18490,24000,5510,1,00449,India
979004,2023-08-16,506,monitor,3249,8000,4751,1,00449,India
979004,2023-08-16,504,iron,449,879,430,1,00449,India
348463,2023-08-16,503,mixer,1349,3249,1900,1,00262,India
348463,2023-08-16,502,iphone 15 pro max,100000,135000,35000,1,00262,India
348463,2023-08-16,505,oven,18490,24000,5510,1,00262,India
716371,2023-08-16,507,washing machine,6990,16490,9500,1,00137,India
616020,2023-08-16,506,monitor,3249,8000,4751,1,00183,India
616020,2023-08-16,501,iphone 15,60000,80000,20000,1,00183,India
616020,2023-08-16,503,mixer,1349,3249,1900,1,00183,India
356759,2023-08-16,501,iphone 15,60000,80000,20000,1,00321,India
356759,2023-08-16,505,oven,18490,24000,5510,1,00321,India
547154,2023-08-16,502,iphone 15 pro max,100000,135000,35000,1,00367,India
716418,2023-08-16,502,iphone 15 pro max,100000,135000,35000,1,00412,India
716418,2023-08-16,501,iphone 15,60000,80000,20000,1,00412,India
924297,2023-08-16,505,oven,18490,24000,5510,1,00328,India
106162,2023-08-16,505,oven,18490,24000,5510,1,00093,India
609536,2023-08-16,502,iphone 15 pro max,100000,135000,35000,1,00382,India
609536,2023-08-16,503,mixer,1349,3249,1900,1,00382,India
642005,2023-08-16,506,monitor,3249,8000,4751,1,00109,India
642005,2023-08-16,501,iphone 15,60000,80000,20000,1,00109,India
916888,2023-08-16,502,iphone 15 pro max,100000,135000,35000,1,00346,India
916888,2023-08-16,501,iphone 15,60000,80000,20000,1,00346,India
916888,2023-08-16,504,iron,449,879,430,1,00346,India
916888,2023-08-16,503,mixer,1349,3249,1900,1,00346,India
916888,2023-08-16,507,washing machine,6990,16490,9500,1,00346,India
733341,2023-08-16,507,washing machine,6990,16490,9500,1,00210,India
733341,2023-08-16,503,mixer,1349,3249,1900,1,00210,India
751217,2023-08-16,505,oven,18490,24000,5510,1,00023,India
751217,2023-08-16,506,monitor,3249,8000,4751,1,00023,India
751217,2023-08-16,501,iphone 15,60000,80000,20000,1,00023,India
721507,2023-08-16,502,iphone 15 pro max,100000,135000,35000,1,00082,India
850523,2023-08-16,501,iphone 15,60000,80000,20000,1,00346,India
850523,2023-08-16,506,monitor,3249,8000,4751,1,00346,India
850523,2023-08-16,504,iron,449,879,430,1,00346,India
705567,2023-08-16,503,mixer,1349,3249,1900,1,00222,India
705567,2023-08-16,506,monitor,3249,8000,4751,1,00222,India
705567,2023-08-16,505,oven,18490,24000,5510,1,00222,India
705567,2023-08-16,502,iphone 15 pro max,100000,135000,35000,1,00222,India
323621,2023-08-16,502,iphone 15 pro max,100000,135000,35000,1,00304,India
323621,2023-08-16,501,iphone 15,60000,80000,20000,1,00304,India
323621,2023-08-16,507,washing machine,6990,16490,9500,1,00304,India
373063,2023-08-16,506,monitor,3249,8000,4751,1,00016,India
373063,2023-08-16,501,iphone 15,60000,80000,20000,1,00016,India
373063,2023-08-16,504,iron,449,879,430,1,00016,India
373063,2023-08-16,502,iphone 15 pro max,100000,135000,35000,1,00016,India
409360,2023-08-16,504,iron,449,879,430,1,00147,India
136742,2023-08-16,506,monitor,3249,8000,4751,1,00003,India
763612,2023-08-16,504,iron,449,879,430,1,00247,India
167512,2023-08-16,502,iphone 15 pro max,100000,135000,35000,1,00012,India
137222,2023-08-16,506,monitor,3249,8000,4751,1,00208,India
137222,2023-08-16,505,oven,18490,24000,5510,1,00208,India
102665,2023-08-16,505,oven,18490,24000,5510,1,00411,India
102665,2023-08-16,506,monitor,3249,8000,4751,1,00411,India
405050,2023-08-16,504,iron,449,879,430,1,00475,India
405050,2023-08-16,502,iphone 15 pro max,100000,135000,35000,1,00475,India
838911,2023-08-16,504,iron,449,879,430,1,00060,India
838911,2023-08-16,501,iphone 15,60000,80000,20000,1,00060,India
838911,2023-08-16,503,mixer,1349,3249,1900,1,00060,India
112428,2023-08-16,504,iron,449,879,430,1,00386,India
112428,2023-08-16,502,iphone 15 pro max,100000,135000,35000,1,00386,India
112428,2023-08-16,507,washing machine,6990,16490,9500,1,00386,India
112428,2023-08-16,501,iphone 15,60000,80000,20000,1,00386,India
492458,2023-08-16,501,iphone 15,60000,80000,20000,1,00054,India
492458,2023-08-16,505,oven,18490,24000,5510,1,00054,India
135651,2023-08-16,503,mixer,1349,3249,1900,1,00455,India
180308,2023-08-16,502,iphone 15 pro max,100000,135000,35000,1,00120,India
180308,2023-08-16,507,washing machine,6990,16490,9500,1,00120,India
180308,2023-08-16,504,iron,449,879,430,1,00120,India
180308,2023-08-16,501,iphone 15,60000,80000,20000,1,00120,India
863869,2023-08-16,505,oven,18490,24000,5510,1,00112,India
863869,2023-08-16,504,iron,449,879,430,1,00112,India
863869,2023-08-16,502,iphone 15 pro max,100000,135000,35000,1,00112,India
563441,2023-08-16,503,mixer,1349,3249,1900,1,00275,India
807247,2023-08-17,503,mixer,1349,3249,1900,1,00216,India
807247,2023-08-17,505,oven,18490,24000,5510,1,00216,India
334184,2023-08-17,504,iron,449,879,430,1,00333,India
334184,2023-08-17,505,oven,18490,24000,5510,1,00333,India
334184,2023-08-17,506,monitor,3249,8000,4751,1,00333,India
334184,2023-08-17,501,iphone 15,60000,80000,20000,1,00333,India
459775,2023-08-17,507,washing machine,6990,16490,9500,1,00463,India
459775,2023-08-17,506,monitor,3249,8000,4751,1,00463,India
459775,2023-08-17,505,oven,18490,24000,5510,1,00463,India
756882,2023-08-17,504,iron,449,879,430,1,00235,India
756882,2023-08-17,501,iphone 15,60000,80000,20000,1,00235,India
756882,2023-08-17,505,oven,18490,24000,5510,1,00235,India
756882,2023-08-17,502,iphone 15 pro max,100000,135000,35000,1,00235,India
866030,2023-08-17,501,iphone 15,60000,80000,20000,1,00045,India
866030,2023-08-17,506,monitor,3249,8000,4751,1,00045,India
866030,2023-08-17,507,washing machine,6990,16490,9500,1,00045,India
288321,2023-08-17,501,iphone 15,60000,80000,20000,1,00210,India
377670,2023-08-17,506,monitor,3249,8000,4751,1,00492,India
377670,2023-08-17,504,iron,449,879,430,1,00492,India
377670,2023-08-17,507,washing machine,6990,16490,9500,1,00492,India
377670,2023-08-17,501,iphone 15,60000,80000,20000,1,00492,India
144755,2023-08-17,507,washing machine,6990,16490,9500,1,00432,India
144755,2023-08-17,504,iron,449,879,430,1,00432,India
144755,2023-08-17,505,oven,18490,24000,5510,1,00432,India
815926,2023-08-17,505,oven,18490,24000,5510,1,00428,India
327519,2023-08-17,504,iron,449,879,430,1,00203,India
327519,2023-08-17,501,iphone 15,60000,80000,20000,1,00203,India
327519,2023-08-17,506,monitor,3249,8000,4751,1,00203,India
906612,2023-08-17,503,mixer,1349,3249,1900,1,00078,India
896674,2023-08-17,501,iphone 15,60000,80000,20000,1,00026,India
896674,2023-08-17,503,mixer,1349,3249,1900,1,00026,India
896674,2023-08-17,502,iphone 15 pro max,100000,135000,35000,1,00026,India
896674,2023-08-17,505,oven,18490,24000,5510,1,00026,India
966025,2023-08-17,505,oven,18490,24000,5510,1,00307,India
966025,2023-08-17,506,monitor,3249,8000,4751,1,00307,India
966025,2023-08-17,504,iron,449,879,430,1,00307,India
966025,2023-08-17,502,iphone 15 pro max,100000,135000,35000,1,00307,India
221924,2023-08-17,503,mixer,1349,3249,1900,1,00005,India
859792,2023-08-17,504,iron,449,879,430,1,00439,India
459918,2023-08-17,503,mixer,1349,3249,1900,1,00208,India
459918,2023-08-17,502,iphone 15 pro max,100000,135000,35000,1,00208,India
459918,2023-08-17,506,monitor,3249,8000,4751,1,00208,India
736531,2023-08-17,502,iphone 15 pro max,100000,135000,35000,1,00364,India
736531,2023-08-17,503,mixer,1349,3249,1900,1,00364,India
669291,2023-08-17,505,oven,18490,24000,5510,1,00385,India
993608,2023-08-17,503,mixer,1349,3249,1900,1,00110,India
467388,2023-08-17,502,iphone 15 pro max,100000,135000,35000,1,00002,India
467388,2023-08-17,507,washing machine,6990,16490,9500,1,00002,India
467388,2023-08-17,506,monitor,3249,8000,4751,1,00002,India
467388,2023-08-17,504,iron,449,879,430,1,00002,India
150578,2023-08-17,507,washing machine,6990,16490,9500,1,00111,India
150578,2023-08-17,504,iron,449,879,430,1,00111,India
150578,2023-08-17,506,monitor,3249,8000,4751,1,00111,India
150578,2023-08-17,502,iphone 15 pro max,100000,135000,35000,1,00111,India
946255,2023-08-17,505,oven,18490,24000,5510,1,00375,India
946255,2023-08-17,504,iron,449,879,430,1,00375,India
946255,2023-08-17,503,mixer,1349,3249,1900,1,00375,India
666713,2023-08-17,502,iphone 15 pro max,100000,135000,35000,1,00247,India
666713,2023-08-17,503,mixer,1349,3249,1900,1,00247,India
666713,2023-08-17,506,monitor,3249,8000,4751,1,00247,India
769294,2023-08-17,503,mixer,1349,3249,1900,1,00478,India
769294,2023-08-17,506,monitor,3249,8000,4751,1,00478,India
769294,2023-08-17,507,washing machine,6990,16490,9500,1,00478,India
499975,2023-08-17,505,oven,18490,24000,5510,1,00202,India
499975,2023-08-17,506,monitor,3249,8000,4751,1,00202,India
499975,2023-08-17,502,iphone 15 pro max,100000,135000,35000,1,00202,India
595507,2023-08-17,507,washing machine,6990,16490,9500,1,00277,India
736221,2023-08-17,503,mixer,1349,3249,1900,1,00378,India
736221,2023-08-17,507,washing machine,6990,16490,9500,1,00378,India
491916,2023-08-17,505,oven,18490,24000,5510,1,00454,India
491916,2023-08-17,507,washing machine,6990,16490,9500,1,00454,India
491916,2023-08-17,504,iron,449,879,430,1,00454,India
763044,2023-08-17,507,washing machine,6990,16490,9500,1,00168,India
763044,2023-08-17,506,monitor,3249,8000,4751,1,00168,India
763044,2023-08-17,501,iphone 15,60000,80000,20000,1,00168,India
763044,2023-08-17,503,mixer,1349,3249,1900,1,00168,India
763044,2023-08-17,502,iphone 15 pro max,100000,135000,35000,1,00168,India
276037,2023-08-17,506,monitor,3249,8000,4751,1,00414,India
276037,2023-08-17,507,washing machine,6990,16490,9500,1,00414,India
151584,2023-08-17,507,washing machine,6990,16490,9500,1,00223,India
151584,2023-08-17,506,monitor,3249,8000,4751,1,00223,India
583733,2023-08-17,507,washing machine,6990,16490,9500,1,00458,India
583733,2023-08-17,506,monitor,3249,8000,4751,1,00458,India
583733,2023-08-17,503,mixer,1349,3249,1900,1,00458,India
278014,2023-08-17,507,washing machine,6990,16490,9500,1,00157,India
283267,2023-08-17,507,washing machine,6990,16490,9500,1,00410,India
283267,2023-08-17,502,iphone 15 pro max,100000,135000,35000,1,00410,India
283267,2023-08-17,501,iphone 15,60000,80000,20000,1,00410,India
988065,2023-08-17,505,oven,18490,24000,5510,1,00393,India
988065,2023-08-17,504,iron,449,879,430,1,00393,India
988065,2023-08-17,503,mixer,1349,3249,1900,1,00393,India
274860,2023-08-17,507,washing machine,6990,16490,9500,1,00202,India
274860,2023-08-17,502,iphone 15 pro max,100000,135000,35000,1,00202,India
274860,2023-08-17,503,mixer,1349,3249,1900,1,00202,India
740969,2023-08-17,506,monitor,3249,8000,4751,1,00356,India
740969,2023-08-17,501,iphone 15,60000,80000,20000,1,00356,India
740969,2023-08-17,503,mixer,1349,3249,1900,1,00356,India
418140,2023-08-17,506,monitor,3249,8000,4751,1,00437,India
418140,2023-08-17,501,iphone 15,60000,80000,20000,1,00437,India
418140,2023-08-17,505,oven,18490,24000,5510,1,00437,India
624601,2023-08-17,504,iron,449,879,430,1,00138,India
557347,2023-08-17,507,washing machine,6990,16490,9500,1,00410,India
557347,2023-08-17,503,mixer,1349,3249,1900,1,00410,India
557347,2023-08-17,502,iphone 15 pro max,100000,135000,35000,1,00410,India
654455,2023-08-17,506,monitor,3249,8000,4751,1,00052,India
654455,2023-08-17,501,iphone 15,60000,80000,20000,1,00052,India
654455,2023-08-17,507,washing machine,6990,16490,9500,1,00052,India
654455,2023-08-17,502,iphone 15 pro max,100000,135000,35000,1,00052,India
197410,2023-08-17,505,oven,18490,24000,5510,1,00135,India
197410,2023-08-17,507,washing machine,6990,16490,9500,1,00135,India
197410,2023-08-17,503,mixer,1349,3249,1900,1,00135,India
197410,2023-08-17,506,monitor,3249,8000,4751,1,00135,India
394874,2023-08-17,503,mixer,1349,3249,1900,1,00099,India
394874,2023-08-17,506,monitor,3249,8000,4751,1,00099,India
394874,2023-08-17,507,washing machine,6990,16490,9500,1,00099,India
517251,2023-08-17,502,iphone 15 pro max,100000,135000,35000,1,00211,India
517251,2023-08-17,506,monitor,3249,8000,4751,1,00211,India
327247,2023-08-17,504,iron,449,879,430,1,00313,India
327247,2023-08-17,503,mixer,1349,3249,1900,1,00313,India
327247,2023-08-17,505,oven,18490,24000,5510,1,00313,India
327247,2023-08-17,506,monitor,3249,8000,4751,1,00313,India
297153,2023-08-17,507,washing machine,6990,16490,9500,1,00060,India
297153,2023-08-17,501,iphone 15,60000,80000,20000,1,00060,India
297153,2023-08-17,506,monitor,3249,8000,4751,1,00060,India
297153,2023-08-17,502,iphone 15 pro max,100000,135000,35000,1,00060,India
297153,2023-08-17,504,iron,449,879,430,1,00060,India
973850,2023-08-17,505,oven,18490,24000,5510,1,00359,India
973850,2023-08-17,506,monitor,3249,8000,4751,1,00359,India
973850,2023-08-17,502,iphone 15 pro max,100000,135000,35000,1,00359,India
201742,2023-08-17,502,iphone 15 pro max,100000,135000,35000,1,00389,India
201742,2023-08-17,504,iron,449,879,430,1,00389,India
359645,2023-08-17,504,iron,449,879,430,1,00038,India
359645,2023-08-17,505,oven,18490,24000,5510,1,00038,India
907035,2023-08-17,505,oven,18490,24000,5510,1,00403,India
907035,2023-08-17,504,iron,449,879,430,1,00403,India
907035,2023-08-17,502,iphone 15 pro max,100000,135000,35000,1,00403,India
103047,2023-08-17,505,oven,18490,24000,5510,1,00055,India
103047,2023-08-17,503,mixer,1349,3249,1900,1,00055,India
103047,2023-08-17,501,iphone 15,60000,80000,20000,1,00055,India
695064,2023-08-17,504,iron,449,879,430,1,00243,India
695064,2023-08-17,503,mixer,1349,3249,1900,1,00243,India
695064,2023-08-17,507,washing machine,6990,16490,9500,1,00243,India
695064,2023-08-17,505,oven,18490,24000,5510,1,00243,India
269156,2023-08-17,504,iron,449,879,430,1,00201,India
269156,2023-08-17,506,monitor,3249,8000,4751,1,00201,India
269156,2023-08-17,501,iphone 15,60000,80000,20000,1,00201,India
269156,2023-08-17,505,oven,18490,24000,5510,1,00201,India
757132,2023-08-17,501,iphone 15,60000,80000,20000,1,00138,India
601686,2023-08-17,505,oven,18490,24000,5510,1,00463,India
758822,2023-08-17,503,mixer,1349,3249,1900,1,00483,India
758822,2023-08-17,506,monitor,3249,8000,4751,1,00483,India
452099,2023-08-17,505,oven,18490,24000,5510,1,00135,India
452099,2023-08-17,503,mixer,1349,3249,1900,1,00135,India
189380,2023-08-17,505,oven,18490,24000,5510,1,00459,India
189380,2023-08-17,507,washing machine,6990,16490,9500,1,00459,India
189380,2023-08-17,503,mixer,1349,3249,1900,1,00459,India
189380,2023-08-17,502,iphone 15 pro max,100000,135000,35000,1,00459,India
313842,2023-08-17,502,iphone 15 pro max,100000,135000,35000,1,00252,India
313842,2023-08-17,505,oven,18490,24000,5510,1,00252,India
313842,2023-08-17,507,washing machine,6990,16490,9500,1,00252,India
494108,2023-08-17,505,oven,18490,24000,5510,1,00196,India
494108,2023-08-17,503,mixer,1349,3249,1900,1,00196,India
494108,2023-08-17,507,washing machine,6990,16490,9500,1,00196,India
871938,2023-08-17,506,monitor,3249,8000,4751,1,00475,India
871938,2023-08-17,503,mixer,1349,3249,1900,1,00475,India
871938,2023-08-17,505,oven,18490,24000,5510,1,00475,India
573726,2023-08-17,502,iphone 15 pro max,100000,135000,35000,1,00052,India
573726,2023-08-17,505,oven,18490,24000,5510,1,00052,India
573726,2023-08-17,503,mixer,1349,3249,1900,1,00052,India
573726,2023-08-17,507,washing machine,6990,16490,9500,1,00052,India
495393,2023-08-17,502,iphone 15 pro max,100000,135000,35000,1,00316,India
495393,2023-08-17,503,mixer,1349,3249,1900,1,00316,India
495393,2023-08-17,501,iphone 15,60000,80000,20000,1,00316,India
633661,2023-08-17,504,iron,449,879,430,1,00165,India
633661,2023-08-17,501,iphone 15,60000,80000,20000,1,00165,India
633661,2023-08-17,506,monitor,3249,8000,4751,1,00165,India
205005,2023-08-18,505,oven,18490,24000,5510,1,00470,India
205005,2023-08-18,506,monitor,3249,8000,4751,1,00470,India
205005,2023-08-18,504,iron,449,879,430,1,00470,India
205005,2023-08-18,507,washing machine,6990,16490,9500,1,00470,India
570687,2023-08-18,501,iphone 15,60000,80000,20000,1,00385,India
570687,2023-08-18,507,washing machine,6990,16490,9500,1,00385,India
570687,2023-08-18,502,iphone 15 pro max,100000,135000,35000,1,00385,India
943852,2023-08-18,504,iron,449,879,430,1,00244,India
943852,2023-08-18,501,iphone 15,60000,80000,20000,1,00244,India
943852,2023-08-18,505,oven,18490,24000,5510,1,00244,India
773233,2023-08-18,501,iphone 15,60000,80000,20000,1,00305,India
773233,2023-08-18,505,oven,18490,24000,5510,1,00305,India
773233,2023-08-18,504,iron,449,879,430,1,00305,India
773233,2023-08-18,503,mixer,1349,3249,1900,1,00305,India
904697,2023-08-18,502,iphone 15 pro max,100000,135000,35000,1,00225,India
904697,2023-08-18,504,iron,449,879,430,1,00225,India
282002,2023-08-18,503,mixer,1349,3249,1900,1,00137,India
282002,2023-08-18,501,iphone 15,60000,80000,20000,1,00137,India
529227,2023-08-18,506,monitor,3249,8000,4751,1,00441,India
529227,2023-08-18,507,washing machine,6990,16490,9500,1,00441,India
529227,2023-08-18,505,oven,18490,24000,5510,1,00441,India
799972,2023-08-18,507,washing machine,6990,16490,9500,1,00098,India
646558,2023-08-18,505,oven,18490,24000,5510,1,00457,India
646558,2023-08-18,507,washing machine,6990,16490,9500,1,00457,India
646558,2023-08-18,502,iphone 15 pro max,100000,135000,35000,1,00457,India
646558,2023-08-18,506,monitor,3249,8000,4751,1,00457,India
160367,2023-08-18,501,iphone 15,60000,80000,20000,1,00041,India
160367,2023-08-18,507,washing machine,6990,16490,9500,1,00041,India
559884,2023-08-18,505,oven,18490,24000,5510,1,00084,India
559884,2023-08-18,504,iron,449,879,430,1,00084,India
559884,2023-08-18,502,iphone 15 pro max,100000,135000,35000,1,00084,India
151999,2023-08-18,503,mixer,1349,3249,1900,1,00245,India
837865,2023-08-18,504,iron,449,879,430,1,00267,India
837865,2023-08-18,507,washing machine,6990,16490,9500,1,00267,India
837865,2023-08-18,501,iphone 15,60000,80000,20000,1,00267,India
824254,2023-08-18,503,mixer,1349,3249,1900,1,00114,India
824254,2023-08-18,504,iron,449,879,430,1,00114,India
824254,2023-08-18,501,iphone 15,60000,80000,20000,1,00114,India
824254,2023-08-18,502,iphone 15 pro max,100000,135000,35000,1,00114,India
895394,2023-08-18,502,iphone 15 pro max,100000,135000,35000,1,00385,India
895394,2023-08-18,507,washing machine,6990,16490,9500,1,00385,India
895394,2023-08-18,503,mixer,1349,3249,1900,1,00385,India
301788,2023-08-18,507,washing machine,6990,16490,9500,1,00045,India
766680,2023-08-18,507,washing machine,6990,16490,9500,1,00424,India
973441,2023-08-18,506,monitor,3249,8000,4751,1,00168,India
973441,2023-08-18,501,iphone 15,60000,80000,20000,1,00168,India
903885,2023-08-18,502,iphone 15 pro max,100000,135000,35000,1,00476,India
607183,2023-08-18,501,iphone 15,60000,80000,20000,1,00433,India
607183,2023-08-18,504,iron,449,879,430,1,00433,India
607183,2023-08-18,502,iphone 15 pro max,100000,135000,35000,1,00433,India
607183,2023-08-18,506,monitor,3249,8000,4751,1,00433,India
878725,2023-08-18,501,iphone 15,60000,80000,20000,1,00416,India
635159,2023-08-18,505,oven,18490,24000,5510,1,00002,India
635159,2023-08-18,501,iphone 15,60000,80000,20000,1,00002,India
870054,2023-08-18,502,iphone 15 pro max,100000,135000,35000,1,00193,India
870054,2023-08-18,506,monitor,3249,8000,4751,1,00193,India
870054,2023-08-18,505,oven,18490,24000,5510,1,00193,India
294256,2023-08-18,505,oven,18490,24000,5510,1,00093,India
294256,2023-08-18,507,washing machine,6990,16490,9500,1,00093,India
294256,2023-08-18,503,mixer,1349,3249,1900,1,00093,India
734635,2023-08-18,501,iphone 15,60000,80000,20000,1,00261,India
668273,2023-08-18,506,monitor,3249,8000,4751,1,00067,India
668273,2023-08-18,503,mixer,1349,3249,1900,1,00067,India
668273,2023-08-18,507,washing machine,6990,16490,9500,1,00067,India
252468,2023-08-18,503,mixer,1349,3249,1900,1,00226,India
252468,2023-08-18,506,monitor,3249,8000,4751,1,00226,India
252468,2023-08-18,504,iron,449,879,430,1,00226,India
252468,2023-08-18,507,washing machine,6990,16490,9500,1,00226,India
252468,2023-08-18,505,oven,18490,24000,5510,1,00226,India
580402,2023-08-18,505,oven,18490,24000,5510,1,00011,India
580402,2023-08-18,504,iron,449,879,430,1,00011,India
580402,2023-08-18,503,mixer,1349,3249,1900,1,00011,India
980875,2023-08-18,501,iphone 15,60000,80000,20000,1,00392,India
980875,2023-08-18,504,iron,449,879,430,1,00392,India
980875,2023-08-18,505,oven,18490,24000,5510,1,00392,India
980875,2023-08-18,507,washing machine,6990,16490,9500,1,00392,India
689419,2023-08-18,507,washing machine,6990,16490,9500,1,00026,India
689419,2023-08-18,503,mixer,1349,3249,1900,1,00026,India
689419,2023-08-18,501,iphone 15,60000,80000,20000,1,00026,India
448392,2023-08-18,505,oven,18490,24000,5510,1,00302,India
448392,2023-08-18,502,iphone 15 pro max,100000,135000,35000,1,00302,India
705517,2023-08-18,506,monitor,3249,8000,4751,1,00417,India
705517,2023-08-18,502,iphone 15 pro max,100000,135000,35000,1,00417,India
705517,2023-08-18,503,mixer,1349,3249,1900,1,00417,India
705517,2023-08-18,501,iphone 15,60000,80000,20000,1,00417,India
670310,2023-08-18,505,oven,18490,24000,5510,1,00088,India
670310,2023-08-18,502,iphone 15 pro max,100000,135000,35000,1,00088,India
443074,2023-08-18,503,mixer,1349,3249,1900,1,00046,India
443074,2023-08-18,501,iphone 15,60000,80000,20000,1,00046,India
443074,2023-08-18,507,washing machine,6990,16490,9500,1,00046,India
443074,2023-08-18,504,iron,449,879,430,1,00046,India
370628,2023-08-18,503,mixer,1349,3249,1900,1,00288,India
370628,2023-08-18,501,iphone 15,60000,80000,20000,1,00288,India
398255,2023-08-18,507,washing machine,6990,16490,9500,1,00351,India
398255,2023-08-18,505,oven,18490,24000,5510,1,00351,India
398255,2023-08-18,503,mixer,1349,3249,1900,1,00351,India
642972,2023-08-18,506,monitor,3249,8000,4751,1,00349,India
642972,2023-08-18,504,iron,449,879,430,1,00349,India
642972,2023-08-18,503,mixer,1349,3249,1900,1,00349,India
987293,2023-08-18,504,iron,449,879,430,1,00288,India
987293,2023-08-18,507,washing machine,6990,16490,9500,1,00288,India
987293,2023-08-18,505,oven,18490,24000,5510,1,00288,India
987293,2023-08-18,501,iphone 15,60000,80000,20000,1,00288,India
987293,2023-08-18,506,monitor,3249,8000,4751,1,00288,India
149597,2023-08-18,506,monitor,3249,8000,4751,1,00301,India
149597,2023-08-18,505,oven,18490,24000,5510,1,00301,India
762493,2023-08-18,502,iphone 15 pro max,100000,135000,35000,1,00082,India
762493,2023-08-18,501,iphone 15,60000,80000,20000,1,00082,India
762493,2023-08-18,507,washing machine,6990,16490,9500,1,00082,India
993644,2023-08-18,506,monitor,3249,8000,4751,1,00332,India
993644,2023-08-18,505,oven,18490,24000,5510,1,00332,India
993644,2023-08-18,504,iron,449,879,430,1,00332,India
993644,2023-08-18,501,iphone 15,60000,80000,20000,1,00332,India
329025,2023-08-18,502,iphone 15 pro max,100000,135000,35000,1,00088,India
329025,2023-08-18,506,monitor,3249,8000,4751,1,00088,India
649026,2023-08-18,505,oven,18490,24000,5510,1,00074,India
649026,2023-08-18,502,iphone 15 pro max,100000,135000,35000,1,00074,India
552484,2023-08-18,507,washing machine,6990,16490,9500,1,00197,India
552484,2023-08-18,502,iphone 15 pro max,100000,135000,35000,1,00197,India
552484,2023-08-18,504,iron,449,879,430,1,00197,India
552484,2023-08-18,506,monitor,3249,8000,4751,1,00197,India
143890,2023-08-18,501,iphone 15,60000,80000,20000,1,00017,India
338934,2023-08-18,507,washing machine,6990,16490,9500,1,00486,India
338934,2023-08-18,506,monitor,3249,8000,4751,1,00486,India
338934,2023-08-18,501,iphone 15,60000,80000,20000,1,00486,India
758344,2023-08-18,503,mixer,1349,3249,1900,1,00162,India
625679,2023-08-18,507,washing machine,6990,16490,9500,1,00325,India
625679,2023-08-18,502,iphone 15 pro max,100000,135000,35000,1,00325,India
631852,2023-08-18,501,iphone 15,60000,80000,20000,1,00210,India
631852,2023-08-18,502,iphone 15 pro max,100000,135000,35000,1,00210,India
631852,2023-08-18,507,washing machine,6990,16490,9500,1,00210,India
631852,2023-08-18,504,iron,449,879,430,1,00210,India
295892,2023-08-18,501,iphone 15,60000,80000,20000,1,00040,India
570186,2023-08-18,507,washing machine,6990,16490,9500,1,00445,India
570186,2023-08-18,503,mixer,1349,3249,1900,1,00445,India
672912,2023-08-18,504,iron,449,879,430,1,00465,India
672912,2023-08-18,505,oven,18490,24000,5510,1,00465,India
987496,2023-08-18,502,iphone 15 pro max,100000,135000,35000,1,00031,India
987496,2023-08-18,503,mixer,1349,3249,1900,1,00031,India
363050,2023-08-18,506,monitor,3249,8000,4751,1,00239,India
363050,2023-08-18,501,iphone 15,60000,80000,20000,1,00239,India
363050,2023-08-18,502,iphone 15 pro max,100000,135000,35000,1,00239,India
580892,2023-08-18,504,iron,449,879,430,1,00303,India
180000,2023-08-18,504,iron,449,879,430,1,00069,India
103195,2023-08-19,502,iphone 15 pro max,100000,135000,35000,1,00362,India
103195,2023-08-19,504,iron,449,879,430,1,00362,India
347911,2023-08-19,507,washing machine,6990,16490,9500,1,00107,India
554791,2023-08-19,502,iphone 15 pro max,100000,135000,35000,1,00495,India
554791,2023-08-19,505,oven,18490,24000,5510,1,00495,India
554791,2023-08-19,501,iphone 15,60000,80000,20000,1,00495,India
726519,2023-08-19,502,iphone 15 pro max,100000,135000,35000,1,00156,India
726519,2023-08-19,504,iron,449,879,430,1,00156,India
865530,2023-08-19,502,iphone 15 pro max,100000,135000,35000,1,00152,India
865530,2023-08-19,507,washing machine,6990,16490,9500,1,00152,India
865530,2023-08-19,501,iphone 15,60000,80000,20000,1,00152,India
865530,2023-08-19,503,mixer,1349,3249,1900,1,00152,India
460992,2023-08-19,502,iphone 15 pro max,100000,135000,35000,1,00492,India
155414,2023-08-19,501,iphone 15,60000,80000,20000,1,00222,India
155414,2023-08-19,504,iron,449,879,430,1,00222,India
734244,2023-08-19,507,washing machine,6990,16490,9500,1,00317,India
734244,2023-08-19,505,oven,18490,24000,5510,1,00317,India
702212,2023-08-19,506,monitor,3249,8000,4751,1,00400,India
702212,2023-08-19,503,mixer,1349,3249,1900,1,00400,India
141308,2023-08-19,504,iron,449,879,430,1,00294,India
141308,2023-08-19,503,mixer,1349,3249,1900,1,00294,India
141308,2023-08-19,507,washing machine,6990,16490,9500,1,00294,India
623272,2023-08-19,502,iphone 15 pro max,100000,135000,35000,1,00208,India
623272,2023-08-19,503,mixer,1349,3249,1900,1,00208,India
264122,2023-08-19,504,iron,449,879,430,1,00309,India
185519,2023-08-19,505,oven,18490,24000,5510,1,00380,India
993738,2023-08-19,507,washing machine,6990,16490,9500,1,00427,India
993738,2023-08-19,504,iron,449,879,430,1,00427,India
741611,2023-08-19,507,washing machine,6990,16490,9500,1,00478,India
741611,2023-08-19,505,oven,18490,24000,5510,1,00478,India
741611,2023-08-19,502,iphone 15 pro max,100000,135000,35000,1,00478,India
678134,2023-08-19,504,iron,449,879,430,1,00208,India
381011,2023-08-19,502,iphone 15 pro max,100000,135000,35000,1,00405,India
381011,2023-08-19,507,washing machine,6990,16490,9500,1,00405,India
381011,2023-08-19,506,monitor,3249,8000,4751,1,00405,India
381011,2023-08-19,505,oven,18490,24000,5510,1,00405,India
893854,2023-08-19,504,iron,449,879,430,1,00290,India
893854,2023-08-19,502,iphone 15 pro max,100000,135000,35000,1,00290,India
893854,2023-08-19,503,mixer,1349,3249,1900,1,00290,India
893854,2023-08-19,505,oven,18490,24000,5510,1,00290,India
678114,2023-08-19,503,mixer,1349,3249,1900,1,00424,India
678114,2023-08-19,502,iphone 15 pro max,100000,135000,35000,1,00424,India
678114,2023-08-19,506,monitor,3249,8000,4751,1,00424,India
356151,2023-08-19,506,monitor,3249,8000,4751,1,00128,India
356151,2023-08-19,504,iron,449,879,430,1,00128,India
356151,2023-08-19,502,iphone 15 pro max,100000,135000,35000,1,00128,India
356151,2023-08-19,505,oven,18490,24000,5510,1,00128,India
697517,2023-08-19,505,oven,18490,24000,5510,1,00104,India
697517,2023-08-19,506,monitor,3249,8000,4751,1,00104,India
740157,2023-08-19,503,mixer,1349,3249,1900,1,00455,India
740157,2023-08-19,507,washing machine,6990,16490,9500,1,00455,India
740157,2023-08-19,505,oven,18490,24000,5510,1,00455,India
740157,2023-08-19,504,iron,449,879,430,1,00455,India
571761,2023-08-19,505,oven,18490,24000,5510,1,00475,India
278054,2023-08-19,503,mixer,1349,3249,1900,1,00138,India
384123,2023-08-19,505,oven,18490,24000,5510,1,00167,India
384123,2023-08-19,504,iron,449,879,430,1,00167,India
384123,2023-08-19,502,iphone 15 pro max,100000,135000,35000,1,00167,India
378245,2023-08-19,503,mixer,1349,3249,1900,1,00120,India
378245,2023-08-19,502,iphone 15 pro max,100000,135000,35000,1,00120,India
378245,2023-08-19,504,iron,449,879,430,1,00120,India
619706,2023-08-19,503,mixer,1349,3249,1900,1,00270,India
471437,2023-08-19,506,monitor,3249,8000,4751,1,00238,India
663165,2023-08-19,505,oven,18490,24000,5510,1,00499,India
663165,2023-08-19,504,iron,449,879,430,1,00499,India
663165,2023-08-19,502,iphone 15 pro max,100000,135000,35000,1,00499,India
549264,2023-08-19,502,iphone 15 pro max,100000,135000,35000,1,00289,India
549264,2023-08-19,504,iron,449,879,430,1,00289,India
549264,2023-08-19,506,monitor,3249,8000,4751,1,00289,India
835583,2023-08-19,506,monitor,3249,8000,4751,1,00170,India
835583,2023-08-19,504,iron,449,879,430,1,00170,India
835583,2023-08-19,505,oven,18490,24000,5510,1,00170,India
700016,2023-08-19,501,iphone 15,60000,80000,20000,1,00494,India
700016,2023-08-19,502,iphone 15 pro max,100000,135000,35000,1,00494,India
700016,2023-08-19,506,monitor,3249,8000,4751,1,00494,India
700016,2023-08-19,504,iron,449,879,430,1,00494,India
399298,2023-08-19,502,iphone 15 pro max,100000,135000,35000,1,00023,India
399298,2023-08-19,504,iron,449,879,430,1,00023,India
835672,2023-08-19,504,iron,449,879,430,1,00334,India
835672,2023-08-19,506,monitor,3249,8000,4751,1,00334,India
847511,2023-08-19,501,iphone 15,60000,80000,20000,1,00437,India
847511,2023-08-19,505,oven,18490,24000,5510,1,00437,India
959144,2023-08-19,503,mixer,1349,3249,1900,1,00248,India
959144,2023-08-19,502,iphone 15 pro max,100000,135000,35000,1,00248,India
603928,2023-08-19,501,iphone 15,60000,80000,20000,1,00205,India
244422,2023-08-19,504,iron,449,879,430,1,00449,India
821311,2023-08-19,503,mixer,1349,3249,1900,1,00046,India
821311,2023-08-19,501,iphone 15,60000,80000,20000,1,00046,India
571872,2023-08-19,503,mixer,1349,3249,1900,1,00133,India
891266,2023-08-19,502,iphone 15 pro max,100000,135000,35000,1,00425,India
891266,2023-08-19,505,oven,18490,24000,5510,1,00425,India
891266,2023-08-19,504,iron,449,879,430,1,00425,India
135014,2023-08-19,503,mixer,1349,3249,1900,1,00495,India
797412,2023-08-19,504,iron,449,879,430,1,00051,India
947201,2023-08-19,506,monitor,3249,8000,4751,1,00185,India
947201,2023-08-19,502,iphone 15 pro max,100000,135000,35000,1,00185,India
947201,2023-08-19,501,iphone 15,60000,80000,20000,1,00185,India
340809,2023-08-19,501,iphone 15,60000,80000,20000,1,00376,India
340809,2023-08-19,502,iphone 15 pro max,100000,135000,35000,1,00376,India
412925,2023-08-19,505,oven,18490,24000,5510,1,00196,India
412925,2023-08-19,503,mixer,1349,3249,1900,1,00196,India
258524,2023-08-19,505,oven,18490,24000,5510,1,00488,India
594414,2023-08-19,506,monitor,3249,8000,4751,1,00236,India
594414,2023-08-19,502,iphone 15 pro max,100000,135000,35000,1,00236,India
872546,2023-08-19,502,iphone 15 pro max,100000,135000,35000,1,00127,India
872546,2023-08-19,501,iphone 15,60000,80000,20000,1,00127,India
872546,2023-08-19,503,mixer,1349,3249,1900,1,00127,India
438455,2023-08-19,503,mixer,1349,3249,1900,1,00290,India
438455,2023-08-19,507,washing machine,6990,16490,9500,1,00290,India
246764,2023-08-19,503,mixer,1349,3249,1900,1,00011,India
246764,2023-08-19,507,washing machine,6990,16490,9500,1,00011,India
145765,2023-08-19,506,monitor,3249,8000,4751,1,00355,India
145765,2023-08-19,504,iron,449,879,430,1,00355,India
776135,2023-08-19,505,oven,18490,24000,5510,1,00140,India
776135,2023-08-19,507,washing machine,6990,16490,9500,1,00140,India
776135,2023-08-19,501,iphone 15,60000,80000,20000,1,00140,India
776135,2023-08-19,506,monitor,3249,8000,4751,1,00140,India
776135,2023-08-19,504,iron,449,879,430,1,00140,India
637055,2023-08-19,507,washing machine,6990,16490,9500,1,00480,India
535173,2023-08-19,504,iron,449,879,430,1,00029,India
535173,2023-08-19,506,monitor,3249,8000,4751,1,00029,India
535173,2023-08-19,503,mixer,1349,3249,1900,1,00029,India
535173,2023-08-19,502,iphone 15 pro max,100000,135000,35000,1,00029,India
319526,2023-08-19,506,monitor,3249,8000,4751,1,00450,India
319526,2023-08-19,504,iron,449,879,430,1,00450,India
319526,2023-08-19,502,iphone 15 pro max,100000,135000,35000,1,00450,India
319526,2023-08-19,507,washing machine,6990,16490,9500,1,00450,India
319526,2023-08-19,503,mixer,1349,3249,1900,1,00450,India
739140,2023-08-19,506,monitor,3249,8000,4751,1,00247,India
739140,2023-08-19,505,oven,18490,24000,5510,1,00247,India
739140,2023-08-19,503,mixer,1349,3249,1900,1,00247,India
932563,2023-08-19,504,iron,449,879,430,1,00388,India
683887,2023-08-19,502,iphone 15 pro max,100000,135000,35000,1,00139,India
624164,2023-08-19,507,washing machine,6990,16490,9500,1,00492,India
316972,2023-08-19,506,monitor,3249,8000,4751,1,00282,India
245466,2023-08-19,507,washing machine,6990,16490,9500,1,00347,India
245466,2023-08-19,505,oven,18490,24000,5510,1,00347,India
245466,2023-08-19,506,monitor,3249,8000,4751,1,00347,India
245466,2023-08-19,504,iron,449,879,430,1,00347,India
644075,2023-08-19,502,iphone 15 pro max,100000,135000,35000,1,00342,India
644075,2023-08-19,505,oven,18490,24000,5510,1,00342,India
644075,2023-08-19,506,monitor,3249,8000,4751,1,00342,India
699280,2023-08-19,501,iphone 15,60000,80000,20000,1,00433,India
699280,2023-08-19,502,iphone 15 pro max,100000,135000,35000,1,00433,India
699280,2023-08-19,506,monitor,3249,8000,4751,1,00433,India
607727,2023-08-19,503,mixer,1349,3249,1900,1,00223,India
607727,2023-08-19,502,iphone 15 pro max,100000,135000,35000,1,00223,India
607727,2023-08-19,507,washing machine,6990,16490,9500,1,00223,India
646475,2023-08-19,503,mixer,1349,3249,1900,1,00428,India
646475,2023-08-19,507,washing machine,6990,16490,9500,1,00428,India
646475,2023-08-19,506,monitor,3249,8000,4751,1,00428,India
646475,2023-08-19,504,iron,449,879,430,1,00428,India
490635,2023-08-19,507,washing machine,6990,16490,9500,1,00326,India
490635,2023-08-19,501,iphone 15,60000,80000,20000,1,00326,India
490635,2023-08-19,505,oven,18490,24000,5510,1,00326,India
490635,2023-08-19,504,iron,449,879,430,1,00326,India
463746,2023-08-19,502,iphone 15 pro max,100000,135000,35000,1,00194,India
224656,2023-08-20,501,iphone 15,60000,80000,20000,1,00389,India
224656,2023-08-20,502,iphone 15 pro max,100000,135000,35000,1,00389,India
224656,2023-08-20,504,iron,449,879,430,1,00389,India
224656,2023-08-20,505,oven,18490,24000,5510,1,00389,India
778866,2023-08-20,507,washing machine,6990,16490,9500,1,00089,India
778866,2023-08-20,501,iphone 15,60000,80000,20000,1,00089,India
994182,2023-08-20,507,washing machine,6990,16490,9500,1,00432,India
994182,2023-08-20,505,oven,18490,24000,5510,1,00432,India
375718,2023-08-20,505,oven,18490,24000,5510,1,00367,India
529331,2023-08-20,504,iron,449,879,430,1,00456,India
529331,2023-08-20,505,oven,18490,24000,5510,1,00456,India
140986,2023-08-20,507,washing machine,6990,16490,9500,1,00374,India
140986,2023-08-20,504,iron,449,879,430,1,00374,India
777359,2023-08-20,504,iron,449,879,430,1,00384,India
777359,2023-08-20,503,mixer,1349,3249,1900,1,00384,India
777359,2023-08-20,502,iphone 15 pro max,100000,135000,35000,1,00384,India
777359,2023-08-20,501,iphone 15,60000,80000,20000,1,00384,India
564068,2023-08-20,506,monitor,3249,8000,4751,1,00016,India
564068,2023-08-20,502,iphone 15 pro max,100000,135000,35000,1,00016,India
246216,2023-08-20,504,iron,449,879,430,1,00359,India
246216,2023-08-20,505,oven,18490,24000,5510,1,00359,India
246216,2023-08-20,503,mixer,1349,3249,1900,1,00359,India
220431,2023-08-20,501,iphone 15,60000,80000,20000,1,00097,India
220431,2023-08-20,506,monitor,3249,8000,4751,1,00097,India
711659,2023-08-20,505,oven,18490,24000,5510,1,00164,India
711659,2023-08-20,506,monitor,3249,8000,4751,1,00164,India
127474,2023-08-20,504,iron,449,879,430,1,00025,India
127474,2023-08-20,506,monitor,3249,8000,4751,1,00025,India
486108,2023-08-20,504,iron,449,879,430,1,00176,India
505683,2023-08-20,504,iron,449,879,430,1,00475,India
816095,2023-08-20,505,oven,18490,24000,5510,1,00153,India
327626,2023-08-20,504,iron,449,879,430,1,00290,India
736737,2023-08-20,507,washing machine,6990,16490,9500,1,00414,India
947086,2023-08-20,501,iphone 15,60000,80000,20000,1,00081,India
947086,2023-08-20,505,oven,18490,24000,5510,1,00081,India
947086,2023-08-20,503,mixer,1349,3249,1900,1,00081,India
947086,2023-08-20,507,washing machine,6990,16490,9500,1,00081,India
973655,2023-08-20,501,iphone 15,60000,80000,20000,1,00136,India
973655,2023-08-20,502,iphone 15 pro max,100000,135000,35000,1,00136,India
973655,2023-08-20,506,monitor,3249,8000,4751,1,00136,India
657253,2023-08-20,502,iphone 15 pro max,100000,135000,35000,1,00337,India
657253,2023-08-20,505,oven,18490,24000,5510,1,00337,India
908585,2023-08-20,505,oven,18490,24000,5510,1,00110,India
908585,2023-08-20,506,monitor,3249,8000,4751,1,00110,India
908585,2023-08-20,507,washing machine,6990,16490,9500,1,00110,India
908585,2023-08-20,503,mixer,1349,3249,1900,1,00110,India
915612,2023-08-20,505,oven,18490,24000,5510,1,00289,India
915612,2023-08-20,506,monitor,3249,8000,4751,1,00289,India
778554,2023-08-20,501,iphone 15,60000,80000,20000,1,00070,India
778554,2023-08-20,505,oven,18490,24000,5510,1,00070,India
778554,2023-08-20,506,monitor,3249,8000,4751,1,00070,India
440175,2023-08-20,507,washing machine,6990,16490,9500,1,00414,India
861910,2023-08-20,501,iphone 15,60000,80000,20000,1,00414,India
936949,2023-08-20,502,iphone 15 pro max,100000,135000,35000,1,00265,India
936949,2023-08-20,501,iphone 15,60000,80000,20000,1,00265,India
936949,2023-08-20,503,mixer,1349,3249,1900,1,00265,India
727932,2023-08-20,506,monitor,3249,8000,4751,1,00219,India
727932,2023-08-20,504,iron,449,879,430,1,00219,India
532836,2023-08-20,505,oven,18490,24000,5510,1,00461,India
220089,2023-08-20,505,oven,18490,24000,5510,1,00333,India
220089,2023-08-20,501,iphone 15,60000,80000,20000,1,00333,India
825542,2023-08-20,505,oven,18490,24000,5510,1,00359,India
825542,2023-08-20,506,monitor,3249,8000,4751,1,00359,India
825542,2023-08-20,507,washing machine,6990,16490,9500,1,00359,India
825542,2023-08-20,502,iphone 15 pro max,100000,135000,35000,1,00359,India
652017,2023-08-20,502,iphone 15 pro max,100000,135000,35000,1,00489,India
652017,2023-08-20,504,iron,449,879,430,1,00489,India
684299,2023-08-20,502,iphone 15 pro max,100000,135000,35000,1,00122,India
684299,2023-08-20,506,monitor,3249,8000,4751,1,00122,India
203982,2023-08-20,501,iphone 15,60000,80000,20000,1,00161,India
203982,2023-08-20,503,mixer,1349,3249,1900,1,00161,India
203982,2023-08-20,502,iphone 15 pro max,100000,135000,35000,1,00161,India
203982,2023-08-20,504,iron,449,879,430,1,00161,India
816894,2023-08-20,502,iphone 15 pro max,100000,135000,35000,1,00140,India
816894,2023-08-20,501,iphone 15,60000,80000,20000,1,00140,India
556585,2023-08-20,505,oven,18490,24000,5510,1,00085,India
144054,2023-08-20,501,iphone 15,60000,80000,20000,1,00219,India
144054,2023-08-20,502,iphone 15 pro max,100000,135000,35000,1,00219,India
144054,2023-08-20,506,monitor,3249,8000,4751,1,00219,India
406192,2023-08-20,501,iphone 15,60000,80000,20000,1,00447,India
406192,2023-08-20,503,mixer,1349,3249,1900,1,00447,India
994350,2023-08-20,507,washing machine,6990,16490,9500,1,00472,India
994350,2023-08-20,501,iphone 15,60000,80000,20000,1,00472,India
994350,2023-08-20,506,monitor,3249,8000,4751,1,00472,India
265442,2023-08-20,507,washing machine,6990,16490,9500,1,00279,India
265442,2023-08-20,506,monitor,3249,8000,4751,1,00279,India
441738,2023-08-20,507,washing machine,6990,16490,9500,1,00294,India
441738,2023-08-20,505,oven,18490,24000,5510,1,00294,India
441738,2023-08-20,506,monitor,3249,8000,4751,1,00294,India
279579,2023-08-20,506,monitor,3249,8000,4751,1,00171,India
279579,2023-08-20,505,oven,18490,24000,5510,1,00171,India
997164,2023-08-20,503,mixer,1349,3249,1900,1,00211,India
997164,2023-08-20,502,iphone 15 pro max,100000,135000,35000,1,00211,India
997164,2023-08-20,506,monitor,3249,8000,4751,1,00211,India
474448,2023-08-20,503,mixer,1349,3249,1900,1,00138,India
789983,2023-08-20,504,iron,449,879,430,1,00275,India
789983,2023-08-20,506,monitor,3249,8000,4751,1,00275,India
789983,2023-08-20,505,oven,18490,24000,5510,1,00275,India
317370,2023-08-20,504,iron,449,879,430,1,00033,India
114005,2023-08-20,502,iphone 15 pro max,100000,135000,35000,1,00138,India
114005,2023-08-20,504,iron,449,879,430,1,00138,India
114005,2023-08-20,505,oven,18490,24000,5510,1,00138,India
114005,2023-08-20,501,iphone 15,60000,80000,20000,1,00138,India
114005,2023-08-20,503,mixer,1349,3249,1900,1,00138,India
275201,2023-08-20,505,oven,18490,24000,5510,1,00416,India
275201,2023-08-20,506,monitor,3249,8000,4751,1,00416,India
275201,2023-08-20,503,mixer,1349,3249,1900,1,00416,India
829155,2023-08-20,504,iron,449,879,430,1,00411,India
829155,2023-08-20,506,monitor,3249,8000,4751,1,00411,India
829155,2023-08-20,507,washing machine,6990,16490,9500,1,00411,India
829155,2023-08-20,503,mixer,1349,3249,1900,1,00411,India
491657,2023-08-20,507,washing machine,6990,16490,9500,1,00148,India
491657,2023-08-20,501,iphone 15,60000,80000,20000,1,00148,India
954211,2023-08-20,504,iron,449,879,430,1,00179,India
954211,2023-08-20,506,monitor,3249,8000,4751,1,00179,India
954211,2023-08-20,503,mixer,1349,3249,1900,1,00179,India
954211,2023-08-20,507,washing machine,6990,16490,9500,1,00179,India
954211,2023-08-20,505,oven,18490,24000,5510,1,00179,India
176079,2023-08-20,506,monitor,3249,8000,4751,1,00186,India
176079,2023-08-20,502,iphone 15 pro max,100000,135000,35000,1,00186,India
332170,2023-08-20,504,iron,449,879,430,1,00316,India
332170,2023-08-20,502,iphone 15 pro max,100000,135000,35000,1,00316,India
332170,2023-08-20,507,washing machine,6990,16490,9500,1,00316,India
332170,2023-08-20,505,oven,18490,24000,5510,1,00316,India
864995,2023-08-20,502,iphone 15 pro max,100000,135000,35000,1,00031,India
864995,2023-08-20,504,iron,449,879,430,1,00031,India
864995,2023-08-20,507,washing machine,6990,16490,9500,1,00031,India
864995,2023-08-20,501,iphone 15,60000,80000,20000,1,00031,India
565990,2023-08-20,501,iphone 15,60000,80000,20000,1,00121,India
565990,2023-08-20,504,iron,449,879,430,1,00121,India
565990,2023-08-20,502,iphone 15 pro max,100000,135000,35000,1,00121,India
361693,2023-08-20,507,washing machine,6990,16490,9500,1,00049,India
361693,2023-08-20,502,iphone 15 pro max,100000,135000,35000,1,00049,India
361693,2023-08-20,506,monitor,3249,8000,4751,1,00049,India
361693,2023-08-20,505,oven,18490,24000,5510,1,00049,India
665801,2023-08-20,504,iron,449,879,430,1,00183,India
269765,2023-08-20,502,iphone 15 pro max,100000,135000,35000,1,00368,India
652029,2023-08-20,505,oven,18490,24000,5510,1,00235,India
652029,2023-08-20,503,mixer,1349,3249,1900,1,00235,India
439998,2023-08-21,507,washing machine,6990,16490,9500,1,00415,India
439998,2023-08-21,502,iphone 15 pro max,100000,135000,35000,1,00415,India
439998,2023-08-21,501,iphone 15,60000,80000,20000,1,00415,India
851240,2023-08-21,502,iphone 15 pro max,100000,135000,35000,1,00203,India
993802,2023-08-21,503,mixer,1349,3249,1900,1,00279,India
993802,2023-08-21,506,monitor,3249,8000,4751,1,00279,India
993802,2023-08-21,507,washing machine,6990,16490,9500,1,00279,India
993802,2023-08-21,502,iphone 15 pro max,100000,135000,35000,1,00279,India
993802,2023-08-21,505,oven,18490,24000,5510,1,00279,India
613180,2023-08-21,507,washing machine,6990,16490,9500,1,00197,India
613180,2023-08-21,501,iphone 15,60000,80000,20000,1,00197,India
613180,2023-08-21,504,iron,449,879,430,1,00197,India
613180,2023-08-21,506,monitor,3249,8000,4751,1,00197,India
156720,2023-08-21,503,mixer,1349,3249,1900,1,00198,India
156720,2023-08-21,502,iphone 15 pro max,100000,135000,35000,1,00198,India
156720,2023-08-21,506,monitor,3249,8000,4751,1,00198,India
807342,2023-08-21,506,monitor,3249,8000,4751,1,00297,India
807342,2023-08-21,507,washing machine,6990,16490,9500,1,00297,India
807342,2023-08-21,502,iphone 15 pro max,100000,135000,35000,1,00297,India
807342,2023-08-21,501,iphone 15,60000,80000,20000,1,00297,India
964613,2023-08-21,505,oven,18490,24000,5510,1,00290,India
964613,2023-08-21,507,washing machine,6990,16490,9500,1,00290,India
964613,2023-08-21,501,iphone 15,60000,80000,20000,1,00290,India
397012,2023-08-21,501,iphone 15,60000,80000,20000,1,00342,India
397012,2023-08-21,507,washing machine,6990,16490,9500,1,00342,India
397012,2023-08-21,502,iphone 15 pro max,100000,135000,35000,1,00342,India
796136,2023-08-21,502,iphone 15 pro max,100000,135000,35000,1,00166,India
796136,2023-08-21,504,iron,449,879,430,1,00166,India
796136,2023-08-21,505,oven,18490,24000,5510,1,00166,India
193766,2023-08-21,506,monitor,3249,8000,4751,1,00243,India
193766,2023-08-21,507,washing machine,6990,16490,9500,1,00243,India
119523,2023-08-21,507,washing machine,6990,16490,9500,1,00266,India
119523,2023-08-21,505,oven,18490,24000,5510,1,00266,India
119523,2023-08-21,506,monitor,3249,8000,4751,1,00266,India
119523,2023-08-21,502,iphone 15 pro max,100000,135000,35000,1,00266,India
694479,2023-08-21,502,iphone 15 pro max,100000,135000,35000,1,00291,India
342668,2023-08-21,505,oven,18490,24000,5510,1,00078,India
342668,2023-08-21,504,iron,449,879,430,1,00078,India
342668,2023-08-21,501,iphone 15,60000,80000,20000,1,00078,India
556242,2023-08-21,502,iphone 15 pro max,100000,135000,35000,1,00345,India
556242,2023-08-21,501,iphone 15,60000,80000,20000,1,00345,India
349071,2023-08-21,506,monitor,3249,8000,4751,1,00206,India
349071,2023-08-21,503,mixer,1349,3249,1900,1,00206,India
176915,2023-08-21,503,mixer,1349,3249,1900,1,00339,India
176915,2023-08-21,506,monitor,3249,8000,4751,1,00339,India
176915,2023-08-21,507,washing machine,6990,16490,9500,1,00339,India
176915,2023-08-21,504,iron,449,879,430,1,00339,India
176915,2023-08-21,502,iphone 15 pro max,100000,135000,35000,1,00339,India
485347,2023-08-21,502,iphone 15 pro max,100000,135000,35000,1,00198,India
485347,2023-08-21,503,mixer,1349,3249,1900,1,00198,India
485347,2023-08-21,507,washing machine,6990,16490,9500,1,00198,India
328981,2023-08-21,503,mixer,1349,3249,1900,1,00430,India
503768,2023-08-21,501,iphone 15,60000,80000,20000,1,00203,India
503768,2023-08-21,503,mixer,1349,3249,1900,1,00203,India
503768,2023-08-21,504,iron,449,879,430,1,00203,India
503768,2023-08-21,506,monitor,3249,8000,4751,1,00203,India
537142,2023-08-21,507,washing machine,6990,16490,9500,1,00335,India
537142,2023-08-21,506,monitor,3249,8000,4751,1,00335,India
537142,2023-08-21,504,iron,449,879,430,1,00335,India
537142,2023-08-21,501,iphone 15,60000,80000,20000,1,00335,India
677591,2023-08-21,506,monitor,3249,8000,4751,1,00145,India
677591,2023-08-21,507,washing machine,6990,16490,9500,1,00145,India
677591,2023-08-21,503,mixer,1349,3249,1900,1,00145,India
185425,2023-08-21,504,iron,449,879,430,1,00136,India
185425,2023-08-21,507,washing machine,6990,16490,9500,1,00136,India
185425,2023-08-21,506,monitor,3249,8000,4751,1,00136,India
185425,2023-08-21,503,mixer,1349,3249,1900,1,00136,India
459702,2023-08-21,505,oven,18490,24000,5510,1,00358,India
459702,2023-08-21,504,iron,449,879,430,1,00358,India
139630,2023-08-21,504,iron,449,879,430,1,00346,India
139630,2023-08-21,506,monitor,3249,8000,4751,1,00346,India
668220,2023-08-21,503,mixer,1349,3249,1900,1,00386,India
668220,2023-08-21,502,iphone 15 pro max,100000,135000,35000,1,00386,India
668220,2023-08-21,506,monitor,3249,8000,4751,1,00386,India
671195,2023-08-21,501,iphone 15,60000,80000,20000,1,00431,India
619706,2023-08-21,503,mixer,1349,3249,1900,1,00270,India
619706,2023-08-21,507,washing machine,6990,16490,9500,1,00270,India
619706,2023-08-21,501,iphone 15,60000,80000,20000,1,00270,India
619706,2023-08-21,506,monitor,3249,8000,4751,1,00270,India
548845,2023-08-21,502,iphone 15 pro max,100000,135000,35000,1,00109,India
548845,2023-08-21,501,iphone 15,60000,80000,20000,1,00109,India
447805,2023-08-21,506,monitor,3249,8000,4751,1,00087,India
447805,2023-08-21,507,washing machine,6990,16490,9500,1,00087,India
447805,2023-08-21,504,iron,449,879,430,1,00087,India
302341,2023-08-21,501,iphone 15,60000,80000,20000,1,00337,India
302341,2023-08-21,505,oven,18490,24000,5510,1,00337,India
302341,2023-08-21,502,iphone 15 pro max,100000,135000,35000,1,00337,India
259304,2023-08-21,501,iphone 15,60000,80000,20000,1,00331,India
259304,2023-08-21,503,mixer,1349,3249,1900,1,00331,India
259304,2023-08-21,505,oven,18490,24000,5510,1,00331,India
823076,2023-08-21,501,iphone 15,60000,80000,20000,1,00311,India
823076,2023-08-21,504,iron,449,879,430,1,00311,India
823076,2023-08-21,506,monitor,3249,8000,4751,1,00311,India
161582,2023-08-21,507,washing machine,6990,16490,9500,1,00426,India
655726,2023-08-21,504,iron,449,879,430,1,00179,India
655726,2023-08-21,507,washing machine,6990,16490,9500,1,00179,India
526335,2023-08-21,503,mixer,1349,3249,1900,1,00427,India
526335,2023-08-21,504,iron,449,879,430,1,00427,India
526335,2023-08-21,505,oven,18490,24000,5510,1,00427,India
526335,2023-08-21,507,washing machine,6990,16490,9500,1,00427,India
946392,2023-08-21,502,iphone 15 pro max,100000,135000,35000,1,00283,India
946392,2023-08-21,503,mixer,1349,3249,1900,1,00283,India
571778,2023-08-21,501,iphone 15,60000,80000,20000,1,00285,India
571778,2023-08-21,507,washing machine,6990,16490,9500,1,00285,India
571778,2023-08-21,505,oven,18490,24000,5510,1,00285,India
571778,2023-08-21,506,monitor,3249,8000,4751,1,00285,India
893835,2023-08-21,502,iphone 15 pro max,100000,135000,35000,1,00365,India
893835,2023-08-21,506,monitor,3249,8000,4751,1,00365,India
893835,2023-08-21,507,washing machine,6990,16490,9500,1,00365,India
893835,2023-08-21,504,iron,449,879,430,1,00365,India
611469,2023-08-21,504,iron,449,879,430,1,00361,India
611469,2023-08-21,502,iphone 15 pro max,100000,135000,35000,1,00361,India
611469,2023-08-21,501,iphone 15,60000,80000,20000,1,00361,India
903733,2023-08-21,502,iphone 15 pro max,100000,135000,35000,1,00020,India
903733,2023-08-21,501,iphone 15,60000,80000,20000,1,00020,India
903733,2023-08-21,505,oven,18490,24000,5510,1,00020,India
558034,2023-08-21,504,iron,449,879,430,1,00416,India
558034,2023-08-21,505,oven,18490,24000,5510,1,00416,India
558034,2023-08-21,506,monitor,3249,8000,4751,1,00416,India
787764,2023-08-21,505,oven,18490,24000,5510,1,00099,India
787764,2023-08-21,507,washing machine,6990,16490,9500,1,00099,India
787764,2023-08-21,501,iphone 15,60000,80000,20000,1,00099,India
495378,2023-08-21,506,monitor,3249,8000,4751,1,00191,India
495378,2023-08-21,501,iphone 15,60000,80000,20000,1,00191,India
950431,2023-08-21,505,oven,18490,24000,5510,1,00322,India
950431,2023-08-21,506,monitor,3249,8000,4751,1,00322,India
950431,2023-08-21,501,iphone 15,60000,80000,20000,1,00322,India
950431,2023-08-21,503,mixer,1349,3249,1900,1,00322,India
420124,2023-08-21,501,iphone 15,60000,80000,20000,1,00403,India
420124,2023-08-21,504,iron,449,879,430,1,00403,India
783627,2023-08-21,504,iron,449,879,430,1,00148,India
783627,2023-08-21,502,iphone 15 pro max,100000,135000,35000,1,00148,India
181301,2023-08-21,505,oven,18490,24000,5510,1,00440,India
181301,2023-08-21,506,monitor,3249,8000,4751,1,00440,India
181301,2023-08-21,502,iphone 15 pro max,100000,135000,35000,1,00440,India
589100,2023-08-21,505,oven,18490,24000,5510,1,00332,India
708985,2023-08-21,504,iron,449,879,430,1,00462,India
612970,2023-08-21,507,washing machine,6990,16490,9500,1,00111,India
612970,2023-08-21,506,monitor,3249,8000,4751,1,00111,India
695843,2023-08-21,503,mixer,1349,3249,1900,1,00195,India
695843,2023-08-21,505,oven,18490,24000,5510,1,00195,India
695843,2023-08-21,501,iphone 15,60000,80000,20000,1,00195,India
411737,2023-08-21,501,iphone 15,60000,80000,20000,1,00291,India
411737,2023-08-21,504,iron,449,879,430,1,00291,India
411737,2023-08-21,503,mixer,1349,3249,1900,1,00291,India
411737,2023-08-21,506,monitor,3249,8000,4751,1,00291,India
466380,2023-08-21,503,mixer,1349,3249,1900,1,00422,India
466380,2023-08-21,504,iron,449,879,430,1,00422,India
820162,2023-08-21,505,oven,18490,24000,5510,1,00116,India
820162,2023-08-21,502,iphone 15 pro max,100000,135000,35000,1,00116,India
820162,2023-08-21,507,washing machine,6990,16490,9500,1,00116,India
478749,2023-08-21,503,mixer,1349,3249,1900,1,00319,India
478749,2023-08-21,506,monitor,3249,8000,4751,1,00319,India
478749,2023-08-21,501,iphone 15,60000,80000,20000,1,00319,India
212377,2023-08-21,502,iphone 15 pro max,100000,135000,35000,1,00237,India
274894,2023-08-21,507,washing machine,6990,16490,9500,1,00320,India
274894,2023-08-21,505,oven,18490,24000,5510,1,00320,India
594256,2023-08-21,502,iphone 15 pro max,100000,135000,35000,1,00051,India
133874,2023-08-21,501,iphone 15,60000,80000,20000,1,00399,India
133874,2023-08-21,506,monitor,3249,8000,4751,1,00399,India
140264,2023-08-21,504,iron,449,879,430,1,00282,India
946861,2023-08-21,503,mixer,1349,3249,1900,1,00380,India
946861,2023-08-21,502,iphone 15 pro max,100000,135000,35000,1,00380,India
946861,2023-08-21,507,washing machine,6990,16490,9500,1,00380,India
336705,2023-08-21,502,iphone 15 pro max,100000,135000,35000,1,00041,India
320164,2023-08-21,505,oven,18490,24000,5510,1,00477,India
320164,2023-08-21,506,monitor,3249,8000,4751,1,00477,India
320164,2023-08-21,501,iphone 15,60000,80000,20000,1,00477,India
877166,2023-08-21,507,washing machine,6990,16490,9500,1,00014,India
877166,2023-08-21,504,iron,449,879,430,1,00014,India
422455,2023-08-21,502,iphone 15 pro max,100000,135000,35000,1,00387,India
422455,2023-08-21,503,mixer,1349,3249,1900,1,00387,India
422455,2023-08-21,505,oven,18490,24000,5510,1,00387,India
442121,2023-08-21,502,iphone 15 pro max,100000,135000,35000,1,00473,India
442121,2023-08-21,504,iron,449,879,430,1,00473,India
442121,2023-08-21,505,oven,18490,24000,5510,1,00473,India
351642,2023-08-21,501,iphone 15,60000,80000,20000,1,00125,India
351642,2023-08-21,502,iphone 15 pro max,100000,135000,35000,1,00125,India
351642,2023-08-21,506,monitor,3249,8000,4751,1,00125,India
265112,2023-08-21,501,iphone 15,60000,80000,20000,1,00283,India
878857,2023-08-21,506,monitor,3249,8000,4751,1,00124,India
878857,2023-08-21,504,iron,449,879,430,1,00124,India
687619,2023-08-21,505,oven,18490,24000,5510,1,00350,India
687619,2023-08-21,502,iphone 15 pro max,100000,135000,35000,1,00350,India
687619,2023-08-21,507,washing machine,6990,16490,9500,1,00350,India
454546,2023-08-21,505,oven,18490,24000,5510,1,00049,India
329345,2023-08-21,506,monitor,3249,8000,4751,1,00141,India
329345,2023-08-21,501,iphone 15,60000,80000,20000,1,00141,India
329345,2023-08-21,507,washing machine,6990,16490,9500,1,00141,India
329345,2023-08-21,502,iphone 15 pro max,100000,135000,35000,1,00141,India
329345,2023-08-21,505,oven,18490,24000,5510,1,00141,India
317872,2023-08-21,501,iphone 15,60000,80000,20000,1,00233,India
609908,2023-08-21,505,oven,18490,24000,5510,1,00474,India
715618,2023-08-21,506,monitor,3249,8000,4751,1,00363,India
715618,2023-08-21,505,oven,18490,24000,5510,1,00363,India
715618,2023-08-21,502,iphone 15 pro max,100000,135000,35000,1,00363,India
715618,2023-08-21,503,mixer,1349,3249,1900,1,00363,India
935232,2023-08-21,502,iphone 15 pro max,100000,135000,35000,1,00093,India
935232,2023-08-21,505,oven,18490,24000,5510,1,00093,India
935232,2023-08-21,503,mixer,1349,3249,1900,1,00093,India
935232,2023-08-21,504,iron,449,879,430,1,00093,India
100042,2023-08-21,504,iron,449,879,430,1,00144,India
100042,2023-08-21,506,monitor,3249,8000,4751,1,00144,India
459616,2023-08-21,506,monitor,3249,8000,4751,1,00376,India
459616,2023-08-21,504,iron,449,879,430,1,00376,India
131595,2023-08-21,507,washing machine,6990,16490,9500,1,00414,India
131595,2023-08-21,502,iphone 15 pro max,100000,135000,35000,1,00414,India
131595,2023-08-21,506,monitor,3249,8000,4751,1,00414,India
128310,2023-08-21,505,oven,18490,24000,5510,1,00314,India
128310,2023-08-21,506,monitor,3249,8000,4751,1,00314,India
492212,2023-08-21,502,iphone 15 pro max,100000,135000,35000,1,00113,India
976494,2023-08-21,506,monitor,3249,8000,4751,1,00023,India
976494,2023-08-21,502,iphone 15 pro max,100000,135000,35000,1,00023,India
976494,2023-08-21,507,washing machine,6990,16490,9500,1,00023,India
731464,2023-08-21,504,iron,449,879,430,1,00328,India
731464,2023-08-21,506,monitor,3249,8000,4751,1,00328,India
731464,2023-08-21,507,washing machine,6990,16490,9500,1,00328,India
815764,2023-08-21,505,oven,18490,24000,5510,1,00181,India
815764,2023-08-21,502,iphone 15 pro max,100000,135000,35000,1,00181,India
256040,2023-08-21,506,monitor,3249,8000,4751,1,00275,India
256040,2023-08-21,507,washing machine,6990,16490,9500,1,00275,India
256040,2023-08-21,505,oven,18490,24000,5510,1,00275,India
638074,2023-08-21,507,washing machine,6990,16490,9500,1,00497,India
269333,2023-08-21,506,monitor,3249,8000,4751,1,00002,India
269333,2023-08-21,503,mixer,1349,3249,1900,1,00002,India
659864,2023-08-22,505,oven,18490,24000,5510,1,00463,India
809355,2023-08-22,504,iron,449,879,430,1,00483,India
809355,2023-08-22,502,iphone 15 pro max,100000,135000,35000,1,00483,India
809355,2023-08-22,503,mixer,1349,3249,1900,1,00483,India
809355,2023-08-22,505,oven,18490,24000,5510,1,00483,India
137741,2023-08-22,502,iphone 15 pro max,100000,135000,35000,1,00201,India
137741,2023-08-22,501,iphone 15,60000,80000,20000,1,00201,India
137741,2023-08-22,504,iron,449,879,430,1,00201,India
137741,2023-08-22,507,washing machine,6990,16490,9500,1,00201,India
459798,2023-08-22,503,mixer,1349,3249,1900,1,00077,India
459798,2023-08-22,502,iphone 15 pro max,100000,135000,35000,1,00077,India
459798,2023-08-22,506,monitor,3249,8000,4751,1,00077,India
459798,2023-08-22,507,washing machine,6990,16490,9500,1,00077,India
212859,2023-08-22,501,iphone 15,60000,80000,20000,1,00274,India
212859,2023-08-22,504,iron,449,879,430,1,00274,India
212859,2023-08-22,507,washing machine,6990,16490,9500,1,00274,India
753277,2023-08-22,505,oven,18490,24000,5510,1,00385,India
753277,2023-08-22,503,mixer,1349,3249,1900,1,00385,India
753277,2023-08-22,502,iphone 15 pro max,100000,135000,35000,1,00385,India
753277,2023-08-22,504,iron,449,879,430,1,00385,India
753277,2023-08-22,501,iphone 15,60000,80000,20000,1,00385,India
704283,2023-08-22,501,iphone 15,60000,80000,20000,1,00415,India
704283,2023-08-22,504,iron,449,879,430,1,00415,India
704283,2023-08-22,506,monitor,3249,8000,4751,1,00415,India
233381,2023-08-22,506,monitor,3249,8000,4751,1,00391,India
233381,2023-08-22,501,iphone 15,60000,80000,20000,1,00391,India
233381,2023-08-22,505,oven,18490,24000,5510,1,00391,India
405937,2023-08-22,503,mixer,1349,3249,1900,1,00096,India
405937,2023-08-22,507,washing machine,6990,16490,9500,1,00096,India
870742,2023-08-22,505,oven,18490,24000,5510,1,00075,India
870742,2023-08-22,503,mixer,1349,3249,1900,1,00075,India
870742,2023-08-22,504,iron,449,879,430,1,00075,India
870742,2023-08-22,501,iphone 15,60000,80000,20000,1,00075,India
203075,2023-08-22,503,mixer,1349,3249,1900,1,00456,India
203075,2023-08-22,504,iron,449,879,430,1,00456,India
203075,2023-08-22,506,monitor,3249,8000,4751,1,00456,India
669502,2023-08-22,502,iphone 15 pro max,100000,135000,35000,1,00488,India
669502,2023-08-22,505,oven,18490,24000,5510,1,00488,India
669502,2023-08-22,504,iron,449,879,430,1,00488,India
669502,2023-08-22,506,monitor,3249,8000,4751,1,00488,India
924535,2023-08-22,505,oven,18490,24000,5510,1,00495,India
713034,2023-08-22,505,oven,18490,24000,5510,1,00272,India
827451,2023-08-22,502,iphone 15 pro max,100000,135000,35000,1,00464,India
827451,2023-08-22,501,iphone 15,60000,80000,20000,1,00464,India
827451,2023-08-22,505,oven,18490,24000,5510,1,00464,India
827451,2023-08-22,507,washing machine,6990,16490,9500,1,00464,India
178975,2023-08-22,506,monitor,3249,8000,4751,1,00247,India
680917,2023-08-22,507,washing machine,6990,16490,9500,1,00112,India
680917,2023-08-22,503,mixer,1349,3249,1900,1,00112,India
680917,2023-08-22,506,monitor,3249,8000,4751,1,00112,India
680917,2023-08-22,501,iphone 15,60000,80000,20000,1,00112,India
628896,2023-08-22,506,monitor,3249,8000,4751,1,00264,India
628896,2023-08-22,504,iron,449,879,430,1,00264,India
335531,2023-08-22,505,oven,18490,24000,5510,1,00227,India
335531,2023-08-22,502,iphone 15 pro max,100000,135000,35000,1,00227,India
650604,2023-08-22,502,iphone 15 pro max,100000,135000,35000,1,00363,India
690229,2023-08-22,506,monitor,3249,8000,4751,1,00219,India
690229,2023-08-22,504,iron,449,879,430,1,00219,India
690229,2023-08-22,505,oven,18490,24000,5510,1,00219,India
690229,2023-08-22,503,mixer,1349,3249,1900,1,00219,India
690229,2023-08-22,501,iphone 15,60000,80000,20000,1,00219,India
132887,2023-08-22,504,iron,449,879,430,1,00195,India
627273,2023-08-22,505,oven,18490,24000,5510,1,00198,India
627273,2023-08-22,501,iphone 15,60000,80000,20000,1,00198,India
935890,2023-08-22,506,monitor,3249,8000,4751,1,00039,India
935890,2023-08-22,501,iphone 15,60000,80000,20000,1,00039,India
935890,2023-08-22,504,iron,449,879,430,1,00039,India
429484,2023-08-22,505,oven,18490,24000,5510,1,00168,India
429484,2023-08-22,507,washing machine,6990,16490,9500,1,00168,India
429484,2023-08-22,503,mixer,1349,3249,1900,1,00168,India
429484,2023-08-22,501,iphone 15,60000,80000,20000,1,00168,India
190641,2023-08-22,507,washing machine,6990,16490,9500,1,00058,India
190641,2023-08-22,506,monitor,3249,8000,4751,1,00058,India
183679,2023-08-22,502,iphone 15 pro max,100000,135000,35000,1,00129,India
183679,2023-08-22,501,iphone 15,60000,80000,20000,1,00129,India
855521,2023-08-22,506,monitor,3249,8000,4751,1,00089,India
855521,2023-08-22,505,oven,18490,24000,5510,1,00089,India
537630,2023-08-22,507,washing machine,6990,16490,9500,1,00018,India
537630,2023-08-22,505,oven,18490,24000,5510,1,00018,India
537630,2023-08-22,506,monitor,3249,8000,4751,1,00018,India
537630,2023-08-22,504,iron,449,879,430,1,00018,India
617182,2023-08-22,502,iphone 15 pro max,100000,135000,35000,1,00176,India
222667,2023-08-22,505,oven,18490,24000,5510,1,00299,India
222667,2023-08-22,501,iphone 15,60000,80000,20000,1,00299,India
997691,2023-08-22,502,iphone 15 pro max,100000,135000,35000,1,00493,India
997691,2023-08-22,506,monitor,3249,8000,4751,1,00493,India
995268,2023-08-22,501,iphone 15,60000,80000,20000,1,00290,India
995268,2023-08-22,502,iphone 15 pro max,100000,135000,35000,1,00290,India
576856,2023-08-22,505,oven,18490,24000,5510,1,00309,India
576856,2023-08-22,502,iphone 15 pro max,100000,135000,35000,1,00309,India
576856,2023-08-22,504,iron,449,879,430,1,00309,India
576856,2023-08-22,506,monitor,3249,8000,4751,1,00309,India
601719,2023-08-22,501,iphone 15,60000,80000,20000,1,00440,India
681055,2023-08-22,505,oven,18490,24000,5510,1,00027,India
775721,2023-08-22,504,iron,449,879,430,1,00189,India
775721,2023-08-22,505,oven,18490,24000,5510,1,00189,India
775721,2023-08-22,503,mixer,1349,3249,1900,1,00189,India
775721,2023-08-22,506,monitor,3249,8000,4751,1,00189,India
296476,2023-08-22,507,washing machine,6990,16490,9500,1,00432,India
296476,2023-08-22,503,mixer,1349,3249,1900,1,00432,India
296476,2023-08-22,506,monitor,3249,8000,4751,1,00432,India
617422,2023-08-22,504,iron,449,879,430,1,00109,India
617422,2023-08-22,507,washing machine,6990,16490,9500,1,00109,India
441873,2023-08-22,507,washing machine,6990,16490,9500,1,00334,India
441873,2023-08-22,503,mixer,1349,3249,1900,1,00334,India
441873,2023-08-22,504,iron,449,879,430,1,00334,India
908516,2023-08-22,503,mixer,1349,3249,1900,1,00315,India
908516,2023-08-22,501,iphone 15,60000,80000,20000,1,00315,India
614926,2023-08-22,501,iphone 15,60000,80000,20000,1,00098,India
614926,2023-08-22,502,iphone 15 pro max,100000,135000,35000,1,00098,India
543183,2023-08-22,503,mixer,1349,3249,1900,1,00129,India
543183,2023-08-22,502,iphone 15 pro max,100000,135000,35000,1,00129,India
543183,2023-08-22,507,washing machine,6990,16490,9500,1,00129,India
625821,2023-08-22,502,iphone 15 pro max,100000,135000,35000,1,00003,India
625821,2023-08-22,501,iphone 15,60000,80000,20000,1,00003,India
625821,2023-08-22,504,iron,449,879,430,1,00003,India
625821,2023-08-22,505,oven,18490,24000,5510,1,00003,India
625821,2023-08-22,506,monitor,3249,8000,4751,1,00003,India
496363,2023-08-22,504,iron,449,879,430,1,00050,India
196466,2023-08-22,501,iphone 15,60000,80000,20000,1,00355,India
196466,2023-08-22,506,monitor,3249,8000,4751,1,00355,India
418958,2023-08-22,507,washing machine,6990,16490,9500,1,00469,India
418958,2023-08-22,502,iphone 15 pro max,100000,135000,35000,1,00469,India
418958,2023-08-22,504,iron,449,879,430,1,00469,India
411778,2023-08-22,502,iphone 15 pro max,100000,135000,35000,1,00134,India
763650,2023-08-22,501,iphone 15,60000,80000,20000,1,00085,India
763650,2023-08-22,503,mixer,1349,3249,1900,1,00085,India
763650,2023-08-22,506,monitor,3249,8000,4751,1,00085,India
763650,2023-08-22,502,iphone 15 pro max,100000,135000,35000,1,00085,India
587552,2023-08-22,507,washing machine,6990,16490,9500,1,00448,India
587552,2023-08-22,501,iphone 15,60000,80000,20000,1,00448,India
588156,2023-08-22,502,iphone 15 pro max,100000,135000,35000,1,00219,India
164161,2023-08-22,506,monitor,3249,8000,4751,1,00371,India
164161,2023-08-22,503,mixer,1349,3249,1900,1,00371,India
164161,2023-08-22,501,iphone 15,60000,80000,20000,1,00371,India
164161,2023-08-22,505,oven,18490,24000,5510,1,00371,India
164161,2023-08-22,504,iron,449,879,430,1,00371,India
840991,2023-08-22,502,iphone 15 pro max,100000,135000,35000,1,00031,India
840991,2023-08-22,505,oven,18490,24000,5510,1,00031,India
840991,2023-08-22,506,monitor,3249,8000,4751,1,00031,India
321746,2023-08-22,505,oven,18490,24000,5510,1,00472,India
321746,2023-08-22,502,iphone 15 pro max,100000,135000,35000,1,00472,India
918772,2023-08-22,501,iphone 15,60000,80000,20000,1,00489,India
918772,2023-08-22,504,iron,449,879,430,1,00489,India
918772,2023-08-22,507,washing machine,6990,16490,9500,1,00489,India
918772,2023-08-22,505,oven,18490,24000,5510,1,00489,India
306549,2023-08-22,502,iphone 15 pro max,100000,135000,35000,1,00208,India
517651,2023-08-22,504,iron,449,879,430,1,00126,India
517651,2023-08-22,506,monitor,3249,8000,4751,1,00126,India
517651,2023-08-22,505,oven,18490,24000,5510,1,00126,India
184784,2023-08-22,503,mixer,1349,3249,1900,1,00213,India
136921,2023-08-22,501,iphone 15,60000,80000,20000,1,00483,India
451881,2023-08-22,504,iron,449,879,430,1,00300,India
451881,2023-08-22,503,mixer,1349,3249,1900,1,00300,India
451881,2023-08-22,501,iphone 15,60000,80000,20000,1,00300,India
340652,2023-08-22,504,iron,449,879,430,1,00081,India
340652,2023-08-22,506,monitor,3249,8000,4751,1,00081,India
302294,2023-08-22,503,mixer,1349,3249,1900,1,00178,India
302294,2023-08-22,505,oven,18490,24000,5510,1,00178,India
302294,2023-08-22,506,monitor,3249,8000,4751,1,00178,India
195476,2023-08-22,504,iron,449,879,430,1,00162,India
195476,2023-08-22,506,monitor,3249,8000,4751,1,00162,India
195476,2023-08-22,503,mixer,1349,3249,1900,1,00162,India
749346,2023-08-22,505,oven,18490,24000,5510,1,00443,India
749346,2023-08-22,503,mixer,1349,3249,1900,1,00443,India
882185,2023-08-22,504,iron,449,879,430,1,00127,India
882185,2023-08-22,501,iphone 15,60000,80000,20000,1,00127,India
880215,2023-08-22,501,iphone 15,60000,80000,20000,1,00494,India
880215,2023-08-22,503,mixer,1349,3249,1900,1,00494,India
731305,2023-08-22,501,iphone 15,60000,80000,20000,1,00114,India
731305,2023-08-22,505,oven,18490,24000,5510,1,00114,India
731305,2023-08-22,507,washing machine,6990,16490,9500,1,00114,India
731305,2023-08-22,503,mixer,1349,3249,1900,1,00114,India
854741,2023-08-22,502,iphone 15 pro max,100000,135000,35000,1,00098,India
854741,2023-08-22,504,iron,449,879,430,1,00098,India
854741,2023-08-22,503,mixer,1349,3249,1900,1,00098,India
489500,2023-08-22,503,mixer,1349,3249,1900,1,00078,India
489500,2023-08-22,505,oven,18490,24000,5510,1,00078,India
489500,2023-08-22,504,iron,449,879,430,1,00078,India
468484,2023-08-23,501,iphone 15,60000,80000,20000,1,00175,India
468484,2023-08-23,502,iphone 15 pro max,100000,135000,35000,1,00175,India
468484,2023-08-23,503,mixer,1349,3249,1900,1,00175,India
993210,2023-08-23,502,iphone 15 pro max,100000,135000,35000,1,00411,India
993210,2023-08-23,507,washing machine,6990,16490,9500,1,00411,India
543746,2023-08-23,503,mixer,1349,3249,1900,1,00463,India
543746,2023-08-23,506,monitor,3249,8000,4751,1,00463,India
543746,2023-08-23,507,washing machine,6990,16490,9500,1,00463,India
927797,2023-08-23,501,iphone 15,60000,80000,20000,1,00487,India
927797,2023-08-23,502,iphone 15 pro max,100000,135000,35000,1,00487,India
535323,2023-08-23,504,iron,449,879,430,1,00114,India
541777,2023-08-23,501,iphone 15,60000,80000,20000,1,00469,India
541777,2023-08-23,504,iron,449,879,430,1,00469,India
541777,2023-08-23,502,iphone 15 pro max,100000,135000,35000,1,00469,India
405897,2023-08-23,504,iron,449,879,430,1,00385,India
732449,2023-08-23,506,monitor,3249,8000,4751,1,00314,India
732449,2023-08-23,503,mixer,1349,3249,1900,1,00314,India
732449,2023-08-23,501,iphone 15,60000,80000,20000,1,00314,India
732449,2023-08-23,502,iphone 15 pro max,100000,135000,35000,1,00314,India
618407,2023-08-23,507,washing machine,6990,16490,9500,1,00098,India
618407,2023-08-23,503,mixer,1349,3249,1900,1,00098,India
618407,2023-08-23,501,iphone 15,60000,80000,20000,1,00098,India
925078,2023-08-23,501,iphone 15,60000,80000,20000,1,00076,India
925078,2023-08-23,503,mixer,1349,3249,1900,1,00076,India
977169,2023-08-23,502,iphone 15 pro max,100000,135000,35000,1,00187,India
570261,2023-08-23,502,iphone 15 pro max,100000,135000,35000,1,00053,India
387609,2023-08-23,502,iphone 15 pro max,100000,135000,35000,1,00201,India
387609,2023-08-23,504,iron,449,879,430,1,00201,India
387609,2023-08-23,501,iphone 15,60000,80000,20000,1,00201,India
301725,2023-08-23,504,iron,449,879,430,1,00024,India
301725,2023-08-23,506,monitor,3249,8000,4751,1,00024,India
159132,2023-08-23,502,iphone 15 pro max,100000,135000,35000,1,00451,India
159132,2023-08-23,505,oven,18490,24000,5510,1,00451,India
159132,2023-08-23,506,monitor,3249,8000,4751,1,00451,India
359204,2023-08-23,502,iphone 15 pro max,100000,135000,35000,1,00482,India
359204,2023-08-23,506,monitor,3249,8000,4751,1,00482,India
683640,2023-08-23,507,washing machine,6990,16490,9500,1,00019,India
683640,2023-08-23,501,iphone 15,60000,80000,20000,1,00019,India
683640,2023-08-23,502,iphone 15 pro max,100000,135000,35000,1,00019,India
683640,2023-08-23,505,oven,18490,24000,5510,1,00019,India
523542,2023-08-23,503,mixer,1349,3249,1900,1,00359,India
523542,2023-08-23,502,iphone 15 pro max,100000,135000,35000,1,00359,India
523542,2023-08-23,507,washing machine,6990,16490,9500,1,00359,India
287765,2023-08-23,503,mixer,1349,3249,1900,1,00124,India
489442,2023-08-23,507,washing machine,6990,16490,9500,1,00404,India
489442,2023-08-23,504,iron,449,879,430,1,00404,India
489442,2023-08-23,502,iphone 15 pro max,100000,135000,35000,1,00404,India
489442,2023-08-23,505,oven,18490,24000,5510,1,00404,India
833246,2023-08-23,503,mixer,1349,3249,1900,1,00022,India
521019,2023-08-23,502,iphone 15 pro max,100000,135000,35000,1,00485,India
521019,2023-08-23,505,oven,18490,24000,5510,1,00485,India
531208,2023-08-23,504,iron,449,879,430,1,00040,India
531208,2023-08-23,501,iphone 15,60000,80000,20000,1,00040,India
531208,2023-08-23,502,iphone 15 pro max,100000,135000,35000,1,00040,India
775092,2023-08-23,504,iron,449,879,430,1,00155,India
775092,2023-08-23,503,mixer,1349,3249,1900,1,00155,India
775092,2023-08-23,507,washing machine,6990,16490,9500,1,00155,India
775092,2023-08-23,505,oven,18490,24000,5510,1,00155,India
234346,2023-08-23,503,mixer,1349,3249,1900,1,00065,India
234346,2023-08-23,501,iphone 15,60000,80000,20000,1,00065,India
234346,2023-08-23,506,monitor,3249,8000,4751,1,00065,India
696090,2023-08-23,505,oven,18490,24000,5510,1,00167,India
251271,2023-08-23,503,mixer,1349,3249,1900,1,00423,India
251271,2023-08-23,505,oven,18490,24000,5510,1,00423,India
190169,2023-08-23,503,mixer,1349,3249,1900,1,00244,India
190169,2023-08-23,504,iron,449,879,430,1,00244,India
190169,2023-08-23,502,iphone 15 pro max,100000,135000,35000,1,00244,India
801362,2023-08-23,503,mixer,1349,3249,1900,1,00048,India
801362,2023-08-23,506,monitor,3249,8000,4751,1,00048,India
801362,2023-08-23,505,oven,18490,24000,5510,1,00048,India
782058,2023-08-23,501,iphone 15,60000,80000,20000,1,00246,India
782058,2023-08-23,504,iron,449,879,430,1,00246,India
755937,2023-08-23,502,iphone 15 pro max,100000,135000,35000,1,00219,India
508718,2023-08-23,501,iphone 15,60000,80000,20000,1,00284,India
662976,2023-08-23,501,iphone 15,60000,80000,20000,1,00429,India
662976,2023-08-23,503,mixer,1349,3249,1900,1,00429,India
278923,2023-08-23,502,iphone 15 pro max,100000,135000,35000,1,00480,India
278923,2023-08-23,506,monitor,3249,8000,4751,1,00480,India
278923,2023-08-23,503,mixer,1349,3249,1900,1,00480,India
278923,2023-08-23,501,iphone 15,60000,80000,20000,1,00480,India
379562,2023-08-23,507,washing machine,6990,16490,9500,1,00416,India
855971,2023-08-23,507,washing machine,6990,16490,9500,1,00368,India
855971,2023-08-23,505,oven,18490,24000,5510,1,00368,India
855971,2023-08-23,506,monitor,3249,8000,4751,1,00368,India
855971,2023-08-23,503,mixer,1349,3249,1900,1,00368,India
928315,2023-08-23,505,oven,18490,24000,5510,1,00196,India
928315,2023-08-23,507,washing machine,6990,16490,9500,1,00196,India
928315,2023-08-23,502,iphone 15 pro max,100000,135000,35000,1,00196,India
119038,2023-08-23,507,washing machine,6990,16490,9500,1,00381,India
119038,2023-08-23,503,mixer,1349,3249,1900,1,00381,India
119038,2023-08-23,501,iphone 15,60000,80000,20000,1,00381,India
119038,2023-08-23,502,iphone 15 pro max,100000,135000,35000,1,00381,India
119038,2023-08-23,505,oven,18490,24000,5510,1,00381,India
597277,2023-08-23,502,iphone 15 pro max,100000,135000,35000,1,00154,India
597277,2023-08-23,505,oven,18490,24000,5510,1,00154,India
597277,2023-08-23,506,monitor,3249,8000,4751,1,00154,India
597277,2023-08-23,507,washing machine,6990,16490,9500,1,00154,India
669629,2023-08-23,503,mixer,1349,3249,1900,1,00299,India
614666,2023-08-23,505,oven,18490,24000,5510,1,00246,India
962166,2023-08-23,502,iphone 15 pro max,100000,135000,35000,1,00376,India
962166,2023-08-23,503,mixer,1349,3249,1900,1,00376,India
962166,2023-08-23,506,monitor,3249,8000,4751,1,00376,India
962166,2023-08-23,501,iphone 15,60000,80000,20000,1,00376,India
976902,2023-08-23,505,oven,18490,24000,5510,1,00460,India
976902,2023-08-23,506,monitor,3249,8000,4751,1,00460,India
805281,2023-08-23,502,iphone 15 pro max,100000,135000,35000,1,00346,India
805281,2023-08-23,503,mixer,1349,3249,1900,1,00346,India
395560,2023-08-23,506,monitor,3249,8000,4751,1,00108,India
395560,2023-08-23,505,oven,18490,24000,5510,1,00108,India
395560,2023-08-23,501,iphone 15,60000,80000,20000,1,00108,India
160025,2023-08-23,503,mixer,1349,3249,1900,1,00040,India
160025,2023-08-23,502,iphone 15 pro max,100000,135000,35000,1,00040,India
160025,2023-08-23,507,washing machine,6990,16490,9500,1,00040,India
291980,2023-08-23,505,oven,18490,24000,5510,1,00411,India
791437,2023-08-23,505,oven,18490,24000,5510,1,00077,India
791437,2023-08-23,501,iphone 15,60000,80000,20000,1,00077,India
297689,2023-08-23,504,iron,449,879,430,1,00182,India
297689,2023-08-23,506,monitor,3249,8000,4751,1,00182,India
297689,2023-08-23,505,oven,18490,24000,5510,1,00182,India
297689,2023-08-23,507,washing machine,6990,16490,9500,1,00182,India
300269,2023-08-23,505,oven,18490,24000,5510,1,00124,India
300269,2023-08-23,507,washing machine,6990,16490,9500,1,00124,India
300269,2023-08-23,504,iron,449,879,430,1,00124,India
300269,2023-08-23,502,iphone 15 pro max,100000,135000,35000,1,00124,India
140593,2023-08-23,504,iron,449,879,430,1,00378,India
140593,2023-08-23,507,washing machine,6990,16490,9500,1,00378,India
818984,2023-08-23,502,iphone 15 pro max,100000,135000,35000,1,00088,India
853628,2023-08-23,502,iphone 15 pro max,100000,135000,35000,1,00236,India
699646,2023-08-23,505,oven,18490,24000,5510,1,00350,India
501698,2023-08-23,503,mixer,1349,3249,1900,1,00343,India
501698,2023-08-23,502,iphone 15 pro max,100000,135000,35000,1,00343,India
501698,2023-08-23,506,monitor,3249,8000,4751,1,00343,India
485684,2023-08-23,505,oven,18490,24000,5510,1,00067,India
485684,2023-08-23,504,iron,449,879,430,1,00067,India
485684,2023-08-23,507,washing machine,6990,16490,9500,1,00067,India
485684,2023-08-23,501,iphone 15,60000,80000,20000,1,00067,India
855255,2023-08-23,502,iphone 15 pro max,100000,135000,35000,1,00277,India
614252,2023-08-23,507,washing machine,6990,16490,9500,1,00310,India
699744,2023-08-23,505,oven,18490,24000,5510,1,00023,India
699744,2023-08-23,503,mixer,1349,3249,1900,1,00023,India
699744,2023-08-23,501,iphone 15,60000,80000,20000,1,00023,India
416917,2023-08-23,507,washing machine,6990,16490,9500,1,00441,India
416917,2023-08-23,502,iphone 15 pro max,100000,135000,35000,1,00441,India
416917,2023-08-23,506,monitor,3249,8000,4751,1,00441,India
416917,2023-08-23,501,iphone 15,60000,80000,20000,1,00441,India
616488,2023-08-23,501,iphone 15,60000,80000,20000,1,00066,India
616488,2023-08-23,504,iron,449,879,430,1,00066,India
616488,2023-08-23,505,oven,18490,24000,5510,1,00066,India
632988,2023-08-23,502,iphone 15 pro max,100000,135000,35000,1,00020,India
654632,2023-08-23,507,washing machine,6990,16490,9500,1,00452,India
654632,2023-08-23,506,monitor,3249,8000,4751,1,00452,India
144092,2023-08-23,503,mixer,1349,3249,1900,1,00331,India
832271,2023-08-23,506,monitor,3249,8000,4751,1,00161,India
832271,2023-08-23,502,iphone 15 pro max,100000,135000,35000,1,00161,India
193309,2023-08-23,501,iphone 15,60000,80000,20000,1,00361,India
193309,2023-08-23,507,washing machine,6990,16490,9500,1,00361,India
193309,2023-08-23,506,monitor,3249,8000,4751,1,00361,India
193309,2023-08-23,502,iphone 15 pro max,100000,135000,35000,1,00361,India
367828,2023-08-23,506,monitor,3249,8000,4751,1,00090,India
367828,2023-08-23,504,iron,449,879,430,1,00090,India
367828,2023-08-23,501,iphone 15,60000,80000,20000,1,00090,India
367828,2023-08-23,505,oven,18490,24000,5510,1,00090,India
158532,2023-08-23,504,iron,449,879,430,1,00414,India
158532,2023-08-23,506,monitor,3249,8000,4751,1,00414,India
651325,2023-08-24,506,monitor,3249,8000,4751,1,00112,India
150661,2023-08-24,507,washing machine,6990,16490,9500,1,00398,India
150661,2023-08-24,504,iron,449,879,430,1,00398,India
147278,2023-08-24,502,iphone 15 pro max,100000,135000,35000,1,00210,India
147278,2023-08-24,506,monitor,3249,8000,4751,1,00210,India
147278,2023-08-24,507,washing machine,6990,16490,9500,1,00210,India
216160,2023-08-24,505,oven,18490,24000,5510,1,00071,India
216160,2023-08-24,501,iphone 15,60000,80000,20000,1,00071,India
216160,2023-08-24,503,mixer,1349,3249,1900,1,00071,India
830765,2023-08-24,506,monitor,3249,8000,4751,1,00136,India
830765,2023-08-24,505,oven,18490,24000,5510,1,00136,India
830765,2023-08-24,503,mixer,1349,3249,1900,1,00136,India
356403,2023-08-24,505,oven,18490,24000,5510,1,00211,India
356403,2023-08-24,504,iron,449,879,430,1,00211,India
254697,2023-08-24,507,washing machine,6990,16490,9500,1,00315,India
254697,2023-08-24,505,oven,18490,24000,5510,1,00315,India
254697,2023-08-24,501,iphone 15,60000,80000,20000,1,00315,India
254697,2023-08-24,503,mixer,1349,3249,1900,1,00315,India
339592,2023-08-24,501,iphone 15,60000,80000,20000,1,00247,India
339592,2023-08-24,506,monitor,3249,8000,4751,1,00247,India
339592,2023-08-24,502,iphone 15 pro max,100000,135000,35000,1,00247,India
639387,2023-08-24,501,iphone 15,60000,80000,20000,1,00047,India
639387,2023-08-24,507,washing machine,6990,16490,9500,1,00047,India
639387,2023-08-24,505,oven,18490,24000,5510,1,00047,India
827886,2023-08-24,502,iphone 15 pro max,100000,135000,35000,1,00161,India
827886,2023-08-24,505,oven,18490,24000,5510,1,00161,India
178485,2023-08-24,507,washing machine,6990,16490,9500,1,00017,India
178485,2023-08-24,504,iron,449,879,430,1,00017,India
376347,2023-08-24,501,iphone 15,60000,80000,20000,1,00483,India
376347,2023-08-24,505,oven,18490,24000,5510,1,00483,India
376347,2023-08-24,507,washing machine,6990,16490,9500,1,00483,India
441058,2023-08-24,501,iphone 15,60000,80000,20000,1,00203,India
798628,2023-08-24,507,washing machine,6990,16490,9500,1,00354,India
798628,2023-08-24,506,monitor,3249,8000,4751,1,00354,India
377915,2023-08-24,503,mixer,1349,3249,1900,1,00188,India
377915,2023-08-24,502,iphone 15 pro max,100000,135000,35000,1,00188,India
717471,2023-08-24,507,washing machine,6990,16490,9500,1,00145,India
717471,2023-08-24,504,iron,449,879,430,1,00145,India
717471,2023-08-24,502,iphone 15 pro max,100000,135000,35000,1,00145,India
717471,2023-08-24,501,iphone 15,60000,80000,20000,1,00145,India
590560,2023-08-24,502,iphone 15 pro max,100000,135000,35000,1,00107,India
590560,2023-08-24,507,washing machine,6990,16490,9500,1,00107,India
590560,2023-08-24,504,iron,449,879,430,1,00107,India
851013,2023-08-24,503,mixer,1349,3249,1900,1,00478,India
851013,2023-08-24,505,oven,18490,24000,5510,1,00478,India
851013,2023-08-24,504,iron,449,879,430,1,00478,India
374719,2023-08-24,501,iphone 15,60000,80000,20000,1,00337,India
374719,2023-08-24,505,oven,18490,24000,5510,1,00337,India
374719,2023-08-24,506,monitor,3249,8000,4751,1,00337,India
961929,2023-08-24,505,oven,18490,24000,5510,1,00468,India
961929,2023-08-24,507,washing machine,6990,16490,9500,1,00468,India
961929,2023-08-24,504,iron,449,879,430,1,00468,India
272912,2023-08-24,502,iphone 15 pro max,100000,135000,35000,1,00324,India
272912,2023-08-24,505,oven,18490,24000,5510,1,00324,India
272912,2023-08-24,501,iphone 15,60000,80000,20000,1,00324,India
272912,2023-08-24,507,washing machine,6990,16490,9500,1,00324,India
592637,2023-08-24,504,iron,449,879,430,1,00356,India
592637,2023-08-24,503,mixer,1349,3249,1900,1,00356,India
685317,2023-08-24,503,mixer,1349,3249,1900,1,00319,India
685317,2023-08-24,504,iron,449,879,430,1,00319,India
956623,2023-08-24,504,iron,449,879,430,1,00433,India
956623,2023-08-24,502,iphone 15 pro max,100000,135000,35000,1,00433,India
990822,2023-08-24,504,iron,449,879,430,1,00410,India
990822,2023-08-24,503,mixer,1349,3249,1900,1,00410,India
813188,2023-08-24,506,monitor,3249,8000,4751,1,00124,India
813188,2023-08-24,505,oven,18490,24000,5510,1,00124,India
973961,2023-08-24,506,monitor,3249,8000,4751,1,00016,India
973961,2023-08-24,505,oven,18490,24000,5510,1,00016,India
973961,2023-08-24,502,iphone 15 pro max,100000,135000,35000,1,00016,India
973961,2023-08-24,503,mixer,1349,3249,1900,1,00016,India
223248,2023-08-24,501,iphone 15,60000,80000,20000,1,00234,India
223248,2023-08-24,505,oven,18490,24000,5510,1,00234,India
223248,2023-08-24,502,iphone 15 pro max,100000,135000,35000,1,00234,India
641991,2023-08-24,505,oven,18490,24000,5510,1,00054,India
641991,2023-08-24,503,mixer,1349,3249,1900,1,00054,India
171107,2023-08-24,507,washing machine,6990,16490,9500,1,00116,India
171107,2023-08-24,502,iphone 15 pro max,100000,135000,35000,1,00116,India
171107,2023-08-24,505,oven,18490,24000,5510,1,00116,India
336317,2023-08-24,501,iphone 15,60000,80000,20000,1,00455,India
281784,2023-08-24,507,washing machine,6990,16490,9500,1,00254,India
281784,2023-08-24,502,iphone 15 pro max,100000,135000,35000,1,00254,India
603243,2023-08-24,506,monitor,3249,8000,4751,1,00036,India
323688,2023-08-24,501,iphone 15,60000,80000,20000,1,00313,India
323688,2023-08-24,507,washing machine,6990,16490,9500,1,00313,India
627945,2023-08-24,501,iphone 15,60000,80000,20000,1,00373,India
627945,2023-08-24,502,iphone 15 pro max,100000,135000,35000,1,00373,India
627945,2023-08-24,507,washing machine,6990,16490,9500,1,00373,India
627945,2023-08-24,506,monitor,3249,8000,4751,1,00373,India
382296,2023-08-24,503,mixer,1349,3249,1900,1,00032,India
382296,2023-08-24,506,monitor,3249,8000,4751,1,00032,India
382296,2023-08-24,505,oven,18490,24000,5510,1,00032,India
382296,2023-08-24,501,iphone 15,60000,80000,20000,1,00032,India
382296,2023-08-24,502,iphone 15 pro max,100000,135000,35000,1,00032,India
682603,2023-08-24,503,mixer,1349,3249,1900,1,00346,India
682603,2023-08-24,507,washing machine,6990,16490,9500,1,00346,India
682603,2023-08-24,504,iron,449,879,430,1,00346,India
192223,2023-08-24,503,mixer,1349,3249,1900,1,00250,India
289666,2023-08-24,504,iron,449,879,430,1,00311,India
289666,2023-08-24,502,iphone 15 pro max,100000,135000,35000,1,00311,India
289666,2023-08-24,501,iphone 15,60000,80000,20000,1,00311,India
116429,2023-08-24,505,oven,18490,24000,5510,1,00059,India
116429,2023-08-24,501,iphone 15,60000,80000,20000,1,00059,India
106027,2023-08-24,505,oven,18490,24000,5510,1,00053,India
106027,2023-08-24,506,monitor,3249,8000,4751,1,00053,India
729559,2023-08-24,503,mixer,1349,3249,1900,1,00492,India
948392,2023-08-24,501,iphone 15,60000,80000,20000,1,00468,India
555495,2023-08-24,502,iphone 15 pro max,100000,135000,35000,1,00194,India
555495,2023-08-24,501,iphone 15,60000,80000,20000,1,00194,India
555495,2023-08-24,505,oven,18490,24000,5510,1,00194,India
769044,2023-08-24,502,iphone 15 pro max,100000,135000,35000,1,00088,India
769044,2023-08-24,503,mixer,1349,3249,1900,1,00088,India
769044,2023-08-24,506,monitor,3249,8000,4751,1,00088,India
769044,2023-08-24,505,oven,18490,24000,5510,1,00088,India
724065,2023-08-24,506,monitor,3249,8000,4751,1,00043,India
724065,2023-08-24,505,oven,18490,24000,5510,1,00043,India
596989,2023-08-24,506,monitor,3249,8000,4751,1,00091,India
596989,2023-08-24,504,iron,449,879,430,1,00091,India
596989,2023-08-24,505,oven,18490,24000,5510,1,00091,India
955153,2023-08-24,502,iphone 15 pro max,100000,135000,35000,1,00320,India
955153,2023-08-24,501,iphone 15,60000,80000,20000,1,00320,India
955153,2023-08-24,506,monitor,3249,8000,4751,1,00320,India
925542,2023-08-24,507,washing machine,6990,16490,9500,1,00405,India
925542,2023-08-24,504,iron,449,879,430,1,00405,India
337290,2023-08-24,501,iphone 15,60000,80000,20000,1,00013,India
337290,2023-08-24,507,washing machine,6990,16490,9500,1,00013,India
337290,2023-08-24,502,iphone 15 pro max,100000,135000,35000,1,00013,India
216537,2023-08-24,502,iphone 15 pro max,100000,135000,35000,1,00474,India
216537,2023-08-24,506,monitor,3249,8000,4751,1,00474,India
216537,2023-08-24,505,oven,18490,24000,5510,1,00474,India
216537,2023-08-24,501,iphone 15,60000,80000,20000,1,00474,India
904950,2023-08-24,501,iphone 15,60000,80000,20000,1,00077,India
904950,2023-08-24,503,mixer,1349,3249,1900,1,00077,India
904950,2023-08-24,505,oven,18490,24000,5510,1,00077,India
904950,2023-08-24,506,monitor,3249,8000,4751,1,00077,India
414262,2023-08-24,505,oven,18490,24000,5510,1,00241,India
414262,2023-08-24,502,iphone 15 pro max,100000,135000,35000,1,00241,India
414262,2023-08-24,507,washing machine,6990,16490,9500,1,00241,India
414262,2023-08-24,506,monitor,3249,8000,4751,1,00241,India
414262,2023-08-24,501,iphone 15,60000,80000,20000,1,00241,India
450234,2023-08-24,503,mixer,1349,3249,1900,1,00350,India
450234,2023-08-24,504,iron,449,879,430,1,00350,India
685742,2023-08-24,506,monitor,3249,8000,4751,1,00407,India
685742,2023-08-24,507,washing machine,6990,16490,9500,1,00407,India
685742,2023-08-24,503,mixer,1349,3249,1900,1,00407,India
685742,2023-08-24,505,oven,18490,24000,5510,1,00407,India
592253,2023-08-24,503,mixer,1349,3249,1900,1,00480,India
592253,2023-08-24,507,washing machine,6990,16490,9500,1,00480,India
592253,2023-08-24,504,iron,449,879,430,1,00480,India
592253,2023-08-24,502,iphone 15 pro max,100000,135000,35000,1,00480,India
715043,2023-08-24,501,iphone 15,60000,80000,20000,1,00382,India
715043,2023-08-24,504,iron,449,879,430,1,00382,India
715043,2023-08-24,502,iphone 15 pro max,100000,135000,35000,1,00382,India
715043,2023-08-24,506,monitor,3249,8000,4751,1,00382,India
454833,2023-08-24,506,monitor,3249,8000,4751,1,00245,India
454833,2023-08-24,502,iphone 15 pro max,100000,135000,35000,1,00245,India
823039,2023-08-24,501,iphone 15,60000,80000,20000,1,00026,India
823039,2023-08-24,506,monitor,3249,8000,4751,1,00026,India
561138,2023-08-24,501,iphone 15,60000,80000,20000,1,00207,India
561138,2023-08-24,506,monitor,3249,8000,4751,1,00207,India
982411,2023-08-24,501,iphone 15,60000,80000,20000,1,00206,India
982411,2023-08-24,507,washing machine,6990,16490,9500,1,00206,India
715399,2023-08-24,506,monitor,3249,8000,4751,1,00083,India
715399,2023-08-24,501,iphone 15,60000,80000,20000,1,00083,India
332266,2023-08-24,507,washing machine,6990,16490,9500,1,00098,India
332266,2023-08-24,501,iphone 15,60000,80000,20000,1,00098,India
332266,2023-08-24,502,iphone 15 pro max,100000,135000,35000,1,00098,India
622498,2023-08-24,503,mixer,1349,3249,1900,1,00120,India
622498,2023-08-24,504,iron,449,879,430,1,00120,India
753253,2023-08-24,501,iphone 15,60000,80000,20000,1,00230,India
753253,2023-08-24,507,washing machine,6990,16490,9500,1,00230,India
627222,2023-08-24,507,washing machine,6990,16490,9500,1,00094,India
170044,2023-08-24,504,iron,449,879,430,1,00055,India
333220,2023-08-24,504,iron,449,879,430,1,00075,India
333220,2023-08-24,507,washing machine,6990,16490,9500,1,00075,India
880795,2023-08-24,505,oven,18490,24000,5510,1,00450,India
880795,2023-08-24,503,mixer,1349,3249,1900,1,00450,India
880795,2023-08-24,504,iron,449,879,430,1,00450,India
922418,2023-08-24,503,mixer,1349,3249,1900,1,00266,India
816543,2023-08-24,501,iphone 15,60000,80000,20000,1,00323,India
937849,2023-08-24,501,iphone 15,60000,80000,20000,1,00139,India
937849,2023-08-24,507,washing machine,6990,16490,9500,1,00139,India
216148,2023-08-24,502,iphone 15 pro max,100000,135000,35000,1,00374,India
216148,2023-08-24,504,iron,449,879,430,1,00374,India
216148,2023-08-24,503,mixer,1349,3249,1900,1,00374,India
216148,2023-08-24,506,monitor,3249,8000,4751,1,00374,India
951493,2023-08-24,506,monitor,3249,8000,4751,1,00206,India
165312,2023-08-24,502,iphone 15 pro max,100000,135000,35000,1,00157,India
549128,2023-08-24,506,monitor,3249,8000,4751,1,00011,India
549128,2023-08-24,505,oven,18490,24000,5510,1,00011,India
549128,2023-08-24,504,iron,449,879,430,1,00011,India
549128,2023-08-24,501,iphone 15,60000,80000,20000,1,00011,India
549128,2023-08-24,507,washing machine,6990,16490,9500,1,00011,India
106418,2023-08-24,502,iphone 15 pro max,100000,135000,35000,1,00185,India
106418,2023-08-24,501,iphone 15,60000,80000,20000,1,00185,India
106418,2023-08-24,503,mixer,1349,3249,1900,1,00185,India
106418,2023-08-24,504,iron,449,879,430,1,00185,India
581580,2023-08-25,501,iphone 15,60000,80000,20000,1,00466,India
581580,2023-08-25,507,washing machine,6990,16490,9500,1,00466,India
987247,2023-08-25,506,monitor,3249,8000,4751,1,00258,India
987247,2023-08-25,507,washing machine,6990,16490,9500,1,00258,India
987247,2023-08-25,501,iphone 15,60000,80000,20000,1,00258,India
987247,2023-08-25,502,iphone 15 pro max,100000,135000,35000,1,00258,India
971757,2023-08-25,504,iron,449,879,430,1,00197,India
971757,2023-08-25,502,iphone 15 pro max,100000,135000,35000,1,00197,India
408524,2023-08-25,503,mixer,1349,3249,1900,1,00002,India
408524,2023-08-25,505,oven,18490,24000,5510,1,00002,India
408524,2023-08-25,507,washing machine,6990,16490,9500,1,00002,India
408524,2023-08-25,501,iphone 15,60000,80000,20000,1,00002,India
685495,2023-08-25,504,iron,449,879,430,1,00099,India
685495,2023-08-25,505,oven,18490,24000,5510,1,00099,India
685495,2023-08-25,506,monitor,3249,8000,4751,1,00099,India
946451,2023-08-25,505,oven,18490,24000,5510,1,00284,India
946451,2023-08-25,501,iphone 15,60000,80000,20000,1,00284,India
946451,2023-08-25,503,mixer,1349,3249,1900,1,00284,India
396033,2023-08-25,504,iron,449,879,430,1,00120,India
396033,2023-08-25,503,mixer,1349,3249,1900,1,00120,India
396033,2023-08-25,501,iphone 15,60000,80000,20000,1,00120,India
332055,2023-08-25,505,oven,18490,24000,5510,1,00091,India
332055,2023-08-25,501,iphone 15,60000,80000,20000,1,00091,India
332055,2023-08-25,507,washing machine,6990,16490,9500,1,00091,India
537794,2023-08-25,506,monitor,3249,8000,4751,1,00294,India
537794,2023-08-25,503,mixer,1349,3249,1900,1,00294,India
537794,2023-08-25,504,iron,449,879,430,1,00294,India
755379,2023-08-25,503,mixer,1349,3249,1900,1,00413,India
755379,2023-08-25,504,iron,449,879,430,1,00413,India
817591,2023-08-25,501,iphone 15,60000,80000,20000,1,00451,India
578155,2023-08-25,507,washing machine,6990,16490,9500,1,00040,India
578155,2023-08-25,501,iphone 15,60000,80000,20000,1,00040,India
578155,2023-08-25,503,mixer,1349,3249,1900,1,00040,India
615772,2023-08-25,507,washing machine,6990,16490,9500,1,00463,India
615772,2023-08-25,506,monitor,3249,8000,4751,1,00463,India
615772,2023-08-25,502,iphone 15 pro max,100000,135000,35000,1,00463,India
615772,2023-08-25,503,mixer,1349,3249,1900,1,00463,India
239235,2023-08-25,503,mixer,1349,3249,1900,1,00007,India
203267,2023-08-25,506,monitor,3249,8000,4751,1,00007,India
156155,2023-08-25,503,mixer,1349,3249,1900,1,00471,India
156155,2023-08-25,502,iphone 15 pro max,100000,135000,35000,1,00471,India
156155,2023-08-25,504,iron,449,879,430,1,00471,India
156155,2023-08-25,501,iphone 15,60000,80000,20000,1,00471,India
156155,2023-08-25,507,washing machine,6990,16490,9500,1,00471,India
745764,2023-08-25,505,oven,18490,24000,5510,1,00239,India
842428,2023-08-25,507,washing machine,6990,16490,9500,1,00456,India
662014,2023-08-25,506,monitor,3249,8000,4751,1,00126,India
662014,2023-08-25,505,oven,18490,24000,5510,1,00126,India
662014,2023-08-25,502,iphone 15 pro max,100000,135000,35000,1,00126,India
381236,2023-08-25,505,oven,18490,24000,5510,1,00323,India
381236,2023-08-25,502,iphone 15 pro max,100000,135000,35000,1,00323,India
381236,2023-08-25,506,monitor,3249,8000,4751,1,00323,India
381236,2023-08-25,501,iphone 15,60000,80000,20000,1,00323,India
941981,2023-08-25,504,iron,449,879,430,1,00424,India
941981,2023-08-25,501,iphone 15,60000,80000,20000,1,00424,India
941981,2023-08-25,505,oven,18490,24000,5510,1,00424,India
941981,2023-08-25,506,monitor,3249,8000,4751,1,00424,India
801261,2023-08-25,507,washing machine,6990,16490,9500,1,00461,India
801261,2023-08-25,505,oven,18490,24000,5510,1,00461,India
166661,2023-08-25,504,iron,449,879,430,1,00416,India
166661,2023-08-25,503,mixer,1349,3249,1900,1,00416,India
166661,2023-08-25,502,iphone 15 pro max,100000,135000,35000,1,00416,India
166661,2023-08-25,505,oven,18490,24000,5510,1,00416,India
368514,2023-08-25,506,monitor,3249,8000,4751,1,00028,India
368514,2023-08-25,503,mixer,1349,3249,1900,1,00028,India
368514,2023-08-25,502,iphone 15 pro max,100000,135000,35000,1,00028,India
368514,2023-08-25,501,iphone 15,60000,80000,20000,1,00028,India
780529,2023-08-25,507,washing machine,6990,16490,9500,1,00474,India
780529,2023-08-25,503,mixer,1349,3249,1900,1,00474,India
780529,2023-08-25,504,iron,449,879,430,1,00474,India
946277,2023-08-25,506,monitor,3249,8000,4751,1,00387,India
946277,2023-08-25,505,oven,18490,24000,5510,1,00387,India
772062,2023-08-25,507,washing machine,6990,16490,9500,1,00330,India
772062,2023-08-25,503,mixer,1349,3249,1900,1,00330,India
772062,2023-08-25,505,oven,18490,24000,5510,1,00330,India
772062,2023-08-25,502,iphone 15 pro max,100000,135000,35000,1,00330,India
213519,2023-08-25,501,iphone 15,60000,80000,20000,1,00344,India
213519,2023-08-25,503,mixer,1349,3249,1900,1,00344,India
213519,2023-08-25,504,iron,449,879,430,1,00344,India
518712,2023-08-25,506,monitor,3249,8000,4751,1,00224,India
518712,2023-08-25,502,iphone 15 pro max,100000,135000,35000,1,00224,India
518712,2023-08-25,507,washing machine,6990,16490,9500,1,00224,India
518712,2023-08-25,504,iron,449,879,430,1,00224,India
920945,2023-08-25,507,washing machine,6990,16490,9500,1,00182,India
920945,2023-08-25,501,iphone 15,60000,80000,20000,1,00182,India
920945,2023-08-25,503,mixer,1349,3249,1900,1,00182,India
920945,2023-08-25,502,iphone 15 pro max,100000,135000,35000,1,00182,India
674110,2023-08-25,506,monitor,3249,8000,4751,1,00451,India
674110,2023-08-25,501,iphone 15,60000,80000,20000,1,00451,India
674110,2023-08-25,507,washing machine,6990,16490,9500,1,00451,India
674110,2023-08-25,503,mixer,1349,3249,1900,1,00451,India
674110,2023-08-25,502,iphone 15 pro max,100000,135000,35000,1,00451,India
798870,2023-08-25,502,iphone 15 pro max,100000,135000,35000,1,00491,India
798870,2023-08-25,503,mixer,1349,3249,1900,1,00491,India
798870,2023-08-25,507,washing machine,6990,16490,9500,1,00491,India
489852,2023-08-25,503,mixer,1349,3249,1900,1,00056,India
345965,2023-08-25,506,monitor,3249,8000,4751,1,00366,India
345965,2023-08-25,504,iron,449,879,430,1,00366,India
544830,2023-08-25,506,monitor,3249,8000,4751,1,00456,India
295062,2023-08-25,502,iphone 15 pro max,100000,135000,35000,1,00035,India
418455,2023-08-25,503,mixer,1349,3249,1900,1,00120,India
418455,2023-08-25,501,iphone 15,60000,80000,20000,1,00120,India
418455,2023-08-25,505,oven,18490,24000,5510,1,00120,India
446904,2023-08-25,502,iphone 15 pro max,100000,135000,35000,1,00011,India
446904,2023-08-25,504,iron,449,879,430,1,00011,India
446904,2023-08-25,503,mixer,1349,3249,1900,1,00011,India
719016,2023-08-25,505,oven,18490,24000,5510,1,00006,India
342807,2023-08-25,503,mixer,1349,3249,1900,1,00118,India
342807,2023-08-25,505,oven,18490,24000,5510,1,00118,India
342807,2023-08-25,506,monitor,3249,8000,4751,1,00118,India
342807,2023-08-25,504,iron,449,879,430,1,00118,India
292099,2023-08-25,506,monitor,3249,8000,4751,1,00285,India
423216,2023-08-25,507,washing machine,6990,16490,9500,1,00247,India
423216,2023-08-25,504,iron,449,879,430,1,00247,India
423216,2023-08-25,502,iphone 15 pro max,100000,135000,35000,1,00247,India
423216,2023-08-25,506,monitor,3249,8000,4751,1,00247,India
565468,2023-08-25,501,iphone 15,60000,80000,20000,1,00222,India
565468,2023-08-25,502,iphone 15 pro max,100000,135000,35000,1,00222,India
565468,2023-08-25,503,mixer,1349,3249,1900,1,00222,India
580931,2023-08-25,501,iphone 15,60000,80000,20000,1,00439,India
580931,2023-08-25,507,washing machine,6990,16490,9500,1,00439,India
115281,2023-08-25,504,iron,449,879,430,1,00310,India
115281,2023-08-25,507,washing machine,6990,16490,9500,1,00310,India
115281,2023-08-25,506,monitor,3249,8000,4751,1,00310,India
143656,2023-08-25,503,mixer,1349,3249,1900,1,00114,India
161117,2023-08-25,505,oven,18490,24000,5510,1,00236,India
161117,2023-08-25,503,mixer,1349,3249,1900,1,00236,India
161117,2023-08-25,502,iphone 15 pro max,100000,135000,35000,1,00236,India
753000,2023-08-25,504,iron,449,879,430,1,00014,India
753000,2023-08-25,506,monitor,3249,8000,4751,1,00014,India
753000,2023-08-25,505,oven,18490,24000,5510,1,00014,India
764747,2023-08-25,502,iphone 15 pro max,100000,135000,35000,1,00263,India
764747,2023-08-25,501,iphone 15,60000,80000,20000,1,00263,India
328651,2023-08-25,507,washing machine,6990,16490,9500,1,00263,India
328651,2023-08-25,503,mixer,1349,3249,1900,1,00263,India
862283,2023-08-25,501,iphone 15,60000,80000,20000,1,00315,India
772520,2023-08-25,504,iron,449,879,430,1,00050,India
772520,2023-08-25,507,washing machine,6990,16490,9500,1,00050,India
772520,2023-08-25,503,mixer,1349,3249,1900,1,00050,India
772520,2023-08-25,502,iphone 15 pro max,100000,135000,35000,1,00050,India
495801,2023-08-25,505,oven,18490,24000,5510,1,00190,India
495801,2023-08-25,507,washing machine,6990,16490,9500,1,00190,India
153771,2023-08-25,506,monitor,3249,8000,4751,1,00197,India
153771,2023-08-25,502,iphone 15 pro max,100000,135000,35000,1,00197,India
153771,2023-08-25,504,iron,449,879,430,1,00197,India
337779,2023-08-25,502,iphone 15 pro max,100000,135000,35000,1,00197,India
337779,2023-08-25,503,mixer,1349,3249,1900,1,00197,India
337779,2023-08-25,505,oven,18490,24000,5510,1,00197,India
337779,2023-08-25,504,iron,449,879,430,1,00197,India
845070,2023-08-26,505,oven,18490,24000,5510,1,00122,India
845070,2023-08-26,507,washing machine,6990,16490,9500,1,00122,India
925996,2023-08-26,504,iron,449,879,430,1,00236,India
925996,2023-08-26,505,oven,18490,24000,5510,1,00236,India
925996,2023-08-26,507,washing machine,6990,16490,9500,1,00236,India
925996,2023-08-26,501,iphone 15,60000,80000,20000,1,00236,India
607760,2023-08-26,502,iphone 15 pro max,100000,135000,35000,1,00275,India
607760,2023-08-26,507,washing machine,6990,16490,9500,1,00275,India
607760,2023-08-26,503,mixer,1349,3249,1900,1,00275,India
494753,2023-08-26,505,oven,18490,24000,5510,1,00194,India
494753,2023-08-26,507,washing machine,6990,16490,9500,1,00194,India
138172,2023-08-26,506,monitor,3249,8000,4751,1,00022,India
138172,2023-08-26,505,oven,18490,24000,5510,1,00022,India
160176,2023-08-26,505,oven,18490,24000,5510,1,00336,India
326982,2023-08-26,502,iphone 15 pro max,100000,135000,35000,1,00473,India
326982,2023-08-26,503,mixer,1349,3249,1900,1,00473,India
326982,2023-08-26,504,iron,449,879,430,1,00473,India
326982,2023-08-26,507,washing machine,6990,16490,9500,1,00473,India
293047,2023-08-26,507,washing machine,6990,16490,9500,1,00424,India
293047,2023-08-26,501,iphone 15,60000,80000,20000,1,00424,India
170780,2023-08-26,505,oven,18490,24000,5510,1,00278,India
170780,2023-08-26,507,washing machine,6990,16490,9500,1,00278,India
170780,2023-08-26,501,iphone 15,60000,80000,20000,1,00278,India
170780,2023-08-26,506,monitor,3249,8000,4751,1,00278,India
666926,2023-08-26,504,iron,449,879,430,1,00497,India
666926,2023-08-26,505,oven,18490,24000,5510,1,00497,India
666926,2023-08-26,507,washing machine,6990,16490,9500,1,00497,India
917029,2023-08-26,507,washing machine,6990,16490,9500,1,00498,India
917029,2023-08-26,501,iphone 15,60000,80000,20000,1,00498,India
917029,2023-08-26,506,monitor,3249,8000,4751,1,00498,India
279008,2023-08-26,503,mixer,1349,3249,1900,1,00433,India
572772,2023-08-26,505,oven,18490,24000,5510,1,00085,India
572772,2023-08-26,507,washing machine,6990,16490,9500,1,00085,India
595601,2023-08-26,501,iphone 15,60000,80000,20000,1,00497,India
577130,2023-08-26,502,iphone 15 pro max,100000,135000,35000,1,00234,India
577130,2023-08-26,504,iron,449,879,430,1,00234,India
470617,2023-08-26,507,washing machine,6990,16490,9500,1,00345,India
470617,2023-08-26,501,iphone 15,60000,80000,20000,1,00345,India
817734,2023-08-26,503,mixer,1349,3249,1900,1,00091,India
817734,2023-08-26,502,iphone 15 pro max,100000,135000,35000,1,00091,India
847028,2023-08-26,504,iron,449,879,430,1,00018,India
847028,2023-08-26,507,washing machine,6990,16490,9500,1,00018,India
847028,2023-08-26,506,monitor,3249,8000,4751,1,00018,India
847028,2023-08-26,501,iphone 15,60000,80000,20000,1,00018,India
847028,2023-08-26,505,oven,18490,24000,5510,1,00018,India
324550,2023-08-26,507,washing machine,6990,16490,9500,1,00417,India
324550,2023-08-26,504,iron,449,879,430,1,00417,India
696076,2023-08-26,505,oven,18490,24000,5510,1,00182,India
747962,2023-08-26,502,iphone 15 pro max,100000,135000,35000,1,00126,India
747962,2023-08-26,503,mixer,1349,3249,1900,1,00126,India
747962,2023-08-26,505,oven,18490,24000,5510,1,00126,India
381282,2023-08-26,501,iphone 15,60000,80000,20000,1,00377,India
381282,2023-08-26,502,iphone 15 pro max,100000,135000,35000,1,00377,India
381282,2023-08-26,505,oven,18490,24000,5510,1,00377,India
812966,2023-08-26,501,iphone 15,60000,80000,20000,1,00117,India
812966,2023-08-26,506,monitor,3249,8000,4751,1,00117,India
578309,2023-08-26,506,monitor,3249,8000,4751,1,00196,India
578309,2023-08-26,503,mixer,1349,3249,1900,1,00196,India
886274,2023-08-26,504,iron,449,879,430,1,00393,India
886274,2023-08-26,506,monitor,3249,8000,4751,1,00393,India
886274,2023-08-26,501,iphone 15,60000,80000,20000,1,00393,India
424226,2023-08-26,501,iphone 15,60000,80000,20000,1,00353,India
612196,2023-08-26,502,iphone 15 pro max,100000,135000,35000,1,00492,India
612196,2023-08-26,506,monitor,3249,8000,4751,1,00492,India
612196,2023-08-26,507,washing machine,6990,16490,9500,1,00492,India
635203,2023-08-26,503,mixer,1349,3249,1900,1,00458,India
635203,2023-08-26,504,iron,449,879,430,1,00458,India
635203,2023-08-26,505,oven,18490,24000,5510,1,00458,India
635203,2023-08-26,507,washing machine,6990,16490,9500,1,00458,India
360397,2023-08-26,502,iphone 15 pro max,100000,135000,35000,1,00191,India
360397,2023-08-26,505,oven,18490,24000,5510,1,00191,India
514783,2023-08-26,506,monitor,3249,8000,4751,1,00498,India
514783,2023-08-26,504,iron,449,879,430,1,00498,India
514783,2023-08-26,502,iphone 15 pro max,100000,135000,35000,1,00498,India
514783,2023-08-26,507,washing machine,6990,16490,9500,1,00498,India
602397,2023-08-26,507,washing machine,6990,16490,9500,1,00155,India
602397,2023-08-26,502,iphone 15 pro max,100000,135000,35000,1,00155,India
602397,2023-08-26,506,monitor,3249,8000,4751,1,00155,India
488464,2023-08-26,504,iron,449,879,430,1,00285,India
997895,2023-08-26,502,iphone 15 pro max,100000,135000,35000,1,00299,India
422406,2023-08-26,502,iphone 15 pro max,100000,135000,35000,1,00252,India
422406,2023-08-26,501,iphone 15,60000,80000,20000,1,00252,India
422406,2023-08-26,506,monitor,3249,8000,4751,1,00252,India
422406,2023-08-26,503,mixer,1349,3249,1900,1,00252,India
285501,2023-08-26,507,washing machine,6990,16490,9500,1,00052,India
285501,2023-08-26,505,oven,18490,24000,5510,1,00052,India
285501,2023-08-26,503,mixer,1349,3249,1900,1,00052,India
114954,2023-08-26,504,iron,449,879,430,1,00069,India
114954,2023-08-26,501,iphone 15,60000,80000,20000,1,00069,India
491533,2023-08-26,503,mixer,1349,3249,1900,1,00403,India
491533,2023-08-26,504,iron,449,879,430,1,00403,India
491533,2023-08-26,505,oven,18490,24000,5510,1,00403,India
569937,2023-08-26,502,iphone 15 pro max,100000,135000,35000,1,00360,India
569937,2023-08-26,505,oven,18490,24000,5510,1,00360,India
191256,2023-08-26,503,mixer,1349,3249,1900,1,00292,India
964882,2023-08-26,501,iphone 15,60000,80000,20000,1,00312,India
184209,2023-08-26,501,iphone 15,60000,80000,20000,1,00485,India
184209,2023-08-26,506,monitor,3249,8000,4751,1,00485,India
320196,2023-08-26,506,monitor,3249,8000,4751,1,00256,India
715700,2023-08-26,506,monitor,3249,8000,4751,1,00069,India
715700,2023-08-26,505,oven,18490,24000,5510,1,00069,India
422479,2023-08-26,507,washing machine,6990,16490,9500,1,00114,India
489272,2023-08-26,506,monitor,3249,8000,4751,1,00024,India
823891,2023-08-26,507,washing machine,6990,16490,9500,1,00166,India
823891,2023-08-26,505,oven,18490,24000,5510,1,00166,India
612072,2023-08-26,502,iphone 15 pro max,100000,135000,35000,1,00234,India
612072,2023-08-26,503,mixer,1349,3249,1900,1,00234,India
612072,2023-08-26,501,iphone 15,60000,80000,20000,1,00234,India
612072,2023-08-26,506,monitor,3249,8000,4751,1,00234,India
327283,2023-08-26,503,mixer,1349,3249,1900,1,00017,India
240993,2023-08-26,506,monitor,3249,8000,4751,1,00184,India
240993,2023-08-26,504,iron,449,879,430,1,00184,India
240993,2023-08-26,502,iphone 15 pro max,100000,135000,35000,1,00184,India
240993,2023-08-26,507,washing machine,6990,16490,9500,1,00184,India
589091,2023-08-26,502,iphone 15 pro max,100000,135000,35000,1,00047,India
589091,2023-08-26,506,monitor,3249,8000,4751,1,00047,India
589091,2023-08-26,503,mixer,1349,3249,1900,1,00047,India
905466,2023-08-27,501,iphone 15,60000,80000,20000,1,00416,India
905466,2023-08-27,507,washing machine,6990,16490,9500,1,00416,India
905466,2023-08-27,503,mixer,1349,3249,1900,1,00416,India
660230,2023-08-27,502,iphone 15 pro max,100000,135000,35000,1,00079,India
660230,2023-08-27,506,monitor,3249,8000,4751,1,00079,India
660230,2023-08-27,503,mixer,1349,3249,1900,1,00079,India
660230,2023-08-27,505,oven,18490,24000,5510,1,00079,India
564738,2023-08-27,504,iron,449,879,430,1,00054,India
564738,2023-08-27,505,oven,18490,24000,5510,1,00054,India
564738,2023-08-27,502,iphone 15 pro max,100000,135000,35000,1,00054,India
564738,2023-08-27,506,monitor,3249,8000,4751,1,00054,India
712236,2023-08-27,507,washing machine,6990,16490,9500,1,00500,India
712236,2023-08-27,504,iron,449,879,430,1,00500,India
712236,2023-08-27,506,monitor,3249,8000,4751,1,00500,India
712236,2023-08-27,505,oven,18490,24000,5510,1,00500,India
781230,2023-08-27,504,iron,449,879,430,1,00488,India
747216,2023-08-27,506,monitor,3249,8000,4751,1,00063,India
747216,2023-08-27,505,oven,18490,24000,5510,1,00063,India
180969,2023-08-27,502,iphone 15 pro max,100000,135000,35000,1,00457,India
384809,2023-08-27,506,monitor,3249,8000,4751,1,00230,India
384809,2023-08-27,507,washing machine,6990,16490,9500,1,00230,India
384809,2023-08-27,503,mixer,1349,3249,1900,1,00230,India
811784,2023-08-27,501,iphone 15,60000,80000,20000,1,00162,India
635081,2023-08-27,505,oven,18490,24000,5510,1,00208,India
323312,2023-08-27,504,iron,449,879,430,1,00202,India
323312,2023-08-27,505,oven,18490,24000,5510,1,00202,India
323312,2023-08-27,502,iphone 15 pro max,100000,135000,35000,1,00202,India
408923,2023-08-27,505,oven,18490,24000,5510,1,00342,India
408923,2023-08-27,507,washing machine,6990,16490,9500,1,00342,India
562800,2023-08-27,503,mixer,1349,3249,1900,1,00335,India
747184,2023-08-27,502,iphone 15 pro max,100000,135000,35000,1,00200,India
747184,2023-08-27,506,monitor,3249,8000,4751,1,00200,India
472955,2023-08-27,502,iphone 15 pro max,100000,135000,35000,1,00145,India
472955,2023-08-27,503,mixer,1349,3249,1900,1,00145,India
472955,2023-08-27,504,iron,449,879,430,1,00145,India
324097,2023-08-27,503,mixer,1349,3249,1900,1,00304,India
324097,2023-08-27,507,washing machine,6990,16490,9500,1,00304,India
324097,2023-08-27,505,oven,18490,24000,5510,1,00304,India
324097,2023-08-27,506,monitor,3249,8000,4751,1,00304,India
376685,2023-08-27,507,washing machine,6990,16490,9500,1,00463,India
376685,2023-08-27,504,iron,449,879,430,1,00463,India
642343,2023-08-27,501,iphone 15,60000,80000,20000,1,00362,India
642343,2023-08-27,506,monitor,3249,8000,4751,1,00362,India
642343,2023-08-27,505,oven,18490,24000,5510,1,00362,India
525034,2023-08-27,503,mixer,1349,3249,1900,1,00098,India
358775,2023-08-27,505,oven,18490,24000,5510,1,00421,India
358775,2023-08-27,504,iron,449,879,430,1,00421,India
358775,2023-08-27,507,washing machine,6990,16490,9500,1,00421,India
899956,2023-08-27,505,oven,18490,24000,5510,1,00191,India
899956,2023-08-27,502,iphone 15 pro max,100000,135000,35000,1,00191,India
416113,2023-08-27,504,iron,449,879,430,1,00293,India
416113,2023-08-27,502,iphone 15 pro max,100000,135000,35000,1,00293,India
416113,2023-08-27,501,iphone 15,60000,80000,20000,1,00293,India
985343,2023-08-27,501,iphone 15,60000,80000,20000,1,00397,India
985343,2023-08-27,507,washing machine,6990,16490,9500,1,00397,India
985343,2023-08-27,503,mixer,1349,3249,1900,1,00397,India
144856,2023-08-27,506,monitor,3249,8000,4751,1,00487,India
144856,2023-08-27,503,mixer,1349,3249,1900,1,00487,India
144856,2023-08-27,505,oven,18490,24000,5510,1,00487,India
144856,2023-08-27,504,iron,449,879,430,1,00487,India
472087,2023-08-27,503,mixer,1349,3249,1900,1,00263,India
472087,2023-08-27,501,iphone 15,60000,80000,20000,1,00263,India
472087,2023-08-27,505,oven,18490,24000,5510,1,00263,India
146483,2023-08-27,506,monitor,3249,8000,4751,1,00154,India
519355,2023-08-27,507,washing machine,6990,16490,9500,1,00463,India
519355,2023-08-27,503,mixer,1349,3249,1900,1,00463,India
519355,2023-08-27,505,oven,18490,24000,5510,1,00463,India
278725,2023-08-27,501,iphone 15,60000,80000,20000,1,00149,India
278725,2023-08-27,505,oven,18490,24000,5510,1,00149,India
278725,2023-08-27,502,iphone 15 pro max,100000,135000,35000,1,00149,India
109884,2023-08-27,502,iphone 15 pro max,100000,135000,35000,1,00117,India
663771,2023-08-27,503,mixer,1349,3249,1900,1,00109,India
643452,2023-08-27,504,iron,449,879,430,1,00339,India
867619,2023-08-27,506,monitor,3249,8000,4751,1,00272,India
577851,2023-08-27,507,washing machine,6990,16490,9500,1,00247,India
120314,2023-08-27,501,iphone 15,60000,80000,20000,1,00149,India
120314,2023-08-27,502,iphone 15 pro max,100000,135000,35000,1,00149,India
120314,2023-08-27,505,oven,18490,24000,5510,1,00149,India
543898,2023-08-27,502,iphone 15 pro max,100000,135000,35000,1,00248,India
543898,2023-08-27,501,iphone 15,60000,80000,20000,1,00248,India
579925,2023-08-27,503,mixer,1349,3249,1900,1,00144,India
579925,2023-08-27,501,iphone 15,60000,80000,20000,1,00144,India
560424,2023-08-27,506,monitor,3249,8000,4751,1,00159,India
560424,2023-08-27,503,mixer,1349,3249,1900,1,00159,India
447860,2023-08-27,501,iphone 15,60000,80000,20000,1,00197,India
447860,2023-08-27,503,mixer,1349,3249,1900,1,00197,India
911111,2023-08-27,502,iphone 15 pro max,100000,135000,35000,1,00364,India
403870,2023-08-27,504,iron,449,879,430,1,00261,India
403870,2023-08-27,505,oven,18490,24000,5510,1,00261,India
403870,2023-08-27,507,washing machine,6990,16490,9500,1,00261,India
807748,2023-08-27,501,iphone 15,60000,80000,20000,1,00325,India
807748,2023-08-27,505,oven,18490,24000,5510,1,00325,India
807748,2023-08-27,503,mixer,1349,3249,1900,1,00325,India
768752,2023-08-27,504,iron,449,879,430,1,00039,India
768752,2023-08-27,505,oven,18490,24000,5510,1,00039,India
768752,2023-08-27,502,iphone 15 pro max,100000,135000,35000,1,00039,India
114062,2023-08-27,501,iphone 15,60000,80000,20000,1,00044,India
114062,2023-08-27,504,iron,449,879,430,1,00044,India
114062,2023-08-27,503,mixer,1349,3249,1900,1,00044,India
442058,2023-08-27,501,iphone 15,60000,80000,20000,1,00286,India
911760,2023-08-27,507,washing machine,6990,16490,9500,1,00134,India
911760,2023-08-27,502,iphone 15 pro max,100000,135000,35000,1,00134,India
911760,2023-08-27,505,oven,18490,24000,5510,1,00134,India
271995,2023-08-27,503,mixer,1349,3249,1900,1,00427,India
442806,2023-08-27,504,iron,449,879,430,1,00459,India
442806,2023-08-27,502,iphone 15 pro max,100000,135000,35000,1,00459,India
442806,2023-08-27,503,mixer,1349,3249,1900,1,00459,India
863360,2023-08-27,507,washing machine,6990,16490,9500,1,00195,India
863360,2023-08-27,504,iron,449,879,430,1,00195,India
121528,2023-08-27,501,iphone 15,60000,80000,20000,1,00102,India
121528,2023-08-27,507,washing machine,6990,16490,9500,1,00102,India
953044,2023-08-27,502,iphone 15 pro max,100000,135000,35000,1,00039,India
953044,2023-08-27,501,iphone 15,60000,80000,20000,1,00039,India
734009,2023-08-27,502,iphone 15 pro max,100000,135000,35000,1,00353,India
734009,2023-08-27,506,monitor,3249,8000,4751,1,00353,India
734009,2023-08-27,504,iron,449,879,430,1,00353,India
799400,2023-08-27,506,monitor,3249,8000,4751,1,00151,India
799400,2023-08-27,503,mixer,1349,3249,1900,1,00151,India
799400,2023-08-27,502,iphone 15 pro max,100000,135000,35000,1,00151,India
542672,2023-08-27,503,mixer,1349,3249,1900,1,00187,India
542672,2023-08-27,507,washing machine,6990,16490,9500,1,00187,India
546538,2023-08-27,506,monitor,3249,8000,4751,1,00148,India
610679,2023-08-27,507,washing machine,6990,16490,9500,1,00179,India
610679,2023-08-27,506,monitor,3249,8000,4751,1,00179,India
500546,2023-08-27,504,iron,449,879,430,1,00478,India
500546,2023-08-27,507,washing machine,6990,16490,9500,1,00478,India
299235,2023-08-27,507,washing machine,6990,16490,9500,1,00144,India
299235,2023-08-27,502,iphone 15 pro max,100000,135000,35000,1,00144,India
769595,2023-08-27,501,iphone 15,60000,80000,20000,1,00494,India
292323,2023-08-27,505,oven,18490,24000,5510,1,00100,India
292323,2023-08-27,506,monitor,3249,8000,4751,1,00100,India
292323,2023-08-27,502,iphone 15 pro max,100000,135000,35000,1,00100,India
318524,2023-08-27,507,washing machine,6990,16490,9500,1,00159,India
318524,2023-08-27,503,mixer,1349,3249,1900,1,00159,India
318524,2023-08-27,506,monitor,3249,8000,4751,1,00159,India
902229,2023-08-27,501,iphone 15,60000,80000,20000,1,00343,India
957322,2023-08-27,502,iphone 15 pro max,100000,135000,35000,1,00188,India
957322,2023-08-27,504,iron,449,879,430,1,00188,India
957322,2023-08-27,501,iphone 15,60000,80000,20000,1,00188,India
387878,2023-08-27,502,iphone 15 pro max,100000,135000,35000,1,00238,India
381748,2023-08-27,507,washing machine,6990,16490,9500,1,00149,India
185303,2023-08-27,501,iphone 15,60000,80000,20000,1,00239,India
185303,2023-08-27,506,monitor,3249,8000,4751,1,00239,India
185303,2023-08-27,504,iron,449,879,430,1,00239,India
185303,2023-08-27,507,washing machine,6990,16490,9500,1,00239,India
343585,2023-08-27,503,mixer,1349,3249,1900,1,00213,India
343585,2023-08-27,506,monitor,3249,8000,4751,1,00213,India
640749,2023-08-27,504,iron,449,879,430,1,00298,India
640749,2023-08-27,505,oven,18490,24000,5510,1,00298,India
221613,2023-08-27,506,monitor,3249,8000,4751,1,00155,India
221613,2023-08-27,503,mixer,1349,3249,1900,1,00155,India
221613,2023-08-27,507,washing machine,6990,16490,9500,1,00155,India
281133,2023-08-27,504,iron,449,879,430,1,00334,India
265624,2023-08-27,502,iphone 15 pro max,100000,135000,35000,1,00075,India
265624,2023-08-27,506,monitor,3249,8000,4751,1,00075,India
265624,2023-08-27,503,mixer,1349,3249,1900,1,00075,India
344380,2023-08-27,505,oven,18490,24000,5510,1,00223,India
344380,2023-08-27,502,iphone 15 pro max,100000,135000,35000,1,00223,India
344380,2023-08-27,507,washing machine,6990,16490,9500,1,00223,India
450585,2023-08-27,501,iphone 15,60000,80000,20000,1,00159,India
523695,2023-08-27,507,washing machine,6990,16490,9500,1,00005,India
592069,2023-08-27,501,iphone 15,60000,80000,20000,1,00259,India
592069,2023-08-27,505,oven,18490,24000,5510,1,00259,India
592069,2023-08-27,502,iphone 15 pro max,100000,135000,35000,1,00259,India
456816,2023-08-27,506,monitor,3249,8000,4751,1,00203,India
586256,2023-08-27,505,oven,18490,24000,5510,1,00188,India
586256,2023-08-27,506,monitor,3249,8000,4751,1,00188,India
586256,2023-08-27,502,iphone 15 pro max,100000,135000,35000,1,00188,India
586256,2023-08-27,501,iphone 15,60000,80000,20000,1,00188,India
276687,2023-08-27,502,iphone 15 pro max,100000,135000,35000,1,00236,India
145828,2023-08-27,503,mixer,1349,3249,1900,1,00225,India
145828,2023-08-27,506,monitor,3249,8000,4751,1,00225,India
145828,2023-08-27,501,iphone 15,60000,80000,20000,1,00225,India
882777,2023-08-27,503,mixer,1349,3249,1900,1,00028,India
884653,2023-08-27,504,iron,449,879,430,1,00479,India
884653,2023-08-27,506,monitor,3249,8000,4751,1,00479,India
884653,2023-08-27,502,iphone 15 pro max,100000,135000,35000,1,00479,India
666388,2023-08-27,505,oven,18490,24000,5510,1,00389,India
666388,2023-08-27,504,iron,449,879,430,1,00389,India
666388,2023-08-27,506,monitor,3249,8000,4751,1,00389,India
731454,2023-08-27,501,iphone 15,60000,80000,20000,1,00033,India
731454,2023-08-27,503,mixer,1349,3249,1900,1,00033,India
731454,2023-08-27,505,oven,18490,24000,5510,1,00033,India
731454,2023-08-27,504,iron,449,879,430,1,00033,India
731454,2023-08-27,502,iphone 15 pro max,100000,135000,35000,1,00033,India
247308,2023-08-27,504,iron,449,879,430,1,00204,India
247308,2023-08-27,502,iphone 15 pro max,100000,135000,35000,1,00204,India
247308,2023-08-27,505,oven,18490,24000,5510,1,00204,India
612264,2023-08-27,503,mixer,1349,3249,1900,1,00435,India
953578,2023-08-27,507,washing machine,6990,16490,9500,1,00181,India
196084,2023-08-27,502,iphone 15 pro max,100000,135000,35000,1,00371,India
286466,2023-08-27,505,oven,18490,24000,5510,1,00456,India
286466,2023-08-27,503,mixer,1349,3249,1900,1,00456,India
286466,2023-08-27,502,iphone 15 pro max,100000,135000,35000,1,00456,India
286466,2023-08-27,507,washing machine,6990,16490,9500,1,00456,India
516633,2023-08-27,502,iphone 15 pro max,100000,135000,35000,1,00266,India
516633,2023-08-27,504,iron,449,879,430,1,00266,India
516633,2023-08-27,505,oven,18490,24000,5510,1,00266,India
516633,2023-08-27,503,mixer,1349,3249,1900,1,00266,India
686788,2023-08-27,501,iphone 15,60000,80000,20000,1,00037,India
686788,2023-08-27,507,washing machine,6990,16490,9500,1,00037,India
686788,2023-08-27,504,iron,449,879,430,1,00037,India
686788,2023-08-27,502,iphone 15 pro max,100000,135000,35000,1,00037,India
686788,2023-08-27,505,oven,18490,24000,5510,1,00037,India
557222,2023-08-27,507,washing machine,6990,16490,9500,1,00434,India
412057,2023-08-27,507,washing machine,6990,16490,9500,1,00036,India
412057,2023-08-27,501,iphone 15,60000,80000,20000,1,00036,India
412057,2023-08-27,504,iron,449,879,430,1,00036,India
412057,2023-08-27,503,mixer,1349,3249,1900,1,00036,India
582035,2023-08-27,505,oven,18490,24000,5510,1,00433,India
582035,2023-08-27,504,iron,449,879,430,1,00433,India
582035,2023-08-27,507,washing machine,6990,16490,9500,1,00433,India
514711,2023-08-27,501,iphone 15,60000,80000,20000,1,00279,India
514711,2023-08-27,506,monitor,3249,8000,4751,1,00279,India
514711,2023-08-27,505,oven,18490,24000,5510,1,00279,India
440753,2023-08-27,501,iphone 15,60000,80000,20000,1,00117,India
440753,2023-08-27,507,washing machine,6990,16490,9500,1,00117,India
809918,2023-08-27,501,iphone 15,60000,80000,20000,1,00472,India
370172,2023-08-27,505,oven,18490,24000,5510,1,00146,India
370172,2023-08-27,507,washing machine,6990,16490,9500,1,00146,India
370172,2023-08-27,503,mixer,1349,3249,1900,1,00146,India
174690,2023-08-27,502,iphone 15 pro max,100000,135000,35000,1,00303,India
174690,2023-08-27,501,iphone 15,60000,80000,20000,1,00303,India
174690,2023-08-27,503,mixer,1349,3249,1900,1,00303,India
174690,2023-08-27,505,oven,18490,24000,5510,1,00303,India
124893,2023-08-27,507,washing machine,6990,16490,9500,1,00196,India
124893,2023-08-27,503,mixer,1349,3249,1900,1,00196,India
812996,2023-08-27,501,iphone 15,60000,80000,20000,1,00122,India
812996,2023-08-27,503,mixer,1349,3249,1900,1,00122,India
592006,2023-08-28,505,oven,18490,24000,5510,1,00265,India
246905,2023-08-28,506,monitor,3249,8000,4751,1,00346,India
246905,2023-08-28,505,oven,18490,24000,5510,1,00346,India
246905,2023-08-28,504,iron,449,879,430,1,00346,India
506123,2023-08-28,501,iphone 15,60000,80000,20000,1,00401,India
506123,2023-08-28,506,monitor,3249,8000,4751,1,00401,India
506123,2023-08-28,507,washing machine,6990,16490,9500,1,00401,India
105455,2023-08-28,507,washing machine,6990,16490,9500,1,00215,India
105455,2023-08-28,504,iron,449,879,430,1,00215,India
105455,2023-08-28,501,iphone 15,60000,80000,20000,1,00215,India
902751,2023-08-28,502,iphone 15 pro max,100000,135000,35000,1,00189,India
902751,2023-08-28,507,washing machine,6990,16490,9500,1,00189,India
529143,2023-08-28,505,oven,18490,24000,5510,1,00380,India
529143,2023-08-28,501,iphone 15,60000,80000,20000,1,00380,India
529143,2023-08-28,502,iphone 15 pro max,100000,135000,35000,1,00380,India
529143,2023-08-28,503,mixer,1349,3249,1900,1,00380,India
529143,2023-08-28,504,iron,449,879,430,1,00380,India
210058,2023-08-28,507,washing machine,6990,16490,9500,1,00245,India
210058,2023-08-28,506,monitor,3249,8000,4751,1,00245,India
210058,2023-08-28,503,mixer,1349,3249,1900,1,00245,India
110316,2023-08-28,503,mixer,1349,3249,1900,1,00268,India
110316,2023-08-28,504,iron,449,879,430,1,00268,India
665511,2023-08-28,502,iphone 15 pro max,100000,135000,35000,1,00352,India
665511,2023-08-28,501,iphone 15,60000,80000,20000,1,00352,India
665511,2023-08-28,506,monitor,3249,8000,4751,1,00352,India
114745,2023-08-28,506,monitor,3249,8000,4751,1,00475,India
346845,2023-08-28,504,iron,449,879,430,1,00068,India
597681,2023-08-28,502,iphone 15 pro max,100000,135000,35000,1,00320,India
597681,2023-08-28,503,mixer,1349,3249,1900,1,00320,India
597779,2023-08-28,504,iron,449,879,430,1,00162,India
109439,2023-08-28,506,monitor,3249,8000,4751,1,00375,India
109439,2023-08-28,505,oven,18490,24000,5510,1,00375,India
176017,2023-08-28,506,monitor,3249,8000,4751,1,00339,India
176017,2023-08-28,502,iphone 15 pro max,100000,135000,35000,1,00339,India
176017,2023-08-28,505,oven,18490,24000,5510,1,00339,India
176017,2023-08-28,504,iron,449,879,430,1,00339,India
690901,2023-08-28,501,iphone 15,60000,80000,20000,1,00024,India
690901,2023-08-28,506,monitor,3249,8000,4751,1,00024,India
407374,2023-08-28,506,monitor,3249,8000,4751,1,00214,India
407374,2023-08-28,502,iphone 15 pro max,100000,135000,35000,1,00214,India
407374,2023-08-28,507,washing machine,6990,16490,9500,1,00214,India
407374,2023-08-28,501,iphone 15,60000,80000,20000,1,00214,India
380639,2023-08-28,503,mixer,1349,3249,1900,1,00261,India
719757,2023-08-28,505,oven,18490,24000,5510,1,00161,India
456313,2023-08-28,506,monitor,3249,8000,4751,1,00480,India
456313,2023-08-28,507,washing machine,6990,16490,9500,1,00480,India
456313,2023-08-28,502,iphone 15 pro max,100000,135000,35000,1,00480,India
456313,2023-08-28,503,mixer,1349,3249,1900,1,00480,India
706550,2023-08-28,504,iron,449,879,430,1,00024,India
706550,2023-08-28,503,mixer,1349,3249,1900,1,00024,India
706550,2023-08-28,502,iphone 15 pro max,100000,135000,35000,1,00024,India
706550,2023-08-28,501,iphone 15,60000,80000,20000,1,00024,India
813926,2023-08-28,505,oven,18490,24000,5510,1,00216,India
813926,2023-08-28,502,iphone 15 pro max,100000,135000,35000,1,00216,India
813926,2023-08-28,507,washing machine,6990,16490,9500,1,00216,India
706179,2023-08-28,501,iphone 15,60000,80000,20000,1,00093,India
706179,2023-08-28,507,washing machine,6990,16490,9500,1,00093,India
706179,2023-08-28,504,iron,449,879,430,1,00093,India
680504,2023-08-28,502,iphone 15 pro max,100000,135000,35000,1,00236,India
680504,2023-08-28,505,oven,18490,24000,5510,1,00236,India
680504,2023-08-28,507,washing machine,6990,16490,9500,1,00236,India
661816,2023-08-28,507,washing machine,6990,16490,9500,1,00329,India
661816,2023-08-28,501,iphone 15,60000,80000,20000,1,00329,India
661816,2023-08-28,506,monitor,3249,8000,4751,1,00329,India
661816,2023-08-28,502,iphone 15 pro max,100000,135000,35000,1,00329,India
290533,2023-08-28,501,iphone 15,60000,80000,20000,1,00008,India
290533,2023-08-28,505,oven,18490,24000,5510,1,00008,India
290533,2023-08-28,507,washing machine,6990,16490,9500,1,00008,India
290533,2023-08-28,502,iphone 15 pro max,100000,135000,35000,1,00008,India
578443,2023-08-28,503,mixer,1349,3249,1900,1,00491,India
578443,2023-08-28,501,iphone 15,60000,80000,20000,1,00491,India
578443,2023-08-28,506,monitor,3249,8000,4751,1,00491,India
237064,2023-08-28,506,monitor,3249,8000,4751,1,00060,India
237064,2023-08-28,501,iphone 15,60000,80000,20000,1,00060,India
143125,2023-08-28,502,iphone 15 pro max,100000,135000,35000,1,00116,India
143125,2023-08-28,506,monitor,3249,8000,4751,1,00116,India
143125,2023-08-28,505,oven,18490,24000,5510,1,00116,India
792141,2023-08-28,506,monitor,3249,8000,4751,1,00412,India
792141,2023-08-28,503,mixer,1349,3249,1900,1,00412,India
977518,2023-08-28,505,oven,18490,24000,5510,1,00037,India
639900,2023-08-28,506,monitor,3249,8000,4751,1,00182,India
639900,2023-08-28,502,iphone 15 pro max,100000,135000,35000,1,00182,India
567622,2023-08-28,505,oven,18490,24000,5510,1,00372,India
114523,2023-08-28,501,iphone 15,60000,80000,20000,1,00155,India
333393,2023-08-28,505,oven,18490,24000,5510,1,00223,India
333393,2023-08-28,502,iphone 15 pro max,100000,135000,35000,1,00223,India
333393,2023-08-28,504,iron,449,879,430,1,00223,India
333393,2023-08-28,501,iphone 15,60000,80000,20000,1,00223,India
333393,2023-08-28,503,mixer,1349,3249,1900,1,00223,India
552234,2023-08-28,503,mixer,1349,3249,1900,1,00428,India
552234,2023-08-28,501,iphone 15,60000,80000,20000,1,00428,India
552234,2023-08-28,505,oven,18490,24000,5510,1,00428,India
552234,2023-08-28,506,monitor,3249,8000,4751,1,00428,India
330428,2023-08-28,502,iphone 15 pro max,100000,135000,35000,1,00199,India
621988,2023-08-28,506,monitor,3249,8000,4751,1,00162,India
621988,2023-08-28,504,iron,449,879,430,1,00162,India
621988,2023-08-28,501,iphone 15,60000,80000,20000,1,00162,India
621988,2023-08-28,505,oven,18490,24000,5510,1,00162,India
362747,2023-08-28,501,iphone 15,60000,80000,20000,1,00207,India
362747,2023-08-28,507,washing machine,6990,16490,9500,1,00207,India
789788,2023-08-28,502,iphone 15 pro max,100000,135000,35000,1,00290,India
789788,2023-08-28,504,iron,449,879,430,1,00290,India
789788,2023-08-28,503,mixer,1349,3249,1900,1,00290,India
789788,2023-08-28,507,washing machine,6990,16490,9500,1,00290,India
468110,2023-08-28,505,oven,18490,24000,5510,1,00102,India
468110,2023-08-28,502,iphone 15 pro max,100000,135000,35000,1,00102,India
468110,2023-08-28,507,washing machine,6990,16490,9500,1,00102,India
201101,2023-08-28,502,iphone 15 pro max,100000,135000,35000,1,00141,India
618783,2023-08-28,504,iron,449,879,430,1,00362,India
618783,2023-08-28,506,monitor,3249,8000,4751,1,00362,India
618783,2023-08-28,502,iphone 15 pro max,100000,135000,35000,1,00362,India
813436,2023-08-28,501,iphone 15,60000,80000,20000,1,00123,India
813436,2023-08-28,504,iron,449,879,430,1,00123,India
143850,2023-08-28,506,monitor,3249,8000,4751,1,00254,India
305114,2023-08-28,506,monitor,3249,8000,4751,1,00442,India
305114,2023-08-28,504,iron,449,879,430,1,00442,India
305114,2023-08-28,507,washing machine,6990,16490,9500,1,00442,India
305114,2023-08-28,501,iphone 15,60000,80000,20000,1,00442,India
895240,2023-08-28,505,oven,18490,24000,5510,1,00305,India
895240,2023-08-28,507,washing machine,6990,16490,9500,1,00305,India
895240,2023-08-28,503,mixer,1349,3249,1900,1,00305,India
895240,2023-08-28,506,monitor,3249,8000,4751,1,00305,India
624186,2023-08-28,505,oven,18490,24000,5510,1,00198,India
624186,2023-08-28,507,washing machine,6990,16490,9500,1,00198,India
451138,2023-08-28,503,mixer,1349,3249,1900,1,00307,India
451138,2023-08-28,505,oven,18490,24000,5510,1,00307,India
451138,2023-08-28,501,iphone 15,60000,80000,20000,1,00307,India
770932,2023-08-28,501,iphone 15,60000,80000,20000,1,00406,India
770932,2023-08-28,507,washing machine,6990,16490,9500,1,00406,India
770932,2023-08-28,504,iron,449,879,430,1,00406,India
869134,2023-08-28,506,monitor,3249,8000,4751,1,00264,India
869134,2023-08-28,501,iphone 15,60000,80000,20000,1,00264,India
162281,2023-08-28,501,iphone 15,60000,80000,20000,1,00311,India
339288,2023-08-28,504,iron,449,879,430,1,00439,India
676331,2023-08-28,507,washing machine,6990,16490,9500,1,00446,India
676331,2023-08-28,504,iron,449,879,430,1,00446,India
676331,2023-08-28,506,monitor,3249,8000,4751,1,00446,India
676331,2023-08-28,502,iphone 15 pro max,100000,135000,35000,1,00446,India
929780,2023-08-28,501,iphone 15,60000,80000,20000,1,00062,India
929780,2023-08-28,506,monitor,3249,8000,4751,1,00062,India
929780,2023-08-28,505,oven,18490,24000,5510,1,00062,India
929780,2023-08-28,503,mixer,1349,3249,1900,1,00062,India
976011,2023-08-28,502,iphone 15 pro max,100000,135000,35000,1,00415,India
976011,2023-08-28,504,iron,449,879,430,1,00415,India
668765,2023-08-28,502,iphone 15 pro max,100000,135000,35000,1,00097,India
668765,2023-08-28,505,oven,18490,24000,5510,1,00097,India
292560,2023-08-28,507,washing machine,6990,16490,9500,1,00353,India
292560,2023-08-28,503,mixer,1349,3249,1900,1,00353,India
292560,2023-08-28,506,monitor,3249,8000,4751,1,00353,India
502413,2023-08-28,505,oven,18490,24000,5510,1,00168,India
970077,2023-08-28,501,iphone 15,60000,80000,20000,1,00178,India
970077,2023-08-28,506,monitor,3249,8000,4751,1,00178,India
220494,2023-08-28,503,mixer,1349,3249,1900,1,00383,India
220494,2023-08-28,505,oven,18490,24000,5510,1,00383,India
220494,2023-08-28,502,iphone 15 pro max,100000,135000,35000,1,00383,India
348694,2023-08-28,504,iron,449,879,430,1,00026,India
518225,2023-08-28,502,iphone 15 pro max,100000,135000,35000,1,00056,India
518225,2023-08-28,503,mixer,1349,3249,1900,1,00056,India
635551,2023-08-28,502,iphone 15 pro max,100000,135000,35000,1,00404,India
635551,2023-08-28,507,washing machine,6990,16490,9500,1,00404,India
635551,2023-08-28,505,oven,18490,24000,5510,1,00404,India
559371,2023-08-28,506,monitor,3249,8000,4751,1,00282,India
412162,2023-08-28,507,washing machine,6990,16490,9500,1,00199,India
412162,2023-08-28,504,iron,449,879,430,1,00199,India
412162,2023-08-28,505,oven,18490,24000,5510,1,00199,India
412162,2023-08-28,506,monitor,3249,8000,4751,1,00199,India
835945,2023-08-28,501,iphone 15,60000,80000,20000,1,00132,India
835945,2023-08-28,506,monitor,3249,8000,4751,1,00132,India
835945,2023-08-28,504,iron,449,879,430,1,00132,India
615813,2023-08-28,505,oven,18490,24000,5510,1,00232,India
615813,2023-08-28,503,mixer,1349,3249,1900,1,00232,India
284913,2023-08-28,501,iphone 15,60000,80000,20000,1,00384,India
284913,2023-08-28,503,mixer,1349,3249,1900,1,00384,India
629917,2023-08-28,502,iphone 15 pro max,100000,135000,35000,1,00075,India
832503,2023-08-28,501,iphone 15,60000,80000,20000,1,00334,India
832503,2023-08-28,503,mixer,1349,3249,1900,1,00334,India
832503,2023-08-28,505,oven,18490,24000,5510,1,00334,India
796765,2023-08-28,503,mixer,1349,3249,1900,1,00396,India
796765,2023-08-28,502,iphone 15 pro max,100000,135000,35000,1,00396,India
796765,2023-08-28,505,oven,18490,24000,5510,1,00396,India
783680,2023-08-28,505,oven,18490,24000,5510,1,00194,India
949606,2023-08-28,507,washing machine,6990,16490,9500,1,00338,India
949606,2023-08-28,506,monitor,3249,8000,4751,1,00338,India
949606,2023-08-28,505,oven,18490,24000,5510,1,00338,India
949606,2023-08-28,502,iphone 15 pro max,100000,135000,35000,1,00338,India
468098,2023-08-28,501,iphone 15,60000,80000,20000,1,00293,India
468098,2023-08-28,506,monitor,3249,8000,4751,1,00293,India
150917,2023-08-28,506,monitor,3249,8000,4751,1,00410,India
150917,2023-08-28,505,oven,18490,24000,5510,1,00410,India
150917,2023-08-28,502,iphone 15 pro max,100000,135000,35000,1,00410,India
150917,2023-08-28,507,washing machine,6990,16490,9500,1,00410,India
539214,2023-08-28,507,washing machine,6990,16490,9500,1,00253,India
539214,2023-08-28,503,mixer,1349,3249,1900,1,00253,India
243958,2023-08-28,505,oven,18490,24000,5510,1,00212,India
243958,2023-08-28,503,mixer,1349,3249,1900,1,00212,India
259571,2023-08-28,506,monitor,3249,8000,4751,1,00185,India
259571,2023-08-28,507,washing machine,6990,16490,9500,1,00185,India
259571,2023-08-28,502,iphone 15 pro max,100000,135000,35000,1,00185,India
259571,2023-08-28,503,mixer,1349,3249,1900,1,00185,India
335768,2023-08-28,502,iphone 15 pro max,100000,135000,35000,1,00496,India
335768,2023-08-28,507,washing machine,6990,16490,9500,1,00496,India
982631,2023-08-28,506,monitor,3249,8000,4751,1,00252,India
982631,2023-08-28,503,mixer,1349,3249,1900,1,00252,India
231064,2023-08-28,506,monitor,3249,8000,4751,1,00178,India
231064,2023-08-28,503,mixer,1349,3249,1900,1,00178,India
231064,2023-08-28,507,washing machine,6990,16490,9500,1,00178,India
185807,2023-08-28,505,oven,18490,24000,5510,1,00292,India
185807,2023-08-28,501,iphone 15,60000,80000,20000,1,00292,India
185807,2023-08-28,506,monitor,3249,8000,4751,1,00292,India
177349,2023-08-28,507,washing machine,6990,16490,9500,1,00266,India
111738,2023-08-29,505,oven,18490,24000,5510,1,00222,India
111738,2023-08-29,503,mixer,1349,3249,1900,1,00222,India
717677,2023-08-29,503,mixer,1349,3249,1900,1,00095,India
717677,2023-08-29,501,iphone 15,60000,80000,20000,1,00095,India
717677,2023-08-29,504,iron,449,879,430,1,00095,India
338631,2023-08-29,504,iron,449,879,430,1,00226,India
338631,2023-08-29,507,washing machine,6990,16490,9500,1,00226,India
338631,2023-08-29,505,oven,18490,24000,5510,1,00226,India
338631,2023-08-29,506,monitor,3249,8000,4751,1,00226,India
690204,2023-08-29,506,monitor,3249,8000,4751,1,00174,India
620372,2023-08-29,504,iron,449,879,430,1,00321,India
620372,2023-08-29,503,mixer,1349,3249,1900,1,00321,India
274670,2023-08-29,506,monitor,3249,8000,4751,1,00397,India
274670,2023-08-29,505,oven,18490,24000,5510,1,00397,India
274670,2023-08-29,501,iphone 15,60000,80000,20000,1,00397,India
111044,2023-08-29,505,oven,18490,24000,5510,1,00266,India
777772,2023-08-29,507,washing machine,6990,16490,9500,1,00410,India
777772,2023-08-29,501,iphone 15,60000,80000,20000,1,00410,India
777772,2023-08-29,502,iphone 15 pro max,100000,135000,35000,1,00410,India
777772,2023-08-29,506,monitor,3249,8000,4751,1,00410,India
265620,2023-08-29,507,washing machine,6990,16490,9500,1,00364,India
265620,2023-08-29,501,iphone 15,60000,80000,20000,1,00364,India
265620,2023-08-29,502,iphone 15 pro max,100000,135000,35000,1,00364,India
252297,2023-08-29,501,iphone 15,60000,80000,20000,1,00411,India
981803,2023-08-29,504,iron,449,879,430,1,00363,India
981803,2023-08-29,506,monitor,3249,8000,4751,1,00363,India
784828,2023-08-29,502,iphone 15 pro max,100000,135000,35000,1,00129,India
784828,2023-08-29,505,oven,18490,24000,5510,1,00129,India
450270,2023-08-29,506,monitor,3249,8000,4751,1,00123,India
552199,2023-08-29,502,iphone 15 pro max,100000,135000,35000,1,00291,India
552199,2023-08-29,505,oven,18490,24000,5510,1,00291,India
552199,2023-08-29,503,mixer,1349,3249,1900,1,00291,India
552199,2023-08-29,504,iron,449,879,430,1,00291,India
248197,2023-08-29,502,iphone 15 pro max,100000,135000,35000,1,00110,India
248197,2023-08-29,503,mixer,1349,3249,1900,1,00110,India
248197,2023-08-29,504,iron,449,879,430,1,00110,India
172700,2023-08-29,505,oven,18490,24000,5510,1,00368,India
633541,2023-08-29,501,iphone 15,60000,80000,20000,1,00295,India
633541,2023-08-29,503,mixer,1349,3249,1900,1,00295,India
633541,2023-08-29,505,oven,18490,24000,5510,1,00295,India
680082,2023-08-29,502,iphone 15 pro max,100000,135000,35000,1,00322,India
680082,2023-08-29,506,monitor,3249,8000,4751,1,00322,India
680082,2023-08-29,504,iron,449,879,430,1,00322,India
895034,2023-08-29,507,washing machine,6990,16490,9500,1,00396,India
895034,2023-08-29,503,mixer,1349,3249,1900,1,00396,India
570814,2023-08-29,505,oven,18490,24000,5510,1,00489,India
570814,2023-08-29,503,mixer,1349,3249,1900,1,00489,India
272691,2023-08-29,505,oven,18490,24000,5510,1,00490,India
272691,2023-08-29,502,iphone 15 pro max,100000,135000,35000,1,00490,India
272691,2023-08-29,507,washing machine,6990,16490,9500,1,00490,India
998157,2023-08-29,502,iphone 15 pro max,100000,135000,35000,1,00202,India
704965,2023-08-29,502,iphone 15 pro max,100000,135000,35000,1,00047,India
704965,2023-08-29,504,iron,449,879,430,1,00047,India
686967,2023-08-29,504,iron,449,879,430,1,00372,India
686967,2023-08-29,501,iphone 15,60000,80000,20000,1,00372,India
686967,2023-08-29,502,iphone 15 pro max,100000,135000,35000,1,00372,India
378365,2023-08-29,504,iron,449,879,430,1,00414,India
413781,2023-08-29,506,monitor,3249,8000,4751,1,00341,India
413781,2023-08-29,505,oven,18490,24000,5510,1,00341,India
413781,2023-08-29,503,mixer,1349,3249,1900,1,00341,India
413781,2023-08-29,507,washing machine,6990,16490,9500,1,00341,India
413781,2023-08-29,504,iron,449,879,430,1,00341,India
276248,2023-08-29,501,iphone 15,60000,80000,20000,1,00029,India
276248,2023-08-29,502,iphone 15 pro max,100000,135000,35000,1,00029,India
276248,2023-08-29,507,washing machine,6990,16490,9500,1,00029,India
276248,2023-08-29,505,oven,18490,24000,5510,1,00029,India
129502,2023-08-29,505,oven,18490,24000,5510,1,00243,India
431029,2023-08-29,504,iron,449,879,430,1,00203,India
431029,2023-08-29,507,washing machine,6990,16490,9500,1,00203,India
636922,2023-08-29,501,iphone 15,60000,80000,20000,1,00385,India
636922,2023-08-29,504,iron,449,879,430,1,00385,India
663357,2023-08-29,507,washing machine,6990,16490,9500,1,00349,India
663357,2023-08-29,502,iphone 15 pro max,100000,135000,35000,1,00349,India
663357,2023-08-29,505,oven,18490,24000,5510,1,00349,India
663357,2023-08-29,501,iphone 15,60000,80000,20000,1,00349,India
292165,2023-08-29,507,washing machine,6990,16490,9500,1,00007,India
292165,2023-08-29,504,iron,449,879,430,1,00007,India
292165,2023-08-29,506,monitor,3249,8000,4751,1,00007,India
292165,2023-08-29,505,oven,18490,24000,5510,1,00007,India
731167,2023-08-29,501,iphone 15,60000,80000,20000,1,00054,India
731167,2023-08-29,504,iron,449,879,430,1,00054,India
731167,2023-08-29,506,monitor,3249,8000,4751,1,00054,India
141434,2023-08-29,504,iron,449,879,430,1,00361,India
141434,2023-08-29,501,iphone 15,60000,80000,20000,1,00361,India
141434,2023-08-29,506,monitor,3249,8000,4751,1,00361,India
141434,2023-08-29,505,oven,18490,24000,5510,1,00361,India
804271,2023-08-29,507,washing machine,6990,16490,9500,1,00499,India
804271,2023-08-29,506,monitor,3249,8000,4751,1,00499,India
307532,2023-08-29,501,iphone 15,60000,80000,20000,1,00439,India
178277,2023-08-29,504,iron,449,879,430,1,00414,India
178277,2023-08-29,502,iphone 15 pro max,100000,135000,35000,1,00414,India
178277,2023-08-29,506,monitor,3249,8000,4751,1,00414,India
462713,2023-08-29,502,iphone 15 pro max,100000,135000,35000,1,00050,India
462713,2023-08-29,505,oven,18490,24000,5510,1,00050,India
354804,2023-08-29,506,monitor,3249,8000,4751,1,00222,India
963786,2023-08-29,501,iphone 15,60000,80000,20000,1,00235,India
963786,2023-08-29,505,oven,18490,24000,5510,1,00235,India
963786,2023-08-29,503,mixer,1349,3249,1900,1,00235,India
963786,2023-08-29,507,washing machine,6990,16490,9500,1,00235,India
314072,2023-08-29,504,iron,449,879,430,1,00235,India
314072,2023-08-29,506,monitor,3249,8000,4751,1,00235,India
314072,2023-08-29,503,mixer,1349,3249,1900,1,00235,India
314072,2023-08-29,507,washing machine,6990,16490,9500,1,00235,India
574033,2023-08-29,505,oven,18490,24000,5510,1,00303,India
141835,2023-08-29,506,monitor,3249,8000,4751,1,00437,India
141835,2023-08-29,507,washing machine,6990,16490,9500,1,00437,India
141835,2023-08-29,505,oven,18490,24000,5510,1,00437,India
659985,2023-08-29,505,oven,18490,24000,5510,1,00459,India
659985,2023-08-29,503,mixer,1349,3249,1900,1,00459,India
396775,2023-08-29,504,iron,449,879,430,1,00131,India
396775,2023-08-29,507,washing machine,6990,16490,9500,1,00131,India
396775,2023-08-29,505,oven,18490,24000,5510,1,00131,India
244700,2023-08-29,503,mixer,1349,3249,1900,1,00266,India
244700,2023-08-29,506,monitor,3249,8000,4751,1,00266,India
244700,2023-08-29,502,iphone 15 pro max,100000,135000,35000,1,00266,India
461463,2023-08-29,503,mixer,1349,3249,1900,1,00338,India
461463,2023-08-29,504,iron,449,879,430,1,00338,India
461463,2023-08-29,505,oven,18490,24000,5510,1,00338,India
461463,2023-08-29,501,iphone 15,60000,80000,20000,1,00338,India
635228,2023-08-29,507,washing machine,6990,16490,9500,1,00328,India
635228,2023-08-29,505,oven,18490,24000,5510,1,00328,India
475966,2023-08-29,504,iron,449,879,430,1,00087,India
475966,2023-08-29,501,iphone 15,60000,80000,20000,1,00087,India
475966,2023-08-29,505,oven,18490,24000,5510,1,00087,India
189547,2023-08-29,501,iphone 15,60000,80000,20000,1,00091,India
189547,2023-08-29,504,iron,449,879,430,1,00091,India
189547,2023-08-29,503,mixer,1349,3249,1900,1,00091,India
608408,2023-08-29,502,iphone 15 pro max,100000,135000,35000,1,00418,India
102160,2023-08-29,502,iphone 15 pro max,100000,135000,35000,1,00087,India
102160,2023-08-29,507,washing machine,6990,16490,9500,1,00087,India
102160,2023-08-29,503,mixer,1349,3249,1900,1,00087,India
551293,2023-08-29,507,washing machine,6990,16490,9500,1,00438,India
225676,2023-08-29,501,iphone 15,60000,80000,20000,1,00027,India
225676,2023-08-29,504,iron,449,879,430,1,00027,India
225676,2023-08-29,507,washing machine,6990,16490,9500,1,00027,India
770498,2023-08-29,502,iphone 15 pro max,100000,135000,35000,1,00196,India
770498,2023-08-29,505,oven,18490,24000,5510,1,00196,India
876785,2023-08-29,502,iphone 15 pro max,100000,135000,35000,1,00199,India
876785,2023-08-29,507,washing machine,6990,16490,9500,1,00199,India
876785,2023-08-29,506,monitor,3249,8000,4751,1,00199,India
876785,2023-08-29,505,oven,18490,24000,5510,1,00199,India
232193,2023-08-29,504,iron,449,879,430,1,00073,India
232193,2023-08-29,506,monitor,3249,8000,4751,1,00073,India
532095,2023-08-29,502,iphone 15 pro max,100000,135000,35000,1,00091,India
532095,2023-08-29,501,iphone 15,60000,80000,20000,1,00091,India
532095,2023-08-29,505,oven,18490,24000,5510,1,00091,India
532095,2023-08-29,503,mixer,1349,3249,1900,1,00091,India
308577,2023-08-29,505,oven,18490,24000,5510,1,00290,India
308577,2023-08-29,501,iphone 15,60000,80000,20000,1,00290,India
308577,2023-08-29,503,mixer,1349,3249,1900,1,00290,India
485765,2023-08-29,506,monitor,3249,8000,4751,1,00125,India
485765,2023-08-29,507,washing machine,6990,16490,9500,1,00125,India
485765,2023-08-29,504,iron,449,879,430,1,00125,India
485765,2023-08-29,502,iphone 15 pro max,100000,135000,35000,1,00125,India
528917,2023-08-29,506,monitor,3249,8000,4751,1,00397,India
528917,2023-08-29,501,iphone 15,60000,80000,20000,1,00397,India
528917,2023-08-29,503,mixer,1349,3249,1900,1,00397,India
528917,2023-08-29,504,iron,449,879,430,1,00397,India
250084,2023-08-29,501,iphone 15,60000,80000,20000,1,00468,India
250084,2023-08-29,507,washing machine,6990,16490,9500,1,00468,India
624368,2023-08-29,505,oven,18490,24000,5510,1,00215,India
393927,2023-08-29,507,washing machine,6990,16490,9500,1,00333,India
393927,2023-08-29,502,iphone 15 pro max,100000,135000,35000,1,00333,India
116129,2023-08-29,502,iphone 15 pro max,100000,135000,35000,1,00119,India
116129,2023-08-29,506,monitor,3249,8000,4751,1,00119,India
116129,2023-08-29,503,mixer,1349,3249,1900,1,00119,India
116129,2023-08-29,507,washing machine,6990,16490,9500,1,00119,India
383820,2023-08-29,506,monitor,3249,8000,4751,1,00144,India
383820,2023-08-29,501,iphone 15,60000,80000,20000,1,00144,India
910020,2023-08-29,501,iphone 15,60000,80000,20000,1,00046,India
910020,2023-08-29,503,mixer,1349,3249,1900,1,00046,India
910020,2023-08-29,507,washing machine,6990,16490,9500,1,00046,India
790792,2023-08-29,502,iphone 15 pro max,100000,135000,35000,1,00467,India
790792,2023-08-29,506,monitor,3249,8000,4751,1,00467,India
790792,2023-08-29,501,iphone 15,60000,80000,20000,1,00467,India
544724,2023-08-29,502,iphone 15 pro max,100000,135000,35000,1,00227,India
544724,2023-08-29,505,oven,18490,24000,5510,1,00227,India
544724,2023-08-29,501,iphone 15,60000,80000,20000,1,00227,India
588144,2023-08-29,503,mixer,1349,3249,1900,1,00091,India
588144,2023-08-29,502,iphone 15 pro max,100000,135000,35000,1,00091,India
275323,2023-08-29,503,mixer,1349,3249,1900,1,00383,India
275323,2023-08-29,507,washing machine,6990,16490,9500,1,00383,India
619104,2023-08-29,506,monitor,3249,8000,4751,1,00357,India
619104,2023-08-29,502,iphone 15 pro max,100000,135000,35000,1,00357,India
525631,2023-08-29,501,iphone 15,60000,80000,20000,1,00097,India
525631,2023-08-29,506,monitor,3249,8000,4751,1,00097,India
525631,2023-08-29,503,mixer,1349,3249,1900,1,00097,India
494469,2023-08-29,503,mixer,1349,3249,1900,1,00332,India
494469,2023-08-29,507,washing machine,6990,16490,9500,1,00332,India
494469,2023-08-29,502,iphone 15 pro max,100000,135000,35000,1,00332,India
153507,2023-08-29,503,mixer,1349,3249,1900,1,00053,India
153507,2023-08-29,502,iphone 15 pro max,100000,135000,35000,1,00053,India
647538,2023-08-29,502,iphone 15 pro max,100000,135000,35000,1,00434,India
647538,2023-08-29,505,oven,18490,24000,5510,1,00434,India
290686,2023-08-30,504,iron,449,879,430,1,00438,India
290686,2023-08-30,502,iphone 15 pro max,100000,135000,35000,1,00438,India
187859,2023-08-30,507,washing machine,6990,16490,9500,1,00381,India
187859,2023-08-30,506,monitor,3249,8000,4751,1,00381,India
187859,2023-08-30,503,mixer,1349,3249,1900,1,00381,India
843094,2023-08-30,503,mixer,1349,3249,1900,1,00011,India
843094,2023-08-30,506,monitor,3249,8000,4751,1,00011,India
843094,2023-08-30,507,washing machine,6990,16490,9500,1,00011,India
661781,2023-08-30,503,mixer,1349,3249,1900,1,00044,India
661781,2023-08-30,505,oven,18490,24000,5510,1,00044,India
661781,2023-08-30,507,washing machine,6990,16490,9500,1,00044,India
670314,2023-08-30,504,iron,449,879,430,1,00226,India
670314,2023-08-30,503,mixer,1349,3249,1900,1,00226,India
670314,2023-08-30,501,iphone 15,60000,80000,20000,1,00226,India
670314,2023-08-30,507,washing machine,6990,16490,9500,1,00226,India
503011,2023-08-30,502,iphone 15 pro max,100000,135000,35000,1,00251,India
503011,2023-08-30,504,iron,449,879,430,1,00251,India
503011,2023-08-30,501,iphone 15,60000,80000,20000,1,00251,India
461596,2023-08-30,507,washing machine,6990,16490,9500,1,00441,India
461596,2023-08-30,503,mixer,1349,3249,1900,1,00441,India
461596,2023-08-30,504,iron,449,879,430,1,00441,India
339143,2023-08-30,502,iphone 15 pro max,100000,135000,35000,1,00312,India
339143,2023-08-30,503,mixer,1349,3249,1900,1,00312,India
339143,2023-08-30,507,washing machine,6990,16490,9500,1,00312,India
339143,2023-08-30,504,iron,449,879,430,1,00312,India
358912,2023-08-30,506,monitor,3249,8000,4751,1,00435,India
358912,2023-08-30,501,iphone 15,60000,80000,20000,1,00435,India
358912,2023-08-30,507,washing machine,6990,16490,9500,1,00435,India
358912,2023-08-30,502,iphone 15 pro max,100000,135000,35000,1,00435,India
262312,2023-08-30,503,mixer,1349,3249,1900,1,00044,India
788021,2023-08-30,505,oven,18490,24000,5510,1,00151,India
788021,2023-08-30,504,iron,449,879,430,1,00151,India
788021,2023-08-30,503,mixer,1349,3249,1900,1,00151,India
253700,2023-08-30,504,iron,449,879,430,1,00493,India
253700,2023-08-30,501,iphone 15,60000,80000,20000,1,00493,India
253700,2023-08-30,505,oven,18490,24000,5510,1,00493,India
166611,2023-08-30,504,iron,449,879,430,1,00284,India
136259,2023-08-30,501,iphone 15,60000,80000,20000,1,00464,India
136259,2023-08-30,507,washing machine,6990,16490,9500,1,00464,India
136259,2023-08-30,506,monitor,3249,8000,4751,1,00464,India
136259,2023-08-30,502,iphone 15 pro max,100000,135000,35000,1,00464,India
453069,2023-08-30,505,oven,18490,24000,5510,1,00270,India
134154,2023-08-30,503,mixer,1349,3249,1900,1,00052,India
134154,2023-08-30,507,washing machine,6990,16490,9500,1,00052,India
134154,2023-08-30,502,iphone 15 pro max,100000,135000,35000,1,00052,India
134154,2023-08-30,501,iphone 15,60000,80000,20000,1,00052,India
645609,2023-08-30,505,oven,18490,24000,5510,1,00215,India
958828,2023-08-30,501,iphone 15,60000,80000,20000,1,00361,India
958828,2023-08-30,507,washing machine,6990,16490,9500,1,00361,India
126528,2023-08-30,506,monitor,3249,8000,4751,1,00156,India
126528,2023-08-30,507,washing machine,6990,16490,9500,1,00156,India
126528,2023-08-30,503,mixer,1349,3249,1900,1,00156,India
810559,2023-08-30,507,washing machine,6990,16490,9500,1,00089,India
810559,2023-08-30,503,mixer,1349,3249,1900,1,00089,India
810559,2023-08-30,505,oven,18490,24000,5510,1,00089,India
208632,2023-08-30,501,iphone 15,60000,80000,20000,1,00171,India
208632,2023-08-30,505,oven,18490,24000,5510,1,00171,India
208632,2023-08-30,504,iron,449,879,430,1,00171,India
208632,2023-08-30,503,mixer,1349,3249,1900,1,00171,India
208632,2023-08-30,507,washing machine,6990,16490,9500,1,00171,India
744492,2023-08-30,505,oven,18490,24000,5510,1,00220,India
462821,2023-08-30,504,iron,449,879,430,1,00130,India
462821,2023-08-30,501,iphone 15,60000,80000,20000,1,00130,India
462821,2023-08-30,502,iphone 15 pro max,100000,135000,35000,1,00130,India
462821,2023-08-30,506,monitor,3249,8000,4751,1,00130,India
688835,2023-08-30,501,iphone 15,60000,80000,20000,1,00480,India
688835,2023-08-30,503,mixer,1349,3249,1900,1,00480,India
688835,2023-08-30,504,iron,449,879,430,1,00480,India
307159,2023-08-30,505,oven,18490,24000,5510,1,00091,India
307159,2023-08-30,502,iphone 15 pro max,100000,135000,35000,1,00091,India
564053,2023-08-30,505,oven,18490,24000,5510,1,00315,India
564053,2023-08-30,502,iphone 15 pro max,100000,135000,35000,1,00315,India
564053,2023-08-30,501,iphone 15,60000,80000,20000,1,00315,India
564053,2023-08-30,504,iron,449,879,430,1,00315,India
924744,2023-08-30,502,iphone 15 pro max,100000,135000,35000,1,00389,India
924744,2023-08-30,504,iron,449,879,430,1,00389,India
924744,2023-08-30,503,mixer,1349,3249,1900,1,00389,India
313189,2023-08-30,501,iphone 15,60000,80000,20000,1,00325,India
313189,2023-08-30,505,oven,18490,24000,5510,1,00325,India
861738,2023-08-30,503,mixer,1349,3249,1900,1,00123,India
490964,2023-08-30,505,oven,18490,24000,5510,1,00299,India
490964,2023-08-30,507,washing machine,6990,16490,9500,1,00299,India
490964,2023-08-30,501,iphone 15,60000,80000,20000,1,00299,India
672378,2023-08-30,506,monitor,3249,8000,4751,1,00220,India
672378,2023-08-30,507,washing machine,6990,16490,9500,1,00220,India
160807,2023-08-30,507,washing machine,6990,16490,9500,1,00478,India
160807,2023-08-30,502,iphone 15 pro max,100000,135000,35000,1,00478,India
160807,2023-08-30,504,iron,449,879,430,1,00478,India
622449,2023-08-30,505,oven,18490,24000,5510,1,00065,India
622449,2023-08-30,507,washing machine,6990,16490,9500,1,00065,India
622449,2023-08-30,503,mixer,1349,3249,1900,1,00065,India
216177,2023-08-30,501,iphone 15,60000,80000,20000,1,00336,India
216177,2023-08-30,505,oven,18490,24000,5510,1,00336,India
199214,2023-08-30,501,iphone 15,60000,80000,20000,1,00303,India
199214,2023-08-30,504,iron,449,879,430,1,00303,India
361971,2023-08-30,501,iphone 15,60000,80000,20000,1,00174,India
361971,2023-08-30,505,oven,18490,24000,5510,1,00174,India
361971,2023-08-30,503,mixer,1349,3249,1900,1,00174,India
812870,2023-08-30,502,iphone 15 pro max,100000,135000,35000,1,00206,India
208061,2023-08-30,507,washing machine,6990,16490,9500,1,00326,India
374640,2023-08-30,507,washing machine,6990,16490,9500,1,00152,India
374640,2023-08-30,503,mixer,1349,3249,1900,1,00152,India
605834,2023-08-30,501,iphone 15,60000,80000,20000,1,00320,India
605834,2023-08-30,503,mixer,1349,3249,1900,1,00320,India
275656,2023-08-30,502,iphone 15 pro max,100000,135000,35000,1,00179,India
275656,2023-08-30,503,mixer,1349,3249,1900,1,00179,India
708936,2023-08-30,502,iphone 15 pro max,100000,135000,35000,1,00151,India
708936,2023-08-30,505,oven,18490,24000,5510,1,00151,India
219272,2023-08-30,502,iphone 15 pro max,100000,135000,35000,1,00300,India
219272,2023-08-30,507,washing machine,6990,16490,9500,1,00300,India
733955,2023-08-30,502,iphone 15 pro max,100000,135000,35000,1,00495,India
733955,2023-08-30,503,mixer,1349,3249,1900,1,00495,India
151207,2023-08-30,502,iphone 15 pro max,100000,135000,35000,1,00493,India
151207,2023-08-30,501,iphone 15,60000,80000,20000,1,00493,India
151207,2023-08-30,507,washing machine,6990,16490,9500,1,00493,India
941982,2023-08-30,504,iron,449,879,430,1,00162,India
941982,2023-08-30,501,iphone 15,60000,80000,20000,1,00162,India
941982,2023-08-30,503,mixer,1349,3249,1900,1,00162,India
458909,2023-08-30,505,oven,18490,24000,5510,1,00168,India
458909,2023-08-30,501,iphone 15,60000,80000,20000,1,00168,India
951519,2023-08-30,501,iphone 15,60000,80000,20000,1,00263,India
951519,2023-08-30,503,mixer,1349,3249,1900,1,00263,India
951519,2023-08-30,507,washing machine,6990,16490,9500,1,00263,India
754403,2023-08-30,501,iphone 15,60000,80000,20000,1,00336,India
754403,2023-08-30,506,monitor,3249,8000,4751,1,00336,India
754403,2023-08-30,503,mixer,1349,3249,1900,1,00336,India
177016,2023-08-30,506,monitor,3249,8000,4751,1,00281,India
177016,2023-08-30,505,oven,18490,24000,5510,1,00281,India
505129,2023-08-30,507,washing machine,6990,16490,9500,1,00095,India
505129,2023-08-30,505,oven,18490,24000,5510,1,00095,India
505129,2023-08-30,501,iphone 15,60000,80000,20000,1,00095,India
505129,2023-08-30,506,monitor,3249,8000,4751,1,00095,India
939884,2023-08-30,505,oven,18490,24000,5510,1,00044,India
939884,2023-08-30,507,washing machine,6990,16490,9500,1,00044,India
436853,2023-08-30,504,iron,449,879,430,1,00278,India
436853,2023-08-30,501,iphone 15,60000,80000,20000,1,00278,India
436853,2023-08-30,503,mixer,1349,3249,1900,1,00278,India
569756,2023-08-30,505,oven,18490,24000,5510,1,00362,India
569756,2023-08-30,506,monitor,3249,8000,4751,1,00362,India
569756,2023-08-30,502,iphone 15 pro max,100000,135000,35000,1,00362,India
798029,2023-08-30,507,washing machine,6990,16490,9500,1,00256,India
798029,2023-08-30,506,monitor,3249,8000,4751,1,00256,India
798029,2023-08-30,504,iron,449,879,430,1,00256,India
798029,2023-08-30,501,iphone 15,60000,80000,20000,1,00256,India
798029,2023-08-30,502,iphone 15 pro max,100000,135000,35000,1,00256,India
762991,2023-08-30,506,monitor,3249,8000,4751,1,00307,India
762991,2023-08-30,502,iphone 15 pro max,100000,135000,35000,1,00307,India
550925,2023-08-30,504,iron,449,879,430,1,00477,India
253396,2023-08-31,501,iphone 15,60000,80000,20000,1,00349,India
213333,2023-08-31,507,washing machine,6990,16490,9500,1,00206,India
213333,2023-08-31,505,oven,18490,24000,5510,1,00206,India
213333,2023-08-31,504,iron,449,879,430,1,00206,India
213333,2023-08-31,506,monitor,3249,8000,4751,1,00206,India
991949,2023-08-31,502,iphone 15 pro max,100000,135000,35000,1,00353,India
817737,2023-08-31,504,iron,449,879,430,1,00366,India
817737,2023-08-31,505,oven,18490,24000,5510,1,00366,India
669502,2023-08-31,502,iphone 15 pro max,100000,135000,35000,1,00488,India
669502,2023-08-31,504,iron,449,879,430,1,00488,India
258413,2023-08-31,507,washing machine,6990,16490,9500,1,00041,India
258413,2023-08-31,506,monitor,3249,8000,4751,1,00041,India
258413,2023-08-31,505,oven,18490,24000,5510,1,00041,India
181149,2023-08-31,506,monitor,3249,8000,4751,1,00247,India
482553,2023-08-31,507,washing machine,6990,16490,9500,1,00217,India
482553,2023-08-31,504,iron,449,879,430,1,00217,India
482553,2023-08-31,501,iphone 15,60000,80000,20000,1,00217,India
424981,2023-08-31,503,mixer,1349,3249,1900,1,00143,India
424981,2023-08-31,502,iphone 15 pro max,100000,135000,35000,1,00143,India
424981,2023-08-31,501,iphone 15,60000,80000,20000,1,00143,India
211497,2023-08-31,504,iron,449,879,430,1,00486,India
211497,2023-08-31,507,washing machine,6990,16490,9500,1,00486,India
211497,2023-08-31,501,iphone 15,60000,80000,20000,1,00486,India
394615,2023-08-31,505,oven,18490,24000,5510,1,00131,India
394615,2023-08-31,507,washing machine,6990,16490,9500,1,00131,India
594486,2023-08-31,504,iron,449,879,430,1,00421,India
594486,2023-08-31,507,washing machine,6990,16490,9500,1,00421,India
927499,2023-08-31,505,oven,18490,24000,5510,1,00137,India
927499,2023-08-31,506,monitor,3249,8000,4751,1,00137,India
927499,2023-08-31,502,iphone 15 pro max,100000,135000,35000,1,00137,India
830353,2023-08-31,505,oven,18490,24000,5510,1,00384,India
830353,2023-08-31,504,iron,449,879,430,1,00384,India
830353,2023-08-31,501,iphone 15,60000,80000,20000,1,00384,India
414131,2023-08-31,506,monitor,3249,8000,4751,1,00016,India
414131,2023-08-31,507,washing machine,6990,16490,9500,1,00016,India
414131,2023-08-31,503,mixer,1349,3249,1900,1,00016,India
692689,2023-08-31,505,oven,18490,24000,5510,1,00414,India
692689,2023-08-31,501,iphone 15,60000,80000,20000,1,00414,India
724672,2023-08-31,506,monitor,3249,8000,4751,1,00419,India
724672,2023-08-31,502,iphone 15 pro max,100000,135000,35000,1,00419,India
465863,2023-08-31,507,washing machine,6990,16490,9500,1,00158,India
754511,2023-08-31,506,monitor,3249,8000,4751,1,00369,India
754511,2023-08-31,501,iphone 15,60000,80000,20000,1,00369,India
143669,2023-08-31,506,monitor,3249,8000,4751,1,00014,India
143669,2023-08-31,505,oven,18490,24000,5510,1,00014,India
143669,2023-08-31,504,iron,449,879,430,1,00014,India
346236,2023-08-31,502,iphone 15 pro max,100000,135000,35000,1,00138,India
346236,2023-08-31,501,iphone 15,60000,80000,20000,1,00138,India
346236,2023-08-31,503,mixer,1349,3249,1900,1,00138,India
827700,2023-08-31,503,mixer,1349,3249,1900,1,00076,India
827700,2023-08-31,507,washing machine,6990,16490,9500,1,00076,India
942209,2023-08-31,501,iphone 15,60000,80000,20000,1,00080,India
836942,2023-08-31,501,iphone 15,60000,80000,20000,1,00109,India
836942,2023-08-31,507,washing machine,6990,16490,9500,1,00109,India
836942,2023-08-31,504,iron,449,879,430,1,00109,India
836942,2023-08-31,505,oven,18490,24000,5510,1,00109,India
184406,2023-08-31,502,iphone 15 pro max,100000,135000,35000,1,00478,India
184406,2023-08-31,503,mixer,1349,3249,1900,1,00478,India
184406,2023-08-31,505,oven,18490,24000,5510,1,00478,India
184406,2023-08-31,504,iron,449,879,430,1,00478,India
764566,2023-08-31,506,monitor,3249,8000,4751,1,00213,India
764566,2023-08-31,502,iphone 15 pro max,100000,135000,35000,1,00213,India
302873,2023-08-31,507,washing machine,6990,16490,9500,1,00344,India
523533,2023-08-31,505,oven,18490,24000,5510,1,00362,India
523533,2023-08-31,501,iphone 15,60000,80000,20000,1,00362,India
523533,2023-08-31,502,iphone 15 pro max,100000,135000,35000,1,00362,India
227658,2023-08-31,506,monitor,3249,8000,4751,1,00201,India
227658,2023-08-31,501,iphone 15,60000,80000,20000,1,00201,India
734100,2023-08-31,506,monitor,3249,8000,4751,1,00103,India
734100,2023-08-31,505,oven,18490,24000,5510,1,00103,India
344703,2023-08-31,507,washing machine,6990,16490,9500,1,00485,India
498091,2023-08-31,502,iphone 15 pro max,100000,135000,35000,1,00096,India
498091,2023-08-31,501,iphone 15,60000,80000,20000,1,00096,India
976910,2023-08-31,502,iphone 15 pro max,100000,135000,35000,1,00261,India
976910,2023-08-31,503,mixer,1349,3249,1900,1,00261,India
268017,2023-08-31,503,mixer,1349,3249,1900,1,00369,India
268017,2023-08-31,505,oven,18490,24000,5510,1,00369,India
268017,2023-08-31,507,washing machine,6990,16490,9500,1,00369,India
805512,2023-08-31,502,iphone 15 pro max,100000,135000,35000,1,00358,India
805512,2023-08-31,506,monitor,3249,8000,4751,1,00358,India
805512,2023-08-31,501,iphone 15,60000,80000,20000,1,00358,India
329466,2023-08-31,503,mixer,1349,3249,1900,1,00370,India
637463,2023-08-31,507,washing machine,6990,16490,9500,1,00454,India
637463,2023-08-31,504,iron,449,879,430,1,00454,India
637463,2023-08-31,505,oven,18490,24000,5510,1,00454,India
530176,2023-08-31,503,mixer,1349,3249,1900,1,00104,India
530176,2023-08-31,506,monitor,3249,8000,4751,1,00104,India
830313,2023-08-31,504,iron,449,879,430,1,00059,India
830313,2023-08-31,501,iphone 15,60000,80000,20000,1,00059,India
830313,2023-08-31,507,washing machine,6990,16490,9500,1,00059,India
474893,2023-08-31,506,monitor,3249,8000,4751,1,00318,India
474893,2023-08-31,507,washing machine,6990,16490,9500,1,00318,India
474893,2023-08-31,501,iphone 15,60000,80000,20000,1,00318,India
790431,2023-08-31,505,oven,18490,24000,5510,1,00402,India
203027,2023-08-31,506,monitor,3249,8000,4751,1,00345,India
203027,2023-08-31,503,mixer,1349,3249,1900,1,00345,India
203027,2023-08-31,502,iphone 15 pro max,100000,135000,35000,1,00345,India
370913,2023-08-31,501,iphone 15,60000,80000,20000,1,00192,India
370913,2023-08-31,505,oven,18490,24000,5510,1,00192,India
370913,2023-08-31,503,mixer,1349,3249,1900,1,00192,India
370913,2023-08-31,506,monitor,3249,8000,4751,1,00192,India
540950,2023-08-31,502,iphone 15 pro max,100000,135000,35000,1,00313,India
540950,2023-08-31,507,washing machine,6990,16490,9500,1,00313,India
540950,2023-08-31,504,iron,449,879,430,1,00313,India
786678,2023-08-31,504,iron,449,879,430,1,00326,India
109204,2023-08-31,504,iron,449,879,430,1,00493,India
109204,2023-08-31,505,oven,18490,24000,5510,1,00493,India
109204,2023-08-31,501,iphone 15,60000,80000,20000,1,00493,India
906214,2023-08-31,506,monitor,3249,8000,4751,1,00458,India
906214,2023-08-31,502,iphone 15 pro max,100000,135000,35000,1,00458,India
906214,2023-08-31,505,oven,18490,24000,5510,1,00458,India
736022,2023-08-31,503,mixer,1349,3249,1900,1,00205,India
736022,2023-08-31,505,oven,18490,24000,5510,1,00205,India
402124,2023-08-31,503,mixer,1349,3249,1900,1,00321,India
143638,2023-08-31,507,washing machine,6990,16490,9500,1,00417,India
143638,2023-08-31,502,iphone 15 pro max,100000,135000,35000,1,00417,India
143638,2023-08-31,505,oven,18490,24000,5510,1,00417,India
587127,2023-08-31,507,washing machine,6990,16490,9500,1,00425,India
854859,2023-08-31,505,oven,18490,24000,5510,1,00360,India
854859,2023-08-31,501,iphone 15,60000,80000,20000,1,00360,India
854859,2023-08-31,507,washing machine,6990,16490,9500,1,00360,India
274756,2023-08-31,501,iphone 15,60000,80000,20000,1,00106,India
274756,2023-08-31,507,washing machine,6990,16490,9500,1,00106,India
550349,2023-08-31,504,iron,449,879,430,1,00102,India
550349,2023-08-31,505,oven,18490,24000,5510,1,00102,India
550349,2023-08-31,506,monitor,3249,8000,4751,1,00102,India
550349,2023-08-31,501,iphone 15,60000,80000,20000,1,00102,India
800907,2023-08-31,506,monitor,3249,8000,4751,1,00371,India
800907,2023-08-31,507,washing machine,6990,16490,9500,1,00371,India
362014,2023-08-31,505,oven,18490,24000,5510,1,00304,India
362014,2023-08-31,502,iphone 15 pro max,100000,135000,35000,1,00304,India
321174,2023-08-31,502,iphone 15 pro max,100000,135000,35000,1,00232,India
321174,2023-08-31,505,oven,18490,24000,5510,1,00232,India
321174,2023-08-31,506,monitor,3249,8000,4751,1,00232,India
321174,2023-08-31,501,iphone 15,60000,80000,20000,1,00232,India
658362,2023-08-31,502,iphone 15 pro max,100000,135000,35000,1,00173,India
658362,2023-08-31,501,iphone 15,60000,80000,20000,1,00173,India
467153,2023-08-31,506,monitor,3249,8000,4751,1,00399,India
467153,2023-08-31,505,oven,18490,24000,5510,1,00399,India
443772,2023-08-31,502,iphone 15 pro max,100000,135000,35000,1,00122,India
443772,2023-08-31,505,oven,18490,24000,5510,1,00122,India
443772,2023-08-31,504,iron,449,879,430,1,00122,India
648155,2023-08-31,501,iphone 15,60000,80000,20000,1,00155,India
648155,2023-08-31,504,iron,449,879,430,1,00155,India
648155,2023-08-31,505,oven,18490,24000,5510,1,00155,India
648155,2023-08-31,507,washing machine,6990,16490,9500,1,00155,India
334725,2023-08-31,504,iron,449,879,430,1,00029,India
904189,2023-08-31,502,iphone 15 pro max,100000,135000,35000,1,00099,India
512650,2023-08-31,505,oven,18490,24000,5510,1,00306,India
192195,2023-08-31,506,monitor,3249,8000,4751,1,00431,India
192195,2023-08-31,503,mixer,1349,3249,1900,1,00431,India
490511,2023-08-31,507,washing machine,6990,16490,9500,1,00190,India
490511,2023-08-31,501,iphone 15,60000,80000,20000,1,00190,India
741713,2023-08-31,501,iphone 15,60000,80000,20000,1,00459,India
286615,2023-08-31,506,monitor,3249,8000,4751,1,00264,India
518324,2023-08-31,502,iphone 15 pro max,100000,135000,35000,1,00452,India
518324,2023-08-31,507,washing machine,6990,16490,9500,1,00452,India
518324,2023-08-31,504,iron,449,879,430,1,00452,India
518324,2023-08-31,501,iphone 15,60000,80000,20000,1,00452,India
518324,2023-08-31,505,oven,18490,24000,5510,1,00452,India
171580,2023-08-31,502,iphone 15 pro max,100000,135000,35000,1,00114,India
171580,2023-08-31,505,oven,18490,24000,5510,1,00114,India
171580,2023-08-31,503,mixer,1349,3249,1900,1,00114,India
171580,2023-08-31,504,iron,449,879,430,1,00114,India
487913,2023-08-31,501,iphone 15,60000,80000,20000,1,00382,India
583736,2023-08-31,506,monitor,3249,8000,4751,1,00048,India
583736,2023-08-31,501,iphone 15,60000,80000,20000,1,00048,India
583736,2023-08-31,507,washing machine,6990,16490,9500,1,00048,India
583736,2023-08-31,505,oven,18490,24000,5510,1,00048,India
821005,2023-08-31,502,iphone 15 pro max,100000,135000,35000,1,00306,India
821005,2023-08-31,506,monitor,3249,8000,4751,1,00306,India
878008,2023-08-31,502,iphone 15 pro max,100000,135000,35000,1,00100,India
878008,2023-08-31,504,iron,449,879,430,1,00100,India
878008,2023-08-31,506,monitor,3249,8000,4751,1,00100,India
878008,2023-08-31,501,iphone 15,60000,80000,20000,1,00100,India
929083,2023-08-31,502,iphone 15 pro max,100000,135000,35000,1,00317,India
929083,2023-08-31,503,mixer,1349,3249,1900,1,00317,India
929083,2023-08-31,504,iron,449,879,430,1,00317,India
929083,2023-08-31,507,washing machine,6990,16490,9500,1,00317,India
752084,2023-08-31,502,iphone 15 pro max,100000,135000,35000,1,00166,India
752084,2023-08-31,505,oven,18490,24000,5510,1,00166,India
752084,2023-08-31,507,washing machine,6990,16490,9500,1,00166,India
752084,2023-08-31,501,iphone 15,60000,80000,20000,1,00166,India
471561,2023-08-31,505,oven,18490,24000,5510,1,00054,India
471561,2023-08-31,503,mixer,1349,3249,1900,1,00054,India
471561,2023-08-31,504,iron,449,879,430,1,00054,India
471561,2023-08-31,501,iphone 15,60000,80000,20000,1,00054,India
288912,2023-08-31,507,washing machine,6990,16490,9500,1,00297,India
288912,2023-08-31,503,mixer,1349,3249,1900,1,00297,India
288912,2023-08-31,506,monitor,3249,8000,4751,1,00297,India
642131,2023-09-01,503,mixer,1349,3249,1900,1,00287,India
642131,2023-09-01,501,iphone 15,60000,80000,20000,1,00287,India
642131,2023-09-01,507,washing machine,6990,16490,9500,1,00287,India
642131,2023-09-01,502,iphone 15 pro max,100000,135000,35000,1,00287,India
296895,2023-09-01,503,mixer,1349,3249,1900,1,00434,India
296895,2023-09-01,502,iphone 15 pro max,100000,135000,35000,1,00434,India
296895,2023-09-01,501,iphone 15,60000,80000,20000,1,00434,India
296895,2023-09-01,507,washing machine,6990,16490,9500,1,00434,India
802724,2023-09-01,503,mixer,1349,3249,1900,1,00261,India
802724,2023-09-01,504,iron,449,879,430,1,00261,India
802724,2023-09-01,507,washing machine,6990,16490,9500,1,00261,India
123855,2023-09-01,504,iron,449,879,430,1,00300,India
123855,2023-09-01,507,washing machine,6990,16490,9500,1,00300,India
497542,2023-09-01,502,iphone 15 pro max,100000,135000,35000,1,00445,India
215018,2023-09-01,502,iphone 15 pro max,100000,135000,35000,1,00029,India
215018,2023-09-01,505,oven,18490,24000,5510,1,00029,India
215018,2023-09-01,507,washing machine,6990,16490,9500,1,00029,India
215018,2023-09-01,503,mixer,1349,3249,1900,1,00029,India
206756,2023-09-01,507,washing machine,6990,16490,9500,1,00495,India
206756,2023-09-01,502,iphone 15 pro max,100000,135000,35000,1,00495,India
206756,2023-09-01,505,oven,18490,24000,5510,1,00495,India
206756,2023-09-01,503,mixer,1349,3249,1900,1,00495,India
209557,2023-09-01,507,washing machine,6990,16490,9500,1,00354,India
209557,2023-09-01,502,iphone 15 pro max,100000,135000,35000,1,00354,India
209557,2023-09-01,506,monitor,3249,8000,4751,1,00354,India
769450,2023-09-01,501,iphone 15,60000,80000,20000,1,00429,India
769450,2023-09-01,504,iron,449,879,430,1,00429,India
769450,2023-09-01,505,oven,18490,24000,5510,1,00429,India
730538,2023-09-01,502,iphone 15 pro max,100000,135000,35000,1,00023,India
730538,2023-09-01,503,mixer,1349,3249,1900,1,00023,India
730538,2023-09-01,506,monitor,3249,8000,4751,1,00023,India
993254,2023-09-01,504,iron,449,879,430,1,00170,India
179241,2023-09-01,505,oven,18490,24000,5510,1,00176,India
179241,2023-09-01,502,iphone 15 pro max,100000,135000,35000,1,00176,India
713492,2023-09-01,503,mixer,1349,3249,1900,1,00082,India
713492,2023-09-01,504,iron,449,879,430,1,00082,India
846632,2023-09-01,502,iphone 15 pro max,100000,135000,35000,1,00025,India
846632,2023-09-01,501,iphone 15,60000,80000,20000,1,00025,India
846632,2023-09-01,505,oven,18490,24000,5510,1,00025,India
846632,2023-09-01,503,mixer,1349,3249,1900,1,00025,India
499485,2023-09-01,507,washing machine,6990,16490,9500,1,00192,India
499485,2023-09-01,502,iphone 15 pro max,100000,135000,35000,1,00192,India
499485,2023-09-01,506,monitor,3249,8000,4751,1,00192,India
499485,2023-09-01,505,oven,18490,24000,5510,1,00192,India
499485,2023-09-01,503,mixer,1349,3249,1900,1,00192,India
583333,2023-09-01,504,iron,449,879,430,1,00142,India
583333,2023-09-01,506,monitor,3249,8000,4751,1,00142,India
583333,2023-09-01,503,mixer,1349,3249,1900,1,00142,India
583333,2023-09-01,502,iphone 15 pro max,100000,135000,35000,1,00142,India
459842,2023-09-01,503,mixer,1349,3249,1900,1,00106,India
459842,2023-09-01,504,iron,449,879,430,1,00106,India
459842,2023-09-01,502,iphone 15 pro max,100000,135000,35000,1,00106,India
353985,2023-09-01,507,washing machine,6990,16490,9500,1,00358,India
353985,2023-09-01,505,oven,18490,24000,5510,1,00358,India
442991,2023-09-01,504,iron,449,879,430,1,00442,India
442991,2023-09-01,501,iphone 15,60000,80000,20000,1,00442,India
442991,2023-09-01,502,iphone 15 pro max,100000,135000,35000,1,00442,India
442991,2023-09-01,506,monitor,3249,8000,4751,1,00442,India
381991,2023-09-01,507,washing machine,6990,16490,9500,1,00104,India
381991,2023-09-01,504,iron,449,879,430,1,00104,India
159666,2023-09-01,507,washing machine,6990,16490,9500,1,00360,India
578761,2023-09-01,504,iron,449,879,430,1,00174,India
589496,2023-09-01,506,monitor,3249,8000,4751,1,00046,India
589496,2023-09-01,502,iphone 15 pro max,100000,135000,35000,1,00046,India
589496,2023-09-01,505,oven,18490,24000,5510,1,00046,India
933281,2023-09-01,502,iphone 15 pro max,100000,135000,35000,1,00363,India
933281,2023-09-01,505,oven,18490,24000,5510,1,00363,India
933281,2023-09-01,501,iphone 15,60000,80000,20000,1,00363,India
485425,2023-09-01,507,washing machine,6990,16490,9500,1,00098,India
485425,2023-09-01,506,monitor,3249,8000,4751,1,00098,India
485425,2023-09-01,504,iron,449,879,430,1,00098,India
305604,2023-09-01,503,mixer,1349,3249,1900,1,00104,India
380179,2023-09-01,503,mixer,1349,3249,1900,1,00211,India
380179,2023-09-01,505,oven,18490,24000,5510,1,00211,India
380179,2023-09-01,501,iphone 15,60000,80000,20000,1,00211,India
745783,2023-09-01,503,mixer,1349,3249,1900,1,00482,India
745783,2023-09-01,501,iphone 15,60000,80000,20000,1,00482,India
745783,2023-09-01,506,monitor,3249,8000,4751,1,00482,India
771031,2023-09-01,507,washing machine,6990,16490,9500,1,00022,India
771031,2023-09-01,503,mixer,1349,3249,1900,1,00022,India
771031,2023-09-01,501,iphone 15,60000,80000,20000,1,00022,India
139906,2023-09-01,503,mixer,1349,3249,1900,1,00124,India
139906,2023-09-01,504,iron,449,879,430,1,00124,India
139906,2023-09-01,507,washing machine,6990,16490,9500,1,00124,India
361383,2023-09-01,504,iron,449,879,430,1,00293,India
102983,2023-09-01,504,iron,449,879,430,1,00436,India
582649,2023-09-01,503,mixer,1349,3249,1900,1,00193,India
582649,2023-09-01,507,washing machine,6990,16490,9500,1,00193,India
582649,2023-09-01,505,oven,18490,24000,5510,1,00193,India
218079,2023-09-01,501,iphone 15,60000,80000,20000,1,00037,India
218079,2023-09-01,502,iphone 15 pro max,100000,135000,35000,1,00037,India
218079,2023-09-01,505,oven,18490,24000,5510,1,00037,India
218079,2023-09-01,503,mixer,1349,3249,1900,1,00037,India
490407,2023-09-01,505,oven,18490,24000,5510,1,00113,India
490407,2023-09-01,507,washing machine,6990,16490,9500,1,00113,India
490407,2023-09-01,502,iphone 15 pro max,100000,135000,35000,1,00113,India
414434,2023-09-01,502,iphone 15 pro max,100000,135000,35000,1,00092,India
922804,2023-09-01,507,washing machine,6990,16490,9500,1,00317,India
786788,2023-09-01,507,washing machine,6990,16490,9500,1,00223,India
786788,2023-09-01,503,mixer,1349,3249,1900,1,00223,India
786788,2023-09-01,504,iron,449,879,430,1,00223,India
786788,2023-09-01,502,iphone 15 pro max,100000,135000,35000,1,00223,India
572862,2023-09-01,505,oven,18490,24000,5510,1,00448,India
572862,2023-09-01,507,washing machine,6990,16490,9500,1,00448,India
572862,2023-09-01,506,monitor,3249,8000,4751,1,00448,India
747649,2023-09-01,507,washing machine,6990,16490,9500,1,00397,India
747649,2023-09-01,502,iphone 15 pro max,100000,135000,35000,1,00397,India
747649,2023-09-01,501,iphone 15,60000,80000,20000,1,00397,India
506820,2023-09-01,507,washing machine,6990,16490,9500,1,00192,India
506820,2023-09-01,504,iron,449,879,430,1,00192,India
996790,2023-09-01,502,iphone 15 pro max,100000,135000,35000,1,00370,India
996790,2023-09-01,501,iphone 15,60000,80000,20000,1,00370,India
996790,2023-09-01,506,monitor,3249,8000,4751,1,00370,India
996790,2023-09-01,503,mixer,1349,3249,1900,1,00370,India
368589,2023-09-01,506,monitor,3249,8000,4751,1,00227,India
874385,2023-09-01,507,washing machine,6990,16490,9500,1,00017,India
874385,2023-09-01,503,mixer,1349,3249,1900,1,00017,India
874385,2023-09-01,506,monitor,3249,8000,4751,1,00017,India
476937,2023-09-01,505,oven,18490,24000,5510,1,00497,India
476937,2023-09-01,503,mixer,1349,3249,1900,1,00497,India
365277,2023-09-01,505,oven,18490,24000,5510,1,00011,India
365277,2023-09-01,506,monitor,3249,8000,4751,1,00011,India
365277,2023-09-01,504,iron,449,879,430,1,00011,India
218995,2023-09-01,505,oven,18490,24000,5510,1,00466,India
218995,2023-09-01,501,iphone 15,60000,80000,20000,1,00466,India
687446,2023-09-01,507,washing machine,6990,16490,9500,1,00060,India
687446,2023-09-01,502,iphone 15 pro max,100000,135000,35000,1,00060,India
687446,2023-09-01,501,iphone 15,60000,80000,20000,1,00060,India
477342,2023-09-01,501,iphone 15,60000,80000,20000,1,00475,India
477342,2023-09-01,505,oven,18490,24000,5510,1,00475,India
449477,2023-09-01,507,washing machine,6990,16490,9500,1,00320,India
449477,2023-09-01,504,iron,449,879,430,1,00320,India
449477,2023-09-01,502,iphone 15 pro max,100000,135000,35000,1,00320,India
101033,2023-09-01,505,oven,18490,24000,5510,1,00425,India
850403,2023-09-01,507,washing machine,6990,16490,9500,1,00193,India
850403,2023-09-01,506,monitor,3249,8000,4751,1,00193,India
969828,2023-09-01,507,washing machine,6990,16490,9500,1,00244,India
449777,2023-09-01,503,mixer,1349,3249,1900,1,00115,India
449777,2023-09-01,507,washing machine,6990,16490,9500,1,00115,India
449777,2023-09-01,505,oven,18490,24000,5510,1,00115,India
968239,2023-09-01,501,iphone 15,60000,80000,20000,1,00233,India
740712,2023-09-01,503,mixer,1349,3249,1900,1,00081,India
740712,2023-09-01,505,oven,18490,24000,5510,1,00081,India
740712,2023-09-01,504,iron,449,879,430,1,00081,India
740712,2023-09-01,502,iphone 15 pro max,100000,135000,35000,1,00081,India
691881,2023-09-01,504,iron,449,879,430,1,00008,India
691881,2023-09-01,503,mixer,1349,3249,1900,1,00008,India
691881,2023-09-01,502,iphone 15 pro max,100000,135000,35000,1,00008,India
167565,2023-09-01,501,iphone 15,60000,80000,20000,1,00149,India
269593,2023-09-01,506,monitor,3249,8000,4751,1,00169,India
269593,2023-09-01,505,oven,18490,24000,5510,1,00169,India
269593,2023-09-01,501,iphone 15,60000,80000,20000,1,00169,India
269593,2023-09-01,507,washing machine,6990,16490,9500,1,00169,India
613569,2023-09-01,505,oven,18490,24000,5510,1,00384,India
613569,2023-09-01,506,monitor,3249,8000,4751,1,00384,India
613569,2023-09-01,503,mixer,1349,3249,1900,1,00384,India
174345,2023-09-01,507,washing machine,6990,16490,9500,1,00336,India
420636,2023-09-01,504,iron,449,879,430,1,00281,India
420636,2023-09-01,507,washing machine,6990,16490,9500,1,00281,India
420636,2023-09-01,503,mixer,1349,3249,1900,1,00281,India
166054,2023-09-01,507,washing machine,6990,16490,9500,1,00100,India
166054,2023-09-01,502,iphone 15 pro max,100000,135000,35000,1,00100,India
166054,2023-09-01,505,oven,18490,24000,5510,1,00100,India
166054,2023-09-01,503,mixer,1349,3249,1900,1,00100,India
838369,2023-09-01,501,iphone 15,60000,80000,20000,1,00340,India
838369,2023-09-01,504,iron,449,879,430,1,00340,India
838369,2023-09-01,503,mixer,1349,3249,1900,1,00340,India
592795,2023-09-01,502,iphone 15 pro max,100000,135000,35000,1,00295,India
592795,2023-09-01,504,iron,449,879,430,1,00295,India
592795,2023-09-01,501,iphone 15,60000,80000,20000,1,00295,India
592795,2023-09-01,505,oven,18490,24000,5510,1,00295,India
124535,2023-09-01,501,iphone 15,60000,80000,20000,1,00053,India
598475,2023-09-01,507,washing machine,6990,16490,9500,1,00142,India
861717,2023-09-01,504,iron,449,879,430,1,00373,India
861717,2023-09-01,501,iphone 15,60000,80000,20000,1,00373,India
988354,2023-09-01,501,iphone 15,60000,80000,20000,1,00497,India
988354,2023-09-01,504,iron,449,879,430,1,00497,India
988354,2023-09-01,503,mixer,1349,3249,1900,1,00497,India
538762,2023-09-01,505,oven,18490,24000,5510,1,00160,India
538762,2023-09-01,506,monitor,3249,8000,4751,1,00160,India
956762,2023-09-01,505,oven,18490,24000,5510,1,00007,India
956762,2023-09-01,501,iphone 15,60000,80000,20000,1,00007,India
956762,2023-09-01,503,mixer,1349,3249,1900,1,00007,India
342389,2023-09-01,502,iphone 15 pro max,100000,135000,35000,1,00010,India
342389,2023-09-01,507,washing machine,6990,16490,9500,1,00010,India
342389,2023-09-01,505,oven,18490,24000,5510,1,00010,India
342389,2023-09-01,503,mixer,1349,3249,1900,1,00010,India
814958,2023-09-01,502,iphone 15 pro max,100000,135000,35000,1,00083,India
814958,2023-09-01,503,mixer,1349,3249,1900,1,00083,India
814958,2023-09-01,505,oven,18490,24000,5510,1,00083,India
814958,2023-09-01,507,washing machine,6990,16490,9500,1,00083,India
384986,2023-09-01,506,monitor,3249,8000,4751,1,00037,India
405630,2023-09-01,502,iphone 15 pro max,100000,135000,35000,1,00254,India
405630,2023-09-01,505,oven,18490,24000,5510,1,00254,India
405630,2023-09-01,506,monitor,3249,8000,4751,1,00254,India
358613,2023-09-01,501,iphone 15,60000,80000,20000,1,00398,India
358613,2023-09-01,503,mixer,1349,3249,1900,1,00398,India
358613,2023-09-01,502,iphone 15 pro max,100000,135000,35000,1,00398,India
359829,2023-09-01,505,oven,18490,24000,5510,1,00419,India
359829,2023-09-01,502,iphone 15 pro max,100000,135000,35000,1,00419,India
359829,2023-09-01,507,washing machine,6990,16490,9500,1,00419,India
359829,2023-09-01,503,mixer,1349,3249,1900,1,00419,India
820856,2023-09-01,507,washing machine,6990,16490,9500,1,00084,India
773674,2023-09-01,507,washing machine,6990,16490,9500,1,00495,India
273454,2023-09-01,505,oven,18490,24000,5510,1,00139,India
273454,2023-09-01,503,mixer,1349,3249,1900,1,00139,India
273454,2023-09-01,504,iron,449,879,430,1,00139,India
273454,2023-09-01,506,monitor,3249,8000,4751,1,00139,India
152716,2023-09-01,507,washing machine,6990,16490,9500,1,00269,India
740473,2023-09-01,506,monitor,3249,8000,4751,1,00070,India
740473,2023-09-01,504,iron,449,879,430,1,00070,India
740473,2023-09-01,503,mixer,1349,3249,1900,1,00070,India
798341,2023-09-02,502,iphone 15 pro max,100000,135000,35000,1,00336,India
798341,2023-09-02,505,oven,18490,24000,5510,1,00336,India
279069,2023-09-02,505,oven,18490,24000,5510,1,00109,India
279069,2023-09-02,502,iphone 15 pro max,100000,135000,35000,1,00109,India
279069,2023-09-02,507,washing machine,6990,16490,9500,1,00109,India
447808,2023-09-02,502,iphone 15 pro max,100000,135000,35000,1,00205,India
869642,2023-09-02,503,mixer,1349,3249,1900,1,00244,India
458426,2023-09-02,503,mixer,1349,3249,1900,1,00019,India
381459,2023-09-02,507,washing machine,6990,16490,9500,1,00165,India
567975,2023-09-02,502,iphone 15 pro max,100000,135000,35000,1,00456,India
567975,2023-09-02,501,iphone 15,60000,80000,20000,1,00456,India
830258,2023-09-02,502,iphone 15 pro max,100000,135000,35000,1,00153,India
830258,2023-09-02,507,washing machine,6990,16490,9500,1,00153,India
856908,2023-09-02,506,monitor,3249,8000,4751,1,00285,India
856908,2023-09-02,505,oven,18490,24000,5510,1,00285,India
856908,2023-09-02,502,iphone 15 pro max,100000,135000,35000,1,00285,India
763059,2023-09-02,506,monitor,3249,8000,4751,1,00499,India
796979,2023-09-02,503,mixer,1349,3249,1900,1,00072,India
796979,2023-09-02,502,iphone 15 pro max,100000,135000,35000,1,00072,India
796979,2023-09-02,505,oven,18490,24000,5510,1,00072,India
749943,2023-09-02,506,monitor,3249,8000,4751,1,00227,India
565648,2023-09-02,502,iphone 15 pro max,100000,135000,35000,1,00230,India
565648,2023-09-02,506,monitor,3249,8000,4751,1,00230,India
565648,2023-09-02,501,iphone 15,60000,80000,20000,1,00230,India
527587,2023-09-02,502,iphone 15 pro max,100000,135000,35000,1,00050,India
527587,2023-09-02,505,oven,18490,24000,5510,1,00050,India
527587,2023-09-02,507,washing machine,6990,16490,9500,1,00050,India
527587,2023-09-02,503,mixer,1349,3249,1900,1,00050,India
739390,2023-09-02,503,mixer,1349,3249,1900,1,00057,India
739390,2023-09-02,504,iron,449,879,430,1,00057,India
739390,2023-09-02,507,washing machine,6990,16490,9500,1,00057,India
724502,2023-09-02,502,iphone 15 pro max,100000,135000,35000,1,00429,India
724502,2023-09-02,504,iron,449,879,430,1,00429,India
724502,2023-09-02,505,oven,18490,24000,5510,1,00429,India
479802,2023-09-02,507,washing machine,6990,16490,9500,1,00473,India
479802,2023-09-02,502,iphone 15 pro max,100000,135000,35000,1,00473,India
640432,2023-09-02,505,oven,18490,24000,5510,1,00093,India
640432,2023-09-02,504,iron,449,879,430,1,00093,India
640432,2023-09-02,503,mixer,1349,3249,1900,1,00093,India
704528,2023-09-02,503,mixer,1349,3249,1900,1,00077,India
704528,2023-09-02,504,iron,449,879,430,1,00077,India
704528,2023-09-02,505,oven,18490,24000,5510,1,00077,India
704528,2023-09-02,501,iphone 15,60000,80000,20000,1,00077,India
288726,2023-09-02,503,mixer,1349,3249,1900,1,00475,India
288726,2023-09-02,505,oven,18490,24000,5510,1,00475,India
288726,2023-09-02,506,monitor,3249,8000,4751,1,00475,India
531719,2023-09-02,503,mixer,1349,3249,1900,1,00211,India
531719,2023-09-02,506,monitor,3249,8000,4751,1,00211,India
531719,2023-09-02,502,iphone 15 pro max,100000,135000,35000,1,00211,India
422022,2023-09-02,506,monitor,3249,8000,4751,1,00182,India
422022,2023-09-02,503,mixer,1349,3249,1900,1,00182,India
422022,2023-09-02,504,iron,449,879,430,1,00182,India
746875,2023-09-02,504,iron,449,879,430,1,00026,India
746875,2023-09-02,507,washing machine,6990,16490,9500,1,00026,India
130486,2023-09-02,506,monitor,3249,8000,4751,1,00335,India
639757,2023-09-02,501,iphone 15,60000,80000,20000,1,00482,India
639757,2023-09-02,506,monitor,3249,8000,4751,1,00482,India
639757,2023-09-02,505,oven,18490,24000,5510,1,00482,India
158519,2023-09-02,505,oven,18490,24000,5510,1,00330,India
158519,2023-09-02,501,iphone 15,60000,80000,20000,1,00330,India
703160,2023-09-02,505,oven,18490,24000,5510,1,00057,India
703160,2023-09-02,504,iron,449,879,430,1,00057,India
628328,2023-09-02,501,iphone 15,60000,80000,20000,1,00127,India
628328,2023-09-02,502,iphone 15 pro max,100000,135000,35000,1,00127,India
628328,2023-09-02,505,oven,18490,24000,5510,1,00127,India
628328,2023-09-02,507,washing machine,6990,16490,9500,1,00127,India
899716,2023-09-02,505,oven,18490,24000,5510,1,00351,India
899716,2023-09-02,507,washing machine,6990,16490,9500,1,00351,India
785620,2023-09-02,502,iphone 15 pro max,100000,135000,35000,1,00170,India
785620,2023-09-02,505,oven,18490,24000,5510,1,00170,India
306096,2023-09-02,502,iphone 15 pro max,100000,135000,35000,1,00493,India
914173,2023-09-02,505,oven,18490,24000,5510,1,00069,India
914173,2023-09-02,502,iphone 15 pro max,100000,135000,35000,1,00069,India
909552,2023-09-02,506,monitor,3249,8000,4751,1,00283,India
909552,2023-09-02,504,iron,449,879,430,1,00283,India
482515,2023-09-02,503,mixer,1349,3249,1900,1,00279,India
719531,2023-09-02,503,mixer,1349,3249,1900,1,00138,India
719531,2023-09-02,501,iphone 15,60000,80000,20000,1,00138,India
674725,2023-09-02,502,iphone 15 pro max,100000,135000,35000,1,00471,India
674725,2023-09-02,505,oven,18490,24000,5510,1,00471,India
810844,2023-09-02,504,iron,449,879,430,1,00195,India
465682,2023-09-02,502,iphone 15 pro max,100000,135000,35000,1,00016,India
465682,2023-09-02,505,oven,18490,24000,5510,1,00016,India
202233,2023-09-02,505,oven,18490,24000,5510,1,00224,India
143419,2023-09-02,502,iphone 15 pro max,100000,135000,35000,1,00467,India
167118,2023-09-02,507,washing machine,6990,16490,9500,1,00263,India
167118,2023-09-02,506,monitor,3249,8000,4751,1,00263,India
167118,2023-09-02,503,mixer,1349,3249,1900,1,00263,India
167118,2023-09-02,505,oven,18490,24000,5510,1,00263,India
167118,2023-09-02,501,iphone 15,60000,80000,20000,1,00263,India
986776,2023-09-02,506,monitor,3249,8000,4751,1,00056,India
986776,2023-09-02,501,iphone 15,60000,80000,20000,1,00056,India
710668,2023-09-02,502,iphone 15 pro max,100000,135000,35000,1,00277,India
710668,2023-09-02,503,mixer,1349,3249,1900,1,00277,India
723351,2023-09-02,504,iron,449,879,430,1,00171,India
723351,2023-09-02,502,iphone 15 pro max,100000,135000,35000,1,00171,India
723351,2023-09-02,501,iphone 15,60000,80000,20000,1,00171,India
254182,2023-09-02,506,monitor,3249,8000,4751,1,00416,India
254182,2023-09-02,501,iphone 15,60000,80000,20000,1,00416,India
254182,2023-09-02,503,mixer,1349,3249,1900,1,00416,India
378448,2023-09-02,505,oven,18490,24000,5510,1,00249,India
378448,2023-09-02,507,washing machine,6990,16490,9500,1,00249,India
378448,2023-09-02,506,monitor,3249,8000,4751,1,00249,India
378448,2023-09-02,501,iphone 15,60000,80000,20000,1,00249,India
348493,2023-09-02,502,iphone 15 pro max,100000,135000,35000,1,00329,India
348493,2023-09-02,501,iphone 15,60000,80000,20000,1,00329,India
348493,2023-09-02,506,monitor,3249,8000,4751,1,00329,India
384488,2023-09-02,503,mixer,1349,3249,1900,1,00376,India
832945,2023-09-02,501,iphone 15,60000,80000,20000,1,00023,India
832945,2023-09-02,504,iron,449,879,430,1,00023,India
632370,2023-09-02,507,washing machine,6990,16490,9500,1,00073,India
632370,2023-09-02,504,iron,449,879,430,1,00073,India
867429,2023-09-02,503,mixer,1349,3249,1900,1,00402,India
992535,2023-09-02,504,iron,449,879,430,1,00205,India
992535,2023-09-02,507,washing machine,6990,16490,9500,1,00205,India
149840,2023-09-02,502,iphone 15 pro max,100000,135000,35000,1,00118,India
149840,2023-09-02,505,oven,18490,24000,5510,1,00118,India
580616,2023-09-02,504,iron,449,879,430,1,00247,India
580616,2023-09-02,507,washing machine,6990,16490,9500,1,00247,India
580616,2023-09-02,506,monitor,3249,8000,4751,1,00247,India
195560,2023-09-02,504,iron,449,879,430,1,00155,India
195560,2023-09-02,502,iphone 15 pro max,100000,135000,35000,1,00155,India
659105,2023-09-02,505,oven,18490,24000,5510,1,00480,India
659105,2023-09-02,502,iphone 15 pro max,100000,135000,35000,1,00480,India
343903,2023-09-02,505,oven,18490,24000,5510,1,00356,India
343903,2023-09-02,501,iphone 15,60000,80000,20000,1,00356,India
343903,2023-09-02,503,mixer,1349,3249,1900,1,00356,India
343903,2023-09-02,506,monitor,3249,8000,4751,1,00356,India
343903,2023-09-02,507,washing machine,6990,16490,9500,1,00356,India
435611,2023-09-02,503,mixer,1349,3249,1900,1,00277,India
435611,2023-09-02,507,washing machine,6990,16490,9500,1,00277,India
435611,2023-09-02,504,iron,449,879,430,1,00277,India
435611,2023-09-02,502,iphone 15 pro max,100000,135000,35000,1,00277,India
310631,2023-09-02,501,iphone 15,60000,80000,20000,1,00066,India
310631,2023-09-02,503,mixer,1349,3249,1900,1,00066,India
355361,2023-09-02,505,oven,18490,24000,5510,1,00040,India
355361,2023-09-02,502,iphone 15 pro max,100000,135000,35000,1,00040,India
355361,2023-09-02,507,washing machine,6990,16490,9500,1,00040,India
905846,2023-09-02,506,monitor,3249,8000,4751,1,00487,India
905846,2023-09-02,505,oven,18490,24000,5510,1,00487,India
905846,2023-09-02,503,mixer,1349,3249,1900,1,00487,India
905846,2023-09-02,502,iphone 15 pro max,100000,135000,35000,1,00487,India
576906,2023-09-02,503,mixer,1349,3249,1900,1,00376,India
708311,2023-09-03,501,iphone 15,60000,80000,20000,1,00467,India
708311,2023-09-03,502,iphone 15 pro max,100000,135000,35000,1,00467,India
153464,2023-09-03,506,monitor,3249,8000,4751,1,00433,India
232526,2023-09-03,501,iphone 15,60000,80000,20000,1,00363,India
232526,2023-09-03,504,iron,449,879,430,1,00363,India
232526,2023-09-03,502,iphone 15 pro max,100000,135000,35000,1,00363,India
227259,2023-09-03,502,iphone 15 pro max,100000,135000,35000,1,00340,India
227259,2023-09-03,501,iphone 15,60000,80000,20000,1,00340,India
707910,2023-09-03,506,monitor,3249,8000,4751,1,00323,India
707910,2023-09-03,502,iphone 15 pro max,100000,135000,35000,1,00323,India
431949,2023-09-03,504,iron,449,879,430,1,00243,India
431949,2023-09-03,501,iphone 15,60000,80000,20000,1,00243,India
431949,2023-09-03,503,mixer,1349,3249,1900,1,00243,India
431949,2023-09-03,502,iphone 15 pro max,100000,135000,35000,1,00243,India
460955,2023-09-03,503,mixer,1349,3249,1900,1,00303,India
233392,2023-09-03,507,washing machine,6990,16490,9500,1,00366,India
233392,2023-09-03,503,mixer,1349,3249,1900,1,00366,India
233392,2023-09-03,506,monitor,3249,8000,4751,1,00366,India
233392,2023-09-03,502,iphone 15 pro max,100000,135000,35000,1,00366,India
171332,2023-09-03,503,mixer,1349,3249,1900,1,00072,India
171332,2023-09-03,501,iphone 15,60000,80000,20000,1,00072,India
171332,2023-09-03,504,iron,449,879,430,1,00072,India
171332,2023-09-03,507,washing machine,6990,16490,9500,1,00072,India
518572,2023-09-03,505,oven,18490,24000,5510,1,00465,India
518572,2023-09-03,507,washing machine,6990,16490,9500,1,00465,India
278714,2023-09-03,507,washing machine,6990,16490,9500,1,00185,India
278714,2023-09-03,506,monitor,3249,8000,4751,1,00185,India
817171,2023-09-03,504,iron,449,879,430,1,00304,India
817171,2023-09-03,501,iphone 15,60000,80000,20000,1,00304,India
447817,2023-09-03,503,mixer,1349,3249,1900,1,00301,India
447817,2023-09-03,502,iphone 15 pro max,100000,135000,35000,1,00301,India
447817,2023-09-03,507,washing machine,6990,16490,9500,1,00301,India
447817,2023-09-03,506,monitor,3249,8000,4751,1,00301,India
297697,2023-09-03,504,iron,449,879,430,1,00297,India
297697,2023-09-03,503,mixer,1349,3249,1900,1,00297,India
442538,2023-09-03,505,oven,18490,24000,5510,1,00038,India
442538,2023-09-03,502,iphone 15 pro max,100000,135000,35000,1,00038,India
442538,2023-09-03,507,washing machine,6990,16490,9500,1,00038,India
442538,2023-09-03,501,iphone 15,60000,80000,20000,1,00038,India
681533,2023-09-03,505,oven,18490,24000,5510,1,00386,India
681533,2023-09-03,504,iron,449,879,430,1,00386,India
681533,2023-09-03,501,iphone 15,60000,80000,20000,1,00386,India
619667,2023-09-03,503,mixer,1349,3249,1900,1,00421,India
619667,2023-09-03,507,washing machine,6990,16490,9500,1,00421,India
602334,2023-09-03,502,iphone 15 pro max,100000,135000,35000,1,00126,India
602334,2023-09-03,501,iphone 15,60000,80000,20000,1,00126,India
602334,2023-09-03,504,iron,449,879,430,1,00126,India
602334,2023-09-03,507,washing machine,6990,16490,9500,1,00126,India
551535,2023-09-03,506,monitor,3249,8000,4751,1,00277,India
551535,2023-09-03,505,oven,18490,24000,5510,1,00277,India
551535,2023-09-03,503,mixer,1349,3249,1900,1,00277,India
224056,2023-09-03,504,iron,449,879,430,1,00495,India
752140,2023-09-03,501,iphone 15,60000,80000,20000,1,00418,India
752140,2023-09-03,502,iphone 15 pro max,100000,135000,35000,1,00418,India
752140,2023-09-03,506,monitor,3249,8000,4751,1,00418,India
752140,2023-09-03,505,oven,18490,24000,5510,1,00418,India
513635,2023-09-03,503,mixer,1349,3249,1900,1,00109,India
513635,2023-09-03,505,oven,18490,24000,5510,1,00109,India
192673,2023-09-03,503,mixer,1349,3249,1900,1,00272,India
192673,2023-09-03,504,iron,449,879,430,1,00272,India
457899,2023-09-03,506,monitor,3249,8000,4751,1,00156,India
923223,2023-09-03,506,monitor,3249,8000,4751,1,00140,India
923223,2023-09-03,507,washing machine,6990,16490,9500,1,00140,India
204943,2023-09-03,504,iron,449,879,430,1,00276,India
204943,2023-09-03,507,washing machine,6990,16490,9500,1,00276,India
204943,2023-09-03,506,monitor,3249,8000,4751,1,00276,India
756940,2023-09-03,502,iphone 15 pro max,100000,135000,35000,1,00270,India
756940,2023-09-03,505,oven,18490,24000,5510,1,00270,India
949954,2023-09-03,503,mixer,1349,3249,1900,1,00092,India
949954,2023-09-03,505,oven,18490,24000,5510,1,00092,India
737940,2023-09-03,501,iphone 15,60000,80000,20000,1,00480,India
198717,2023-09-03,507,washing machine,6990,16490,9500,1,00111,India
198717,2023-09-03,504,iron,449,879,430,1,00111,India
198717,2023-09-03,501,iphone 15,60000,80000,20000,1,00111,India
180489,2023-09-03,506,monitor,3249,8000,4751,1,00042,India
628617,2023-09-03,503,mixer,1349,3249,1900,1,00432,India
833237,2023-09-03,503,mixer,1349,3249,1900,1,00094,India
954395,2023-09-03,501,iphone 15,60000,80000,20000,1,00403,India
954395,2023-09-03,504,iron,449,879,430,1,00403,India
954395,2023-09-03,506,monitor,3249,8000,4751,1,00403,India
636201,2023-09-03,503,mixer,1349,3249,1900,1,00234,India
636201,2023-09-03,502,iphone 15 pro max,100000,135000,35000,1,00234,India
636201,2023-09-03,507,washing machine,6990,16490,9500,1,00234,India
974164,2023-09-03,502,iphone 15 pro max,100000,135000,35000,1,00393,India
974164,2023-09-03,505,oven,18490,24000,5510,1,00393,India
974164,2023-09-03,506,monitor,3249,8000,4751,1,00393,India
974164,2023-09-03,501,iphone 15,60000,80000,20000,1,00393,India
112413,2023-09-03,507,washing machine,6990,16490,9500,1,00441,India
112413,2023-09-03,505,oven,18490,24000,5510,1,00441,India
112413,2023-09-03,506,monitor,3249,8000,4751,1,00441,India
112413,2023-09-03,504,iron,449,879,430,1,00441,India
112413,2023-09-03,503,mixer,1349,3249,1900,1,00441,India
633323,2023-09-03,504,iron,449,879,430,1,00010,India
633323,2023-09-03,502,iphone 15 pro max,100000,135000,35000,1,00010,India
955707,2023-09-03,504,iron,449,879,430,1,00237,India
177261,2023-09-03,502,iphone 15 pro max,100000,135000,35000,1,00274,India
177261,2023-09-03,504,iron,449,879,430,1,00274,India
177261,2023-09-03,503,mixer,1349,3249,1900,1,00274,India
989949,2023-09-03,505,oven,18490,24000,5510,1,00431,India
989949,2023-09-03,503,mixer,1349,3249,1900,1,00431,India
989949,2023-09-03,506,monitor,3249,8000,4751,1,00431,India
261616,2023-09-03,506,monitor,3249,8000,4751,1,00323,India
261616,2023-09-03,507,washing machine,6990,16490,9500,1,00323,India
882842,2023-09-03,504,iron,449,879,430,1,00489,India
882842,2023-09-03,506,monitor,3249,8000,4751,1,00489,India
882842,2023-09-03,502,iphone 15 pro max,100000,135000,35000,1,00489,India
882842,2023-09-03,507,washing machine,6990,16490,9500,1,00489,India
845297,2023-09-03,506,monitor,3249,8000,4751,1,00195,India
845297,2023-09-03,504,iron,449,879,430,1,00195,India
845297,2023-09-03,507,washing machine,6990,16490,9500,1,00195,India
481270,2023-09-03,501,iphone 15,60000,80000,20000,1,00010,India
481270,2023-09-03,505,oven,18490,24000,5510,1,00010,India
564013,2023-09-03,506,monitor,3249,8000,4751,1,00134,India
564013,2023-09-03,502,iphone 15 pro max,100000,135000,35000,1,00134,India
564013,2023-09-03,504,iron,449,879,430,1,00134,India
619726,2023-09-03,504,iron,449,879,430,1,00183,India
619726,2023-09-03,502,iphone 15 pro max,100000,135000,35000,1,00183,India
619726,2023-09-03,507,washing machine,6990,16490,9500,1,00183,India
497884,2023-09-03,503,mixer,1349,3249,1900,1,00060,India
497884,2023-09-03,505,oven,18490,24000,5510,1,00060,India
497884,2023-09-03,507,washing machine,6990,16490,9500,1,00060,India
497884,2023-09-03,502,iphone 15 pro max,100000,135000,35000,1,00060,India
200452,2023-09-03,505,oven,18490,24000,5510,1,00345,India
200452,2023-09-03,504,iron,449,879,430,1,00345,India
379489,2023-09-03,503,mixer,1349,3249,1900,1,00472,India
339072,2023-09-03,501,iphone 15,60000,80000,20000,1,00292,India
339072,2023-09-03,505,oven,18490,24000,5510,1,00292,India
339072,2023-09-03,507,washing machine,6990,16490,9500,1,00292,India
867016,2023-09-03,502,iphone 15 pro max,100000,135000,35000,1,00251,India
867016,2023-09-03,506,monitor,3249,8000,4751,1,00251,India
867016,2023-09-03,504,iron,449,879,430,1,00251,India
190413,2023-09-04,505,oven,18490,24000,5510,1,00475,India
879794,2023-09-04,503,mixer,1349,3249,1900,1,00203,India
879794,2023-09-04,501,iphone 15,60000,80000,20000,1,00203,India
879794,2023-09-04,502,iphone 15 pro max,100000,135000,35000,1,00203,India
849104,2023-09-04,501,iphone 15,60000,80000,20000,1,00104,India
849104,2023-09-04,504,iron,449,879,430,1,00104,India
849104,2023-09-04,506,monitor,3249,8000,4751,1,00104,India
307566,2023-09-04,501,iphone 15,60000,80000,20000,1,00344,India
431329,2023-09-04,503,mixer,1349,3249,1900,1,00314,India
431329,2023-09-04,504,iron,449,879,430,1,00314,India
704044,2023-09-04,505,oven,18490,24000,5510,1,00466,India
598135,2023-09-04,501,iphone 15,60000,80000,20000,1,00153,India
598135,2023-09-04,505,oven,18490,24000,5510,1,00153,India
598135,2023-09-04,506,monitor,3249,8000,4751,1,00153,India
598135,2023-09-04,504,iron,449,879,430,1,00153,India
598135,2023-09-04,502,iphone 15 pro max,100000,135000,35000,1,00153,India
426077,2023-09-04,502,iphone 15 pro max,100000,135000,35000,1,00353,India
426077,2023-09-04,503,mixer,1349,3249,1900,1,00353,India
426077,2023-09-04,504,iron,449,879,430,1,00353,India
426077,2023-09-04,501,iphone 15,60000,80000,20000,1,00353,India
299356,2023-09-04,505,oven,18490,24000,5510,1,00137,India
398318,2023-09-04,506,monitor,3249,8000,4751,1,00344,India
398318,2023-09-04,503,mixer,1349,3249,1900,1,00344,India
398318,2023-09-04,505,oven,18490,24000,5510,1,00344,India
398318,2023-09-04,507,washing machine,6990,16490,9500,1,00344,India
300080,2023-09-04,507,washing machine,6990,16490,9500,1,00162,India
300080,2023-09-04,503,mixer,1349,3249,1900,1,00162,India
907503,2023-09-04,503,mixer,1349,3249,1900,1,00234,India
907503,2023-09-04,504,iron,449,879,430,1,00234,India
907503,2023-09-04,502,iphone 15 pro max,100000,135000,35000,1,00234,India
907503,2023-09-04,506,monitor,3249,8000,4751,1,00234,India
533413,2023-09-04,502,iphone 15 pro max,100000,135000,35000,1,00490,India
533413,2023-09-04,501,iphone 15,60000,80000,20000,1,00490,India
360839,2023-09-04,507,washing machine,6990,16490,9500,1,00008,India
937857,2023-09-04,506,monitor,3249,8000,4751,1,00151,India
937857,2023-09-04,503,mixer,1349,3249,1900,1,00151,India
208296,2023-09-04,502,iphone 15 pro max,100000,135000,35000,1,00185,India
758617,2023-09-04,504,iron,449,879,430,1,00100,India
115117,2023-09-04,506,monitor,3249,8000,4751,1,00171,India
115117,2023-09-04,502,iphone 15 pro max,100000,135000,35000,1,00171,India
115117,2023-09-04,503,mixer,1349,3249,1900,1,00171,India
675348,2023-09-04,503,mixer,1349,3249,1900,1,00103,India
675348,2023-09-04,504,iron,449,879,430,1,00103,India
675348,2023-09-04,507,washing machine,6990,16490,9500,1,00103,India
215860,2023-09-04,505,oven,18490,24000,5510,1,00105,India
215860,2023-09-04,506,monitor,3249,8000,4751,1,00105,India
215860,2023-09-04,503,mixer,1349,3249,1900,1,00105,India
249670,2023-09-04,503,mixer,1349,3249,1900,1,00305,India
249670,2023-09-04,502,iphone 15 pro max,100000,135000,35000,1,00305,India
253028,2023-09-04,506,monitor,3249,8000,4751,1,00176,India
253028,2023-09-04,507,washing machine,6990,16490,9500,1,00176,India
253028,2023-09-04,504,iron,449,879,430,1,00176,India
152396,2023-09-04,505,oven,18490,24000,5510,1,00044,India
152396,2023-09-04,504,iron,449,879,430,1,00044,India
895976,2023-09-04,502,iphone 15 pro max,100000,135000,35000,1,00237,India
895976,2023-09-04,507,washing machine,6990,16490,9500,1,00237,India
199479,2023-09-04,505,oven,18490,24000,5510,1,00204,India
508744,2023-09-04,507,washing machine,6990,16490,9500,1,00453,India
563442,2023-09-04,505,oven,18490,24000,5510,1,00124,India
563442,2023-09-04,502,iphone 15 pro max,100000,135000,35000,1,00124,India
196893,2023-09-04,505,oven,18490,24000,5510,1,00388,India
196893,2023-09-04,501,iphone 15,60000,80000,20000,1,00388,India
196893,2023-09-04,504,iron,449,879,430,1,00388,India
894154,2023-09-04,501,iphone 15,60000,80000,20000,1,00471,India
894154,2023-09-04,507,washing machine,6990,16490,9500,1,00471,India
894154,2023-09-04,505,oven,18490,24000,5510,1,00471,India
300890,2023-09-04,505,oven,18490,24000,5510,1,00435,India
300890,2023-09-04,506,monitor,3249,8000,4751,1,00435,India
300890,2023-09-04,504,iron,449,879,430,1,00435,India
725598,2023-09-04,507,washing machine,6990,16490,9500,1,00122,India
725598,2023-09-04,504,iron,449,879,430,1,00122,India
725598,2023-09-04,505,oven,18490,24000,5510,1,00122,India
725598,2023-09-04,506,monitor,3249,8000,4751,1,00122,India
915939,2023-09-04,501,iphone 15,60000,80000,20000,1,00314,India
915939,2023-09-04,502,iphone 15 pro max,100000,135000,35000,1,00314,India
198024,2023-09-04,506,monitor,3249,8000,4751,1,00429,India
198024,2023-09-04,504,iron,449,879,430,1,00429,India
198024,2023-09-04,502,iphone 15 pro max,100000,135000,35000,1,00429,India
198024,2023-09-04,507,washing machine,6990,16490,9500,1,00429,India
962194,2023-09-04,501,iphone 15,60000,80000,20000,1,00426,India
962194,2023-09-04,506,monitor,3249,8000,4751,1,00426,India
329813,2023-09-04,504,iron,449,879,430,1,00485,India
329813,2023-09-04,507,washing machine,6990,16490,9500,1,00485,India
389282,2023-09-04,505,oven,18490,24000,5510,1,00342,India
389282,2023-09-04,503,mixer,1349,3249,1900,1,00342,India
152467,2023-09-04,506,monitor,3249,8000,4751,1,00094,India
152467,2023-09-04,504,iron,449,879,430,1,00094,India
523990,2023-09-04,504,iron,449,879,430,1,00108,India
523990,2023-09-04,506,monitor,3249,8000,4751,1,00108,India
523990,2023-09-04,505,oven,18490,24000,5510,1,00108,India
408981,2023-09-04,504,iron,449,879,430,1,00057,India
408981,2023-09-04,506,monitor,3249,8000,4751,1,00057,India
135518,2023-09-04,505,oven,18490,24000,5510,1,00024,India
135518,2023-09-04,502,iphone 15 pro max,100000,135000,35000,1,00024,India
812567,2023-09-04,501,iphone 15,60000,80000,20000,1,00301,India
812567,2023-09-04,507,washing machine,6990,16490,9500,1,00301,India
812567,2023-09-04,503,mixer,1349,3249,1900,1,00301,India
812567,2023-09-04,506,monitor,3249,8000,4751,1,00301,India
219481,2023-09-04,507,washing machine,6990,16490,9500,1,00060,India
219481,2023-09-04,501,iphone 15,60000,80000,20000,1,00060,India
219481,2023-09-04,502,iphone 15 pro max,100000,135000,35000,1,00060,India
392999,2023-09-04,504,iron,449,879,430,1,00441,India
392999,2023-09-04,506,monitor,3249,8000,4751,1,00441,India
392999,2023-09-04,503,mixer,1349,3249,1900,1,00441,India
135038,2023-09-04,503,mixer,1349,3249,1900,1,00138,India
135038,2023-09-04,501,iphone 15,60000,80000,20000,1,00138,India
660831,2023-09-04,503,mixer,1349,3249,1900,1,00343,India
568602,2023-09-04,507,washing machine,6990,16490,9500,1,00270,India
568602,2023-09-04,501,iphone 15,60000,80000,20000,1,00270,India
353711,2023-09-04,507,washing machine,6990,16490,9500,1,00345,India
353711,2023-09-04,504,iron,449,879,430,1,00345,India
906901,2023-09-04,501,iphone 15,60000,80000,20000,1,00060,India
743273,2023-09-04,507,washing machine,6990,16490,9500,1,00272,India
268745,2023-09-04,507,washing machine,6990,16490,9500,1,00221,India
126740,2023-09-04,506,monitor,3249,8000,4751,1,00299,India
126740,2023-09-04,507,washing machine,6990,16490,9500,1,00299,India
126740,2023-09-04,505,oven,18490,24000,5510,1,00299,India
499971,2023-09-04,506,monitor,3249,8000,4751,1,00302,India
449052,2023-09-04,503,mixer,1349,3249,1900,1,00183,India
449052,2023-09-04,502,iphone 15 pro max,100000,135000,35000,1,00183,India
171598,2023-09-04,501,iphone 15,60000,80000,20000,1,00300,India
171598,2023-09-04,502,iphone 15 pro max,100000,135000,35000,1,00300,India
698291,2023-09-04,507,washing machine,6990,16490,9500,1,00238,India
698291,2023-09-04,502,iphone 15 pro max,100000,135000,35000,1,00238,India
698291,2023-09-04,501,iphone 15,60000,80000,20000,1,00238,India
908943,2023-09-04,505,oven,18490,24000,5510,1,00301,India
908943,2023-09-04,503,mixer,1349,3249,1900,1,00301,India
908943,2023-09-04,502,iphone 15 pro max,100000,135000,35000,1,00301,India
908943,2023-09-04,504,iron,449,879,430,1,00301,India
702368,2023-09-04,504,iron,449,879,430,1,00297,India
702368,2023-09-04,505,oven,18490,24000,5510,1,00297,India
702368,2023-09-04,507,washing machine,6990,16490,9500,1,00297,India
702368,2023-09-04,503,mixer,1349,3249,1900,1,00297,India
824045,2023-09-04,501,iphone 15,60000,80000,20000,1,00427,India
493007,2023-09-04,503,mixer,1349,3249,1900,1,00184,India
493007,2023-09-04,504,iron,449,879,430,1,00184,India
493007,2023-09-04,507,washing machine,6990,16490,9500,1,00184,India
122016,2023-09-04,505,oven,18490,24000,5510,1,00079,India
122016,2023-09-04,503,mixer,1349,3249,1900,1,00079,India
700105,2023-09-04,503,mixer,1349,3249,1900,1,00074,India
700105,2023-09-04,501,iphone 15,60000,80000,20000,1,00074,India
700105,2023-09-04,506,monitor,3249,8000,4751,1,00074,India
700105,2023-09-04,507,washing machine,6990,16490,9500,1,00074,India
733151,2023-09-04,505,oven,18490,24000,5510,1,00195,India
733151,2023-09-04,501,iphone 15,60000,80000,20000,1,00195,India
733151,2023-09-04,507,washing machine,6990,16490,9500,1,00195,India
775706,2023-09-04,502,iphone 15 pro max,100000,135000,35000,1,00060,India
775706,2023-09-04,505,oven,18490,24000,5510,1,00060,India
775706,2023-09-04,506,monitor,3249,8000,4751,1,00060,India
175402,2023-09-04,507,washing machine,6990,16490,9500,1,00027,India
175402,2023-09-04,506,monitor,3249,8000,4751,1,00027,India
175402,2023-09-04,504,iron,449,879,430,1,00027,India
740482,2023-09-04,506,monitor,3249,8000,4751,1,00341,India
740482,2023-09-04,503,mixer,1349,3249,1900,1,00341,India
391227,2023-09-04,504,iron,449,879,430,1,00067,India
391227,2023-09-04,506,monitor,3249,8000,4751,1,00067,India
391227,2023-09-04,507,washing machine,6990,16490,9500,1,00067,India
781999,2023-09-04,505,oven,18490,24000,5510,1,00349,India
781999,2023-09-04,501,iphone 15,60000,80000,20000,1,00349,India
626540,2023-09-04,503,mixer,1349,3249,1900,1,00051,India
626540,2023-09-04,505,oven,18490,24000,5510,1,00051,India
626540,2023-09-04,502,iphone 15 pro max,100000,135000,35000,1,00051,India
581402,2023-09-04,504,iron,449,879,430,1,00223,India
581402,2023-09-04,502,iphone 15 pro max,100000,135000,35000,1,00223,India
581402,2023-09-04,501,iphone 15,60000,80000,20000,1,00223,India
298753,2023-09-04,503,mixer,1349,3249,1900,1,00428,India
942694,2023-09-04,507,washing machine,6990,16490,9500,1,00255,India
942694,2023-09-04,501,iphone 15,60000,80000,20000,1,00255,India
942694,2023-09-04,506,monitor,3249,8000,4751,1,00255,India
942694,2023-09-04,502,iphone 15 pro max,100000,135000,35000,1,00255,India
735441,2023-09-04,501,iphone 15,60000,80000,20000,1,00410,India
735441,2023-09-04,504,iron,449,879,430,1,00410,India
861607,2023-09-04,505,oven,18490,24000,5510,1,00378,India
592088,2023-09-04,504,iron,449,879,430,1,00387,India
592088,2023-09-04,505,oven,18490,24000,5510,1,00387,India
592088,2023-09-04,502,iphone 15 pro max,100000,135000,35000,1,00387,India
592088,2023-09-04,503,mixer,1349,3249,1900,1,00387,India
585594,2023-09-04,503,mixer,1349,3249,1900,1,00458,India
897148,2023-09-04,505,oven,18490,24000,5510,1,00166,India
298599,2023-09-04,503,mixer,1349,3249,1900,1,00161,India
728023,2023-09-04,507,washing machine,6990,16490,9500,1,00005,India
728023,2023-09-04,501,iphone 15,60000,80000,20000,1,00005,India
728023,2023-09-04,503,mixer,1349,3249,1900,1,00005,India
231305,2023-09-04,506,monitor,3249,8000,4751,1,00198,India
231305,2023-09-04,502,iphone 15 pro max,100000,135000,35000,1,00198,India
231305,2023-09-04,504,iron,449,879,430,1,00198,India
231305,2023-09-04,501,iphone 15,60000,80000,20000,1,00198,India
231305,2023-09-04,503,mixer,1349,3249,1900,1,00198,India
486996,2023-09-04,504,iron,449,879,430,1,00077,India
350798,2023-09-04,501,iphone 15,60000,80000,20000,1,00438,India
350798,2023-09-04,507,washing machine,6990,16490,9500,1,00438,India
929182,2023-09-04,505,oven,18490,24000,5510,1,00249,India
512321,2023-09-04,505,oven,18490,24000,5510,1,00143,India
512321,2023-09-04,507,washing machine,6990,16490,9500,1,00143,India
512321,2023-09-04,501,iphone 15,60000,80000,20000,1,00143,India
489996,2023-09-05,507,washing machine,6990,16490,9500,1,00077,India
489996,2023-09-05,501,iphone 15,60000,80000,20000,1,00077,India
489996,2023-09-05,506,monitor,3249,8000,4751,1,00077,India
489996,2023-09-05,505,oven,18490,24000,5510,1,00077,India
644064,2023-09-05,503,mixer,1349,3249,1900,1,00074,India
644064,2023-09-05,504,iron,449,879,430,1,00074,India
644064,2023-09-05,507,washing machine,6990,16490,9500,1,00074,India
644064,2023-09-05,501,iphone 15,60000,80000,20000,1,00074,India
799778,2023-09-05,506,monitor,3249,8000,4751,1,00472,India
799778,2023-09-05,504,iron,449,879,430,1,00472,India
799778,2023-09-05,503,mixer,1349,3249,1900,1,00472,India
941748,2023-09-05,507,washing machine,6990,16490,9500,1,00262,India
941748,2023-09-05,504,iron,449,879,430,1,00262,India
792738,2023-09-05,502,iphone 15 pro max,100000,135000,35000,1,00309,India
792738,2023-09-05,504,iron,449,879,430,1,00309,India
889409,2023-09-05,504,iron,449,879,430,1,00185,India
889409,2023-09-05,501,iphone 15,60000,80000,20000,1,00185,India
358426,2023-09-05,507,washing machine,6990,16490,9500,1,00097,India
358426,2023-09-05,504,iron,449,879,430,1,00097,India
188747,2023-09-05,504,iron,449,879,430,1,00441,India
188747,2023-09-05,501,iphone 15,60000,80000,20000,1,00441,India
188747,2023-09-05,502,iphone 15 pro max,100000,135000,35000,1,00441,India
188747,2023-09-05,503,mixer,1349,3249,1900,1,00441,India
188747,2023-09-05,506,monitor,3249,8000,4751,1,00441,India
371153,2023-09-05,504,iron,449,879,430,1,00196,India
371153,2023-09-05,506,monitor,3249,8000,4751,1,00196,India
783198,2023-09-05,503,mixer,1349,3249,1900,1,00233,India
337566,2023-09-05,503,mixer,1349,3249,1900,1,00301,India
337566,2023-09-05,502,iphone 15 pro max,100000,135000,35000,1,00301,India
337566,2023-09-05,506,monitor,3249,8000,4751,1,00301,India
337566,2023-09-05,507,washing machine,6990,16490,9500,1,00301,India
770150,2023-09-05,507,washing machine,6990,16490,9500,1,00110,India
208757,2023-09-05,503,mixer,1349,3249,1900,1,00345,India
318533,2023-09-05,501,iphone 15,60000,80000,20000,1,00170,India
318533,2023-09-05,502,iphone 15 pro max,100000,135000,35000,1,00170,India
824775,2023-09-05,504,iron,449,879,430,1,00224,India
824775,2023-09-05,505,oven,18490,24000,5510,1,00224,India
824775,2023-09-05,507,washing machine,6990,16490,9500,1,00224,India
824775,2023-09-05,502,iphone 15 pro max,100000,135000,35000,1,00224,India
805574,2023-09-05,501,iphone 15,60000,80000,20000,1,00044,India
805574,2023-09-05,507,washing machine,6990,16490,9500,1,00044,India
805574,2023-09-05,506,monitor,3249,8000,4751,1,00044,India
121117,2023-09-05,507,washing machine,6990,16490,9500,1,00076,India
121117,2023-09-05,503,mixer,1349,3249,1900,1,00076,India
121117,2023-09-05,506,monitor,3249,8000,4751,1,00076,India
499704,2023-09-05,503,mixer,1349,3249,1900,1,00398,India
499704,2023-09-05,505,oven,18490,24000,5510,1,00398,India
499704,2023-09-05,507,washing machine,6990,16490,9500,1,00398,India
677587,2023-09-05,505,oven,18490,24000,5510,1,00148,India
677587,2023-09-05,502,iphone 15 pro max,100000,135000,35000,1,00148,India
677587,2023-09-05,501,iphone 15,60000,80000,20000,1,00148,India
675813,2023-09-05,506,monitor,3249,8000,4751,1,00268,India
675813,2023-09-05,507,washing machine,6990,16490,9500,1,00268,India
675813,2023-09-05,503,mixer,1349,3249,1900,1,00268,India
128384,2023-09-05,504,iron,449,879,430,1,00348,India
128384,2023-09-05,502,iphone 15 pro max,100000,135000,35000,1,00348,India
198977,2023-09-05,506,monitor,3249,8000,4751,1,00329,India
198977,2023-09-05,501,iphone 15,60000,80000,20000,1,00329,India
198977,2023-09-05,502,iphone 15 pro max,100000,135000,35000,1,00329,India
198977,2023-09-05,503,mixer,1349,3249,1900,1,00329,India
224139,2023-09-05,507,washing machine,6990,16490,9500,1,00465,India
224139,2023-09-05,506,monitor,3249,8000,4751,1,00465,India
224139,2023-09-05,504,iron,449,879,430,1,00465,India
333824,2023-09-05,506,monitor,3249,8000,4751,1,00337,India
250377,2023-09-05,503,mixer,1349,3249,1900,1,00479,India
250377,2023-09-05,501,iphone 15,60000,80000,20000,1,00479,India
250377,2023-09-05,507,washing machine,6990,16490,9500,1,00479,India
250377,2023-09-05,504,iron,449,879,430,1,00479,India
566804,2023-09-05,506,monitor,3249,8000,4751,1,00405,India
566804,2023-09-05,504,iron,449,879,430,1,00405,India
566804,2023-09-05,503,mixer,1349,3249,1900,1,00405,India
566804,2023-09-05,505,oven,18490,24000,5510,1,00405,India
389742,2023-09-05,506,monitor,3249,8000,4751,1,00062,India
915385,2023-09-05,506,monitor,3249,8000,4751,1,00274,India
995433,2023-09-05,505,oven,18490,24000,5510,1,00432,India
390033,2023-09-05,503,mixer,1349,3249,1900,1,00186,India
390033,2023-09-05,506,monitor,3249,8000,4751,1,00186,India
465082,2023-09-05,505,oven,18490,24000,5510,1,00441,India
465082,2023-09-05,502,iphone 15 pro max,100000,135000,35000,1,00441,India
465082,2023-09-05,504,iron,449,879,430,1,00441,India
465082,2023-09-05,501,iphone 15,60000,80000,20000,1,00441,India
812078,2023-09-05,503,mixer,1349,3249,1900,1,00310,India
812078,2023-09-05,505,oven,18490,24000,5510,1,00310,India
773455,2023-09-05,501,iphone 15,60000,80000,20000,1,00055,India
743816,2023-09-05,501,iphone 15,60000,80000,20000,1,00392,India
873840,2023-09-05,502,iphone 15 pro max,100000,135000,35000,1,00433,India
873840,2023-09-05,503,mixer,1349,3249,1900,1,00433,India
873840,2023-09-05,504,iron,449,879,430,1,00433,India
873840,2023-09-05,507,washing machine,6990,16490,9500,1,00433,India
994793,2023-09-05,502,iphone 15 pro max,100000,135000,35000,1,00019,India
994793,2023-09-05,501,iphone 15,60000,80000,20000,1,00019,India
835286,2023-09-05,502,iphone 15 pro max,100000,135000,35000,1,00047,India
835286,2023-09-05,506,monitor,3249,8000,4751,1,00047,India
792450,2023-09-05,506,monitor,3249,8000,4751,1,00164,India
936664,2023-09-05,504,iron,449,879,430,1,00266,India
715573,2023-09-05,501,iphone 15,60000,80000,20000,1,00229,India
180325,2023-09-05,505,oven,18490,24000,5510,1,00065,India
180325,2023-09-05,501,iphone 15,60000,80000,20000,1,00065,India
783768,2023-09-05,501,iphone 15,60000,80000,20000,1,00497,India
783768,2023-09-05,503,mixer,1349,3249,1900,1,00497,India
783768,2023-09-05,504,iron,449,879,430,1,00497,India
783768,2023-09-05,507,washing machine,6990,16490,9500,1,00497,India
113615,2023-09-05,502,iphone 15 pro max,100000,135000,35000,1,00080,India
113615,2023-09-05,503,mixer,1349,3249,1900,1,00080,India
994612,2023-09-05,502,iphone 15 pro max,100000,135000,35000,1,00189,India
994612,2023-09-05,507,washing machine,6990,16490,9500,1,00189,India
994612,2023-09-05,501,iphone 15,60000,80000,20000,1,00189,India
421188,2023-09-05,507,washing machine,6990,16490,9500,1,00314,India
421188,2023-09-05,502,iphone 15 pro max,100000,135000,35000,1,00314,India
421188,2023-09-05,504,iron,449,879,430,1,00314,India
421188,2023-09-05,501,iphone 15,60000,80000,20000,1,00314,India
550057,2023-09-05,502,iphone 15 pro max,100000,135000,35000,1,00330,India
928300,2023-09-05,502,iphone 15 pro max,100000,135000,35000,1,00193,India
622231,2023-09-05,505,oven,18490,24000,5510,1,00443,India
622231,2023-09-05,502,iphone 15 pro max,100000,135000,35000,1,00443,India
985331,2023-09-05,505,oven,18490,24000,5510,1,00346,India
985331,2023-09-05,507,washing machine,6990,16490,9500,1,00346,India
985331,2023-09-05,501,iphone 15,60000,80000,20000,1,00346,India
985331,2023-09-05,503,mixer,1349,3249,1900,1,00346,India
474523,2023-09-05,507,washing machine,6990,16490,9500,1,00299,India
474523,2023-09-05,502,iphone 15 pro max,100000,135000,35000,1,00299,India
474523,2023-09-05,505,oven,18490,24000,5510,1,00299,India
366785,2023-09-05,506,monitor,3249,8000,4751,1,00465,India
366785,2023-09-05,505,oven,18490,24000,5510,1,00465,India
974234,2023-09-06,502,iphone 15 pro max,100000,135000,35000,1,00390,India
974234,2023-09-06,501,iphone 15,60000,80000,20000,1,00390,India
974234,2023-09-06,504,iron,449,879,430,1,00390,India
737178,2023-09-06,504,iron,449,879,430,1,00498,India
686014,2023-09-06,502,iphone 15 pro max,100000,135000,35000,1,00206,India
753101,2023-09-06,504,iron,449,879,430,1,00290,India
753101,2023-09-06,506,monitor,3249,8000,4751,1,00290,India
506794,2023-09-06,503,mixer,1349,3249,1900,1,00249,India
169828,2023-09-06,506,monitor,3249,8000,4751,1,00036,India
284581,2023-09-06,502,iphone 15 pro max,100000,135000,35000,1,00351,India
284581,2023-09-06,501,iphone 15,60000,80000,20000,1,00351,India
284581,2023-09-06,505,oven,18490,24000,5510,1,00351,India
240084,2023-09-06,503,mixer,1349,3249,1900,1,00314,India
240084,2023-09-06,506,monitor,3249,8000,4751,1,00314,India
240084,2023-09-06,504,iron,449,879,430,1,00314,India
240084,2023-09-06,505,oven,18490,24000,5510,1,00314,India
860743,2023-09-06,505,oven,18490,24000,5510,1,00476,India
860743,2023-09-06,506,monitor,3249,8000,4751,1,00476,India
656483,2023-09-06,503,mixer,1349,3249,1900,1,00319,India
840730,2023-09-06,501,iphone 15,60000,80000,20000,1,00115,India
840730,2023-09-06,507,washing machine,6990,16490,9500,1,00115,India
840730,2023-09-06,504,iron,449,879,430,1,00115,India
350759,2023-09-06,505,oven,18490,24000,5510,1,00327,India
350759,2023-09-06,506,monitor,3249,8000,4751,1,00327,India
638406,2023-09-06,502,iphone 15 pro max,100000,135000,35000,1,00075,India
423614,2023-09-06,507,washing machine,6990,16490,9500,1,00247,India
928439,2023-09-06,503,mixer,1349,3249,1900,1,00255,India
928439,2023-09-06,507,washing machine,6990,16490,9500,1,00255,India
928439,2023-09-06,506,monitor,3249,8000,4751,1,00255,India
928439,2023-09-06,502,iphone 15 pro max,100000,135000,35000,1,00255,India
928439,2023-09-06,501,iphone 15,60000,80000,20000,1,00255,India
561792,2023-09-06,502,iphone 15 pro max,100000,135000,35000,1,00074,India
539326,2023-09-06,504,iron,449,879,430,1,00332,India
539326,2023-09-06,506,monitor,3249,8000,4751,1,00332,India
539326,2023-09-06,507,washing machine,6990,16490,9500,1,00332,India
209995,2023-09-06,503,mixer,1349,3249,1900,1,00095,India
209995,2023-09-06,507,washing machine,6990,16490,9500,1,00095,India
746768,2023-09-06,506,monitor,3249,8000,4751,1,00494,India
972872,2023-09-06,506,monitor,3249,8000,4751,1,00158,India
972872,2023-09-06,501,iphone 15,60000,80000,20000,1,00158,India
972872,2023-09-06,503,mixer,1349,3249,1900,1,00158,India
454023,2023-09-06,505,oven,18490,24000,5510,1,00106,India
454023,2023-09-06,501,iphone 15,60000,80000,20000,1,00106,India
454023,2023-09-06,506,monitor,3249,8000,4751,1,00106,India
910283,2023-09-06,506,monitor,3249,8000,4751,1,00133,India
910283,2023-09-06,501,iphone 15,60000,80000,20000,1,00133,India
589553,2023-09-06,507,washing machine,6990,16490,9500,1,00149,India
648746,2023-09-06,505,oven,18490,24000,5510,1,00086,India
648746,2023-09-06,502,iphone 15 pro max,100000,135000,35000,1,00086,India
789494,2023-09-06,501,iphone 15,60000,80000,20000,1,00462,India
789494,2023-09-06,503,mixer,1349,3249,1900,1,00462,India
789494,2023-09-06,506,monitor,3249,8000,4751,1,00462,India
789494,2023-09-06,502,iphone 15 pro max,100000,135000,35000,1,00462,India
407194,2023-09-06,504,iron,449,879,430,1,00254,India
407194,2023-09-06,506,monitor,3249,8000,4751,1,00254,India
194504,2023-09-06,501,iphone 15,60000,80000,20000,1,00153,India
194504,2023-09-06,503,mixer,1349,3249,1900,1,00153,India
224189,2023-09-06,501,iphone 15,60000,80000,20000,1,00067,India
910841,2023-09-06,501,iphone 15,60000,80000,20000,1,00180,India
910841,2023-09-06,502,iphone 15 pro max,100000,135000,35000,1,00180,India
448767,2023-09-06,503,mixer,1349,3249,1900,1,00361,India
281606,2023-09-06,505,oven,18490,24000,5510,1,00162,India
281606,2023-09-06,504,iron,449,879,430,1,00162,India
281606,2023-09-06,503,mixer,1349,3249,1900,1,00162,India
848210,2023-09-06,503,mixer,1349,3249,1900,1,00102,India
848210,2023-09-06,501,iphone 15,60000,80000,20000,1,00102,India
613708,2023-09-06,504,iron,449,879,430,1,00265,India
613708,2023-09-06,502,iphone 15 pro max,100000,135000,35000,1,00265,India
613708,2023-09-06,507,washing machine,6990,16490,9500,1,00265,India
141983,2023-09-06,507,washing machine,6990,16490,9500,1,00283,India
141983,2023-09-06,503,mixer,1349,3249,1900,1,00283,India
141983,2023-09-06,505,oven,18490,24000,5510,1,00283,India
141983,2023-09-06,502,iphone 15 pro max,100000,135000,35000,1,00283,India
774406,2023-09-06,501,iphone 15,60000,80000,20000,1,00469,India
774406,2023-09-06,503,mixer,1349,3249,1900,1,00469,India
774406,2023-09-06,507,washing machine,6990,16490,9500,1,00469,India
774406,2023-09-06,502,iphone 15 pro max,100000,135000,35000,1,00469,India
564830,2023-09-06,505,oven,18490,24000,5510,1,00343,India
564830,2023-09-06,507,washing machine,6990,16490,9500,1,00343,India
564830,2023-09-06,503,mixer,1349,3249,1900,1,00343,India
564830,2023-09-06,506,monitor,3249,8000,4751,1,00343,India
994443,2023-09-06,506,monitor,3249,8000,4751,1,00201,India
792559,2023-09-06,506,monitor,3249,8000,4751,1,00169,India
951244,2023-09-06,502,iphone 15 pro max,100000,135000,35000,1,00454,India
951244,2023-09-06,505,oven,18490,24000,5510,1,00454,India
773574,2023-09-06,504,iron,449,879,430,1,00108,India
773574,2023-09-06,507,washing machine,6990,16490,9500,1,00108,India
773574,2023-09-06,503,mixer,1349,3249,1900,1,00108,India
773574,2023-09-06,502,iphone 15 pro max,100000,135000,35000,1,00108,India
773574,2023-09-06,506,monitor,3249,8000,4751,1,00108,India
761702,2023-09-06,506,monitor,3249,8000,4751,1,00472,India
761702,2023-09-06,507,washing machine,6990,16490,9500,1,00472,India
814697,2023-09-06,504,iron,449,879,430,1,00317,India
814697,2023-09-06,503,mixer,1349,3249,1900,1,00317,India
324302,2023-09-06,505,oven,18490,24000,5510,1,00323,India
324302,2023-09-06,503,mixer,1349,3249,1900,1,00323,India
324302,2023-09-06,506,monitor,3249,8000,4751,1,00323,India
324302,2023-09-06,504,iron,449,879,430,1,00323,India
322419,2023-09-06,505,oven,18490,24000,5510,1,00222,India
322419,2023-09-06,506,monitor,3249,8000,4751,1,00222,India
322419,2023-09-06,501,iphone 15,60000,80000,20000,1,00222,India
322419,2023-09-06,504,iron,449,879,430,1,00222,India
843865,2023-09-06,505,oven,18490,24000,5510,1,00218,India
358965,2023-09-06,504,iron,449,879,430,1,00237,India
358965,2023-09-06,506,monitor,3249,8000,4751,1,00237,India
358965,2023-09-06,507,washing machine,6990,16490,9500,1,00237,India
519007,2023-09-06,503,mixer,1349,3249,1900,1,00282,India
519007,2023-09-06,501,iphone 15,60000,80000,20000,1,00282,India
519007,2023-09-06,502,iphone 15 pro max,100000,135000,35000,1,00282,India
819368,2023-09-06,505,oven,18490,24000,5510,1,00148,India
819368,2023-09-06,503,mixer,1349,3249,1900,1,00148,India
819368,2023-09-06,506,monitor,3249,8000,4751,1,00148,India
819368,2023-09-06,502,iphone 15 pro max,100000,135000,35000,1,00148,India
962186,2023-09-06,501,iphone 15,60000,80000,20000,1,00276,India
962186,2023-09-06,502,iphone 15 pro max,100000,135000,35000,1,00276,India
962186,2023-09-06,503,mixer,1349,3249,1900,1,00276,India
783710,2023-09-06,502,iphone 15 pro max,100000,135000,35000,1,00461,India
783710,2023-09-06,505,oven,18490,24000,5510,1,00461,India
783710,2023-09-06,503,mixer,1349,3249,1900,1,00461,India
783710,2023-09-06,501,iphone 15,60000,80000,20000,1,00461,India
783710,2023-09-06,504,iron,449,879,430,1,00461,India
390031,2023-09-06,507,washing machine,6990,16490,9500,1,00224,India
813224,2023-09-06,506,monitor,3249,8000,4751,1,00120,India
813224,2023-09-06,504,iron,449,879,430,1,00120,India
813224,2023-09-06,501,iphone 15,60000,80000,20000,1,00120,India
813224,2023-09-06,505,oven,18490,24000,5510,1,00120,India
992849,2023-09-06,501,iphone 15,60000,80000,20000,1,00118,India
992849,2023-09-06,502,iphone 15 pro max,100000,135000,35000,1,00118,India
992849,2023-09-06,507,washing machine,6990,16490,9500,1,00118,India
992849,2023-09-06,506,monitor,3249,8000,4751,1,00118,India
992849,2023-09-06,503,mixer,1349,3249,1900,1,00118,India
499182,2023-09-06,504,iron,449,879,430,1,00221,India
499182,2023-09-06,506,monitor,3249,8000,4751,1,00221,India
499182,2023-09-06,505,oven,18490,24000,5510,1,00221,India
499182,2023-09-06,503,mixer,1349,3249,1900,1,00221,India
355492,2023-09-06,505,oven,18490,24000,5510,1,00009,India
355492,2023-09-06,501,iphone 15,60000,80000,20000,1,00009,India
355492,2023-09-06,503,mixer,1349,3249,1900,1,00009,India
401127,2023-09-06,503,mixer,1349,3249,1900,1,00271,India
401127,2023-09-06,504,iron,449,879,430,1,00271,India
401127,2023-09-06,507,washing machine,6990,16490,9500,1,00271,India
627886,2023-09-06,505,oven,18490,24000,5510,1,00272,India
627886,2023-09-06,504,iron,449,879,430,1,00272,India
627886,2023-09-06,506,monitor,3249,8000,4751,1,00272,India
609326,2023-09-06,503,mixer,1349,3249,1900,1,00058,India
420351,2023-09-06,504,iron,449,879,430,1,00212,India
915936,2023-09-06,506,monitor,3249,8000,4751,1,00083,India
915936,2023-09-06,505,oven,18490,24000,5510,1,00083,India
399221,2023-09-06,501,iphone 15,60000,80000,20000,1,00233,India
399221,2023-09-06,504,iron,449,879,430,1,00233,India
399221,2023-09-06,507,washing machine,6990,16490,9500,1,00233,India
559915,2023-09-06,501,iphone 15,60000,80000,20000,1,00326,India
559915,2023-09-06,504,iron,449,879,430,1,00326,India
559915,2023-09-06,506,monitor,3249,8000,4751,1,00326,India
953608,2023-09-06,503,mixer,1349,3249,1900,1,00436,India
953608,2023-09-06,504,iron,449,879,430,1,00436,India
953608,2023-09-06,507,washing machine,6990,16490,9500,1,00436,India
953608,2023-09-06,506,monitor,3249,8000,4751,1,00436,India
262250,2023-09-06,503,mixer,1349,3249,1900,1,00195,India
262250,2023-09-06,507,washing machine,6990,16490,9500,1,00195,India
370995,2023-09-06,506,monitor,3249,8000,4751,1,00139,India
370995,2023-09-06,501,iphone 15,60000,80000,20000,1,00139,India
712586,2023-09-06,501,iphone 15,60000,80000,20000,1,00467,India
712586,2023-09-06,502,iphone 15 pro max,100000,135000,35000,1,00467,India
712586,2023-09-06,503,mixer,1349,3249,1900,1,00467,India
319093,2023-09-06,501,iphone 15,60000,80000,20000,1,00055,India
988151,2023-09-06,502,iphone 15 pro max,100000,135000,35000,1,00278,India
988151,2023-09-06,507,washing machine,6990,16490,9500,1,00278,India
988151,2023-09-06,501,iphone 15,60000,80000,20000,1,00278,India
397437,2023-09-06,504,iron,449,879,430,1,00288,India
397437,2023-09-06,503,mixer,1349,3249,1900,1,00288,India
397437,2023-09-06,501,iphone 15,60000,80000,20000,1,00288,India
397437,2023-09-06,507,washing machine,6990,16490,9500,1,00288,India
402238,2023-09-06,504,iron,449,879,430,1,00210,India
402238,2023-09-06,507,washing machine,6990,16490,9500,1,00210,India
402238,2023-09-06,506,monitor,3249,8000,4751,1,00210,India
876431,2023-09-06,505,oven,18490,24000,5510,1,00415,India
876431,2023-09-06,506,monitor,3249,8000,4751,1,00415,India
876431,2023-09-06,507,washing machine,6990,16490,9500,1,00415,India
895603,2023-09-06,503,mixer,1349,3249,1900,1,00254,India
872246,2023-09-06,504,iron,449,879,430,1,00094,India
872246,2023-09-06,505,oven,18490,24000,5510,1,00094,India
872246,2023-09-06,501,iphone 15,60000,80000,20000,1,00094,India
938788,2023-09-06,502,iphone 15 pro max,100000,135000,35000,1,00096,India
938788,2023-09-06,505,oven,18490,24000,5510,1,00096,India
466391,2023-09-06,505,oven,18490,24000,5510,1,00137,India
466391,2023-09-06,501,iphone 15,60000,80000,20000,1,00137,India
466391,2023-09-06,507,washing machine,6990,16490,9500,1,00137,India
466391,2023-09-06,506,monitor,3249,8000,4751,1,00137,India
529050,2023-09-06,504,iron,449,879,430,1,00415,India
529050,2023-09-06,506,monitor,3249,8000,4751,1,00415,India
529050,2023-09-06,507,washing machine,6990,16490,9500,1,00415,India
988284,2023-09-06,503,mixer,1349,3249,1900,1,00302,India
988284,2023-09-06,502,iphone 15 pro max,100000,135000,35000,1,00302,India
602609,2023-09-06,504,iron,449,879,430,1,00242,India
121852,2023-09-06,504,iron,449,879,430,1,00411,India
121852,2023-09-06,507,washing machine,6990,16490,9500,1,00411,India
167221,2023-09-06,504,iron,449,879,430,1,00124,India
167221,2023-09-06,505,oven,18490,24000,5510,1,00124,India
526362,2023-09-06,505,oven,18490,24000,5510,1,00369,India
526362,2023-09-06,507,washing machine,6990,16490,9500,1,00369,India
526362,2023-09-06,504,iron,449,879,430,1,00369,India
526362,2023-09-06,503,mixer,1349,3249,1900,1,00369,India
187982,2023-09-06,507,washing machine,6990,16490,9500,1,00014,India
187982,2023-09-06,502,iphone 15 pro max,100000,135000,35000,1,00014,India
187982,2023-09-06,505,oven,18490,24000,5510,1,00014,India
929657,2023-09-06,501,iphone 15,60000,80000,20000,1,00330,India
929657,2023-09-06,505,oven,18490,24000,5510,1,00330,India
929657,2023-09-06,502,iphone 15 pro max,100000,135000,35000,1,00330,India
929657,2023-09-06,503,mixer,1349,3249,1900,1,00330,India
547692,2023-09-06,501,iphone 15,60000,80000,20000,1,00245,India
297992,2023-09-06,502,iphone 15 pro max,100000,135000,35000,1,00162,India
297992,2023-09-06,506,monitor,3249,8000,4751,1,00162,India
842705,2023-09-06,507,washing machine,6990,16490,9500,1,00074,India
842705,2023-09-06,502,iphone 15 pro max,100000,135000,35000,1,00074,India
842705,2023-09-06,501,iphone 15,60000,80000,20000,1,00074,India
842705,2023-09-06,504,iron,449,879,430,1,00074,India
626675,2023-09-07,507,washing machine,6990,16490,9500,1,00007,India
626675,2023-09-07,505,oven,18490,24000,5510,1,00007,India
626675,2023-09-07,502,iphone 15 pro max,100000,135000,35000,1,00007,India
626675,2023-09-07,504,iron,449,879,430,1,00007,India
652203,2023-09-07,505,oven,18490,24000,5510,1,00040,India
652203,2023-09-07,506,monitor,3249,8000,4751,1,00040,India
652203,2023-09-07,507,washing machine,6990,16490,9500,1,00040,India
285150,2023-09-07,507,washing machine,6990,16490,9500,1,00129,India
285150,2023-09-07,505,oven,18490,24000,5510,1,00129,India
285150,2023-09-07,503,mixer,1349,3249,1900,1,00129,India
528558,2023-09-07,502,iphone 15 pro max,100000,135000,35000,1,00386,India
448948,2023-09-07,505,oven,18490,24000,5510,1,00175,India
448948,2023-09-07,504,iron,449,879,430,1,00175,India
448948,2023-09-07,502,iphone 15 pro max,100000,135000,35000,1,00175,India
448948,2023-09-07,501,iphone 15,60000,80000,20000,1,00175,India
825937,2023-09-07,501,iphone 15,60000,80000,20000,1,00298,India
825937,2023-09-07,507,washing machine,6990,16490,9500,1,00298,India
825937,2023-09-07,503,mixer,1349,3249,1900,1,00298,India
270815,2023-09-07,504,iron,449,879,430,1,00298,India
270815,2023-09-07,502,iphone 15 pro max,100000,135000,35000,1,00298,India
270815,2023-09-07,503,mixer,1349,3249,1900,1,00298,India
270815,2023-09-07,507,washing machine,6990,16490,9500,1,00298,India
270815,2023-09-07,506,monitor,3249,8000,4751,1,00298,India
869687,2023-09-07,503,mixer,1349,3249,1900,1,00186,India
869687,2023-09-07,506,monitor,3249,8000,4751,1,00186,India
177952,2023-09-07,502,iphone 15 pro max,100000,135000,35000,1,00393,India
177952,2023-09-07,506,monitor,3249,8000,4751,1,00393,India
177952,2023-09-07,503,mixer,1349,3249,1900,1,00393,India
177952,2023-09-07,507,washing machine,6990,16490,9500,1,00393,India
177952,2023-09-07,504,iron,449,879,430,1,00393,India
614616,2023-09-07,504,iron,449,879,430,1,00396,India
614616,2023-09-07,505,oven,18490,24000,5510,1,00396,India
576032,2023-09-07,505,oven,18490,24000,5510,1,00088,India
576032,2023-09-07,501,iphone 15,60000,80000,20000,1,00088,India
576032,2023-09-07,507,washing machine,6990,16490,9500,1,00088,India
680765,2023-09-07,506,monitor,3249,8000,4751,1,00223,India
680765,2023-09-07,502,iphone 15 pro max,100000,135000,35000,1,00223,India
680765,2023-09-07,503,mixer,1349,3249,1900,1,00223,India
429016,2023-09-07,504,iron,449,879,430,1,00470,India
429016,2023-09-07,501,iphone 15,60000,80000,20000,1,00470,India
245596,2023-09-07,502,iphone 15 pro max,100000,135000,35000,1,00307,India
180358,2023-09-07,501,iphone 15,60000,80000,20000,1,00474,India
318147,2023-09-07,502,iphone 15 pro max,100000,135000,35000,1,00123,India
318147,2023-09-07,507,washing machine,6990,16490,9500,1,00123,India
318147,2023-09-07,505,oven,18490,24000,5510,1,00123,India
318147,2023-09-07,504,iron,449,879,430,1,00123,India
777536,2023-09-07,502,iphone 15 pro max,100000,135000,35000,1,00305,India
777536,2023-09-07,507,washing machine,6990,16490,9500,1,00305,India
777536,2023-09-07,501,iphone 15,60000,80000,20000,1,00305,India
480459,2023-09-07,505,oven,18490,24000,5510,1,00088,India
480459,2023-09-07,504,iron,449,879,430,1,00088,India
480459,2023-09-07,502,iphone 15 pro max,100000,135000,35000,1,00088,India
480459,2023-09-07,506,monitor,3249,8000,4751,1,00088,India
234194,2023-09-07,507,washing machine,6990,16490,9500,1,00057,India
234194,2023-09-07,502,iphone 15 pro max,100000,135000,35000,1,00057,India
234194,2023-09-07,504,iron,449,879,430,1,00057,India
567843,2023-09-07,504,iron,449,879,430,1,00272,India
567843,2023-09-07,502,iphone 15 pro max,100000,135000,35000,1,00272,India
567843,2023-09-07,503,mixer,1349,3249,1900,1,00272,India
567843,2023-09-07,501,iphone 15,60000,80000,20000,1,00272,India
375050,2023-09-07,505,oven,18490,24000,5510,1,00265,India
375050,2023-09-07,503,mixer,1349,3249,1900,1,00265,India
375050,2023-09-07,502,iphone 15 pro max,100000,135000,35000,1,00265,India
110966,2023-09-07,503,mixer,1349,3249,1900,1,00416,India
110966,2023-09-07,504,iron,449,879,430,1,00416,India
110966,2023-09-07,501,iphone 15,60000,80000,20000,1,00416,India
673523,2023-09-07,502,iphone 15 pro max,100000,135000,35000,1,00243,India
673523,2023-09-07,505,oven,18490,24000,5510,1,00243,India
745616,2023-09-07,502,iphone 15 pro max,100000,135000,35000,1,00476,India
745616,2023-09-07,503,mixer,1349,3249,1900,1,00476,India
745616,2023-09-07,507,washing machine,6990,16490,9500,1,00476,India
901575,2023-09-07,502,iphone 15 pro max,100000,135000,35000,1,00497,India
901575,2023-09-07,507,washing machine,6990,16490,9500,1,00497,India
651030,2023-09-07,505,oven,18490,24000,5510,1,00157,India
651030,2023-09-07,507,washing machine,6990,16490,9500,1,00157,India
651030,2023-09-07,501,iphone 15,60000,80000,20000,1,00157,India
924089,2023-09-07,504,iron,449,879,430,1,00343,India
924089,2023-09-07,502,iphone 15 pro max,100000,135000,35000,1,00343,India
924089,2023-09-07,503,mixer,1349,3249,1900,1,00343,India
687283,2023-09-07,503,mixer,1349,3249,1900,1,00403,India
708203,2023-09-07,507,washing machine,6990,16490,9500,1,00361,India
708203,2023-09-07,501,iphone 15,60000,80000,20000,1,00361,India
708203,2023-09-07,503,mixer,1349,3249,1900,1,00361,India
708203,2023-09-07,504,iron,449,879,430,1,00361,India
955928,2023-09-07,503,mixer,1349,3249,1900,1,00052,India
955928,2023-09-07,507,washing machine,6990,16490,9500,1,00052,India
955928,2023-09-07,506,monitor,3249,8000,4751,1,00052,India
955928,2023-09-07,502,iphone 15 pro max,100000,135000,35000,1,00052,India
984964,2023-09-07,502,iphone 15 pro max,100000,135000,35000,1,00017,India
915433,2023-09-07,507,washing machine,6990,16490,9500,1,00198,India
915433,2023-09-07,503,mixer,1349,3249,1900,1,00198,India
915433,2023-09-07,504,iron,449,879,430,1,00198,India
261883,2023-09-07,504,iron,449,879,430,1,00460,India
261883,2023-09-07,507,washing machine,6990,16490,9500,1,00460,India
584917,2023-09-07,504,iron,449,879,430,1,00067,India
591698,2023-09-07,502,iphone 15 pro max,100000,135000,35000,1,00274,India
591698,2023-09-07,501,iphone 15,60000,80000,20000,1,00274,India
591698,2023-09-07,505,oven,18490,24000,5510,1,00274,India
591698,2023-09-07,507,washing machine,6990,16490,9500,1,00274,India
405273,2023-09-07,506,monitor,3249,8000,4751,1,00375,India
405273,2023-09-07,501,iphone 15,60000,80000,20000,1,00375,India
405273,2023-09-07,507,washing machine,6990,16490,9500,1,00375,India
915718,2023-09-07,506,monitor,3249,8000,4751,1,00096,India
915718,2023-09-07,505,oven,18490,24000,5510,1,00096,India
106686,2023-09-07,505,oven,18490,24000,5510,1,00075,India
106686,2023-09-07,502,iphone 15 pro max,100000,135000,35000,1,00075,India
106686,2023-09-07,503,mixer,1349,3249,1900,1,00075,India
232881,2023-09-07,505,oven,18490,24000,5510,1,00256,India
232881,2023-09-07,506,monitor,3249,8000,4751,1,00256,India
943573,2023-09-07,501,iphone 15,60000,80000,20000,1,00444,India
501704,2023-09-07,503,mixer,1349,3249,1900,1,00099,India
501704,2023-09-07,505,oven,18490,24000,5510,1,00099,India
501704,2023-09-07,501,iphone 15,60000,80000,20000,1,00099,India
511753,2023-09-07,506,monitor,3249,8000,4751,1,00403,India
511753,2023-09-07,505,oven,18490,24000,5510,1,00403,India
511753,2023-09-07,501,iphone 15,60000,80000,20000,1,00403,India
773568,2023-09-07,505,oven,18490,24000,5510,1,00064,India
773568,2023-09-07,506,monitor,3249,8000,4751,1,00064,India
366943,2023-09-07,506,monitor,3249,8000,4751,1,00151,India
903632,2023-09-07,504,iron,449,879,430,1,00196,India
903632,2023-09-07,507,washing machine,6990,16490,9500,1,00196,India
903632,2023-09-07,501,iphone 15,60000,80000,20000,1,00196,India
842832,2023-09-07,506,monitor,3249,8000,4751,1,00262,India
842832,2023-09-07,504,iron,449,879,430,1,00262,India
132243,2023-09-07,507,washing machine,6990,16490,9500,1,00019,India
921746,2023-09-07,502,iphone 15 pro max,100000,135000,35000,1,00202,India
921746,2023-09-07,507,washing machine,6990,16490,9500,1,00202,India
224106,2023-09-07,505,oven,18490,24000,5510,1,00389,India
108399,2023-09-07,506,monitor,3249,8000,4751,1,00053,India
108399,2023-09-07,503,mixer,1349,3249,1900,1,00053,India
108399,2023-09-07,507,washing machine,6990,16490,9500,1,00053,India
108399,2023-09-07,501,iphone 15,60000,80000,20000,1,00053,India
123552,2023-09-07,504,iron,449,879,430,1,00080,India
123552,2023-09-07,502,iphone 15 pro max,100000,135000,35000,1,00080,India
653885,2023-09-07,506,monitor,3249,8000,4751,1,00306,India
653885,2023-09-07,504,iron,449,879,430,1,00306,India
653885,2023-09-07,502,iphone 15 pro max,100000,135000,35000,1,00306,India
397463,2023-09-07,502,iphone 15 pro max,100000,135000,35000,1,00194,India
397463,2023-09-07,507,washing machine,6990,16490,9500,1,00194,India
567205,2023-09-07,506,monitor,3249,8000,4751,1,00155,India
567205,2023-09-07,503,mixer,1349,3249,1900,1,00155,India
567205,2023-09-07,505,oven,18490,24000,5510,1,00155,India
545374,2023-09-07,505,oven,18490,24000,5510,1,00307,India
545374,2023-09-07,507,washing machine,6990,16490,9500,1,00307,India
743704,2023-09-07,507,washing machine,6990,16490,9500,1,00023,India
743704,2023-09-07,506,monitor,3249,8000,4751,1,00023,India
743704,2023-09-07,503,mixer,1349,3249,1900,1,00023,India
743704,2023-09-07,501,iphone 15,60000,80000,20000,1,00023,India
736890,2023-09-07,507,washing machine,6990,16490,9500,1,00120,India
736890,2023-09-07,502,iphone 15 pro max,100000,135000,35000,1,00120,India
596489,2023-09-07,506,monitor,3249,8000,4751,1,00411,India
906310,2023-09-07,501,iphone 15,60000,80000,20000,1,00382,India
906310,2023-09-07,504,iron,449,879,430,1,00382,India
906310,2023-09-07,506,monitor,3249,8000,4751,1,00382,India
808892,2023-09-07,507,washing machine,6990,16490,9500,1,00453,India
317785,2023-09-07,501,iphone 15,60000,80000,20000,1,00358,India
331438,2023-09-07,503,mixer,1349,3249,1900,1,00420,India
331438,2023-09-07,507,washing machine,6990,16490,9500,1,00420,India
679932,2023-09-07,504,iron,449,879,430,1,00159,India
679932,2023-09-07,505,oven,18490,24000,5510,1,00159,India
679932,2023-09-07,503,mixer,1349,3249,1900,1,00159,India
245058,2023-09-07,507,washing machine,6990,16490,9500,1,00475,India
245058,2023-09-07,502,iphone 15 pro max,100000,135000,35000,1,00475,India
876479,2023-09-07,504,iron,449,879,430,1,00240,India
876479,2023-09-07,507,washing machine,6990,16490,9500,1,00240,India
876479,2023-09-07,506,monitor,3249,8000,4751,1,00240,India
114955,2023-09-07,505,oven,18490,24000,5510,1,00033,India
781907,2023-09-07,501,iphone 15,60000,80000,20000,1,00271,India
781907,2023-09-07,505,oven,18490,24000,5510,1,00271,India
781907,2023-09-07,502,iphone 15 pro max,100000,135000,35000,1,00271,India
120391,2023-09-07,505,oven,18490,24000,5510,1,00159,India
120391,2023-09-07,506,monitor,3249,8000,4751,1,00159,India
711206,2023-09-07,506,monitor,3249,8000,4751,1,00359,India
711206,2023-09-07,502,iphone 15 pro max,100000,135000,35000,1,00359,India
711206,2023-09-07,503,mixer,1349,3249,1900,1,00359,India
511929,2023-09-07,501,iphone 15,60000,80000,20000,1,00253,India
511929,2023-09-07,503,mixer,1349,3249,1900,1,00253,India
511929,2023-09-07,507,washing machine,6990,16490,9500,1,00253,India
530024,2023-09-07,507,washing machine,6990,16490,9500,1,00422,India
530024,2023-09-07,503,mixer,1349,3249,1900,1,00422,India
160226,2023-09-07,502,iphone 15 pro max,100000,135000,35000,1,00096,India
160226,2023-09-07,503,mixer,1349,3249,1900,1,00096,India
160226,2023-09-07,507,washing machine,6990,16490,9500,1,00096,India
160226,2023-09-07,505,oven,18490,24000,5510,1,00096,India
952608,2023-09-07,506,monitor,3249,8000,4751,1,00268,India
952608,2023-09-07,507,washing machine,6990,16490,9500,1,00268,India
952608,2023-09-07,505,oven,18490,24000,5510,1,00268,India
527846,2023-09-07,507,washing machine,6990,16490,9500,1,00287,India
181790,2023-09-07,504,iron,449,879,430,1,00175,India
837046,2023-09-07,502,iphone 15 pro max,100000,135000,35000,1,00367,India
837046,2023-09-07,506,monitor,3249,8000,4751,1,00367,India
550922,2023-09-07,505,oven,18490,24000,5510,1,00322,India
550922,2023-09-07,502,iphone 15 pro max,100000,135000,35000,1,00322,India
550922,2023-09-07,506,monitor,3249,8000,4751,1,00322,India
830942,2023-09-07,503,mixer,1349,3249,1900,1,00466,India
830942,2023-09-07,507,washing machine,6990,16490,9500,1,00466,India
830942,2023-09-07,506,monitor,3249,8000,4751,1,00466,India
719885,2023-09-07,506,monitor,3249,8000,4751,1,00124,India
719885,2023-09-07,505,oven,18490,24000,5510,1,00124,India
719885,2023-09-07,502,iphone 15 pro max,100000,135000,35000,1,00124,India
546234,2023-09-07,504,iron,449,879,430,1,00101,India
705909,2023-09-08,504,iron,449,879,430,1,00408,India
705909,2023-09-08,505,oven,18490,24000,5510,1,00408,India
705909,2023-09-08,507,washing machine,6990,16490,9500,1,00408,India
519964,2023-09-08,502,iphone 15 pro max,100000,135000,35000,1,00156,India
519964,2023-09-08,504,iron,449,879,430,1,00156,India
519964,2023-09-08,505,oven,18490,24000,5510,1,00156,India
466082,2023-09-08,505,oven,18490,24000,5510,1,00257,India
416608,2023-09-08,506,monitor,3249,8000,4751,1,00429,India
416608,2023-09-08,501,iphone 15,60000,80000,20000,1,00429,India
416608,2023-09-08,502,iphone 15 pro max,100000,135000,35000,1,00429,India
416608,2023-09-08,503,mixer,1349,3249,1900,1,00429,India
828348,2023-09-08,505,oven,18490,24000,5510,1,00035,India
727320,2023-09-08,505,oven,18490,24000,5510,1,00223,India
727320,2023-09-08,504,iron,449,879,430,1,00223,India
727320,2023-09-08,502,iphone 15 pro max,100000,135000,35000,1,00223,India
820448,2023-09-08,507,washing machine,6990,16490,9500,1,00012,India
594942,2023-09-08,501,iphone 15,60000,80000,20000,1,00208,India
594942,2023-09-08,503,mixer,1349,3249,1900,1,00208,India
736988,2023-09-08,502,iphone 15 pro max,100000,135000,35000,1,00313,India
736988,2023-09-08,503,mixer,1349,3249,1900,1,00313,India
736988,2023-09-08,501,iphone 15,60000,80000,20000,1,00313,India
736988,2023-09-08,505,oven,18490,24000,5510,1,00313,India
320594,2023-09-08,503,mixer,1349,3249,1900,1,00255,India
320594,2023-09-08,502,iphone 15 pro max,100000,135000,35000,1,00255,India
320594,2023-09-08,504,iron,449,879,430,1,00255,India
949154,2023-09-08,503,mixer,1349,3249,1900,1,00466,India
681130,2023-09-08,501,iphone 15,60000,80000,20000,1,00328,India
681130,2023-09-08,502,iphone 15 pro max,100000,135000,35000,1,00328,India
681130,2023-09-08,504,iron,449,879,430,1,00328,India
681130,2023-09-08,503,mixer,1349,3249,1900,1,00328,India
700102,2023-09-08,506,monitor,3249,8000,4751,1,00332,India
700102,2023-09-08,507,washing machine,6990,16490,9500,1,00332,India
700102,2023-09-08,503,mixer,1349,3249,1900,1,00332,India
700102,2023-09-08,501,iphone 15,60000,80000,20000,1,00332,India
313413,2023-09-08,502,iphone 15 pro max,100000,135000,35000,1,00062,India
313413,2023-09-08,506,monitor,3249,8000,4751,1,00062,India
313413,2023-09-08,507,washing machine,6990,16490,9500,1,00062,India
313413,2023-09-08,501,iphone 15,60000,80000,20000,1,00062,India
873534,2023-09-08,503,mixer,1349,3249,1900,1,00164,India
873534,2023-09-08,507,washing machine,6990,16490,9500,1,00164,India
559208,2023-09-08,505,oven,18490,24000,5510,1,00055,India
559208,2023-09-08,501,iphone 15,60000,80000,20000,1,00055,India
595863,2023-09-08,505,oven,18490,24000,5510,1,00260,India
595863,2023-09-08,504,iron,449,879,430,1,00260,India
753425,2023-09-08,506,monitor,3249,8000,4751,1,00152,India
753425,2023-09-08,501,iphone 15,60000,80000,20000,1,00152,India
934937,2023-09-08,502,iphone 15 pro max,100000,135000,35000,1,00374,India
934937,2023-09-08,503,mixer,1349,3249,1900,1,00374,India
934937,2023-09-08,504,iron,449,879,430,1,00374,India
934937,2023-09-08,507,washing machine,6990,16490,9500,1,00374,India
500677,2023-09-08,504,iron,449,879,430,1,00238,India
500677,2023-09-08,501,iphone 15,60000,80000,20000,1,00238,India
500677,2023-09-08,505,oven,18490,24000,5510,1,00238,India
500677,2023-09-08,507,washing machine,6990,16490,9500,1,00238,India
697348,2023-09-08,504,iron,449,879,430,1,00390,India
697348,2023-09-08,501,iphone 15,60000,80000,20000,1,00390,India
697348,2023-09-08,503,mixer,1349,3249,1900,1,00390,India
697348,2023-09-08,506,monitor,3249,8000,4751,1,00390,India
231244,2023-09-08,502,iphone 15 pro max,100000,135000,35000,1,00353,India
231244,2023-09-08,503,mixer,1349,3249,1900,1,00353,India
231244,2023-09-08,507,washing machine,6990,16490,9500,1,00353,India
810491,2023-09-08,506,monitor,3249,8000,4751,1,00369,India
810491,2023-09-08,502,iphone 15 pro max,100000,135000,35000,1,00369,India
810491,2023-09-08,505,oven,18490,24000,5510,1,00369,India
810491,2023-09-08,507,washing machine,6990,16490,9500,1,00369,India
325958,2023-09-08,503,mixer,1349,3249,1900,1,00413,India
325958,2023-09-08,501,iphone 15,60000,80000,20000,1,00413,India
325958,2023-09-08,506,monitor,3249,8000,4751,1,00413,India
442087,2023-09-08,506,monitor,3249,8000,4751,1,00131,India
442087,2023-09-08,504,iron,449,879,430,1,00131,India
442087,2023-09-08,507,washing machine,6990,16490,9500,1,00131,India
442087,2023-09-08,502,iphone 15 pro max,100000,135000,35000,1,00131,India
170225,2023-09-08,507,washing machine,6990,16490,9500,1,00452,India
341962,2023-09-08,505,oven,18490,24000,5510,1,00280,India
899788,2023-09-08,502,iphone 15 pro max,100000,135000,35000,1,00299,India
899788,2023-09-08,505,oven,18490,24000,5510,1,00299,India
899788,2023-09-08,501,iphone 15,60000,80000,20000,1,00299,India
899788,2023-09-08,503,mixer,1349,3249,1900,1,00299,India
838674,2023-09-08,502,iphone 15 pro max,100000,135000,35000,1,00006,India
838674,2023-09-08,501,iphone 15,60000,80000,20000,1,00006,India
838674,2023-09-08,505,oven,18490,24000,5510,1,00006,India
838674,2023-09-08,506,monitor,3249,8000,4751,1,00006,India
698893,2023-09-08,502,iphone 15 pro max,100000,135000,35000,1,00225,India
441188,2023-09-08,505,oven,18490,24000,5510,1,00340,India
441188,2023-09-08,502,iphone 15 pro max,100000,135000,35000,1,00340,India
380137,2023-09-08,502,iphone 15 pro max,100000,135000,35000,1,00269,India
380137,2023-09-08,507,washing machine,6990,16490,9500,1,00269,India
820592,2023-09-08,507,washing machine,6990,16490,9500,1,00366,India
820592,2023-09-08,503,mixer,1349,3249,1900,1,00366,India
820592,2023-09-08,505,oven,18490,24000,5510,1,00366,India
820592,2023-09-08,501,iphone 15,60000,80000,20000,1,00366,India
820592,2023-09-08,504,iron,449,879,430,1,00366,India
375769,2023-09-08,501,iphone 15,60000,80000,20000,1,00156,India
375769,2023-09-08,507,washing machine,6990,16490,9500,1,00156,India
375769,2023-09-08,503,mixer,1349,3249,1900,1,00156,India
935185,2023-09-08,505,oven,18490,24000,5510,1,00071,India
935185,2023-09-08,507,washing machine,6990,16490,9500,1,00071,India
935185,2023-09-08,502,iphone 15 pro max,100000,135000,35000,1,00071,India
675698,2023-09-08,506,monitor,3249,8000,4751,1,00101,India
675698,2023-09-08,503,mixer,1349,3249,1900,1,00101,India
675698,2023-09-08,504,iron,449,879,430,1,00101,India
675698,2023-09-08,502,iphone 15 pro max,100000,135000,35000,1,00101,India
423242,2023-09-08,501,iphone 15,60000,80000,20000,1,00033,India
423242,2023-09-08,504,iron,449,879,430,1,00033,India
423242,2023-09-08,507,washing machine,6990,16490,9500,1,00033,India
264580,2023-09-08,502,iphone 15 pro max,100000,135000,35000,1,00249,India
264580,2023-09-08,503,mixer,1349,3249,1900,1,00249,India
810085,2023-09-08,505,oven,18490,24000,5510,1,00409,India
810085,2023-09-08,504,iron,449,879,430,1,00409,India
810085,2023-09-08,503,mixer,1349,3249,1900,1,00409,India
454165,2023-09-08,502,iphone 15 pro max,100000,135000,35000,1,00257,India
454165,2023-09-08,507,washing machine,6990,16490,9500,1,00257,India
725318,2023-09-08,506,monitor,3249,8000,4751,1,00282,India
261780,2023-09-08,501,iphone 15,60000,80000,20000,1,00141,India
261780,2023-09-08,506,monitor,3249,8000,4751,1,00141,India
261780,2023-09-08,505,oven,18490,24000,5510,1,00141,India
271612,2023-09-08,506,monitor,3249,8000,4751,1,00494,India
271612,2023-09-08,504,iron,449,879,430,1,00494,India
271612,2023-09-08,502,iphone 15 pro max,100000,135000,35000,1,00494,India
766670,2023-09-08,505,oven,18490,24000,5510,1,00297,India
766670,2023-09-08,503,mixer,1349,3249,1900,1,00297,India
492169,2023-09-08,502,iphone 15 pro max,100000,135000,35000,1,00363,India
492169,2023-09-08,506,monitor,3249,8000,4751,1,00363,India
667020,2023-09-08,503,mixer,1349,3249,1900,1,00489,India
667020,2023-09-08,501,iphone 15,60000,80000,20000,1,00489,India
640362,2023-09-08,502,iphone 15 pro max,100000,135000,35000,1,00277,India
640362,2023-09-08,503,mixer,1349,3249,1900,1,00277,India
684688,2023-09-08,504,iron,449,879,430,1,00107,India
962858,2023-09-08,507,washing machine,6990,16490,9500,1,00260,India
226367,2023-09-08,506,monitor,3249,8000,4751,1,00483,India
226367,2023-09-08,507,washing machine,6990,16490,9500,1,00483,India
226367,2023-09-08,502,iphone 15 pro max,100000,135000,35000,1,00483,India
226367,2023-09-08,505,oven,18490,24000,5510,1,00483,India
482448,2023-09-08,507,washing machine,6990,16490,9500,1,00177,India
482448,2023-09-08,506,monitor,3249,8000,4751,1,00177,India
482448,2023-09-08,503,mixer,1349,3249,1900,1,00177,India
801552,2023-09-08,501,iphone 15,60000,80000,20000,1,00130,India
801552,2023-09-08,502,iphone 15 pro max,100000,135000,35000,1,00130,India
801552,2023-09-08,507,washing machine,6990,16490,9500,1,00130,India
801552,2023-09-08,503,mixer,1349,3249,1900,1,00130,India
468285,2023-09-08,506,monitor,3249,8000,4751,1,00420,India
468285,2023-09-08,502,iphone 15 pro max,100000,135000,35000,1,00420,India
468285,2023-09-08,507,washing machine,6990,16490,9500,1,00420,India
987958,2023-09-08,507,washing machine,6990,16490,9500,1,00327,India
824426,2023-09-08,502,iphone 15 pro max,100000,135000,35000,1,00314,India
958322,2023-09-08,502,iphone 15 pro max,100000,135000,35000,1,00450,India
958322,2023-09-08,506,monitor,3249,8000,4751,1,00450,India
958322,2023-09-08,503,mixer,1349,3249,1900,1,00450,India
666497,2023-09-08,505,oven,18490,24000,5510,1,00117,India
666497,2023-09-08,507,washing machine,6990,16490,9500,1,00117,India
608358,2023-09-08,506,monitor,3249,8000,4751,1,00343,India
608358,2023-09-08,504,iron,449,879,430,1,00343,India
608358,2023-09-08,502,iphone 15 pro max,100000,135000,35000,1,00343,India
757396,2023-09-08,504,iron,449,879,430,1,00429,India
757396,2023-09-08,501,iphone 15,60000,80000,20000,1,00429,India
665474,2023-09-08,501,iphone 15,60000,80000,20000,1,00384,India
665474,2023-09-08,507,washing machine,6990,16490,9500,1,00384,India
665474,2023-09-08,502,iphone 15 pro max,100000,135000,35000,1,00384,India
518579,2023-09-08,503,mixer,1349,3249,1900,1,00102,India
207287,2023-09-08,501,iphone 15,60000,80000,20000,1,00269,India
207287,2023-09-08,504,iron,449,879,430,1,00269,India
207287,2023-09-08,502,iphone 15 pro max,100000,135000,35000,1,00269,India
200885,2023-09-08,501,iphone 15,60000,80000,20000,1,00385,India
200885,2023-09-08,503,mixer,1349,3249,1900,1,00385,India
200885,2023-09-08,504,iron,449,879,430,1,00385,India
200885,2023-09-08,506,monitor,3249,8000,4751,1,00385,India
735268,2023-09-08,502,iphone 15 pro max,100000,135000,35000,1,00424,India
735268,2023-09-08,507,washing machine,6990,16490,9500,1,00424,India
735268,2023-09-08,503,mixer,1349,3249,1900,1,00424,India
878752,2023-09-08,503,mixer,1349,3249,1900,1,00495,India
878752,2023-09-08,507,washing machine,6990,16490,9500,1,00495,India
878752,2023-09-08,501,iphone 15,60000,80000,20000,1,00495,India
878752,2023-09-08,505,oven,18490,24000,5510,1,00495,India
878752,2023-09-08,502,iphone 15 pro max,100000,135000,35000,1,00495,India
219627,2023-09-08,505,oven,18490,24000,5510,1,00295,India
219627,2023-09-08,507,washing machine,6990,16490,9500,1,00295,India
219627,2023-09-08,501,iphone 15,60000,80000,20000,1,00295,India
442904,2023-09-08,501,iphone 15,60000,80000,20000,1,00045,India
410120,2023-09-08,507,washing machine,6990,16490,9500,1,00232,India
410120,2023-09-08,505,oven,18490,24000,5510,1,00232,India
410120,2023-09-08,501,iphone 15,60000,80000,20000,1,00232,India
396356,2023-09-08,503,mixer,1349,3249,1900,1,00287,India
396356,2023-09-08,501,iphone 15,60000,80000,20000,1,00287,India
497091,2023-09-08,502,iphone 15 pro max,100000,135000,35000,1,00261,India
497091,2023-09-08,505,oven,18490,24000,5510,1,00261,India
353130,2023-09-08,503,mixer,1349,3249,1900,1,00290,India
353130,2023-09-08,502,iphone 15 pro max,100000,135000,35000,1,00290,India
353130,2023-09-08,505,oven,18490,24000,5510,1,00290,India
923864,2023-09-08,506,monitor,3249,8000,4751,1,00268,India
923864,2023-09-08,505,oven,18490,24000,5510,1,00268,India
923864,2023-09-08,507,washing machine,6990,16490,9500,1,00268,India
532372,2023-09-08,507,washing machine,6990,16490,9500,1,00423,India
907059,2023-09-08,505,oven,18490,24000,5510,1,00210,India
907059,2023-09-08,507,washing machine,6990,16490,9500,1,00210,India
907059,2023-09-08,503,mixer,1349,3249,1900,1,00210,India
907059,2023-09-08,502,iphone 15 pro max,100000,135000,35000,1,00210,India
720153,2023-09-08,503,mixer,1349,3249,1900,1,00214,India
720153,2023-09-08,505,oven,18490,24000,5510,1,00214,India
720153,2023-09-08,506,monitor,3249,8000,4751,1,00214,India
519810,2023-09-08,503,mixer,1349,3249,1900,1,00195,India
519810,2023-09-08,504,iron,449,879,430,1,00195,India
519810,2023-09-08,506,monitor,3249,8000,4751,1,00195,India
519810,2023-09-08,507,washing machine,6990,16490,9500,1,00195,India
519810,2023-09-08,505,oven,18490,24000,5510,1,00195,India
523642,2023-09-08,503,mixer,1349,3249,1900,1,00033,India
523642,2023-09-08,501,iphone 15,60000,80000,20000,1,00033,India
523642,2023-09-08,505,oven,18490,24000,5510,1,00033,India
684009,2023-09-08,505,oven,18490,24000,5510,1,00339,India
684009,2023-09-08,501,iphone 15,60000,80000,20000,1,00339,India
684009,2023-09-08,503,mixer,1349,3249,1900,1,00339,India
822077,2023-09-08,503,mixer,1349,3249,1900,1,00223,India
796838,2023-09-08,507,washing machine,6990,16490,9500,1,00300,India
796838,2023-09-08,501,iphone 15,60000,80000,20000,1,00300,India
328984,2023-09-08,503,mixer,1349,3249,1900,1,00279,India
328984,2023-09-08,505,oven,18490,24000,5510,1,00279,India
328984,2023-09-08,507,washing machine,6990,16490,9500,1,00279,India
301366,2023-09-08,503,mixer,1349,3249,1900,1,00379,India
364200,2023-09-08,505,oven,18490,24000,5510,1,00301,India
364200,2023-09-08,507,washing machine,6990,16490,9500,1,00301,India
364200,2023-09-08,504,iron,449,879,430,1,00301,India
810512,2023-09-08,503,mixer,1349,3249,1900,1,00219,India
810512,2023-09-08,502,iphone 15 pro max,100000,135000,35000,1,00219,India
810512,2023-09-08,507,washing machine,6990,16490,9500,1,00219,India
802596,2023-09-08,502,iphone 15 pro max,100000,135000,35000,1,00389,India
802596,2023-09-08,505,oven,18490,24000,5510,1,00389,India
802596,2023-09-08,503,mixer,1349,3249,1900,1,00389,India
802596,2023-09-08,507,washing machine,6990,16490,9500,1,00389,India
477179,2023-09-08,507,washing machine,6990,16490,9500,1,00296,India
816421,2023-09-08,505,oven,18490,24000,5510,1,00308,India
816421,2023-09-08,507,washing machine,6990,16490,9500,1,00308,India
816421,2023-09-08,501,iphone 15,60000,80000,20000,1,00308,India
100338,2023-09-08,505,oven,18490,24000,5510,1,00301,India
321144,2023-09-08,504,iron,449,879,430,1,00074,India
321144,2023-09-08,506,monitor,3249,8000,4751,1,00074,India
778727,2023-09-08,505,oven,18490,24000,5510,1,00426,India
157812,2023-09-09,507,washing machine,6990,16490,9500,1,00008,India
157812,2023-09-09,503,mixer,1349,3249,1900,1,00008,India
157812,2023-09-09,504,iron,449,879,430,1,00008,India
923839,2023-09-09,507,washing machine,6990,16490,9500,1,00238,India
157056,2023-09-09,501,iphone 15,60000,80000,20000,1,00063,India
157056,2023-09-09,507,washing machine,6990,16490,9500,1,00063,India
635556,2023-09-09,502,iphone 15 pro max,100000,135000,35000,1,00129,India
635556,2023-09-09,503,mixer,1349,3249,1900,1,00129,India
288886,2023-09-09,505,oven,18490,24000,5510,1,00420,India
288886,2023-09-09,507,washing machine,6990,16490,9500,1,00420,India
288886,2023-09-09,501,iphone 15,60000,80000,20000,1,00420,India
233925,2023-09-09,505,oven,18490,24000,5510,1,00346,India
233925,2023-09-09,501,iphone 15,60000,80000,20000,1,00346,India
233925,2023-09-09,502,iphone 15 pro max,100000,135000,35000,1,00346,India
544654,2023-09-09,503,mixer,1349,3249,1900,1,00186,India
544654,2023-09-09,505,oven,18490,24000,5510,1,00186,India
544654,2023-09-09,504,iron,449,879,430,1,00186,India
791420,2023-09-09,501,iphone 15,60000,80000,20000,1,00478,India
791420,2023-09-09,503,mixer,1349,3249,1900,1,00478,India
791420,2023-09-09,505,oven,18490,24000,5510,1,00478,India
626478,2023-09-09,505,oven,18490,24000,5510,1,00369,India
626478,2023-09-09,507,washing machine,6990,16490,9500,1,00369,India
626478,2023-09-09,506,monitor,3249,8000,4751,1,00369,India
626478,2023-09-09,501,iphone 15,60000,80000,20000,1,00369,India
577163,2023-09-09,502,iphone 15 pro max,100000,135000,35000,1,00145,India
577163,2023-09-09,501,iphone 15,60000,80000,20000,1,00145,India
577163,2023-09-09,505,oven,18490,24000,5510,1,00145,India
863012,2023-09-09,506,monitor,3249,8000,4751,1,00311,India
863012,2023-09-09,503,mixer,1349,3249,1900,1,00311,India
863012,2023-09-09,507,washing machine,6990,16490,9500,1,00311,India
863012,2023-09-09,502,iphone 15 pro max,100000,135000,35000,1,00311,India
728432,2023-09-09,503,mixer,1349,3249,1900,1,00222,India
728432,2023-09-09,502,iphone 15 pro max,100000,135000,35000,1,00222,India
728432,2023-09-09,505,oven,18490,24000,5510,1,00222,India
728432,2023-09-09,504,iron,449,879,430,1,00222,India
537712,2023-09-09,504,iron,449,879,430,1,00317,India
537712,2023-09-09,502,iphone 15 pro max,100000,135000,35000,1,00317,India
537712,2023-09-09,501,iphone 15,60000,80000,20000,1,00317,India
455653,2023-09-09,503,mixer,1349,3249,1900,1,00387,India
908605,2023-09-09,504,iron,449,879,430,1,00036,India
908605,2023-09-09,502,iphone 15 pro max,100000,135000,35000,1,00036,India
353512,2023-09-09,504,iron,449,879,430,1,00171,India
353512,2023-09-09,506,monitor,3249,8000,4751,1,00171,India
291296,2023-09-09,507,washing machine,6990,16490,9500,1,00304,India
291296,2023-09-09,501,iphone 15,60000,80000,20000,1,00304,India
291296,2023-09-09,506,monitor,3249,8000,4751,1,00304,India
819928,2023-09-09,503,mixer,1349,3249,1900,1,00241,India
819928,2023-09-09,501,iphone 15,60000,80000,20000,1,00241,India
819928,2023-09-09,502,iphone 15 pro max,100000,135000,35000,1,00241,India
615122,2023-09-09,503,mixer,1349,3249,1900,1,00288,India
980650,2023-09-09,506,monitor,3249,8000,4751,1,00258,India
980650,2023-09-09,505,oven,18490,24000,5510,1,00258,India
980650,2023-09-09,502,iphone 15 pro max,100000,135000,35000,1,00258,India
980650,2023-09-09,504,iron,449,879,430,1,00258,India
980650,2023-09-09,507,washing machine,6990,16490,9500,1,00258,India
189220,2023-09-09,501,iphone 15,60000,80000,20000,1,00482,India
189220,2023-09-09,503,mixer,1349,3249,1900,1,00482,India
189220,2023-09-09,504,iron,449,879,430,1,00482,India
189220,2023-09-09,505,oven,18490,24000,5510,1,00482,India
332434,2023-09-09,505,oven,18490,24000,5510,1,00298,India
332434,2023-09-09,503,mixer,1349,3249,1900,1,00298,India
332434,2023-09-09,504,iron,449,879,430,1,00298,India
196921,2023-09-09,507,washing machine,6990,16490,9500,1,00108,India
196921,2023-09-09,501,iphone 15,60000,80000,20000,1,00108,India
196921,2023-09-09,504,iron,449,879,430,1,00108,India
790901,2023-09-09,507,washing machine,6990,16490,9500,1,00044,India
790901,2023-09-09,506,monitor,3249,8000,4751,1,00044,India
790901,2023-09-09,503,mixer,1349,3249,1900,1,00044,India
790901,2023-09-09,501,iphone 15,60000,80000,20000,1,00044,India
790901,2023-09-09,504,iron,449,879,430,1,00044,India
493075,2023-09-09,507,washing machine,6990,16490,9500,1,00300,India
493075,2023-09-09,504,iron,449,879,430,1,00300,India
529755,2023-09-09,504,iron,449,879,430,1,00101,India
529755,2023-09-09,506,monitor,3249,8000,4751,1,00101,India
356773,2023-09-09,501,iphone 15,60000,80000,20000,1,00096,India
356773,2023-09-09,505,oven,18490,24000,5510,1,00096,India
182031,2023-09-09,507,washing machine,6990,16490,9500,1,00332,India
844140,2023-09-09,501,iphone 15,60000,80000,20000,1,00377,India
914512,2023-09-09,505,oven,18490,24000,5510,1,00259,India
914512,2023-09-09,503,mixer,1349,3249,1900,1,00259,India
275513,2023-09-09,504,iron,449,879,430,1,00263,India
275513,2023-09-09,507,washing machine,6990,16490,9500,1,00263,India
275513,2023-09-09,506,monitor,3249,8000,4751,1,00263,India
275513,2023-09-09,502,iphone 15 pro max,100000,135000,35000,1,00263,India
275513,2023-09-09,501,iphone 15,60000,80000,20000,1,00263,India
423673,2023-09-09,503,mixer,1349,3249,1900,1,00155,India
423673,2023-09-09,501,iphone 15,60000,80000,20000,1,00155,India
213948,2023-09-09,505,oven,18490,24000,5510,1,00103,India
213948,2023-09-09,502,iphone 15 pro max,100000,135000,35000,1,00103,India
749260,2023-09-09,501,iphone 15,60000,80000,20000,1,00304,India
749260,2023-09-09,504,iron,449,879,430,1,00304,India
749260,2023-09-09,503,mixer,1349,3249,1900,1,00304,India
749260,2023-09-09,507,washing machine,6990,16490,9500,1,00304,India
748034,2023-09-09,503,mixer,1349,3249,1900,1,00317,India
748034,2023-09-09,501,iphone 15,60000,80000,20000,1,00317,India
748034,2023-09-09,506,monitor,3249,8000,4751,1,00317,India
594970,2023-09-09,507,washing machine,6990,16490,9500,1,00498,India
594970,2023-09-09,501,iphone 15,60000,80000,20000,1,00498,India
402117,2023-09-09,502,iphone 15 pro max,100000,135000,35000,1,00339,India
402117,2023-09-09,503,mixer,1349,3249,1900,1,00339,India
402117,2023-09-09,506,monitor,3249,8000,4751,1,00339,India
327034,2023-09-09,506,monitor,3249,8000,4751,1,00104,India
758986,2023-09-09,503,mixer,1349,3249,1900,1,00307,India
758986,2023-09-09,504,iron,449,879,430,1,00307,India
758986,2023-09-09,505,oven,18490,24000,5510,1,00307,India
758986,2023-09-09,506,monitor,3249,8000,4751,1,00307,India
148917,2023-09-09,505,oven,18490,24000,5510,1,00442,India
148917,2023-09-09,501,iphone 15,60000,80000,20000,1,00442,India
148917,2023-09-09,503,mixer,1349,3249,1900,1,00442,India
148917,2023-09-09,502,iphone 15 pro max,100000,135000,35000,1,00442,India
522026,2023-09-09,503,mixer,1349,3249,1900,1,00295,India
522026,2023-09-09,505,oven,18490,24000,5510,1,00295,India
522026,2023-09-09,506,monitor,3249,8000,4751,1,00295,India
522026,2023-09-09,502,iphone 15 pro max,100000,135000,35000,1,00295,India
479683,2023-09-09,502,iphone 15 pro max,100000,135000,35000,1,00076,India
479683,2023-09-09,506,monitor,3249,8000,4751,1,00076,India
479683,2023-09-09,504,iron,449,879,430,1,00076,India
211901,2023-09-09,504,iron,449,879,430,1,00132,India
211901,2023-09-09,506,monitor,3249,8000,4751,1,00132,India
211901,2023-09-09,507,washing machine,6990,16490,9500,1,00132,India
511266,2023-09-09,503,mixer,1349,3249,1900,1,00473,India
511266,2023-09-09,507,washing machine,6990,16490,9500,1,00473,India
897778,2023-09-09,506,monitor,3249,8000,4751,1,00270,India
897778,2023-09-09,501,iphone 15,60000,80000,20000,1,00270,India
181280,2023-09-09,504,iron,449,879,430,1,00436,India
181280,2023-09-09,503,mixer,1349,3249,1900,1,00436,India
181280,2023-09-09,507,washing machine,6990,16490,9500,1,00436,India
181280,2023-09-09,506,monitor,3249,8000,4751,1,00436,India
169489,2023-09-09,501,iphone 15,60000,80000,20000,1,00407,India
169489,2023-09-09,505,oven,18490,24000,5510,1,00407,India
169489,2023-09-09,507,washing machine,6990,16490,9500,1,00407,India
672528,2023-09-09,502,iphone 15 pro max,100000,135000,35000,1,00448,India
672528,2023-09-09,507,washing machine,6990,16490,9500,1,00448,India
672528,2023-09-09,505,oven,18490,24000,5510,1,00448,India
974200,2023-09-09,503,mixer,1349,3249,1900,1,00014,India
807248,2023-09-09,507,washing machine,6990,16490,9500,1,00056,India
807248,2023-09-09,504,iron,449,879,430,1,00056,India
807248,2023-09-09,501,iphone 15,60000,80000,20000,1,00056,India
462371,2023-09-09,503,mixer,1349,3249,1900,1,00126,India
462371,2023-09-09,505,oven,18490,24000,5510,1,00126,India
462371,2023-09-09,504,iron,449,879,430,1,00126,India
690063,2023-09-09,507,washing machine,6990,16490,9500,1,00268,India
690063,2023-09-09,506,monitor,3249,8000,4751,1,00268,India
888582,2023-09-09,506,monitor,3249,8000,4751,1,00288,India
888582,2023-09-09,504,iron,449,879,430,1,00288,India
888582,2023-09-09,501,iphone 15,60000,80000,20000,1,00288,India
888582,2023-09-09,502,iphone 15 pro max,100000,135000,35000,1,00288,India
888582,2023-09-09,505,oven,18490,24000,5510,1,00288,India
752528,2023-09-09,501,iphone 15,60000,80000,20000,1,00400,India
752528,2023-09-09,504,iron,449,879,430,1,00400,India
752528,2023-09-09,506,monitor,3249,8000,4751,1,00400,India
752528,2023-09-09,503,mixer,1349,3249,1900,1,00400,India
288940,2023-09-09,501,iphone 15,60000,80000,20000,1,00149,India
288940,2023-09-09,502,iphone 15 pro max,100000,135000,35000,1,00149,India
910295,2023-09-09,504,iron,449,879,430,1,00056,India
910295,2023-09-09,506,monitor,3249,8000,4751,1,00056,India
910295,2023-09-09,502,iphone 15 pro max,100000,135000,35000,1,00056,India
109211,2023-09-09,503,mixer,1349,3249,1900,1,00347,India
852285,2023-09-09,501,iphone 15,60000,80000,20000,1,00278,India
852285,2023-09-09,504,iron,449,879,430,1,00278,India
852285,2023-09-09,507,washing machine,6990,16490,9500,1,00278,India
852285,2023-09-09,506,monitor,3249,8000,4751,1,00278,India
454510,2023-09-09,505,oven,18490,24000,5510,1,00193,India
454510,2023-09-09,507,washing machine,6990,16490,9500,1,00193,India
454510,2023-09-09,501,iphone 15,60000,80000,20000,1,00193,India
454510,2023-09-09,504,iron,449,879,430,1,00193,India
469818,2023-09-09,505,oven,18490,24000,5510,1,00301,India
469818,2023-09-09,502,iphone 15 pro max,100000,135000,35000,1,00301,India
436390,2023-09-09,504,iron,449,879,430,1,00201,India
828957,2023-09-09,503,mixer,1349,3249,1900,1,00122,India
828957,2023-09-09,505,oven,18490,24000,5510,1,00122,India
828957,2023-09-09,501,iphone 15,60000,80000,20000,1,00122,India
331288,2023-09-09,503,mixer,1349,3249,1900,1,00082,India
331288,2023-09-09,502,iphone 15 pro max,100000,135000,35000,1,00082,India
331288,2023-09-09,501,iphone 15,60000,80000,20000,1,00082,India
331288,2023-09-09,507,washing machine,6990,16490,9500,1,00082,India
437151,2023-09-09,501,iphone 15,60000,80000,20000,1,00354,India
244411,2023-09-09,503,mixer,1349,3249,1900,1,00164,India
244411,2023-09-09,507,washing machine,6990,16490,9500,1,00164,India
244411,2023-09-09,505,oven,18490,24000,5510,1,00164,India
244411,2023-09-09,504,iron,449,879,430,1,00164,India
416764,2023-09-09,501,iphone 15,60000,80000,20000,1,00030,India
416764,2023-09-09,505,oven,18490,24000,5510,1,00030,India
416764,2023-09-09,506,monitor,3249,8000,4751,1,00030,India
964529,2023-09-09,505,oven,18490,24000,5510,1,00077,India
964529,2023-09-09,503,mixer,1349,3249,1900,1,00077,India
410222,2023-09-09,501,iphone 15,60000,80000,20000,1,00330,India
410222,2023-09-09,507,washing machine,6990,16490,9500,1,00330,India
381749,2023-09-09,502,iphone 15 pro max,100000,135000,35000,1,00173,India
381749,2023-09-09,505,oven,18490,24000,5510,1,00173,India
958062,2023-09-09,501,iphone 15,60000,80000,20000,1,00351,India
368175,2023-09-09,501,iphone 15,60000,80000,20000,1,00326,India
368175,2023-09-09,504,iron,449,879,430,1,00326,India
902472,2023-09-09,506,monitor,3249,8000,4751,1,00030,India
902472,2023-09-09,507,washing machine,6990,16490,9500,1,00030,India
821073,2023-09-09,501,iphone 15,60000,80000,20000,1,00474,India
977792,2023-09-09,502,iphone 15 pro max,100000,135000,35000,1,00336,India
977792,2023-09-09,504,iron,449,879,430,1,00336,India
977792,2023-09-09,503,mixer,1349,3249,1900,1,00336,India
847114,2023-09-09,507,washing machine,6990,16490,9500,1,00079,India
847114,2023-09-09,506,monitor,3249,8000,4751,1,00079,India
847114,2023-09-09,501,iphone 15,60000,80000,20000,1,00079,India
847114,2023-09-09,504,iron,449,879,430,1,00079,India
503974,2023-09-09,506,monitor,3249,8000,4751,1,00193,India
727570,2023-09-09,505,oven,18490,24000,5510,1,00343,India
907545,2023-09-09,505,oven,18490,24000,5510,1,00188,India
907545,2023-09-09,501,iphone 15,60000,80000,20000,1,00188,India
907545,2023-09-09,507,washing machine,6990,16490,9500,1,00188,India
523490,2023-09-09,506,monitor,3249,8000,4751,1,00456,India
523490,2023-09-09,507,washing machine,6990,16490,9500,1,00456,India
523490,2023-09-09,503,mixer,1349,3249,1900,1,00456,India
603437,2023-09-09,502,iphone 15 pro max,100000,135000,35000,1,00495,India
603437,2023-09-09,504,iron,449,879,430,1,00495,India
603437,2023-09-09,503,mixer,1349,3249,1900,1,00495,India
497605,2023-09-10,507,washing machine,6990,16490,9500,1,00008,India
497605,2023-09-10,503,mixer,1349,3249,1900,1,00008,India
497605,2023-09-10,502,iphone 15 pro max,100000,135000,35000,1,00008,India
597883,2023-09-10,505,oven,18490,24000,5510,1,00480,India
597883,2023-09-10,501,iphone 15,60000,80000,20000,1,00480,India
597883,2023-09-10,502,iphone 15 pro max,100000,135000,35000,1,00480,India
597883,2023-09-10,507,washing machine,6990,16490,9500,1,00480,India
597883,2023-09-10,504,iron,449,879,430,1,00480,India
295070,2023-09-10,505,oven,18490,24000,5510,1,00447,India
295070,2023-09-10,502,iphone 15 pro max,100000,135000,35000,1,00447,India
295070,2023-09-10,504,iron,449,879,430,1,00447,India
295070,2023-09-10,506,monitor,3249,8000,4751,1,00447,India
383147,2023-09-10,507,washing machine,6990,16490,9500,1,00267,India
897665,2023-09-10,505,oven,18490,24000,5510,1,00121,India
897665,2023-09-10,503,mixer,1349,3249,1900,1,00121,India
897665,2023-09-10,507,washing machine,6990,16490,9500,1,00121,India
897665,2023-09-10,502,iphone 15 pro max,100000,135000,35000,1,00121,India
686538,2023-09-10,502,iphone 15 pro max,100000,135000,35000,1,00359,India
686538,2023-09-10,505,oven,18490,24000,5510,1,00359,India
213962,2023-09-10,503,mixer,1349,3249,1900,1,00314,India
213962,2023-09-10,504,iron,449,879,430,1,00314,India
587535,2023-09-10,505,oven,18490,24000,5510,1,00137,India
587535,2023-09-10,504,iron,449,879,430,1,00137,India
587535,2023-09-10,507,washing machine,6990,16490,9500,1,00137,India
844937,2023-09-10,502,iphone 15 pro max,100000,135000,35000,1,00200,India
844937,2023-09-10,503,mixer,1349,3249,1900,1,00200,India
844937,2023-09-10,505,oven,18490,24000,5510,1,00200,India
522090,2023-09-10,502,iphone 15 pro max,100000,135000,35000,1,00203,India
522090,2023-09-10,501,iphone 15,60000,80000,20000,1,00203,India
522090,2023-09-10,506,monitor,3249,8000,4751,1,00203,India
522090,2023-09-10,504,iron,449,879,430,1,00203,India
436841,2023-09-10,507,washing machine,6990,16490,9500,1,00331,India
436841,2023-09-10,504,iron,449,879,430,1,00331,India
893085,2023-09-10,507,washing machine,6990,16490,9500,1,00122,India
893085,2023-09-10,506,monitor,3249,8000,4751,1,00122,India
893085,2023-09-10,505,oven,18490,24000,5510,1,00122,India
207806,2023-09-10,506,monitor,3249,8000,4751,1,00255,India
207806,2023-09-10,504,iron,449,879,430,1,00255,India
207806,2023-09-10,507,washing machine,6990,16490,9500,1,00255,India
112193,2023-09-10,506,monitor,3249,8000,4751,1,00418,India
615582,2023-09-10,501,iphone 15,60000,80000,20000,1,00250,India
615582,2023-09-10,507,washing machine,6990,16490,9500,1,00250,India
254812,2023-09-10,503,mixer,1349,3249,1900,1,00003,India
787290,2023-09-10,506,monitor,3249,8000,4751,1,00450,India
787290,2023-09-10,507,washing machine,6990,16490,9500,1,00450,India
787290,2023-09-10,501,iphone 15,60000,80000,20000,1,00450,India
416388,2023-09-10,503,mixer,1349,3249,1900,1,00160,India
730099,2023-09-10,504,iron,449,879,430,1,00043,India
730099,2023-09-10,503,mixer,1349,3249,1900,1,00043,India
730099,2023-09-10,501,iphone 15,60000,80000,20000,1,00043,India
933687,2023-09-10,506,monitor,3249,8000,4751,1,00081,India
933687,2023-09-10,503,mixer,1349,3249,1900,1,00081,India
933687,2023-09-10,504,iron,449,879,430,1,00081,India
933687,2023-09-10,507,washing machine,6990,16490,9500,1,00081,India
691570,2023-09-10,502,iphone 15 pro max,100000,135000,35000,1,00495,India
691570,2023-09-10,501,iphone 15,60000,80000,20000,1,00495,India
841684,2023-09-10,502,iphone 15 pro max,100000,135000,35000,1,00325,India
841684,2023-09-10,507,washing machine,6990,16490,9500,1,00325,India
841684,2023-09-10,501,iphone 15,60000,80000,20000,1,00325,India
841684,2023-09-10,505,oven,18490,24000,5510,1,00325,India
693676,2023-09-10,503,mixer,1349,3249,1900,1,00471,India
243751,2023-09-10,503,mixer,1349,3249,1900,1,00144,India
243751,2023-09-10,505,oven,18490,24000,5510,1,00144,India
760466,2023-09-10,504,iron,449,879,430,1,00301,India
760466,2023-09-10,505,oven,18490,24000,5510,1,00301,India
760466,2023-09-10,502,iphone 15 pro max,100000,135000,35000,1,00301,India
760466,2023-09-10,507,washing machine,6990,16490,9500,1,00301,India
849031,2023-09-10,501,iphone 15,60000,80000,20000,1,00165,India
849031,2023-09-10,505,oven,18490,24000,5510,1,00165,India
368889,2023-09-10,501,iphone 15,60000,80000,20000,1,00019,India
419538,2023-09-10,505,oven,18490,24000,5510,1,00015,India
419538,2023-09-10,504,iron,449,879,430,1,00015,India
419538,2023-09-10,503,mixer,1349,3249,1900,1,00015,India
252477,2023-09-10,503,mixer,1349,3249,1900,1,00299,India
252477,2023-09-10,505,oven,18490,24000,5510,1,00299,India
116961,2023-09-10,507,washing machine,6990,16490,9500,1,00346,India
479728,2023-09-10,503,mixer,1349,3249,1900,1,00349,India
479728,2023-09-10,505,oven,18490,24000,5510,1,00349,India
918181,2023-09-10,501,iphone 15,60000,80000,20000,1,00477,India
966332,2023-09-10,503,mixer,1349,3249,1900,1,00023,India
957839,2023-09-10,505,oven,18490,24000,5510,1,00199,India
957839,2023-09-10,503,mixer,1349,3249,1900,1,00199,India
957839,2023-09-10,502,iphone 15 pro max,100000,135000,35000,1,00199,India
957839,2023-09-10,507,washing machine,6990,16490,9500,1,00199,India
423676,2023-09-10,505,oven,18490,24000,5510,1,00184,India
423676,2023-09-10,501,iphone 15,60000,80000,20000,1,00184,India
423676,2023-09-10,504,iron,449,879,430,1,00184,India
853843,2023-09-10,507,washing machine,6990,16490,9500,1,00011,India
853843,2023-09-10,505,oven,18490,24000,5510,1,00011,India
853843,2023-09-10,506,monitor,3249,8000,4751,1,00011,India
634889,2023-09-10,506,monitor,3249,8000,4751,1,00186,India
634889,2023-09-10,502,iphone 15 pro max,100000,135000,35000,1,00186,India
634889,2023-09-10,501,iphone 15,60000,80000,20000,1,00186,India
150092,2023-09-10,502,iphone 15 pro max,100000,135000,35000,1,00309,India
522952,2023-09-10,502,iphone 15 pro max,100000,135000,35000,1,00145,India
522952,2023-09-10,503,mixer,1349,3249,1900,1,00145,India
522952,2023-09-10,506,monitor,3249,8000,4751,1,00145,India
522952,2023-09-10,501,iphone 15,60000,80000,20000,1,00145,India
320266,2023-09-10,507,washing machine,6990,16490,9500,1,00403,India
320266,2023-09-10,505,oven,18490,24000,5510,1,00403,India
320266,2023-09-10,502,iphone 15 pro max,100000,135000,35000,1,00403,India
456192,2023-09-10,507,washing machine,6990,16490,9500,1,00487,India
681777,2023-09-10,505,oven,18490,24000,5510,1,00014,India
548894,2023-09-10,506,monitor,3249,8000,4751,1,00115,India
548894,2023-09-10,507,washing machine,6990,16490,9500,1,00115,India
201645,2023-09-10,507,washing machine,6990,16490,9500,1,00249,India
841874,2023-09-10,507,washing machine,6990,16490,9500,1,00268,India
841874,2023-09-10,505,oven,18490,24000,5510,1,00268,India
841874,2023-09-10,506,monitor,3249,8000,4751,1,00268,India
695857,2023-09-10,501,iphone 15,60000,80000,20000,1,00095,India
695857,2023-09-10,502,iphone 15 pro max,100000,135000,35000,1,00095,India
695857,2023-09-10,505,oven,18490,24000,5510,1,00095,India
602966,2023-09-10,506,monitor,3249,8000,4751,1,00203,India
602966,2023-09-10,505,oven,18490,24000,5510,1,00203,India
602966,2023-09-10,504,iron,449,879,430,1,00203,India
602966,2023-09-10,501,iphone 15,60000,80000,20000,1,00203,India
191854,2023-09-10,503,mixer,1349,3249,1900,1,00170,India
191854,2023-09-10,507,washing machine,6990,16490,9500,1,00170,India
191854,2023-09-10,504,iron,449,879,430,1,00170,India
674631,2023-09-10,506,monitor,3249,8000,4751,1,00154,India
674631,2023-09-10,502,iphone 15 pro max,100000,135000,35000,1,00154,India
674631,2023-09-10,507,washing machine,6990,16490,9500,1,00154,India
674631,2023-09-10,505,oven,18490,24000,5510,1,00154,India
752137,2023-09-10,505,oven,18490,24000,5510,1,00011,India
752137,2023-09-10,502,iphone 15 pro max,100000,135000,35000,1,00011,India
752137,2023-09-10,506,monitor,3249,8000,4751,1,00011,India
752137,2023-09-10,507,washing machine,6990,16490,9500,1,00011,India
315855,2023-09-10,505,oven,18490,24000,5510,1,00422,India
315855,2023-09-10,502,iphone 15 pro max,100000,135000,35000,1,00422,India
315855,2023-09-10,501,iphone 15,60000,80000,20000,1,00422,India
315855,2023-09-10,506,monitor,3249,8000,4751,1,00422,India
923900,2023-09-10,505,oven,18490,24000,5510,1,00008,India
923900,2023-09-10,502,iphone 15 pro max,100000,135000,35000,1,00008,India
923900,2023-09-10,506,monitor,3249,8000,4751,1,00008,India
923900,2023-09-10,503,mixer,1349,3249,1900,1,00008,India
189613,2023-09-10,502,iphone 15 pro max,100000,135000,35000,1,00063,India
739635,2023-09-10,501,iphone 15,60000,80000,20000,1,00106,India
739635,2023-09-10,507,washing machine,6990,16490,9500,1,00106,India
739635,2023-09-10,504,iron,449,879,430,1,00106,India
739635,2023-09-10,503,mixer,1349,3249,1900,1,00106,India
594249,2023-09-10,507,washing machine,6990,16490,9500,1,00210,India
594249,2023-09-10,503,mixer,1349,3249,1900,1,00210,India
594249,2023-09-10,505,oven,18490,24000,5510,1,00210,India
594249,2023-09-10,501,iphone 15,60000,80000,20000,1,00210,India
594249,2023-09-10,502,iphone 15 pro max,100000,135000,35000,1,00210,India
752842,2023-09-10,503,mixer,1349,3249,1900,1,00252,India
752842,2023-09-10,502,iphone 15 pro max,100000,135000,35000,1,00252,India
290235,2023-09-10,504,iron,449,879,430,1,00179,India
290235,2023-09-10,507,washing machine,6990,16490,9500,1,00179,India
290235,2023-09-10,505,oven,18490,24000,5510,1,00179,India
290235,2023-09-10,502,iphone 15 pro max,100000,135000,35000,1,00179,India
620668,2023-09-10,504,iron,449,879,430,1,00492,India
292484,2023-09-10,502,iphone 15 pro max,100000,135000,35000,1,00448,India
292484,2023-09-10,507,washing machine,6990,16490,9500,1,00448,India
292484,2023-09-10,501,iphone 15,60000,80000,20000,1,00448,India
417373,2023-09-10,507,washing machine,6990,16490,9500,1,00282,India
417373,2023-09-10,501,iphone 15,60000,80000,20000,1,00282,India
869971,2023-09-10,501,iphone 15,60000,80000,20000,1,00465,India
240357,2023-09-10,505,oven,18490,24000,5510,1,00033,India
240357,2023-09-10,503,mixer,1349,3249,1900,1,00033,India
240357,2023-09-10,501,iphone 15,60000,80000,20000,1,00033,India
117739,2023-09-10,505,oven,18490,24000,5510,1,00168,India
117739,2023-09-10,503,mixer,1349,3249,1900,1,00168,India
661622,2023-09-10,506,monitor,3249,8000,4751,1,00274,India
802816,2023-09-10,503,mixer,1349,3249,1900,1,00081,India
802816,2023-09-10,502,iphone 15 pro max,100000,135000,35000,1,00081,India
367893,2023-09-10,502,iphone 15 pro max,100000,135000,35000,1,00265,India
618634,2023-09-10,504,iron,449,879,430,1,00373,India
618634,2023-09-10,503,mixer,1349,3249,1900,1,00373,India
618634,2023-09-10,502,iphone 15 pro max,100000,135000,35000,1,00373,India
131412,2023-09-10,502,iphone 15 pro max,100000,135000,35000,1,00173,India
131412,2023-09-10,503,mixer,1349,3249,1900,1,00173,India
131412,2023-09-10,507,washing machine,6990,16490,9500,1,00173,India
260087,2023-09-10,503,mixer,1349,3249,1900,1,00230,India
353353,2023-09-10,505,oven,18490,24000,5510,1,00136,India
353353,2023-09-10,506,monitor,3249,8000,4751,1,00136,India
162957,2023-09-11,503,mixer,1349,3249,1900,1,00183,India
203834,2023-09-11,505,oven,18490,24000,5510,1,00032,India
203834,2023-09-11,503,mixer,1349,3249,1900,1,00032,India
203834,2023-09-11,501,iphone 15,60000,80000,20000,1,00032,India
824482,2023-09-11,503,mixer,1349,3249,1900,1,00287,India
824482,2023-09-11,505,oven,18490,24000,5510,1,00287,India
824482,2023-09-11,506,monitor,3249,8000,4751,1,00287,India
391792,2023-09-11,504,iron,449,879,430,1,00092,India
391792,2023-09-11,502,iphone 15 pro max,100000,135000,35000,1,00092,India
391792,2023-09-11,501,iphone 15,60000,80000,20000,1,00092,India
742914,2023-09-11,506,monitor,3249,8000,4751,1,00351,India
742914,2023-09-11,505,oven,18490,24000,5510,1,00351,India
742914,2023-09-11,501,iphone 15,60000,80000,20000,1,00351,India
186745,2023-09-11,503,mixer,1349,3249,1900,1,00487,India
949113,2023-09-11,503,mixer,1349,3249,1900,1,00381,India
949113,2023-09-11,502,iphone 15 pro max,100000,135000,35000,1,00381,India
920874,2023-09-11,504,iron,449,879,430,1,00308,India
374775,2023-09-11,503,mixer,1349,3249,1900,1,00287,India
374775,2023-09-11,504,iron,449,879,430,1,00287,India
374775,2023-09-11,507,washing machine,6990,16490,9500,1,00287,India
231792,2023-09-11,501,iphone 15,60000,80000,20000,1,00143,India
539367,2023-09-11,505,oven,18490,24000,5510,1,00164,India
317513,2023-09-11,505,oven,18490,24000,5510,1,00409,India
317513,2023-09-11,503,mixer,1349,3249,1900,1,00409,India
317513,2023-09-11,502,iphone 15 pro max,100000,135000,35000,1,00409,India
317513,2023-09-11,501,iphone 15,60000,80000,20000,1,00409,India
258857,2023-09-11,507,washing machine,6990,16490,9500,1,00203,India
553374,2023-09-11,502,iphone 15 pro max,100000,135000,35000,1,00315,India
553374,2023-09-11,504,iron,449,879,430,1,00315,India
553374,2023-09-11,505,oven,18490,24000,5510,1,00315,India
553374,2023-09-11,507,washing machine,6990,16490,9500,1,00315,India
125068,2023-09-11,503,mixer,1349,3249,1900,1,00272,India
125068,2023-09-11,506,monitor,3249,8000,4751,1,00272,India
324757,2023-09-11,505,oven,18490,24000,5510,1,00277,India
324757,2023-09-11,504,iron,449,879,430,1,00277,India
395729,2023-09-11,501,iphone 15,60000,80000,20000,1,00010,India
395729,2023-09-11,506,monitor,3249,8000,4751,1,00010,India
395729,2023-09-11,503,mixer,1349,3249,1900,1,00010,India
753176,2023-09-11,504,iron,449,879,430,1,00266,India
727492,2023-09-11,506,monitor,3249,8000,4751,1,00351,India
216973,2023-09-11,507,washing machine,6990,16490,9500,1,00356,India
914809,2023-09-11,507,washing machine,6990,16490,9500,1,00286,India
462682,2023-09-11,507,washing machine,6990,16490,9500,1,00374,India
462682,2023-09-11,504,iron,449,879,430,1,00374,India
462682,2023-09-11,505,oven,18490,24000,5510,1,00374,India
462682,2023-09-11,503,mixer,1349,3249,1900,1,00374,India
883992,2023-09-11,505,oven,18490,24000,5510,1,00316,India
883992,2023-09-11,501,iphone 15,60000,80000,20000,1,00316,India
883992,2023-09-11,502,iphone 15 pro max,100000,135000,35000,1,00316,India
829730,2023-09-11,505,oven,18490,24000,5510,1,00145,India
100489,2023-09-11,504,iron,449,879,430,1,00487,India
100489,2023-09-11,506,monitor,3249,8000,4751,1,00487,India
269289,2023-09-11,506,monitor,3249,8000,4751,1,00282,India
269289,2023-09-11,501,iphone 15,60000,80000,20000,1,00282,India
269289,2023-09-11,505,oven,18490,24000,5510,1,00282,India
959538,2023-09-11,503,mixer,1349,3249,1900,1,00282,India
959538,2023-09-11,505,oven,18490,24000,5510,1,00282,India
545770,2023-09-11,502,iphone 15 pro max,100000,135000,35000,1,00150,India
545770,2023-09-11,507,washing machine,6990,16490,9500,1,00150,India
545770,2023-09-11,501,iphone 15,60000,80000,20000,1,00150,India
545770,2023-09-11,504,iron,449,879,430,1,00150,India
454648,2023-09-11,504,iron,449,879,430,1,00164,India
232520,2023-09-11,506,monitor,3249,8000,4751,1,00159,India
232520,2023-09-11,503,mixer,1349,3249,1900,1,00159,India
860948,2023-09-11,504,iron,449,879,430,1,00110,India
899854,2023-09-11,506,monitor,3249,8000,4751,1,00165,India
946832,2023-09-11,505,oven,18490,24000,5510,1,00102,India
946832,2023-09-11,506,monitor,3249,8000,4751,1,00102,India
946832,2023-09-11,504,iron,449,879,430,1,00102,India
143081,2023-09-11,507,washing machine,6990,16490,9500,1,00216,India
143081,2023-09-11,504,iron,449,879,430,1,00216,India
754697,2023-09-11,503,mixer,1349,3249,1900,1,00213,India
754697,2023-09-11,501,iphone 15,60000,80000,20000,1,00213,India
754697,2023-09-11,502,iphone 15 pro max,100000,135000,35000,1,00213,India
391778,2023-09-11,504,iron,449,879,430,1,00027,India
391778,2023-09-11,505,oven,18490,24000,5510,1,00027,India
273206,2023-09-11,503,mixer,1349,3249,1900,1,00168,India
273206,2023-09-11,506,monitor,3249,8000,4751,1,00168,India
273206,2023-09-11,502,iphone 15 pro max,100000,135000,35000,1,00168,India
391525,2023-09-11,503,mixer,1349,3249,1900,1,00424,India
391525,2023-09-11,507,washing machine,6990,16490,9500,1,00424,India
391525,2023-09-11,505,oven,18490,24000,5510,1,00424,India
988576,2023-09-11,506,monitor,3249,8000,4751,1,00243,India
988576,2023-09-11,505,oven,18490,24000,5510,1,00243,India
570898,2023-09-11,506,monitor,3249,8000,4751,1,00072,India
570898,2023-09-11,504,iron,449,879,430,1,00072,India
362878,2023-09-11,504,iron,449,879,430,1,00020,India
362878,2023-09-11,503,mixer,1349,3249,1900,1,00020,India
362878,2023-09-11,501,iphone 15,60000,80000,20000,1,00020,India
600330,2023-09-11,506,monitor,3249,8000,4751,1,00083,India
600330,2023-09-11,502,iphone 15 pro max,100000,135000,35000,1,00083,India
391818,2023-09-11,504,iron,449,879,430,1,00026,India
391818,2023-09-11,501,iphone 15,60000,80000,20000,1,00026,India
199275,2023-09-11,503,mixer,1349,3249,1900,1,00089,India
885387,2023-09-11,506,monitor,3249,8000,4751,1,00471,India
885387,2023-09-11,502,iphone 15 pro max,100000,135000,35000,1,00471,India
885387,2023-09-11,503,mixer,1349,3249,1900,1,00471,India
885387,2023-09-11,501,iphone 15,60000,80000,20000,1,00471,India
362598,2023-09-11,504,iron,449,879,430,1,00102,India
362598,2023-09-11,501,iphone 15,60000,80000,20000,1,00102,India
362598,2023-09-11,502,iphone 15 pro max,100000,135000,35000,1,00102,India
362598,2023-09-11,507,washing machine,6990,16490,9500,1,00102,India
318512,2023-09-11,502,iphone 15 pro max,100000,135000,35000,1,00456,India
701501,2023-09-11,503,mixer,1349,3249,1900,1,00120,India
701501,2023-09-11,501,iphone 15,60000,80000,20000,1,00120,India
701501,2023-09-11,505,oven,18490,24000,5510,1,00120,India
701501,2023-09-11,506,monitor,3249,8000,4751,1,00120,India
802680,2023-09-11,501,iphone 15,60000,80000,20000,1,00242,India
802680,2023-09-11,507,washing machine,6990,16490,9500,1,00242,India
802680,2023-09-11,503,mixer,1349,3249,1900,1,00242,India
292568,2023-09-11,501,iphone 15,60000,80000,20000,1,00458,India
292568,2023-09-11,502,iphone 15 pro max,100000,135000,35000,1,00458,India
292568,2023-09-11,506,monitor,3249,8000,4751,1,00458,India
741206,2023-09-11,507,washing machine,6990,16490,9500,1,00239,India
741206,2023-09-11,506,monitor,3249,8000,4751,1,00239,India
592611,2023-09-11,502,iphone 15 pro max,100000,135000,35000,1,00257,India
596357,2023-09-11,503,mixer,1349,3249,1900,1,00384,India
670714,2023-09-11,503,mixer,1349,3249,1900,1,00017,India
670714,2023-09-11,505,oven,18490,24000,5510,1,00017,India
670714,2023-09-11,501,iphone 15,60000,80000,20000,1,00017,India
502875,2023-09-12,503,mixer,1349,3249,1900,1,00007,India
502875,2023-09-12,506,monitor,3249,8000,4751,1,00007,India
502875,2023-09-12,507,washing machine,6990,16490,9500,1,00007,India
502875,2023-09-12,501,iphone 15,60000,80000,20000,1,00007,India
915065,2023-09-12,505,oven,18490,24000,5510,1,00178,India
915065,2023-09-12,501,iphone 15,60000,80000,20000,1,00178,India
704438,2023-09-12,507,washing machine,6990,16490,9500,1,00448,India
704438,2023-09-12,505,oven,18490,24000,5510,1,00448,India
704438,2023-09-12,503,mixer,1349,3249,1900,1,00448,India
704438,2023-09-12,501,iphone 15,60000,80000,20000,1,00448,India
643865,2023-09-12,503,mixer,1349,3249,1900,1,00218,India
279097,2023-09-12,503,mixer,1349,3249,1900,1,00130,India
279097,2023-09-12,505,oven,18490,24000,5510,1,00130,India
279097,2023-09-12,504,iron,449,879,430,1,00130,India
245955,2023-09-12,501,iphone 15,60000,80000,20000,1,00321,India
245955,2023-09-12,505,oven,18490,24000,5510,1,00321,India
245955,2023-09-12,502,iphone 15 pro max,100000,135000,35000,1,00321,India
200742,2023-09-12,503,mixer,1349,3249,1900,1,00216,India
200742,2023-09-12,501,iphone 15,60000,80000,20000,1,00216,India
200742,2023-09-12,506,monitor,3249,8000,4751,1,00216,India
486763,2023-09-12,502,iphone 15 pro max,100000,135000,35000,1,00441,India
486763,2023-09-12,506,monitor,3249,8000,4751,1,00441,India
244060,2023-09-12,507,washing machine,6990,16490,9500,1,00306,India
244060,2023-09-12,503,mixer,1349,3249,1900,1,00306,India
639921,2023-09-12,501,iphone 15,60000,80000,20000,1,00241,India
476030,2023-09-12,504,iron,449,879,430,1,00284,India
476030,2023-09-12,506,monitor,3249,8000,4751,1,00284,India
476030,2023-09-12,503,mixer,1349,3249,1900,1,00284,India
275893,2023-09-12,507,washing machine,6990,16490,9500,1,00072,India
319468,2023-09-12,505,oven,18490,24000,5510,1,00240,India
319468,2023-09-12,506,monitor,3249,8000,4751,1,00240,India
319468,2023-09-12,503,mixer,1349,3249,1900,1,00240,India
406273,2023-09-12,502,iphone 15 pro max,100000,135000,35000,1,00409,India
601536,2023-09-12,504,iron,449,879,430,1,00284,India
601536,2023-09-12,506,monitor,3249,8000,4751,1,00284,India
601536,2023-09-12,502,iphone 15 pro max,100000,135000,35000,1,00284,India
601536,2023-09-12,503,mixer,1349,3249,1900,1,00284,India
861317,2023-09-12,505,oven,18490,24000,5510,1,00205,India
199031,2023-09-12,503,mixer,1349,3249,1900,1,00293,India
199031,2023-09-12,507,washing machine,6990,16490,9500,1,00293,India
199031,2023-09-12,506,monitor,3249,8000,4751,1,00293,India
199031,2023-09-12,502,iphone 15 pro max,100000,135000,35000,1,00293,India
920963,2023-09-12,502,iphone 15 pro max,100000,135000,35000,1,00216,India
920963,2023-09-12,505,oven,18490,24000,5510,1,00216,India
608737,2023-09-12,504,iron,449,879,430,1,00116,India
608737,2023-09-12,503,mixer,1349,3249,1900,1,00116,India
608737,2023-09-12,502,iphone 15 pro max,100000,135000,35000,1,00116,India
608737,2023-09-12,501,iphone 15,60000,80000,20000,1,00116,India
790752,2023-09-12,503,mixer,1349,3249,1900,1,00364,India
790752,2023-09-12,505,oven,18490,24000,5510,1,00364,India
790752,2023-09-12,507,washing machine,6990,16490,9500,1,00364,India
790752,2023-09-12,504,iron,449,879,430,1,00364,India
413009,2023-09-12,506,monitor,3249,8000,4751,1,00291,India
413009,2023-09-12,503,mixer,1349,3249,1900,1,00291,India
291141,2023-09-12,505,oven,18490,24000,5510,1,00036,India
291141,2023-09-12,504,iron,449,879,430,1,00036,India
291141,2023-09-12,503,mixer,1349,3249,1900,1,00036,India
291141,2023-09-12,502,iphone 15 pro max,100000,135000,35000,1,00036,India
701713,2023-09-12,507,washing machine,6990,16490,9500,1,00485,India
701713,2023-09-12,504,iron,449,879,430,1,00485,India
824421,2023-09-12,502,iphone 15 pro max,100000,135000,35000,1,00156,India
824421,2023-09-12,504,iron,449,879,430,1,00156,India
726035,2023-09-12,502,iphone 15 pro max,100000,135000,35000,1,00140,India
726035,2023-09-12,507,washing machine,6990,16490,9500,1,00140,India
726035,2023-09-12,503,mixer,1349,3249,1900,1,00140,India
726035,2023-09-12,506,monitor,3249,8000,4751,1,00140,India
106011,2023-09-12,503,mixer,1349,3249,1900,1,00472,India
106011,2023-09-12,504,iron,449,879,430,1,00472,India
388591,2023-09-12,504,iron,449,879,430,1,00300,India
161414,2023-09-12,507,washing machine,6990,16490,9500,1,00118,India
161414,2023-09-12,503,mixer,1349,3249,1900,1,00118,India
230387,2023-09-12,507,washing machine,6990,16490,9500,1,00361,India
230387,2023-09-12,502,iphone 15 pro max,100000,135000,35000,1,00361,India
230387,2023-09-12,506,monitor,3249,8000,4751,1,00361,India
165781,2023-09-12,506,monitor,3249,8000,4751,1,00469,India
165781,2023-09-12,507,washing machine,6990,16490,9500,1,00469,India
165781,2023-09-12,503,mixer,1349,3249,1900,1,00469,India
770135,2023-09-12,501,iphone 15,60000,80000,20000,1,00426,India
770135,2023-09-12,505,oven,18490,24000,5510,1,00426,India
770135,2023-09-12,503,mixer,1349,3249,1900,1,00426,India
733891,2023-09-12,504,iron,449,879,430,1,00245,India
526168,2023-09-12,506,monitor,3249,8000,4751,1,00098,India
526168,2023-09-12,501,iphone 15,60000,80000,20000,1,00098,India
526168,2023-09-12,505,oven,18490,24000,5510,1,00098,India
835853,2023-09-12,505,oven,18490,24000,5510,1,00205,India
835853,2023-09-12,507,washing machine,6990,16490,9500,1,00205,India
835853,2023-09-12,502,iphone 15 pro max,100000,135000,35000,1,00205,India
636815,2023-09-12,507,washing machine,6990,16490,9500,1,00187,India
636815,2023-09-12,503,mixer,1349,3249,1900,1,00187,India
636815,2023-09-12,502,iphone 15 pro max,100000,135000,35000,1,00187,India
257807,2023-09-12,506,monitor,3249,8000,4751,1,00065,India
257807,2023-09-12,504,iron,449,879,430,1,00065,India
257807,2023-09-12,507,washing machine,6990,16490,9500,1,00065,India
685310,2023-09-12,506,monitor,3249,8000,4751,1,00331,India
120281,2023-09-12,504,iron,449,879,430,1,00139,India
738315,2023-09-12,504,iron,449,879,430,1,00348,India
738315,2023-09-12,505,oven,18490,24000,5510,1,00348,India
738315,2023-09-12,507,washing machine,6990,16490,9500,1,00348,India
645988,2023-09-12,502,iphone 15 pro max,100000,135000,35000,1,00372,India
645988,2023-09-12,503,mixer,1349,3249,1900,1,00372,India
645988,2023-09-12,504,iron,449,879,430,1,00372,India
715704,2023-09-12,507,washing machine,6990,16490,9500,1,00471,India
715704,2023-09-12,501,iphone 15,60000,80000,20000,1,00471,India
715704,2023-09-12,506,monitor,3249,8000,4751,1,00471,India
715704,2023-09-12,504,iron,449,879,430,1,00471,India
896847,2023-09-12,503,mixer,1349,3249,1900,1,00133,India
896847,2023-09-12,507,washing machine,6990,16490,9500,1,00133,India
465550,2023-09-12,504,iron,449,879,430,1,00434,India
465550,2023-09-12,502,iphone 15 pro max,100000,135000,35000,1,00434,India
606635,2023-09-12,503,mixer,1349,3249,1900,1,00272,India
606635,2023-09-12,502,iphone 15 pro max,100000,135000,35000,1,00272,India
968417,2023-09-12,504,iron,449,879,430,1,00272,India
968417,2023-09-12,507,washing machine,6990,16490,9500,1,00272,India
968417,2023-09-12,505,oven,18490,24000,5510,1,00272,India
968417,2023-09-12,506,monitor,3249,8000,4751,1,00272,India
493475,2023-09-12,501,iphone 15,60000,80000,20000,1,00311,India
493475,2023-09-12,505,oven,18490,24000,5510,1,00311,India
295260,2023-09-12,502,iphone 15 pro max,100000,135000,35000,1,00271,India
295260,2023-09-12,503,mixer,1349,3249,1900,1,00271,India
295260,2023-09-12,501,iphone 15,60000,80000,20000,1,00271,India
295260,2023-09-12,506,monitor,3249,8000,4751,1,00271,India
915676,2023-09-12,503,mixer,1349,3249,1900,1,00220,India
853150,2023-09-12,505,oven,18490,24000,5510,1,00218,India
853150,2023-09-12,506,monitor,3249,8000,4751,1,00218,India
853150,2023-09-12,504,iron,449,879,430,1,00218,India
998778,2023-09-12,501,iphone 15,60000,80000,20000,1,00305,India
998778,2023-09-12,505,oven,18490,24000,5510,1,00305,India
998778,2023-09-12,502,iphone 15 pro max,100000,135000,35000,1,00305,India
998778,2023-09-12,503,mixer,1349,3249,1900,1,00305,India
998778,2023-09-12,507,washing machine,6990,16490,9500,1,00305,India
405067,2023-09-12,502,iphone 15 pro max,100000,135000,35000,1,00250,India
405067,2023-09-12,503,mixer,1349,3249,1900,1,00250,India
405067,2023-09-12,504,iron,449,879,430,1,00250,India
816348,2023-09-12,507,washing machine,6990,16490,9500,1,00054,India
816348,2023-09-12,503,mixer,1349,3249,1900,1,00054,India
816348,2023-09-12,506,monitor,3249,8000,4751,1,00054,India
940540,2023-09-12,504,iron,449,879,430,1,00047,India
940540,2023-09-12,506,monitor,3249,8000,4751,1,00047,India
940540,2023-09-12,505,oven,18490,24000,5510,1,00047,India
681955,2023-09-12,507,washing machine,6990,16490,9500,1,00398,India
681955,2023-09-12,503,mixer,1349,3249,1900,1,00398,India
972727,2023-09-12,504,iron,449,879,430,1,00312,India
972727,2023-09-12,501,iphone 15,60000,80000,20000,1,00312,India
972727,2023-09-12,507,washing machine,6990,16490,9500,1,00312,India
922637,2023-09-12,501,iphone 15,60000,80000,20000,1,00182,India
842172,2023-09-12,501,iphone 15,60000,80000,20000,1,00273,India
374925,2023-09-12,505,oven,18490,24000,5510,1,00037,India
374925,2023-09-12,502,iphone 15 pro max,100000,135000,35000,1,00037,India
374925,2023-09-12,506,monitor,3249,8000,4751,1,00037,India
354690,2023-09-12,503,mixer,1349,3249,1900,1,00452,India
354690,2023-09-12,505,oven,18490,24000,5510,1,00452,India
326042,2023-09-12,507,washing machine,6990,16490,9500,1,00235,India
326042,2023-09-12,503,mixer,1349,3249,1900,1,00235,India
195609,2023-09-12,506,monitor,3249,8000,4751,1,00139,India
195609,2023-09-12,505,oven,18490,24000,5510,1,00139,India
195609,2023-09-12,503,mixer,1349,3249,1900,1,00139,India
657975,2023-09-12,505,oven,18490,24000,5510,1,00335,India
657975,2023-09-12,502,iphone 15 pro max,100000,135000,35000,1,00335,India
861010,2023-09-12,503,mixer,1349,3249,1900,1,00299,India
861010,2023-09-12,507,washing machine,6990,16490,9500,1,00299,India
171747,2023-09-12,503,mixer,1349,3249,1900,1,00358,India
171747,2023-09-12,506,monitor,3249,8000,4751,1,00358,India
919556,2023-09-12,505,oven,18490,24000,5510,1,00253,India
919556,2023-09-12,501,iphone 15,60000,80000,20000,1,00253,India
919556,2023-09-12,502,iphone 15 pro max,100000,135000,35000,1,00253,India
259831,2023-09-12,506,monitor,3249,8000,4751,1,00238,India
259831,2023-09-12,502,iphone 15 pro max,100000,135000,35000,1,00238,India
608291,2023-09-13,503,mixer,1349,3249,1900,1,00165,India
608291,2023-09-13,506,monitor,3249,8000,4751,1,00165,India
608291,2023-09-13,504,iron,449,879,430,1,00165,India
608291,2023-09-13,507,washing machine,6990,16490,9500,1,00165,India
321632,2023-09-13,501,iphone 15,60000,80000,20000,1,00264,India
521459,2023-09-13,502,iphone 15 pro max,100000,135000,35000,1,00431,India
521459,2023-09-13,505,oven,18490,24000,5510,1,00431,India
521459,2023-09-13,503,mixer,1349,3249,1900,1,00431,India
521459,2023-09-13,501,iphone 15,60000,80000,20000,1,00431,India
122662,2023-09-13,503,mixer,1349,3249,1900,1,00203,India
122662,2023-09-13,507,washing machine,6990,16490,9500,1,00203,India
122662,2023-09-13,505,oven,18490,24000,5510,1,00203,India
166895,2023-09-13,507,washing machine,6990,16490,9500,1,00239,India
166895,2023-09-13,506,monitor,3249,8000,4751,1,00239,India
166895,2023-09-13,502,iphone 15 pro max,100000,135000,35000,1,00239,India
450264,2023-09-13,502,iphone 15 pro max,100000,135000,35000,1,00104,India
450264,2023-09-13,503,mixer,1349,3249,1900,1,00104,India
903416,2023-09-13,504,iron,449,879,430,1,00168,India
903416,2023-09-13,506,monitor,3249,8000,4751,1,00168,India
903416,2023-09-13,502,iphone 15 pro max,100000,135000,35000,1,00168,India
903416,2023-09-13,507,washing machine,6990,16490,9500,1,00168,India
104802,2023-09-13,502,iphone 15 pro max,100000,135000,35000,1,00325,India
104802,2023-09-13,505,oven,18490,24000,5510,1,00325,India
536757,2023-09-13,507,washing machine,6990,16490,9500,1,00351,India
435704,2023-09-13,507,washing machine,6990,16490,9500,1,00181,India
435704,2023-09-13,504,iron,449,879,430,1,00181,India
435704,2023-09-13,501,iphone 15,60000,80000,20000,1,00181,India
435704,2023-09-13,503,mixer,1349,3249,1900,1,00181,India
113013,2023-09-13,506,monitor,3249,8000,4751,1,00358,India
113013,2023-09-13,505,oven,18490,24000,5510,1,00358,India
723191,2023-09-13,501,iphone 15,60000,80000,20000,1,00430,India
747216,2023-09-13,504,iron,449,879,430,1,00063,India
747216,2023-09-13,505,oven,18490,24000,5510,1,00063,India
747216,2023-09-13,502,iphone 15 pro max,100000,135000,35000,1,00063,India
268799,2023-09-13,506,monitor,3249,8000,4751,1,00277,India
268799,2023-09-13,507,washing machine,6990,16490,9500,1,00277,India
268799,2023-09-13,505,oven,18490,24000,5510,1,00277,India
641102,2023-09-13,507,washing machine,6990,16490,9500,1,00098,India
641102,2023-09-13,503,mixer,1349,3249,1900,1,00098,India
641102,2023-09-13,502,iphone 15 pro max,100000,135000,35000,1,00098,India
253046,2023-09-13,503,mixer,1349,3249,1900,1,00362,India
976383,2023-09-13,502,iphone 15 pro max,100000,135000,35000,1,00129,India
976383,2023-09-13,504,iron,449,879,430,1,00129,India
976383,2023-09-13,507,washing machine,6990,16490,9500,1,00129,India
666463,2023-09-13,504,iron,449,879,430,1,00271,India
666463,2023-09-13,502,iphone 15 pro max,100000,135000,35000,1,00271,India
693223,2023-09-13,506,monitor,3249,8000,4751,1,00484,India
693223,2023-09-13,501,iphone 15,60000,80000,20000,1,00484,India
278144,2023-09-13,506,monitor,3249,8000,4751,1,00134,India
278144,2023-09-13,507,washing machine,6990,16490,9500,1,00134,India
278144,2023-09-13,505,oven,18490,24000,5510,1,00134,India
278144,2023-09-13,502,iphone 15 pro max,100000,135000,35000,1,00134,India
104541,2023-09-13,506,monitor,3249,8000,4751,1,00308,India
104541,2023-09-13,504,iron,449,879,430,1,00308,India
538388,2023-09-13,507,washing machine,6990,16490,9500,1,00029,India
538388,2023-09-13,502,iphone 15 pro max,100000,135000,35000,1,00029,India
538388,2023-09-13,506,monitor,3249,8000,4751,1,00029,India
538388,2023-09-13,505,oven,18490,24000,5510,1,00029,India
263938,2023-09-13,506,monitor,3249,8000,4751,1,00347,India
263938,2023-09-13,507,washing machine,6990,16490,9500,1,00347,India
263938,2023-09-13,502,iphone 15 pro max,100000,135000,35000,1,00347,India
102818,2023-09-13,501,iphone 15,60000,80000,20000,1,00244,India
102818,2023-09-13,505,oven,18490,24000,5510,1,00244,India
102818,2023-09-13,503,mixer,1349,3249,1900,1,00244,India
163890,2023-09-13,501,iphone 15,60000,80000,20000,1,00400,India
163890,2023-09-13,502,iphone 15 pro max,100000,135000,35000,1,00400,India
855635,2023-09-13,503,mixer,1349,3249,1900,1,00256,India
855635,2023-09-13,505,oven,18490,24000,5510,1,00256,India
855635,2023-09-13,507,washing machine,6990,16490,9500,1,00256,India
855635,2023-09-13,506,monitor,3249,8000,4751,1,00256,India
105637,2023-09-13,506,monitor,3249,8000,4751,1,00421,India
818722,2023-09-13,503,mixer,1349,3249,1900,1,00087,India
818722,2023-09-13,501,iphone 15,60000,80000,20000,1,00087,India
818722,2023-09-13,502,iphone 15 pro max,100000,135000,35000,1,00087,India
282272,2023-09-13,505,oven,18490,24000,5510,1,00013,India
135301,2023-09-13,506,monitor,3249,8000,4751,1,00185,India
135301,2023-09-13,504,iron,449,879,430,1,00185,India
623977,2023-09-13,506,monitor,3249,8000,4751,1,00219,India
446569,2023-09-13,505,oven,18490,24000,5510,1,00169,India
114516,2023-09-13,506,monitor,3249,8000,4751,1,00464,India
114516,2023-09-13,504,iron,449,879,430,1,00464,India
114516,2023-09-13,503,mixer,1349,3249,1900,1,00464,India
114516,2023-09-13,501,iphone 15,60000,80000,20000,1,00464,India
679466,2023-09-13,503,mixer,1349,3249,1900,1,00105,India
961610,2023-09-13,501,iphone 15,60000,80000,20000,1,00321,India
961610,2023-09-13,503,mixer,1349,3249,1900,1,00321,India
961610,2023-09-13,506,monitor,3249,8000,4751,1,00321,India
787250,2023-09-13,503,mixer,1349,3249,1900,1,00412,India
438950,2023-09-13,501,iphone 15,60000,80000,20000,1,00430,India
438950,2023-09-13,503,mixer,1349,3249,1900,1,00430,India
649544,2023-09-13,507,washing machine,6990,16490,9500,1,00061,India
717880,2023-09-13,505,oven,18490,24000,5510,1,00227,India
717880,2023-09-13,506,monitor,3249,8000,4751,1,00227,India
717880,2023-09-13,507,washing machine,6990,16490,9500,1,00227,India
196818,2023-09-13,505,oven,18490,24000,5510,1,00198,India
280664,2023-09-13,502,iphone 15 pro max,100000,135000,35000,1,00445,India
280664,2023-09-13,503,mixer,1349,3249,1900,1,00445,India
280664,2023-09-13,506,monitor,3249,8000,4751,1,00445,India
176958,2023-09-13,506,monitor,3249,8000,4751,1,00089,India
176958,2023-09-13,505,oven,18490,24000,5510,1,00089,India
176958,2023-09-13,503,mixer,1349,3249,1900,1,00089,India
909058,2023-09-13,505,oven,18490,24000,5510,1,00140,India
909058,2023-09-13,504,iron,449,879,430,1,00140,India
909058,2023-09-13,506,monitor,3249,8000,4751,1,00140,India
909058,2023-09-13,502,iphone 15 pro max,100000,135000,35000,1,00140,India
718339,2023-09-13,505,oven,18490,24000,5510,1,00209,India
718339,2023-09-13,507,washing machine,6990,16490,9500,1,00209,India
718339,2023-09-13,506,monitor,3249,8000,4751,1,00209,India
973987,2023-09-13,502,iphone 15 pro max,100000,135000,35000,1,00215,India
973987,2023-09-13,504,iron,449,879,430,1,00215,India
718204,2023-09-13,502,iphone 15 pro max,100000,135000,35000,1,00106,India
718204,2023-09-13,507,washing machine,6990,16490,9500,1,00106,India
136409,2023-09-13,504,iron,449,879,430,1,00053,India
136409,2023-09-13,502,iphone 15 pro max,100000,135000,35000,1,00053,India
136409,2023-09-13,501,iphone 15,60000,80000,20000,1,00053,India
136409,2023-09-13,505,oven,18490,24000,5510,1,00053,India
136409,2023-09-13,506,monitor,3249,8000,4751,1,00053,India
963928,2023-09-13,505,oven,18490,24000,5510,1,00305,India
491635,2023-09-13,505,oven,18490,24000,5510,1,00136,India
491635,2023-09-13,503,mixer,1349,3249,1900,1,00136,India
491635,2023-09-13,502,iphone 15 pro max,100000,135000,35000,1,00136,India
837819,2023-09-13,504,iron,449,879,430,1,00393,India
837819,2023-09-13,503,mixer,1349,3249,1900,1,00393,India
837819,2023-09-13,505,oven,18490,24000,5510,1,00393,India
837819,2023-09-13,506,monitor,3249,8000,4751,1,00393,India
837819,2023-09-13,501,iphone 15,60000,80000,20000,1,00393,India
891502,2023-09-13,505,oven,18490,24000,5510,1,00446,India
891502,2023-09-13,506,monitor,3249,8000,4751,1,00446,India
891502,2023-09-13,502,iphone 15 pro max,100000,135000,35000,1,00446,India
146788,2023-09-13,506,monitor,3249,8000,4751,1,00237,India
146788,2023-09-13,507,washing machine,6990,16490,9500,1,00237,India
248160,2023-09-13,505,oven,18490,24000,5510,1,00264,India
248160,2023-09-13,502,iphone 15 pro max,100000,135000,35000,1,00264,India
248160,2023-09-13,501,iphone 15,60000,80000,20000,1,00264,India
617459,2023-09-14,501,iphone 15,60000,80000,20000,1,00234,India
424142,2023-09-14,502,iphone 15 pro max,100000,135000,35000,1,00366,India
500695,2023-09-14,502,iphone 15 pro max,100000,135000,35000,1,00213,India
957571,2023-09-14,506,monitor,3249,8000,4751,1,00413,India
957571,2023-09-14,507,washing machine,6990,16490,9500,1,00413,India
957571,2023-09-14,503,mixer,1349,3249,1900,1,00413,India
957571,2023-09-14,505,oven,18490,24000,5510,1,00413,India
957571,2023-09-14,501,iphone 15,60000,80000,20000,1,00413,India
923038,2023-09-14,505,oven,18490,24000,5510,1,00311,India
923038,2023-09-14,502,iphone 15 pro max,100000,135000,35000,1,00311,India
923038,2023-09-14,507,washing machine,6990,16490,9500,1,00311,India
923038,2023-09-14,504,iron,449,879,430,1,00311,India
740406,2023-09-14,502,iphone 15 pro max,100000,135000,35000,1,00328,India
740406,2023-09-14,506,monitor,3249,8000,4751,1,00328,India
950612,2023-09-14,502,iphone 15 pro max,100000,135000,35000,1,00413,India
950612,2023-09-14,505,oven,18490,24000,5510,1,00413,India
322637,2023-09-14,504,iron,449,879,430,1,00214,India
557770,2023-09-14,501,iphone 15,60000,80000,20000,1,00076,India
557770,2023-09-14,502,iphone 15 pro max,100000,135000,35000,1,00076,India
239944,2023-09-14,503,mixer,1349,3249,1900,1,00114,India
239944,2023-09-14,504,iron,449,879,430,1,00114,India
999519,2023-09-14,506,monitor,3249,8000,4751,1,00107,India
999519,2023-09-14,501,iphone 15,60000,80000,20000,1,00107,India
999519,2023-09-14,504,iron,449,879,430,1,00107,India
699101,2023-09-14,504,iron,449,879,430,1,00070,India
699101,2023-09-14,506,monitor,3249,8000,4751,1,00070,India
699101,2023-09-14,505,oven,18490,24000,5510,1,00070,India
699101,2023-09-14,503,mixer,1349,3249,1900,1,00070,India
916202,2023-09-14,507,washing machine,6990,16490,9500,1,00480,India
651003,2023-09-14,506,monitor,3249,8000,4751,1,00177,India
651003,2023-09-14,507,washing machine,6990,16490,9500,1,00177,India
304114,2023-09-14,507,washing machine,6990,16490,9500,1,00391,India
304114,2023-09-14,502,iphone 15 pro max,100000,135000,35000,1,00391,India
824026,2023-09-14,505,oven,18490,24000,5510,1,00147,India
824026,2023-09-14,502,iphone 15 pro max,100000,135000,35000,1,00147,India
824026,2023-09-14,506,monitor,3249,8000,4751,1,00147,India
691324,2023-09-14,502,iphone 15 pro max,100000,135000,35000,1,00263,India
691324,2023-09-14,504,iron,449,879,430,1,00263,India
691324,2023-09-14,503,mixer,1349,3249,1900,1,00263,India
691324,2023-09-14,501,iphone 15,60000,80000,20000,1,00263,India
732054,2023-09-14,507,washing machine,6990,16490,9500,1,00495,India
732054,2023-09-14,505,oven,18490,24000,5510,1,00495,India
732054,2023-09-14,506,monitor,3249,8000,4751,1,00495,India
600424,2023-09-14,501,iphone 15,60000,80000,20000,1,00195,India
113282,2023-09-14,503,mixer,1349,3249,1900,1,00398,India
113282,2023-09-14,501,iphone 15,60000,80000,20000,1,00398,India
169633,2023-09-14,502,iphone 15 pro max,100000,135000,35000,1,00303,India
169633,2023-09-14,504,iron,449,879,430,1,00303,India
169633,2023-09-14,505,oven,18490,24000,5510,1,00303,India
878898,2023-09-14,506,monitor,3249,8000,4751,1,00101,India
878898,2023-09-14,502,iphone 15 pro max,100000,135000,35000,1,00101,India
878898,2023-09-14,504,iron,449,879,430,1,00101,India
611805,2023-09-14,502,iphone 15 pro max,100000,135000,35000,1,00050,India
611805,2023-09-14,505,oven,18490,24000,5510,1,00050,India
611805,2023-09-14,507,washing machine,6990,16490,9500,1,00050,India
964691,2023-09-14,501,iphone 15,60000,80000,20000,1,00311,India
964691,2023-09-14,507,washing machine,6990,16490,9500,1,00311,India
964691,2023-09-14,506,monitor,3249,8000,4751,1,00311,India
857535,2023-09-14,507,washing machine,6990,16490,9500,1,00088,India
857535,2023-09-14,503,mixer,1349,3249,1900,1,00088,India
277872,2023-09-14,505,oven,18490,24000,5510,1,00032,India
670521,2023-09-14,505,oven,18490,24000,5510,1,00173,India
670521,2023-09-14,504,iron,449,879,430,1,00173,India
894023,2023-09-14,504,iron,449,879,430,1,00126,India
894023,2023-09-14,501,iphone 15,60000,80000,20000,1,00126,India
912288,2023-09-14,506,monitor,3249,8000,4751,1,00188,India
912288,2023-09-14,501,iphone 15,60000,80000,20000,1,00188,India
959774,2023-09-14,502,iphone 15 pro max,100000,135000,35000,1,00231,India
959774,2023-09-14,501,iphone 15,60000,80000,20000,1,00231,India
959774,2023-09-14,505,oven,18490,24000,5510,1,00231,India
421725,2023-09-14,503,mixer,1349,3249,1900,1,00250,India
421725,2023-09-14,506,monitor,3249,8000,4751,1,00250,India
421725,2023-09-14,504,iron,449,879,430,1,00250,India
282479,2023-09-14,501,iphone 15,60000,80000,20000,1,00288,India
282479,2023-09-14,506,monitor,3249,8000,4751,1,00288,India
282479,2023-09-14,503,mixer,1349,3249,1900,1,00288,India
873001,2023-09-14,506,monitor,3249,8000,4751,1,00469,India
873001,2023-09-14,502,iphone 15 pro max,100000,135000,35000,1,00469,India
873001,2023-09-14,507,washing machine,6990,16490,9500,1,00469,India
945027,2023-09-14,503,mixer,1349,3249,1900,1,00235,India
945027,2023-09-14,507,washing machine,6990,16490,9500,1,00235,India
945027,2023-09-14,506,monitor,3249,8000,4751,1,00235,India
945027,2023-09-14,502,iphone 15 pro max,100000,135000,35000,1,00235,India
841189,2023-09-14,505,oven,18490,24000,5510,1,00350,India
841189,2023-09-14,506,monitor,3249,8000,4751,1,00350,India
841189,2023-09-14,502,iphone 15 pro max,100000,135000,35000,1,00350,India
442282,2023-09-14,503,mixer,1349,3249,1900,1,00139,India
442282,2023-09-14,505,oven,18490,24000,5510,1,00139,India
490081,2023-09-14,505,oven,18490,24000,5510,1,00200,India
490081,2023-09-14,502,iphone 15 pro max,100000,135000,35000,1,00200,India
490081,2023-09-14,503,mixer,1349,3249,1900,1,00200,India
490081,2023-09-14,506,monitor,3249,8000,4751,1,00200,India
924409,2023-09-14,503,mixer,1349,3249,1900,1,00129,India
924409,2023-09-14,502,iphone 15 pro max,100000,135000,35000,1,00129,India
924409,2023-09-14,506,monitor,3249,8000,4751,1,00129,India
924409,2023-09-14,501,iphone 15,60000,80000,20000,1,00129,India
570930,2023-09-14,504,iron,449,879,430,1,00392,India
151065,2023-09-14,501,iphone 15,60000,80000,20000,1,00492,India
151065,2023-09-14,507,washing machine,6990,16490,9500,1,00492,India
151065,2023-09-14,505,oven,18490,24000,5510,1,00492,India
151065,2023-09-14,504,iron,449,879,430,1,00492,India
769438,2023-09-14,507,washing machine,6990,16490,9500,1,00241,India
769438,2023-09-14,506,monitor,3249,8000,4751,1,00241,India
769438,2023-09-14,502,iphone 15 pro max,100000,135000,35000,1,00241,India
941146,2023-09-14,505,oven,18490,24000,5510,1,00359,India
941146,2023-09-14,506,monitor,3249,8000,4751,1,00359,India
941146,2023-09-14,502,iphone 15 pro max,100000,135000,35000,1,00359,India
515590,2023-09-14,502,iphone 15 pro max,100000,135000,35000,1,00186,India
515590,2023-09-14,501,iphone 15,60000,80000,20000,1,00186,India
631989,2023-09-14,505,oven,18490,24000,5510,1,00482,India
631989,2023-09-14,502,iphone 15 pro max,100000,135000,35000,1,00482,India
631989,2023-09-14,504,iron,449,879,430,1,00482,India
296854,2023-09-14,501,iphone 15,60000,80000,20000,1,00191,India
296854,2023-09-14,505,oven,18490,24000,5510,1,00191,India
296854,2023-09-14,503,mixer,1349,3249,1900,1,00191,India
540550,2023-09-14,507,washing machine,6990,16490,9500,1,00390,India
944072,2023-09-14,505,oven,18490,24000,5510,1,00091,India
944072,2023-09-14,504,iron,449,879,430,1,00091,India
654822,2023-09-14,507,washing machine,6990,16490,9500,1,00298,India
654822,2023-09-14,503,mixer,1349,3249,1900,1,00298,India
518756,2023-09-14,505,oven,18490,24000,5510,1,00068,India
518756,2023-09-14,507,washing machine,6990,16490,9500,1,00068,India
761579,2023-09-14,502,iphone 15 pro max,100000,135000,35000,1,00172,India
801448,2023-09-14,503,mixer,1349,3249,1900,1,00300,India
801448,2023-09-14,506,monitor,3249,8000,4751,1,00300,India
801448,2023-09-14,504,iron,449,879,430,1,00300,India
648876,2023-09-14,503,mixer,1349,3249,1900,1,00458,India
648876,2023-09-14,501,iphone 15,60000,80000,20000,1,00458,India
648876,2023-09-14,502,iphone 15 pro max,100000,135000,35000,1,00458,India
648876,2023-09-14,505,oven,18490,24000,5510,1,00458,India
412070,2023-09-14,505,oven,18490,24000,5510,1,00441,India
412070,2023-09-14,507,washing machine,6990,16490,9500,1,00441,India
412070,2023-09-14,501,iphone 15,60000,80000,20000,1,00441,India
412070,2023-09-14,503,mixer,1349,3249,1900,1,00441,India
317386,2023-09-14,501,iphone 15,60000,80000,20000,1,00051,India
317386,2023-09-14,505,oven,18490,24000,5510,1,00051,India
317386,2023-09-14,503,mixer,1349,3249,1900,1,00051,India
810122,2023-09-14,504,iron,449,879,430,1,00396,India
810122,2023-09-14,506,monitor,3249,8000,4751,1,00396,India
810122,2023-09-14,501,iphone 15,60000,80000,20000,1,00396,India
810122,2023-09-14,507,washing machine,6990,16490,9500,1,00396,India
841606,2023-09-14,505,oven,18490,24000,5510,1,00167,India
743023,2023-09-14,504,iron,449,879,430,1,00293,India
743023,2023-09-14,506,monitor,3249,8000,4751,1,00293,India
743023,2023-09-14,501,iphone 15,60000,80000,20000,1,00293,India
107522,2023-09-14,506,monitor,3249,8000,4751,1,00388,India
107522,2023-09-14,507,washing machine,6990,16490,9500,1,00388,India
424737,2023-09-14,505,oven,18490,24000,5510,1,00113,India
742816,2023-09-14,504,iron,449,879,430,1,00293,India
742816,2023-09-14,502,iphone 15 pro max,100000,135000,35000,1,00293,India
857485,2023-09-14,507,washing machine,6990,16490,9500,1,00197,India
857485,2023-09-14,503,mixer,1349,3249,1900,1,00197,India
857485,2023-09-14,502,iphone 15 pro max,100000,135000,35000,1,00197,India
857485,2023-09-14,504,iron,449,879,430,1,00197,India
861793,2023-09-14,504,iron,449,879,430,1,00409,India
861793,2023-09-14,505,oven,18490,24000,5510,1,00409,India
446473,2023-09-14,503,mixer,1349,3249,1900,1,00196,India
446473,2023-09-14,501,iphone 15,60000,80000,20000,1,00196,India
446473,2023-09-14,504,iron,449,879,430,1,00196,India
585113,2023-09-14,504,iron,449,879,430,1,00477,India
126857,2023-09-14,505,oven,18490,24000,5510,1,00423,India
515886,2023-09-14,504,iron,449,879,430,1,00487,India
515886,2023-09-14,503,mixer,1349,3249,1900,1,00487,India
932472,2023-09-14,505,oven,18490,24000,5510,1,00209,India
932472,2023-09-14,507,washing machine,6990,16490,9500,1,00209,India
932472,2023-09-14,502,iphone 15 pro max,100000,135000,35000,1,00209,India
660574,2023-09-14,502,iphone 15 pro max,100000,135000,35000,1,00121,India
660574,2023-09-14,506,monitor,3249,8000,4751,1,00121,India
387989,2023-09-14,503,mixer,1349,3249,1900,1,00103,India
387989,2023-09-14,501,iphone 15,60000,80000,20000,1,00103,India
387989,2023-09-14,504,iron,449,879,430,1,00103,India
734612,2023-09-14,505,oven,18490,24000,5510,1,00141,India
734612,2023-09-14,503,mixer,1349,3249,1900,1,00141,India
734612,2023-09-14,506,monitor,3249,8000,4751,1,00141,India
734612,2023-09-14,501,iphone 15,60000,80000,20000,1,00141,India
398680,2023-09-14,502,iphone 15 pro max,100000,135000,35000,1,00294,India
398680,2023-09-14,504,iron,449,879,430,1,00294,India
398680,2023-09-14,506,monitor,3249,8000,4751,1,00294,India
398680,2023-09-14,503,mixer,1349,3249,1900,1,00294,India
141426,2023-09-14,506,monitor,3249,8000,4751,1,00359,India
141426,2023-09-14,502,iphone 15 pro max,100000,135000,35000,1,00359,India
281925,2023-09-14,503,mixer,1349,3249,1900,1,00427,India
281925,2023-09-14,501,iphone 15,60000,80000,20000,1,00427,India
281925,2023-09-14,504,iron,449,879,430,1,00427,India
281925,2023-09-14,505,oven,18490,24000,5510,1,00427,India
847259,2023-09-14,502,iphone 15 pro max,100000,135000,35000,1,00313,India
847259,2023-09-14,503,mixer,1349,3249,1900,1,00313,India
847259,2023-09-14,504,iron,449,879,430,1,00313,India
847259,2023-09-14,507,washing machine,6990,16490,9500,1,00313,India
979028,2023-09-14,503,mixer,1349,3249,1900,1,00396,India
979028,2023-09-14,506,monitor,3249,8000,4751,1,00396,India
298391,2023-09-14,506,monitor,3249,8000,4751,1,00173,India
298391,2023-09-14,504,iron,449,879,430,1,00173,India
298391,2023-09-14,507,washing machine,6990,16490,9500,1,00173,India
857125,2023-09-14,504,iron,449,879,430,1,00421,India
857125,2023-09-14,506,monitor,3249,8000,4751,1,00421,India
857125,2023-09-14,505,oven,18490,24000,5510,1,00421,India
721001,2023-09-14,505,oven,18490,24000,5510,1,00173,India
721001,2023-09-14,504,iron,449,879,430,1,00173,India
772048,2023-09-14,502,iphone 15 pro max,100000,135000,35000,1,00030,India
772048,2023-09-14,501,iphone 15,60000,80000,20000,1,00030,India
772048,2023-09-14,503,mixer,1349,3249,1900,1,00030,India
772048,2023-09-14,506,monitor,3249,8000,4751,1,00030,India
772048,2023-09-14,507,washing machine,6990,16490,9500,1,00030,India
909684,2023-09-14,503,mixer,1349,3249,1900,1,00134,India
909684,2023-09-14,504,iron,449,879,430,1,00134,India
389060,2023-09-14,506,monitor,3249,8000,4751,1,00391,India
755430,2023-09-14,504,iron,449,879,430,1,00031,India
755430,2023-09-14,503,mixer,1349,3249,1900,1,00031,India
755430,2023-09-14,501,iphone 15,60000,80000,20000,1,00031,India
918754,2023-09-14,503,mixer,1349,3249,1900,1,00239,India
918754,2023-09-14,502,iphone 15 pro max,100000,135000,35000,1,00239,India
358434,2023-09-14,502,iphone 15 pro max,100000,135000,35000,1,00051,India
358434,2023-09-14,505,oven,18490,24000,5510,1,00051,India
358434,2023-09-14,501,iphone 15,60000,80000,20000,1,00051,India
448500,2023-09-14,502,iphone 15 pro max,100000,135000,35000,1,00173,India
448500,2023-09-14,507,washing machine,6990,16490,9500,1,00173,India
448500,2023-09-14,506,monitor,3249,8000,4751,1,00173,India
665604,2023-09-14,504,iron,449,879,430,1,00036,India
665604,2023-09-14,507,washing machine,6990,16490,9500,1,00036,India
665604,2023-09-14,502,iphone 15 pro max,100000,135000,35000,1,00036,India
590056,2023-09-14,502,iphone 15 pro max,100000,135000,35000,1,00068,India
590056,2023-09-14,504,iron,449,879,430,1,00068,India
590056,2023-09-14,503,mixer,1349,3249,1900,1,00068,India
590056,2023-09-14,506,monitor,3249,8000,4751,1,00068,India
504493,2023-09-14,505,oven,18490,24000,5510,1,00071,India
504493,2023-09-14,507,washing machine,6990,16490,9500,1,00071,India
504493,2023-09-14,503,mixer,1349,3249,1900,1,00071,India
504493,2023-09-14,504,iron,449,879,430,1,00071,India
209758,2023-09-14,506,monitor,3249,8000,4751,1,00146,India
209758,2023-09-14,501,iphone 15,60000,80000,20000,1,00146,India
209758,2023-09-14,504,iron,449,879,430,1,00146,India
710070,2023-09-14,507,washing machine,6990,16490,9500,1,00251,India
710070,2023-09-14,505,oven,18490,24000,5510,1,00251,India
710070,2023-09-14,503,mixer,1349,3249,1900,1,00251,India
710070,2023-09-14,502,iphone 15 pro max,100000,135000,35000,1,00251,India
710070,2023-09-14,501,iphone 15,60000,80000,20000,1,00251,India
615419,2023-09-14,507,washing machine,6990,16490,9500,1,00104,India
927653,2023-09-14,502,iphone 15 pro max,100000,135000,35000,1,00344,India
927653,2023-09-14,507,washing machine,6990,16490,9500,1,00344,India
527577,2023-09-14,504,iron,449,879,430,1,00011,India
527577,2023-09-14,505,oven,18490,24000,5510,1,00011,India
527577,2023-09-14,502,iphone 15 pro max,100000,135000,35000,1,00011,India
527577,2023-09-14,503,mixer,1349,3249,1900,1,00011,India
331309,2023-09-14,503,mixer,1349,3249,1900,1,00292,India
331309,2023-09-14,501,iphone 15,60000,80000,20000,1,00292,India
160097,2023-09-14,504,iron,449,879,430,1,00444,India
160097,2023-09-14,507,washing machine,6990,16490,9500,1,00444,India
247665,2023-09-14,506,monitor,3249,8000,4751,1,00242,India
822972,2023-09-14,504,iron,449,879,430,1,00404,India
822972,2023-09-14,507,washing machine,6990,16490,9500,1,00404,India
250077,2023-09-14,504,iron,449,879,430,1,00207,India
155822,2023-09-15,507,washing machine,6990,16490,9500,1,00064,India
155822,2023-09-15,505,oven,18490,24000,5510,1,00064,India
911022,2023-09-15,506,monitor,3249,8000,4751,1,00247,India
911022,2023-09-15,504,iron,449,879,430,1,00247,India
672814,2023-09-15,501,iphone 15,60000,80000,20000,1,00170,India
672814,2023-09-15,507,washing machine,6990,16490,9500,1,00170,India
729607,2023-09-15,503,mixer,1349,3249,1900,1,00389,India
729607,2023-09-15,507,washing machine,6990,16490,9500,1,00389,India
729607,2023-09-15,504,iron,449,879,430,1,00389,India
574505,2023-09-15,502,iphone 15 pro max,100000,135000,35000,1,00451,India
173820,2023-09-15,506,monitor,3249,8000,4751,1,00442,India
228701,2023-09-15,507,washing machine,6990,16490,9500,1,00399,India
228701,2023-09-15,502,iphone 15 pro max,100000,135000,35000,1,00399,India
228701,2023-09-15,501,iphone 15,60000,80000,20000,1,00399,India
228701,2023-09-15,506,monitor,3249,8000,4751,1,00399,India
470932,2023-09-15,503,mixer,1349,3249,1900,1,00133,India
470932,2023-09-15,504,iron,449,879,430,1,00133,India
866020,2023-09-15,501,iphone 15,60000,80000,20000,1,00107,India
866020,2023-09-15,503,mixer,1349,3249,1900,1,00107,India
221049,2023-09-15,503,mixer,1349,3249,1900,1,00195,India
221049,2023-09-15,507,washing machine,6990,16490,9500,1,00195,India
722918,2023-09-15,502,iphone 15 pro max,100000,135000,35000,1,00075,India
722918,2023-09-15,506,monitor,3249,8000,4751,1,00075,India
722918,2023-09-15,507,washing machine,6990,16490,9500,1,00075,India
722918,2023-09-15,504,iron,449,879,430,1,00075,India
205461,2023-09-15,504,iron,449,879,430,1,00051,India
205461,2023-09-15,502,iphone 15 pro max,100000,135000,35000,1,00051,India
205461,2023-09-15,505,oven,18490,24000,5510,1,00051,India
205461,2023-09-15,507,washing machine,6990,16490,9500,1,00051,India
383694,2023-09-15,505,oven,18490,24000,5510,1,00420,India
293235,2023-09-15,504,iron,449,879,430,1,00046,India
293235,2023-09-15,505,oven,18490,24000,5510,1,00046,India
293235,2023-09-15,503,mixer,1349,3249,1900,1,00046,India
293235,2023-09-15,506,monitor,3249,8000,4751,1,00046,India
211992,2023-09-15,503,mixer,1349,3249,1900,1,00278,India
211992,2023-09-15,505,oven,18490,24000,5510,1,00278,India
211992,2023-09-15,506,monitor,3249,8000,4751,1,00278,India
303836,2023-09-15,507,washing machine,6990,16490,9500,1,00095,India
303836,2023-09-15,502,iphone 15 pro max,100000,135000,35000,1,00095,India
303836,2023-09-15,503,mixer,1349,3249,1900,1,00095,India
303836,2023-09-15,505,oven,18490,24000,5510,1,00095,India
563588,2023-09-15,501,iphone 15,60000,80000,20000,1,00413,India
563588,2023-09-15,506,monitor,3249,8000,4751,1,00413,India
563588,2023-09-15,504,iron,449,879,430,1,00413,India
563588,2023-09-15,507,washing machine,6990,16490,9500,1,00413,India
724563,2023-09-15,507,washing machine,6990,16490,9500,1,00412,India
883067,2023-09-15,503,mixer,1349,3249,1900,1,00090,India
883067,2023-09-15,502,iphone 15 pro max,100000,135000,35000,1,00090,India
883067,2023-09-15,506,monitor,3249,8000,4751,1,00090,India
527464,2023-09-15,506,monitor,3249,8000,4751,1,00357,India
527464,2023-09-15,504,iron,449,879,430,1,00357,India
527464,2023-09-15,502,iphone 15 pro max,100000,135000,35000,1,00357,India
750147,2023-09-15,504,iron,449,879,430,1,00472,India
842066,2023-09-15,504,iron,449,879,430,1,00271,India
842066,2023-09-15,502,iphone 15 pro max,100000,135000,35000,1,00271,India
367602,2023-09-15,501,iphone 15,60000,80000,20000,1,00466,India
367602,2023-09-15,503,mixer,1349,3249,1900,1,00466,India
367602,2023-09-15,507,washing machine,6990,16490,9500,1,00466,India
817808,2023-09-15,502,iphone 15 pro max,100000,135000,35000,1,00027,India
817808,2023-09-15,506,monitor,3249,8000,4751,1,00027,India
817808,2023-09-15,503,mixer,1349,3249,1900,1,00027,India
783128,2023-09-15,506,monitor,3249,8000,4751,1,00497,India
783128,2023-09-15,505,oven,18490,24000,5510,1,00497,India
783128,2023-09-15,501,iphone 15,60000,80000,20000,1,00497,India
746021,2023-09-15,501,iphone 15,60000,80000,20000,1,00470,India
746021,2023-09-15,507,washing machine,6990,16490,9500,1,00470,India
746021,2023-09-15,506,monitor,3249,8000,4751,1,00470,India
650637,2023-09-15,503,mixer,1349,3249,1900,1,00324,India
533288,2023-09-15,504,iron,449,879,430,1,00069,India
533288,2023-09-15,503,mixer,1349,3249,1900,1,00069,India
334056,2023-09-15,504,iron,449,879,430,1,00009,India
334056,2023-09-15,506,monitor,3249,8000,4751,1,00009,India
334056,2023-09-15,505,oven,18490,24000,5510,1,00009,India
768114,2023-09-15,506,monitor,3249,8000,4751,1,00414,India
768114,2023-09-15,502,iphone 15 pro max,100000,135000,35000,1,00414,India
561185,2023-09-15,504,iron,449,879,430,1,00025,India
561185,2023-09-15,501,iphone 15,60000,80000,20000,1,00025,India
561185,2023-09-15,503,mixer,1349,3249,1900,1,00025,India
561185,2023-09-15,505,oven,18490,24000,5510,1,00025,India
703514,2023-09-15,505,oven,18490,24000,5510,1,00246,India
703514,2023-09-15,501,iphone 15,60000,80000,20000,1,00246,India
703514,2023-09-15,507,washing machine,6990,16490,9500,1,00246,India
205841,2023-09-15,501,iphone 15,60000,80000,20000,1,00464,India
205841,2023-09-15,503,mixer,1349,3249,1900,1,00464,India
861765,2023-09-15,501,iphone 15,60000,80000,20000,1,00121,India
861765,2023-09-15,505,oven,18490,24000,5510,1,00121,India
999200,2023-09-15,505,oven,18490,24000,5510,1,00309,India
999200,2023-09-15,502,iphone 15 pro max,100000,135000,35000,1,00309,India
999200,2023-09-15,501,iphone 15,60000,80000,20000,1,00309,India
999200,2023-09-15,503,mixer,1349,3249,1900,1,00309,India
973209,2023-09-15,504,iron,449,879,430,1,00163,India
973209,2023-09-15,507,washing machine,6990,16490,9500,1,00163,India
281811,2023-09-15,502,iphone 15 pro max,100000,135000,35000,1,00306,India
281811,2023-09-15,503,mixer,1349,3249,1900,1,00306,India
281811,2023-09-15,507,washing machine,6990,16490,9500,1,00306,India
281811,2023-09-15,504,iron,449,879,430,1,00306,India
962894,2023-09-15,503,mixer,1349,3249,1900,1,00462,India
962894,2023-09-15,504,iron,449,879,430,1,00462,India
102090,2023-09-15,501,iphone 15,60000,80000,20000,1,00316,India
102090,2023-09-15,507,washing machine,6990,16490,9500,1,00316,India
592306,2023-09-15,506,monitor,3249,8000,4751,1,00097,India
592306,2023-09-15,503,mixer,1349,3249,1900,1,00097,India
592306,2023-09-15,507,washing machine,6990,16490,9500,1,00097,India
711221,2023-09-15,503,mixer,1349,3249,1900,1,00066,India
711221,2023-09-15,502,iphone 15 pro max,100000,135000,35000,1,00066,India
652713,2023-09-15,502,iphone 15 pro max,100000,135000,35000,1,00039,India
652713,2023-09-15,505,oven,18490,24000,5510,1,00039,India
652713,2023-09-15,507,washing machine,6990,16490,9500,1,00039,India
652713,2023-09-15,501,iphone 15,60000,80000,20000,1,00039,India
980836,2023-09-15,506,monitor,3249,8000,4751,1,00150,India
980836,2023-09-15,507,washing machine,6990,16490,9500,1,00150,India
269401,2023-09-15,502,iphone 15 pro max,100000,135000,35000,1,00489,India
269401,2023-09-15,507,washing machine,6990,16490,9500,1,00489,India
269401,2023-09-15,504,iron,449,879,430,1,00489,India
269401,2023-09-15,505,oven,18490,24000,5510,1,00489,India
269401,2023-09-15,503,mixer,1349,3249,1900,1,00489,India
619491,2023-09-15,501,iphone 15,60000,80000,20000,1,00409,India
619491,2023-09-15,507,washing machine,6990,16490,9500,1,00409,India
619491,2023-09-15,503,mixer,1349,3249,1900,1,00409,India
966732,2023-09-15,504,iron,449,879,430,1,00489,India
966732,2023-09-15,501,iphone 15,60000,80000,20000,1,00489,India
699119,2023-09-15,504,iron,449,879,430,1,00430,India
699119,2023-09-15,506,monitor,3249,8000,4751,1,00430,India
699119,2023-09-15,501,iphone 15,60000,80000,20000,1,00430,India
492534,2023-09-15,506,monitor,3249,8000,4751,1,00115,India
492534,2023-09-15,504,iron,449,879,430,1,00115,India
492534,2023-09-15,505,oven,18490,24000,5510,1,00115,India
993729,2023-09-15,503,mixer,1349,3249,1900,1,00470,India
906727,2023-09-15,503,mixer,1349,3249,1900,1,00345,India
906727,2023-09-15,505,oven,18490,24000,5510,1,00345,India
798626,2023-09-15,503,mixer,1349,3249,1900,1,00221,India
798626,2023-09-15,507,washing machine,6990,16490,9500,1,00221,India
798626,2023-09-15,501,iphone 15,60000,80000,20000,1,00221,India
899868,2023-09-15,505,oven,18490,24000,5510,1,00160,India
899868,2023-09-15,502,iphone 15 pro max,100000,135000,35000,1,00160,India
300828,2023-09-15,504,iron,449,879,430,1,00260,India
300828,2023-09-15,506,monitor,3249,8000,4751,1,00260,India
300828,2023-09-15,507,washing machine,6990,16490,9500,1,00260,India
757902,2023-09-15,502,iphone 15 pro max,100000,135000,35000,1,00482,India
601013,2023-09-15,503,mixer,1349,3249,1900,1,00335,India
601013,2023-09-15,501,iphone 15,60000,80000,20000,1,00335,India
601013,2023-09-15,502,iphone 15 pro max,100000,135000,35000,1,00335,India
601013,2023-09-15,506,monitor,3249,8000,4751,1,00335,India
601013,2023-09-15,505,oven,18490,24000,5510,1,00335,India
316868,2023-09-15,506,monitor,3249,8000,4751,1,00284,India
158583,2023-09-15,504,iron,449,879,430,1,00330,India
158583,2023-09-15,503,mixer,1349,3249,1900,1,00330,India
158583,2023-09-15,506,monitor,3249,8000,4751,1,00330,India
116016,2023-09-15,506,monitor,3249,8000,4751,1,00302,India
116016,2023-09-15,505,oven,18490,24000,5510,1,00302,India
116016,2023-09-15,502,iphone 15 pro max,100000,135000,35000,1,00302,India
680032,2023-09-15,501,iphone 15,60000,80000,20000,1,00308,India
680032,2023-09-15,502,iphone 15 pro max,100000,135000,35000,1,00308,India
680032,2023-09-15,507,washing machine,6990,16490,9500,1,00308,India
680032,2023-09-15,505,oven,18490,24000,5510,1,00308,India
661742,2023-09-15,506,monitor,3249,8000,4751,1,00308,India
661742,2023-09-15,505,oven,18490,24000,5510,1,00308,India
661742,2023-09-15,504,iron,449,879,430,1,00308,India
611012,2023-09-15,507,washing machine,6990,16490,9500,1,00453,India
236715,2023-09-15,506,monitor,3249,8000,4751,1,00301,India
236715,2023-09-15,501,iphone 15,60000,80000,20000,1,00301,India
236715,2023-09-15,505,oven,18490,24000,5510,1,00301,India
236715,2023-09-15,503,mixer,1349,3249,1900,1,00301,India
709051,2023-09-15,506,monitor,3249,8000,4751,1,00296,India
709051,2023-09-15,501,iphone 15,60000,80000,20000,1,00296,India
346590,2023-09-15,504,iron,449,879,430,1,00437,India
213049,2023-09-15,504,iron,449,879,430,1,00295,India
213049,2023-09-15,503,mixer,1349,3249,1900,1,00295,India
213049,2023-09-15,507,washing machine,6990,16490,9500,1,00295,India
999429,2023-09-15,507,washing machine,6990,16490,9500,1,00274,India
999429,2023-09-15,501,iphone 15,60000,80000,20000,1,00274,India
999429,2023-09-15,502,iphone 15 pro max,100000,135000,35000,1,00274,India
101215,2023-09-15,503,mixer,1349,3249,1900,1,00021,India
101215,2023-09-15,506,monitor,3249,8000,4751,1,00021,India
101215,2023-09-15,504,iron,449,879,430,1,00021,India
101215,2023-09-15,502,iphone 15 pro max,100000,135000,35000,1,00021,India
784425,2023-09-15,507,washing machine,6990,16490,9500,1,00360,India
784425,2023-09-15,501,iphone 15,60000,80000,20000,1,00360,India
893010,2023-09-15,506,monitor,3249,8000,4751,1,00122,India
893010,2023-09-15,501,iphone 15,60000,80000,20000,1,00122,India
893010,2023-09-15,503,mixer,1349,3249,1900,1,00122,India
893010,2023-09-15,507,washing machine,6990,16490,9500,1,00122,India
756595,2023-09-15,507,washing machine,6990,16490,9500,1,00122,India
756595,2023-09-15,502,iphone 15 pro max,100000,135000,35000,1,00122,India
756595,2023-09-15,506,monitor,3249,8000,4751,1,00122,India
756595,2023-09-15,505,oven,18490,24000,5510,1,00122,India
984522,2023-09-15,502,iphone 15 pro max,100000,135000,35000,1,00150,India
108552,2023-09-15,503,mixer,1349,3249,1900,1,00411,India
108552,2023-09-15,505,oven,18490,24000,5510,1,00411,India
719407,2023-09-15,505,oven,18490,24000,5510,1,00338,India
719407,2023-09-15,503,mixer,1349,3249,1900,1,00338,India
719407,2023-09-15,506,monitor,3249,8000,4751,1,00338,India
244011,2023-09-15,505,oven,18490,24000,5510,1,00349,India
244011,2023-09-15,506,monitor,3249,8000,4751,1,00349,India
244011,2023-09-15,503,mixer,1349,3249,1900,1,00349,India
244011,2023-09-15,507,washing machine,6990,16490,9500,1,00349,India
437854,2023-09-15,501,iphone 15,60000,80000,20000,1,00079,India
437854,2023-09-15,507,washing machine,6990,16490,9500,1,00079,India
783767,2023-09-15,501,iphone 15,60000,80000,20000,1,00046,India
783767,2023-09-15,504,iron,449,879,430,1,00046,India
783767,2023-09-15,505,oven,18490,24000,5510,1,00046,India
783767,2023-09-15,507,washing machine,6990,16490,9500,1,00046,India
783767,2023-09-15,502,iphone 15 pro max,100000,135000,35000,1,00046,India
599356,2023-09-15,507,washing machine,6990,16490,9500,1,00351,India
136884,2023-09-15,501,iphone 15,60000,80000,20000,1,00027,India
591316,2023-09-15,506,monitor,3249,8000,4751,1,00100,India
591316,2023-09-15,504,iron,449,879,430,1,00100,India
591316,2023-09-15,503,mixer,1349,3249,1900,1,00100,India
591316,2023-09-15,502,iphone 15 pro max,100000,135000,35000,1,00100,India
591316,2023-09-15,507,washing machine,6990,16490,9500,1,00100,India
114873,2023-09-15,503,mixer,1349,3249,1900,1,00424,India
386298,2023-09-15,501,iphone 15,60000,80000,20000,1,00173,India
386298,2023-09-15,504,iron,449,879,430,1,00173,India
386298,2023-09-15,502,iphone 15 pro max,100000,135000,35000,1,00173,India
386298,2023-09-15,503,mixer,1349,3249,1900,1,00173,India
405468,2023-09-15,504,iron,449,879,430,1,00219,India
405468,2023-09-15,506,monitor,3249,8000,4751,1,00219,India
512059,2023-09-15,501,iphone 15,60000,80000,20000,1,00236,India
512059,2023-09-15,505,oven,18490,24000,5510,1,00236,India
512059,2023-09-15,507,washing machine,6990,16490,9500,1,00236,India
267917,2023-09-15,506,monitor,3249,8000,4751,1,00214,India
362989,2023-09-15,505,oven,18490,24000,5510,1,00230,India
362989,2023-09-15,507,washing machine,6990,16490,9500,1,00230,India
362989,2023-09-15,501,iphone 15,60000,80000,20000,1,00230,India
362989,2023-09-15,503,mixer,1349,3249,1900,1,00230,India
204518,2023-09-15,505,oven,18490,24000,5510,1,00036,India
508804,2023-09-15,505,oven,18490,24000,5510,1,00417,India
246727,2023-09-15,503,mixer,1349,3249,1900,1,00075,India
246727,2023-09-15,506,monitor,3249,8000,4751,1,00075,India
246727,2023-09-15,502,iphone 15 pro max,100000,135000,35000,1,00075,India
600266,2023-09-15,505,oven,18490,24000,5510,1,00166,India
600266,2023-09-15,507,washing machine,6990,16490,9500,1,00166,India
763721,2023-09-15,505,oven,18490,24000,5510,1,00338,India
557495,2023-09-16,507,washing machine,6990,16490,9500,1,00123,India
436369,2023-09-16,507,washing machine,6990,16490,9500,1,00096,India
436369,2023-09-16,504,iron,449,879,430,1,00096,India
976055,2023-09-16,502,iphone 15 pro max,100000,135000,35000,1,00161,India
976055,2023-09-16,506,monitor,3249,8000,4751,1,00161,India
976055,2023-09-16,507,washing machine,6990,16490,9500,1,00161,India
785867,2023-09-16,505,oven,18490,24000,5510,1,00214,India
785867,2023-09-16,507,washing machine,6990,16490,9500,1,00214,India
785867,2023-09-16,502,iphone 15 pro max,100000,135000,35000,1,00214,India
247915,2023-09-16,506,monitor,3249,8000,4751,1,00359,India
247915,2023-09-16,504,iron,449,879,430,1,00359,India
247915,2023-09-16,507,washing machine,6990,16490,9500,1,00359,India
247915,2023-09-16,502,iphone 15 pro max,100000,135000,35000,1,00359,India
374449,2023-09-16,503,mixer,1349,3249,1900,1,00321,India
374449,2023-09-16,506,monitor,3249,8000,4751,1,00321,India
374449,2023-09-16,501,iphone 15,60000,80000,20000,1,00321,India
374449,2023-09-16,505,oven,18490,24000,5510,1,00321,India
779768,2023-09-16,501,iphone 15,60000,80000,20000,1,00314,India
364529,2023-09-16,502,iphone 15 pro max,100000,135000,35000,1,00100,India
750677,2023-09-16,505,oven,18490,24000,5510,1,00299,India
750677,2023-09-16,504,iron,449,879,430,1,00299,India
293194,2023-09-16,503,mixer,1349,3249,1900,1,00426,India
293194,2023-09-16,504,iron,449,879,430,1,00426,India
629420,2023-09-16,506,monitor,3249,8000,4751,1,00026,India
629420,2023-09-16,503,mixer,1349,3249,1900,1,00026,India
629420,2023-09-16,504,iron,449,879,430,1,00026,India
610181,2023-09-16,502,iphone 15 pro max,100000,135000,35000,1,00437,India
610181,2023-09-16,505,oven,18490,24000,5510,1,00437,India
610181,2023-09-16,507,washing machine,6990,16490,9500,1,00437,India
610181,2023-09-16,501,iphone 15,60000,80000,20000,1,00437,India
760507,2023-09-16,503,mixer,1349,3249,1900,1,00484,India
218981,2023-09-16,506,monitor,3249,8000,4751,1,00097,India
218981,2023-09-16,504,iron,449,879,430,1,00097,India
218981,2023-09-16,502,iphone 15 pro max,100000,135000,35000,1,00097,India
567676,2023-09-16,503,mixer,1349,3249,1900,1,00209,India
567676,2023-09-16,504,iron,449,879,430,1,00209,India
641894,2023-09-16,501,iphone 15,60000,80000,20000,1,00454,India
641894,2023-09-16,502,iphone 15 pro max,100000,135000,35000,1,00454,India
641894,2023-09-16,503,mixer,1349,3249,1900,1,00454,India
157036,2023-09-16,502,iphone 15 pro max,100000,135000,35000,1,00410,India
157036,2023-09-16,504,iron,449,879,430,1,00410,India
316323,2023-09-16,505,oven,18490,24000,5510,1,00419,India
316323,2023-09-16,507,washing machine,6990,16490,9500,1,00419,India
316323,2023-09-16,502,iphone 15 pro max,100000,135000,35000,1,00419,India
433340,2023-09-16,501,iphone 15,60000,80000,20000,1,00114,India
433340,2023-09-16,507,washing machine,6990,16490,9500,1,00114,India
856830,2023-09-16,505,oven,18490,24000,5510,1,00377,India
856830,2023-09-16,504,iron,449,879,430,1,00377,India
856830,2023-09-16,507,washing machine,6990,16490,9500,1,00377,India
856830,2023-09-16,506,monitor,3249,8000,4751,1,00377,India
277284,2023-09-16,507,washing machine,6990,16490,9500,1,00306,India
277284,2023-09-16,501,iphone 15,60000,80000,20000,1,00306,India
277284,2023-09-16,503,mixer,1349,3249,1900,1,00306,India
959026,2023-09-16,502,iphone 15 pro max,100000,135000,35000,1,00069,India
433085,2023-09-16,504,iron,449,879,430,1,00194,India
214999,2023-09-16,504,iron,449,879,430,1,00458,India
214999,2023-09-16,503,mixer,1349,3249,1900,1,00458,India
214999,2023-09-16,501,iphone 15,60000,80000,20000,1,00458,India
677017,2023-09-16,501,iphone 15,60000,80000,20000,1,00341,India
677017,2023-09-16,502,iphone 15 pro max,100000,135000,35000,1,00341,India
199071,2023-09-16,507,washing machine,6990,16490,9500,1,00194,India
199071,2023-09-16,506,monitor,3249,8000,4751,1,00194,India
199071,2023-09-16,504,iron,449,879,430,1,00194,India
199071,2023-09-16,502,iphone 15 pro max,100000,135000,35000,1,00194,India
805291,2023-09-16,503,mixer,1349,3249,1900,1,00030,India
482941,2023-09-16,503,mixer,1349,3249,1900,1,00161,India
482941,2023-09-16,505,oven,18490,24000,5510,1,00161,India
311586,2023-09-16,502,iphone 15 pro max,100000,135000,35000,1,00471,India
311586,2023-09-16,507,washing machine,6990,16490,9500,1,00471,India
311586,2023-09-16,503,mixer,1349,3249,1900,1,00471,India
441215,2023-09-16,502,iphone 15 pro max,100000,135000,35000,1,00313,India
441215,2023-09-16,506,monitor,3249,8000,4751,1,00313,India
441215,2023-09-16,501,iphone 15,60000,80000,20000,1,00313,India
581910,2023-09-16,501,iphone 15,60000,80000,20000,1,00274,India
581910,2023-09-16,506,monitor,3249,8000,4751,1,00274,India
581910,2023-09-16,507,washing machine,6990,16490,9500,1,00274,India
787079,2023-09-16,507,washing machine,6990,16490,9500,1,00249,India
787079,2023-09-16,502,iphone 15 pro max,100000,135000,35000,1,00249,India
787079,2023-09-16,503,mixer,1349,3249,1900,1,00249,India
790048,2023-09-16,501,iphone 15,60000,80000,20000,1,00327,India
790048,2023-09-16,502,iphone 15 pro max,100000,135000,35000,1,00327,India
159042,2023-09-16,505,oven,18490,24000,5510,1,00345,India
159042,2023-09-16,503,mixer,1349,3249,1900,1,00345,India
177795,2023-09-16,504,iron,449,879,430,1,00413,India
177795,2023-09-16,501,iphone 15,60000,80000,20000,1,00413,India
627302,2023-09-16,504,iron,449,879,430,1,00236,India
627302,2023-09-16,506,monitor,3249,8000,4751,1,00236,India
919535,2023-09-16,503,mixer,1349,3249,1900,1,00194,India
919535,2023-09-16,506,monitor,3249,8000,4751,1,00194,India
919535,2023-09-16,502,iphone 15 pro max,100000,135000,35000,1,00194,India
784008,2023-09-16,501,iphone 15,60000,80000,20000,1,00326,India
784008,2023-09-16,506,monitor,3249,8000,4751,1,00326,India
342062,2023-09-16,504,iron,449,879,430,1,00199,India
342062,2023-09-16,503,mixer,1349,3249,1900,1,00199,India
342062,2023-09-16,501,iphone 15,60000,80000,20000,1,00199,India
350098,2023-09-16,506,monitor,3249,8000,4751,1,00056,India
350098,2023-09-16,504,iron,449,879,430,1,00056,India
350098,2023-09-16,502,iphone 15 pro max,100000,135000,35000,1,00056,India
980497,2023-09-16,506,monitor,3249,8000,4751,1,00143,India
980497,2023-09-16,504,iron,449,879,430,1,00143,India
980497,2023-09-16,505,oven,18490,24000,5510,1,00143,India
680067,2023-09-16,505,oven,18490,24000,5510,1,00245,India
981410,2023-09-16,504,iron,449,879,430,1,00450,India
981410,2023-09-16,506,monitor,3249,8000,4751,1,00450,India
566667,2023-09-16,502,iphone 15 pro max,100000,135000,35000,1,00302,India
185264,2023-09-16,501,iphone 15,60000,80000,20000,1,00409,India
185264,2023-09-16,502,iphone 15 pro max,100000,135000,35000,1,00409,India
185264,2023-09-16,507,washing machine,6990,16490,9500,1,00409,India
143974,2023-09-16,502,iphone 15 pro max,100000,135000,35000,1,00133,India
750334,2023-09-16,503,mixer,1349,3249,1900,1,00054,India
118773,2023-09-16,506,monitor,3249,8000,4751,1,00325,India
466693,2023-09-16,504,iron,449,879,430,1,00105,India
466693,2023-09-16,505,oven,18490,24000,5510,1,00105,India
466693,2023-09-16,507,washing machine,6990,16490,9500,1,00105,India
674631,2023-09-16,503,mixer,1349,3249,1900,1,00154,India
636968,2023-09-16,502,iphone 15 pro max,100000,135000,35000,1,00174,India
636968,2023-09-16,503,mixer,1349,3249,1900,1,00174,India
636968,2023-09-16,505,oven,18490,24000,5510,1,00174,India
252285,2023-09-16,503,mixer,1349,3249,1900,1,00495,India
252285,2023-09-16,502,iphone 15 pro max,100000,135000,35000,1,00495,India
608033,2023-09-16,501,iphone 15,60000,80000,20000,1,00389,India
608033,2023-09-16,503,mixer,1349,3249,1900,1,00389,India
608033,2023-09-16,507,washing machine,6990,16490,9500,1,00389,India
608033,2023-09-16,504,iron,449,879,430,1,00389,India
608033,2023-09-16,502,iphone 15 pro max,100000,135000,35000,1,00389,India
792767,2023-09-16,501,iphone 15,60000,80000,20000,1,00271,India
792767,2023-09-16,505,oven,18490,24000,5510,1,00271,India
769136,2023-09-16,507,washing machine,6990,16490,9500,1,00222,India
769136,2023-09-16,506,monitor,3249,8000,4751,1,00222,India
769136,2023-09-16,503,mixer,1349,3249,1900,1,00222,India
254300,2023-09-16,503,mixer,1349,3249,1900,1,00021,India
254300,2023-09-16,502,iphone 15 pro max,100000,135000,35000,1,00021,India
254300,2023-09-16,501,iphone 15,60000,80000,20000,1,00021,India
753506,2023-09-16,502,iphone 15 pro max,100000,135000,35000,1,00198,India
437340,2023-09-16,505,oven,18490,24000,5510,1,00113,India
437340,2023-09-16,501,iphone 15,60000,80000,20000,1,00113,India
624269,2023-09-16,501,iphone 15,60000,80000,20000,1,00372,India
624269,2023-09-16,503,mixer,1349,3249,1900,1,00372,India
624269,2023-09-16,502,iphone 15 pro max,100000,135000,35000,1,00372,India
281333,2023-09-16,504,iron,449,879,430,1,00130,India
563841,2023-09-16,504,iron,449,879,430,1,00385,India
563841,2023-09-16,507,washing machine,6990,16490,9500,1,00385,India
563841,2023-09-16,503,mixer,1349,3249,1900,1,00385,India
934792,2023-09-16,503,mixer,1349,3249,1900,1,00495,India
934792,2023-09-16,504,iron,449,879,430,1,00495,India
965409,2023-09-16,501,iphone 15,60000,80000,20000,1,00333,India
965409,2023-09-16,507,washing machine,6990,16490,9500,1,00333,India
965409,2023-09-16,504,iron,449,879,430,1,00333,India
788086,2023-09-16,505,oven,18490,24000,5510,1,00328,India
788086,2023-09-16,507,washing machine,6990,16490,9500,1,00328,India
788086,2023-09-16,502,iphone 15 pro max,100000,135000,35000,1,00328,India
951779,2023-09-16,503,mixer,1349,3249,1900,1,00073,India
951779,2023-09-16,506,monitor,3249,8000,4751,1,00073,India
951779,2023-09-16,502,iphone 15 pro max,100000,135000,35000,1,00073,India
951779,2023-09-16,507,washing machine,6990,16490,9500,1,00073,India
545482,2023-09-16,504,iron,449,879,430,1,00255,India
545482,2023-09-16,505,oven,18490,24000,5510,1,00255,India
963746,2023-09-16,502,iphone 15 pro max,100000,135000,35000,1,00050,India
963746,2023-09-16,507,washing machine,6990,16490,9500,1,00050,India
963746,2023-09-16,506,monitor,3249,8000,4751,1,00050,India
383547,2023-09-16,502,iphone 15 pro max,100000,135000,35000,1,00367,India
383547,2023-09-16,504,iron,449,879,430,1,00367,India
593818,2023-09-16,507,washing machine,6990,16490,9500,1,00146,India
593818,2023-09-16,506,monitor,3249,8000,4751,1,00146,India
593818,2023-09-16,505,oven,18490,24000,5510,1,00146,India
593818,2023-09-16,504,iron,449,879,430,1,00146,India
641595,2023-09-16,502,iphone 15 pro max,100000,135000,35000,1,00401,India
641595,2023-09-16,501,iphone 15,60000,80000,20000,1,00401,India
641595,2023-09-16,503,mixer,1349,3249,1900,1,00401,India
315357,2023-09-16,506,monitor,3249,8000,4751,1,00002,India
864899,2023-09-16,506,monitor,3249,8000,4751,1,00080,India
864899,2023-09-16,501,iphone 15,60000,80000,20000,1,00080,India
178767,2023-09-16,501,iphone 15,60000,80000,20000,1,00015,India
178767,2023-09-16,504,iron,449,879,430,1,00015,India
178767,2023-09-16,506,monitor,3249,8000,4751,1,00015,India
327183,2023-09-16,501,iphone 15,60000,80000,20000,1,00260,India
327183,2023-09-16,507,washing machine,6990,16490,9500,1,00260,India
819541,2023-09-16,506,monitor,3249,8000,4751,1,00177,India
819541,2023-09-16,501,iphone 15,60000,80000,20000,1,00177,India
819541,2023-09-16,504,iron,449,879,430,1,00177,India
673001,2023-09-16,501,iphone 15,60000,80000,20000,1,00133,India
354243,2023-09-16,502,iphone 15 pro max,100000,135000,35000,1,00464,India
354243,2023-09-16,501,iphone 15,60000,80000,20000,1,00464,India
595743,2023-09-16,506,monitor,3249,8000,4751,1,00061,India
595743,2023-09-16,501,iphone 15,60000,80000,20000,1,00061,India
595743,2023-09-16,502,iphone 15 pro max,100000,135000,35000,1,00061,India
595743,2023-09-16,507,washing machine,6990,16490,9500,1,00061,India
655288,2023-09-16,505,oven,18490,24000,5510,1,00394,India
655288,2023-09-16,502,iphone 15 pro max,100000,135000,35000,1,00394,India
218274,2023-09-16,506,monitor,3249,8000,4751,1,00043,India
218274,2023-09-16,505,oven,18490,24000,5510,1,00043,India
901075,2023-09-16,504,iron,449,879,430,1,00251,India
184679,2023-09-16,505,oven,18490,24000,5510,1,00358,India
196173,2023-09-16,505,oven,18490,24000,5510,1,00351,India
196173,2023-09-16,503,mixer,1349,3249,1900,1,00351,India
370230,2023-09-16,503,mixer,1349,3249,1900,1,00004,India
370230,2023-09-16,501,iphone 15,60000,80000,20000,1,00004,India
827556,2023-09-16,501,iphone 15,60000,80000,20000,1,00276,India
827556,2023-09-16,502,iphone 15 pro max,100000,135000,35000,1,00276,India
827556,2023-09-16,506,monitor,3249,8000,4751,1,00276,India
306303,2023-09-16,504,iron,449,879,430,1,00278,India
306303,2023-09-16,503,mixer,1349,3249,1900,1,00278,India
154317,2023-09-16,501,iphone 15,60000,80000,20000,1,00163,India
115308,2023-09-16,507,washing machine,6990,16490,9500,1,00069,India
115308,2023-09-16,505,oven,18490,24000,5510,1,00069,India
115308,2023-09-16,501,iphone 15,60000,80000,20000,1,00069,India
224135,2023-09-16,506,monitor,3249,8000,4751,1,00392,India
224135,2023-09-16,503,mixer,1349,3249,1900,1,00392,India
224135,2023-09-16,505,oven,18490,24000,5510,1,00392,India
224135,2023-09-16,502,iphone 15 pro max,100000,135000,35000,1,00392,India
520971,2023-09-16,506,monitor,3249,8000,4751,1,00384,India
520971,2023-09-16,501,iphone 15,60000,80000,20000,1,00384,India
617585,2023-09-17,503,mixer,1349,3249,1900,1,00496,India
617585,2023-09-17,505,oven,18490,24000,5510,1,00496,India
617585,2023-09-17,502,iphone 15 pro max,100000,135000,35000,1,00496,India
617585,2023-09-17,501,iphone 15,60000,80000,20000,1,00496,India
880814,2023-09-17,505,oven,18490,24000,5510,1,00093,India
880814,2023-09-17,502,iphone 15 pro max,100000,135000,35000,1,00093,India
880814,2023-09-17,504,iron,449,879,430,1,00093,India
880814,2023-09-17,501,iphone 15,60000,80000,20000,1,00093,India
783714,2023-09-17,502,iphone 15 pro max,100000,135000,35000,1,00461,India
783714,2023-09-17,507,washing machine,6990,16490,9500,1,00461,India
783714,2023-09-17,505,oven,18490,24000,5510,1,00461,India
639128,2023-09-17,504,iron,449,879,430,1,00100,India
639128,2023-09-17,503,mixer,1349,3249,1900,1,00100,India
461549,2023-09-17,505,oven,18490,24000,5510,1,00458,India
658139,2023-09-17,502,iphone 15 pro max,100000,135000,35000,1,00255,India
658139,2023-09-17,504,iron,449,879,430,1,00255,India
255286,2023-09-17,506,monitor,3249,8000,4751,1,00031,India
255286,2023-09-17,505,oven,18490,24000,5510,1,00031,India
451851,2023-09-17,505,oven,18490,24000,5510,1,00184,India
451851,2023-09-17,507,washing machine,6990,16490,9500,1,00184,India
451851,2023-09-17,504,iron,449,879,430,1,00184,India
451851,2023-09-17,501,iphone 15,60000,80000,20000,1,00184,India
843526,2023-09-17,507,washing machine,6990,16490,9500,1,00426,India
328387,2023-09-17,502,iphone 15 pro max,100000,135000,35000,1,00465,India
328387,2023-09-17,503,mixer,1349,3249,1900,1,00465,India
328387,2023-09-17,507,washing machine,6990,16490,9500,1,00465,India
328387,2023-09-17,505,oven,18490,24000,5510,1,00465,India
335753,2023-09-17,501,iphone 15,60000,80000,20000,1,00086,India
335753,2023-09-17,505,oven,18490,24000,5510,1,00086,India
335753,2023-09-17,504,iron,449,879,430,1,00086,India
804501,2023-09-17,504,iron,449,879,430,1,00499,India
804501,2023-09-17,507,washing machine,6990,16490,9500,1,00499,India
804501,2023-09-17,503,mixer,1349,3249,1900,1,00499,India
127736,2023-09-17,506,monitor,3249,8000,4751,1,00222,India
761586,2023-09-17,507,washing machine,6990,16490,9500,1,00031,India
761586,2023-09-17,506,monitor,3249,8000,4751,1,00031,India
761586,2023-09-17,501,iphone 15,60000,80000,20000,1,00031,India
761586,2023-09-17,503,mixer,1349,3249,1900,1,00031,India
124743,2023-09-17,505,oven,18490,24000,5510,1,00078,India
124743,2023-09-17,502,iphone 15 pro max,100000,135000,35000,1,00078,India
124743,2023-09-17,506,monitor,3249,8000,4751,1,00078,India
142802,2023-09-17,506,monitor,3249,8000,4751,1,00427,India
142802,2023-09-17,503,mixer,1349,3249,1900,1,00427,India
709065,2023-09-17,506,monitor,3249,8000,4751,1,00491,India
709065,2023-09-17,504,iron,449,879,430,1,00491,India
709065,2023-09-17,502,iphone 15 pro max,100000,135000,35000,1,00491,India
709065,2023-09-17,505,oven,18490,24000,5510,1,00491,India
742757,2023-09-17,503,mixer,1349,3249,1900,1,00382,India
742757,2023-09-17,506,monitor,3249,8000,4751,1,00382,India
742757,2023-09-17,502,iphone 15 pro max,100000,135000,35000,1,00382,India
529979,2023-09-17,502,iphone 15 pro max,100000,135000,35000,1,00011,India
529979,2023-09-17,503,mixer,1349,3249,1900,1,00011,India
544673,2023-09-17,507,washing machine,6990,16490,9500,1,00422,India
909763,2023-09-17,507,washing machine,6990,16490,9500,1,00419,India
909763,2023-09-17,501,iphone 15,60000,80000,20000,1,00419,India
909763,2023-09-17,505,oven,18490,24000,5510,1,00419,India
640741,2023-09-17,503,mixer,1349,3249,1900,1,00366,India
640741,2023-09-17,505,oven,18490,24000,5510,1,00366,India
640741,2023-09-17,502,iphone 15 pro max,100000,135000,35000,1,00366,India
716577,2023-09-17,506,monitor,3249,8000,4751,1,00250,India
716577,2023-09-17,504,iron,449,879,430,1,00250,India
716577,2023-09-17,501,iphone 15,60000,80000,20000,1,00250,India
716577,2023-09-17,503,mixer,1349,3249,1900,1,00250,India
254638,2023-09-17,507,washing machine,6990,16490,9500,1,00260,India
254638,2023-09-17,506,monitor,3249,8000,4751,1,00260,India
254638,2023-09-17,505,oven,18490,24000,5510,1,00260,India
254638,2023-09-17,502,iphone 15 pro max,100000,135000,35000,1,00260,India
254638,2023-09-17,504,iron,449,879,430,1,00260,India
391551,2023-09-17,505,oven,18490,24000,5510,1,00042,India
391551,2023-09-17,501,iphone 15,60000,80000,20000,1,00042,India
240343,2023-09-17,502,iphone 15 pro max,100000,135000,35000,1,00090,India
240343,2023-09-17,506,monitor,3249,8000,4751,1,00090,India
434304,2023-09-17,503,mixer,1349,3249,1900,1,00116,India
748723,2023-09-17,504,iron,449,879,430,1,00116,India
748723,2023-09-17,507,washing machine,6990,16490,9500,1,00116,India
596386,2023-09-17,505,oven,18490,24000,5510,1,00193,India
596386,2023-09-17,507,washing machine,6990,16490,9500,1,00193,India
596386,2023-09-17,502,iphone 15 pro max,100000,135000,35000,1,00193,India
213747,2023-09-17,502,iphone 15 pro max,100000,135000,35000,1,00081,India
213747,2023-09-17,506,monitor,3249,8000,4751,1,00081,India
979579,2023-09-17,502,iphone 15 pro max,100000,135000,35000,1,00325,India
979579,2023-09-17,504,iron,449,879,430,1,00325,India
979579,2023-09-17,506,monitor,3249,8000,4751,1,00325,India
254090,2023-09-17,504,iron,449,879,430,1,00403,India
254090,2023-09-17,505,oven,18490,24000,5510,1,00403,India
255454,2023-09-17,503,mixer,1349,3249,1900,1,00023,India
255454,2023-09-17,507,washing machine,6990,16490,9500,1,00023,India
255454,2023-09-17,504,iron,449,879,430,1,00023,India
410336,2023-09-17,507,washing machine,6990,16490,9500,1,00104,India
410336,2023-09-17,501,iphone 15,60000,80000,20000,1,00104,India
410336,2023-09-17,506,monitor,3249,8000,4751,1,00104,India
533148,2023-09-17,507,washing machine,6990,16490,9500,1,00341,India
336336,2023-09-17,505,oven,18490,24000,5510,1,00486,India
336336,2023-09-17,502,iphone 15 pro max,100000,135000,35000,1,00486,India
336336,2023-09-17,506,monitor,3249,8000,4751,1,00486,India
336336,2023-09-17,501,iphone 15,60000,80000,20000,1,00486,India
921141,2023-09-17,503,mixer,1349,3249,1900,1,00370,India
921141,2023-09-17,506,monitor,3249,8000,4751,1,00370,India
921141,2023-09-17,504,iron,449,879,430,1,00370,India
921141,2023-09-17,505,oven,18490,24000,5510,1,00370,India
783085,2023-09-17,504,iron,449,879,430,1,00485,India
783085,2023-09-17,503,mixer,1349,3249,1900,1,00485,India
140910,2023-09-17,507,washing machine,6990,16490,9500,1,00495,India
140910,2023-09-17,501,iphone 15,60000,80000,20000,1,00495,India
140910,2023-09-17,502,iphone 15 pro max,100000,135000,35000,1,00495,India
140910,2023-09-17,506,monitor,3249,8000,4751,1,00495,India
620667,2023-09-17,503,mixer,1349,3249,1900,1,00405,India
620667,2023-09-17,505,oven,18490,24000,5510,1,00405,India
620667,2023-09-17,507,washing machine,6990,16490,9500,1,00405,India
620667,2023-09-17,504,iron,449,879,430,1,00405,India
209516,2023-09-17,501,iphone 15,60000,80000,20000,1,00220,India
209516,2023-09-17,506,monitor,3249,8000,4751,1,00220,India
209516,2023-09-17,504,iron,449,879,430,1,00220,India
788567,2023-09-17,505,oven,18490,24000,5510,1,00150,India
788567,2023-09-17,504,iron,449,879,430,1,00150,India
788567,2023-09-17,501,iphone 15,60000,80000,20000,1,00150,India
788567,2023-09-17,506,monitor,3249,8000,4751,1,00150,India
812515,2023-09-17,501,iphone 15,60000,80000,20000,1,00297,India
812515,2023-09-17,503,mixer,1349,3249,1900,1,00297,India
812515,2023-09-17,507,washing machine,6990,16490,9500,1,00297,India
812515,2023-09-17,504,iron,449,879,430,1,00297,India
483161,2023-09-17,503,mixer,1349,3249,1900,1,00403,India
483161,2023-09-17,501,iphone 15,60000,80000,20000,1,00403,India
483161,2023-09-17,506,monitor,3249,8000,4751,1,00403,India
763645,2023-09-17,505,oven,18490,24000,5510,1,00059,India
625798,2023-09-17,507,washing machine,6990,16490,9500,1,00060,India
946084,2023-09-17,503,mixer,1349,3249,1900,1,00290,India
946084,2023-09-17,502,iphone 15 pro max,100000,135000,35000,1,00290,India
946084,2023-09-17,507,washing machine,6990,16490,9500,1,00290,India
892193,2023-09-17,505,oven,18490,24000,5510,1,00305,India
892193,2023-09-17,501,iphone 15,60000,80000,20000,1,00305,India
892193,2023-09-17,504,iron,449,879,430,1,00305,India
123158,2023-09-17,506,monitor,3249,8000,4751,1,00376,India
123158,2023-09-17,505,oven,18490,24000,5510,1,00376,India
366296,2023-09-17,503,mixer,1349,3249,1900,1,00207,India
610151,2023-09-17,507,washing machine,6990,16490,9500,1,00176,India
610151,2023-09-17,505,oven,18490,24000,5510,1,00176,India
373650,2023-09-17,507,washing machine,6990,16490,9500,1,00109,India
843332,2023-09-17,501,iphone 15,60000,80000,20000,1,00409,India
843332,2023-09-17,506,monitor,3249,8000,4751,1,00409,India
843332,2023-09-17,504,iron,449,879,430,1,00409,India
862543,2023-09-18,505,oven,18490,24000,5510,1,00259,India
862543,2023-09-18,504,iron,449,879,430,1,00259,India
862543,2023-09-18,507,washing machine,6990,16490,9500,1,00259,India
420424,2023-09-18,502,iphone 15 pro max,100000,135000,35000,1,00085,India
420424,2023-09-18,504,iron,449,879,430,1,00085,India
420424,2023-09-18,507,washing machine,6990,16490,9500,1,00085,India
420424,2023-09-18,501,iphone 15,60000,80000,20000,1,00085,India
236204,2023-09-18,504,iron,449,879,430,1,00126,India
236204,2023-09-18,501,iphone 15,60000,80000,20000,1,00126,India
236204,2023-09-18,505,oven,18490,24000,5510,1,00126,India
236204,2023-09-18,507,washing machine,6990,16490,9500,1,00126,India
861070,2023-09-18,507,washing machine,6990,16490,9500,1,00484,India
861070,2023-09-18,503,mixer,1349,3249,1900,1,00484,India
861070,2023-09-18,505,oven,18490,24000,5510,1,00484,India
861070,2023-09-18,504,iron,449,879,430,1,00484,India
938699,2023-09-18,503,mixer,1349,3249,1900,1,00404,India
938699,2023-09-18,505,oven,18490,24000,5510,1,00404,India
938699,2023-09-18,502,iphone 15 pro max,100000,135000,35000,1,00404,India
938699,2023-09-18,504,iron,449,879,430,1,00404,India
975442,2023-09-18,507,washing machine,6990,16490,9500,1,00434,India
975442,2023-09-18,504,iron,449,879,430,1,00434,India
335152,2023-09-18,506,monitor,3249,8000,4751,1,00246,India
335152,2023-09-18,507,washing machine,6990,16490,9500,1,00246,India
335152,2023-09-18,502,iphone 15 pro max,100000,135000,35000,1,00246,India
335152,2023-09-18,504,iron,449,879,430,1,00246,India
157725,2023-09-18,505,oven,18490,24000,5510,1,00489,India
157725,2023-09-18,504,iron,449,879,430,1,00489,India
969753,2023-09-18,502,iphone 15 pro max,100000,135000,35000,1,00310,India
969753,2023-09-18,506,monitor,3249,8000,4751,1,00310,India
353562,2023-09-18,506,monitor,3249,8000,4751,1,00359,India
353562,2023-09-18,502,iphone 15 pro max,100000,135000,35000,1,00359,India
353562,2023-09-18,501,iphone 15,60000,80000,20000,1,00359,India
268885,2023-09-18,503,mixer,1349,3249,1900,1,00092,India
268885,2023-09-18,501,iphone 15,60000,80000,20000,1,00092,India
268885,2023-09-18,506,monitor,3249,8000,4751,1,00092,India
832159,2023-09-18,507,washing machine,6990,16490,9500,1,00415,India
542363,2023-09-18,502,iphone 15 pro max,100000,135000,35000,1,00436,India
542363,2023-09-18,504,iron,449,879,430,1,00436,India
542363,2023-09-18,501,iphone 15,60000,80000,20000,1,00436,India
156483,2023-09-18,507,washing machine,6990,16490,9500,1,00285,India
156483,2023-09-18,501,iphone 15,60000,80000,20000,1,00285,India
156483,2023-09-18,502,iphone 15 pro max,100000,135000,35000,1,00285,India
704394,2023-09-18,502,iphone 15 pro max,100000,135000,35000,1,00460,India
704394,2023-09-18,505,oven,18490,24000,5510,1,00460,India
279399,2023-09-18,506,monitor,3249,8000,4751,1,00106,India
279399,2023-09-18,502,iphone 15 pro max,100000,135000,35000,1,00106,India
279399,2023-09-18,503,mixer,1349,3249,1900,1,00106,India
279399,2023-09-18,504,iron,449,879,430,1,00106,India
403007,2023-09-18,507,washing machine,6990,16490,9500,1,00475,India
403007,2023-09-18,501,iphone 15,60000,80000,20000,1,00475,India
403007,2023-09-18,503,mixer,1349,3249,1900,1,00475,India
403007,2023-09-18,502,iphone 15 pro max,100000,135000,35000,1,00475,India
798424,2023-09-18,504,iron,449,879,430,1,00448,India
962464,2023-09-18,505,oven,18490,24000,5510,1,00109,India
962464,2023-09-18,504,iron,449,879,430,1,00109,India
634993,2023-09-18,507,washing machine,6990,16490,9500,1,00168,India
634993,2023-09-18,504,iron,449,879,430,1,00168,India
586633,2023-09-18,507,washing machine,6990,16490,9500,1,00115,India
586633,2023-09-18,503,mixer,1349,3249,1900,1,00115,India
586633,2023-09-18,501,iphone 15,60000,80000,20000,1,00115,India
586633,2023-09-18,505,oven,18490,24000,5510,1,00115,India
186492,2023-09-18,506,monitor,3249,8000,4751,1,00099,India
186492,2023-09-18,504,iron,449,879,430,1,00099,India
186492,2023-09-18,505,oven,18490,24000,5510,1,00099,India
186492,2023-09-18,501,iphone 15,60000,80000,20000,1,00099,India
186492,2023-09-18,502,iphone 15 pro max,100000,135000,35000,1,00099,India
651065,2023-09-18,503,mixer,1349,3249,1900,1,00174,India
651065,2023-09-18,507,washing machine,6990,16490,9500,1,00174,India
253588,2023-09-18,503,mixer,1349,3249,1900,1,00190,India
253588,2023-09-18,504,iron,449,879,430,1,00190,India
308987,2023-09-18,502,iphone 15 pro max,100000,135000,35000,1,00079,India
504591,2023-09-18,507,washing machine,6990,16490,9500,1,00219,India
414587,2023-09-18,503,mixer,1349,3249,1900,1,00466,India
414587,2023-09-18,504,iron,449,879,430,1,00466,India
414587,2023-09-18,506,monitor,3249,8000,4751,1,00466,India
414587,2023-09-18,507,washing machine,6990,16490,9500,1,00466,India
258127,2023-09-18,507,washing machine,6990,16490,9500,1,00210,India
258127,2023-09-18,504,iron,449,879,430,1,00210,India
514769,2023-09-18,506,monitor,3249,8000,4751,1,00339,India
514769,2023-09-18,501,iphone 15,60000,80000,20000,1,00339,India
514769,2023-09-18,502,iphone 15 pro max,100000,135000,35000,1,00339,India
675537,2023-09-18,501,iphone 15,60000,80000,20000,1,00178,India
675537,2023-09-18,503,mixer,1349,3249,1900,1,00178,India
675537,2023-09-18,504,iron,449,879,430,1,00178,India
157583,2023-09-18,506,monitor,3249,8000,4751,1,00488,India
157583,2023-09-18,505,oven,18490,24000,5510,1,00488,India
157583,2023-09-18,501,iphone 15,60000,80000,20000,1,00488,India
157583,2023-09-18,503,mixer,1349,3249,1900,1,00488,India
805339,2023-09-18,502,iphone 15 pro max,100000,135000,35000,1,00194,India
805339,2023-09-18,506,monitor,3249,8000,4751,1,00194,India
805339,2023-09-18,503,mixer,1349,3249,1900,1,00194,India
744515,2023-09-18,503,mixer,1349,3249,1900,1,00486,India
744515,2023-09-18,507,washing machine,6990,16490,9500,1,00486,India
744515,2023-09-18,501,iphone 15,60000,80000,20000,1,00486,India
921056,2023-09-18,504,iron,449,879,430,1,00281,India
469691,2023-09-18,507,washing machine,6990,16490,9500,1,00137,India
469691,2023-09-18,506,monitor,3249,8000,4751,1,00137,India
657211,2023-09-18,506,monitor,3249,8000,4751,1,00218,India
657211,2023-09-18,502,iphone 15 pro max,100000,135000,35000,1,00218,India
657211,2023-09-18,503,mixer,1349,3249,1900,1,00218,India
478357,2023-09-18,501,iphone 15,60000,80000,20000,1,00154,India
478357,2023-09-18,504,iron,449,879,430,1,00154,India
616904,2023-09-18,503,mixer,1349,3249,1900,1,00411,India
616904,2023-09-18,505,oven,18490,24000,5510,1,00411,India
616904,2023-09-18,501,iphone 15,60000,80000,20000,1,00411,India
901492,2023-09-18,501,iphone 15,60000,80000,20000,1,00171,India
901492,2023-09-18,504,iron,449,879,430,1,00171,India
901492,2023-09-18,506,monitor,3249,8000,4751,1,00171,India
264945,2023-09-18,504,iron,449,879,430,1,00021,India
264945,2023-09-18,505,oven,18490,24000,5510,1,00021,India
908942,2023-09-18,505,oven,18490,24000,5510,1,00324,India
908942,2023-09-18,504,iron,449,879,430,1,00324,India
908942,2023-09-18,506,monitor,3249,8000,4751,1,00324,India
822169,2023-09-18,502,iphone 15 pro max,100000,135000,35000,1,00393,India
360384,2023-09-18,503,mixer,1349,3249,1900,1,00219,India
315275,2023-09-18,506,monitor,3249,8000,4751,1,00308,India
941962,2023-09-18,506,monitor,3249,8000,4751,1,00320,India
427640,2023-09-18,505,oven,18490,24000,5510,1,00288,India
427640,2023-09-18,503,mixer,1349,3249,1900,1,00288,India
934358,2023-09-18,502,iphone 15 pro max,100000,135000,35000,1,00082,India
934358,2023-09-18,503,mixer,1349,3249,1900,1,00082,India
885963,2023-09-18,504,iron,449,879,430,1,00470,India
885963,2023-09-18,506,monitor,3249,8000,4751,1,00470,India
885963,2023-09-18,503,mixer,1349,3249,1900,1,00470,India
720448,2023-09-18,502,iphone 15 pro max,100000,135000,35000,1,00239,India
720448,2023-09-18,501,iphone 15,60000,80000,20000,1,00239,India
720448,2023-09-18,505,oven,18490,24000,5510,1,00239,India
303655,2023-09-18,504,iron,449,879,430,1,00216,India
303655,2023-09-18,507,washing machine,6990,16490,9500,1,00216,India
227225,2023-09-18,503,mixer,1349,3249,1900,1,00394,India
227225,2023-09-18,506,monitor,3249,8000,4751,1,00394,India
851780,2023-09-18,506,monitor,3249,8000,4751,1,00338,India
851780,2023-09-18,502,iphone 15 pro max,100000,135000,35000,1,00338,India
765063,2023-09-18,506,monitor,3249,8000,4751,1,00221,India
765063,2023-09-18,505,oven,18490,24000,5510,1,00221,India
765063,2023-09-18,503,mixer,1349,3249,1900,1,00221,India
765063,2023-09-18,502,iphone 15 pro max,100000,135000,35000,1,00221,India
765063,2023-09-18,504,iron,449,879,430,1,00221,India
572616,2023-09-19,507,washing machine,6990,16490,9500,1,00437,India
572616,2023-09-19,503,mixer,1349,3249,1900,1,00437,India
613069,2023-09-19,504,iron,449,879,430,1,00280,India
613069,2023-09-19,503,mixer,1349,3249,1900,1,00280,India
107668,2023-09-19,505,oven,18490,24000,5510,1,00305,India
107668,2023-09-19,506,monitor,3249,8000,4751,1,00305,India
721537,2023-09-19,505,oven,18490,24000,5510,1,00373,India
721537,2023-09-19,502,iphone 15 pro max,100000,135000,35000,1,00373,India
721537,2023-09-19,506,monitor,3249,8000,4751,1,00373,India
526852,2023-09-19,507,washing machine,6990,16490,9500,1,00144,India
526852,2023-09-19,503,mixer,1349,3249,1900,1,00144,India
526852,2023-09-19,506,monitor,3249,8000,4751,1,00144,India
342920,2023-09-19,507,washing machine,6990,16490,9500,1,00142,India
342920,2023-09-19,504,iron,449,879,430,1,00142,India
342920,2023-09-19,501,iphone 15,60000,80000,20000,1,00142,India
847509,2023-09-19,504,iron,449,879,430,1,00251,India
847509,2023-09-19,505,oven,18490,24000,5510,1,00251,India
847509,2023-09-19,501,iphone 15,60000,80000,20000,1,00251,India
847509,2023-09-19,507,washing machine,6990,16490,9500,1,00251,India
767536,2023-09-19,506,monitor,3249,8000,4751,1,00331,India
456134,2023-09-19,504,iron,449,879,430,1,00183,India
736567,2023-09-19,501,iphone 15,60000,80000,20000,1,00153,India
736567,2023-09-19,507,washing machine,6990,16490,9500,1,00153,India
404134,2023-09-19,506,monitor,3249,8000,4751,1,00494,India
268597,2023-09-19,504,iron,449,879,430,1,00217,India
779529,2023-09-19,504,iron,449,879,430,1,00384,India
429377,2023-09-19,505,oven,18490,24000,5510,1,00056,India
969140,2023-09-19,502,iphone 15 pro max,100000,135000,35000,1,00463,India
969140,2023-09-19,504,iron,449,879,430,1,00463,India
595148,2023-09-19,503,mixer,1349,3249,1900,1,00216,India
595148,2023-09-19,502,iphone 15 pro max,100000,135000,35000,1,00216,India
595148,2023-09-19,507,washing machine,6990,16490,9500,1,00216,India
595148,2023-09-19,501,iphone 15,60000,80000,20000,1,00216,India
595148,2023-09-19,506,monitor,3249,8000,4751,1,00216,India
896502,2023-09-19,503,mixer,1349,3249,1900,1,00263,India
896502,2023-09-19,506,monitor,3249,8000,4751,1,00263,India
999039,2023-09-19,503,mixer,1349,3249,1900,1,00398,India
999039,2023-09-19,505,oven,18490,24000,5510,1,00398,India
999039,2023-09-19,501,iphone 15,60000,80000,20000,1,00398,India
999039,2023-09-19,507,washing machine,6990,16490,9500,1,00398,India
134168,2023-09-19,507,washing machine,6990,16490,9500,1,00281,India
134168,2023-09-19,504,iron,449,879,430,1,00281,India
134168,2023-09-19,501,iphone 15,60000,80000,20000,1,00281,India
134168,2023-09-19,506,monitor,3249,8000,4751,1,00281,India
126354,2023-09-19,504,iron,449,879,430,1,00252,India
126354,2023-09-19,506,monitor,3249,8000,4751,1,00252,India
126354,2023-09-19,502,iphone 15 pro max,100000,135000,35000,1,00252,India
126354,2023-09-19,503,mixer,1349,3249,1900,1,00252,India
606292,2023-09-19,501,iphone 15,60000,80000,20000,1,00077,India
683404,2023-09-19,503,mixer,1349,3249,1900,1,00455,India
926594,2023-09-19,506,monitor,3249,8000,4751,1,00414,India
926594,2023-09-19,503,mixer,1349,3249,1900,1,00414,India
926594,2023-09-19,504,iron,449,879,430,1,00414,India
431288,2023-09-19,503,mixer,1349,3249,1900,1,00369,India
431288,2023-09-19,507,washing machine,6990,16490,9500,1,00369,India
545037,2023-09-19,505,oven,18490,24000,5510,1,00256,India
545037,2023-09-19,503,mixer,1349,3249,1900,1,00256,India
545037,2023-09-19,501,iphone 15,60000,80000,20000,1,00256,India
545037,2023-09-19,507,washing machine,6990,16490,9500,1,00256,India
777943,2023-09-19,502,iphone 15 pro max,100000,135000,35000,1,00294,India
728386,2023-09-19,503,mixer,1349,3249,1900,1,00284,India
728386,2023-09-19,501,iphone 15,60000,80000,20000,1,00284,India
847891,2023-09-19,501,iphone 15,60000,80000,20000,1,00042,India
847891,2023-09-19,507,washing machine,6990,16490,9500,1,00042,India
847891,2023-09-19,505,oven,18490,24000,5510,1,00042,India
847891,2023-09-19,502,iphone 15 pro max,100000,135000,35000,1,00042,India
814376,2023-09-19,502,iphone 15 pro max,100000,135000,35000,1,00145,India
814376,2023-09-19,507,washing machine,6990,16490,9500,1,00145,India
618434,2023-09-19,505,oven,18490,24000,5510,1,00102,India
618434,2023-09-19,504,iron,449,879,430,1,00102,India
263067,2023-09-19,507,washing machine,6990,16490,9500,1,00308,India
263067,2023-09-19,503,mixer,1349,3249,1900,1,00308,India
263067,2023-09-19,501,iphone 15,60000,80000,20000,1,00308,India
594658,2023-09-19,507,washing machine,6990,16490,9500,1,00135,India
594658,2023-09-19,502,iphone 15 pro max,100000,135000,35000,1,00135,India
594658,2023-09-19,503,mixer,1349,3249,1900,1,00135,India
594658,2023-09-19,505,oven,18490,24000,5510,1,00135,India
526760,2023-09-19,505,oven,18490,24000,5510,1,00066,India
526760,2023-09-19,507,washing machine,6990,16490,9500,1,00066,India
526760,2023-09-19,503,mixer,1349,3249,1900,1,00066,India
526760,2023-09-19,502,iphone 15 pro max,100000,135000,35000,1,00066,India
667838,2023-09-19,504,iron,449,879,430,1,00168,India
667838,2023-09-19,506,monitor,3249,8000,4751,1,00168,India
191467,2023-09-19,501,iphone 15,60000,80000,20000,1,00001,India
191467,2023-09-19,505,oven,18490,24000,5510,1,00001,India
191467,2023-09-19,503,mixer,1349,3249,1900,1,00001,India
191467,2023-09-19,504,iron,449,879,430,1,00001,India
540654,2023-09-19,501,iphone 15,60000,80000,20000,1,00143,India
540654,2023-09-19,506,monitor,3249,8000,4751,1,00143,India
540654,2023-09-19,507,washing machine,6990,16490,9500,1,00143,India
540654,2023-09-19,505,oven,18490,24000,5510,1,00143,India
959871,2023-09-19,503,mixer,1349,3249,1900,1,00468,India
959871,2023-09-19,504,iron,449,879,430,1,00468,India
846118,2023-09-19,506,monitor,3249,8000,4751,1,00036,India
846118,2023-09-19,501,iphone 15,60000,80000,20000,1,00036,India
846118,2023-09-19,504,iron,449,879,430,1,00036,India
278025,2023-09-19,501,iphone 15,60000,80000,20000,1,00011,India
278025,2023-09-19,503,mixer,1349,3249,1900,1,00011,India
789010,2023-09-19,501,iphone 15,60000,80000,20000,1,00491,India
789010,2023-09-19,507,washing machine,6990,16490,9500,1,00491,India
792869,2023-09-19,506,monitor,3249,8000,4751,1,00438,India
105440,2023-09-19,503,mixer,1349,3249,1900,1,00235,India
105440,2023-09-19,507,washing machine,6990,16490,9500,1,00235,India
105440,2023-09-19,505,oven,18490,24000,5510,1,00235,India
576823,2023-09-19,503,mixer,1349,3249,1900,1,00447,India
576823,2023-09-19,501,iphone 15,60000,80000,20000,1,00447,India
576823,2023-09-19,504,iron,449,879,430,1,00447,India
576823,2023-09-19,505,oven,18490,24000,5510,1,00447,India
647287,2023-09-19,501,iphone 15,60000,80000,20000,1,00339,India
647287,2023-09-19,502,iphone 15 pro max,100000,135000,35000,1,00339,India
514152,2023-09-19,505,oven,18490,24000,5510,1,00254,India
514152,2023-09-19,507,washing machine,6990,16490,9500,1,00254,India
514152,2023-09-19,503,mixer,1349,3249,1900,1,00254,India
669678,2023-09-19,502,iphone 15 pro max,100000,135000,35000,1,00426,India
669678,2023-09-19,507,washing machine,6990,16490,9500,1,00426,India
669678,2023-09-19,506,monitor,3249,8000,4751,1,00426,India
669678,2023-09-19,503,mixer,1349,3249,1900,1,00426,India
326860,2023-09-19,503,mixer,1349,3249,1900,1,00445,India
326860,2023-09-19,501,iphone 15,60000,80000,20000,1,00445,India
877218,2023-09-19,502,iphone 15 pro max,100000,135000,35000,1,00204,India
877218,2023-09-19,501,iphone 15,60000,80000,20000,1,00204,India
877218,2023-09-19,504,iron,449,879,430,1,00204,India
769373,2023-09-19,505,oven,18490,24000,5510,1,00049,India
769373,2023-09-19,506,monitor,3249,8000,4751,1,00049,India
769373,2023-09-19,502,iphone 15 pro max,100000,135000,35000,1,00049,India
769373,2023-09-19,507,washing machine,6990,16490,9500,1,00049,India
793178,2023-09-19,503,mixer,1349,3249,1900,1,00208,India
793178,2023-09-19,505,oven,18490,24000,5510,1,00208,India
793178,2023-09-19,506,monitor,3249,8000,4751,1,00208,India
793178,2023-09-19,502,iphone 15 pro max,100000,135000,35000,1,00208,India
264984,2023-09-20,505,oven,18490,24000,5510,1,00116,India
316756,2023-09-20,505,oven,18490,24000,5510,1,00439,India
316756,2023-09-20,507,washing machine,6990,16490,9500,1,00439,India
316756,2023-09-20,502,iphone 15 pro max,100000,135000,35000,1,00439,India
316756,2023-09-20,503,mixer,1349,3249,1900,1,00439,India
892024,2023-09-20,505,oven,18490,24000,5510,1,00042,India
892024,2023-09-20,504,iron,449,879,430,1,00042,India
892024,2023-09-20,503,mixer,1349,3249,1900,1,00042,India
372308,2023-09-20,501,iphone 15,60000,80000,20000,1,00055,India
948601,2023-09-20,503,mixer,1349,3249,1900,1,00093,India
948601,2023-09-20,507,washing machine,6990,16490,9500,1,00093,India
258059,2023-09-20,504,iron,449,879,430,1,00008,India
258059,2023-09-20,502,iphone 15 pro max,100000,135000,35000,1,00008,India
258059,2023-09-20,501,iphone 15,60000,80000,20000,1,00008,India
258059,2023-09-20,503,mixer,1349,3249,1900,1,00008,India
683486,2023-09-20,501,iphone 15,60000,80000,20000,1,00344,India
683486,2023-09-20,506,monitor,3249,8000,4751,1,00344,India
337053,2023-09-20,501,iphone 15,60000,80000,20000,1,00057,India
639252,2023-09-20,503,mixer,1349,3249,1900,1,00102,India
639252,2023-09-20,502,iphone 15 pro max,100000,135000,35000,1,00102,India
639252,2023-09-20,506,monitor,3249,8000,4751,1,00102,India
372132,2023-09-20,506,monitor,3249,8000,4751,1,00471,India
372132,2023-09-20,504,iron,449,879,430,1,00471,India
372132,2023-09-20,503,mixer,1349,3249,1900,1,00471,India
997430,2023-09-20,502,iphone 15 pro max,100000,135000,35000,1,00027,India
997430,2023-09-20,501,iphone 15,60000,80000,20000,1,00027,India
997430,2023-09-20,503,mixer,1349,3249,1900,1,00027,India
997430,2023-09-20,507,washing machine,6990,16490,9500,1,00027,India
997430,2023-09-20,505,oven,18490,24000,5510,1,00027,India
392063,2023-09-20,502,iphone 15 pro max,100000,135000,35000,1,00007,India
392063,2023-09-20,503,mixer,1349,3249,1900,1,00007,India
392063,2023-09-20,505,oven,18490,24000,5510,1,00007,India
976977,2023-09-20,501,iphone 15,60000,80000,20000,1,00293,India
976977,2023-09-20,507,washing machine,6990,16490,9500,1,00293,India
976977,2023-09-20,506,monitor,3249,8000,4751,1,00293,India
976977,2023-09-20,504,iron,449,879,430,1,00293,India
181075,2023-09-20,501,iphone 15,60000,80000,20000,1,00277,India
181075,2023-09-20,507,washing machine,6990,16490,9500,1,00277,India
503193,2023-09-20,502,iphone 15 pro max,100000,135000,35000,1,00311,India
503193,2023-09-20,503,mixer,1349,3249,1900,1,00311,India
503193,2023-09-20,501,iphone 15,60000,80000,20000,1,00311,India
130302,2023-09-20,503,mixer,1349,3249,1900,1,00428,India
157606,2023-09-20,504,iron,449,879,430,1,00456,India
157606,2023-09-20,507,washing machine,6990,16490,9500,1,00456,India
157606,2023-09-20,502,iphone 15 pro max,100000,135000,35000,1,00456,India
987363,2023-09-20,504,iron,449,879,430,1,00343,India
987363,2023-09-20,502,iphone 15 pro max,100000,135000,35000,1,00343,India
987363,2023-09-20,505,oven,18490,24000,5510,1,00343,India
252631,2023-09-20,506,monitor,3249,8000,4751,1,00156,India
252631,2023-09-20,505,oven,18490,24000,5510,1,00156,India
252631,2023-09-20,501,iphone 15,60000,80000,20000,1,00156,India
229006,2023-09-20,501,iphone 15,60000,80000,20000,1,00478,India
229006,2023-09-20,507,washing machine,6990,16490,9500,1,00478,India
229006,2023-09-20,503,mixer,1349,3249,1900,1,00478,India
229006,2023-09-20,502,iphone 15 pro max,100000,135000,35000,1,00478,India
229006,2023-09-20,506,monitor,3249,8000,4751,1,00478,India
267210,2023-09-20,505,oven,18490,24000,5510,1,00373,India
267210,2023-09-20,503,mixer,1349,3249,1900,1,00373,India
267210,2023-09-20,502,iphone 15 pro max,100000,135000,35000,1,00373,India
267210,2023-09-20,507,washing machine,6990,16490,9500,1,00373,India
225059,2023-09-20,502,iphone 15 pro max,100000,135000,35000,1,00419,India
225059,2023-09-20,507,washing machine,6990,16490,9500,1,00419,India
507192,2023-09-20,504,iron,449,879,430,1,00052,India
507192,2023-09-20,506,monitor,3249,8000,4751,1,00052,India
507192,2023-09-20,502,iphone 15 pro max,100000,135000,35000,1,00052,India
507192,2023-09-20,501,iphone 15,60000,80000,20000,1,00052,India
528395,2023-09-20,504,iron,449,879,430,1,00398,India
528395,2023-09-20,505,oven,18490,24000,5510,1,00398,India
192098,2023-09-20,505,oven,18490,24000,5510,1,00229,India
192098,2023-09-20,506,monitor,3249,8000,4751,1,00229,India
192098,2023-09-20,503,mixer,1349,3249,1900,1,00229,India
192098,2023-09-20,507,washing machine,6990,16490,9500,1,00229,India
860120,2023-09-20,505,oven,18490,24000,5510,1,00451,India
860120,2023-09-20,506,monitor,3249,8000,4751,1,00451,India
351687,2023-09-20,502,iphone 15 pro max,100000,135000,35000,1,00207,India
351687,2023-09-20,507,washing machine,6990,16490,9500,1,00207,India
351687,2023-09-20,506,monitor,3249,8000,4751,1,00207,India
351687,2023-09-20,505,oven,18490,24000,5510,1,00207,India
351687,2023-09-20,503,mixer,1349,3249,1900,1,00207,India
549113,2023-09-20,502,iphone 15 pro max,100000,135000,35000,1,00294,India
549113,2023-09-20,501,iphone 15,60000,80000,20000,1,00294,India
875421,2023-09-20,501,iphone 15,60000,80000,20000,1,00172,India
875421,2023-09-20,504,iron,449,879,430,1,00172,India
875421,2023-09-20,502,iphone 15 pro max,100000,135000,35000,1,00172,India
161330,2023-09-20,502,iphone 15 pro max,100000,135000,35000,1,00158,India
161330,2023-09-20,501,iphone 15,60000,80000,20000,1,00158,India
161330,2023-09-20,505,oven,18490,24000,5510,1,00158,India
643143,2023-09-20,501,iphone 15,60000,80000,20000,1,00221,India
643143,2023-09-20,504,iron,449,879,430,1,00221,India
480035,2023-09-20,503,mixer,1349,3249,1900,1,00494,India
480035,2023-09-20,507,washing machine,6990,16490,9500,1,00494,India
296680,2023-09-20,505,oven,18490,24000,5510,1,00493,India
296680,2023-09-20,504,iron,449,879,430,1,00493,India
296680,2023-09-20,501,iphone 15,60000,80000,20000,1,00493,India
251425,2023-09-20,503,mixer,1349,3249,1900,1,00019,India
251425,2023-09-20,506,monitor,3249,8000,4751,1,00019,India
925532,2023-09-20,503,mixer,1349,3249,1900,1,00255,India
925532,2023-09-20,501,iphone 15,60000,80000,20000,1,00255,India
925532,2023-09-20,504,iron,449,879,430,1,00255,India
925532,2023-09-20,502,iphone 15 pro max,100000,135000,35000,1,00255,India
856737,2023-09-20,506,monitor,3249,8000,4751,1,00297,India
854051,2023-09-20,501,iphone 15,60000,80000,20000,1,00246,India
854051,2023-09-20,502,iphone 15 pro max,100000,135000,35000,1,00246,India
854051,2023-09-20,505,oven,18490,24000,5510,1,00246,India
881483,2023-09-20,503,mixer,1349,3249,1900,1,00168,India
881483,2023-09-20,506,monitor,3249,8000,4751,1,00168,India
881483,2023-09-20,507,washing machine,6990,16490,9500,1,00168,India
517500,2023-09-20,504,iron,449,879,430,1,00059,India
517500,2023-09-20,503,mixer,1349,3249,1900,1,00059,India
205478,2023-09-20,503,mixer,1349,3249,1900,1,00341,India
205478,2023-09-20,507,washing machine,6990,16490,9500,1,00341,India
586253,2023-09-20,504,iron,449,879,430,1,00275,India
586253,2023-09-20,507,washing machine,6990,16490,9500,1,00275,India
586253,2023-09-20,501,iphone 15,60000,80000,20000,1,00275,India
165652,2023-09-20,501,iphone 15,60000,80000,20000,1,00030,India
165652,2023-09-20,503,mixer,1349,3249,1900,1,00030,India
880517,2023-09-20,505,oven,18490,24000,5510,1,00107,India
968501,2023-09-20,504,iron,449,879,430,1,00050,India
968501,2023-09-20,502,iphone 15 pro max,100000,135000,35000,1,00050,India
968501,2023-09-20,501,iphone 15,60000,80000,20000,1,00050,India
580433,2023-09-20,503,mixer,1349,3249,1900,1,00062,India
994613,2023-09-20,506,monitor,3249,8000,4751,1,00449,India
422609,2023-09-20,502,iphone 15 pro max,100000,135000,35000,1,00308,India
422609,2023-09-20,504,iron,449,879,430,1,00308,India
422609,2023-09-20,506,monitor,3249,8000,4751,1,00308,India
422609,2023-09-20,501,iphone 15,60000,80000,20000,1,00308,India
422609,2023-09-20,507,washing machine,6990,16490,9500,1,00308,India
380652,2023-09-20,506,monitor,3249,8000,4751,1,00333,India
380652,2023-09-20,501,iphone 15,60000,80000,20000,1,00333,India
380652,2023-09-20,507,washing machine,6990,16490,9500,1,00333,India
380652,2023-09-20,504,iron,449,879,430,1,00333,India
751653,2023-09-20,501,iphone 15,60000,80000,20000,1,00290,India
751653,2023-09-20,505,oven,18490,24000,5510,1,00290,India
751653,2023-09-20,503,mixer,1349,3249,1900,1,00290,India
577286,2023-09-20,504,iron,449,879,430,1,00163,India
577286,2023-09-20,506,monitor,3249,8000,4751,1,00163,India
577286,2023-09-20,505,oven,18490,24000,5510,1,00163,India
577286,2023-09-20,503,mixer,1349,3249,1900,1,00163,India
441771,2023-09-20,505,oven,18490,24000,5510,1,00314,India
441771,2023-09-20,501,iphone 15,60000,80000,20000,1,00314,India
215098,2023-09-20,501,iphone 15,60000,80000,20000,1,00291,India
860972,2023-09-20,507,washing machine,6990,16490,9500,1,00070,India
939100,2023-09-20,501,iphone 15,60000,80000,20000,1,00167,India
939100,2023-09-20,505,oven,18490,24000,5510,1,00167,India
939100,2023-09-20,502,iphone 15 pro max,100000,135000,35000,1,00167,India
899944,2023-09-20,503,mixer,1349,3249,1900,1,00144,India
899944,2023-09-20,502,iphone 15 pro max,100000,135000,35000,1,00144,India
899944,2023-09-20,504,iron,449,879,430,1,00144,India
899944,2023-09-20,506,monitor,3249,8000,4751,1,00144,India
224583,2023-09-21,505,oven,18490,24000,5510,1,00081,India
224583,2023-09-21,504,iron,449,879,430,1,00081,India
654579,2023-09-21,506,monitor,3249,8000,4751,1,00028,India
654579,2023-09-21,504,iron,449,879,430,1,00028,India
743393,2023-09-21,504,iron,449,879,430,1,00095,India
743393,2023-09-21,501,iphone 15,60000,80000,20000,1,00095,India
869265,2023-09-21,507,washing machine,6990,16490,9500,1,00096,India
869265,2023-09-21,504,iron,449,879,430,1,00096,India
530421,2023-09-21,506,monitor,3249,8000,4751,1,00318,India
530421,2023-09-21,505,oven,18490,24000,5510,1,00318,India
530421,2023-09-21,504,iron,449,879,430,1,00318,India
530421,2023-09-21,501,iphone 15,60000,80000,20000,1,00318,India
303794,2023-09-21,506,monitor,3249,8000,4751,1,00240,India
303794,2023-09-21,501,iphone 15,60000,80000,20000,1,00240,India
303794,2023-09-21,505,oven,18490,24000,5510,1,00240,India
436716,2023-09-21,501,iphone 15,60000,80000,20000,1,00447,India
436716,2023-09-21,506,monitor,3249,8000,4751,1,00447,India
436716,2023-09-21,505,oven,18490,24000,5510,1,00447,India
436716,2023-09-21,502,iphone 15 pro max,100000,135000,35000,1,00447,India
874108,2023-09-21,501,iphone 15,60000,80000,20000,1,00046,India
874108,2023-09-21,502,iphone 15 pro max,100000,135000,35000,1,00046,India
874108,2023-09-21,504,iron,449,879,430,1,00046,India
208219,2023-09-21,507,washing machine,6990,16490,9500,1,00040,India
208219,2023-09-21,502,iphone 15 pro max,100000,135000,35000,1,00040,India
468682,2023-09-21,506,monitor,3249,8000,4751,1,00340,India
468682,2023-09-21,503,mixer,1349,3249,1900,1,00340,India
468682,2023-09-21,504,iron,449,879,430,1,00340,India
359684,2023-09-21,507,washing machine,6990,16490,9500,1,00441,India
359684,2023-09-21,506,monitor,3249,8000,4751,1,00441,India
359684,2023-09-21,504,iron,449,879,430,1,00441,India
191358,2023-09-21,506,monitor,3249,8000,4751,1,00183,India
191358,2023-09-21,501,iphone 15,60000,80000,20000,1,00183,India
748254,2023-09-21,507,washing machine,6990,16490,9500,1,00467,India
748254,2023-09-21,501,iphone 15,60000,80000,20000,1,00467,India
748254,2023-09-21,505,oven,18490,24000,5510,1,00467,India
748254,2023-09-21,504,iron,449,879,430,1,00467,India
748254,2023-09-21,503,mixer,1349,3249,1900,1,00467,India
781338,2023-09-21,501,iphone 15,60000,80000,20000,1,00079,India
781338,2023-09-21,506,monitor,3249,8000,4751,1,00079,India
349626,2023-09-21,507,washing machine,6990,16490,9500,1,00031,India
349626,2023-09-21,501,iphone 15,60000,80000,20000,1,00031,India
349626,2023-09-21,502,iphone 15 pro max,100000,135000,35000,1,00031,India
349626,2023-09-21,504,iron,449,879,430,1,00031,India
398589,2023-09-21,502,iphone 15 pro max,100000,135000,35000,1,00294,India
398589,2023-09-21,506,monitor,3249,8000,4751,1,00294,India
398589,2023-09-21,505,oven,18490,24000,5510,1,00294,India
398589,2023-09-21,501,iphone 15,60000,80000,20000,1,00294,India
288953,2023-09-21,504,iron,449,879,430,1,00113,India
288953,2023-09-21,502,iphone 15 pro max,100000,135000,35000,1,00113,India
288953,2023-09-21,501,iphone 15,60000,80000,20000,1,00113,India
219609,2023-09-21,504,iron,449,879,430,1,00102,India
219609,2023-09-21,503,mixer,1349,3249,1900,1,00102,India
219609,2023-09-21,506,monitor,3249,8000,4751,1,00102,India
598987,2023-09-21,507,washing machine,6990,16490,9500,1,00266,India
598987,2023-09-21,506,monitor,3249,8000,4751,1,00266,India
898103,2023-09-21,507,washing machine,6990,16490,9500,1,00060,India
251869,2023-09-21,502,iphone 15 pro max,100000,135000,35000,1,00224,India
251869,2023-09-21,505,oven,18490,24000,5510,1,00224,India
251869,2023-09-21,504,iron,449,879,430,1,00224,India
251869,2023-09-21,503,mixer,1349,3249,1900,1,00224,India
251869,2023-09-21,507,washing machine,6990,16490,9500,1,00224,India
809163,2023-09-21,506,monitor,3249,8000,4751,1,00239,India
203004,2023-09-21,502,iphone 15 pro max,100000,135000,35000,1,00383,India
162364,2023-09-21,504,iron,449,879,430,1,00243,India
566501,2023-09-21,501,iphone 15,60000,80000,20000,1,00031,India
566501,2023-09-21,503,mixer,1349,3249,1900,1,00031,India
277312,2023-09-21,501,iphone 15,60000,80000,20000,1,00288,India
277312,2023-09-21,507,washing machine,6990,16490,9500,1,00288,India
277312,2023-09-21,502,iphone 15 pro max,100000,135000,35000,1,00288,India
277312,2023-09-21,505,oven,18490,24000,5510,1,00288,India
267167,2023-09-21,506,monitor,3249,8000,4751,1,00379,India
267167,2023-09-21,501,iphone 15,60000,80000,20000,1,00379,India
111610,2023-09-21,501,iphone 15,60000,80000,20000,1,00358,India
111610,2023-09-21,507,washing machine,6990,16490,9500,1,00358,India
296388,2023-09-21,504,iron,449,879,430,1,00170,India
296388,2023-09-21,507,washing machine,6990,16490,9500,1,00170,India
296388,2023-09-21,506,monitor,3249,8000,4751,1,00170,India
296388,2023-09-21,503,mixer,1349,3249,1900,1,00170,India
510710,2023-09-21,507,washing machine,6990,16490,9500,1,00189,India
510710,2023-09-21,501,iphone 15,60000,80000,20000,1,00189,India
239012,2023-09-21,506,monitor,3249,8000,4751,1,00495,India
239012,2023-09-21,502,iphone 15 pro max,100000,135000,35000,1,00495,India
239012,2023-09-21,505,oven,18490,24000,5510,1,00495,India
239012,2023-09-21,503,mixer,1349,3249,1900,1,00495,India
614539,2023-09-21,501,iphone 15,60000,80000,20000,1,00449,India
614539,2023-09-21,507,washing machine,6990,16490,9500,1,00449,India
614539,2023-09-21,506,monitor,3249,8000,4751,1,00449,India
614539,2023-09-21,502,iphone 15 pro max,100000,135000,35000,1,00449,India
438664,2023-09-21,505,oven,18490,24000,5510,1,00180,India
438664,2023-09-21,507,washing machine,6990,16490,9500,1,00180,India
438664,2023-09-21,504,iron,449,879,430,1,00180,India
627127,2023-09-21,506,monitor,3249,8000,4751,1,00309,India
627127,2023-09-21,504,iron,449,879,430,1,00309,India
465531,2023-09-21,504,iron,449,879,430,1,00128,India
465531,2023-09-21,503,mixer,1349,3249,1900,1,00128,India
465531,2023-09-21,505,oven,18490,24000,5510,1,00128,India
465531,2023-09-21,507,washing machine,6990,16490,9500,1,00128,India
465531,2023-09-21,502,iphone 15 pro max,100000,135000,35000,1,00128,India
303108,2023-09-21,502,iphone 15 pro max,100000,135000,35000,1,00450,India
303108,2023-09-21,505,oven,18490,24000,5510,1,00450,India
142574,2023-09-21,504,iron,449,879,430,1,00491,India
142574,2023-09-21,506,monitor,3249,8000,4751,1,00491,India
142574,2023-09-21,501,iphone 15,60000,80000,20000,1,00491,India
504553,2023-09-21,505,oven,18490,24000,5510,1,00317,India
472812,2023-09-21,506,monitor,3249,8000,4751,1,00171,India
472812,2023-09-21,502,iphone 15 pro max,100000,135000,35000,1,00171,India
472812,2023-09-21,503,mixer,1349,3249,1900,1,00171,India
384653,2023-09-21,503,mixer,1349,3249,1900,1,00318,India
384653,2023-09-21,504,iron,449,879,430,1,00318,India
384653,2023-09-21,502,iphone 15 pro max,100000,135000,35000,1,00318,India
384653,2023-09-21,501,iphone 15,60000,80000,20000,1,00318,India
472815,2023-09-21,502,iphone 15 pro max,100000,135000,35000,1,00015,India
399923,2023-09-21,502,iphone 15 pro max,100000,135000,35000,1,00332,India
104920,2023-09-21,506,monitor,3249,8000,4751,1,00034,India
104920,2023-09-21,503,mixer,1349,3249,1900,1,00034,India
104920,2023-09-21,505,oven,18490,24000,5510,1,00034,India
566251,2023-09-21,502,iphone 15 pro max,100000,135000,35000,1,00115,India
566251,2023-09-21,506,monitor,3249,8000,4751,1,00115,India
566251,2023-09-21,507,washing machine,6990,16490,9500,1,00115,India
698754,2023-09-21,504,iron,449,879,430,1,00220,India
698754,2023-09-21,506,monitor,3249,8000,4751,1,00220,India
698754,2023-09-21,503,mixer,1349,3249,1900,1,00220,India
580193,2023-09-21,503,mixer,1349,3249,1900,1,00244,India
540928,2023-09-21,506,monitor,3249,8000,4751,1,00488,India
171933,2023-09-21,506,monitor,3249,8000,4751,1,00396,India
171933,2023-09-21,504,iron,449,879,430,1,00396,India
429573,2023-09-21,502,iphone 15 pro max,100000,135000,35000,1,00031,India
429573,2023-09-21,506,monitor,3249,8000,4751,1,00031,India
429573,2023-09-21,501,iphone 15,60000,80000,20000,1,00031,India
686933,2023-09-21,503,mixer,1349,3249,1900,1,00105,India
686933,2023-09-21,502,iphone 15 pro max,100000,135000,35000,1,00105,India
686933,2023-09-21,505,oven,18490,24000,5510,1,00105,India
686933,2023-09-21,504,iron,449,879,430,1,00105,India
280546,2023-09-21,502,iphone 15 pro max,100000,135000,35000,1,00262,India
280546,2023-09-21,505,oven,18490,24000,5510,1,00262,India
818479,2023-09-21,505,oven,18490,24000,5510,1,00032,India
818479,2023-09-21,501,iphone 15,60000,80000,20000,1,00032,India
818479,2023-09-21,507,washing machine,6990,16490,9500,1,00032,India
725216,2023-09-21,506,monitor,3249,8000,4751,1,00451,India
725216,2023-09-21,502,iphone 15 pro max,100000,135000,35000,1,00451,India
725216,2023-09-21,505,oven,18490,24000,5510,1,00451,India
725216,2023-09-21,507,washing machine,6990,16490,9500,1,00451,India
781074,2023-09-21,502,iphone 15 pro max,100000,135000,35000,1,00266,India
247345,2023-09-21,507,washing machine,6990,16490,9500,1,00253,India
934974,2023-09-21,503,mixer,1349,3249,1900,1,00163,India
934974,2023-09-21,506,monitor,3249,8000,4751,1,00163,India
913388,2023-09-21,503,mixer,1349,3249,1900,1,00204,India
913388,2023-09-21,507,washing machine,6990,16490,9500,1,00204,India
913388,2023-09-21,505,oven,18490,24000,5510,1,00204,India
619626,2023-09-21,506,monitor,3249,8000,4751,1,00478,India
619626,2023-09-21,507,washing machine,6990,16490,9500,1,00478,India
619626,2023-09-21,504,iron,449,879,430,1,00478,India
619626,2023-09-21,505,oven,18490,24000,5510,1,00478,India
619626,2023-09-21,502,iphone 15 pro max,100000,135000,35000,1,00478,India
826415,2023-09-21,504,iron,449,879,430,1,00224,India
826415,2023-09-21,501,iphone 15,60000,80000,20000,1,00224,India
826415,2023-09-21,505,oven,18490,24000,5510,1,00224,India
610757,2023-09-21,502,iphone 15 pro max,100000,135000,35000,1,00301,India
610757,2023-09-21,506,monitor,3249,8000,4751,1,00301,India
753378,2023-09-21,503,mixer,1349,3249,1900,1,00090,India
753378,2023-09-21,507,washing machine,6990,16490,9500,1,00090,India
578305,2023-09-21,504,iron,449,879,430,1,00023,India
578305,2023-09-21,507,washing machine,6990,16490,9500,1,00023,India
469296,2023-09-21,507,washing machine,6990,16490,9500,1,00474,India
793390,2023-09-21,504,iron,449,879,430,1,00028,India
754250,2023-09-21,505,oven,18490,24000,5510,1,00165,India
754250,2023-09-21,502,iphone 15 pro max,100000,135000,35000,1,00165,India
616579,2023-09-21,505,oven,18490,24000,5510,1,00232,India
616579,2023-09-21,504,iron,449,879,430,1,00232,India
934552,2023-09-21,503,mixer,1349,3249,1900,1,00411,India
934552,2023-09-21,501,iphone 15,60000,80000,20000,1,00411,India
934552,2023-09-21,502,iphone 15 pro max,100000,135000,35000,1,00411,India
934552,2023-09-21,504,iron,449,879,430,1,00411,India
934552,2023-09-21,507,washing machine,6990,16490,9500,1,00411,India
169295,2023-09-21,501,iphone 15,60000,80000,20000,1,00493,India
335069,2023-09-21,501,iphone 15,60000,80000,20000,1,00309,India
919259,2023-09-21,507,washing machine,6990,16490,9500,1,00427,India
919259,2023-09-21,505,oven,18490,24000,5510,1,00427,India
585060,2023-09-21,503,mixer,1349,3249,1900,1,00226,India
585060,2023-09-21,502,iphone 15 pro max,100000,135000,35000,1,00226,India
585060,2023-09-21,505,oven,18490,24000,5510,1,00226,India
585060,2023-09-21,506,monitor,3249,8000,4751,1,00226,India
803424,2023-09-21,501,iphone 15,60000,80000,20000,1,00042,India
406082,2023-09-21,506,monitor,3249,8000,4751,1,00030,India
406082,2023-09-21,504,iron,449,879,430,1,00030,India
406082,2023-09-21,507,washing machine,6990,16490,9500,1,00030,India
834440,2023-09-21,504,iron,449,879,430,1,00349,India
834440,2023-09-21,507,washing machine,6990,16490,9500,1,00349,India
834440,2023-09-21,506,monitor,3249,8000,4751,1,00349,India
703194,2023-09-21,503,mixer,1349,3249,1900,1,00478,India
703194,2023-09-21,502,iphone 15 pro max,100000,135000,35000,1,00478,India
703194,2023-09-21,504,iron,449,879,430,1,00478,India
703194,2023-09-21,501,iphone 15,60000,80000,20000,1,00478,India
329411,2023-09-21,507,washing machine,6990,16490,9500,1,00260,India
329411,2023-09-21,502,iphone 15 pro max,100000,135000,35000,1,00260,India
394388,2023-09-21,507,washing machine,6990,16490,9500,1,00006,India
394388,2023-09-21,501,iphone 15,60000,80000,20000,1,00006,India
394388,2023-09-21,503,mixer,1349,3249,1900,1,00006,India
394388,2023-09-21,502,iphone 15 pro max,100000,135000,35000,1,00006,India
234628,2023-09-21,501,iphone 15,60000,80000,20000,1,00197,India
351529,2023-09-21,505,oven,18490,24000,5510,1,00224,India
561864,2023-09-21,505,oven,18490,24000,5510,1,00006,India
561864,2023-09-21,507,washing machine,6990,16490,9500,1,00006,India
561864,2023-09-21,502,iphone 15 pro max,100000,135000,35000,1,00006,India
823225,2023-09-21,506,monitor,3249,8000,4751,1,00151,India
226774,2023-09-21,505,oven,18490,24000,5510,1,00053,India
226774,2023-09-21,504,iron,449,879,430,1,00053,India
226774,2023-09-21,507,washing machine,6990,16490,9500,1,00053,India
226774,2023-09-21,502,iphone 15 pro max,100000,135000,35000,1,00053,India
880522,2023-09-21,504,iron,449,879,430,1,00162,India
710316,2023-09-21,504,iron,449,879,430,1,00207,India
710316,2023-09-21,506,monitor,3249,8000,4751,1,00207,India
327824,2023-09-22,504,iron,449,879,430,1,00110,India
327824,2023-09-22,501,iphone 15,60000,80000,20000,1,00110,India
327824,2023-09-22,507,washing machine,6990,16490,9500,1,00110,India
628799,2023-09-22,503,mixer,1349,3249,1900,1,00344,India
628799,2023-09-22,502,iphone 15 pro max,100000,135000,35000,1,00344,India
628799,2023-09-22,501,iphone 15,60000,80000,20000,1,00344,India
929809,2023-09-22,507,washing machine,6990,16490,9500,1,00034,India
929809,2023-09-22,502,iphone 15 pro max,100000,135000,35000,1,00034,India
929809,2023-09-22,501,iphone 15,60000,80000,20000,1,00034,India
491785,2023-09-22,504,iron,449,879,430,1,00277,India
491785,2023-09-22,503,mixer,1349,3249,1900,1,00277,India
491785,2023-09-22,506,monitor,3249,8000,4751,1,00277,India
337282,2023-09-22,505,oven,18490,24000,5510,1,00405,India
337282,2023-09-22,503,mixer,1349,3249,1900,1,00405,India
980568,2023-09-22,507,washing machine,6990,16490,9500,1,00228,India
980568,2023-09-22,504,iron,449,879,430,1,00228,India
655239,2023-09-22,505,oven,18490,24000,5510,1,00277,India
655239,2023-09-22,501,iphone 15,60000,80000,20000,1,00277,India
103173,2023-09-22,507,washing machine,6990,16490,9500,1,00036,India
940582,2023-09-22,501,iphone 15,60000,80000,20000,1,00186,India
940582,2023-09-22,503,mixer,1349,3249,1900,1,00186,India
585938,2023-09-22,505,oven,18490,24000,5510,1,00189,India
631873,2023-09-22,503,mixer,1349,3249,1900,1,00227,India
631873,2023-09-22,507,washing machine,6990,16490,9500,1,00227,India
477803,2023-09-22,504,iron,449,879,430,1,00109,India
477803,2023-09-22,501,iphone 15,60000,80000,20000,1,00109,India
477803,2023-09-22,505,oven,18490,24000,5510,1,00109,India
477803,2023-09-22,506,monitor,3249,8000,4751,1,00109,India
718702,2023-09-22,501,iphone 15,60000,80000,20000,1,00486,India
718702,2023-09-22,504,iron,449,879,430,1,00486,India
812541,2023-09-22,501,iphone 15,60000,80000,20000,1,00426,India
812541,2023-09-22,502,iphone 15 pro max,100000,135000,35000,1,00426,India
812541,2023-09-22,507,washing machine,6990,16490,9500,1,00426,India
342327,2023-09-22,503,mixer,1349,3249,1900,1,00349,India
342327,2023-09-22,502,iphone 15 pro max,100000,135000,35000,1,00349,India
342327,2023-09-22,506,monitor,3249,8000,4751,1,00349,India
503797,2023-09-22,505,oven,18490,24000,5510,1,00142,India
307163,2023-09-22,507,washing machine,6990,16490,9500,1,00027,India
307163,2023-09-22,504,iron,449,879,430,1,00027,India
407634,2023-09-22,505,oven,18490,24000,5510,1,00013,India
953698,2023-09-22,504,iron,449,879,430,1,00404,India
953698,2023-09-22,501,iphone 15,60000,80000,20000,1,00404,India
952409,2023-09-22,503,mixer,1349,3249,1900,1,00457,India
670647,2023-09-22,503,mixer,1349,3249,1900,1,00229,India
670647,2023-09-22,506,monitor,3249,8000,4751,1,00229,India
271628,2023-09-22,503,mixer,1349,3249,1900,1,00114,India
271628,2023-09-22,502,iphone 15 pro max,100000,135000,35000,1,00114,India
534884,2023-09-22,504,iron,449,879,430,1,00078,India
534884,2023-09-22,503,mixer,1349,3249,1900,1,00078,India
974474,2023-09-22,501,iphone 15,60000,80000,20000,1,00405,India
312191,2023-09-22,502,iphone 15 pro max,100000,135000,35000,1,00373,India
797797,2023-09-22,507,washing machine,6990,16490,9500,1,00220,India
533113,2023-09-22,504,iron,449,879,430,1,00125,India
813144,2023-09-22,501,iphone 15,60000,80000,20000,1,00108,India
343623,2023-09-22,504,iron,449,879,430,1,00014,India
343623,2023-09-22,507,washing machine,6990,16490,9500,1,00014,India
343623,2023-09-22,501,iphone 15,60000,80000,20000,1,00014,India
581807,2023-09-22,501,iphone 15,60000,80000,20000,1,00256,India
581807,2023-09-22,507,washing machine,6990,16490,9500,1,00256,India
581807,2023-09-22,503,mixer,1349,3249,1900,1,00256,India
747056,2023-09-22,505,oven,18490,24000,5510,1,00310,India
747056,2023-09-22,503,mixer,1349,3249,1900,1,00310,India
747056,2023-09-22,501,iphone 15,60000,80000,20000,1,00310,India
981230,2023-09-22,503,mixer,1349,3249,1900,1,00028,India
981230,2023-09-22,504,iron,449,879,430,1,00028,India
981230,2023-09-22,502,iphone 15 pro max,100000,135000,35000,1,00028,India
636135,2023-09-22,504,iron,449,879,430,1,00370,India
636135,2023-09-22,505,oven,18490,24000,5510,1,00370,India
636135,2023-09-22,501,iphone 15,60000,80000,20000,1,00370,India
194025,2023-09-22,502,iphone 15 pro max,100000,135000,35000,1,00457,India
194025,2023-09-22,505,oven,18490,24000,5510,1,00457,India
194025,2023-09-22,504,iron,449,879,430,1,00457,India
194025,2023-09-22,506,monitor,3249,8000,4751,1,00457,India
194025,2023-09-22,501,iphone 15,60000,80000,20000,1,00457,India
328786,2023-09-22,505,oven,18490,24000,5510,1,00265,India
335718,2023-09-22,501,iphone 15,60000,80000,20000,1,00466,India
335718,2023-09-22,503,mixer,1349,3249,1900,1,00466,India
335718,2023-09-22,507,washing machine,6990,16490,9500,1,00466,India
403168,2023-09-22,501,iphone 15,60000,80000,20000,1,00428,India
403168,2023-09-22,504,iron,449,879,430,1,00428,India
883390,2023-09-22,503,mixer,1349,3249,1900,1,00079,India
883390,2023-09-22,504,iron,449,879,430,1,00079,India
883390,2023-09-22,501,iphone 15,60000,80000,20000,1,00079,India
808760,2023-09-22,503,mixer,1349,3249,1900,1,00050,India
731417,2023-09-22,503,mixer,1349,3249,1900,1,00498,India
731417,2023-09-22,505,oven,18490,24000,5510,1,00498,India
731417,2023-09-22,502,iphone 15 pro max,100000,135000,35000,1,00498,India
637387,2023-09-22,502,iphone 15 pro max,100000,135000,35000,1,00489,India
362868,2023-09-22,501,iphone 15,60000,80000,20000,1,00381,India
600133,2023-09-22,506,monitor,3249,8000,4751,1,00389,India
600133,2023-09-22,505,oven,18490,24000,5510,1,00389,India
600133,2023-09-22,504,iron,449,879,430,1,00389,India
600133,2023-09-22,507,washing machine,6990,16490,9500,1,00389,India
869185,2023-09-22,501,iphone 15,60000,80000,20000,1,00440,India
869185,2023-09-22,506,monitor,3249,8000,4751,1,00440,India
885212,2023-09-22,503,mixer,1349,3249,1900,1,00208,India
885212,2023-09-22,507,washing machine,6990,16490,9500,1,00208,India
885212,2023-09-22,501,iphone 15,60000,80000,20000,1,00208,India
396438,2023-09-22,503,mixer,1349,3249,1900,1,00402,India
396438,2023-09-22,506,monitor,3249,8000,4751,1,00402,India
623816,2023-09-22,507,washing machine,6990,16490,9500,1,00383,India
519404,2023-09-22,503,mixer,1349,3249,1900,1,00282,India
519404,2023-09-22,506,monitor,3249,8000,4751,1,00282,India
751347,2023-09-22,502,iphone 15 pro max,100000,135000,35000,1,00492,India
751347,2023-09-22,501,iphone 15,60000,80000,20000,1,00492,India
751347,2023-09-22,504,iron,449,879,430,1,00492,India
751347,2023-09-22,505,oven,18490,24000,5510,1,00492,India
467431,2023-09-22,507,washing machine,6990,16490,9500,1,00449,India
467431,2023-09-22,504,iron,449,879,430,1,00449,India
467431,2023-09-22,506,monitor,3249,8000,4751,1,00449,India
266647,2023-09-22,502,iphone 15 pro max,100000,135000,35000,1,00356,India
785696,2023-09-22,501,iphone 15,60000,80000,20000,1,00003,India
285471,2023-09-22,504,iron,449,879,430,1,00481,India
532513,2023-09-22,507,washing machine,6990,16490,9500,1,00308,India
532513,2023-09-22,506,monitor,3249,8000,4751,1,00308,India
532513,2023-09-22,504,iron,449,879,430,1,00308,India
659703,2023-09-22,503,mixer,1349,3249,1900,1,00216,India
659703,2023-09-22,507,washing machine,6990,16490,9500,1,00216,India
689922,2023-09-22,506,monitor,3249,8000,4751,1,00128,India
689922,2023-09-22,502,iphone 15 pro max,100000,135000,35000,1,00128,India
689922,2023-09-22,507,washing machine,6990,16490,9500,1,00128,India
839866,2023-09-22,501,iphone 15,60000,80000,20000,1,00271,India
839866,2023-09-22,507,washing machine,6990,16490,9500,1,00271,India
839866,2023-09-22,503,mixer,1349,3249,1900,1,00271,India
839866,2023-09-22,506,monitor,3249,8000,4751,1,00271,India
177788,2023-09-22,501,iphone 15,60000,80000,20000,1,00411,India
618774,2023-09-22,501,iphone 15,60000,80000,20000,1,00157,India
618774,2023-09-22,504,iron,449,879,430,1,00157,India
302740,2023-09-22,502,iphone 15 pro max,100000,135000,35000,1,00441,India
302740,2023-09-22,501,iphone 15,60000,80000,20000,1,00441,India
302740,2023-09-22,504,iron,449,879,430,1,00441,India
149000,2023-09-22,503,mixer,1349,3249,1900,1,00036,India
149000,2023-09-22,501,iphone 15,60000,80000,20000,1,00036,India
149000,2023-09-22,502,iphone 15 pro max,100000,135000,35000,1,00036,India
149000,2023-09-22,506,monitor,3249,8000,4751,1,00036,India
692291,2023-09-22,504,iron,449,879,430,1,00055,India
692291,2023-09-22,507,washing machine,6990,16490,9500,1,00055,India
692291,2023-09-22,505,oven,18490,24000,5510,1,00055,India
836219,2023-09-22,505,oven,18490,24000,5510,1,00082,India
836219,2023-09-22,507,washing machine,6990,16490,9500,1,00082,India
688709,2023-09-22,507,washing machine,6990,16490,9500,1,00049,India
688709,2023-09-22,505,oven,18490,24000,5510,1,00049,India
688709,2023-09-22,503,mixer,1349,3249,1900,1,00049,India
688709,2023-09-22,501,iphone 15,60000,80000,20000,1,00049,India
766166,2023-09-22,501,iphone 15,60000,80000,20000,1,00002,India
766166,2023-09-22,503,mixer,1349,3249,1900,1,00002,India
766166,2023-09-22,506,monitor,3249,8000,4751,1,00002,India
766166,2023-09-22,504,iron,449,879,430,1,00002,India
766166,2023-09-22,505,oven,18490,24000,5510,1,00002,India
276639,2023-09-22,503,mixer,1349,3249,1900,1,00192,India
332409,2023-09-22,505,oven,18490,24000,5510,1,00232,India
332409,2023-09-22,502,iphone 15 pro max,100000,135000,35000,1,00232,India
345764,2023-09-22,507,washing machine,6990,16490,9500,1,00447,India
345764,2023-09-22,506,monitor,3249,8000,4751,1,00447,India
345764,2023-09-22,505,oven,18490,24000,5510,1,00447,India
975610,2023-09-22,502,iphone 15 pro max,100000,135000,35000,1,00380,India
975610,2023-09-22,503,mixer,1349,3249,1900,1,00380,India
975610,2023-09-22,504,iron,449,879,430,1,00380,India
311848,2023-09-22,501,iphone 15,60000,80000,20000,1,00292,India
311848,2023-09-22,502,iphone 15 pro max,100000,135000,35000,1,00292,India
447399,2023-09-22,505,oven,18490,24000,5510,1,00456,India
447399,2023-09-22,506,monitor,3249,8000,4751,1,00456,India
633327,2023-09-22,501,iphone 15,60000,80000,20000,1,00313,India
633327,2023-09-22,504,iron,449,879,430,1,00313,India
633327,2023-09-22,506,monitor,3249,8000,4751,1,00313,India
633327,2023-09-22,502,iphone 15 pro max,100000,135000,35000,1,00313,India
633327,2023-09-22,505,oven,18490,24000,5510,1,00313,India
529513,2023-09-22,504,iron,449,879,430,1,00201,India
529513,2023-09-22,502,iphone 15 pro max,100000,135000,35000,1,00201,India
529513,2023-09-22,503,mixer,1349,3249,1900,1,00201,India
529513,2023-09-22,501,iphone 15,60000,80000,20000,1,00201,India
505495,2023-09-22,503,mixer,1349,3249,1900,1,00045,India
505495,2023-09-22,506,monitor,3249,8000,4751,1,00045,India
505495,2023-09-22,501,iphone 15,60000,80000,20000,1,00045,India
505495,2023-09-22,505,oven,18490,24000,5510,1,00045,India
230720,2023-09-22,507,washing machine,6990,16490,9500,1,00316,India
230720,2023-09-22,506,monitor,3249,8000,4751,1,00316,India
230720,2023-09-22,504,iron,449,879,430,1,00316,India
767858,2023-09-22,501,iphone 15,60000,80000,20000,1,00379,India
767858,2023-09-22,505,oven,18490,24000,5510,1,00379,India
767858,2023-09-22,502,iphone 15 pro max,100000,135000,35000,1,00379,India
767858,2023-09-22,504,iron,449,879,430,1,00379,India
624151,2023-09-22,507,washing machine,6990,16490,9500,1,00210,India
624151,2023-09-22,506,monitor,3249,8000,4751,1,00210,India
530371,2023-09-23,504,iron,449,879,430,1,00082,India
530371,2023-09-23,507,washing machine,6990,16490,9500,1,00082,India
530371,2023-09-23,505,oven,18490,24000,5510,1,00082,India
907869,2023-09-23,505,oven,18490,24000,5510,1,00440,India
907869,2023-09-23,506,monitor,3249,8000,4751,1,00440,India
907869,2023-09-23,502,iphone 15 pro max,100000,135000,35000,1,00440,India
897461,2023-09-23,503,mixer,1349,3249,1900,1,00256,India
897461,2023-09-23,501,iphone 15,60000,80000,20000,1,00256,India
897461,2023-09-23,505,oven,18490,24000,5510,1,00256,India
125431,2023-09-23,506,monitor,3249,8000,4751,1,00252,India
125431,2023-09-23,507,washing machine,6990,16490,9500,1,00252,India
125431,2023-09-23,503,mixer,1349,3249,1900,1,00252,India
347885,2023-09-23,504,iron,449,879,430,1,00315,India
347885,2023-09-23,501,iphone 15,60000,80000,20000,1,00315,India
347885,2023-09-23,503,mixer,1349,3249,1900,1,00315,India
347885,2023-09-23,506,monitor,3249,8000,4751,1,00315,India
477181,2023-09-23,504,iron,449,879,430,1,00271,India
477181,2023-09-23,505,oven,18490,24000,5510,1,00271,India
477181,2023-09-23,502,iphone 15 pro max,100000,135000,35000,1,00271,India
477181,2023-09-23,501,iphone 15,60000,80000,20000,1,00271,India
442464,2023-09-23,506,monitor,3249,8000,4751,1,00242,India
442464,2023-09-23,507,washing machine,6990,16490,9500,1,00242,India
442464,2023-09-23,501,iphone 15,60000,80000,20000,1,00242,India
442464,2023-09-23,504,iron,449,879,430,1,00242,India
833161,2023-09-23,504,iron,449,879,430,1,00183,India
833161,2023-09-23,501,iphone 15,60000,80000,20000,1,00183,India
833161,2023-09-23,503,mixer,1349,3249,1900,1,00183,India
967205,2023-09-23,506,monitor,3249,8000,4751,1,00244,India
967205,2023-09-23,505,oven,18490,24000,5510,1,00244,India
349978,2023-09-23,503,mixer,1349,3249,1900,1,00247,India
349978,2023-09-23,505,oven,18490,24000,5510,1,00247,India
349978,2023-09-23,501,iphone 15,60000,80000,20000,1,00247,India
508124,2023-09-23,501,iphone 15,60000,80000,20000,1,00006,India
269200,2023-09-23,505,oven,18490,24000,5510,1,00066,India
269200,2023-09-23,504,iron,449,879,430,1,00066,India
269200,2023-09-23,501,iphone 15,60000,80000,20000,1,00066,India
269200,2023-09-23,502,iphone 15 pro max,100000,135000,35000,1,00066,India
269200,2023-09-23,506,monitor,3249,8000,4751,1,00066,India
410009,2023-09-23,503,mixer,1349,3249,1900,1,00334,India
410009,2023-09-23,505,oven,18490,24000,5510,1,00334,India
236978,2023-09-23,507,washing machine,6990,16490,9500,1,00292,India
236978,2023-09-23,506,monitor,3249,8000,4751,1,00292,India
432944,2023-09-23,503,mixer,1349,3249,1900,1,00286,India
432944,2023-09-23,506,monitor,3249,8000,4751,1,00286,India
432944,2023-09-23,505,oven,18490,24000,5510,1,00286,India
724992,2023-09-23,506,monitor,3249,8000,4751,1,00383,India
698942,2023-09-23,502,iphone 15 pro max,100000,135000,35000,1,00185,India
698942,2023-09-23,505,oven,18490,24000,5510,1,00185,India
698942,2023-09-23,504,iron,449,879,430,1,00185,India
508515,2023-09-23,504,iron,449,879,430,1,00056,India
590706,2023-09-23,506,monitor,3249,8000,4751,1,00012,India
590706,2023-09-23,504,iron,449,879,430,1,00012,India
590706,2023-09-23,501,iphone 15,60000,80000,20000,1,00012,India
804287,2023-09-23,506,monitor,3249,8000,4751,1,00431,India
804287,2023-09-23,504,iron,449,879,430,1,00431,India
158043,2023-09-23,502,iphone 15 pro max,100000,135000,35000,1,00291,India
529737,2023-09-23,502,iphone 15 pro max,100000,135000,35000,1,00464,India
529737,2023-09-23,506,monitor,3249,8000,4751,1,00464,India
529737,2023-09-23,501,iphone 15,60000,80000,20000,1,00464,India
529737,2023-09-23,503,mixer,1349,3249,1900,1,00464,India
282315,2023-09-23,506,monitor,3249,8000,4751,1,00032,India
869895,2023-09-23,501,iphone 15,60000,80000,20000,1,00443,India
869895,2023-09-23,502,iphone 15 pro max,100000,135000,35000,1,00443,India
869895,2023-09-23,503,mixer,1349,3249,1900,1,00443,India
173711,2023-09-23,507,washing machine,6990,16490,9500,1,00453,India
669864,2023-09-23,506,monitor,3249,8000,4751,1,00126,India
669864,2023-09-23,504,iron,449,879,430,1,00126,India
669864,2023-09-23,507,washing machine,6990,16490,9500,1,00126,India
876714,2023-09-23,502,iphone 15 pro max,100000,135000,35000,1,00175,India
876714,2023-09-23,505,oven,18490,24000,5510,1,00175,India
876714,2023-09-23,506,monitor,3249,8000,4751,1,00175,India
438568,2023-09-23,503,mixer,1349,3249,1900,1,00236,India
438568,2023-09-23,506,monitor,3249,8000,4751,1,00236,India
438568,2023-09-23,502,iphone 15 pro max,100000,135000,35000,1,00236,India
677335,2023-09-23,501,iphone 15,60000,80000,20000,1,00475,India
677335,2023-09-23,504,iron,449,879,430,1,00475,India
677335,2023-09-23,503,mixer,1349,3249,1900,1,00475,India
107144,2023-09-23,507,washing machine,6990,16490,9500,1,00105,India
107144,2023-09-23,501,iphone 15,60000,80000,20000,1,00105,India
107144,2023-09-23,503,mixer,1349,3249,1900,1,00105,India
705600,2023-09-23,506,monitor,3249,8000,4751,1,00388,India
705600,2023-09-23,504,iron,449,879,430,1,00388,India
266769,2023-09-23,503,mixer,1349,3249,1900,1,00173,India
266769,2023-09-23,502,iphone 15 pro max,100000,135000,35000,1,00173,India
266769,2023-09-23,506,monitor,3249,8000,4751,1,00173,India
266769,2023-09-23,504,iron,449,879,430,1,00173,India
389253,2023-09-23,504,iron,449,879,430,1,00284,India
389253,2023-09-23,505,oven,18490,24000,5510,1,00284,India
230254,2023-09-23,501,iphone 15,60000,80000,20000,1,00292,India
641059,2023-09-23,503,mixer,1349,3249,1900,1,00064,India
641059,2023-09-23,504,iron,449,879,430,1,00064,India
641059,2023-09-23,501,iphone 15,60000,80000,20000,1,00064,India
752582,2023-09-23,506,monitor,3249,8000,4751,1,00471,India
761737,2023-09-23,505,oven,18490,24000,5510,1,00333,India
536347,2023-09-23,506,monitor,3249,8000,4751,1,00444,India
536347,2023-09-23,505,oven,18490,24000,5510,1,00444,India
536347,2023-09-23,501,iphone 15,60000,80000,20000,1,00444,India
536347,2023-09-23,504,iron,449,879,430,1,00444,India
647304,2023-09-23,506,monitor,3249,8000,4751,1,00149,India
647304,2023-09-23,502,iphone 15 pro max,100000,135000,35000,1,00149,India
647304,2023-09-23,503,mixer,1349,3249,1900,1,00149,India
647304,2023-09-23,504,iron,449,879,430,1,00149,India
971238,2023-09-23,505,oven,18490,24000,5510,1,00056,India
971238,2023-09-23,502,iphone 15 pro max,100000,135000,35000,1,00056,India
628829,2023-09-23,503,mixer,1349,3249,1900,1,00044,India
628829,2023-09-23,505,oven,18490,24000,5510,1,00044,India
628829,2023-09-23,501,iphone 15,60000,80000,20000,1,00044,India
628829,2023-09-23,504,iron,449,879,430,1,00044,India
881117,2023-09-23,506,monitor,3249,8000,4751,1,00241,India
881117,2023-09-23,503,mixer,1349,3249,1900,1,00241,India
918746,2023-09-23,507,washing machine,6990,16490,9500,1,00466,India
918746,2023-09-23,503,mixer,1349,3249,1900,1,00466,India
918746,2023-09-23,501,iphone 15,60000,80000,20000,1,00466,India
692830,2023-09-23,506,monitor,3249,8000,4751,1,00137,India
692830,2023-09-23,507,washing machine,6990,16490,9500,1,00137,India
330265,2023-09-23,503,mixer,1349,3249,1900,1,00045,India
499498,2023-09-23,505,oven,18490,24000,5510,1,00453,India
499498,2023-09-23,504,iron,449,879,430,1,00453,India
578082,2023-09-23,507,washing machine,6990,16490,9500,1,00391,India
578082,2023-09-23,504,iron,449,879,430,1,00391,India
578082,2023-09-23,501,iphone 15,60000,80000,20000,1,00391,India
180592,2023-09-23,504,iron,449,879,430,1,00356,India
180592,2023-09-23,507,washing machine,6990,16490,9500,1,00356,India
471853,2023-09-23,507,washing machine,6990,16490,9500,1,00243,India
471853,2023-09-23,504,iron,449,879,430,1,00243,India
471853,2023-09-23,503,mixer,1349,3249,1900,1,00243,India
295226,2023-09-23,506,monitor,3249,8000,4751,1,00016,India
295226,2023-09-23,504,iron,449,879,430,1,00016,India
295226,2023-09-23,502,iphone 15 pro max,100000,135000,35000,1,00016,India
533625,2023-09-23,502,iphone 15 pro max,100000,135000,35000,1,00348,India
533625,2023-09-23,503,mixer,1349,3249,1900,1,00348,India
950532,2023-09-23,507,washing machine,6990,16490,9500,1,00407,India
950532,2023-09-23,502,iphone 15 pro max,100000,135000,35000,1,00407,India
950532,2023-09-23,505,oven,18490,24000,5510,1,00407,India
513685,2023-09-23,503,mixer,1349,3249,1900,1,00405,India
513685,2023-09-23,506,monitor,3249,8000,4751,1,00405,India
513685,2023-09-23,501,iphone 15,60000,80000,20000,1,00405,India
435495,2023-09-23,506,monitor,3249,8000,4751,1,00397,India
435495,2023-09-23,501,iphone 15,60000,80000,20000,1,00397,India
999418,2023-09-23,504,iron,449,879,430,1,00073,India
999418,2023-09-23,503,mixer,1349,3249,1900,1,00073,India
999418,2023-09-23,502,iphone 15 pro max,100000,135000,35000,1,00073,India
550523,2023-09-23,502,iphone 15 pro max,100000,135000,35000,1,00204,India
574586,2023-09-23,501,iphone 15,60000,80000,20000,1,00325,India
913423,2023-09-23,501,iphone 15,60000,80000,20000,1,00216,India
985879,2023-09-24,507,washing machine,6990,16490,9500,1,00083,India
985879,2023-09-24,506,monitor,3249,8000,4751,1,00083,India
985879,2023-09-24,501,iphone 15,60000,80000,20000,1,00083,India
937416,2023-09-24,503,mixer,1349,3249,1900,1,00161,India
658616,2023-09-24,506,monitor,3249,8000,4751,1,00092,India
658616,2023-09-24,503,mixer,1349,3249,1900,1,00092,India
658616,2023-09-24,505,oven,18490,24000,5510,1,00092,India
796767,2023-09-24,507,washing machine,6990,16490,9500,1,00451,India
796767,2023-09-24,506,monitor,3249,8000,4751,1,00451,India
524287,2023-09-24,504,iron,449,879,430,1,00019,India
524287,2023-09-24,505,oven,18490,24000,5510,1,00019,India
524287,2023-09-24,507,washing machine,6990,16490,9500,1,00019,India
524287,2023-09-24,503,mixer,1349,3249,1900,1,00019,India
280062,2023-09-24,504,iron,449,879,430,1,00307,India
280062,2023-09-24,506,monitor,3249,8000,4751,1,00307,India
802159,2023-09-24,506,monitor,3249,8000,4751,1,00319,India
802159,2023-09-24,504,iron,449,879,430,1,00319,India
802159,2023-09-24,501,iphone 15,60000,80000,20000,1,00319,India
802159,2023-09-24,502,iphone 15 pro max,100000,135000,35000,1,00319,India
536979,2023-09-24,506,monitor,3249,8000,4751,1,00015,India
536979,2023-09-24,502,iphone 15 pro max,100000,135000,35000,1,00015,India
382706,2023-09-24,506,monitor,3249,8000,4751,1,00412,India
382706,2023-09-24,502,iphone 15 pro max,100000,135000,35000,1,00412,India
382706,2023-09-24,501,iphone 15,60000,80000,20000,1,00412,India
412164,2023-09-24,505,oven,18490,24000,5510,1,00091,India
690035,2023-09-24,501,iphone 15,60000,80000,20000,1,00127,India
690035,2023-09-24,505,oven,18490,24000,5510,1,00127,India
690035,2023-09-24,502,iphone 15 pro max,100000,135000,35000,1,00127,India
731785,2023-09-24,501,iphone 15,60000,80000,20000,1,00322,India
731785,2023-09-24,505,oven,18490,24000,5510,1,00322,India
731785,2023-09-24,503,mixer,1349,3249,1900,1,00322,India
731785,2023-09-24,507,washing machine,6990,16490,9500,1,00322,India
845517,2023-09-24,501,iphone 15,60000,80000,20000,1,00077,India
845517,2023-09-24,502,iphone 15 pro max,100000,135000,35000,1,00077,India
384569,2023-09-24,506,monitor,3249,8000,4751,1,00391,India
384569,2023-09-24,502,iphone 15 pro max,100000,135000,35000,1,00391,India
384569,2023-09-24,505,oven,18490,24000,5510,1,00391,India
384569,2023-09-24,507,washing machine,6990,16490,9500,1,00391,India
853891,2023-09-24,506,monitor,3249,8000,4751,1,00484,India
853891,2023-09-24,503,mixer,1349,3249,1900,1,00484,India
853891,2023-09-24,505,oven,18490,24000,5510,1,00484,India
853891,2023-09-24,504,iron,449,879,430,1,00484,India
254591,2023-09-24,502,iphone 15 pro max,100000,135000,35000,1,00337,India
254591,2023-09-24,501,iphone 15,60000,80000,20000,1,00337,India
254591,2023-09-24,504,iron,449,879,430,1,00337,India
207118,2023-09-24,503,mixer,1349,3249,1900,1,00049,India
496385,2023-09-24,503,mixer,1349,3249,1900,1,00431,India
911847,2023-09-24,506,monitor,3249,8000,4751,1,00315,India
911847,2023-09-24,507,washing machine,6990,16490,9500,1,00315,India
911847,2023-09-24,505,oven,18490,24000,5510,1,00315,India
881923,2023-09-24,504,iron,449,879,430,1,00236,India
881923,2023-09-24,507,washing machine,6990,16490,9500,1,00236,India
881923,2023-09-24,503,mixer,1349,3249,1900,1,00236,India
796815,2023-09-24,502,iphone 15 pro max,100000,135000,35000,1,00270,India
796815,2023-09-24,504,iron,449,879,430,1,00270,India
423937,2023-09-24,504,iron,449,879,430,1,00145,India
423937,2023-09-24,502,iphone 15 pro max,100000,135000,35000,1,00145,India
423937,2023-09-24,503,mixer,1349,3249,1900,1,00145,India
832942,2023-09-24,502,iphone 15 pro max,100000,135000,35000,1,00450,India
832942,2023-09-24,504,iron,449,879,430,1,00450,India
832942,2023-09-24,506,monitor,3249,8000,4751,1,00450,India
458668,2023-09-24,507,washing machine,6990,16490,9500,1,00081,India
458668,2023-09-24,502,iphone 15 pro max,100000,135000,35000,1,00081,India
843675,2023-09-24,502,iphone 15 pro max,100000,135000,35000,1,00299,India
843675,2023-09-24,506,monitor,3249,8000,4751,1,00299,India
843675,2023-09-24,503,mixer,1349,3249,1900,1,00299,India
843675,2023-09-24,501,iphone 15,60000,80000,20000,1,00299,India
919127,2023-09-24,504,iron,449,879,430,1,00352,India
919127,2023-09-24,502,iphone 15 pro max,100000,135000,35000,1,00352,India
919127,2023-09-24,501,iphone 15,60000,80000,20000,1,00352,India
442692,2023-09-24,502,iphone 15 pro max,100000,135000,35000,1,00009,India
442692,2023-09-24,506,monitor,3249,8000,4751,1,00009,India
275917,2023-09-24,503,mixer,1349,3249,1900,1,00304,India
275917,2023-09-24,505,oven,18490,24000,5510,1,00304,India
712301,2023-09-24,506,monitor,3249,8000,4751,1,00148,India
712301,2023-09-24,503,mixer,1349,3249,1900,1,00148,India
712301,2023-09-24,504,iron,449,879,430,1,00148,India
712301,2023-09-24,502,iphone 15 pro max,100000,135000,35000,1,00148,India
400492,2023-09-24,507,washing machine,6990,16490,9500,1,00467,India
400492,2023-09-24,504,iron,449,879,430,1,00467,India
436757,2023-09-24,502,iphone 15 pro max,100000,135000,35000,1,00233,India
436757,2023-09-24,504,iron,449,879,430,1,00233,India
436757,2023-09-24,506,monitor,3249,8000,4751,1,00233,India
108305,2023-09-24,501,iphone 15,60000,80000,20000,1,00114,India
665623,2023-09-24,505,oven,18490,24000,5510,1,00255,India
665623,2023-09-24,502,iphone 15 pro max,100000,135000,35000,1,00255,India
665623,2023-09-24,506,monitor,3249,8000,4751,1,00255,India
665623,2023-09-24,503,mixer,1349,3249,1900,1,00255,India
857521,2023-09-24,505,oven,18490,24000,5510,1,00143,India
857521,2023-09-24,502,iphone 15 pro max,100000,135000,35000,1,00143,India
857521,2023-09-24,501,iphone 15,60000,80000,20000,1,00143,India
155686,2023-09-24,505,oven,18490,24000,5510,1,00263,India
753944,2023-09-24,505,oven,18490,24000,5510,1,00170,India
753944,2023-09-24,503,mixer,1349,3249,1900,1,00170,India
753944,2023-09-24,502,iphone 15 pro max,100000,135000,35000,1,00170,India
579128,2023-09-24,501,iphone 15,60000,80000,20000,1,00093,India
579128,2023-09-24,506,monitor,3249,8000,4751,1,00093,India
579128,2023-09-24,505,oven,18490,24000,5510,1,00093,India
685214,2023-09-24,506,monitor,3249,8000,4751,1,00335,India
685214,2023-09-24,502,iphone 15 pro max,100000,135000,35000,1,00335,India
759374,2023-09-24,503,mixer,1349,3249,1900,1,00054,India
898411,2023-09-24,507,washing machine,6990,16490,9500,1,00348,India
898411,2023-09-24,505,oven,18490,24000,5510,1,00348,India
190503,2023-09-24,506,monitor,3249,8000,4751,1,00220,India
190503,2023-09-24,502,iphone 15 pro max,100000,135000,35000,1,00220,India
190503,2023-09-24,501,iphone 15,60000,80000,20000,1,00220,India
473924,2023-09-24,506,monitor,3249,8000,4751,1,00314,India
473924,2023-09-24,502,iphone 15 pro max,100000,135000,35000,1,00314,India
473924,2023-09-24,503,mixer,1349,3249,1900,1,00314,India
506584,2023-09-24,507,washing machine,6990,16490,9500,1,00345,India
506584,2023-09-24,501,iphone 15,60000,80000,20000,1,00345,India
506584,2023-09-24,505,oven,18490,24000,5510,1,00345,India
630610,2023-09-24,506,monitor,3249,8000,4751,1,00460,India
630610,2023-09-24,501,iphone 15,60000,80000,20000,1,00460,India
630610,2023-09-24,507,washing machine,6990,16490,9500,1,00460,India
499302,2023-09-24,506,monitor,3249,8000,4751,1,00065,India
499302,2023-09-24,507,washing machine,6990,16490,9500,1,00065,India
499302,2023-09-24,501,iphone 15,60000,80000,20000,1,00065,India
171272,2023-09-24,507,washing machine,6990,16490,9500,1,00308,India
171272,2023-09-24,501,iphone 15,60000,80000,20000,1,00308,India
171272,2023-09-24,504,iron,449,879,430,1,00308,India
502708,2023-09-24,501,iphone 15,60000,80000,20000,1,00033,India
502708,2023-09-24,504,iron,449,879,430,1,00033,India
789803,2023-09-24,505,oven,18490,24000,5510,1,00262,India
789803,2023-09-24,506,monitor,3249,8000,4751,1,00262,India
988052,2023-09-24,502,iphone 15 pro max,100000,135000,35000,1,00325,India
988052,2023-09-24,507,washing machine,6990,16490,9500,1,00325,India
988052,2023-09-24,505,oven,18490,24000,5510,1,00325,India
226466,2023-09-24,506,monitor,3249,8000,4751,1,00218,India
444014,2023-09-24,501,iphone 15,60000,80000,20000,1,00265,India
444014,2023-09-24,502,iphone 15 pro max,100000,135000,35000,1,00265,India
444014,2023-09-24,506,monitor,3249,8000,4751,1,00265,India
714183,2023-09-24,504,iron,449,879,430,1,00166,India
546752,2023-09-24,505,oven,18490,24000,5510,1,00329,India
939888,2023-09-24,501,iphone 15,60000,80000,20000,1,00468,India
939888,2023-09-24,507,washing machine,6990,16490,9500,1,00468,India
939888,2023-09-24,503,mixer,1349,3249,1900,1,00468,India
939888,2023-09-24,506,monitor,3249,8000,4751,1,00468,India
849823,2023-09-24,504,iron,449,879,430,1,00150,India
849823,2023-09-24,505,oven,18490,24000,5510,1,00150,India
618631,2023-09-24,502,iphone 15 pro max,100000,135000,35000,1,00291,India
618631,2023-09-24,503,mixer,1349,3249,1900,1,00291,India
587277,2023-09-24,504,iron,449,879,430,1,00020,India
587277,2023-09-24,503,mixer,1349,3249,1900,1,00020,India
587277,2023-09-24,506,monitor,3249,8000,4751,1,00020,India
587277,2023-09-24,501,iphone 15,60000,80000,20000,1,00020,India
427241,2023-09-24,503,mixer,1349,3249,1900,1,00181,India
427241,2023-09-24,505,oven,18490,24000,5510,1,00181,India
427241,2023-09-24,507,washing machine,6990,16490,9500,1,00181,India
973831,2023-09-24,505,oven,18490,24000,5510,1,00375,India
973831,2023-09-24,503,mixer,1349,3249,1900,1,00375,India
317860,2023-09-24,505,oven,18490,24000,5510,1,00344,India
317860,2023-09-24,503,mixer,1349,3249,1900,1,00344,India
789800,2023-09-24,506,monitor,3249,8000,4751,1,00076,India
789800,2023-09-24,503,mixer,1349,3249,1900,1,00076,India
821112,2023-09-24,504,iron,449,879,430,1,00382,India
540921,2023-09-24,505,oven,18490,24000,5510,1,00048,India
540921,2023-09-24,502,iphone 15 pro max,100000,135000,35000,1,00048,India
540921,2023-09-24,503,mixer,1349,3249,1900,1,00048,India
540921,2023-09-24,504,iron,449,879,430,1,00048,India
540921,2023-09-24,507,washing machine,6990,16490,9500,1,00048,India
798319,2023-09-24,506,monitor,3249,8000,4751,1,00230,India
283431,2023-09-24,506,monitor,3249,8000,4751,1,00376,India
283431,2023-09-24,503,mixer,1349,3249,1900,1,00376,India
880722,2023-09-24,504,iron,449,879,430,1,00485,India
880722,2023-09-24,503,mixer,1349,3249,1900,1,00485,India
880722,2023-09-24,505,oven,18490,24000,5510,1,00485,India
518302,2023-09-24,505,oven,18490,24000,5510,1,00355,India
518302,2023-09-24,506,monitor,3249,8000,4751,1,00355,India
518302,2023-09-24,504,iron,449,879,430,1,00355,India
518302,2023-09-24,507,washing machine,6990,16490,9500,1,00355,India
245710,2023-09-24,505,oven,18490,24000,5510,1,00009,India
245710,2023-09-24,504,iron,449,879,430,1,00009,India
245710,2023-09-24,502,iphone 15 pro max,100000,135000,35000,1,00009,India
173592,2023-09-24,502,iphone 15 pro max,100000,135000,35000,1,00387,India
173592,2023-09-24,506,monitor,3249,8000,4751,1,00387,India
173592,2023-09-24,503,mixer,1349,3249,1900,1,00387,India
257989,2023-09-24,501,iphone 15,60000,80000,20000,1,00032,India
257989,2023-09-24,503,mixer,1349,3249,1900,1,00032,India
257989,2023-09-24,504,iron,449,879,430,1,00032,India
257989,2023-09-24,502,iphone 15 pro max,100000,135000,35000,1,00032,India
390470,2023-09-24,501,iphone 15,60000,80000,20000,1,00080,India
390470,2023-09-24,507,washing machine,6990,16490,9500,1,00080,India
594745,2023-09-24,504,iron,449,879,430,1,00350,India
594745,2023-09-24,503,mixer,1349,3249,1900,1,00350,India
758013,2023-09-24,503,mixer,1349,3249,1900,1,00160,India
694195,2023-09-24,504,iron,449,879,430,1,00312,India
328265,2023-09-24,503,mixer,1349,3249,1900,1,00388,India
328265,2023-09-24,505,oven,18490,24000,5510,1,00388,India
328265,2023-09-24,504,iron,449,879,430,1,00388,India
612906,2023-09-24,507,washing machine,6990,16490,9500,1,00342,India
612906,2023-09-24,503,mixer,1349,3249,1900,1,00342,India
612906,2023-09-24,501,iphone 15,60000,80000,20000,1,00342,India
612906,2023-09-24,505,oven,18490,24000,5510,1,00342,India
260904,2023-09-24,505,oven,18490,24000,5510,1,00097,India
260904,2023-09-24,501,iphone 15,60000,80000,20000,1,00097,India
260904,2023-09-24,506,monitor,3249,8000,4751,1,00097,India
260904,2023-09-24,504,iron,449,879,430,1,00097,India
957181,2023-09-24,507,washing machine,6990,16490,9500,1,00319,India
957181,2023-09-24,505,oven,18490,24000,5510,1,00319,India
957181,2023-09-24,501,iphone 15,60000,80000,20000,1,00319,India
719795,2023-09-24,501,iphone 15,60000,80000,20000,1,00102,India
719795,2023-09-24,506,monitor,3249,8000,4751,1,00102,India
719795,2023-09-24,502,iphone 15 pro max,100000,135000,35000,1,00102,India
719795,2023-09-24,507,washing machine,6990,16490,9500,1,00102,India
855562,2023-09-24,505,oven,18490,24000,5510,1,00498,India
855562,2023-09-24,504,iron,449,879,430,1,00498,India
931535,2023-09-24,501,iphone 15,60000,80000,20000,1,00258,India
985951,2023-09-24,504,iron,449,879,430,1,00105,India
985951,2023-09-24,507,washing machine,6990,16490,9500,1,00105,India
295376,2023-09-24,501,iphone 15,60000,80000,20000,1,00125,India
374028,2023-09-24,501,iphone 15,60000,80000,20000,1,00115,India
374028,2023-09-24,506,monitor,3249,8000,4751,1,00115,India
374028,2023-09-24,502,iphone 15 pro max,100000,135000,35000,1,00115,India
442759,2023-09-24,503,mixer,1349,3249,1900,1,00493,India
442759,2023-09-24,507,washing machine,6990,16490,9500,1,00493,India
442759,2023-09-24,502,iphone 15 pro max,100000,135000,35000,1,00493,India
442759,2023-09-24,505,oven,18490,24000,5510,1,00493,India
264919,2023-09-24,503,mixer,1349,3249,1900,1,00146,India
264919,2023-09-24,502,iphone 15 pro max,100000,135000,35000,1,00146,India
955249,2023-09-24,504,iron,449,879,430,1,00489,India
955249,2023-09-24,507,washing machine,6990,16490,9500,1,00489,India
955249,2023-09-24,506,monitor,3249,8000,4751,1,00489,India
474786,2023-09-24,503,mixer,1349,3249,1900,1,00005,India
474786,2023-09-24,504,iron,449,879,430,1,00005,India
903162,2023-09-24,504,iron,449,879,430,1,00488,India
903162,2023-09-24,502,iphone 15 pro max,100000,135000,35000,1,00488,India
497257,2023-09-24,503,mixer,1349,3249,1900,1,00256,India
497257,2023-09-24,507,washing machine,6990,16490,9500,1,00256,India
497257,2023-09-24,502,iphone 15 pro max,100000,135000,35000,1,00256,India
328462,2023-09-24,506,monitor,3249,8000,4751,1,00483,India
328462,2023-09-24,503,mixer,1349,3249,1900,1,00483,India
328462,2023-09-24,502,iphone 15 pro max,100000,135000,35000,1,00483,India
328462,2023-09-24,507,washing machine,6990,16490,9500,1,00483,India
952906,2023-09-24,505,oven,18490,24000,5510,1,00079,India
952906,2023-09-24,503,mixer,1349,3249,1900,1,00079,India
896684,2023-09-24,504,iron,449,879,430,1,00257,India
896684,2023-09-24,503,mixer,1349,3249,1900,1,00257,India
251384,2023-09-24,502,iphone 15 pro max,100000,135000,35000,1,00467,India
251384,2023-09-24,504,iron,449,879,430,1,00467,India
251384,2023-09-24,501,iphone 15,60000,80000,20000,1,00467,India
251384,2023-09-24,505,oven,18490,24000,5510,1,00467,India
251384,2023-09-24,507,washing machine,6990,16490,9500,1,00467,India
289810,2023-09-24,503,mixer,1349,3249,1900,1,00230,India
887611,2023-09-24,501,iphone 15,60000,80000,20000,1,00066,India
887611,2023-09-24,504,iron,449,879,430,1,00066,India
469303,2023-09-24,504,iron,449,879,430,1,00266,India
469303,2023-09-24,503,mixer,1349,3249,1900,1,00266,India
633104,2023-09-24,502,iphone 15 pro max,100000,135000,35000,1,00009,India
633104,2023-09-24,507,washing machine,6990,16490,9500,1,00009,India
633104,2023-09-24,505,oven,18490,24000,5510,1,00009,India
633104,2023-09-24,506,monitor,3249,8000,4751,1,00009,India
633104,2023-09-24,501,iphone 15,60000,80000,20000,1,00009,India
824100,2023-09-24,502,iphone 15 pro max,100000,135000,35000,1,00075,India
824100,2023-09-24,503,mixer,1349,3249,1900,1,00075,India
824100,2023-09-24,501,iphone 15,60000,80000,20000,1,00075,India
824100,2023-09-24,507,washing machine,6990,16490,9500,1,00075,India
823843,2023-09-25,501,iphone 15,60000,80000,20000,1,00118,India
823843,2023-09-25,502,iphone 15 pro max,100000,135000,35000,1,00118,India
632469,2023-09-25,507,washing machine,6990,16490,9500,1,00028,India
632469,2023-09-25,505,oven,18490,24000,5510,1,00028,India
632469,2023-09-25,501,iphone 15,60000,80000,20000,1,00028,India
632469,2023-09-25,502,iphone 15 pro max,100000,135000,35000,1,00028,India
472009,2023-09-25,502,iphone 15 pro max,100000,135000,35000,1,00466,India
472009,2023-09-25,507,washing machine,6990,16490,9500,1,00466,India
772249,2023-09-25,506,monitor,3249,8000,4751,1,00119,India
772249,2023-09-25,504,iron,449,879,430,1,00119,India
772249,2023-09-25,502,iphone 15 pro max,100000,135000,35000,1,00119,India
772249,2023-09-25,505,oven,18490,24000,5510,1,00119,India
358251,2023-09-25,507,washing machine,6990,16490,9500,1,00265,India
358251,2023-09-25,504,iron,449,879,430,1,00265,India
358251,2023-09-25,502,iphone 15 pro max,100000,135000,35000,1,00265,India
358251,2023-09-25,506,monitor,3249,8000,4751,1,00265,India
950107,2023-09-25,503,mixer,1349,3249,1900,1,00216,India
950107,2023-09-25,501,iphone 15,60000,80000,20000,1,00216,India
515650,2023-09-25,506,monitor,3249,8000,4751,1,00068,India
925184,2023-09-25,506,monitor,3249,8000,4751,1,00225,India
925184,2023-09-25,507,washing machine,6990,16490,9500,1,00225,India
421666,2023-09-25,506,monitor,3249,8000,4751,1,00271,India
421666,2023-09-25,502,iphone 15 pro max,100000,135000,35000,1,00271,India
421666,2023-09-25,504,iron,449,879,430,1,00271,India
119321,2023-09-25,506,monitor,3249,8000,4751,1,00326,India
405590,2023-09-25,507,washing machine,6990,16490,9500,1,00117,India
645310,2023-09-25,503,mixer,1349,3249,1900,1,00418,India
645310,2023-09-25,501,iphone 15,60000,80000,20000,1,00418,India
753064,2023-09-25,502,iphone 15 pro max,100000,135000,35000,1,00098,India
753064,2023-09-25,507,washing machine,6990,16490,9500,1,00098,India
418301,2023-09-25,502,iphone 15 pro max,100000,135000,35000,1,00232,India
418301,2023-09-25,501,iphone 15,60000,80000,20000,1,00232,India
418301,2023-09-25,507,washing machine,6990,16490,9500,1,00232,India
406224,2023-09-25,505,oven,18490,24000,5510,1,00481,India
406224,2023-09-25,507,washing machine,6990,16490,9500,1,00481,India
910210,2023-09-25,505,oven,18490,24000,5510,1,00329,India
910210,2023-09-25,507,washing machine,6990,16490,9500,1,00329,India
385479,2023-09-25,504,iron,449,879,430,1,00261,India
385479,2023-09-25,505,oven,18490,24000,5510,1,00261,India
548778,2023-09-25,507,washing machine,6990,16490,9500,1,00351,India
548778,2023-09-25,501,iphone 15,60000,80000,20000,1,00351,India
548778,2023-09-25,506,monitor,3249,8000,4751,1,00351,India
633230,2023-09-25,502,iphone 15 pro max,100000,135000,35000,1,00238,India
633230,2023-09-25,507,washing machine,6990,16490,9500,1,00238,India
633230,2023-09-25,501,iphone 15,60000,80000,20000,1,00238,India
308273,2023-09-25,502,iphone 15 pro max,100000,135000,35000,1,00444,India
308273,2023-09-25,503,mixer,1349,3249,1900,1,00444,India
684987,2023-09-25,502,iphone 15 pro max,100000,135000,35000,1,00171,India
684987,2023-09-25,505,oven,18490,24000,5510,1,00171,India
729040,2023-09-25,505,oven,18490,24000,5510,1,00336,India
729040,2023-09-25,503,mixer,1349,3249,1900,1,00336,India
729040,2023-09-25,506,monitor,3249,8000,4751,1,00336,India
729040,2023-09-25,507,washing machine,6990,16490,9500,1,00336,India
554744,2023-09-25,501,iphone 15,60000,80000,20000,1,00366,India
211680,2023-09-25,503,mixer,1349,3249,1900,1,00040,India
211680,2023-09-25,505,oven,18490,24000,5510,1,00040,India
211680,2023-09-25,504,iron,449,879,430,1,00040,India
242344,2023-09-25,505,oven,18490,24000,5510,1,00389,India
242344,2023-09-25,504,iron,449,879,430,1,00389,India
242344,2023-09-25,506,monitor,3249,8000,4751,1,00389,India
242344,2023-09-25,507,washing machine,6990,16490,9500,1,00389,India
242344,2023-09-25,501,iphone 15,60000,80000,20000,1,00389,India
723355,2023-09-25,507,washing machine,6990,16490,9500,1,00379,India
723355,2023-09-25,501,iphone 15,60000,80000,20000,1,00379,India
723355,2023-09-25,506,monitor,3249,8000,4751,1,00379,India
897506,2023-09-25,507,washing machine,6990,16490,9500,1,00086,India
897506,2023-09-25,505,oven,18490,24000,5510,1,00086,India
897506,2023-09-25,504,iron,449,879,430,1,00086,India
248621,2023-09-25,504,iron,449,879,430,1,00159,India
248621,2023-09-25,505,oven,18490,24000,5510,1,00159,India
248621,2023-09-25,506,monitor,3249,8000,4751,1,00159,India
248621,2023-09-25,507,washing machine,6990,16490,9500,1,00159,India
562049,2023-09-25,501,iphone 15,60000,80000,20000,1,00137,India
377361,2023-09-25,503,mixer,1349,3249,1900,1,00258,India
377361,2023-09-25,504,iron,449,879,430,1,00258,India
377361,2023-09-25,506,monitor,3249,8000,4751,1,00258,India
377361,2023-09-25,507,washing machine,6990,16490,9500,1,00258,India
831229,2023-09-25,501,iphone 15,60000,80000,20000,1,00082,India
831229,2023-09-25,502,iphone 15 pro max,100000,135000,35000,1,00082,India
831229,2023-09-25,507,washing machine,6990,16490,9500,1,00082,India
831229,2023-09-25,504,iron,449,879,430,1,00082,India
897293,2023-09-25,506,monitor,3249,8000,4751,1,00135,India
897293,2023-09-25,503,mixer,1349,3249,1900,1,00135,India
521889,2023-09-25,502,iphone 15 pro max,100000,135000,35000,1,00390,India
521889,2023-09-25,504,iron,449,879,430,1,00390,India
965554,2023-09-25,507,washing machine,6990,16490,9500,1,00437,India
965554,2023-09-25,503,mixer,1349,3249,1900,1,00437,India
965554,2023-09-25,504,iron,449,879,430,1,00437,India
600795,2023-09-25,505,oven,18490,24000,5510,1,00375,India
600795,2023-09-25,504,iron,449,879,430,1,00375,India
600795,2023-09-25,503,mixer,1349,3249,1900,1,00375,India
600795,2023-09-25,501,iphone 15,60000,80000,20000,1,00375,India
602175,2023-09-25,502,iphone 15 pro max,100000,135000,35000,1,00368,India
602175,2023-09-25,507,washing machine,6990,16490,9500,1,00368,India
965054,2023-09-25,504,iron,449,879,430,1,00372,India
259661,2023-09-25,501,iphone 15,60000,80000,20000,1,00334,India
259661,2023-09-25,506,monitor,3249,8000,4751,1,00334,India
259661,2023-09-25,504,iron,449,879,430,1,00334,India
833605,2023-09-25,505,oven,18490,24000,5510,1,00196,India
833605,2023-09-25,501,iphone 15,60000,80000,20000,1,00196,India
781430,2023-09-25,506,monitor,3249,8000,4751,1,00345,India
781430,2023-09-25,503,mixer,1349,3249,1900,1,00345,India
781430,2023-09-25,505,oven,18490,24000,5510,1,00345,India
286084,2023-09-25,507,washing machine,6990,16490,9500,1,00455,India
286084,2023-09-25,504,iron,449,879,430,1,00455,India
286084,2023-09-25,501,iphone 15,60000,80000,20000,1,00455,India
390654,2023-09-25,501,iphone 15,60000,80000,20000,1,00137,India
390654,2023-09-25,506,monitor,3249,8000,4751,1,00137,India
541538,2023-09-25,506,monitor,3249,8000,4751,1,00057,India
541538,2023-09-25,505,oven,18490,24000,5510,1,00057,India
525903,2023-09-25,502,iphone 15 pro max,100000,135000,35000,1,00421,India
525903,2023-09-25,507,washing machine,6990,16490,9500,1,00421,India
962126,2023-09-25,503,mixer,1349,3249,1900,1,00183,India
962126,2023-09-25,505,oven,18490,24000,5510,1,00183,India
962126,2023-09-25,506,monitor,3249,8000,4751,1,00183,India
220472,2023-09-25,503,mixer,1349,3249,1900,1,00247,India
220472,2023-09-25,507,washing machine,6990,16490,9500,1,00247,India
220472,2023-09-25,505,oven,18490,24000,5510,1,00247,India
265945,2023-09-25,507,washing machine,6990,16490,9500,1,00399,India
758934,2023-09-25,506,monitor,3249,8000,4751,1,00190,India
758934,2023-09-25,501,iphone 15,60000,80000,20000,1,00190,India
832336,2023-09-25,507,washing machine,6990,16490,9500,1,00041,India
832336,2023-09-25,501,iphone 15,60000,80000,20000,1,00041,India
343919,2023-09-25,506,monitor,3249,8000,4751,1,00017,India
276954,2023-09-25,507,washing machine,6990,16490,9500,1,00259,India
276954,2023-09-25,501,iphone 15,60000,80000,20000,1,00259,India
811475,2023-09-25,506,monitor,3249,8000,4751,1,00146,India
811475,2023-09-25,505,oven,18490,24000,5510,1,00146,India
811475,2023-09-25,504,iron,449,879,430,1,00146,India
513087,2023-09-25,504,iron,449,879,430,1,00289,India
513087,2023-09-25,506,monitor,3249,8000,4751,1,00289,India
848405,2023-09-25,503,mixer,1349,3249,1900,1,00209,India
848405,2023-09-25,506,monitor,3249,8000,4751,1,00209,India
848405,2023-09-25,507,washing machine,6990,16490,9500,1,00209,India
146430,2023-09-25,506,monitor,3249,8000,4751,1,00168,India
146430,2023-09-25,507,washing machine,6990,16490,9500,1,00168,India
146430,2023-09-25,502,iphone 15 pro max,100000,135000,35000,1,00168,India
146430,2023-09-25,501,iphone 15,60000,80000,20000,1,00168,India
531804,2023-09-25,504,iron,449,879,430,1,00335,India
531804,2023-09-25,501,iphone 15,60000,80000,20000,1,00335,India
779524,2023-09-25,504,iron,449,879,430,1,00303,India
779524,2023-09-25,505,oven,18490,24000,5510,1,00303,India
779524,2023-09-25,506,monitor,3249,8000,4751,1,00303,India
779524,2023-09-25,507,washing machine,6990,16490,9500,1,00303,India
439781,2023-09-25,505,oven,18490,24000,5510,1,00296,India
944879,2023-09-25,504,iron,449,879,430,1,00199,India
944879,2023-09-25,506,monitor,3249,8000,4751,1,00199,India
210272,2023-09-25,505,oven,18490,24000,5510,1,00020,India
210272,2023-09-25,504,iron,449,879,430,1,00020,India
955073,2023-09-25,506,monitor,3249,8000,4751,1,00070,India
837856,2023-09-25,505,oven,18490,24000,5510,1,00269,India
837856,2023-09-25,504,iron,449,879,430,1,00269,India
376288,2023-09-25,506,monitor,3249,8000,4751,1,00073,India
376288,2023-09-25,507,washing machine,6990,16490,9500,1,00073,India
636157,2023-09-25,505,oven,18490,24000,5510,1,00330,India
636157,2023-09-25,507,washing machine,6990,16490,9500,1,00330,India
636157,2023-09-25,502,iphone 15 pro max,100000,135000,35000,1,00330,India
636157,2023-09-25,501,iphone 15,60000,80000,20000,1,00330,India
342197,2023-09-25,503,mixer,1349,3249,1900,1,00200,India
342197,2023-09-25,505,oven,18490,24000,5510,1,00200,India
513622,2023-09-25,504,iron,449,879,430,1,00107,India
513622,2023-09-25,501,iphone 15,60000,80000,20000,1,00107,India
678033,2023-09-25,507,washing machine,6990,16490,9500,1,00117,India
678033,2023-09-25,501,iphone 15,60000,80000,20000,1,00117,India
678033,2023-09-25,505,oven,18490,24000,5510,1,00117,India
978265,2023-09-25,506,monitor,3249,8000,4751,1,00115,India
978265,2023-09-25,503,mixer,1349,3249,1900,1,00115,India
978265,2023-09-25,504,iron,449,879,430,1,00115,India
138862,2023-09-25,506,monitor,3249,8000,4751,1,00318,India
824228,2023-09-25,504,iron,449,879,430,1,00485,India
824228,2023-09-25,506,monitor,3249,8000,4751,1,00485,India
195560,2023-09-25,502,iphone 15 pro max,100000,135000,35000,1,00155,India
411027,2023-09-25,505,oven,18490,24000,5510,1,00163,India
255528,2023-09-25,502,iphone 15 pro max,100000,135000,35000,1,00191,India
345077,2023-09-25,503,mixer,1349,3249,1900,1,00457,India
345077,2023-09-25,506,monitor,3249,8000,4751,1,00457,India
345077,2023-09-25,502,iphone 15 pro max,100000,135000,35000,1,00457,India
407079,2023-09-25,502,iphone 15 pro max,100000,135000,35000,1,00197,India
407079,2023-09-25,501,iphone 15,60000,80000,20000,1,00197,India
346402,2023-09-25,501,iphone 15,60000,80000,20000,1,00007,India
346402,2023-09-25,502,iphone 15 pro max,100000,135000,35000,1,00007,India
923969,2023-09-25,502,iphone 15 pro max,100000,135000,35000,1,00436,India
923969,2023-09-25,505,oven,18490,24000,5510,1,00436,India
923969,2023-09-25,501,iphone 15,60000,80000,20000,1,00436,India
913396,2023-09-25,501,iphone 15,60000,80000,20000,1,00484,India
913396,2023-09-25,506,monitor,3249,8000,4751,1,00484,India
913396,2023-09-25,502,iphone 15 pro max,100000,135000,35000,1,00484,India
416002,2023-09-25,507,washing machine,6990,16490,9500,1,00280,India
416002,2023-09-25,505,oven,18490,24000,5510,1,00280,India
821614,2023-09-25,505,oven,18490,24000,5510,1,00291,India
821614,2023-09-25,507,washing machine,6990,16490,9500,1,00291,India
821614,2023-09-25,503,mixer,1349,3249,1900,1,00291,India
821614,2023-09-25,501,iphone 15,60000,80000,20000,1,00291,India
784038,2023-09-25,507,washing machine,6990,16490,9500,1,00323,India
784038,2023-09-25,506,monitor,3249,8000,4751,1,00323,India
243789,2023-09-25,507,washing machine,6990,16490,9500,1,00019,India
243789,2023-09-25,505,oven,18490,24000,5510,1,00019,India
243789,2023-09-25,506,monitor,3249,8000,4751,1,00019,India
243789,2023-09-25,502,iphone 15 pro max,100000,135000,35000,1,00019,India
128073,2023-09-25,507,washing machine,6990,16490,9500,1,00109,India
908988,2023-09-25,501,iphone 15,60000,80000,20000,1,00256,India
908988,2023-09-25,503,mixer,1349,3249,1900,1,00256,India
908988,2023-09-25,504,iron,449,879,430,1,00256,India
908988,2023-09-25,505,oven,18490,24000,5510,1,00256,India
917016,2023-09-26,502,iphone 15 pro max,100000,135000,35000,1,00493,India
338773,2023-09-26,501,iphone 15,60000,80000,20000,1,00045,India
338773,2023-09-26,505,oven,18490,24000,5510,1,00045,India
338773,2023-09-26,504,iron,449,879,430,1,00045,India
338773,2023-09-26,506,monitor,3249,8000,4751,1,00045,India
369472,2023-09-26,502,iphone 15 pro max,100000,135000,35000,1,00176,India
369472,2023-09-26,505,oven,18490,24000,5510,1,00176,India
932563,2023-09-26,502,iphone 15 pro max,100000,135000,35000,1,00388,India
932563,2023-09-26,501,iphone 15,60000,80000,20000,1,00388,India
932563,2023-09-26,507,washing machine,6990,16490,9500,1,00388,India
932563,2023-09-26,503,mixer,1349,3249,1900,1,00388,India
712849,2023-09-26,503,mixer,1349,3249,1900,1,00401,India
822278,2023-09-26,504,iron,449,879,430,1,00218,India
822278,2023-09-26,507,washing machine,6990,16490,9500,1,00218,India
822278,2023-09-26,506,monitor,3249,8000,4751,1,00218,India
558965,2023-09-26,507,washing machine,6990,16490,9500,1,00324,India
558965,2023-09-26,502,iphone 15 pro max,100000,135000,35000,1,00324,India
558965,2023-09-26,505,oven,18490,24000,5510,1,00324,India
553076,2023-09-26,503,mixer,1349,3249,1900,1,00150,India
842726,2023-09-26,507,washing machine,6990,16490,9500,1,00008,India
842726,2023-09-26,506,monitor,3249,8000,4751,1,00008,India
842726,2023-09-26,501,iphone 15,60000,80000,20000,1,00008,India
842726,2023-09-26,503,mixer,1349,3249,1900,1,00008,India
567395,2023-09-26,506,monitor,3249,8000,4751,1,00088,India
567395,2023-09-26,507,washing machine,6990,16490,9500,1,00088,India
754919,2023-09-26,501,iphone 15,60000,80000,20000,1,00491,India
754919,2023-09-26,502,iphone 15 pro max,100000,135000,35000,1,00491,India
754919,2023-09-26,504,iron,449,879,430,1,00491,India
164452,2023-09-26,505,oven,18490,24000,5510,1,00364,India
164452,2023-09-26,501,iphone 15,60000,80000,20000,1,00364,India
164452,2023-09-26,502,iphone 15 pro max,100000,135000,35000,1,00364,India
398675,2023-09-26,507,washing machine,6990,16490,9500,1,00392,India
398675,2023-09-26,501,iphone 15,60000,80000,20000,1,00392,India
398675,2023-09-26,505,oven,18490,24000,5510,1,00392,India
765007,2023-09-26,504,iron,449,879,430,1,00157,India
177721,2023-09-26,506,monitor,3249,8000,4751,1,00194,India
177721,2023-09-26,504,iron,449,879,430,1,00194,India
177721,2023-09-26,505,oven,18490,24000,5510,1,00194,India
309805,2023-09-26,504,iron,449,879,430,1,00437,India
309805,2023-09-26,505,oven,18490,24000,5510,1,00437,India
309805,2023-09-26,506,monitor,3249,8000,4751,1,00437,India
679724,2023-09-26,503,mixer,1349,3249,1900,1,00298,India
327189,2023-09-26,503,mixer,1349,3249,1900,1,00345,India
327189,2023-09-26,504,iron,449,879,430,1,00345,India
327189,2023-09-26,502,iphone 15 pro max,100000,135000,35000,1,00345,India
926091,2023-09-26,502,iphone 15 pro max,100000,135000,35000,1,00407,India
926091,2023-09-26,505,oven,18490,24000,5510,1,00407,India
926091,2023-09-26,501,iphone 15,60000,80000,20000,1,00407,India
471564,2023-09-26,502,iphone 15 pro max,100000,135000,35000,1,00167,India
471564,2023-09-26,504,iron,449,879,430,1,00167,India
471564,2023-09-26,506,monitor,3249,8000,4751,1,00167,India
778291,2023-09-26,501,iphone 15,60000,80000,20000,1,00185,India
778291,2023-09-26,502,iphone 15 pro max,100000,135000,35000,1,00185,India
778291,2023-09-26,504,iron,449,879,430,1,00185,India
124843,2023-09-26,502,iphone 15 pro max,100000,135000,35000,1,00453,India
124843,2023-09-26,501,iphone 15,60000,80000,20000,1,00453,India
265728,2023-09-26,504,iron,449,879,430,1,00242,India
265728,2023-09-26,501,iphone 15,60000,80000,20000,1,00242,India
265728,2023-09-26,507,washing machine,6990,16490,9500,1,00242,India
265728,2023-09-26,502,iphone 15 pro max,100000,135000,35000,1,00242,India
725861,2023-09-26,505,oven,18490,24000,5510,1,00049,India
725861,2023-09-26,502,iphone 15 pro max,100000,135000,35000,1,00049,India
725861,2023-09-26,506,monitor,3249,8000,4751,1,00049,India
917803,2023-09-26,507,washing machine,6990,16490,9500,1,00088,India
917803,2023-09-26,505,oven,18490,24000,5510,1,00088,India
917803,2023-09-26,503,mixer,1349,3249,1900,1,00088,India
917803,2023-09-26,501,iphone 15,60000,80000,20000,1,00088,India
504280,2023-09-26,502,iphone 15 pro max,100000,135000,35000,1,00119,India
504280,2023-09-26,503,mixer,1349,3249,1900,1,00119,India
504280,2023-09-26,506,monitor,3249,8000,4751,1,00119,India
949262,2023-09-26,504,iron,449,879,430,1,00296,India
949262,2023-09-26,507,washing machine,6990,16490,9500,1,00296,India
672034,2023-09-26,507,washing machine,6990,16490,9500,1,00060,India
672034,2023-09-26,504,iron,449,879,430,1,00060,India
672034,2023-09-26,503,mixer,1349,3249,1900,1,00060,India
672034,2023-09-26,502,iphone 15 pro max,100000,135000,35000,1,00060,India
708799,2023-09-26,507,washing machine,6990,16490,9500,1,00394,India
708799,2023-09-26,501,iphone 15,60000,80000,20000,1,00394,India
708799,2023-09-26,506,monitor,3249,8000,4751,1,00394,India
947433,2023-09-26,501,iphone 15,60000,80000,20000,1,00099,India
947433,2023-09-26,507,washing machine,6990,16490,9500,1,00099,India
947433,2023-09-26,502,iphone 15 pro max,100000,135000,35000,1,00099,India
485993,2023-09-26,501,iphone 15,60000,80000,20000,1,00136,India
485993,2023-09-26,505,oven,18490,24000,5510,1,00136,India
485993,2023-09-26,502,iphone 15 pro max,100000,135000,35000,1,00136,India
592887,2023-09-26,503,mixer,1349,3249,1900,1,00459,India
489361,2023-09-26,504,iron,449,879,430,1,00097,India
489361,2023-09-26,502,iphone 15 pro max,100000,135000,35000,1,00097,India
570205,2023-09-26,503,mixer,1349,3249,1900,1,00022,India
850217,2023-09-26,503,mixer,1349,3249,1900,1,00352,India
850217,2023-09-26,507,washing machine,6990,16490,9500,1,00352,India
816340,2023-09-26,501,iphone 15,60000,80000,20000,1,00137,India
816340,2023-09-26,503,mixer,1349,3249,1900,1,00137,India
633183,2023-09-26,502,iphone 15 pro max,100000,135000,35000,1,00270,India
633183,2023-09-26,505,oven,18490,24000,5510,1,00270,India
633183,2023-09-26,504,iron,449,879,430,1,00270,India
633183,2023-09-26,503,mixer,1349,3249,1900,1,00270,India
868133,2023-09-26,507,washing machine,6990,16490,9500,1,00232,India
868133,2023-09-26,501,iphone 15,60000,80000,20000,1,00232,India
868133,2023-09-26,505,oven,18490,24000,5510,1,00232,India
868133,2023-09-26,503,mixer,1349,3249,1900,1,00232,India
126539,2023-09-26,504,iron,449,879,430,1,00482,India
126539,2023-09-26,501,iphone 15,60000,80000,20000,1,00482,India
126539,2023-09-26,505,oven,18490,24000,5510,1,00482,India
126539,2023-09-26,503,mixer,1349,3249,1900,1,00482,India
126539,2023-09-26,507,washing machine,6990,16490,9500,1,00482,India
282975,2023-09-26,502,iphone 15 pro max,100000,135000,35000,1,00378,India
282975,2023-09-26,505,oven,18490,24000,5510,1,00378,India
581834,2023-09-26,506,monitor,3249,8000,4751,1,00024,India
581834,2023-09-26,507,washing machine,6990,16490,9500,1,00024,India
581834,2023-09-26,501,iphone 15,60000,80000,20000,1,00024,India
581834,2023-09-26,505,oven,18490,24000,5510,1,00024,India
355520,2023-09-26,503,mixer,1349,3249,1900,1,00283,India
355520,2023-09-26,504,iron,449,879,430,1,00283,India
578970,2023-09-26,503,mixer,1349,3249,1900,1,00464,India
429937,2023-09-26,504,iron,449,879,430,1,00471,India
429937,2023-09-26,507,washing machine,6990,16490,9500,1,00471,India
429937,2023-09-26,501,iphone 15,60000,80000,20000,1,00471,India
829711,2023-09-26,505,oven,18490,24000,5510,1,00311,India
829711,2023-09-26,507,washing machine,6990,16490,9500,1,00311,India
829711,2023-09-26,502,iphone 15 pro max,100000,135000,35000,1,00311,India
909243,2023-09-26,504,iron,449,879,430,1,00224,India
909243,2023-09-26,502,iphone 15 pro max,100000,135000,35000,1,00224,India
909243,2023-09-26,501,iphone 15,60000,80000,20000,1,00224,India
909243,2023-09-26,503,mixer,1349,3249,1900,1,00224,India
389145,2023-09-26,507,washing machine,6990,16490,9500,1,00140,India
389145,2023-09-26,504,iron,449,879,430,1,00140,India
389145,2023-09-26,505,oven,18490,24000,5510,1,00140,India
259232,2023-09-26,504,iron,449,879,430,1,00346,India
259232,2023-09-26,507,washing machine,6990,16490,9500,1,00346,India
259232,2023-09-26,503,mixer,1349,3249,1900,1,00346,India
844006,2023-09-26,505,oven,18490,24000,5510,1,00096,India
844006,2023-09-26,507,washing machine,6990,16490,9500,1,00096,India
135327,2023-09-26,501,iphone 15,60000,80000,20000,1,00453,India
533887,2023-09-26,507,washing machine,6990,16490,9500,1,00182,India
533887,2023-09-26,503,mixer,1349,3249,1900,1,00182,India
533887,2023-09-26,506,monitor,3249,8000,4751,1,00182,India
533887,2023-09-26,504,iron,449,879,430,1,00182,India
463442,2023-09-26,505,oven,18490,24000,5510,1,00495,India
463442,2023-09-26,507,washing machine,6990,16490,9500,1,00495,India
740435,2023-09-26,507,washing machine,6990,16490,9500,1,00159,India
740435,2023-09-26,505,oven,18490,24000,5510,1,00159,India
740435,2023-09-26,502,iphone 15 pro max,100000,135000,35000,1,00159,India
740435,2023-09-26,504,iron,449,879,430,1,00159,India
561653,2023-09-26,501,iphone 15,60000,80000,20000,1,00479,India
717981,2023-09-26,507,washing machine,6990,16490,9500,1,00349,India
717981,2023-09-26,502,iphone 15 pro max,100000,135000,35000,1,00349,India
717981,2023-09-26,501,iphone 15,60000,80000,20000,1,00349,India
808699,2023-09-26,507,washing machine,6990,16490,9500,1,00211,India
808699,2023-09-26,505,oven,18490,24000,5510,1,00211,India
804533,2023-09-26,504,iron,449,879,430,1,00001,India
804533,2023-09-26,506,monitor,3249,8000,4751,1,00001,India
804533,2023-09-26,501,iphone 15,60000,80000,20000,1,00001,India
825372,2023-09-26,504,iron,449,879,430,1,00036,India
825372,2023-09-26,501,iphone 15,60000,80000,20000,1,00036,India
825372,2023-09-26,506,monitor,3249,8000,4751,1,00036,India
566534,2023-09-26,503,mixer,1349,3249,1900,1,00176,India
566534,2023-09-26,504,iron,449,879,430,1,00176,India
150755,2023-09-26,503,mixer,1349,3249,1900,1,00118,India
150755,2023-09-26,505,oven,18490,24000,5510,1,00118,India
150755,2023-09-26,501,iphone 15,60000,80000,20000,1,00118,India
348847,2023-09-26,507,washing machine,6990,16490,9500,1,00137,India
348847,2023-09-26,505,oven,18490,24000,5510,1,00137,India
348847,2023-09-26,503,mixer,1349,3249,1900,1,00137,India
348847,2023-09-26,504,iron,449,879,430,1,00137,India
541514,2023-09-26,506,monitor,3249,8000,4751,1,00255,India
541514,2023-09-26,505,oven,18490,24000,5510,1,00255,India
541514,2023-09-26,507,washing machine,6990,16490,9500,1,00255,India
541514,2023-09-26,502,iphone 15 pro max,100000,135000,35000,1,00255,India
397916,2023-09-26,505,oven,18490,24000,5510,1,00248,India
397916,2023-09-26,502,iphone 15 pro max,100000,135000,35000,1,00248,India
397916,2023-09-26,506,monitor,3249,8000,4751,1,00248,India
397916,2023-09-26,503,mixer,1349,3249,1900,1,00248,India
948888,2023-09-26,506,monitor,3249,8000,4751,1,00434,India
839447,2023-09-26,501,iphone 15,60000,80000,20000,1,00139,India
495047,2023-09-26,501,iphone 15,60000,80000,20000,1,00400,India
495047,2023-09-26,504,iron,449,879,430,1,00400,India
495047,2023-09-26,507,washing machine,6990,16490,9500,1,00400,India
495047,2023-09-26,502,iphone 15 pro max,100000,135000,35000,1,00400,India
495047,2023-09-26,505,oven,18490,24000,5510,1,00400,India
709186,2023-09-26,507,washing machine,6990,16490,9500,1,00354,India
709186,2023-09-26,504,iron,449,879,430,1,00354,India
709186,2023-09-26,503,mixer,1349,3249,1900,1,00354,India
709186,2023-09-26,502,iphone 15 pro max,100000,135000,35000,1,00354,India
332070,2023-09-26,506,monitor,3249,8000,4751,1,00238,India
332070,2023-09-26,501,iphone 15,60000,80000,20000,1,00238,India
644406,2023-09-26,505,oven,18490,24000,5510,1,00410,India
112829,2023-09-26,502,iphone 15 pro max,100000,135000,35000,1,00356,India
112829,2023-09-26,505,oven,18490,24000,5510,1,00356,India
112829,2023-09-26,506,monitor,3249,8000,4751,1,00356,India
155307,2023-09-26,505,oven,18490,24000,5510,1,00273,India
155307,2023-09-26,502,iphone 15 pro max,100000,135000,35000,1,00273,India
155307,2023-09-26,503,mixer,1349,3249,1900,1,00273,India
478364,2023-09-26,503,mixer,1349,3249,1900,1,00377,India
478364,2023-09-26,505,oven,18490,24000,5510,1,00377,India
478364,2023-09-26,501,iphone 15,60000,80000,20000,1,00377,India
953168,2023-09-26,507,washing machine,6990,16490,9500,1,00189,India
953168,2023-09-26,504,iron,449,879,430,1,00189,India
953168,2023-09-26,505,oven,18490,24000,5510,1,00189,India
772724,2023-09-27,505,oven,18490,24000,5510,1,00120,India
772724,2023-09-27,501,iphone 15,60000,80000,20000,1,00120,India
714544,2023-09-27,504,iron,449,879,430,1,00140,India
714544,2023-09-27,505,oven,18490,24000,5510,1,00140,India
714544,2023-09-27,507,washing machine,6990,16490,9500,1,00140,India
107227,2023-09-27,502,iphone 15 pro max,100000,135000,35000,1,00352,India
107227,2023-09-27,505,oven,18490,24000,5510,1,00352,India
107227,2023-09-27,506,monitor,3249,8000,4751,1,00352,India
107227,2023-09-27,503,mixer,1349,3249,1900,1,00352,India
339083,2023-09-27,502,iphone 15 pro max,100000,135000,35000,1,00486,India
339083,2023-09-27,507,washing machine,6990,16490,9500,1,00486,India
688690,2023-09-27,507,washing machine,6990,16490,9500,1,00454,India
688690,2023-09-27,504,iron,449,879,430,1,00454,India
688690,2023-09-27,505,oven,18490,24000,5510,1,00454,India
688690,2023-09-27,503,mixer,1349,3249,1900,1,00454,India
907931,2023-09-27,501,iphone 15,60000,80000,20000,1,00443,India
907931,2023-09-27,506,monitor,3249,8000,4751,1,00443,India
907931,2023-09-27,503,mixer,1349,3249,1900,1,00443,India
907931,2023-09-27,507,washing machine,6990,16490,9500,1,00443,India
618572,2023-09-27,506,monitor,3249,8000,4751,1,00340,India
618572,2023-09-27,507,washing machine,6990,16490,9500,1,00340,India
455194,2023-09-27,506,monitor,3249,8000,4751,1,00298,India
455194,2023-09-27,504,iron,449,879,430,1,00298,India
455194,2023-09-27,503,mixer,1349,3249,1900,1,00298,India
768703,2023-09-27,505,oven,18490,24000,5510,1,00378,India
768703,2023-09-27,506,monitor,3249,8000,4751,1,00378,India
768703,2023-09-27,501,iphone 15,60000,80000,20000,1,00378,India
588175,2023-09-27,505,oven,18490,24000,5510,1,00441,India
588175,2023-09-27,503,mixer,1349,3249,1900,1,00441,India
588175,2023-09-27,506,monitor,3249,8000,4751,1,00441,India
588175,2023-09-27,507,washing machine,6990,16490,9500,1,00441,India
590310,2023-09-27,507,washing machine,6990,16490,9500,1,00377,India
590310,2023-09-27,501,iphone 15,60000,80000,20000,1,00377,India
590310,2023-09-27,502,iphone 15 pro max,100000,135000,35000,1,00377,India
987725,2023-09-27,505,oven,18490,24000,5510,1,00001,India
987725,2023-09-27,503,mixer,1349,3249,1900,1,00001,India
987725,2023-09-27,501,iphone 15,60000,80000,20000,1,00001,India
987725,2023-09-27,504,iron,449,879,430,1,00001,India
987725,2023-09-27,502,iphone 15 pro max,100000,135000,35000,1,00001,India
167156,2023-09-27,502,iphone 15 pro max,100000,135000,35000,1,00110,India
167156,2023-09-27,507,washing machine,6990,16490,9500,1,00110,India
167156,2023-09-27,503,mixer,1349,3249,1900,1,00110,India
167156,2023-09-27,504,iron,449,879,430,1,00110,India
492949,2023-09-27,504,iron,449,879,430,1,00340,India
492949,2023-09-27,501,iphone 15,60000,80000,20000,1,00340,India
492949,2023-09-27,503,mixer,1349,3249,1900,1,00340,India
186241,2023-09-27,506,monitor,3249,8000,4751,1,00360,India
186241,2023-09-27,502,iphone 15 pro max,100000,135000,35000,1,00360,India
750929,2023-09-27,502,iphone 15 pro max,100000,135000,35000,1,00069,India
750929,2023-09-27,506,monitor,3249,8000,4751,1,00069,India
750929,2023-09-27,504,iron,449,879,430,1,00069,India
750929,2023-09-27,507,washing machine,6990,16490,9500,1,00069,India
750929,2023-09-27,501,iphone 15,60000,80000,20000,1,00069,India
696897,2023-09-27,503,mixer,1349,3249,1900,1,00236,India
715812,2023-09-27,503,mixer,1349,3249,1900,1,00118,India
715812,2023-09-27,502,iphone 15 pro max,100000,135000,35000,1,00118,India
216327,2023-09-27,505,oven,18490,24000,5510,1,00401,India
216327,2023-09-27,502,iphone 15 pro max,100000,135000,35000,1,00401,India
216327,2023-09-27,506,monitor,3249,8000,4751,1,00401,India
297266,2023-09-27,501,iphone 15,60000,80000,20000,1,00351,India
297266,2023-09-27,504,iron,449,879,430,1,00351,India
984887,2023-09-27,505,oven,18490,24000,5510,1,00316,India
984887,2023-09-27,501,iphone 15,60000,80000,20000,1,00316,India
984887,2023-09-27,506,monitor,3249,8000,4751,1,00316,India
955953,2023-09-27,505,oven,18490,24000,5510,1,00175,India
955953,2023-09-27,506,monitor,3249,8000,4751,1,00175,India
955953,2023-09-27,507,washing machine,6990,16490,9500,1,00175,India
355891,2023-09-27,501,iphone 15,60000,80000,20000,1,00185,India
355891,2023-09-27,505,oven,18490,24000,5510,1,00185,India
355891,2023-09-27,502,iphone 15 pro max,100000,135000,35000,1,00185,India
941383,2023-09-27,505,oven,18490,24000,5510,1,00240,India
941383,2023-09-27,504,iron,449,879,430,1,00240,India
941383,2023-09-27,506,monitor,3249,8000,4751,1,00240,India
422080,2023-09-27,501,iphone 15,60000,80000,20000,1,00426,India
422080,2023-09-27,504,iron,449,879,430,1,00426,India
422080,2023-09-27,502,iphone 15 pro max,100000,135000,35000,1,00426,India
100843,2023-09-27,501,iphone 15,60000,80000,20000,1,00475,India
100843,2023-09-27,503,mixer,1349,3249,1900,1,00475,India
100843,2023-09-27,504,iron,449,879,430,1,00475,India
141709,2023-09-27,506,monitor,3249,8000,4751,1,00450,India
141709,2023-09-27,504,iron,449,879,430,1,00450,India
141709,2023-09-27,501,iphone 15,60000,80000,20000,1,00450,India
201927,2023-09-27,505,oven,18490,24000,5510,1,00163,India
201927,2023-09-27,504,iron,449,879,430,1,00163,India
201927,2023-09-27,507,washing machine,6990,16490,9500,1,00163,India
166550,2023-09-27,503,mixer,1349,3249,1900,1,00020,India
166550,2023-09-27,502,iphone 15 pro max,100000,135000,35000,1,00020,India
166550,2023-09-27,506,monitor,3249,8000,4751,1,00020,India
387806,2023-09-27,507,washing machine,6990,16490,9500,1,00055,India
387806,2023-09-27,504,iron,449,879,430,1,00055,India
387806,2023-09-27,501,iphone 15,60000,80000,20000,1,00055,India
387806,2023-09-27,506,monitor,3249,8000,4751,1,00055,India
149343,2023-09-27,506,monitor,3249,8000,4751,1,00429,India
850353,2023-09-27,506,monitor,3249,8000,4751,1,00418,India
773527,2023-09-27,507,washing machine,6990,16490,9500,1,00094,India
773527,2023-09-27,504,iron,449,879,430,1,00094,India
773527,2023-09-27,502,iphone 15 pro max,100000,135000,35000,1,00094,India
832270,2023-09-27,502,iphone 15 pro max,100000,135000,35000,1,00412,India
233943,2023-09-27,506,monitor,3249,8000,4751,1,00429,India
233943,2023-09-27,501,iphone 15,60000,80000,20000,1,00429,India
233943,2023-09-27,502,iphone 15 pro max,100000,135000,35000,1,00429,India
233943,2023-09-27,507,washing machine,6990,16490,9500,1,00429,India
908756,2023-09-27,505,oven,18490,24000,5510,1,00020,India
908756,2023-09-27,501,iphone 15,60000,80000,20000,1,00020,India
908756,2023-09-27,507,washing machine,6990,16490,9500,1,00020,India
366867,2023-09-27,505,oven,18490,24000,5510,1,00093,India
366867,2023-09-27,507,washing machine,6990,16490,9500,1,00093,India
927811,2023-09-27,507,washing machine,6990,16490,9500,1,00309,India
927811,2023-09-27,504,iron,449,879,430,1,00309,India
963973,2023-09-27,501,iphone 15,60000,80000,20000,1,00033,India
501181,2023-09-27,502,iphone 15 pro max,100000,135000,35000,1,00204,India
501181,2023-09-27,501,iphone 15,60000,80000,20000,1,00204,India
542463,2023-09-27,502,iphone 15 pro max,100000,135000,35000,1,00264,India
542463,2023-09-27,501,iphone 15,60000,80000,20000,1,00264,India
542463,2023-09-27,507,washing machine,6990,16490,9500,1,00264,India
859013,2023-09-27,505,oven,18490,24000,5510,1,00196,India
859013,2023-09-27,506,monitor,3249,8000,4751,1,00196,India
859013,2023-09-27,507,washing machine,6990,16490,9500,1,00196,India
859013,2023-09-27,503,mixer,1349,3249,1900,1,00196,India
782656,2023-09-27,505,oven,18490,24000,5510,1,00278,India
362507,2023-09-27,504,iron,449,879,430,1,00348,India
362507,2023-09-27,501,iphone 15,60000,80000,20000,1,00348,India
362507,2023-09-27,506,monitor,3249,8000,4751,1,00348,India
362507,2023-09-27,507,washing machine,6990,16490,9500,1,00348,India
773674,2023-09-27,504,iron,449,879,430,1,00495,India
773674,2023-09-27,507,washing machine,6990,16490,9500,1,00495,India
773674,2023-09-27,501,iphone 15,60000,80000,20000,1,00495,India
677831,2023-09-27,504,iron,449,879,430,1,00446,India
677831,2023-09-27,503,mixer,1349,3249,1900,1,00446,India
310138,2023-09-27,505,oven,18490,24000,5510,1,00284,India
310138,2023-09-27,503,mixer,1349,3249,1900,1,00284,India
147431,2023-09-27,502,iphone 15 pro max,100000,135000,35000,1,00217,India
419033,2023-09-27,503,mixer,1349,3249,1900,1,00207,India
419033,2023-09-27,505,oven,18490,24000,5510,1,00207,India
927909,2023-09-27,502,iphone 15 pro max,100000,135000,35000,1,00094,India
927909,2023-09-27,507,washing machine,6990,16490,9500,1,00094,India
927909,2023-09-27,501,iphone 15,60000,80000,20000,1,00094,India
514745,2023-09-27,503,mixer,1349,3249,1900,1,00195,India
514745,2023-09-27,501,iphone 15,60000,80000,20000,1,00195,India
309417,2023-09-27,507,washing machine,6990,16490,9500,1,00140,India
309417,2023-09-27,506,monitor,3249,8000,4751,1,00140,India
906385,2023-09-27,503,mixer,1349,3249,1900,1,00031,India
906385,2023-09-27,501,iphone 15,60000,80000,20000,1,00031,India
906385,2023-09-27,507,washing machine,6990,16490,9500,1,00031,India
139941,2023-09-27,507,washing machine,6990,16490,9500,1,00082,India
139941,2023-09-27,506,monitor,3249,8000,4751,1,00082,India
139941,2023-09-27,503,mixer,1349,3249,1900,1,00082,India
369540,2023-09-27,502,iphone 15 pro max,100000,135000,35000,1,00319,India
369540,2023-09-27,503,mixer,1349,3249,1900,1,00319,India
606664,2023-09-27,503,mixer,1349,3249,1900,1,00169,India
606664,2023-09-27,505,oven,18490,24000,5510,1,00169,India
606664,2023-09-27,504,iron,449,879,430,1,00169,India
339789,2023-09-27,507,washing machine,6990,16490,9500,1,00399,India
339789,2023-09-27,503,mixer,1349,3249,1900,1,00399,India
339789,2023-09-27,502,iphone 15 pro max,100000,135000,35000,1,00399,India
339789,2023-09-27,505,oven,18490,24000,5510,1,00399,India
389307,2023-09-27,503,mixer,1349,3249,1900,1,00228,India
389307,2023-09-27,502,iphone 15 pro max,100000,135000,35000,1,00228,India
389307,2023-09-27,501,iphone 15,60000,80000,20000,1,00228,India
389307,2023-09-27,506,monitor,3249,8000,4751,1,00228,India
436937,2023-09-27,503,mixer,1349,3249,1900,1,00360,India
210179,2023-09-27,502,iphone 15 pro max,100000,135000,35000,1,00110,India
401073,2023-09-27,503,mixer,1349,3249,1900,1,00149,India
401073,2023-09-27,506,monitor,3249,8000,4751,1,00149,India
747841,2023-09-27,505,oven,18490,24000,5510,1,00210,India
747841,2023-09-27,506,monitor,3249,8000,4751,1,00210,India
747841,2023-09-27,501,iphone 15,60000,80000,20000,1,00210,India
747841,2023-09-27,503,mixer,1349,3249,1900,1,00210,India
406331,2023-09-27,501,iphone 15,60000,80000,20000,1,00200,India
406331,2023-09-27,504,iron,449,879,430,1,00200,India
406331,2023-09-27,502,iphone 15 pro max,100000,135000,35000,1,00200,India
406331,2023-09-27,506,monitor,3249,8000,4751,1,00200,India
248089,2023-09-27,503,mixer,1349,3249,1900,1,00427,India
248089,2023-09-27,501,iphone 15,60000,80000,20000,1,00427,India
354030,2023-09-27,507,washing machine,6990,16490,9500,1,00208,India
704610,2023-09-27,507,washing machine,6990,16490,9500,1,00307,India
704610,2023-09-27,501,iphone 15,60000,80000,20000,1,00307,India
704610,2023-09-27,506,monitor,3249,8000,4751,1,00307,India
850665,2023-09-27,503,mixer,1349,3249,1900,1,00339,India
850665,2023-09-27,501,iphone 15,60000,80000,20000,1,00339,India
597294,2023-09-27,507,washing machine,6990,16490,9500,1,00012,India
473280,2023-09-27,506,monitor,3249,8000,4751,1,00378,India
473280,2023-09-27,504,iron,449,879,430,1,00378,India
473280,2023-09-27,505,oven,18490,24000,5510,1,00378,India
113478,2023-09-27,507,washing machine,6990,16490,9500,1,00100,India
859690,2023-09-27,506,monitor,3249,8000,4751,1,00188,India
693390,2023-09-27,501,iphone 15,60000,80000,20000,1,00276,India
693390,2023-09-27,503,mixer,1349,3249,1900,1,00276,India
693390,2023-09-27,502,iphone 15 pro max,100000,135000,35000,1,00276,India
345896,2023-09-27,503,mixer,1349,3249,1900,1,00211,India
345896,2023-09-27,501,iphone 15,60000,80000,20000,1,00211,India
875723,2023-09-27,502,iphone 15 pro max,100000,135000,35000,1,00096,India
875723,2023-09-27,505,oven,18490,24000,5510,1,00096,India
875723,2023-09-27,504,iron,449,879,430,1,00096,India
490099,2023-09-27,502,iphone 15 pro max,100000,135000,35000,1,00430,India
643717,2023-09-27,502,iphone 15 pro max,100000,135000,35000,1,00323,India
966264,2023-09-27,502,iphone 15 pro max,100000,135000,35000,1,00438,India
966264,2023-09-27,501,iphone 15,60000,80000,20000,1,00438,India
966264,2023-09-27,507,washing machine,6990,16490,9500,1,00438,India
481975,2023-09-27,502,iphone 15 pro max,100000,135000,35000,1,00077,India
402800,2023-09-27,506,monitor,3249,8000,4751,1,00206,India
402800,2023-09-27,501,iphone 15,60000,80000,20000,1,00206,India
402800,2023-09-27,507,washing machine,6990,16490,9500,1,00206,India
402800,2023-09-27,502,iphone 15 pro max,100000,135000,35000,1,00206,India
466314,2023-09-28,503,mixer,1349,3249,1900,1,00498,India
466314,2023-09-28,502,iphone 15 pro max,100000,135000,35000,1,00498,India
426937,2023-09-28,506,monitor,3249,8000,4751,1,00127,India
426937,2023-09-28,507,washing machine,6990,16490,9500,1,00127,India
493594,2023-09-28,503,mixer,1349,3249,1900,1,00326,India
493594,2023-09-28,507,washing machine,6990,16490,9500,1,00326,India
493594,2023-09-28,506,monitor,3249,8000,4751,1,00326,India
666877,2023-09-28,507,washing machine,6990,16490,9500,1,00489,India
666877,2023-09-28,501,iphone 15,60000,80000,20000,1,00489,India
666877,2023-09-28,505,oven,18490,24000,5510,1,00489,India
666877,2023-09-28,506,monitor,3249,8000,4751,1,00489,India
794695,2023-09-28,507,washing machine,6990,16490,9500,1,00481,India
861161,2023-09-28,503,mixer,1349,3249,1900,1,00477,India
861161,2023-09-28,505,oven,18490,24000,5510,1,00477,India
861161,2023-09-28,506,monitor,3249,8000,4751,1,00477,India
165266,2023-09-28,506,monitor,3249,8000,4751,1,00414,India
165266,2023-09-28,501,iphone 15,60000,80000,20000,1,00414,India
368232,2023-09-28,502,iphone 15 pro max,100000,135000,35000,1,00318,India
368232,2023-09-28,501,iphone 15,60000,80000,20000,1,00318,India
210066,2023-09-28,504,iron,449,879,430,1,00249,India
632054,2023-09-28,504,iron,449,879,430,1,00369,India
586860,2023-09-28,503,mixer,1349,3249,1900,1,00154,India
586860,2023-09-28,501,iphone 15,60000,80000,20000,1,00154,India
586860,2023-09-28,506,monitor,3249,8000,4751,1,00154,India
586860,2023-09-28,505,oven,18490,24000,5510,1,00154,India
453775,2023-09-28,501,iphone 15,60000,80000,20000,1,00453,India
453775,2023-09-28,505,oven,18490,24000,5510,1,00453,India
453775,2023-09-28,503,mixer,1349,3249,1900,1,00453,India
115936,2023-09-28,506,monitor,3249,8000,4751,1,00073,India
260544,2023-09-28,505,oven,18490,24000,5510,1,00129,India
523569,2023-09-28,506,monitor,3249,8000,4751,1,00035,India
934041,2023-09-28,506,monitor,3249,8000,4751,1,00266,India
934041,2023-09-28,502,iphone 15 pro max,100000,135000,35000,1,00266,India
934041,2023-09-28,507,washing machine,6990,16490,9500,1,00266,India
934041,2023-09-28,501,iphone 15,60000,80000,20000,1,00266,India
927249,2023-09-28,506,monitor,3249,8000,4751,1,00480,India
927249,2023-09-28,505,oven,18490,24000,5510,1,00480,India
927249,2023-09-28,501,iphone 15,60000,80000,20000,1,00480,India
310319,2023-09-28,505,oven,18490,24000,5510,1,00179,India
310319,2023-09-28,503,mixer,1349,3249,1900,1,00179,India
310319,2023-09-28,501,iphone 15,60000,80000,20000,1,00179,India
578430,2023-09-28,505,oven,18490,24000,5510,1,00035,India
578430,2023-09-28,507,washing machine,6990,16490,9500,1,00035,India
901951,2023-09-28,504,iron,449,879,430,1,00242,India
145941,2023-09-28,505,oven,18490,24000,5510,1,00455,India
145941,2023-09-28,506,monitor,3249,8000,4751,1,00455,India
827469,2023-09-28,505,oven,18490,24000,5510,1,00153,India
827469,2023-09-28,507,washing machine,6990,16490,9500,1,00153,India
827469,2023-09-28,502,iphone 15 pro max,100000,135000,35000,1,00153,India
827469,2023-09-28,504,iron,449,879,430,1,00153,India
742212,2023-09-28,503,mixer,1349,3249,1900,1,00316,India
695022,2023-09-28,507,washing machine,6990,16490,9500,1,00260,India
695022,2023-09-28,504,iron,449,879,430,1,00260,India
695022,2023-09-28,506,monitor,3249,8000,4751,1,00260,India
363685,2023-09-28,507,washing machine,6990,16490,9500,1,00448,India
363685,2023-09-28,501,iphone 15,60000,80000,20000,1,00448,India
363685,2023-09-28,503,mixer,1349,3249,1900,1,00448,India
363685,2023-09-28,504,iron,449,879,430,1,00448,India
573767,2023-09-28,506,monitor,3249,8000,4751,1,00097,India
573767,2023-09-28,502,iphone 15 pro max,100000,135000,35000,1,00097,India
573767,2023-09-28,505,oven,18490,24000,5510,1,00097,India
573767,2023-09-28,501,iphone 15,60000,80000,20000,1,00097,India
279635,2023-09-28,502,iphone 15 pro max,100000,135000,35000,1,00247,India
818662,2023-09-28,502,iphone 15 pro max,100000,135000,35000,1,00032,India
796729,2023-09-28,507,washing machine,6990,16490,9500,1,00396,India
796729,2023-09-28,504,iron,449,879,430,1,00396,India
514006,2023-09-28,507,washing machine,6990,16490,9500,1,00463,India
514006,2023-09-28,506,monitor,3249,8000,4751,1,00463,India
514006,2023-09-28,504,iron,449,879,430,1,00463,India
842914,2023-09-28,506,monitor,3249,8000,4751,1,00231,India
640467,2023-09-28,503,mixer,1349,3249,1900,1,00048,India
640467,2023-09-28,504,iron,449,879,430,1,00048,India
640467,2023-09-28,506,monitor,3249,8000,4751,1,00048,India
640467,2023-09-28,505,oven,18490,24000,5510,1,00048,India
438997,2023-09-28,501,iphone 15,60000,80000,20000,1,00343,India
438997,2023-09-28,504,iron,449,879,430,1,00343,India
438997,2023-09-28,505,oven,18490,24000,5510,1,00343,India
438997,2023-09-28,507,washing machine,6990,16490,9500,1,00343,India
815910,2023-09-28,502,iphone 15 pro max,100000,135000,35000,1,00471,India
815910,2023-09-28,507,washing machine,6990,16490,9500,1,00471,India
815910,2023-09-28,503,mixer,1349,3249,1900,1,00471,India
815910,2023-09-28,504,iron,449,879,430,1,00471,India
420840,2023-09-28,505,oven,18490,24000,5510,1,00420,India
420840,2023-09-28,507,washing machine,6990,16490,9500,1,00420,India
420840,2023-09-28,504,iron,449,879,430,1,00420,India
420840,2023-09-28,501,iphone 15,60000,80000,20000,1,00420,India
844662,2023-09-28,506,monitor,3249,8000,4751,1,00070,India
844662,2023-09-28,505,oven,18490,24000,5510,1,00070,India
844662,2023-09-28,504,iron,449,879,430,1,00070,India
920242,2023-09-28,506,monitor,3249,8000,4751,1,00421,India
920242,2023-09-28,501,iphone 15,60000,80000,20000,1,00421,India
920242,2023-09-28,503,mixer,1349,3249,1900,1,00421,India
519901,2023-09-28,501,iphone 15,60000,80000,20000,1,00062,India
519901,2023-09-28,503,mixer,1349,3249,1900,1,00062,India
519901,2023-09-28,507,washing machine,6990,16490,9500,1,00062,India
377008,2023-09-28,506,monitor,3249,8000,4751,1,00070,India
377008,2023-09-28,505,oven,18490,24000,5510,1,00070,India
377008,2023-09-28,504,iron,449,879,430,1,00070,India
979574,2023-09-28,502,iphone 15 pro max,100000,135000,35000,1,00387,India
979574,2023-09-28,506,monitor,3249,8000,4751,1,00387,India
979574,2023-09-28,507,washing machine,6990,16490,9500,1,00387,India
929160,2023-09-28,505,oven,18490,24000,5510,1,00114,India
929160,2023-09-28,507,washing machine,6990,16490,9500,1,00114,India
780179,2023-09-28,501,iphone 15,60000,80000,20000,1,00477,India
780179,2023-09-28,503,mixer,1349,3249,1900,1,00477,India
780179,2023-09-28,504,iron,449,879,430,1,00477,India
173735,2023-09-28,505,oven,18490,24000,5510,1,00293,India
173735,2023-09-28,502,iphone 15 pro max,100000,135000,35000,1,00293,India
173735,2023-09-28,503,mixer,1349,3249,1900,1,00293,India
173735,2023-09-28,504,iron,449,879,430,1,00293,India
644396,2023-09-28,501,iphone 15,60000,80000,20000,1,00352,India
644396,2023-09-28,507,washing machine,6990,16490,9500,1,00352,India
695438,2023-09-28,504,iron,449,879,430,1,00149,India
695438,2023-09-28,503,mixer,1349,3249,1900,1,00149,India
695438,2023-09-28,501,iphone 15,60000,80000,20000,1,00149,India
554975,2023-09-28,505,oven,18490,24000,5510,1,00299,India
554975,2023-09-28,501,iphone 15,60000,80000,20000,1,00299,India
554975,2023-09-28,503,mixer,1349,3249,1900,1,00299,India
554975,2023-09-28,506,monitor,3249,8000,4751,1,00299,India
190065,2023-09-28,502,iphone 15 pro max,100000,135000,35000,1,00296,India
190065,2023-09-28,505,oven,18490,24000,5510,1,00296,India
740003,2023-09-28,503,mixer,1349,3249,1900,1,00467,India
740003,2023-09-28,504,iron,449,879,430,1,00467,India
532882,2023-09-28,502,iphone 15 pro max,100000,135000,35000,1,00276,India
630660,2023-09-28,505,oven,18490,24000,5510,1,00414,India
518735,2023-09-28,506,monitor,3249,8000,4751,1,00493,India
518735,2023-09-28,504,iron,449,879,430,1,00493,India
518735,2023-09-28,501,iphone 15,60000,80000,20000,1,00493,India
592953,2023-09-28,502,iphone 15 pro max,100000,135000,35000,1,00304,India
991033,2023-09-28,504,iron,449,879,430,1,00228,India
836261,2023-09-28,501,iphone 15,60000,80000,20000,1,00067,India
958139,2023-09-28,502,iphone 15 pro max,100000,135000,35000,1,00348,India
958139,2023-09-28,505,oven,18490,24000,5510,1,00348,India
958139,2023-09-28,501,iphone 15,60000,80000,20000,1,00348,India
189847,2023-09-28,501,iphone 15,60000,80000,20000,1,00391,India
334988,2023-09-28,502,iphone 15 pro max,100000,135000,35000,1,00044,India
334988,2023-09-28,507,washing machine,6990,16490,9500,1,00044,India
334988,2023-09-28,503,mixer,1349,3249,1900,1,00044,India
841500,2023-09-28,505,oven,18490,24000,5510,1,00316,India
415627,2023-09-28,507,washing machine,6990,16490,9500,1,00143,India
415627,2023-09-28,506,monitor,3249,8000,4751,1,00143,India
190370,2023-09-28,502,iphone 15 pro max,100000,135000,35000,1,00443,India
501550,2023-09-28,504,iron,449,879,430,1,00289,India
802718,2023-09-28,502,iphone 15 pro max,100000,135000,35000,1,00402,India
802718,2023-09-28,507,washing machine,6990,16490,9500,1,00402,India
802718,2023-09-28,501,iphone 15,60000,80000,20000,1,00402,India
802718,2023-09-28,504,iron,449,879,430,1,00402,India
468208,2023-09-28,504,iron,449,879,430,1,00252,India
468208,2023-09-28,502,iphone 15 pro max,100000,135000,35000,1,00252,India
468208,2023-09-28,505,oven,18490,24000,5510,1,00252,India
973567,2023-09-28,507,washing machine,6990,16490,9500,1,00002,India
973567,2023-09-28,504,iron,449,879,430,1,00002,India
129656,2023-09-28,507,washing machine,6990,16490,9500,1,00184,India
129656,2023-09-28,501,iphone 15,60000,80000,20000,1,00184,India
132084,2023-09-28,502,iphone 15 pro max,100000,135000,35000,1,00335,India
132084,2023-09-28,503,mixer,1349,3249,1900,1,00335,India
926934,2023-09-28,505,oven,18490,24000,5510,1,00098,India
926934,2023-09-28,503,mixer,1349,3249,1900,1,00098,India
814183,2023-09-28,504,iron,449,879,430,1,00269,India
814183,2023-09-28,507,washing machine,6990,16490,9500,1,00269,India
653703,2023-09-28,504,iron,449,879,430,1,00354,India
653703,2023-09-28,506,monitor,3249,8000,4751,1,00354,India
653703,2023-09-28,505,oven,18490,24000,5510,1,00354,India
808587,2023-09-28,506,monitor,3249,8000,4751,1,00068,India
257949,2023-09-28,504,iron,449,879,430,1,00430,India
458971,2023-09-28,507,washing machine,6990,16490,9500,1,00368,India
458971,2023-09-28,506,monitor,3249,8000,4751,1,00368,India
458971,2023-09-28,505,oven,18490,24000,5510,1,00368,India
458971,2023-09-28,503,mixer,1349,3249,1900,1,00368,India
924216,2023-09-28,502,iphone 15 pro max,100000,135000,35000,1,00403,India
924216,2023-09-28,504,iron,449,879,430,1,00403,India
234204,2023-09-28,507,washing machine,6990,16490,9500,1,00448,India
234204,2023-09-28,505,oven,18490,24000,5510,1,00448,India
340288,2023-09-28,504,iron,449,879,430,1,00225,India
340288,2023-09-28,502,iphone 15 pro max,100000,135000,35000,1,00225,India
340288,2023-09-28,501,iphone 15,60000,80000,20000,1,00225,India
526770,2023-09-28,507,washing machine,6990,16490,9500,1,00370,India
526770,2023-09-28,502,iphone 15 pro max,100000,135000,35000,1,00370,India
526770,2023-09-28,506,monitor,3249,8000,4751,1,00370,India
528366,2023-09-28,502,iphone 15 pro max,100000,135000,35000,1,00375,India
528366,2023-09-28,505,oven,18490,24000,5510,1,00375,India
139016,2023-09-28,507,washing machine,6990,16490,9500,1,00013,India
139016,2023-09-28,506,monitor,3249,8000,4751,1,00013,India
661081,2023-09-28,505,oven,18490,24000,5510,1,00194,India
661081,2023-09-28,507,washing machine,6990,16490,9500,1,00194,India
661081,2023-09-28,502,iphone 15 pro max,100000,135000,35000,1,00194,India
661081,2023-09-28,506,monitor,3249,8000,4751,1,00194,India
564844,2023-09-28,507,washing machine,6990,16490,9500,1,00472,India
564844,2023-09-28,506,monitor,3249,8000,4751,1,00472,India
564844,2023-09-28,504,iron,449,879,430,1,00472,India
850851,2023-09-28,507,washing machine,6990,16490,9500,1,00363,India
850851,2023-09-28,505,oven,18490,24000,5510,1,00363,India
850851,2023-09-28,501,iphone 15,60000,80000,20000,1,00363,India
324008,2023-09-28,507,washing machine,6990,16490,9500,1,00142,India
809072,2023-09-28,507,washing machine,6990,16490,9500,1,00237,India
809072,2023-09-28,505,oven,18490,24000,5510,1,00237,India
809072,2023-09-28,503,mixer,1349,3249,1900,1,00237,India
795501,2023-09-28,501,iphone 15,60000,80000,20000,1,00173,India
795501,2023-09-28,504,iron,449,879,430,1,00173,India
806746,2023-09-28,505,oven,18490,24000,5510,1,00065,India
523043,2023-09-28,502,iphone 15 pro max,100000,135000,35000,1,00356,India
523043,2023-09-28,504,iron,449,879,430,1,00356,India
523043,2023-09-28,506,monitor,3249,8000,4751,1,00356,India
523043,2023-09-28,507,washing machine,6990,16490,9500,1,00356,India
482831,2023-09-28,504,iron,449,879,430,1,00067,India
482831,2023-09-28,507,washing machine,6990,16490,9500,1,00067,India
482831,2023-09-28,506,monitor,3249,8000,4751,1,00067,India
349684,2023-09-28,503,mixer,1349,3249,1900,1,00365,India
349684,2023-09-28,506,monitor,3249,8000,4751,1,00365,India
680893,2023-09-28,507,washing machine,6990,16490,9500,1,00005,India
680893,2023-09-28,505,oven,18490,24000,5510,1,00005,India
680893,2023-09-28,503,mixer,1349,3249,1900,1,00005,India
680893,2023-09-28,506,monitor,3249,8000,4751,1,00005,India
139924,2023-09-28,502,iphone 15 pro max,100000,135000,35000,1,00287,India
139924,2023-09-28,507,washing machine,6990,16490,9500,1,00287,India
139924,2023-09-28,504,iron,449,879,430,1,00287,India
139924,2023-09-28,503,mixer,1349,3249,1900,1,00287,India
454900,2023-09-28,506,monitor,3249,8000,4751,1,00140,India
614274,2023-09-28,504,iron,449,879,430,1,00160,India
614274,2023-09-28,505,oven,18490,24000,5510,1,00160,India
614274,2023-09-28,503,mixer,1349,3249,1900,1,00160,India
614274,2023-09-28,507,washing machine,6990,16490,9500,1,00160,India
183721,2023-09-28,505,oven,18490,24000,5510,1,00220,India
341279,2023-09-29,504,iron,449,879,430,1,00497,India
341279,2023-09-29,507,washing machine,6990,16490,9500,1,00497,India
623491,2023-09-29,503,mixer,1349,3249,1900,1,00096,India
713986,2023-09-29,504,iron,449,879,430,1,00372,India
713986,2023-09-29,502,iphone 15 pro max,100000,135000,35000,1,00372,India
479884,2023-09-29,505,oven,18490,24000,5510,1,00324,India
246808,2023-09-29,505,oven,18490,24000,5510,1,00303,India
246808,2023-09-29,507,washing machine,6990,16490,9500,1,00303,India
246808,2023-09-29,503,mixer,1349,3249,1900,1,00303,India
246808,2023-09-29,506,monitor,3249,8000,4751,1,00303,India
715531,2023-09-29,505,oven,18490,24000,5510,1,00366,India
715531,2023-09-29,504,iron,449,879,430,1,00366,India
972368,2023-09-29,505,oven,18490,24000,5510,1,00116,India
972368,2023-09-29,501,iphone 15,60000,80000,20000,1,00116,India
972368,2023-09-29,503,mixer,1349,3249,1900,1,00116,India
972368,2023-09-29,504,iron,449,879,430,1,00116,India
760440,2023-09-29,503,mixer,1349,3249,1900,1,00015,India
760440,2023-09-29,506,monitor,3249,8000,4751,1,00015,India
169074,2023-09-29,501,iphone 15,60000,80000,20000,1,00453,India
169074,2023-09-29,507,washing machine,6990,16490,9500,1,00453,India
544420,2023-09-29,502,iphone 15 pro max,100000,135000,35000,1,00362,India
783872,2023-09-29,501,iphone 15,60000,80000,20000,1,00158,India
783872,2023-09-29,507,washing machine,6990,16490,9500,1,00158,India
263452,2023-09-29,502,iphone 15 pro max,100000,135000,35000,1,00051,India
790007,2023-09-29,501,iphone 15,60000,80000,20000,1,00119,India
790007,2023-09-29,505,oven,18490,24000,5510,1,00119,India
170083,2023-09-29,504,iron,449,879,430,1,00251,India
170083,2023-09-29,507,washing machine,6990,16490,9500,1,00251,India
170083,2023-09-29,501,iphone 15,60000,80000,20000,1,00251,India
170083,2023-09-29,503,mixer,1349,3249,1900,1,00251,India
499589,2023-09-29,501,iphone 15,60000,80000,20000,1,00294,India
499589,2023-09-29,503,mixer,1349,3249,1900,1,00294,India
499589,2023-09-29,504,iron,449,879,430,1,00294,India
193898,2023-09-29,504,iron,449,879,430,1,00434,India
155527,2023-09-29,505,oven,18490,24000,5510,1,00428,India
155527,2023-09-29,507,washing machine,6990,16490,9500,1,00428,India
155527,2023-09-29,504,iron,449,879,430,1,00428,India
958414,2023-09-29,502,iphone 15 pro max,100000,135000,35000,1,00307,India
633645,2023-09-29,504,iron,449,879,430,1,00230,India
209026,2023-09-29,504,iron,449,879,430,1,00220,India
209026,2023-09-29,506,monitor,3249,8000,4751,1,00220,India
209026,2023-09-29,503,mixer,1349,3249,1900,1,00220,India
131594,2023-09-29,505,oven,18490,24000,5510,1,00382,India
131594,2023-09-29,507,washing machine,6990,16490,9500,1,00382,India
131594,2023-09-29,501,iphone 15,60000,80000,20000,1,00382,India
588998,2023-09-29,501,iphone 15,60000,80000,20000,1,00371,India
588998,2023-09-29,502,iphone 15 pro max,100000,135000,35000,1,00371,India
588998,2023-09-29,505,oven,18490,24000,5510,1,00371,India
371217,2023-09-29,506,monitor,3249,8000,4751,1,00208,India
371217,2023-09-29,503,mixer,1349,3249,1900,1,00208,India
371217,2023-09-29,501,iphone 15,60000,80000,20000,1,00208,India
371217,2023-09-29,504,iron,449,879,430,1,00208,India
166629,2023-09-29,502,iphone 15 pro max,100000,135000,35000,1,00359,India
166629,2023-09-29,503,mixer,1349,3249,1900,1,00359,India
166629,2023-09-29,505,oven,18490,24000,5510,1,00359,India
204893,2023-09-29,503,mixer,1349,3249,1900,1,00299,India
204893,2023-09-29,507,washing machine,6990,16490,9500,1,00299,India
204893,2023-09-29,506,monitor,3249,8000,4751,1,00299,India
902596,2023-09-29,503,mixer,1349,3249,1900,1,00276,India
902596,2023-09-29,502,iphone 15 pro max,100000,135000,35000,1,00276,India
836790,2023-09-29,503,mixer,1349,3249,1900,1,00396,India
444990,2023-09-29,507,washing machine,6990,16490,9500,1,00462,India
444990,2023-09-29,504,iron,449,879,430,1,00462,India
444990,2023-09-29,505,oven,18490,24000,5510,1,00462,India
521261,2023-09-29,504,iron,449,879,430,1,00133,India
141121,2023-09-29,501,iphone 15,60000,80000,20000,1,00488,India
141121,2023-09-29,505,oven,18490,24000,5510,1,00488,India
447653,2023-09-29,504,iron,449,879,430,1,00289,India
447653,2023-09-29,507,washing machine,6990,16490,9500,1,00289,India
447653,2023-09-29,505,oven,18490,24000,5510,1,00289,India
456421,2023-09-29,502,iphone 15 pro max,100000,135000,35000,1,00023,India
456421,2023-09-29,505,oven,18490,24000,5510,1,00023,India
456421,2023-09-29,506,monitor,3249,8000,4751,1,00023,India
523250,2023-09-29,503,mixer,1349,3249,1900,1,00165,India
523250,2023-09-29,502,iphone 15 pro max,100000,135000,35000,1,00165,India
523250,2023-09-29,501,iphone 15,60000,80000,20000,1,00165,India
593514,2023-09-29,503,mixer,1349,3249,1900,1,00137,India
697672,2023-09-29,507,washing machine,6990,16490,9500,1,00296,India
697672,2023-09-29,503,mixer,1349,3249,1900,1,00296,India
148280,2023-09-29,507,washing machine,6990,16490,9500,1,00484,India
148280,2023-09-29,501,iphone 15,60000,80000,20000,1,00484,India
754592,2023-09-29,503,mixer,1349,3249,1900,1,00488,India
754592,2023-09-29,502,iphone 15 pro max,100000,135000,35000,1,00488,India
754592,2023-09-29,507,washing machine,6990,16490,9500,1,00488,India
588968,2023-09-29,501,iphone 15,60000,80000,20000,1,00341,India
588968,2023-09-29,503,mixer,1349,3249,1900,1,00341,India
588968,2023-09-29,504,iron,449,879,430,1,00341,India
588968,2023-09-29,507,washing machine,6990,16490,9500,1,00341,India
836788,2023-09-29,506,monitor,3249,8000,4751,1,00455,India
311006,2023-09-29,501,iphone 15,60000,80000,20000,1,00083,India
745073,2023-09-29,505,oven,18490,24000,5510,1,00333,India
745073,2023-09-29,502,iphone 15 pro max,100000,135000,35000,1,00333,India
745073,2023-09-29,503,mixer,1349,3249,1900,1,00333,India
433575,2023-09-29,502,iphone 15 pro max,100000,135000,35000,1,00057,India
433575,2023-09-29,504,iron,449,879,430,1,00057,India
433575,2023-09-29,505,oven,18490,24000,5510,1,00057,India
914207,2023-09-29,501,iphone 15,60000,80000,20000,1,00270,India
914207,2023-09-29,502,iphone 15 pro max,100000,135000,35000,1,00270,India
590694,2023-09-29,502,iphone 15 pro max,100000,135000,35000,1,00236,India
688006,2023-09-29,506,monitor,3249,8000,4751,1,00071,India
688006,2023-09-29,502,iphone 15 pro max,100000,135000,35000,1,00071,India
250696,2023-09-29,504,iron,449,879,430,1,00089,India
250696,2023-09-29,505,oven,18490,24000,5510,1,00089,India
250696,2023-09-29,506,monitor,3249,8000,4751,1,00089,India
250696,2023-09-29,501,iphone 15,60000,80000,20000,1,00089,India
673884,2023-09-29,504,iron,449,879,430,1,00014,India
673884,2023-09-29,506,monitor,3249,8000,4751,1,00014,India
673884,2023-09-29,502,iphone 15 pro max,100000,135000,35000,1,00014,India
592826,2023-09-29,506,monitor,3249,8000,4751,1,00297,India
592826,2023-09-29,501,iphone 15,60000,80000,20000,1,00297,India
592826,2023-09-29,502,iphone 15 pro max,100000,135000,35000,1,00297,India
355849,2023-09-29,507,washing machine,6990,16490,9500,1,00227,India
355849,2023-09-29,506,monitor,3249,8000,4751,1,00227,India
364131,2023-09-29,506,monitor,3249,8000,4751,1,00453,India
364131,2023-09-29,504,iron,449,879,430,1,00453,India
510738,2023-09-30,507,washing machine,6990,16490,9500,1,00140,India
510738,2023-09-30,505,oven,18490,24000,5510,1,00140,India
510738,2023-09-30,506,monitor,3249,8000,4751,1,00140,India
830368,2023-09-30,501,iphone 15,60000,80000,20000,1,00438,India
483517,2023-09-30,505,oven,18490,24000,5510,1,00426,India
483517,2023-09-30,501,iphone 15,60000,80000,20000,1,00426,India
217227,2023-09-30,506,monitor,3249,8000,4751,1,00338,India
217227,2023-09-30,507,washing machine,6990,16490,9500,1,00338,India
132592,2023-09-30,502,iphone 15 pro max,100000,135000,35000,1,00249,India
132592,2023-09-30,504,iron,449,879,430,1,00249,India
132592,2023-09-30,506,monitor,3249,8000,4751,1,00249,India
132592,2023-09-30,505,oven,18490,24000,5510,1,00249,India
500876,2023-09-30,506,monitor,3249,8000,4751,1,00422,India
500876,2023-09-30,507,washing machine,6990,16490,9500,1,00422,India
958152,2023-09-30,507,washing machine,6990,16490,9500,1,00049,India
134873,2023-09-30,504,iron,449,879,430,1,00012,India
134873,2023-09-30,505,oven,18490,24000,5510,1,00012,India
134873,2023-09-30,503,mixer,1349,3249,1900,1,00012,India
581534,2023-09-30,505,oven,18490,24000,5510,1,00343,India
581534,2023-09-30,501,iphone 15,60000,80000,20000,1,00343,India
581534,2023-09-30,503,mixer,1349,3249,1900,1,00343,India
842792,2023-09-30,505,oven,18490,24000,5510,1,00300,India
842792,2023-09-30,501,iphone 15,60000,80000,20000,1,00300,India
842792,2023-09-30,507,washing machine,6990,16490,9500,1,00300,India
158937,2023-09-30,502,iphone 15 pro max,100000,135000,35000,1,00310,India
158937,2023-09-30,506,monitor,3249,8000,4751,1,00310,India
353200,2023-09-30,507,washing machine,6990,16490,9500,1,00476,India
353200,2023-09-30,502,iphone 15 pro max,100000,135000,35000,1,00476,India
353200,2023-09-30,503,mixer,1349,3249,1900,1,00476,India
426875,2023-09-30,501,iphone 15,60000,80000,20000,1,00235,India
915974,2023-09-30,507,washing machine,6990,16490,9500,1,00398,India
915974,2023-09-30,503,mixer,1349,3249,1900,1,00398,India
326923,2023-09-30,503,mixer,1349,3249,1900,1,00484,India
717308,2023-09-30,503,mixer,1349,3249,1900,1,00202,India
717308,2023-09-30,501,iphone 15,60000,80000,20000,1,00202,India
717308,2023-09-30,507,washing machine,6990,16490,9500,1,00202,India
322143,2023-09-30,506,monitor,3249,8000,4751,1,00195,India
246626,2023-09-30,503,mixer,1349,3249,1900,1,00291,India
457381,2023-09-30,507,washing machine,6990,16490,9500,1,00125,India
457381,2023-09-30,504,iron,449,879,430,1,00125,India
457381,2023-09-30,506,monitor,3249,8000,4751,1,00125,India
457381,2023-09-30,505,oven,18490,24000,5510,1,00125,India
602979,2023-09-30,502,iphone 15 pro max,100000,135000,35000,1,00354,India
602979,2023-09-30,501,iphone 15,60000,80000,20000,1,00354,India
602979,2023-09-30,505,oven,18490,24000,5510,1,00354,India
601243,2023-09-30,502,iphone 15 pro max,100000,135000,35000,1,00224,India
341829,2023-09-30,507,washing machine,6990,16490,9500,1,00309,India
341829,2023-09-30,502,iphone 15 pro max,100000,135000,35000,1,00309,India
341829,2023-09-30,505,oven,18490,24000,5510,1,00309,India
243200,2023-09-30,501,iphone 15,60000,80000,20000,1,00360,India
243200,2023-09-30,506,monitor,3249,8000,4751,1,00360,India
243200,2023-09-30,503,mixer,1349,3249,1900,1,00360,India
281694,2023-09-30,503,mixer,1349,3249,1900,1,00102,India
891524,2023-09-30,505,oven,18490,24000,5510,1,00028,India
891524,2023-09-30,504,iron,449,879,430,1,00028,India
891524,2023-09-30,506,monitor,3249,8000,4751,1,00028,India
891524,2023-09-30,503,mixer,1349,3249,1900,1,00028,India
237347,2023-09-30,505,oven,18490,24000,5510,1,00396,India
237347,2023-09-30,501,iphone 15,60000,80000,20000,1,00396,India
237347,2023-09-30,506,monitor,3249,8000,4751,1,00396,India
492534,2023-09-30,507,washing machine,6990,16490,9500,1,00115,India
492534,2023-09-30,505,oven,18490,24000,5510,1,00115,India
492534,2023-09-30,501,iphone 15,60000,80000,20000,1,00115,India
492534,2023-09-30,502,iphone 15 pro max,100000,135000,35000,1,00115,India
602047,2023-09-30,501,iphone 15,60000,80000,20000,1,00403,India
602047,2023-09-30,507,washing machine,6990,16490,9500,1,00403,India
602047,2023-09-30,505,oven,18490,24000,5510,1,00403,India
602047,2023-09-30,502,iphone 15 pro max,100000,135000,35000,1,00403,India
327595,2023-09-30,505,oven,18490,24000,5510,1,00087,India
886314,2023-09-30,501,iphone 15,60000,80000,20000,1,00204,India
886314,2023-09-30,502,iphone 15 pro max,100000,135000,35000,1,00204,India
233846,2023-09-30,505,oven,18490,24000,5510,1,00240,India
233846,2023-09-30,503,mixer,1349,3249,1900,1,00240,India
233846,2023-09-30,506,monitor,3249,8000,4751,1,00240,India
233846,2023-09-30,507,washing machine,6990,16490,9500,1,00240,India
799294,2023-09-30,503,mixer,1349,3249,1900,1,00465,India
799294,2023-09-30,502,iphone 15 pro max,100000,135000,35000,1,00465,India
799294,2023-09-30,501,iphone 15,60000,80000,20000,1,00465,India
910659,2023-09-30,503,mixer,1349,3249,1900,1,00097,India
663655,2023-09-30,502,iphone 15 pro max,100000,135000,35000,1,00227,India
663655,2023-09-30,504,iron,449,879,430,1,00227,India
663655,2023-09-30,507,washing machine,6990,16490,9500,1,00227,India
988397,2023-09-30,504,iron,449,879,430,1,00165,India
988397,2023-09-30,501,iphone 15,60000,80000,20000,1,00165,India
988397,2023-09-30,505,oven,18490,24000,5510,1,00165,India
988397,2023-09-30,502,iphone 15 pro max,100000,135000,35000,1,00165,India
896704,2023-09-30,505,oven,18490,24000,5510,1,00159,India
896704,2023-09-30,501,iphone 15,60000,80000,20000,1,00159,India
896704,2023-09-30,504,iron,449,879,430,1,00159,India
346591,2023-09-30,505,oven,18490,24000,5510,1,00497,India
346591,2023-09-30,503,mixer,1349,3249,1900,1,00497,India
346591,2023-09-30,502,iphone 15 pro max,100000,135000,35000,1,00497,India
400527,2023-09-30,503,mixer,1349,3249,1900,1,00167,India
400527,2023-09-30,502,iphone 15 pro max,100000,135000,35000,1,00167,India
400527,2023-09-30,501,iphone 15,60000,80000,20000,1,00167,India
400527,2023-09-30,506,monitor,3249,8000,4751,1,00167,India
396769,2023-09-30,505,oven,18490,24000,5510,1,00224,India
396769,2023-09-30,504,iron,449,879,430,1,00224,India
396769,2023-09-30,501,iphone 15,60000,80000,20000,1,00224,India
725314,2023-09-30,507,washing machine,6990,16490,9500,1,00211,India
200403,2023-09-30,504,iron,449,879,430,1,00434,India
200403,2023-09-30,502,iphone 15 pro max,100000,135000,35000,1,00434,India
200403,2023-09-30,507,washing machine,6990,16490,9500,1,00434,India
611283,2023-09-30,502,iphone 15 pro max,100000,135000,35000,1,00250,India
611283,2023-09-30,504,iron,449,879,430,1,00250,India
343971,2023-09-30,504,iron,449,879,430,1,00089,India
219786,2023-09-30,502,iphone 15 pro max,100000,135000,35000,1,00407,India
219786,2023-09-30,503,mixer,1349,3249,1900,1,00407,India
107712,2023-09-30,503,mixer,1349,3249,1900,1,00148,India
922880,2023-09-30,505,oven,18490,24000,5510,1,00418,India
867112,2023-09-30,504,iron,449,879,430,1,00348,India
867112,2023-09-30,503,mixer,1349,3249,1900,1,00348,India
313818,2023-09-30,505,oven,18490,24000,5510,1,00247,India
313818,2023-09-30,504,iron,449,879,430,1,00247,India
313818,2023-09-30,507,washing machine,6990,16490,9500,1,00247,India
793767,2023-09-30,502,iphone 15 pro max,100000,135000,35000,1,00440,India
793767,2023-09-30,504,iron,449,879,430,1,00440,India
793767,2023-09-30,501,iphone 15,60000,80000,20000,1,00440,India
206967,2023-09-30,503,mixer,1349,3249,1900,1,00330,India
206967,2023-09-30,507,washing machine,6990,16490,9500,1,00330,India
206967,2023-09-30,501,iphone 15,60000,80000,20000,1,00330,India
206967,2023-09-30,505,oven,18490,24000,5510,1,00330,India
206967,2023-09-30,506,monitor,3249,8000,4751,1,00330,India
508520,2023-09-30,502,iphone 15 pro max,100000,135000,35000,1,00055,India
508520,2023-09-30,505,oven,18490,24000,5510,1,00055,India
508520,2023-09-30,507,washing machine,6990,16490,9500,1,00055,India
508520,2023-09-30,503,mixer,1349,3249,1900,1,00055,India
483170,2023-09-30,507,washing machine,6990,16490,9500,1,00499,India
483170,2023-09-30,501,iphone 15,60000,80000,20000,1,00499,India
263318,2023-09-30,507,washing machine,6990,16490,9500,1,00495,India
263318,2023-09-30,506,monitor,3249,8000,4751,1,00495,India
891691,2023-09-30,505,oven,18490,24000,5510,1,00314,India
333884,2023-10-01,504,iron,449,879,430,1,00081,India
665053,2023-10-01,506,monitor,3249,8000,4751,1,00451,India
665053,2023-10-01,505,oven,18490,24000,5510,1,00451,India
665053,2023-10-01,507,washing machine,6990,16490,9500,1,00451,India
197027,2023-10-01,507,washing machine,6990,16490,9500,1,00423,India
151350,2023-10-01,504,iron,449,879,430,1,00478,India
928255,2023-10-01,504,iron,449,879,430,1,00223,India
928255,2023-10-01,502,iphone 15 pro max,100000,135000,35000,2,00223,India
928255,2023-10-01,507,washing machine,6990,16490,9500,1,00223,India
928255,2023-10-01,506,monitor,3249,8000,4751,1,00223,India
865259,2023-10-01,501,iphone 15,60000,80000,20000,2,00409,India
865259,2023-10-01,507,washing machine,6990,16490,9500,1,00409,India
554254,2023-10-01,504,iron,449,879,430,1,00005,India
554254,2023-10-01,502,iphone 15 pro max,100000,135000,35000,2,00005,India
439101,2023-10-01,501,iphone 15,60000,80000,20000,2,00085,India
439101,2023-10-01,505,oven,18490,24000,5510,1,00085,India
446783,2023-10-01,503,mixer,1349,3249,1900,1,00174,India
446783,2023-10-01,502,iphone 15 pro max,100000,135000,35000,2,00174,India
446783,2023-10-01,506,monitor,3249,8000,4751,1,00174,India
446783,2023-10-01,505,oven,18490,24000,5510,1,00174,India
324953,2023-10-01,502,iphone 15 pro max,100000,135000,35000,2,00061,India
324953,2023-10-01,503,mixer,1349,3249,1900,1,00061,India
324953,2023-10-01,504,iron,449,879,430,1,00061,India
677375,2023-10-01,504,iron,449,879,430,1,00462,India
268274,2023-10-01,506,monitor,3249,8000,4751,1,00458,India
268274,2023-10-01,505,oven,18490,24000,5510,1,00458,India
935547,2023-10-01,503,mixer,1349,3249,1900,1,00189,India
549861,2023-10-01,506,monitor,3249,8000,4751,1,00031,India
549861,2023-10-01,504,iron,449,879,430,1,00031,India
283179,2023-10-01,503,mixer,1349,3249,1900,1,00179,India
283179,2023-10-01,504,iron,449,879,430,1,00179,India
283179,2023-10-01,507,washing machine,6990,16490,9500,1,00179,India
435594,2023-10-01,501,iphone 15,60000,80000,20000,2,00069,India
435594,2023-10-01,503,mixer,1349,3249,1900,1,00069,India
435594,2023-10-01,507,washing machine,6990,16490,9500,1,00069,India
435594,2023-10-01,502,iphone 15 pro max,100000,135000,35000,2,00069,India
995713,2023-10-01,504,iron,449,879,430,1,00399,India
902256,2023-10-01,507,washing machine,6990,16490,9500,1,00134,India
902256,2023-10-01,503,mixer,1349,3249,1900,1,00134,India
949057,2023-10-01,502,iphone 15 pro max,100000,135000,35000,2,00029,India
734766,2023-10-01,502,iphone 15 pro max,100000,135000,35000,2,00468,India
734766,2023-10-01,504,iron,449,879,430,1,00468,India
734766,2023-10-01,506,monitor,3249,8000,4751,1,00468,India
734766,2023-10-01,503,mixer,1349,3249,1900,1,00468,India
742822,2023-10-01,505,oven,18490,24000,5510,1,00273,India
742822,2023-10-01,506,monitor,3249,8000,4751,1,00273,India
742822,2023-10-01,501,iphone 15,60000,80000,20000,2,00273,India
229929,2023-10-01,501,iphone 15,60000,80000,20000,2,00312,India
229929,2023-10-01,507,washing machine,6990,16490,9500,1,00312,India
471873,2023-10-01,504,iron,449,879,430,1,00414,India
471873,2023-10-01,502,iphone 15 pro max,100000,135000,35000,2,00414,India
882176,2023-10-01,507,washing machine,6990,16490,9500,1,00161,India
468932,2023-10-01,501,iphone 15,60000,80000,20000,2,00248,India
287320,2023-10-01,501,iphone 15,60000,80000,20000,2,00485,India
287320,2023-10-01,503,mixer,1349,3249,1900,1,00485,India
200714,2023-10-01,505,oven,18490,24000,5510,1,00085,India
200714,2023-10-01,504,iron,449,879,430,1,00085,India
200714,2023-10-01,503,mixer,1349,3249,1900,1,00085,India
338974,2023-10-01,507,washing machine,6990,16490,9500,1,00019,India
793724,2023-10-01,503,mixer,1349,3249,1900,1,00319,India
793724,2023-10-01,505,oven,18490,24000,5510,1,00319,India
793724,2023-10-01,501,iphone 15,60000,80000,20000,2,00319,India
793724,2023-10-01,507,washing machine,6990,16490,9500,1,00319,India
987363,2023-10-01,507,washing machine,6990,16490,9500,1,00343,India
987363,2023-10-01,504,iron,449,879,430,1,00343,India
987363,2023-10-01,501,iphone 15,60000,80000,20000,2,00343,India
104149,2023-10-01,502,iphone 15 pro max,100000,135000,35000,2,00160,India
104149,2023-10-01,506,monitor,3249,8000,4751,1,00160,India
104149,2023-10-01,507,washing machine,6990,16490,9500,1,00160,India
104149,2023-10-01,503,mixer,1349,3249,1900,1,00160,India
313565,2023-10-01,505,oven,18490,24000,5510,1,00357,India
313565,2023-10-01,507,washing machine,6990,16490,9500,1,00357,India
313565,2023-10-01,501,iphone 15,60000,80000,20000,2,00357,India
313565,2023-10-01,506,monitor,3249,8000,4751,1,00357,India
313565,2023-10-01,502,iphone 15 pro max,100000,135000,35000,2,00357,India
264668,2023-10-01,507,washing machine,6990,16490,9500,1,00336,India
264668,2023-10-01,502,iphone 15 pro max,100000,135000,35000,2,00336,India
264668,2023-10-01,501,iphone 15,60000,80000,20000,2,00336,India
430701,2023-10-01,502,iphone 15 pro max,100000,135000,35000,2,00375,India
363656,2023-10-01,506,monitor,3249,8000,4751,1,00040,India
363656,2023-10-01,501,iphone 15,60000,80000,20000,2,00040,India
146690,2023-10-01,504,iron,449,879,430,1,00451,India
309663,2023-10-01,501,iphone 15,60000,80000,20000,2,00041,India
309663,2023-10-01,504,iron,449,879,430,1,00041,India
309663,2023-10-01,505,oven,18490,24000,5510,1,00041,India
309663,2023-10-01,507,washing machine,6990,16490,9500,1,00041,India
309663,2023-10-01,502,iphone 15 pro max,100000,135000,35000,2,00041,India
806605,2023-10-01,503,mixer,1349,3249,1900,1,00246,India
806605,2023-10-01,504,iron,449,879,430,1,00246,India
806605,2023-10-01,502,iphone 15 pro max,100000,135000,35000,2,00246,India
318712,2023-10-01,502,iphone 15 pro max,100000,135000,35000,2,00125,India
700009,2023-10-01,503,mixer,1349,3249,1900,1,00256,India
411252,2023-10-01,502,iphone 15 pro max,100000,135000,35000,2,00340,India
411252,2023-10-01,504,iron,449,879,430,1,00340,India
554666,2023-10-01,507,washing machine,6990,16490,9500,1,00418,India
554666,2023-10-01,505,oven,18490,24000,5510,1,00418,India
559880,2023-10-01,503,mixer,1349,3249,1900,1,00332,India
559880,2023-10-01,502,iphone 15 pro max,100000,135000,35000,2,00332,India
920054,2023-10-01,501,iphone 15,60000,80000,20000,2,00060,India
920054,2023-10-01,504,iron,449,879,430,1,00060,India
985494,2023-10-01,507,washing machine,6990,16490,9500,1,00097,India
107841,2023-10-01,504,iron,449,879,430,1,00076,India
107841,2023-10-01,507,washing machine,6990,16490,9500,1,00076,India
563169,2023-10-01,504,iron,449,879,430,1,00035,India
563169,2023-10-01,506,monitor,3249,8000,4751,1,00035,India
563169,2023-10-01,507,washing machine,6990,16490,9500,1,00035,India
563169,2023-10-01,505,oven,18490,24000,5510,1,00035,India
901837,2023-10-01,504,iron,449,879,430,1,00087,India
901837,2023-10-01,506,monitor,3249,8000,4751,1,00087,India
121726,2023-10-01,504,iron,449,879,430,1,00380,India
121726,2023-10-01,507,washing machine,6990,16490,9500,1,00380,India
121726,2023-10-01,502,iphone 15 pro max,100000,135000,35000,2,00380,India
121726,2023-10-01,505,oven,18490,24000,5510,1,00380,India
242896,2023-10-01,503,mixer,1349,3249,1900,1,00499,India
899009,2023-10-01,504,iron,449,879,430,1,00289,India
899009,2023-10-01,503,mixer,1349,3249,1900,1,00289,India
899009,2023-10-01,507,washing machine,6990,16490,9500,1,00289,India
885160,2023-10-01,507,washing machine,6990,16490,9500,1,00170,India
885160,2023-10-01,501,iphone 15,60000,80000,20000,2,00170,India
885160,2023-10-01,502,iphone 15 pro max,100000,135000,35000,2,00170,India
182893,2023-10-01,507,washing machine,6990,16490,9500,1,00406,India
182893,2023-10-01,503,mixer,1349,3249,1900,1,00406,India
182893,2023-10-01,504,iron,449,879,430,1,00406,India
420325,2023-10-01,503,mixer,1349,3249,1900,1,00249,India
491751,2023-10-01,501,iphone 15,60000,80000,20000,2,00460,India
491751,2023-10-01,503,mixer,1349,3249,1900,1,00460,India
491751,2023-10-01,507,washing machine,6990,16490,9500,1,00460,India
682346,2023-10-01,504,iron,449,879,430,1,00338,India
682346,2023-10-01,507,washing machine,6990,16490,9500,1,00338,India
682346,2023-10-01,505,oven,18490,24000,5510,1,00338,India
682346,2023-10-01,506,monitor,3249,8000,4751,1,00338,India
316339,2023-10-01,505,oven,18490,24000,5510,1,00228,India
316339,2023-10-01,507,washing machine,6990,16490,9500,1,00228,India
316339,2023-10-01,506,monitor,3249,8000,4751,1,00228,India
316339,2023-10-01,501,iphone 15,60000,80000,20000,2,00228,India
456804,2023-10-01,506,monitor,3249,8000,4751,1,00498,India
456804,2023-10-01,504,iron,449,879,430,1,00498,India
456804,2023-10-01,507,washing machine,6990,16490,9500,1,00498,India
565199,2023-10-01,502,iphone 15 pro max,100000,135000,35000,2,00358,India
565199,2023-10-01,505,oven,18490,24000,5510,1,00358,India
565199,2023-10-01,504,iron,449,879,430,1,00358,India
489783,2023-10-01,503,mixer,1349,3249,1900,1,00136,India
395315,2023-10-01,502,iphone 15 pro max,100000,135000,35000,2,00233,India
395315,2023-10-01,504,iron,449,879,430,1,00233,India
395315,2023-10-01,503,mixer,1349,3249,1900,1,00233,India
580617,2023-10-01,505,oven,18490,24000,5510,1,00223,India
580617,2023-10-01,506,monitor,3249,8000,4751,1,00223,India
580617,2023-10-01,507,washing machine,6990,16490,9500,1,00223,India
291921,2023-10-01,505,oven,18490,24000,5510,1,00203,India
291921,2023-10-01,504,iron,449,879,430,1,00203,India
969726,2023-10-02,505,oven,18490,24000,5510,1,00320,India
969726,2023-10-02,502,iphone 15 pro max,100000,135000,35000,2,00320,India
751951,2023-10-02,505,oven,18490,24000,5510,1,00230,India
751951,2023-10-02,506,monitor,3249,8000,4751,1,00230,India
751951,2023-10-02,507,washing machine,6990,16490,9500,1,00230,India
751951,2023-10-02,501,iphone 15,60000,80000,20000,2,00230,India
151975,2023-10-02,506,monitor,3249,8000,4751,1,00271,India
519289,2023-10-02,505,oven,18490,24000,5510,1,00311,India
519289,2023-10-02,503,mixer,1349,3249,1900,1,00311,India
519289,2023-10-02,507,washing machine,6990,16490,9500,1,00311,India
314897,2023-10-02,506,monitor,3249,8000,4751,1,00051,India
314897,2023-10-02,505,oven,18490,24000,5510,1,00051,India
393211,2023-10-02,507,washing machine,6990,16490,9500,1,00199,India
393211,2023-10-02,506,monitor,3249,8000,4751,1,00199,India
317120,2023-10-02,507,washing machine,6990,16490,9500,1,00111,India
317120,2023-10-02,506,monitor,3249,8000,4751,1,00111,India
160897,2023-10-02,505,oven,18490,24000,5510,1,00168,India
631952,2023-10-02,505,oven,18490,24000,5510,1,00284,India
631952,2023-10-02,503,mixer,1349,3249,1900,1,00284,India
631952,2023-10-02,502,iphone 15 pro max,100000,135000,35000,2,00284,India
499392,2023-10-02,506,monitor,3249,8000,4751,1,00209,India
347464,2023-10-02,501,iphone 15,60000,80000,20000,2,00392,India
347464,2023-10-02,507,washing machine,6990,16490,9500,1,00392,India
124857,2023-10-02,503,mixer,1349,3249,1900,1,00224,India
124857,2023-10-02,504,iron,449,879,430,1,00224,India
124857,2023-10-02,501,iphone 15,60000,80000,20000,2,00224,India
228923,2023-10-02,502,iphone 15 pro max,100000,135000,35000,2,00063,India
856956,2023-10-02,504,iron,449,879,430,1,00402,India
856956,2023-10-02,507,washing machine,6990,16490,9500,1,00402,India
856956,2023-10-02,501,iphone 15,60000,80000,20000,2,00402,India
856956,2023-10-02,505,oven,18490,24000,5510,1,00402,India
357849,2023-10-02,502,iphone 15 pro max,100000,135000,35000,2,00101,India
167266,2023-10-02,503,mixer,1349,3249,1900,1,00394,India
167266,2023-10-02,504,iron,449,879,430,1,00394,India
681279,2023-10-02,503,mixer,1349,3249,1900,1,00450,India
681279,2023-10-02,504,iron,449,879,430,1,00450,India
733844,2023-10-02,506,monitor,3249,8000,4751,1,00229,India
733844,2023-10-02,505,oven,18490,24000,5510,1,00229,India
993432,2023-10-02,504,iron,449,879,430,1,00446,India
993432,2023-10-02,506,monitor,3249,8000,4751,1,00446,India
993432,2023-10-02,503,mixer,1349,3249,1900,1,00446,India
137181,2023-10-02,503,mixer,1349,3249,1900,1,00386,India
137181,2023-10-02,502,iphone 15 pro max,100000,135000,35000,2,00386,India
137181,2023-10-02,504,iron,449,879,430,1,00386,India
568702,2023-10-02,505,oven,18490,24000,5510,1,00459,India
568702,2023-10-02,504,iron,449,879,430,1,00459,India
196005,2023-10-02,502,iphone 15 pro max,100000,135000,35000,2,00437,India
587432,2023-10-02,503,mixer,1349,3249,1900,1,00008,India
587432,2023-10-02,504,iron,449,879,430,1,00008,India
587432,2023-10-02,501,iphone 15,60000,80000,20000,2,00008,India
503168,2023-10-02,507,washing machine,6990,16490,9500,1,00217,India
503168,2023-10-02,501,iphone 15,60000,80000,20000,2,00217,India
948866,2023-10-02,507,washing machine,6990,16490,9500,1,00063,India
948866,2023-10-02,504,iron,449,879,430,1,00063,India
715535,2023-10-02,503,mixer,1349,3249,1900,1,00370,India
715535,2023-10-02,501,iphone 15,60000,80000,20000,2,00370,India
715535,2023-10-02,505,oven,18490,24000,5510,1,00370,India
715535,2023-10-02,506,monitor,3249,8000,4751,1,00370,India
658773,2023-10-02,504,iron,449,879,430,1,00336,India
650899,2023-10-02,506,monitor,3249,8000,4751,1,00034,India
930551,2023-10-02,506,monitor,3249,8000,4751,1,00080,India
930551,2023-10-02,504,iron,449,879,430,1,00080,India
840516,2023-10-02,501,iphone 15,60000,80000,20000,2,00328,India
840516,2023-10-02,506,monitor,3249,8000,4751,1,00328,India
840516,2023-10-02,507,washing machine,6990,16490,9500,1,00328,India
840516,2023-10-02,502,iphone 15 pro max,100000,135000,35000,2,00328,India
511395,2023-10-02,503,mixer,1349,3249,1900,1,00383,India
511395,2023-10-02,506,monitor,3249,8000,4751,1,00383,India
511395,2023-10-02,502,iphone 15 pro max,100000,135000,35000,2,00383,India
511395,2023-10-02,507,washing machine,6990,16490,9500,1,00383,India
826206,2023-10-02,502,iphone 15 pro max,100000,135000,35000,2,00226,India
826206,2023-10-02,504,iron,449,879,430,1,00226,India
826206,2023-10-02,505,oven,18490,24000,5510,1,00226,India
398377,2023-10-02,503,mixer,1349,3249,1900,1,00084,India
398377,2023-10-02,501,iphone 15,60000,80000,20000,2,00084,India
398377,2023-10-02,507,washing machine,6990,16490,9500,1,00084,India
379589,2023-10-02,505,oven,18490,24000,5510,1,00177,India
379589,2023-10-02,503,mixer,1349,3249,1900,1,00177,India
379589,2023-10-02,502,iphone 15 pro max,100000,135000,35000,2,00177,India
379589,2023-10-02,507,washing machine,6990,16490,9500,1,00177,India
208413,2023-10-02,507,washing machine,6990,16490,9500,1,00383,India
208413,2023-10-02,504,iron,449,879,430,1,00383,India
208413,2023-10-02,501,iphone 15,60000,80000,20000,2,00383,India
209761,2023-10-02,502,iphone 15 pro max,100000,135000,35000,2,00417,India
209761,2023-10-02,507,washing machine,6990,16490,9500,1,00417,India
209761,2023-10-02,506,monitor,3249,8000,4751,1,00417,India
209761,2023-10-02,503,mixer,1349,3249,1900,1,00417,India
209761,2023-10-02,504,iron,449,879,430,1,00417,India
564943,2023-10-02,501,iphone 15,60000,80000,20000,2,00013,India
564943,2023-10-02,502,iphone 15 pro max,100000,135000,35000,2,00013,India
282332,2023-10-02,502,iphone 15 pro max,100000,135000,35000,2,00042,India
282332,2023-10-02,506,monitor,3249,8000,4751,1,00042,India
282332,2023-10-02,505,oven,18490,24000,5510,1,00042,India
223069,2023-10-02,505,oven,18490,24000,5510,1,00329,India
223069,2023-10-02,502,iphone 15 pro max,100000,135000,35000,2,00329,India
223069,2023-10-02,506,monitor,3249,8000,4751,1,00329,India
330239,2023-10-02,507,washing machine,6990,16490,9500,1,00080,India
330239,2023-10-02,504,iron,449,879,430,1,00080,India
330239,2023-10-02,503,mixer,1349,3249,1900,1,00080,India
330239,2023-10-02,502,iphone 15 pro max,100000,135000,35000,2,00080,India
518405,2023-10-02,504,iron,449,879,430,1,00014,India
518405,2023-10-02,505,oven,18490,24000,5510,1,00014,India
365461,2023-10-02,506,monitor,3249,8000,4751,1,00414,India
140235,2023-10-02,506,monitor,3249,8000,4751,1,00026,India
140235,2023-10-02,503,mixer,1349,3249,1900,1,00026,India
140235,2023-10-02,502,iphone 15 pro max,100000,135000,35000,2,00026,India
975218,2023-10-02,505,oven,18490,24000,5510,1,00062,India
975218,2023-10-02,504,iron,449,879,430,1,00062,India
851317,2023-10-02,507,washing machine,6990,16490,9500,1,00476,India
851317,2023-10-02,504,iron,449,879,430,1,00476,India
851317,2023-10-02,502,iphone 15 pro max,100000,135000,35000,2,00476,India
817494,2023-10-02,506,monitor,3249,8000,4751,1,00248,India
817494,2023-10-02,501,iphone 15,60000,80000,20000,2,00248,India
469846,2023-10-02,502,iphone 15 pro max,100000,135000,35000,2,00486,India
469846,2023-10-02,505,oven,18490,24000,5510,1,00486,India
206997,2023-10-02,504,iron,449,879,430,1,00033,India
206997,2023-10-02,506,monitor,3249,8000,4751,1,00033,India
206997,2023-10-02,507,washing machine,6990,16490,9500,1,00033,India
206997,2023-10-02,501,iphone 15,60000,80000,20000,2,00033,India
483748,2023-10-02,506,monitor,3249,8000,4751,1,00094,India
403816,2023-10-02,506,monitor,3249,8000,4751,1,00338,India
403816,2023-10-02,505,oven,18490,24000,5510,1,00338,India
764751,2023-10-02,505,oven,18490,24000,5510,1,00285,India
764751,2023-10-02,503,mixer,1349,3249,1900,1,00285,India
764751,2023-10-02,504,iron,449,879,430,1,00285,India
764751,2023-10-02,507,washing machine,6990,16490,9500,1,00285,India
143519,2023-10-02,507,washing machine,6990,16490,9500,1,00087,India
993637,2023-10-02,507,washing machine,6990,16490,9500,1,00332,India
857698,2023-10-02,503,mixer,1349,3249,1900,1,00051,India
857698,2023-10-02,505,oven,18490,24000,5510,1,00051,India
857698,2023-10-02,504,iron,449,879,430,1,00051,India
857698,2023-10-02,502,iphone 15 pro max,100000,135000,35000,2,00051,India
236984,2023-10-02,507,washing machine,6990,16490,9500,1,00145,India
236984,2023-10-02,501,iphone 15,60000,80000,20000,2,00145,India
236984,2023-10-02,506,monitor,3249,8000,4751,1,00145,India
236984,2023-10-02,504,iron,449,879,430,1,00145,India
938245,2023-10-02,502,iphone 15 pro max,100000,135000,35000,2,00172,India
938245,2023-10-02,506,monitor,3249,8000,4751,1,00172,India
938245,2023-10-02,503,mixer,1349,3249,1900,1,00172,India
938245,2023-10-02,501,iphone 15,60000,80000,20000,2,00172,India
970919,2023-10-02,504,iron,449,879,430,1,00463,India
970919,2023-10-02,502,iphone 15 pro max,100000,135000,35000,2,00463,India
970919,2023-10-02,501,iphone 15,60000,80000,20000,2,00463,India
187974,2023-10-02,503,mixer,1349,3249,1900,1,00280,India
187974,2023-10-02,506,monitor,3249,8000,4751,1,00280,India
187974,2023-10-02,504,iron,449,879,430,1,00280,India
147196,2023-10-02,507,washing machine,6990,16490,9500,1,00470,India
147196,2023-10-02,502,iphone 15 pro max,100000,135000,35000,2,00470,India
147196,2023-10-02,503,mixer,1349,3249,1900,1,00470,India
147196,2023-10-02,505,oven,18490,24000,5510,1,00470,India
503862,2023-10-02,504,iron,449,879,430,1,00266,India
316877,2023-10-02,503,mixer,1349,3249,1900,1,00347,India
316877,2023-10-02,504,iron,449,879,430,1,00347,India
842910,2023-10-02,501,iphone 15,60000,80000,20000,2,00155,India
842910,2023-10-02,507,washing machine,6990,16490,9500,1,00155,India
842910,2023-10-02,502,iphone 15 pro max,100000,135000,35000,2,00155,India
669969,2023-10-02,502,iphone 15 pro max,100000,135000,35000,2,00151,India
608015,2023-10-02,507,washing machine,6990,16490,9500,1,00268,India
330211,2023-10-02,503,mixer,1349,3249,1900,1,00355,India
330211,2023-10-02,505,oven,18490,24000,5510,1,00355,India
330211,2023-10-02,506,monitor,3249,8000,4751,1,00355,India
161641,2023-10-02,506,monitor,3249,8000,4751,1,00153,India
161641,2023-10-02,505,oven,18490,24000,5510,1,00153,India
161641,2023-10-02,507,washing machine,6990,16490,9500,1,00153,India
435626,2023-10-02,505,oven,18490,24000,5510,1,00195,India
435626,2023-10-02,503,mixer,1349,3249,1900,1,00195,India
435626,2023-10-02,502,iphone 15 pro max,100000,135000,35000,2,00195,India
568100,2023-10-02,502,iphone 15 pro max,100000,135000,35000,2,00433,India
568100,2023-10-02,505,oven,18490,24000,5510,1,00433,India
527275,2023-10-02,503,mixer,1349,3249,1900,1,00238,India
527275,2023-10-02,501,iphone 15,60000,80000,20000,2,00238,India
527275,2023-10-02,505,oven,18490,24000,5510,1,00238,India
491289,2023-10-02,505,oven,18490,24000,5510,1,00388,India
151029,2023-10-02,501,iphone 15,60000,80000,20000,2,00165,India
151029,2023-10-02,505,oven,18490,24000,5510,1,00165,India
151029,2023-10-02,506,monitor,3249,8000,4751,1,00165,India
969191,2023-10-02,501,iphone 15,60000,80000,20000,2,00016,India
969191,2023-10-02,507,washing machine,6990,16490,9500,1,00016,India
865146,2023-10-02,504,iron,449,879,430,1,00164,India
865146,2023-10-02,503,mixer,1349,3249,1900,1,00164,India
865146,2023-10-02,501,iphone 15,60000,80000,20000,2,00164,India
814896,2023-10-02,501,iphone 15,60000,80000,20000,2,00057,India
814896,2023-10-02,505,oven,18490,24000,5510,1,00057,India
814896,2023-10-02,503,mixer,1349,3249,1900,1,00057,India
745381,2023-10-02,506,monitor,3249,8000,4751,1,00089,India
745381,2023-10-02,507,washing machine,6990,16490,9500,1,00089,India
745381,2023-10-02,503,mixer,1349,3249,1900,1,00089,India
678978,2023-10-02,501,iphone 15,60000,80000,20000,2,00198,India
522894,2023-10-02,502,iphone 15 pro max,100000,135000,35000,2,00443,India
522894,2023-10-02,503,mixer,1349,3249,1900,1,00443,India
522894,2023-10-02,501,iphone 15,60000,80000,20000,2,00443,India
522894,2023-10-02,507,washing machine,6990,16490,9500,1,00443,India
138669,2023-10-02,503,mixer,1349,3249,1900,1,00017,India
860196,2023-10-02,504,iron,449,879,430,1,00166,India
860196,2023-10-02,507,washing machine,6990,16490,9500,1,00166,India
761457,2023-10-02,506,monitor,3249,8000,4751,1,00187,India
761457,2023-10-02,505,oven,18490,24000,5510,1,00187,India
761457,2023-10-02,503,mixer,1349,3249,1900,1,00187,India
761457,2023-10-02,502,iphone 15 pro max,100000,135000,35000,2,00187,India
139615,2023-10-02,506,monitor,3249,8000,4751,1,00402,India
139615,2023-10-02,501,iphone 15,60000,80000,20000,2,00402,India
139615,2023-10-02,503,mixer,1349,3249,1900,1,00402,India
370629,2023-10-02,503,mixer,1349,3249,1900,1,00213,India
157433,2023-10-02,506,monitor,3249,8000,4751,1,00136,India
157433,2023-10-02,507,washing machine,6990,16490,9500,1,00136,India
226767,2023-10-02,504,iron,449,879,430,1,00291,India
226767,2023-10-02,503,mixer,1349,3249,1900,1,00291,India
226767,2023-10-02,502,iphone 15 pro max,100000,135000,35000,2,00291,India
864353,2023-10-02,503,mixer,1349,3249,1900,1,00332,India
864353,2023-10-02,504,iron,449,879,430,1,00332,India
864353,2023-10-02,507,washing machine,6990,16490,9500,1,00332,India
277647,2023-10-02,503,mixer,1349,3249,1900,1,00134,India
506769,2023-10-02,502,iphone 15 pro max,100000,135000,35000,2,00024,India
506769,2023-10-02,505,oven,18490,24000,5510,1,00024,India
604242,2023-10-02,505,oven,18490,24000,5510,1,00153,India
604242,2023-10-02,506,monitor,3249,8000,4751,1,00153,India
290895,2023-10-02,507,washing machine,6990,16490,9500,1,00123,India
369044,2023-10-02,505,oven,18490,24000,5510,1,00357,India
369044,2023-10-02,504,iron,449,879,430,1,00357,India
738966,2023-10-02,503,mixer,1349,3249,1900,1,00431,India
767474,2023-10-02,505,oven,18490,24000,5510,1,00236,India
767474,2023-10-02,507,washing machine,6990,16490,9500,1,00236,India
767474,2023-10-02,504,iron,449,879,430,1,00236,India
111565,2023-10-02,507,washing machine,6990,16490,9500,1,00328,India
111565,2023-10-02,503,mixer,1349,3249,1900,1,00328,India
111565,2023-10-02,502,iphone 15 pro max,100000,135000,35000,2,00328,India
111565,2023-10-02,506,monitor,3249,8000,4751,1,00328,India
457981,2023-10-02,503,mixer,1349,3249,1900,1,00205,India
457981,2023-10-02,504,iron,449,879,430,1,00205,India
457981,2023-10-02,507,washing machine,6990,16490,9500,1,00205,India
419265,2023-10-02,503,mixer,1349,3249,1900,1,00176,India
580084,2023-10-02,505,oven,18490,24000,5510,1,00401,India
580084,2023-10-02,504,iron,449,879,430,1,00401,India
580084,2023-10-02,501,iphone 15,60000,80000,20000,2,00401,India
165878,2023-10-02,507,washing machine,6990,16490,9500,1,00135,India
165878,2023-10-02,504,iron,449,879,430,1,00135,India
165878,2023-10-02,505,oven,18490,24000,5510,1,00135,India
165878,2023-10-02,503,mixer,1349,3249,1900,1,00135,India
903224,2023-10-02,503,mixer,1349,3249,1900,1,00121,India
903224,2023-10-02,505,oven,18490,24000,5510,1,00121,India
903224,2023-10-02,507,washing machine,6990,16490,9500,1,00121,India
141517,2023-10-02,503,mixer,1349,3249,1900,1,00180,India
141517,2023-10-02,507,washing machine,6990,16490,9500,1,00180,India
973344,2023-10-03,504,iron,449,879,430,1,00201,India
973344,2023-10-03,507,washing machine,6990,16490,9500,1,00201,India
522879,2023-10-03,503,mixer,1349,3249,1900,1,00070,India
890592,2023-10-03,507,washing machine,6990,16490,9500,1,00297,India
890592,2023-10-03,502,iphone 15 pro max,100000,135000,35000,2,00297,India
815727,2023-10-03,506,monitor,3249,8000,4751,1,00077,India
815727,2023-10-03,501,iphone 15,60000,80000,20000,2,00077,India
469512,2023-10-03,503,mixer,1349,3249,1900,1,00199,India
469512,2023-10-03,504,iron,449,879,430,1,00199,India
469512,2023-10-03,502,iphone 15 pro max,100000,135000,35000,2,00199,India
232375,2023-10-03,504,iron,449,879,430,1,00088,India
489067,2023-10-03,505,oven,18490,24000,5510,1,00306,India
809959,2023-10-03,505,oven,18490,24000,5510,1,00227,India
809959,2023-10-03,501,iphone 15,60000,80000,20000,2,00227,India
412243,2023-10-03,501,iphone 15,60000,80000,20000,2,00049,India
412243,2023-10-03,504,iron,449,879,430,1,00049,India
412243,2023-10-03,506,monitor,3249,8000,4751,1,00049,India
791868,2023-10-03,506,monitor,3249,8000,4751,1,00403,India
791868,2023-10-03,505,oven,18490,24000,5510,1,00403,India
791868,2023-10-03,502,iphone 15 pro max,100000,135000,35000,2,00403,India
579634,2023-10-03,504,iron,449,879,430,1,00308,India
697047,2023-10-03,503,mixer,1349,3249,1900,1,00226,India
697047,2023-10-03,504,iron,449,879,430,1,00226,India
876406,2023-10-03,506,monitor,3249,8000,4751,1,00241,India
876406,2023-10-03,503,mixer,1349,3249,1900,1,00241,India
876406,2023-10-03,502,iphone 15 pro max,100000,135000,35000,2,00241,India
921799,2023-10-03,506,monitor,3249,8000,4751,1,00450,India
921799,2023-10-03,501,iphone 15,60000,80000,20000,2,00450,India
921799,2023-10-03,504,iron,449,879,430,1,00450,India
921799,2023-10-03,502,iphone 15 pro max,100000,135000,35000,2,00450,India
746150,2023-10-03,504,iron,449,879,430,1,00250,India
746150,2023-10-03,502,iphone 15 pro max,100000,135000,35000,2,00250,India
746150,2023-10-03,506,monitor,3249,8000,4751,1,00250,India
746150,2023-10-03,501,iphone 15,60000,80000,20000,2,00250,India
746150,2023-10-03,503,mixer,1349,3249,1900,1,00250,India
206526,2023-10-03,502,iphone 15 pro max,100000,135000,35000,2,00279,India
206526,2023-10-03,506,monitor,3249,8000,4751,1,00279,India
206526,2023-10-03,505,oven,18490,24000,5510,1,00279,India
132353,2023-10-03,507,washing machine,6990,16490,9500,1,00241,India
132353,2023-10-03,503,mixer,1349,3249,1900,1,00241,India
829927,2023-10-03,501,iphone 15,60000,80000,20000,2,00392,India
829927,2023-10-03,505,oven,18490,24000,5510,1,00392,India
829927,2023-10-03,504,iron,449,879,430,1,00392,India
638047,2023-10-03,506,monitor,3249,8000,4751,1,00356,India
638047,2023-10-03,505,oven,18490,24000,5510,1,00356,India
638047,2023-10-03,501,iphone 15,60000,80000,20000,2,00356,India
941856,2023-10-03,507,washing machine,6990,16490,9500,1,00354,India
941856,2023-10-03,502,iphone 15 pro max,100000,135000,35000,2,00354,India
326205,2023-10-03,507,washing machine,6990,16490,9500,1,00048,India
326205,2023-10-03,504,iron,449,879,430,1,00048,India
213150,2023-10-03,504,iron,449,879,430,1,00057,India
213150,2023-10-03,502,iphone 15 pro max,100000,135000,35000,2,00057,India
213150,2023-10-03,506,monitor,3249,8000,4751,1,00057,India
213150,2023-10-03,505,oven,18490,24000,5510,1,00057,India
299027,2023-10-03,501,iphone 15,60000,80000,20000,2,00394,India
299027,2023-10-03,507,washing machine,6990,16490,9500,1,00394,India
299027,2023-10-03,506,monitor,3249,8000,4751,1,00394,India
392982,2023-10-03,502,iphone 15 pro max,100000,135000,35000,2,00046,India
918863,2023-10-03,507,washing machine,6990,16490,9500,1,00283,India
918863,2023-10-03,506,monitor,3249,8000,4751,1,00283,India
110386,2023-10-03,507,washing machine,6990,16490,9500,1,00259,India
635107,2023-10-03,507,washing machine,6990,16490,9500,1,00004,India
635107,2023-10-03,506,monitor,3249,8000,4751,1,00004,India
635107,2023-10-03,504,iron,449,879,430,1,00004,India
112615,2023-10-03,502,iphone 15 pro max,100000,135000,35000,2,00445,India
112615,2023-10-03,505,oven,18490,24000,5510,1,00445,India
699093,2023-10-03,502,iphone 15 pro max,100000,135000,35000,2,00488,India
699093,2023-10-03,507,washing machine,6990,16490,9500,1,00488,India
699093,2023-10-03,503,mixer,1349,3249,1900,1,00488,India
699093,2023-10-03,501,iphone 15,60000,80000,20000,2,00488,India
416351,2023-10-03,502,iphone 15 pro max,100000,135000,35000,2,00369,India
166357,2023-10-03,503,mixer,1349,3249,1900,1,00059,India
166357,2023-10-03,506,monitor,3249,8000,4751,1,00059,India
748277,2023-10-03,504,iron,449,879,430,1,00428,India
748277,2023-10-03,507,washing machine,6990,16490,9500,1,00428,India
748277,2023-10-03,506,monitor,3249,8000,4751,1,00428,India
227647,2023-10-03,506,monitor,3249,8000,4751,1,00191,India
824213,2023-10-03,507,washing machine,6990,16490,9500,1,00096,India
824213,2023-10-03,502,iphone 15 pro max,100000,135000,35000,2,00096,India
429642,2023-10-03,502,iphone 15 pro max,100000,135000,35000,2,00295,India
520444,2023-10-03,506,monitor,3249,8000,4751,1,00180,India
520444,2023-10-03,503,mixer,1349,3249,1900,1,00180,India
395939,2023-10-03,506,monitor,3249,8000,4751,1,00344,India
395939,2023-10-03,502,iphone 15 pro max,100000,135000,35000,2,00344,India
395939,2023-10-03,505,oven,18490,24000,5510,1,00344,India
395939,2023-10-03,501,iphone 15,60000,80000,20000,2,00344,India
877542,2023-10-03,501,iphone 15,60000,80000,20000,2,00030,India
877542,2023-10-03,503,mixer,1349,3249,1900,1,00030,India
877542,2023-10-03,502,iphone 15 pro max,100000,135000,35000,2,00030,India
457581,2023-10-03,501,iphone 15,60000,80000,20000,2,00479,India
457581,2023-10-03,503,mixer,1349,3249,1900,1,00479,India
457581,2023-10-03,507,washing machine,6990,16490,9500,1,00479,India
666120,2023-10-03,504,iron,449,879,430,1,00106,India
666120,2023-10-03,503,mixer,1349,3249,1900,1,00106,India
666120,2023-10-03,506,monitor,3249,8000,4751,1,00106,India
666120,2023-10-03,505,oven,18490,24000,5510,1,00106,India
666120,2023-10-03,507,washing machine,6990,16490,9500,1,00106,India
126029,2023-10-03,505,oven,18490,24000,5510,1,00497,India
126029,2023-10-03,501,iphone 15,60000,80000,20000,2,00497,India
729995,2023-10-03,504,iron,449,879,430,1,00408,India
729995,2023-10-03,503,mixer,1349,3249,1900,1,00408,India
950125,2023-10-03,501,iphone 15,60000,80000,20000,2,00363,India
950125,2023-10-03,504,iron,449,879,430,1,00363,India
950125,2023-10-03,507,washing machine,6990,16490,9500,1,00363,India
950125,2023-10-03,505,oven,18490,24000,5510,1,00363,India
272496,2023-10-03,506,monitor,3249,8000,4751,1,00130,India
272496,2023-10-03,503,mixer,1349,3249,1900,1,00130,India
272496,2023-10-03,505,oven,18490,24000,5510,1,00130,India
585293,2023-10-03,501,iphone 15,60000,80000,20000,2,00161,India
585293,2023-10-03,502,iphone 15 pro max,100000,135000,35000,2,00161,India
585293,2023-10-03,505,oven,18490,24000,5510,1,00161,India
585293,2023-10-03,504,iron,449,879,430,1,00161,India
439300,2023-10-03,504,iron,449,879,430,1,00284,India
439300,2023-10-03,503,mixer,1349,3249,1900,1,00284,India
439300,2023-10-03,501,iphone 15,60000,80000,20000,2,00284,India
439300,2023-10-03,505,oven,18490,24000,5510,1,00284,India
878115,2023-10-03,505,oven,18490,24000,5510,1,00295,India
878115,2023-10-03,504,iron,449,879,430,1,00295,India
878115,2023-10-03,501,iphone 15,60000,80000,20000,2,00295,India
878115,2023-10-03,503,mixer,1349,3249,1900,1,00295,India
611984,2023-10-03,505,oven,18490,24000,5510,1,00216,India
611984,2023-10-03,502,iphone 15 pro max,100000,135000,35000,2,00216,India
611984,2023-10-03,503,mixer,1349,3249,1900,1,00216,India
611984,2023-10-03,501,iphone 15,60000,80000,20000,2,00216,India
743770,2023-10-03,501,iphone 15,60000,80000,20000,2,00468,India
743770,2023-10-03,507,washing machine,6990,16490,9500,1,00468,India
107103,2023-10-03,501,iphone 15,60000,80000,20000,2,00156,India
321118,2023-10-03,504,iron,449,879,430,1,00434,India
453569,2023-10-03,501,iphone 15,60000,80000,20000,2,00222,India
264691,2023-10-03,504,iron,449,879,430,1,00217,India
786639,2023-10-03,505,oven,18490,24000,5510,1,00145,India
786639,2023-10-03,502,iphone 15 pro max,100000,135000,35000,2,00145,India
786639,2023-10-03,503,mixer,1349,3249,1900,1,00145,India
786639,2023-10-03,507,washing machine,6990,16490,9500,1,00145,India
122045,2023-10-03,503,mixer,1349,3249,1900,1,00277,India
122045,2023-10-03,501,iphone 15,60000,80000,20000,2,00277,India
122045,2023-10-03,502,iphone 15 pro max,100000,135000,35000,2,00277,India
122045,2023-10-03,506,monitor,3249,8000,4751,1,00277,India
503159,2023-10-03,503,mixer,1349,3249,1900,1,00089,India
503159,2023-10-03,507,washing machine,6990,16490,9500,1,00089,India
503159,2023-10-03,501,iphone 15,60000,80000,20000,2,00089,India
503159,2023-10-03,504,iron,449,879,430,1,00089,India
564572,2023-10-03,502,iphone 15 pro max,100000,135000,35000,2,00101,India
564572,2023-10-03,501,iphone 15,60000,80000,20000,2,00101,India
661421,2023-10-03,503,mixer,1349,3249,1900,1,00115,India
661421,2023-10-03,504,iron,449,879,430,1,00115,India
221431,2023-10-03,504,iron,449,879,430,1,00401,India
221431,2023-10-03,506,monitor,3249,8000,4751,1,00401,India
221431,2023-10-03,501,iphone 15,60000,80000,20000,2,00401,India
221431,2023-10-03,507,washing machine,6990,16490,9500,1,00401,India
883988,2023-10-04,502,iphone 15 pro max,100000,135000,35000,2,00189,India
883988,2023-10-04,506,monitor,3249,8000,4751,1,00189,India
883988,2023-10-04,507,washing machine,6990,16490,9500,1,00189,India
883988,2023-10-04,501,iphone 15,60000,80000,20000,2,00189,India
814636,2023-10-04,501,iphone 15,60000,80000,20000,2,00134,India
814636,2023-10-04,502,iphone 15 pro max,100000,135000,35000,2,00134,India
814636,2023-10-04,506,monitor,3249,8000,4751,1,00134,India
879069,2023-10-04,505,oven,18490,24000,5510,1,00402,India
879069,2023-10-04,506,monitor,3249,8000,4751,1,00402,India
879069,2023-10-04,502,iphone 15 pro max,100000,135000,35000,2,00402,India
228311,2023-10-04,503,mixer,1349,3249,1900,1,00096,India
228311,2023-10-04,506,monitor,3249,8000,4751,1,00096,India
228311,2023-10-04,504,iron,449,879,430,1,00096,India
234527,2023-10-04,506,monitor,3249,8000,4751,1,00066,India
234527,2023-10-04,505,oven,18490,24000,5510,1,00066,India
234527,2023-10-04,507,washing machine,6990,16490,9500,1,00066,India
603920,2023-10-04,506,monitor,3249,8000,4751,1,00158,India
603920,2023-10-04,505,oven,18490,24000,5510,1,00158,India
603920,2023-10-04,501,iphone 15,60000,80000,20000,2,00158,India
926528,2023-10-04,501,iphone 15,60000,80000,20000,2,00349,India
926528,2023-10-04,506,monitor,3249,8000,4751,1,00349,India
926528,2023-10-04,503,mixer,1349,3249,1900,1,00349,India
926528,2023-10-04,502,iphone 15 pro max,100000,135000,35000,2,00349,India
353000,2023-10-04,503,mixer,1349,3249,1900,1,00163,India
353000,2023-10-04,507,washing machine,6990,16490,9500,1,00163,India
127105,2023-10-04,504,iron,449,879,430,1,00106,India
127105,2023-10-04,505,oven,18490,24000,5510,1,00106,India
127105,2023-10-04,506,monitor,3249,8000,4751,1,00106,India
722505,2023-10-04,507,washing machine,6990,16490,9500,1,00328,India
950115,2023-10-04,502,iphone 15 pro max,100000,135000,35000,2,00118,India
950115,2023-10-04,507,washing machine,6990,16490,9500,1,00118,India
950115,2023-10-04,503,mixer,1349,3249,1900,1,00118,India
407453,2023-10-04,506,monitor,3249,8000,4751,1,00489,India
407453,2023-10-04,501,iphone 15,60000,80000,20000,2,00489,India
847281,2023-10-04,501,iphone 15,60000,80000,20000,2,00423,India
847281,2023-10-04,504,iron,449,879,430,1,00423,India
847281,2023-10-04,506,monitor,3249,8000,4751,1,00423,India
859841,2023-10-04,503,mixer,1349,3249,1900,1,00215,India
221070,2023-10-04,503,mixer,1349,3249,1900,1,00359,India
221070,2023-10-04,505,oven,18490,24000,5510,1,00359,India
221070,2023-10-04,506,monitor,3249,8000,4751,1,00359,India
221070,2023-10-04,504,iron,449,879,430,1,00359,India
427879,2023-10-04,505,oven,18490,24000,5510,1,00083,India
427879,2023-10-04,501,iphone 15,60000,80000,20000,2,00083,India
427879,2023-10-04,506,monitor,3249,8000,4751,1,00083,India
830572,2023-10-04,502,iphone 15 pro max,100000,135000,35000,2,00272,India
827754,2023-10-04,503,mixer,1349,3249,1900,1,00108,India
827754,2023-10-04,506,monitor,3249,8000,4751,1,00108,India
827754,2023-10-04,507,washing machine,6990,16490,9500,1,00108,India
755221,2023-10-04,501,iphone 15,60000,80000,20000,2,00035,India
755221,2023-10-04,505,oven,18490,24000,5510,1,00035,India
755221,2023-10-04,502,iphone 15 pro max,100000,135000,35000,2,00035,India
752884,2023-10-04,504,iron,449,879,430,1,00300,India
752884,2023-10-04,506,monitor,3249,8000,4751,1,00300,India
752884,2023-10-04,507,washing machine,6990,16490,9500,1,00300,India
588196,2023-10-04,505,oven,18490,24000,5510,1,00139,India
588196,2023-10-04,503,mixer,1349,3249,1900,1,00139,India
588196,2023-10-04,504,iron,449,879,430,1,00139,India
588196,2023-10-04,502,iphone 15 pro max,100000,135000,35000,2,00139,India
588196,2023-10-04,507,washing machine,6990,16490,9500,1,00139,India
705418,2023-10-04,503,mixer,1349,3249,1900,1,00042,India
705418,2023-10-04,506,monitor,3249,8000,4751,1,00042,India
705418,2023-10-04,504,iron,449,879,430,1,00042,India
705418,2023-10-04,507,washing machine,6990,16490,9500,1,00042,India
705418,2023-10-04,502,iphone 15 pro max,100000,135000,35000,2,00042,India
265420,2023-10-04,505,oven,18490,24000,5510,1,00174,India
265420,2023-10-04,503,mixer,1349,3249,1900,1,00174,India
265420,2023-10-04,507,washing machine,6990,16490,9500,1,00174,India
817647,2023-10-04,506,monitor,3249,8000,4751,1,00305,India
817647,2023-10-04,507,washing machine,6990,16490,9500,1,00305,India
817647,2023-10-04,501,iphone 15,60000,80000,20000,2,00305,India
866365,2023-10-04,504,iron,449,879,430,1,00130,India
866365,2023-10-04,501,iphone 15,60000,80000,20000,2,00130,India
563129,2023-10-04,501,iphone 15,60000,80000,20000,2,00052,India
563129,2023-10-04,506,monitor,3249,8000,4751,1,00052,India
563129,2023-10-04,505,oven,18490,24000,5510,1,00052,India
563129,2023-10-04,504,iron,449,879,430,1,00052,India
200722,2023-10-04,502,iphone 15 pro max,100000,135000,35000,2,00458,India
217115,2023-10-04,502,iphone 15 pro max,100000,135000,35000,2,00350,India
217115,2023-10-04,503,mixer,1349,3249,1900,1,00350,India
217115,2023-10-04,506,monitor,3249,8000,4751,1,00350,India
409006,2023-10-04,503,mixer,1349,3249,1900,1,00061,India
409006,2023-10-04,501,iphone 15,60000,80000,20000,2,00061,India
693891,2023-10-04,506,monitor,3249,8000,4751,1,00452,India
693891,2023-10-04,507,washing machine,6990,16490,9500,1,00452,India
211411,2023-10-04,504,iron,449,879,430,1,00487,India
767753,2023-10-04,502,iphone 15 pro max,100000,135000,35000,2,00168,India
791419,2023-10-04,505,oven,18490,24000,5510,1,00042,India
791419,2023-10-04,504,iron,449,879,430,1,00042,India
791419,2023-10-04,501,iphone 15,60000,80000,20000,2,00042,India
983523,2023-10-04,501,iphone 15,60000,80000,20000,2,00352,India
983523,2023-10-04,506,monitor,3249,8000,4751,1,00352,India
243063,2023-10-04,504,iron,449,879,430,1,00313,India
243063,2023-10-04,501,iphone 15,60000,80000,20000,2,00313,India
243063,2023-10-04,505,oven,18490,24000,5510,1,00313,India
243063,2023-10-04,502,iphone 15 pro max,100000,135000,35000,2,00313,India
253248,2023-10-04,503,mixer,1349,3249,1900,1,00003,India
253248,2023-10-04,506,monitor,3249,8000,4751,1,00003,India
253248,2023-10-04,501,iphone 15,60000,80000,20000,2,00003,India
991817,2023-10-04,504,iron,449,879,430,1,00468,India
991817,2023-10-04,501,iphone 15,60000,80000,20000,2,00468,India
493424,2023-10-04,505,oven,18490,24000,5510,1,00150,India
493424,2023-10-04,501,iphone 15,60000,80000,20000,2,00150,India
493424,2023-10-04,507,washing machine,6990,16490,9500,1,00150,India
438141,2023-10-04,503,mixer,1349,3249,1900,1,00203,India
794990,2023-10-04,503,mixer,1349,3249,1900,1,00276,India
483923,2023-10-04,502,iphone 15 pro max,100000,135000,35000,2,00283,India
483923,2023-10-04,507,washing machine,6990,16490,9500,1,00283,India
493471,2023-10-04,506,monitor,3249,8000,4751,1,00075,India
493471,2023-10-04,507,washing machine,6990,16490,9500,1,00075,India
493471,2023-10-04,504,iron,449,879,430,1,00075,India
217660,2023-10-04,502,iphone 15 pro max,100000,135000,35000,2,00401,India
217660,2023-10-04,505,oven,18490,24000,5510,1,00401,India
217660,2023-10-04,503,mixer,1349,3249,1900,1,00401,India
785758,2023-10-04,507,washing machine,6990,16490,9500,1,00116,India
785758,2023-10-04,502,iphone 15 pro max,100000,135000,35000,2,00116,India
785758,2023-10-04,501,iphone 15,60000,80000,20000,2,00116,India
242113,2023-10-04,507,washing machine,6990,16490,9500,1,00182,India
242113,2023-10-04,501,iphone 15,60000,80000,20000,2,00182,India
242113,2023-10-04,502,iphone 15 pro max,100000,135000,35000,2,00182,India
201206,2023-10-04,502,iphone 15 pro max,100000,135000,35000,2,00249,India
201206,2023-10-04,501,iphone 15,60000,80000,20000,2,00249,India
201206,2023-10-04,504,iron,449,879,430,1,00249,India
201206,2023-10-04,505,oven,18490,24000,5510,1,00249,India
404728,2023-10-04,507,washing machine,6990,16490,9500,1,00396,India
404728,2023-10-04,505,oven,18490,24000,5510,1,00396,India
103964,2023-10-04,502,iphone 15 pro max,100000,135000,35000,2,00216,India
103964,2023-10-04,503,mixer,1349,3249,1900,1,00216,India
278583,2023-10-04,502,iphone 15 pro max,100000,135000,35000,2,00009,India
278583,2023-10-04,505,oven,18490,24000,5510,1,00009,India
278583,2023-10-04,503,mixer,1349,3249,1900,1,00009,India
963566,2023-10-04,506,monitor,3249,8000,4751,1,00346,India
963566,2023-10-04,503,mixer,1349,3249,1900,1,00346,India
963566,2023-10-04,505,oven,18490,24000,5510,1,00346,India
963566,2023-10-04,502,iphone 15 pro max,100000,135000,35000,2,00346,India
345194,2023-10-04,502,iphone 15 pro max,100000,135000,35000,2,00284,India
345194,2023-10-04,504,iron,449,879,430,1,00284,India
265923,2023-10-04,504,iron,449,879,430,1,00469,India
850291,2023-10-04,507,washing machine,6990,16490,9500,1,00446,India
713810,2023-10-04,506,monitor,3249,8000,4751,1,00259,India
713810,2023-10-04,505,oven,18490,24000,5510,1,00259,India
713810,2023-10-04,503,mixer,1349,3249,1900,1,00259,India
713810,2023-10-04,502,iphone 15 pro max,100000,135000,35000,2,00259,India
637695,2023-10-04,503,mixer,1349,3249,1900,1,00017,India
859375,2023-10-04,503,mixer,1349,3249,1900,1,00251,India
859375,2023-10-04,501,iphone 15,60000,80000,20000,2,00251,India
859375,2023-10-04,506,monitor,3249,8000,4751,1,00251,India
302909,2023-10-04,503,mixer,1349,3249,1900,1,00151,India
302909,2023-10-04,506,monitor,3249,8000,4751,1,00151,India
742066,2023-10-04,501,iphone 15,60000,80000,20000,2,00172,India
155495,2023-10-04,504,iron,449,879,430,1,00290,India
155495,2023-10-04,503,mixer,1349,3249,1900,1,00290,India
474688,2023-10-04,507,washing machine,6990,16490,9500,1,00364,India
386563,2023-10-04,507,washing machine,6990,16490,9500,1,00074,India
386563,2023-10-04,503,mixer,1349,3249,1900,1,00074,India
386563,2023-10-04,504,iron,449,879,430,1,00074,India
386563,2023-10-04,501,iphone 15,60000,80000,20000,2,00074,India
913557,2023-10-04,501,iphone 15,60000,80000,20000,2,00135,India
913557,2023-10-04,503,mixer,1349,3249,1900,1,00135,India
913557,2023-10-04,505,oven,18490,24000,5510,1,00135,India
986483,2023-10-04,503,mixer,1349,3249,1900,1,00392,India
986483,2023-10-04,507,washing machine,6990,16490,9500,1,00392,India
986483,2023-10-04,504,iron,449,879,430,1,00392,India
508850,2023-10-05,501,iphone 15,60000,80000,20000,2,00152,India
508850,2023-10-05,507,washing machine,6990,16490,9500,1,00152,India
508850,2023-10-05,505,oven,18490,24000,5510,1,00152,India
803184,2023-10-05,506,monitor,3249,8000,4751,1,00427,India
803184,2023-10-05,504,iron,449,879,430,1,00427,India
428960,2023-10-05,502,iphone 15 pro max,100000,135000,35000,2,00293,India
966120,2023-10-05,503,mixer,1349,3249,1900,1,00305,India
966120,2023-10-05,505,oven,18490,24000,5510,1,00305,India
966120,2023-10-05,507,washing machine,6990,16490,9500,1,00305,India
970060,2023-10-05,506,monitor,3249,8000,4751,1,00025,India
970060,2023-10-05,503,mixer,1349,3249,1900,1,00025,India
970060,2023-10-05,507,washing machine,6990,16490,9500,1,00025,India
363564,2023-10-05,507,washing machine,6990,16490,9500,1,00390,India
363564,2023-10-05,506,monitor,3249,8000,4751,1,00390,India
365858,2023-10-05,502,iphone 15 pro max,100000,135000,35000,2,00111,India
365858,2023-10-05,501,iphone 15,60000,80000,20000,2,00111,India
337045,2023-10-05,503,mixer,1349,3249,1900,1,00473,India
337045,2023-10-05,504,iron,449,879,430,1,00473,India
337045,2023-10-05,502,iphone 15 pro max,100000,135000,35000,2,00473,India
107385,2023-10-05,501,iphone 15,60000,80000,20000,2,00107,India
107385,2023-10-05,506,monitor,3249,8000,4751,1,00107,India
107385,2023-10-05,507,washing machine,6990,16490,9500,1,00107,India
485700,2023-10-05,504,iron,449,879,430,1,00444,India
485700,2023-10-05,507,washing machine,6990,16490,9500,1,00444,India
485700,2023-10-05,503,mixer,1349,3249,1900,1,00444,India
303554,2023-10-05,502,iphone 15 pro max,100000,135000,35000,2,00195,India
358127,2023-10-05,501,iphone 15,60000,80000,20000,2,00079,India
175418,2023-10-05,506,monitor,3249,8000,4751,1,00440,India
628354,2023-10-05,503,mixer,1349,3249,1900,1,00464,India
628354,2023-10-05,507,washing machine,6990,16490,9500,1,00464,India
628354,2023-10-05,504,iron,449,879,430,1,00464,India
628354,2023-10-05,505,oven,18490,24000,5510,1,00464,India
107989,2023-10-05,507,washing machine,6990,16490,9500,1,00046,India
107989,2023-10-05,505,oven,18490,24000,5510,1,00046,India
107989,2023-10-05,502,iphone 15 pro max,100000,135000,35000,2,00046,India
251156,2023-10-05,501,iphone 15,60000,80000,20000,2,00397,India
251156,2023-10-05,505,oven,18490,24000,5510,1,00397,India
849067,2023-10-05,502,iphone 15 pro max,100000,135000,35000,2,00135,India
849067,2023-10-05,501,iphone 15,60000,80000,20000,2,00135,India
849067,2023-10-05,505,oven,18490,24000,5510,1,00135,India
849067,2023-10-05,507,washing machine,6990,16490,9500,1,00135,India
554514,2023-10-05,505,oven,18490,24000,5510,1,00023,India
554514,2023-10-05,503,mixer,1349,3249,1900,1,00023,India
550205,2023-10-05,507,washing machine,6990,16490,9500,1,00240,India
550205,2023-10-05,501,iphone 15,60000,80000,20000,2,00240,India
426308,2023-10-05,501,iphone 15,60000,80000,20000,2,00162,India
426308,2023-10-05,504,iron,449,879,430,1,00162,India
426308,2023-10-05,503,mixer,1349,3249,1900,1,00162,India
987505,2023-10-05,503,mixer,1349,3249,1900,1,00265,India
987505,2023-10-05,506,monitor,3249,8000,4751,1,00265,India
987505,2023-10-05,504,iron,449,879,430,1,00265,India
987505,2023-10-05,502,iphone 15 pro max,100000,135000,35000,2,00265,India
956410,2023-10-05,505,oven,18490,24000,5510,1,00208,India
956410,2023-10-05,501,iphone 15,60000,80000,20000,2,00208,India
626264,2023-10-05,501,iphone 15,60000,80000,20000,2,00359,India
422285,2023-10-05,505,oven,18490,24000,5510,1,00108,India
422285,2023-10-05,503,mixer,1349,3249,1900,1,00108,India
652960,2023-10-05,503,mixer,1349,3249,1900,1,00309,India
345330,2023-10-05,507,washing machine,6990,16490,9500,1,00408,India
345330,2023-10-05,502,iphone 15 pro max,100000,135000,35000,2,00408,India
345330,2023-10-05,505,oven,18490,24000,5510,1,00408,India
583539,2023-10-05,505,oven,18490,24000,5510,1,00060,India
583539,2023-10-05,504,iron,449,879,430,1,00060,India
583539,2023-10-05,501,iphone 15,60000,80000,20000,2,00060,India
304431,2023-10-05,507,washing machine,6990,16490,9500,1,00235,India
304431,2023-10-05,502,iphone 15 pro max,100000,135000,35000,2,00235,India
901237,2023-10-05,501,iphone 15,60000,80000,20000,2,00010,India
124827,2023-10-05,507,washing machine,6990,16490,9500,1,00220,India
124827,2023-10-05,501,iphone 15,60000,80000,20000,2,00220,India
124827,2023-10-05,504,iron,449,879,430,1,00220,India
124827,2023-10-05,505,oven,18490,24000,5510,1,00220,India
293872,2023-10-05,503,mixer,1349,3249,1900,1,00078,India
293872,2023-10-05,504,iron,449,879,430,1,00078,India
293872,2023-10-05,505,oven,18490,24000,5510,1,00078,India
293872,2023-10-05,506,monitor,3249,8000,4751,1,00078,India
856800,2023-10-05,501,iphone 15,60000,80000,20000,2,00374,India
108918,2023-10-05,501,iphone 15,60000,80000,20000,2,00095,India
108918,2023-10-05,503,mixer,1349,3249,1900,1,00095,India
108918,2023-10-05,502,iphone 15 pro max,100000,135000,35000,2,00095,India
971121,2023-10-05,507,washing machine,6990,16490,9500,1,00152,India
111937,2023-10-05,502,iphone 15 pro max,100000,135000,35000,2,00159,India
111937,2023-10-05,505,oven,18490,24000,5510,1,00159,India
111937,2023-10-05,504,iron,449,879,430,1,00159,India
894079,2023-10-05,503,mixer,1349,3249,1900,1,00051,India
894079,2023-10-05,502,iphone 15 pro max,100000,135000,35000,2,00051,India
894079,2023-10-05,501,iphone 15,60000,80000,20000,2,00051,India
833886,2023-10-05,502,iphone 15 pro max,100000,135000,35000,2,00209,India
833886,2023-10-05,504,iron,449,879,430,1,00209,India
833886,2023-10-05,507,washing machine,6990,16490,9500,1,00209,India
833886,2023-10-05,505,oven,18490,24000,5510,1,00209,India
467639,2023-10-05,502,iphone 15 pro max,100000,135000,35000,2,00349,India
467639,2023-10-05,506,monitor,3249,8000,4751,1,00349,India
467639,2023-10-05,505,oven,18490,24000,5510,1,00349,India
650125,2023-10-05,501,iphone 15,60000,80000,20000,2,00128,India
650125,2023-10-05,505,oven,18490,24000,5510,1,00128,India
650125,2023-10-05,504,iron,449,879,430,1,00128,India
650125,2023-10-05,503,mixer,1349,3249,1900,1,00128,India
457649,2023-10-05,503,mixer,1349,3249,1900,1,00029,India
457649,2023-10-05,501,iphone 15,60000,80000,20000,2,00029,India
151078,2023-10-05,505,oven,18490,24000,5510,1,00330,India
364776,2023-10-05,506,monitor,3249,8000,4751,1,00315,India
818195,2023-10-05,502,iphone 15 pro max,100000,135000,35000,2,00111,India
818195,2023-10-05,501,iphone 15,60000,80000,20000,2,00111,India
818195,2023-10-05,504,iron,449,879,430,1,00111,India
114217,2023-10-05,502,iphone 15 pro max,100000,135000,35000,2,00268,India
149653,2023-10-05,501,iphone 15,60000,80000,20000,2,00364,India
149653,2023-10-05,506,monitor,3249,8000,4751,1,00364,India
149653,2023-10-05,507,washing machine,6990,16490,9500,1,00364,India
166154,2023-10-05,504,iron,449,879,430,1,00252,India
166154,2023-10-05,506,monitor,3249,8000,4751,1,00252,India
166154,2023-10-05,503,mixer,1349,3249,1900,1,00252,India
851746,2023-10-05,506,monitor,3249,8000,4751,1,00496,India
420415,2023-10-05,505,oven,18490,24000,5510,1,00438,India
420415,2023-10-05,506,monitor,3249,8000,4751,1,00438,India
420415,2023-10-05,504,iron,449,879,430,1,00438,India
188392,2023-10-05,503,mixer,1349,3249,1900,1,00107,India
725853,2023-10-05,505,oven,18490,24000,5510,1,00207,India
725853,2023-10-05,503,mixer,1349,3249,1900,1,00207,India
725853,2023-10-05,506,monitor,3249,8000,4751,1,00207,India
833913,2023-10-05,503,mixer,1349,3249,1900,1,00393,India
833913,2023-10-05,502,iphone 15 pro max,100000,135000,35000,2,00393,India
833913,2023-10-05,505,oven,18490,24000,5510,1,00393,India
888311,2023-10-05,503,mixer,1349,3249,1900,1,00112,India
888311,2023-10-05,504,iron,449,879,430,1,00112,India
888311,2023-10-05,507,washing machine,6990,16490,9500,1,00112,India
273720,2023-10-05,507,washing machine,6990,16490,9500,1,00310,India
684594,2023-10-06,504,iron,449,879,430,1,00483,India
544641,2023-10-06,504,iron,449,879,430,1,00258,India
544641,2023-10-06,507,washing machine,6990,16490,9500,1,00258,India
544641,2023-10-06,505,oven,18490,24000,5510,1,00258,India
544641,2023-10-06,506,monitor,3249,8000,4751,1,00258,India
591221,2023-10-06,502,iphone 15 pro max,100000,135000,35000,2,00083,India
204250,2023-10-06,505,oven,18490,24000,5510,1,00170,India
204250,2023-10-06,506,monitor,3249,8000,4751,1,00170,India
204250,2023-10-06,507,washing machine,6990,16490,9500,1,00170,India
969944,2023-10-06,503,mixer,1349,3249,1900,1,00148,India
663492,2023-10-06,504,iron,449,879,430,1,00025,India
663492,2023-10-06,503,mixer,1349,3249,1900,1,00025,India
663492,2023-10-06,502,iphone 15 pro max,100000,135000,35000,2,00025,India
663492,2023-10-06,506,monitor,3249,8000,4751,1,00025,India
125637,2023-10-06,501,iphone 15,60000,80000,20000,2,00145,India
125637,2023-10-06,505,oven,18490,24000,5510,1,00145,India
125637,2023-10-06,507,washing machine,6990,16490,9500,1,00145,India
424581,2023-10-06,507,washing machine,6990,16490,9500,1,00015,India
424581,2023-10-06,502,iphone 15 pro max,100000,135000,35000,2,00015,India
424581,2023-10-06,501,iphone 15,60000,80000,20000,2,00015,India
424581,2023-10-06,503,mixer,1349,3249,1900,1,00015,India
900740,2023-10-06,506,monitor,3249,8000,4751,1,00320,India
900740,2023-10-06,505,oven,18490,24000,5510,1,00320,India
415708,2023-10-06,505,oven,18490,24000,5510,1,00222,India
415708,2023-10-06,503,mixer,1349,3249,1900,1,00222,India
583264,2023-10-06,502,iphone 15 pro max,100000,135000,35000,2,00082,India
943197,2023-10-06,507,washing machine,6990,16490,9500,1,00190,India
754127,2023-10-06,502,iphone 15 pro max,100000,135000,35000,2,00178,India
754127,2023-10-06,504,iron,449,879,430,1,00178,India
754127,2023-10-06,506,monitor,3249,8000,4751,1,00178,India
736335,2023-10-06,504,iron,449,879,430,1,00485,India
736335,2023-10-06,506,monitor,3249,8000,4751,1,00485,India
736335,2023-10-06,502,iphone 15 pro max,100000,135000,35000,2,00485,India
736335,2023-10-06,503,mixer,1349,3249,1900,1,00485,India
869219,2023-10-06,507,washing machine,6990,16490,9500,1,00103,India
869219,2023-10-06,502,iphone 15 pro max,100000,135000,35000,2,00103,India
869219,2023-10-06,504,iron,449,879,430,1,00103,India
869219,2023-10-06,501,iphone 15,60000,80000,20000,2,00103,India
868843,2023-10-06,504,iron,449,879,430,1,00285,India
868843,2023-10-06,502,iphone 15 pro max,100000,135000,35000,2,00285,India
868843,2023-10-06,503,mixer,1349,3249,1900,1,00285,India
868843,2023-10-06,501,iphone 15,60000,80000,20000,2,00285,India
868843,2023-10-06,505,oven,18490,24000,5510,1,00285,India
769687,2023-10-06,506,monitor,3249,8000,4751,1,00228,India
769687,2023-10-06,505,oven,18490,24000,5510,1,00228,India
769687,2023-10-06,504,iron,449,879,430,1,00228,India
814440,2023-10-06,507,washing machine,6990,16490,9500,1,00052,India
814440,2023-10-06,502,iphone 15 pro max,100000,135000,35000,2,00052,India
814440,2023-10-06,504,iron,449,879,430,1,00052,India
814440,2023-10-06,501,iphone 15,60000,80000,20000,2,00052,India
511796,2023-10-06,502,iphone 15 pro max,100000,135000,35000,2,00103,India
511796,2023-10-06,507,washing machine,6990,16490,9500,1,00103,India
511796,2023-10-06,506,monitor,3249,8000,4751,1,00103,India
511796,2023-10-06,505,oven,18490,24000,5510,1,00103,India
998018,2023-10-06,507,washing machine,6990,16490,9500,1,00313,India
998018,2023-10-06,502,iphone 15 pro max,100000,135000,35000,2,00313,India
998018,2023-10-06,503,mixer,1349,3249,1900,1,00313,India
526362,2023-10-06,507,washing machine,6990,16490,9500,1,00369,India
526362,2023-10-06,502,iphone 15 pro max,100000,135000,35000,2,00369,India
526362,2023-10-06,505,oven,18490,24000,5510,1,00369,India
526362,2023-10-06,501,iphone 15,60000,80000,20000,2,00369,India
932039,2023-10-06,501,iphone 15,60000,80000,20000,2,00344,India
932039,2023-10-06,504,iron,449,879,430,1,00344,India
932039,2023-10-06,505,oven,18490,24000,5510,1,00344,India
932039,2023-10-06,503,mixer,1349,3249,1900,1,00344,India
564339,2023-10-06,506,monitor,3249,8000,4751,1,00274,India
564339,2023-10-06,502,iphone 15 pro max,100000,135000,35000,2,00274,India
564339,2023-10-06,504,iron,449,879,430,1,00274,India
564339,2023-10-06,503,mixer,1349,3249,1900,1,00274,India
244008,2023-10-06,506,monitor,3249,8000,4751,1,00279,India
363969,2023-10-06,501,iphone 15,60000,80000,20000,2,00255,India
363969,2023-10-06,506,monitor,3249,8000,4751,1,00255,India
363969,2023-10-06,503,mixer,1349,3249,1900,1,00255,India
810929,2023-10-06,505,oven,18490,24000,5510,1,00138,India
810929,2023-10-06,503,mixer,1349,3249,1900,1,00138,India
810929,2023-10-06,507,washing machine,6990,16490,9500,1,00138,India
703107,2023-10-06,502,iphone 15 pro max,100000,135000,35000,2,00365,India
703107,2023-10-06,501,iphone 15,60000,80000,20000,2,00365,India
703107,2023-10-06,506,monitor,3249,8000,4751,1,00365,India
811814,2023-10-06,507,washing machine,6990,16490,9500,1,00482,India
811814,2023-10-06,506,monitor,3249,8000,4751,1,00482,India
811814,2023-10-06,501,iphone 15,60000,80000,20000,2,00482,India
811814,2023-10-06,503,mixer,1349,3249,1900,1,00482,India
811814,2023-10-06,502,iphone 15 pro max,100000,135000,35000,2,00482,India
738855,2023-10-06,506,monitor,3249,8000,4751,1,00276,India
738855,2023-10-06,505,oven,18490,24000,5510,1,00276,India
491632,2023-10-06,503,mixer,1349,3249,1900,1,00179,India
491632,2023-10-06,502,iphone 15 pro max,100000,135000,35000,2,00179,India
491632,2023-10-06,507,washing machine,6990,16490,9500,1,00179,India
491632,2023-10-06,501,iphone 15,60000,80000,20000,2,00179,India
634319,2023-10-06,503,mixer,1349,3249,1900,1,00492,India
634319,2023-10-06,501,iphone 15,60000,80000,20000,2,00492,India
634319,2023-10-06,502,iphone 15 pro max,100000,135000,35000,2,00492,India
992727,2023-10-06,502,iphone 15 pro max,100000,135000,35000,2,00109,India
992727,2023-10-06,507,washing machine,6990,16490,9500,1,00109,India
882505,2023-10-06,507,washing machine,6990,16490,9500,1,00082,India
882505,2023-10-06,506,monitor,3249,8000,4751,1,00082,India
882505,2023-10-06,502,iphone 15 pro max,100000,135000,35000,2,00082,India
630997,2023-10-06,506,monitor,3249,8000,4751,1,00272,India
115923,2023-10-06,506,monitor,3249,8000,4751,1,00393,India
915966,2023-10-06,502,iphone 15 pro max,100000,135000,35000,2,00362,India
879622,2023-10-06,505,oven,18490,24000,5510,1,00011,India
879622,2023-10-06,504,iron,449,879,430,1,00011,India
879622,2023-10-06,506,monitor,3249,8000,4751,1,00011,India
264203,2023-10-06,505,oven,18490,24000,5510,1,00198,India
264203,2023-10-06,507,washing machine,6990,16490,9500,1,00198,India
264203,2023-10-06,506,monitor,3249,8000,4751,1,00198,India
294198,2023-10-06,504,iron,449,879,430,1,00461,India
294198,2023-10-06,502,iphone 15 pro max,100000,135000,35000,2,00461,India
294198,2023-10-06,506,monitor,3249,8000,4751,1,00461,India
895027,2023-10-06,506,monitor,3249,8000,4751,1,00487,India
415652,2023-10-06,503,mixer,1349,3249,1900,1,00177,India
415652,2023-10-06,501,iphone 15,60000,80000,20000,2,00177,India
415652,2023-10-06,505,oven,18490,24000,5510,1,00177,India
128515,2023-10-06,501,iphone 15,60000,80000,20000,2,00228,India
128515,2023-10-06,503,mixer,1349,3249,1900,1,00228,India
500218,2023-10-06,504,iron,449,879,430,1,00085,India
462656,2023-10-06,505,oven,18490,24000,5510,1,00289,India
462656,2023-10-06,504,iron,449,879,430,1,00289,India
651494,2023-10-06,502,iphone 15 pro max,100000,135000,35000,2,00310,India
927532,2023-10-06,503,mixer,1349,3249,1900,1,00134,India
927532,2023-10-06,507,washing machine,6990,16490,9500,1,00134,India
927532,2023-10-06,504,iron,449,879,430,1,00134,India
879937,2023-10-06,501,iphone 15,60000,80000,20000,2,00004,India
879937,2023-10-06,507,washing machine,6990,16490,9500,1,00004,India
540198,2023-10-06,504,iron,449,879,430,1,00188,India
540198,2023-10-06,507,washing machine,6990,16490,9500,1,00188,India
540198,2023-10-06,501,iphone 15,60000,80000,20000,2,00188,India
540198,2023-10-06,503,mixer,1349,3249,1900,1,00188,India
223633,2023-10-06,505,oven,18490,24000,5510,1,00217,India
223633,2023-10-06,506,monitor,3249,8000,4751,1,00217,India
223633,2023-10-06,502,iphone 15 pro max,100000,135000,35000,2,00217,India
527964,2023-10-06,501,iphone 15,60000,80000,20000,2,00342,India
527964,2023-10-06,507,washing machine,6990,16490,9500,1,00342,India
527964,2023-10-06,503,mixer,1349,3249,1900,1,00342,India
488316,2023-10-07,501,iphone 15,60000,80000,20000,2,00029,India
488316,2023-10-07,503,mixer,1349,3249,1900,1,00029,India
488316,2023-10-07,507,washing machine,6990,16490,9500,1,00029,India
277976,2023-10-07,507,washing machine,6990,16490,9500,1,00194,India
277976,2023-10-07,501,iphone 15,60000,80000,20000,2,00194,India
972408,2023-10-07,502,iphone 15 pro max,100000,135000,35000,2,00310,India
933365,2023-10-07,502,iphone 15 pro max,100000,135000,35000,2,00137,India
933365,2023-10-07,506,monitor,3249,8000,4751,1,00137,India
933365,2023-10-07,503,mixer,1349,3249,1900,1,00137,India
933365,2023-10-07,504,iron,449,879,430,1,00137,India
933365,2023-10-07,501,iphone 15,60000,80000,20000,2,00137,India
565791,2023-10-07,507,washing machine,6990,16490,9500,1,00353,India
565791,2023-10-07,502,iphone 15 pro max,100000,135000,35000,2,00353,India
969881,2023-10-07,504,iron,449,879,430,1,00280,India
969881,2023-10-07,502,iphone 15 pro max,100000,135000,35000,2,00280,India
969881,2023-10-07,506,monitor,3249,8000,4751,1,00280,India
245952,2023-10-07,504,iron,449,879,430,1,00008,India
245952,2023-10-07,502,iphone 15 pro max,100000,135000,35000,2,00008,India
245952,2023-10-07,506,monitor,3249,8000,4751,1,00008,India
853071,2023-10-07,503,mixer,1349,3249,1900,1,00160,India
853071,2023-10-07,504,iron,449,879,430,1,00160,India
853071,2023-10-07,505,oven,18490,24000,5510,1,00160,India
583720,2023-10-07,504,iron,449,879,430,1,00193,India
583720,2023-10-07,502,iphone 15 pro max,100000,135000,35000,2,00193,India
583720,2023-10-07,506,monitor,3249,8000,4751,1,00193,India
868750,2023-10-07,504,iron,449,879,430,1,00305,India
868750,2023-10-07,507,washing machine,6990,16490,9500,1,00305,India
609284,2023-10-07,503,mixer,1349,3249,1900,1,00372,India
609284,2023-10-07,506,monitor,3249,8000,4751,1,00372,India
609284,2023-10-07,505,oven,18490,24000,5510,1,00372,India
609284,2023-10-07,502,iphone 15 pro max,100000,135000,35000,2,00372,India
151553,2023-10-07,503,mixer,1349,3249,1900,1,00009,India
151553,2023-10-07,507,washing machine,6990,16490,9500,1,00009,India
151553,2023-10-07,505,oven,18490,24000,5510,1,00009,India
771459,2023-10-07,502,iphone 15 pro max,100000,135000,35000,2,00304,India
644488,2023-10-07,501,iphone 15,60000,80000,20000,2,00462,India
644488,2023-10-07,502,iphone 15 pro max,100000,135000,35000,2,00462,India
765978,2023-10-07,502,iphone 15 pro max,100000,135000,35000,2,00301,India
765978,2023-10-07,503,mixer,1349,3249,1900,1,00301,India
106533,2023-10-07,506,monitor,3249,8000,4751,1,00251,India
106533,2023-10-07,507,washing machine,6990,16490,9500,1,00251,India
106533,2023-10-07,501,iphone 15,60000,80000,20000,2,00251,India
792164,2023-10-07,501,iphone 15,60000,80000,20000,2,00318,India
792164,2023-10-07,502,iphone 15 pro max,100000,135000,35000,2,00318,India
792164,2023-10-07,503,mixer,1349,3249,1900,1,00318,India
942436,2023-10-07,502,iphone 15 pro max,100000,135000,35000,2,00429,India
942436,2023-10-07,504,iron,449,879,430,1,00429,India
942436,2023-10-07,506,monitor,3249,8000,4751,1,00429,India
119423,2023-10-07,506,monitor,3249,8000,4751,1,00491,India
119423,2023-10-07,505,oven,18490,24000,5510,1,00491,India
119423,2023-10-07,507,washing machine,6990,16490,9500,1,00491,India
119423,2023-10-07,502,iphone 15 pro max,100000,135000,35000,2,00491,India
939153,2023-10-07,501,iphone 15,60000,80000,20000,2,00210,India
386990,2023-10-07,502,iphone 15 pro max,100000,135000,35000,2,00205,India
386990,2023-10-07,501,iphone 15,60000,80000,20000,2,00205,India
117087,2023-10-07,506,monitor,3249,8000,4751,1,00315,India
117087,2023-10-07,503,mixer,1349,3249,1900,1,00315,India
117087,2023-10-07,507,washing machine,6990,16490,9500,1,00315,India
632747,2023-10-07,506,monitor,3249,8000,4751,1,00070,India
632747,2023-10-07,501,iphone 15,60000,80000,20000,2,00070,India
632747,2023-10-07,507,washing machine,6990,16490,9500,1,00070,India
632747,2023-10-07,502,iphone 15 pro max,100000,135000,35000,2,00070,India
764637,2023-10-07,502,iphone 15 pro max,100000,135000,35000,2,00472,India
764637,2023-10-07,501,iphone 15,60000,80000,20000,2,00472,India
764637,2023-10-07,503,mixer,1349,3249,1900,1,00472,India
502281,2023-10-07,503,mixer,1349,3249,1900,1,00491,India
502281,2023-10-07,506,monitor,3249,8000,4751,1,00491,India
502281,2023-10-07,502,iphone 15 pro max,100000,135000,35000,2,00491,India
594169,2023-10-07,507,washing machine,6990,16490,9500,1,00443,India
594169,2023-10-07,502,iphone 15 pro max,100000,135000,35000,2,00443,India
594169,2023-10-07,506,monitor,3249,8000,4751,1,00443,India
147825,2023-10-07,504,iron,449,879,430,1,00034,India
147825,2023-10-07,506,monitor,3249,8000,4751,1,00034,India
534965,2023-10-07,501,iphone 15,60000,80000,20000,2,00421,India
534965,2023-10-07,506,monitor,3249,8000,4751,1,00421,India
534965,2023-10-07,502,iphone 15 pro max,100000,135000,35000,2,00421,India
738706,2023-10-07,502,iphone 15 pro max,100000,135000,35000,2,00221,India
738706,2023-10-07,507,washing machine,6990,16490,9500,1,00221,India
765243,2023-10-07,503,mixer,1349,3249,1900,1,00161,India
765243,2023-10-07,507,washing machine,6990,16490,9500,1,00161,India
793214,2023-10-07,507,washing machine,6990,16490,9500,1,00182,India
793214,2023-10-07,501,iphone 15,60000,80000,20000,2,00182,India
793214,2023-10-07,503,mixer,1349,3249,1900,1,00182,India
793214,2023-10-07,504,iron,449,879,430,1,00182,India
942420,2023-10-07,504,iron,449,879,430,1,00165,India
942420,2023-10-07,506,monitor,3249,8000,4751,1,00165,India
942420,2023-10-07,505,oven,18490,24000,5510,1,00165,India
659407,2023-10-07,505,oven,18490,24000,5510,1,00146,India
659407,2023-10-07,502,iphone 15 pro max,100000,135000,35000,2,00146,India
856586,2023-10-07,503,mixer,1349,3249,1900,1,00137,India
856586,2023-10-07,506,monitor,3249,8000,4751,1,00137,India
451671,2023-10-07,502,iphone 15 pro max,100000,135000,35000,2,00218,India
451671,2023-10-07,501,iphone 15,60000,80000,20000,2,00218,India
677948,2023-10-07,505,oven,18490,24000,5510,1,00157,India
587078,2023-10-07,505,oven,18490,24000,5510,1,00321,India
587078,2023-10-07,506,monitor,3249,8000,4751,1,00321,India
587078,2023-10-07,503,mixer,1349,3249,1900,1,00321,India
319913,2023-10-07,503,mixer,1349,3249,1900,1,00485,India
319913,2023-10-07,506,monitor,3249,8000,4751,1,00485,India
319913,2023-10-07,505,oven,18490,24000,5510,1,00485,India
633746,2023-10-07,503,mixer,1349,3249,1900,1,00301,India
633746,2023-10-07,505,oven,18490,24000,5510,1,00301,India
633746,2023-10-07,502,iphone 15 pro max,100000,135000,35000,2,00301,India
377841,2023-10-07,506,monitor,3249,8000,4751,1,00313,India
377841,2023-10-07,504,iron,449,879,430,1,00313,India
377841,2023-10-07,502,iphone 15 pro max,100000,135000,35000,2,00313,India
377841,2023-10-07,501,iphone 15,60000,80000,20000,2,00313,India
177791,2023-10-07,505,oven,18490,24000,5510,1,00401,India
137795,2023-10-07,504,iron,449,879,430,1,00200,India
137795,2023-10-07,505,oven,18490,24000,5510,1,00200,India
916190,2023-10-07,501,iphone 15,60000,80000,20000,2,00253,India
500700,2023-10-07,504,iron,449,879,430,1,00500,India
449423,2023-10-07,506,monitor,3249,8000,4751,1,00267,India
449423,2023-10-07,504,iron,449,879,430,1,00267,India
149998,2023-10-07,506,monitor,3249,8000,4751,1,00338,India
149998,2023-10-07,501,iphone 15,60000,80000,20000,2,00338,India
211667,2023-10-07,501,iphone 15,60000,80000,20000,2,00004,India
211667,2023-10-07,503,mixer,1349,3249,1900,1,00004,India
252114,2023-10-07,507,washing machine,6990,16490,9500,1,00337,India
252114,2023-10-07,502,iphone 15 pro max,100000,135000,35000,2,00337,India
927554,2023-10-07,501,iphone 15,60000,80000,20000,2,00290,India
927554,2023-10-07,506,monitor,3249,8000,4751,1,00290,India
927554,2023-10-07,502,iphone 15 pro max,100000,135000,35000,2,00290,India
469335,2023-10-07,506,monitor,3249,8000,4751,1,00027,India
469335,2023-10-07,507,washing machine,6990,16490,9500,1,00027,India
469335,2023-10-07,504,iron,449,879,430,1,00027,India
408676,2023-10-07,506,monitor,3249,8000,4751,1,00091,India
408676,2023-10-07,502,iphone 15 pro max,100000,135000,35000,2,00091,India
408676,2023-10-07,501,iphone 15,60000,80000,20000,2,00091,India
408676,2023-10-07,505,oven,18490,24000,5510,1,00091,India
117175,2023-10-07,505,oven,18490,24000,5510,1,00036,India
117175,2023-10-07,502,iphone 15 pro max,100000,135000,35000,2,00036,India
117175,2023-10-07,507,washing machine,6990,16490,9500,1,00036,India
271254,2023-10-07,503,mixer,1349,3249,1900,1,00314,India
271254,2023-10-07,501,iphone 15,60000,80000,20000,2,00314,India
483745,2023-10-07,507,washing machine,6990,16490,9500,1,00384,India
483745,2023-10-07,506,monitor,3249,8000,4751,1,00384,India
693613,2023-10-07,501,iphone 15,60000,80000,20000,2,00405,India
693613,2023-10-07,504,iron,449,879,430,1,00405,India
693613,2023-10-07,506,monitor,3249,8000,4751,1,00405,India
693613,2023-10-07,503,mixer,1349,3249,1900,1,00405,India
906013,2023-10-07,506,monitor,3249,8000,4751,1,00250,India
906013,2023-10-07,501,iphone 15,60000,80000,20000,2,00250,India
906013,2023-10-07,505,oven,18490,24000,5510,1,00250,India
906013,2023-10-07,502,iphone 15 pro max,100000,135000,35000,2,00250,India
459127,2023-10-07,505,oven,18490,24000,5510,1,00223,India
459127,2023-10-07,504,iron,449,879,430,1,00223,India
438244,2023-10-07,506,monitor,3249,8000,4751,1,00160,India
438244,2023-10-07,504,iron,449,879,430,1,00160,India
438244,2023-10-07,501,iphone 15,60000,80000,20000,2,00160,India
438244,2023-10-07,502,iphone 15 pro max,100000,135000,35000,2,00160,India
684408,2023-10-07,505,oven,18490,24000,5510,1,00100,India
684408,2023-10-07,501,iphone 15,60000,80000,20000,2,00100,India
684408,2023-10-07,507,washing machine,6990,16490,9500,1,00100,India
684408,2023-10-07,503,mixer,1349,3249,1900,1,00100,India
738864,2023-10-07,504,iron,449,879,430,1,00457,India
738864,2023-10-07,501,iphone 15,60000,80000,20000,2,00457,India
738864,2023-10-07,506,monitor,3249,8000,4751,1,00457,India
909489,2023-10-07,507,washing machine,6990,16490,9500,1,00132,India
909489,2023-10-07,503,mixer,1349,3249,1900,1,00132,India
909489,2023-10-07,504,iron,449,879,430,1,00132,India
909489,2023-10-07,501,iphone 15,60000,80000,20000,2,00132,India
385235,2023-10-07,505,oven,18490,24000,5510,1,00231,India
390296,2023-10-07,502,iphone 15 pro max,100000,135000,35000,2,00095,India
562079,2023-10-07,507,washing machine,6990,16490,9500,1,00473,India
562079,2023-10-07,504,iron,449,879,430,1,00473,India
562079,2023-10-07,503,mixer,1349,3249,1900,1,00473,India
649460,2023-10-07,504,iron,449,879,430,1,00017,India
649460,2023-10-07,505,oven,18490,24000,5510,1,00017,India
649460,2023-10-07,507,washing machine,6990,16490,9500,1,00017,India
638390,2023-10-07,506,monitor,3249,8000,4751,1,00097,India
765310,2023-10-07,502,iphone 15 pro max,100000,135000,35000,2,00050,India
765310,2023-10-07,506,monitor,3249,8000,4751,1,00050,India
768130,2023-10-07,501,iphone 15,60000,80000,20000,2,00130,India
768130,2023-10-07,504,iron,449,879,430,1,00130,India
768130,2023-10-07,506,monitor,3249,8000,4751,1,00130,India
189566,2023-10-07,504,iron,449,879,430,1,00251,India
189566,2023-10-07,501,iphone 15,60000,80000,20000,2,00251,India
189566,2023-10-07,507,washing machine,6990,16490,9500,1,00251,India
189566,2023-10-07,506,monitor,3249,8000,4751,1,00251,India
189566,2023-10-07,505,oven,18490,24000,5510,1,00251,India
596849,2023-10-07,506,monitor,3249,8000,4751,1,00043,India
596849,2023-10-07,503,mixer,1349,3249,1900,1,00043,India
596849,2023-10-07,502,iphone 15 pro max,100000,135000,35000,2,00043,India
287680,2023-10-07,501,iphone 15,60000,80000,20000,2,00274,India
287680,2023-10-07,502,iphone 15 pro max,100000,135000,35000,2,00274,India
775125,2023-10-07,503,mixer,1349,3249,1900,1,00434,India
775125,2023-10-07,502,iphone 15 pro max,100000,135000,35000,2,00434,India
587950,2023-10-07,503,mixer,1349,3249,1900,1,00401,India
587950,2023-10-07,505,oven,18490,24000,5510,1,00401,India
389028,2023-10-07,502,iphone 15 pro max,100000,135000,35000,2,00401,India
389028,2023-10-07,503,mixer,1349,3249,1900,1,00401,India
389028,2023-10-07,501,iphone 15,60000,80000,20000,2,00401,India
630065,2023-10-07,503,mixer,1349,3249,1900,1,00037,India
630065,2023-10-07,505,oven,18490,24000,5510,1,00037,India
587351,2023-10-07,501,iphone 15,60000,80000,20000,2,00130,India
587351,2023-10-07,507,washing machine,6990,16490,9500,1,00130,India
587351,2023-10-07,506,monitor,3249,8000,4751,1,00130,India
988710,2023-10-07,501,iphone 15,60000,80000,20000,2,00368,India
988710,2023-10-07,506,monitor,3249,8000,4751,1,00368,India
988710,2023-10-07,505,oven,18490,24000,5510,1,00368,India
514403,2023-10-07,507,washing machine,6990,16490,9500,1,00462,India
514403,2023-10-07,503,mixer,1349,3249,1900,1,00462,India
514403,2023-10-07,506,monitor,3249,8000,4751,1,00462,India
154479,2023-10-07,502,iphone 15 pro max,100000,135000,35000,2,00001,India
154479,2023-10-07,505,oven,18490,24000,5510,1,00001,India
154479,2023-10-07,506,monitor,3249,8000,4751,1,00001,India
154479,2023-10-07,501,iphone 15,60000,80000,20000,2,00001,India
638166,2023-10-07,506,monitor,3249,8000,4751,1,00422,India
638166,2023-10-07,502,iphone 15 pro max,100000,135000,35000,2,00422,India
638166,2023-10-07,504,iron,449,879,430,1,00422,India
713556,2023-10-07,505,oven,18490,24000,5510,1,00041,India
713556,2023-10-07,504,iron,449,879,430,1,00041,India
625001,2023-10-07,507,washing machine,6990,16490,9500,1,00167,India
625001,2023-10-07,505,oven,18490,24000,5510,1,00167,India
625001,2023-10-07,506,monitor,3249,8000,4751,1,00167,India
512475,2023-10-07,503,mixer,1349,3249,1900,1,00068,India
834888,2023-10-07,506,monitor,3249,8000,4751,1,00230,India
834888,2023-10-07,501,iphone 15,60000,80000,20000,2,00230,India
834888,2023-10-07,502,iphone 15 pro max,100000,135000,35000,2,00230,India
920121,2023-10-07,506,monitor,3249,8000,4751,1,00271,India
920121,2023-10-07,507,washing machine,6990,16490,9500,1,00271,India
216552,2023-10-07,503,mixer,1349,3249,1900,1,00006,India
216552,2023-10-07,505,oven,18490,24000,5510,1,00006,India
299086,2023-10-07,503,mixer,1349,3249,1900,1,00341,India
299086,2023-10-07,504,iron,449,879,430,1,00341,India
772585,2023-10-07,503,mixer,1349,3249,1900,1,00411,India
234853,2023-10-07,502,iphone 15 pro max,100000,135000,35000,2,00472,India
457439,2023-10-08,504,iron,449,879,430,1,00467,India
457439,2023-10-08,503,mixer,1349,3249,1900,1,00467,India
457439,2023-10-08,507,washing machine,6990,16490,9500,1,00467,India
945254,2023-10-08,503,mixer,1349,3249,1900,1,00453,India
126949,2023-10-08,506,monitor,3249,8000,4751,1,00406,India
126949,2023-10-08,505,oven,18490,24000,5510,1,00406,India
206272,2023-10-08,505,oven,18490,24000,5510,1,00309,India
206272,2023-10-08,506,monitor,3249,8000,4751,1,00309,India
206272,2023-10-08,501,iphone 15,60000,80000,20000,2,00309,India
206272,2023-10-08,507,washing machine,6990,16490,9500,1,00309,India
261344,2023-10-08,501,iphone 15,60000,80000,20000,2,00408,India
261344,2023-10-08,506,monitor,3249,8000,4751,1,00408,India
261344,2023-10-08,502,iphone 15 pro max,100000,135000,35000,2,00408,India
261344,2023-10-08,505,oven,18490,24000,5510,1,00408,India
549324,2023-10-08,506,monitor,3249,8000,4751,1,00313,India
549324,2023-10-08,501,iphone 15,60000,80000,20000,2,00313,India
531222,2023-10-08,502,iphone 15 pro max,100000,135000,35000,2,00036,India
531222,2023-10-08,505,oven,18490,24000,5510,1,00036,India
892739,2023-10-08,506,monitor,3249,8000,4751,1,00360,India
892739,2023-10-08,505,oven,18490,24000,5510,1,00360,India
210115,2023-10-08,502,iphone 15 pro max,100000,135000,35000,2,00452,India
210115,2023-10-08,506,monitor,3249,8000,4751,1,00452,India
576583,2023-10-08,502,iphone 15 pro max,100000,135000,35000,2,00448,India
629162,2023-10-08,503,mixer,1349,3249,1900,1,00252,India
320666,2023-10-08,501,iphone 15,60000,80000,20000,2,00481,India
320666,2023-10-08,503,mixer,1349,3249,1900,1,00481,India
949083,2023-10-08,504,iron,449,879,430,1,00225,India
949083,2023-10-08,502,iphone 15 pro max,100000,135000,35000,2,00225,India
949083,2023-10-08,503,mixer,1349,3249,1900,1,00225,India
949083,2023-10-08,505,oven,18490,24000,5510,1,00225,India
888801,2023-10-08,507,washing machine,6990,16490,9500,1,00371,India
888801,2023-10-08,502,iphone 15 pro max,100000,135000,35000,2,00371,India
802148,2023-10-08,507,washing machine,6990,16490,9500,1,00159,India
242420,2023-10-08,505,oven,18490,24000,5510,1,00322,India
928438,2023-10-08,501,iphone 15,60000,80000,20000,2,00423,India
406322,2023-10-08,505,oven,18490,24000,5510,1,00329,India
914111,2023-10-08,503,mixer,1349,3249,1900,1,00492,India
914111,2023-10-08,501,iphone 15,60000,80000,20000,2,00492,India
334696,2023-10-08,503,mixer,1349,3249,1900,1,00067,India
334696,2023-10-08,501,iphone 15,60000,80000,20000,2,00067,India
865150,2023-10-08,507,washing machine,6990,16490,9500,1,00118,India
865150,2023-10-08,506,monitor,3249,8000,4751,1,00118,India
865150,2023-10-08,504,iron,449,879,430,1,00118,India
790095,2023-10-08,506,monitor,3249,8000,4751,1,00439,India
790095,2023-10-08,507,washing machine,6990,16490,9500,1,00439,India
790095,2023-10-08,502,iphone 15 pro max,100000,135000,35000,2,00439,India
509306,2023-10-08,504,iron,449,879,430,1,00378,India
509306,2023-10-08,507,washing machine,6990,16490,9500,1,00378,India
509306,2023-10-08,501,iphone 15,60000,80000,20000,2,00378,India
779687,2023-10-08,503,mixer,1349,3249,1900,1,00207,India
779687,2023-10-08,507,washing machine,6990,16490,9500,1,00207,India
817522,2023-10-08,502,iphone 15 pro max,100000,135000,35000,2,00224,India
764846,2023-10-08,506,monitor,3249,8000,4751,1,00472,India
126788,2023-10-08,503,mixer,1349,3249,1900,1,00020,India
126788,2023-10-08,506,monitor,3249,8000,4751,1,00020,India
126788,2023-10-08,505,oven,18490,24000,5510,1,00020,India
126788,2023-10-08,502,iphone 15 pro max,100000,135000,35000,2,00020,India
766517,2023-10-08,502,iphone 15 pro max,100000,135000,35000,2,00453,India
766517,2023-10-08,505,oven,18490,24000,5510,1,00453,India
469454,2023-10-08,502,iphone 15 pro max,100000,135000,35000,2,00005,India
767156,2023-10-08,501,iphone 15,60000,80000,20000,2,00431,India
767156,2023-10-08,505,oven,18490,24000,5510,1,00431,India
645354,2023-10-08,506,monitor,3249,8000,4751,1,00493,India
645354,2023-10-08,507,washing machine,6990,16490,9500,1,00493,India
645354,2023-10-08,501,iphone 15,60000,80000,20000,2,00493,India
379294,2023-10-08,506,monitor,3249,8000,4751,1,00166,India
379294,2023-10-08,501,iphone 15,60000,80000,20000,2,00166,India
882101,2023-10-08,501,iphone 15,60000,80000,20000,2,00490,India
882101,2023-10-08,504,iron,449,879,430,1,00490,India
882101,2023-10-08,507,washing machine,6990,16490,9500,1,00490,India
240990,2023-10-08,501,iphone 15,60000,80000,20000,2,00104,India
634377,2023-10-08,507,washing machine,6990,16490,9500,1,00052,India
634377,2023-10-08,506,monitor,3249,8000,4751,1,00052,India
830282,2023-10-08,502,iphone 15 pro max,100000,135000,35000,2,00087,India
830282,2023-10-08,503,mixer,1349,3249,1900,1,00087,India
382555,2023-10-08,505,oven,18490,24000,5510,1,00477,India
912210,2023-10-08,501,iphone 15,60000,80000,20000,2,00386,India
912210,2023-10-08,503,mixer,1349,3249,1900,1,00386,India
145893,2023-10-08,503,mixer,1349,3249,1900,1,00017,India
145893,2023-10-08,504,iron,449,879,430,1,00017,India
145893,2023-10-08,501,iphone 15,60000,80000,20000,2,00017,India
385775,2023-10-08,501,iphone 15,60000,80000,20000,2,00329,India
385775,2023-10-08,502,iphone 15 pro max,100000,135000,35000,2,00329,India
207770,2023-10-08,503,mixer,1349,3249,1900,1,00290,India
207770,2023-10-08,501,iphone 15,60000,80000,20000,2,00290,India
207770,2023-10-08,504,iron,449,879,430,1,00290,India
207770,2023-10-08,502,iphone 15 pro max,100000,135000,35000,2,00290,India
178171,2023-10-08,507,washing machine,6990,16490,9500,1,00322,India
574667,2023-10-08,502,iphone 15 pro max,100000,135000,35000,2,00485,India
574667,2023-10-08,506,monitor,3249,8000,4751,1,00485,India
574667,2023-10-08,501,iphone 15,60000,80000,20000,2,00485,India
270919,2023-10-08,504,iron,449,879,430,1,00136,India
270919,2023-10-08,501,iphone 15,60000,80000,20000,2,00136,India
270919,2023-10-08,505,oven,18490,24000,5510,1,00136,India
316721,2023-10-08,501,iphone 15,60000,80000,20000,2,00018,India
316721,2023-10-08,502,iphone 15 pro max,100000,135000,35000,2,00018,India
316721,2023-10-08,503,mixer,1349,3249,1900,1,00018,India
870578,2023-10-08,504,iron,449,879,430,1,00062,India
870578,2023-10-08,503,mixer,1349,3249,1900,1,00062,India
870578,2023-10-08,502,iphone 15 pro max,100000,135000,35000,2,00062,India
729180,2023-10-08,504,iron,449,879,430,1,00341,India
729180,2023-10-08,507,washing machine,6990,16490,9500,1,00341,India
729180,2023-10-08,506,monitor,3249,8000,4751,1,00341,India
986225,2023-10-08,503,mixer,1349,3249,1900,1,00090,India
986225,2023-10-08,507,washing machine,6990,16490,9500,1,00090,India
986225,2023-10-08,501,iphone 15,60000,80000,20000,2,00090,India
868085,2023-10-08,503,mixer,1349,3249,1900,1,00314,India
238410,2023-10-08,505,oven,18490,24000,5510,1,00194,India
238410,2023-10-08,503,mixer,1349,3249,1900,1,00194,India
238410,2023-10-08,507,washing machine,6990,16490,9500,1,00194,India
101169,2023-10-08,505,oven,18490,24000,5510,1,00397,India
732458,2023-10-08,504,iron,449,879,430,1,00222,India
732458,2023-10-08,501,iphone 15,60000,80000,20000,2,00222,India
732458,2023-10-08,507,washing machine,6990,16490,9500,1,00222,India
347680,2023-10-08,507,washing machine,6990,16490,9500,1,00333,India
347680,2023-10-08,505,oven,18490,24000,5510,1,00333,India
887893,2023-10-08,507,washing machine,6990,16490,9500,1,00325,India
887893,2023-10-08,502,iphone 15 pro max,100000,135000,35000,2,00325,India
887893,2023-10-08,504,iron,449,879,430,1,00325,India
737475,2023-10-08,505,oven,18490,24000,5510,1,00348,India
737475,2023-10-08,507,washing machine,6990,16490,9500,1,00348,India
737475,2023-10-08,502,iphone 15 pro max,100000,135000,35000,2,00348,India
351574,2023-10-08,505,oven,18490,24000,5510,1,00259,India
351574,2023-10-08,501,iphone 15,60000,80000,20000,2,00259,India
351574,2023-10-08,503,mixer,1349,3249,1900,1,00259,India
149061,2023-10-08,504,iron,449,879,430,1,00322,India
149061,2023-10-08,507,washing machine,6990,16490,9500,1,00322,India
149061,2023-10-08,505,oven,18490,24000,5510,1,00322,India
149061,2023-10-08,503,mixer,1349,3249,1900,1,00322,India
187645,2023-10-09,501,iphone 15,60000,80000,20000,2,00323,India
187645,2023-10-09,506,monitor,3249,8000,4751,1,00323,India
771994,2023-10-09,505,oven,18490,24000,5510,1,00114,India
771994,2023-10-09,502,iphone 15 pro max,100000,135000,35000,2,00114,India
771994,2023-10-09,504,iron,449,879,430,1,00114,India
771994,2023-10-09,503,mixer,1349,3249,1900,1,00114,India
497521,2023-10-09,506,monitor,3249,8000,4751,1,00019,India
497521,2023-10-09,507,washing machine,6990,16490,9500,1,00019,India
497521,2023-10-09,503,mixer,1349,3249,1900,1,00019,India
583301,2023-10-09,502,iphone 15 pro max,100000,135000,35000,2,00227,India
328947,2023-10-09,506,monitor,3249,8000,4751,1,00178,India
328947,2023-10-09,501,iphone 15,60000,80000,20000,2,00178,India
328947,2023-10-09,504,iron,449,879,430,1,00178,India
693333,2023-10-09,503,mixer,1349,3249,1900,1,00380,India
976064,2023-10-09,504,iron,449,879,430,1,00483,India
976064,2023-10-09,502,iphone 15 pro max,100000,135000,35000,2,00483,India
976064,2023-10-09,503,mixer,1349,3249,1900,1,00483,India
124715,2023-10-09,502,iphone 15 pro max,100000,135000,35000,2,00115,India
124715,2023-10-09,501,iphone 15,60000,80000,20000,2,00115,India
204273,2023-10-09,506,monitor,3249,8000,4751,1,00084,India
204273,2023-10-09,505,oven,18490,24000,5510,1,00084,India
204273,2023-10-09,502,iphone 15 pro max,100000,135000,35000,2,00084,India
889457,2023-10-09,503,mixer,1349,3249,1900,1,00161,India
889457,2023-10-09,507,washing machine,6990,16490,9500,1,00161,India
889457,2023-10-09,505,oven,18490,24000,5510,1,00161,India
930924,2023-10-09,505,oven,18490,24000,5510,1,00280,India
930924,2023-10-09,506,monitor,3249,8000,4751,1,00280,India
930924,2023-10-09,504,iron,449,879,430,1,00280,India
736525,2023-10-09,502,iphone 15 pro max,100000,135000,35000,2,00225,India
472410,2023-10-09,502,iphone 15 pro max,100000,135000,35000,2,00453,India
746326,2023-10-09,506,monitor,3249,8000,4751,1,00397,India
746326,2023-10-09,504,iron,449,879,430,1,00397,India
964084,2023-10-09,507,washing machine,6990,16490,9500,1,00389,India
964084,2023-10-09,505,oven,18490,24000,5510,1,00389,India
964084,2023-10-09,501,iphone 15,60000,80000,20000,2,00389,India
270493,2023-10-09,505,oven,18490,24000,5510,1,00321,India
270493,2023-10-09,507,washing machine,6990,16490,9500,1,00321,India
270493,2023-10-09,502,iphone 15 pro max,100000,135000,35000,2,00321,India
141769,2023-10-09,503,mixer,1349,3249,1900,1,00100,India
141769,2023-10-09,506,monitor,3249,8000,4751,1,00100,India
141769,2023-10-09,501,iphone 15,60000,80000,20000,2,00100,India
141769,2023-10-09,504,iron,449,879,430,1,00100,India
176752,2023-10-09,505,oven,18490,24000,5510,1,00500,India
176752,2023-10-09,503,mixer,1349,3249,1900,1,00500,India
390602,2023-10-09,504,iron,449,879,430,1,00271,India
390602,2023-10-09,506,monitor,3249,8000,4751,1,00271,India
966403,2023-10-09,504,iron,449,879,430,1,00322,India
966403,2023-10-09,502,iphone 15 pro max,100000,135000,35000,2,00322,India
966403,2023-10-09,505,oven,18490,24000,5510,1,00322,India
614471,2023-10-09,502,iphone 15 pro max,100000,135000,35000,2,00337,India
614471,2023-10-09,504,iron,449,879,430,1,00337,India
515162,2023-10-09,507,washing machine,6990,16490,9500,1,00236,India
208893,2023-10-09,503,mixer,1349,3249,1900,1,00104,India
208893,2023-10-09,506,monitor,3249,8000,4751,1,00104,India
208893,2023-10-09,507,washing machine,6990,16490,9500,1,00104,India
325147,2023-10-09,504,iron,449,879,430,1,00236,India
325147,2023-10-09,506,monitor,3249,8000,4751,1,00236,India
222294,2023-10-09,504,iron,449,879,430,1,00092,India
222294,2023-10-09,503,mixer,1349,3249,1900,1,00092,India
292221,2023-10-09,504,iron,449,879,430,1,00296,India
292221,2023-10-09,506,monitor,3249,8000,4751,1,00296,India
292221,2023-10-09,501,iphone 15,60000,80000,20000,2,00296,India
292221,2023-10-09,503,mixer,1349,3249,1900,1,00296,India
157801,2023-10-09,501,iphone 15,60000,80000,20000,2,00237,India
157801,2023-10-09,507,washing machine,6990,16490,9500,1,00237,India
863105,2023-10-09,507,washing machine,6990,16490,9500,1,00354,India
863105,2023-10-09,503,mixer,1349,3249,1900,1,00354,India
542515,2023-10-09,504,iron,449,879,430,1,00236,India
542515,2023-10-09,506,monitor,3249,8000,4751,1,00236,India
542515,2023-10-09,507,washing machine,6990,16490,9500,1,00236,India
854623,2023-10-09,505,oven,18490,24000,5510,1,00077,India
854623,2023-10-09,506,monitor,3249,8000,4751,1,00077,India
854623,2023-10-09,504,iron,449,879,430,1,00077,India
941928,2023-10-09,504,iron,449,879,430,1,00261,India
941928,2023-10-09,505,oven,18490,24000,5510,1,00261,India
328593,2023-10-09,503,mixer,1349,3249,1900,1,00302,India
328593,2023-10-09,505,oven,18490,24000,5510,1,00302,India
265821,2023-10-09,502,iphone 15 pro max,100000,135000,35000,2,00421,India
265821,2023-10-09,504,iron,449,879,430,1,00421,India
794109,2023-10-09,503,mixer,1349,3249,1900,1,00304,India
794109,2023-10-09,502,iphone 15 pro max,100000,135000,35000,2,00304,India
576107,2023-10-09,506,monitor,3249,8000,4751,1,00467,India
576107,2023-10-09,504,iron,449,879,430,1,00467,India
881813,2023-10-09,502,iphone 15 pro max,100000,135000,35000,2,00380,India
881813,2023-10-09,507,washing machine,6990,16490,9500,1,00380,India
881813,2023-10-09,504,iron,449,879,430,1,00380,India
838927,2023-10-09,507,washing machine,6990,16490,9500,1,00134,India
328545,2023-10-09,504,iron,449,879,430,1,00080,India
328545,2023-10-09,503,mixer,1349,3249,1900,1,00080,India
685476,2023-10-09,506,monitor,3249,8000,4751,1,00405,India
685476,2023-10-09,502,iphone 15 pro max,100000,135000,35000,2,00405,India
685476,2023-10-09,507,washing machine,6990,16490,9500,1,00405,India
668993,2023-10-09,503,mixer,1349,3249,1900,1,00250,India
668993,2023-10-09,501,iphone 15,60000,80000,20000,2,00250,India
668993,2023-10-09,505,oven,18490,24000,5510,1,00250,India
354781,2023-10-09,506,monitor,3249,8000,4751,1,00049,India
434276,2023-10-09,505,oven,18490,24000,5510,1,00017,India
763802,2023-10-09,505,oven,18490,24000,5510,1,00096,India
763802,2023-10-09,501,iphone 15,60000,80000,20000,2,00096,India
763802,2023-10-09,502,iphone 15 pro max,100000,135000,35000,2,00096,India
763802,2023-10-09,507,washing machine,6990,16490,9500,1,00096,India
170421,2023-10-09,505,oven,18490,24000,5510,1,00224,India
170421,2023-10-09,502,iphone 15 pro max,100000,135000,35000,2,00224,India
170421,2023-10-09,507,washing machine,6990,16490,9500,1,00224,India
665987,2023-10-09,505,oven,18490,24000,5510,1,00114,India
707224,2023-10-09,507,washing machine,6990,16490,9500,1,00321,India
707224,2023-10-09,505,oven,18490,24000,5510,1,00321,India
707224,2023-10-09,502,iphone 15 pro max,100000,135000,35000,2,00321,India
208484,2023-10-09,501,iphone 15,60000,80000,20000,2,00378,India
845939,2023-10-09,507,washing machine,6990,16490,9500,1,00183,India
845939,2023-10-09,501,iphone 15,60000,80000,20000,2,00183,India
845939,2023-10-09,504,iron,449,879,430,1,00183,India
797939,2023-10-09,505,oven,18490,24000,5510,1,00235,India
778043,2023-10-09,501,iphone 15,60000,80000,20000,2,00253,India
778043,2023-10-09,504,iron,449,879,430,1,00253,India
332126,2023-10-09,504,iron,449,879,430,1,00249,India
332126,2023-10-09,506,monitor,3249,8000,4751,1,00249,India
332126,2023-10-09,501,iphone 15,60000,80000,20000,2,00249,India
274122,2023-10-09,507,washing machine,6990,16490,9500,1,00431,India
274122,2023-10-09,502,iphone 15 pro max,100000,135000,35000,2,00431,India
274122,2023-10-09,503,mixer,1349,3249,1900,1,00431,India
405342,2023-10-09,502,iphone 15 pro max,100000,135000,35000,2,00072,India
405342,2023-10-09,504,iron,449,879,430,1,00072,India
405342,2023-10-09,503,mixer,1349,3249,1900,1,00072,India
858303,2023-10-09,501,iphone 15,60000,80000,20000,2,00096,India
858303,2023-10-09,503,mixer,1349,3249,1900,1,00096,India
858303,2023-10-09,505,oven,18490,24000,5510,1,00096,India
858303,2023-10-09,506,monitor,3249,8000,4751,1,00096,India
978593,2023-10-09,502,iphone 15 pro max,100000,135000,35000,2,00383,India
426339,2023-10-09,504,iron,449,879,430,1,00177,India
426339,2023-10-09,506,monitor,3249,8000,4751,1,00177,India
563102,2023-10-09,504,iron,449,879,430,1,00402,India
636656,2023-10-09,501,iphone 15,60000,80000,20000,2,00469,India
636656,2023-10-09,506,monitor,3249,8000,4751,1,00469,India
636656,2023-10-09,505,oven,18490,24000,5510,1,00469,India
636656,2023-10-09,502,iphone 15 pro max,100000,135000,35000,2,00469,India
267074,2023-10-09,505,oven,18490,24000,5510,1,00112,India
294277,2023-10-09,505,oven,18490,24000,5510,1,00315,India
979787,2023-10-09,501,iphone 15,60000,80000,20000,2,00092,India
979787,2023-10-09,502,iphone 15 pro max,100000,135000,35000,2,00092,India
979787,2023-10-09,507,washing machine,6990,16490,9500,1,00092,India
979787,2023-10-09,503,mixer,1349,3249,1900,1,00092,India
409635,2023-10-09,507,washing machine,6990,16490,9500,1,00309,India
409635,2023-10-09,501,iphone 15,60000,80000,20000,2,00309,India
409635,2023-10-09,503,mixer,1349,3249,1900,1,00309,India
944347,2023-10-10,503,mixer,1349,3249,1900,1,00024,India
944347,2023-10-10,507,washing machine,6990,16490,9500,1,00024,India
192434,2023-10-10,507,washing machine,6990,16490,9500,1,00427,India
192434,2023-10-10,505,oven,18490,24000,5510,1,00427,India
192434,2023-10-10,504,iron,449,879,430,1,00427,India
299214,2023-10-10,502,iphone 15 pro max,100000,135000,35000,2,00306,India
299214,2023-10-10,501,iphone 15,60000,80000,20000,2,00306,India
299214,2023-10-10,503,mixer,1349,3249,1900,1,00306,India
421380,2023-10-10,505,oven,18490,24000,5510,1,00327,India
421380,2023-10-10,507,washing machine,6990,16490,9500,1,00327,India
421380,2023-10-10,502,iphone 15 pro max,100000,135000,35000,2,00327,India
133877,2023-10-10,504,iron,449,879,430,1,00404,India
133877,2023-10-10,505,oven,18490,24000,5510,1,00404,India
133877,2023-10-10,502,iphone 15 pro max,100000,135000,35000,2,00404,India
518697,2023-10-10,502,iphone 15 pro max,100000,135000,35000,2,00226,India
518697,2023-10-10,503,mixer,1349,3249,1900,1,00226,India
518697,2023-10-10,506,monitor,3249,8000,4751,1,00226,India
281783,2023-10-10,503,mixer,1349,3249,1900,1,00491,India
281783,2023-10-10,504,iron,449,879,430,1,00491,India
885820,2023-10-10,507,washing machine,6990,16490,9500,1,00343,India
165313,2023-10-10,501,iphone 15,60000,80000,20000,2,00173,India
319229,2023-10-10,506,monitor,3249,8000,4751,1,00392,India
319229,2023-10-10,507,washing machine,6990,16490,9500,1,00392,India
319229,2023-10-10,505,oven,18490,24000,5510,1,00392,India
104975,2023-10-10,502,iphone 15 pro max,100000,135000,35000,2,00100,India
104975,2023-10-10,501,iphone 15,60000,80000,20000,2,00100,India
104975,2023-10-10,506,monitor,3249,8000,4751,1,00100,India
390717,2023-10-10,501,iphone 15,60000,80000,20000,2,00463,India
390717,2023-10-10,506,monitor,3249,8000,4751,1,00463,India
390717,2023-10-10,503,mixer,1349,3249,1900,1,00463,India
390717,2023-10-10,502,iphone 15 pro max,100000,135000,35000,2,00463,India
180683,2023-10-10,505,oven,18490,24000,5510,1,00391,India
180683,2023-10-10,503,mixer,1349,3249,1900,1,00391,India
347579,2023-10-10,504,iron,449,879,430,1,00246,India
347579,2023-10-10,507,washing machine,6990,16490,9500,1,00246,India
347579,2023-10-10,503,mixer,1349,3249,1900,1,00246,India
530509,2023-10-10,501,iphone 15,60000,80000,20000,2,00054,India
424358,2023-10-10,502,iphone 15 pro max,100000,135000,35000,2,00253,India
424358,2023-10-10,504,iron,449,879,430,1,00253,India
424358,2023-10-10,506,monitor,3249,8000,4751,1,00253,India
906706,2023-10-10,507,washing machine,6990,16490,9500,1,00260,India
906706,2023-10-10,504,iron,449,879,430,1,00260,India
906706,2023-10-10,505,oven,18490,24000,5510,1,00260,India
345847,2023-10-10,505,oven,18490,24000,5510,1,00268,India
345847,2023-10-10,503,mixer,1349,3249,1900,1,00268,India
345847,2023-10-10,502,iphone 15 pro max,100000,135000,35000,2,00268,India
345847,2023-10-10,501,iphone 15,60000,80000,20000,2,00268,India
368934,2023-10-10,501,iphone 15,60000,80000,20000,2,00450,India
368934,2023-10-10,503,mixer,1349,3249,1900,1,00450,India
368934,2023-10-10,507,washing machine,6990,16490,9500,1,00450,India
368934,2023-10-10,504,iron,449,879,430,1,00450,India
368934,2023-10-10,505,oven,18490,24000,5510,1,00450,India
500391,2023-10-10,501,iphone 15,60000,80000,20000,2,00428,India
748295,2023-10-10,502,iphone 15 pro max,100000,135000,35000,2,00257,India
748295,2023-10-10,505,oven,18490,24000,5510,1,00257,India
748295,2023-10-10,501,iphone 15,60000,80000,20000,2,00257,India
748295,2023-10-10,503,mixer,1349,3249,1900,1,00257,India
470635,2023-10-10,501,iphone 15,60000,80000,20000,2,00130,India
470635,2023-10-10,507,washing machine,6990,16490,9500,1,00130,India
470635,2023-10-10,506,monitor,3249,8000,4751,1,00130,India
366632,2023-10-10,502,iphone 15 pro max,100000,135000,35000,2,00337,India
366632,2023-10-10,504,iron,449,879,430,1,00337,India
366632,2023-10-10,505,oven,18490,24000,5510,1,00337,India
932358,2023-10-10,504,iron,449,879,430,1,00103,India
932358,2023-10-10,505,oven,18490,24000,5510,1,00103,India
932358,2023-10-10,501,iphone 15,60000,80000,20000,2,00103,India
852129,2023-10-10,505,oven,18490,24000,5510,1,00014,India
852129,2023-10-10,507,washing machine,6990,16490,9500,1,00014,India
852129,2023-10-10,501,iphone 15,60000,80000,20000,2,00014,India
852129,2023-10-10,504,iron,449,879,430,1,00014,India
800289,2023-10-10,507,washing machine,6990,16490,9500,1,00380,India
800289,2023-10-10,506,monitor,3249,8000,4751,1,00380,India
800289,2023-10-10,502,iphone 15 pro max,100000,135000,35000,2,00380,India
651003,2023-10-10,507,washing machine,6990,16490,9500,1,00177,India
651003,2023-10-10,504,iron,449,879,430,1,00177,India
325798,2023-10-10,506,monitor,3249,8000,4751,1,00165,India
395659,2023-10-10,504,iron,449,879,430,1,00018,India
395659,2023-10-10,501,iphone 15,60000,80000,20000,2,00018,India
994823,2023-10-10,507,washing machine,6990,16490,9500,1,00049,India
994823,2023-10-10,505,oven,18490,24000,5510,1,00049,India
542172,2023-10-10,506,monitor,3249,8000,4751,1,00239,India
542172,2023-10-10,503,mixer,1349,3249,1900,1,00239,India
542172,2023-10-10,505,oven,18490,24000,5510,1,00239,India
542172,2023-10-10,504,iron,449,879,430,1,00239,India
751474,2023-10-10,502,iphone 15 pro max,100000,135000,35000,2,00350,India
973596,2023-10-10,507,washing machine,6990,16490,9500,1,00458,India
973596,2023-10-10,506,monitor,3249,8000,4751,1,00458,India
973596,2023-10-10,501,iphone 15,60000,80000,20000,2,00458,India
678852,2023-10-10,507,washing machine,6990,16490,9500,1,00255,India
410553,2023-10-10,506,monitor,3249,8000,4751,1,00256,India
347848,2023-10-10,501,iphone 15,60000,80000,20000,2,00429,India
347848,2023-10-10,505,oven,18490,24000,5510,1,00429,India
347848,2023-10-10,504,iron,449,879,430,1,00429,India
347848,2023-10-10,507,washing machine,6990,16490,9500,1,00429,India
807620,2023-10-10,506,monitor,3249,8000,4751,1,00443,India
931149,2023-10-10,505,oven,18490,24000,5510,1,00019,India
931149,2023-10-10,503,mixer,1349,3249,1900,1,00019,India
285704,2023-10-10,505,oven,18490,24000,5510,1,00491,India
716376,2023-10-10,501,iphone 15,60000,80000,20000,2,00061,India
716376,2023-10-10,506,monitor,3249,8000,4751,1,00061,India
688160,2023-10-10,506,monitor,3249,8000,4751,1,00380,India
888759,2023-10-10,503,mixer,1349,3249,1900,1,00406,India
994167,2023-10-10,503,mixer,1349,3249,1900,1,00398,India
994167,2023-10-10,507,washing machine,6990,16490,9500,1,00398,India
702584,2023-10-10,506,monitor,3249,8000,4751,1,00136,India
583037,2023-10-10,505,oven,18490,24000,5510,1,00433,India
583037,2023-10-10,503,mixer,1349,3249,1900,1,00433,India
813140,2023-10-10,501,iphone 15,60000,80000,20000,2,00146,India
813140,2023-10-10,502,iphone 15 pro max,100000,135000,35000,2,00146,India
813140,2023-10-10,505,oven,18490,24000,5510,1,00146,India
190185,2023-10-10,506,monitor,3249,8000,4751,1,00336,India
853050,2023-10-10,505,oven,18490,24000,5510,1,00241,India
853050,2023-10-10,501,iphone 15,60000,80000,20000,2,00241,India
853050,2023-10-10,507,washing machine,6990,16490,9500,1,00241,India
420474,2023-10-10,506,monitor,3249,8000,4751,1,00131,India
353442,2023-10-10,504,iron,449,879,430,1,00074,India
353442,2023-10-10,503,mixer,1349,3249,1900,1,00074,India
387439,2023-10-10,504,iron,449,879,430,1,00327,India
387439,2023-10-10,503,mixer,1349,3249,1900,1,00327,India
288792,2023-10-10,507,washing machine,6990,16490,9500,1,00326,India
288792,2023-10-10,503,mixer,1349,3249,1900,1,00326,India
288792,2023-10-10,502,iphone 15 pro max,100000,135000,35000,2,00326,India
288792,2023-10-10,506,monitor,3249,8000,4751,1,00326,India
596313,2023-10-10,504,iron,449,879,430,1,00339,India
596313,2023-10-10,507,washing machine,6990,16490,9500,1,00339,India
596313,2023-10-10,502,iphone 15 pro max,100000,135000,35000,2,00339,India
596313,2023-10-10,505,oven,18490,24000,5510,1,00339,India
301256,2023-10-10,506,monitor,3249,8000,4751,1,00494,India
226205,2023-10-10,501,iphone 15,60000,80000,20000,2,00145,India
226205,2023-10-10,504,iron,449,879,430,1,00145,India
226205,2023-10-10,503,mixer,1349,3249,1900,1,00145,India
386598,2023-10-10,501,iphone 15,60000,80000,20000,2,00387,India
386598,2023-10-10,504,iron,449,879,430,1,00387,India
386598,2023-10-10,505,oven,18490,24000,5510,1,00387,India
386598,2023-10-10,507,washing machine,6990,16490,9500,1,00387,India
386598,2023-10-10,506,monitor,3249,8000,4751,1,00387,India
795376,2023-10-10,502,iphone 15 pro max,100000,135000,35000,2,00347,India
725687,2023-10-10,503,mixer,1349,3249,1900,1,00286,India
751521,2023-10-10,504,iron,449,879,430,1,00272,India
751521,2023-10-10,502,iphone 15 pro max,100000,135000,35000,2,00272,India
751521,2023-10-10,506,monitor,3249,8000,4751,1,00272,India
751521,2023-10-10,503,mixer,1349,3249,1900,1,00272,India
802839,2023-10-10,504,iron,449,879,430,1,00264,India
802839,2023-10-10,501,iphone 15,60000,80000,20000,2,00264,India
802839,2023-10-10,507,washing machine,6990,16490,9500,1,00264,India
640450,2023-10-10,505,oven,18490,24000,5510,1,00018,India
915868,2023-10-10,505,oven,18490,24000,5510,1,00031,India
915868,2023-10-10,502,iphone 15 pro max,100000,135000,35000,2,00031,India
392439,2023-10-10,501,iphone 15,60000,80000,20000,2,00260,India
392439,2023-10-10,503,mixer,1349,3249,1900,1,00260,India
392439,2023-10-10,505,oven,18490,24000,5510,1,00260,India
297361,2023-10-10,504,iron,449,879,430,1,00198,India
237849,2023-10-10,507,washing machine,6990,16490,9500,1,00087,India
237849,2023-10-10,501,iphone 15,60000,80000,20000,2,00087,India
237849,2023-10-10,503,mixer,1349,3249,1900,1,00087,India
183550,2023-10-10,501,iphone 15,60000,80000,20000,2,00403,India
421396,2023-10-10,504,iron,449,879,430,1,00421,India
421396,2023-10-10,506,monitor,3249,8000,4751,1,00421,India
943578,2023-10-10,502,iphone 15 pro max,100000,135000,35000,2,00347,India
943578,2023-10-10,501,iphone 15,60000,80000,20000,2,00347,India
943578,2023-10-10,505,oven,18490,24000,5510,1,00347,India
943578,2023-10-10,506,monitor,3249,8000,4751,1,00347,India
846151,2023-10-10,502,iphone 15 pro max,100000,135000,35000,2,00360,India
846151,2023-10-10,505,oven,18490,24000,5510,1,00360,India
846151,2023-10-10,506,monitor,3249,8000,4751,1,00360,India
719042,2023-10-10,503,mixer,1349,3249,1900,1,00331,India
719042,2023-10-10,507,washing machine,6990,16490,9500,1,00331,India
763834,2023-10-10,507,washing machine,6990,16490,9500,1,00216,India
211049,2023-10-10,506,monitor,3249,8000,4751,1,00418,India
211049,2023-10-10,504,iron,449,879,430,1,00418,India
262062,2023-10-10,501,iphone 15,60000,80000,20000,2,00196,India
262062,2023-10-10,506,monitor,3249,8000,4751,1,00196,India
973699,2023-10-10,501,iphone 15,60000,80000,20000,2,00430,India
973699,2023-10-10,505,oven,18490,24000,5510,1,00430,India
746266,2023-10-10,506,monitor,3249,8000,4751,1,00034,India
715173,2023-10-10,502,iphone 15 pro max,100000,135000,35000,2,00066,India
715173,2023-10-10,505,oven,18490,24000,5510,1,00066,India
715173,2023-10-10,506,monitor,3249,8000,4751,1,00066,India
715173,2023-10-10,504,iron,449,879,430,1,00066,India
529154,2023-10-10,503,mixer,1349,3249,1900,1,00372,India
529154,2023-10-10,504,iron,449,879,430,1,00372,India
744307,2023-10-10,507,washing machine,6990,16490,9500,1,00491,India
744307,2023-10-10,505,oven,18490,24000,5510,1,00491,India
688827,2023-10-11,507,washing machine,6990,16490,9500,1,00170,India
230453,2023-10-11,505,oven,18490,24000,5510,1,00002,India
230453,2023-10-11,502,iphone 15 pro max,100000,135000,35000,2,00002,India
780822,2023-10-11,507,washing machine,6990,16490,9500,1,00043,India
780822,2023-10-11,504,iron,449,879,430,1,00043,India
827249,2023-10-11,502,iphone 15 pro max,100000,135000,35000,2,00225,India
827249,2023-10-11,506,monitor,3249,8000,4751,1,00225,India
827249,2023-10-11,501,iphone 15,60000,80000,20000,2,00225,India
261908,2023-10-11,506,monitor,3249,8000,4751,1,00002,India
521490,2023-10-11,501,iphone 15,60000,80000,20000,2,00070,India
521490,2023-10-11,502,iphone 15 pro max,100000,135000,35000,2,00070,India
521490,2023-10-11,507,washing machine,6990,16490,9500,1,00070,India
756812,2023-10-11,507,washing machine,6990,16490,9500,1,00168,India
376785,2023-10-11,505,oven,18490,24000,5510,1,00497,India
376785,2023-10-11,504,iron,449,879,430,1,00497,India
851958,2023-10-11,502,iphone 15 pro max,100000,135000,35000,2,00018,India
851958,2023-10-11,501,iphone 15,60000,80000,20000,2,00018,India
851958,2023-10-11,506,monitor,3249,8000,4751,1,00018,India
851958,2023-10-11,505,oven,18490,24000,5510,1,00018,India
807480,2023-10-11,502,iphone 15 pro max,100000,135000,35000,2,00472,India
807480,2023-10-11,507,washing machine,6990,16490,9500,1,00472,India
807480,2023-10-11,501,iphone 15,60000,80000,20000,2,00472,India
135052,2023-10-11,503,mixer,1349,3249,1900,1,00477,India
135052,2023-10-11,504,iron,449,879,430,1,00477,India
135052,2023-10-11,506,monitor,3249,8000,4751,1,00477,India
135052,2023-10-11,507,washing machine,6990,16490,9500,1,00477,India
703962,2023-10-11,507,washing machine,6990,16490,9500,1,00411,India
703962,2023-10-11,504,iron,449,879,430,1,00411,India
703962,2023-10-11,501,iphone 15,60000,80000,20000,2,00411,India
703962,2023-10-11,503,mixer,1349,3249,1900,1,00411,India
507107,2023-10-11,503,mixer,1349,3249,1900,1,00292,India
507107,2023-10-11,504,iron,449,879,430,1,00292,India
507107,2023-10-11,506,monitor,3249,8000,4751,1,00292,India
507107,2023-10-11,507,washing machine,6990,16490,9500,1,00292,India
640629,2023-10-11,504,iron,449,879,430,1,00314,India
959365,2023-10-11,504,iron,449,879,430,1,00016,India
770173,2023-10-11,502,iphone 15 pro max,100000,135000,35000,2,00323,India
770173,2023-10-11,504,iron,449,879,430,1,00323,India
770173,2023-10-11,505,oven,18490,24000,5510,1,00323,India
181075,2023-10-11,501,iphone 15,60000,80000,20000,2,00277,India
181075,2023-10-11,502,iphone 15 pro max,100000,135000,35000,2,00277,India
181075,2023-10-11,504,iron,449,879,430,1,00277,India
181075,2023-10-11,507,washing machine,6990,16490,9500,1,00277,India
559835,2023-10-11,505,oven,18490,24000,5510,1,00366,India
559835,2023-10-11,507,washing machine,6990,16490,9500,1,00366,India
559835,2023-10-11,506,monitor,3249,8000,4751,1,00366,India
559835,2023-10-11,501,iphone 15,60000,80000,20000,2,00366,India
632127,2023-10-11,503,mixer,1349,3249,1900,1,00362,India
632127,2023-10-11,505,oven,18490,24000,5510,1,00362,India
632127,2023-10-11,506,monitor,3249,8000,4751,1,00362,India
866301,2023-10-11,503,mixer,1349,3249,1900,1,00183,India
592174,2023-10-11,505,oven,18490,24000,5510,1,00041,India
592174,2023-10-11,503,mixer,1349,3249,1900,1,00041,India
592174,2023-10-11,501,iphone 15,60000,80000,20000,2,00041,India
948706,2023-10-11,504,iron,449,879,430,1,00274,India
948706,2023-10-11,507,washing machine,6990,16490,9500,1,00274,India
948706,2023-10-11,502,iphone 15 pro max,100000,135000,35000,2,00274,India
222343,2023-10-11,501,iphone 15,60000,80000,20000,2,00004,India
222343,2023-10-11,506,monitor,3249,8000,4751,1,00004,India
222343,2023-10-11,505,oven,18490,24000,5510,1,00004,India
222343,2023-10-11,502,iphone 15 pro max,100000,135000,35000,2,00004,India
463076,2023-10-11,501,iphone 15,60000,80000,20000,2,00346,India
901718,2023-10-11,504,iron,449,879,430,1,00331,India
312258,2023-10-11,505,oven,18490,24000,5510,1,00178,India
312258,2023-10-11,503,mixer,1349,3249,1900,1,00178,India
312258,2023-10-11,506,monitor,3249,8000,4751,1,00178,India
547963,2023-10-11,503,mixer,1349,3249,1900,1,00492,India
547963,2023-10-11,501,iphone 15,60000,80000,20000,2,00492,India
547963,2023-10-11,505,oven,18490,24000,5510,1,00492,India
890688,2023-10-11,505,oven,18490,24000,5510,1,00383,India
890688,2023-10-11,503,mixer,1349,3249,1900,1,00383,India
520130,2023-10-11,505,oven,18490,24000,5510,1,00452,India
520130,2023-10-11,504,iron,449,879,430,1,00452,India
520130,2023-10-11,503,mixer,1349,3249,1900,1,00452,India
520130,2023-10-11,501,iphone 15,60000,80000,20000,2,00452,India
863254,2023-10-11,505,oven,18490,24000,5510,1,00057,India
863254,2023-10-11,503,mixer,1349,3249,1900,1,00057,India
175500,2023-10-11,504,iron,449,879,430,1,00200,India
175500,2023-10-11,501,iphone 15,60000,80000,20000,2,00200,India
192117,2023-10-11,502,iphone 15 pro max,100000,135000,35000,2,00010,India
192117,2023-10-11,503,mixer,1349,3249,1900,1,00010,India
192117,2023-10-11,501,iphone 15,60000,80000,20000,2,00010,India
192117,2023-10-11,507,washing machine,6990,16490,9500,1,00010,India
192117,2023-10-11,505,oven,18490,24000,5510,1,00010,India
384825,2023-10-11,502,iphone 15 pro max,100000,135000,35000,2,00129,India
705977,2023-10-11,501,iphone 15,60000,80000,20000,2,00111,India
705977,2023-10-11,505,oven,18490,24000,5510,1,00111,India
901865,2023-10-11,501,iphone 15,60000,80000,20000,2,00192,India
901865,2023-10-11,505,oven,18490,24000,5510,1,00192,India
901865,2023-10-11,502,iphone 15 pro max,100000,135000,35000,2,00192,India
901865,2023-10-11,506,monitor,3249,8000,4751,1,00192,India
529238,2023-10-11,503,mixer,1349,3249,1900,1,00044,India
529238,2023-10-11,505,oven,18490,24000,5510,1,00044,India
529238,2023-10-11,507,washing machine,6990,16490,9500,1,00044,India
246938,2023-10-11,503,mixer,1349,3249,1900,1,00059,India
246938,2023-10-11,505,oven,18490,24000,5510,1,00059,India
873731,2023-10-11,503,mixer,1349,3249,1900,1,00443,India
873731,2023-10-11,507,washing machine,6990,16490,9500,1,00443,India
873731,2023-10-11,504,iron,449,879,430,1,00443,India
873731,2023-10-11,501,iphone 15,60000,80000,20000,2,00443,India
925124,2023-10-11,506,monitor,3249,8000,4751,1,00195,India
925124,2023-10-11,501,iphone 15,60000,80000,20000,2,00195,India
925124,2023-10-11,502,iphone 15 pro max,100000,135000,35000,2,00195,India
925124,2023-10-11,503,mixer,1349,3249,1900,1,00195,India
298862,2023-10-11,505,oven,18490,24000,5510,1,00015,India
298862,2023-10-11,503,mixer,1349,3249,1900,1,00015,India
166906,2023-10-11,503,mixer,1349,3249,1900,1,00390,India
265087,2023-10-11,502,iphone 15 pro max,100000,135000,35000,2,00142,India
265087,2023-10-11,504,iron,449,879,430,1,00142,India
445281,2023-10-11,507,washing machine,6990,16490,9500,1,00394,India
500903,2023-10-11,506,monitor,3249,8000,4751,1,00465,India
500903,2023-10-11,507,washing machine,6990,16490,9500,1,00465,India
500903,2023-10-11,504,iron,449,879,430,1,00465,India
500903,2023-10-11,505,oven,18490,24000,5510,1,00465,India
560487,2023-10-11,506,monitor,3249,8000,4751,1,00441,India
560487,2023-10-11,501,iphone 15,60000,80000,20000,2,00441,India
303564,2023-10-11,507,washing machine,6990,16490,9500,1,00015,India
303564,2023-10-11,505,oven,18490,24000,5510,1,00015,India
963707,2023-10-11,501,iphone 15,60000,80000,20000,2,00262,India
963707,2023-10-11,502,iphone 15 pro max,100000,135000,35000,2,00262,India
438037,2023-10-11,505,oven,18490,24000,5510,1,00266,India
746961,2023-10-11,504,iron,449,879,430,1,00453,India
746961,2023-10-11,505,oven,18490,24000,5510,1,00453,India
746961,2023-10-11,503,mixer,1349,3249,1900,1,00453,India
601602,2023-10-11,506,monitor,3249,8000,4751,1,00396,India
601602,2023-10-11,502,iphone 15 pro max,100000,135000,35000,2,00396,India
561879,2023-10-11,502,iphone 15 pro max,100000,135000,35000,2,00372,India
561879,2023-10-11,506,monitor,3249,8000,4751,1,00372,India
561879,2023-10-11,501,iphone 15,60000,80000,20000,2,00372,India
561879,2023-10-11,505,oven,18490,24000,5510,1,00372,India
151716,2023-10-11,502,iphone 15 pro max,100000,135000,35000,2,00168,India
151716,2023-10-11,501,iphone 15,60000,80000,20000,2,00168,India
943834,2023-10-11,507,washing machine,6990,16490,9500,1,00353,India
943834,2023-10-11,501,iphone 15,60000,80000,20000,2,00353,India
943834,2023-10-11,504,iron,449,879,430,1,00353,India
478674,2023-10-11,503,mixer,1349,3249,1900,1,00317,India
885393,2023-10-11,504,iron,449,879,430,1,00419,India
885393,2023-10-11,507,washing machine,6990,16490,9500,1,00419,India
604886,2023-10-11,504,iron,449,879,430,1,00315,India
604886,2023-10-11,503,mixer,1349,3249,1900,1,00315,India
604886,2023-10-11,505,oven,18490,24000,5510,1,00315,India
604886,2023-10-11,507,washing machine,6990,16490,9500,1,00315,India
529748,2023-10-11,503,mixer,1349,3249,1900,1,00006,India
529748,2023-10-11,501,iphone 15,60000,80000,20000,2,00006,India
429824,2023-10-11,506,monitor,3249,8000,4751,1,00488,India
429824,2023-10-11,505,oven,18490,24000,5510,1,00488,India
429824,2023-10-11,501,iphone 15,60000,80000,20000,2,00488,India
147528,2023-10-11,502,iphone 15 pro max,100000,135000,35000,2,00479,India
147528,2023-10-11,506,monitor,3249,8000,4751,1,00479,India
147528,2023-10-11,503,mixer,1349,3249,1900,1,00479,India
569235,2023-10-11,503,mixer,1349,3249,1900,1,00441,India
703610,2023-10-11,507,washing machine,6990,16490,9500,1,00288,India
703610,2023-10-11,506,monitor,3249,8000,4751,1,00288,India
703610,2023-10-11,505,oven,18490,24000,5510,1,00288,India
703610,2023-10-11,502,iphone 15 pro max,100000,135000,35000,2,00288,India
703610,2023-10-11,504,iron,449,879,430,1,00288,India
345865,2023-10-11,507,washing machine,6990,16490,9500,1,00190,India
539870,2023-10-11,506,monitor,3249,8000,4751,1,00301,India
539870,2023-10-11,504,iron,449,879,430,1,00301,India
514205,2023-10-11,503,mixer,1349,3249,1900,1,00278,India
514205,2023-10-11,501,iphone 15,60000,80000,20000,2,00278,India
618574,2023-10-11,503,mixer,1349,3249,1900,1,00453,India
546303,2023-10-11,506,monitor,3249,8000,4751,1,00117,India
546303,2023-10-11,502,iphone 15 pro max,100000,135000,35000,2,00117,India
546303,2023-10-11,501,iphone 15,60000,80000,20000,2,00117,India
636796,2023-10-11,502,iphone 15 pro max,100000,135000,35000,2,00294,India
639926,2023-10-11,504,iron,449,879,430,1,00114,India
639926,2023-10-11,505,oven,18490,24000,5510,1,00114,India
639926,2023-10-11,502,iphone 15 pro max,100000,135000,35000,2,00114,India
332079,2023-10-11,502,iphone 15 pro max,100000,135000,35000,2,00390,India
332079,2023-10-11,507,washing machine,6990,16490,9500,1,00390,India
332079,2023-10-11,504,iron,449,879,430,1,00390,India
332079,2023-10-11,505,oven,18490,24000,5510,1,00390,India
196871,2023-10-11,507,washing machine,6990,16490,9500,1,00304,India
182155,2023-10-11,507,washing machine,6990,16490,9500,1,00184,India
182155,2023-10-11,502,iphone 15 pro max,100000,135000,35000,2,00184,India
826745,2023-10-11,501,iphone 15,60000,80000,20000,2,00314,India
826745,2023-10-11,507,washing machine,6990,16490,9500,1,00314,India
102995,2023-10-11,504,iron,449,879,430,1,00298,India
102995,2023-10-11,507,washing machine,6990,16490,9500,1,00298,India
102995,2023-10-11,506,monitor,3249,8000,4751,1,00298,India
835270,2023-10-11,506,monitor,3249,8000,4751,1,00118,India
894869,2023-10-11,504,iron,449,879,430,1,00034,India
894869,2023-10-11,506,monitor,3249,8000,4751,1,00034,India
894869,2023-10-11,501,iphone 15,60000,80000,20000,2,00034,India
558846,2023-10-11,503,mixer,1349,3249,1900,1,00464,India
558846,2023-10-11,506,monitor,3249,8000,4751,1,00464,India
558846,2023-10-11,505,oven,18490,24000,5510,1,00464,India
558846,2023-10-11,507,washing machine,6990,16490,9500,1,00464,India
722473,2023-10-11,507,washing machine,6990,16490,9500,1,00452,India
722473,2023-10-11,504,iron,449,879,430,1,00452,India
722473,2023-10-11,505,oven,18490,24000,5510,1,00452,India
722473,2023-10-11,506,monitor,3249,8000,4751,1,00452,India
192104,2023-10-11,503,mixer,1349,3249,1900,1,00474,India
192104,2023-10-11,504,iron,449,879,430,1,00474,India
192104,2023-10-11,506,monitor,3249,8000,4751,1,00474,India
291887,2023-10-11,504,iron,449,879,430,1,00484,India
291887,2023-10-11,507,washing machine,6990,16490,9500,1,00484,India
291887,2023-10-11,506,monitor,3249,8000,4751,1,00484,India
139585,2023-10-11,501,iphone 15,60000,80000,20000,2,00163,India
139585,2023-10-11,505,oven,18490,24000,5510,1,00163,India
139585,2023-10-11,502,iphone 15 pro max,100000,135000,35000,2,00163,India
513191,2023-10-11,502,iphone 15 pro max,100000,135000,35000,2,00398,India
513191,2023-10-11,503,mixer,1349,3249,1900,1,00398,India
910590,2023-10-11,506,monitor,3249,8000,4751,1,00165,India
910590,2023-10-11,503,mixer,1349,3249,1900,1,00165,India
910590,2023-10-11,507,washing machine,6990,16490,9500,1,00165,India
910590,2023-10-11,502,iphone 15 pro max,100000,135000,35000,2,00165,India
367451,2023-10-11,502,iphone 15 pro max,100000,135000,35000,2,00280,India
856439,2023-10-11,506,monitor,3249,8000,4751,1,00305,India
856439,2023-10-11,502,iphone 15 pro max,100000,135000,35000,2,00305,India
961674,2023-10-11,502,iphone 15 pro max,100000,135000,35000,2,00440,India
961674,2023-10-11,506,monitor,3249,8000,4751,1,00440,India
244711,2023-10-11,505,oven,18490,24000,5510,1,00007,India
172773,2023-10-11,505,oven,18490,24000,5510,1,00346,India
172773,2023-10-11,503,mixer,1349,3249,1900,1,00346,India
881405,2023-10-11,503,mixer,1349,3249,1900,1,00006,India
881405,2023-10-11,506,monitor,3249,8000,4751,1,00006,India
602549,2023-10-11,501,iphone 15,60000,80000,20000,2,00183,India
602549,2023-10-11,505,oven,18490,24000,5510,1,00183,India
602549,2023-10-11,502,iphone 15 pro max,100000,135000,35000,2,00183,India
602549,2023-10-11,506,monitor,3249,8000,4751,1,00183,India
854656,2023-10-11,502,iphone 15 pro max,100000,135000,35000,2,00327,India
854656,2023-10-11,506,monitor,3249,8000,4751,1,00327,India
854656,2023-10-11,507,washing machine,6990,16490,9500,1,00327,India
854656,2023-10-11,504,iron,449,879,430,1,00327,India
548566,2023-10-11,503,mixer,1349,3249,1900,1,00238,India
581525,2023-10-11,506,monitor,3249,8000,4751,1,00286,India
581525,2023-10-11,504,iron,449,879,430,1,00286,India
581525,2023-10-11,505,oven,18490,24000,5510,1,00286,India
581525,2023-10-11,507,washing machine,6990,16490,9500,1,00286,India
518576,2023-10-11,504,iron,449,879,430,1,00027,India
351894,2023-10-11,502,iphone 15 pro max,100000,135000,35000,2,00356,India
853404,2023-10-11,505,oven,18490,24000,5510,1,00383,India
853404,2023-10-11,502,iphone 15 pro max,100000,135000,35000,2,00383,India
853404,2023-10-11,501,iphone 15,60000,80000,20000,2,00383,India
173204,2023-10-11,502,iphone 15 pro max,100000,135000,35000,2,00386,India
957257,2023-10-11,503,mixer,1349,3249,1900,1,00051,India
807180,2023-10-11,507,washing machine,6990,16490,9500,1,00385,India
387958,2023-10-11,503,mixer,1349,3249,1900,1,00194,India
387958,2023-10-11,505,oven,18490,24000,5510,1,00194,India
387958,2023-10-11,501,iphone 15,60000,80000,20000,2,00194,India
281603,2023-10-11,504,iron,449,879,430,1,00100,India
161492,2023-10-12,506,monitor,3249,8000,4751,1,00470,India
161492,2023-10-12,505,oven,18490,24000,5510,1,00470,India
161492,2023-10-12,507,washing machine,6990,16490,9500,1,00470,India
161492,2023-10-12,502,iphone 15 pro max,100000,135000,35000,2,00470,India
835212,2023-10-12,504,iron,449,879,430,1,00136,India
835212,2023-10-12,507,washing machine,6990,16490,9500,1,00136,India
225956,2023-10-12,504,iron,449,879,430,1,00499,India
167972,2023-10-12,501,iphone 15,60000,80000,20000,2,00115,India
167972,2023-10-12,506,monitor,3249,8000,4751,1,00115,India
167972,2023-10-12,502,iphone 15 pro max,100000,135000,35000,2,00115,India
185624,2023-10-12,501,iphone 15,60000,80000,20000,2,00271,India
156584,2023-10-12,503,mixer,1349,3249,1900,1,00318,India
156584,2023-10-12,502,iphone 15 pro max,100000,135000,35000,2,00318,India
203383,2023-10-12,506,monitor,3249,8000,4751,1,00357,India
396663,2023-10-12,507,washing machine,6990,16490,9500,1,00164,India
814685,2023-10-12,501,iphone 15,60000,80000,20000,2,00361,India
814685,2023-10-12,503,mixer,1349,3249,1900,1,00361,India
114959,2023-10-12,506,monitor,3249,8000,4751,1,00014,India
114959,2023-10-12,505,oven,18490,24000,5510,1,00014,India
114959,2023-10-12,501,iphone 15,60000,80000,20000,2,00014,India
114959,2023-10-12,507,washing machine,6990,16490,9500,1,00014,India
648118,2023-10-12,504,iron,449,879,430,1,00381,India
296421,2023-10-12,502,iphone 15 pro max,100000,135000,35000,2,00002,India
296421,2023-10-12,501,iphone 15,60000,80000,20000,2,00002,India
326735,2023-10-12,506,monitor,3249,8000,4751,1,00126,India
326735,2023-10-12,503,mixer,1349,3249,1900,1,00126,India
326735,2023-10-12,501,iphone 15,60000,80000,20000,2,00126,India
295774,2023-10-12,501,iphone 15,60000,80000,20000,2,00098,India
295774,2023-10-12,503,mixer,1349,3249,1900,1,00098,India
409529,2023-10-12,504,iron,449,879,430,1,00289,India
409529,2023-10-12,506,monitor,3249,8000,4751,1,00289,India
409529,2023-10-12,505,oven,18490,24000,5510,1,00289,India
409529,2023-10-12,503,mixer,1349,3249,1900,1,00289,India
514756,2023-10-12,504,iron,449,879,430,1,00369,India
514756,2023-10-12,507,washing machine,6990,16490,9500,1,00369,India
434446,2023-10-12,501,iphone 15,60000,80000,20000,2,00319,India
434446,2023-10-12,505,oven,18490,24000,5510,1,00319,India
827526,2023-10-12,502,iphone 15 pro max,100000,135000,35000,2,00013,India
827526,2023-10-12,507,washing machine,6990,16490,9500,1,00013,India
827526,2023-10-12,504,iron,449,879,430,1,00013,India
747666,2023-10-12,506,monitor,3249,8000,4751,1,00171,India
324873,2023-10-12,504,iron,449,879,430,1,00062,India
324873,2023-10-12,501,iphone 15,60000,80000,20000,2,00062,India
324873,2023-10-12,506,monitor,3249,8000,4751,1,00062,India
566819,2023-10-12,507,washing machine,6990,16490,9500,1,00156,India
566819,2023-10-12,503,mixer,1349,3249,1900,1,00156,India
566819,2023-10-12,505,oven,18490,24000,5510,1,00156,India
566819,2023-10-12,506,monitor,3249,8000,4751,1,00156,India
566819,2023-10-12,504,iron,449,879,430,1,00156,India
244454,2023-10-12,504,iron,449,879,430,1,00048,India
244454,2023-10-12,501,iphone 15,60000,80000,20000,2,00048,India
244454,2023-10-12,505,oven,18490,24000,5510,1,00048,India
533494,2023-10-12,502,iphone 15 pro max,100000,135000,35000,2,00302,India
786589,2023-10-12,506,monitor,3249,8000,4751,1,00494,India
786589,2023-10-12,503,mixer,1349,3249,1900,1,00494,India
786589,2023-10-12,505,oven,18490,24000,5510,1,00494,India
786589,2023-10-12,507,washing machine,6990,16490,9500,1,00494,India
786589,2023-10-12,502,iphone 15 pro max,100000,135000,35000,2,00494,India
758200,2023-10-12,502,iphone 15 pro max,100000,135000,35000,2,00078,India
758200,2023-10-12,504,iron,449,879,430,1,00078,India
758200,2023-10-12,505,oven,18490,24000,5510,1,00078,India
321109,2023-10-12,505,oven,18490,24000,5510,1,00174,India
373570,2023-10-12,507,washing machine,6990,16490,9500,1,00131,India
871780,2023-10-12,504,iron,449,879,430,1,00056,India
871780,2023-10-12,503,mixer,1349,3249,1900,1,00056,India
871780,2023-10-12,501,iphone 15,60000,80000,20000,2,00056,India
644998,2023-10-12,502,iphone 15 pro max,100000,135000,35000,2,00020,India
644998,2023-10-12,503,mixer,1349,3249,1900,1,00020,India
644998,2023-10-12,504,iron,449,879,430,1,00020,India
805810,2023-10-12,503,mixer,1349,3249,1900,1,00282,India
554233,2023-10-12,506,monitor,3249,8000,4751,1,00285,India
554233,2023-10-12,505,oven,18490,24000,5510,1,00285,India
589777,2023-10-12,504,iron,449,879,430,1,00246,India
589777,2023-10-12,503,mixer,1349,3249,1900,1,00246,India
589777,2023-10-12,505,oven,18490,24000,5510,1,00246,India
589777,2023-10-12,506,monitor,3249,8000,4751,1,00246,India
482528,2023-10-12,501,iphone 15,60000,80000,20000,2,00234,India
940860,2023-10-12,506,monitor,3249,8000,4751,1,00291,India
940860,2023-10-12,502,iphone 15 pro max,100000,135000,35000,2,00291,India
388300,2023-10-12,501,iphone 15,60000,80000,20000,2,00156,India
417358,2023-10-12,504,iron,449,879,430,1,00355,India
417358,2023-10-12,505,oven,18490,24000,5510,1,00355,India
912174,2023-10-12,501,iphone 15,60000,80000,20000,2,00137,India
912174,2023-10-12,504,iron,449,879,430,1,00137,India
912174,2023-10-12,505,oven,18490,24000,5510,1,00137,India
912174,2023-10-12,507,washing machine,6990,16490,9500,1,00137,India
193287,2023-10-12,501,iphone 15,60000,80000,20000,2,00481,India
193287,2023-10-12,505,oven,18490,24000,5510,1,00481,India
193287,2023-10-12,504,iron,449,879,430,1,00481,India
281091,2023-10-12,506,monitor,3249,8000,4751,1,00120,India
281091,2023-10-12,501,iphone 15,60000,80000,20000,2,00120,India
281091,2023-10-12,504,iron,449,879,430,1,00120,India
951572,2023-10-12,502,iphone 15 pro max,100000,135000,35000,2,00413,India
903772,2023-10-12,505,oven,18490,24000,5510,1,00482,India
903772,2023-10-12,502,iphone 15 pro max,100000,135000,35000,2,00482,India
478951,2023-10-12,507,washing machine,6990,16490,9500,1,00074,India
478951,2023-10-12,503,mixer,1349,3249,1900,1,00074,India
478951,2023-10-12,502,iphone 15 pro max,100000,135000,35000,2,00074,India
136753,2023-10-12,505,oven,18490,24000,5510,1,00377,India
856709,2023-10-12,507,washing machine,6990,16490,9500,1,00175,India
856709,2023-10-12,501,iphone 15,60000,80000,20000,2,00175,India
785094,2023-10-12,505,oven,18490,24000,5510,1,00282,India
528143,2023-10-12,503,mixer,1349,3249,1900,1,00393,India
126485,2023-10-12,502,iphone 15 pro max,100000,135000,35000,2,00041,India
126485,2023-10-12,504,iron,449,879,430,1,00041,India
126485,2023-10-12,505,oven,18490,24000,5510,1,00041,India
288792,2023-10-12,501,iphone 15,60000,80000,20000,2,00326,India
288792,2023-10-12,505,oven,18490,24000,5510,1,00326,India
288792,2023-10-12,504,iron,449,879,430,1,00326,India
288792,2023-10-12,507,washing machine,6990,16490,9500,1,00326,India
670626,2023-10-12,506,monitor,3249,8000,4751,1,00116,India
670626,2023-10-12,505,oven,18490,24000,5510,1,00116,India
339838,2023-10-12,502,iphone 15 pro max,100000,135000,35000,2,00329,India
339838,2023-10-12,505,oven,18490,24000,5510,1,00329,India
339838,2023-10-12,506,monitor,3249,8000,4751,1,00329,India
106836,2023-10-12,504,iron,449,879,430,1,00393,India
171749,2023-10-12,503,mixer,1349,3249,1900,1,00058,India
171749,2023-10-12,505,oven,18490,24000,5510,1,00058,India
426269,2023-10-12,507,washing machine,6990,16490,9500,1,00321,India
784834,2023-10-12,501,iphone 15,60000,80000,20000,2,00421,India
784834,2023-10-12,503,mixer,1349,3249,1900,1,00421,India
888700,2023-10-12,507,washing machine,6990,16490,9500,1,00094,India
888700,2023-10-12,506,monitor,3249,8000,4751,1,00094,India
888700,2023-10-12,502,iphone 15 pro max,100000,135000,35000,2,00094,India
888700,2023-10-12,503,mixer,1349,3249,1900,1,00094,India
888700,2023-10-12,505,oven,18490,24000,5510,1,00094,India
362266,2023-10-12,506,monitor,3249,8000,4751,1,00465,India
362266,2023-10-12,502,iphone 15 pro max,100000,135000,35000,2,00465,India
908407,2023-10-12,502,iphone 15 pro max,100000,135000,35000,2,00395,India
609281,2023-10-12,502,iphone 15 pro max,100000,135000,35000,2,00372,India
609281,2023-10-12,505,oven,18490,24000,5510,1,00372,India
974973,2023-10-12,505,oven,18490,24000,5510,1,00358,India
974973,2023-10-12,507,washing machine,6990,16490,9500,1,00358,India
974973,2023-10-12,502,iphone 15 pro max,100000,135000,35000,2,00358,India
492546,2023-10-12,502,iphone 15 pro max,100000,135000,35000,2,00079,India
526672,2023-10-12,504,iron,449,879,430,1,00019,India
526672,2023-10-12,501,iphone 15,60000,80000,20000,2,00019,India
639533,2023-10-12,505,oven,18490,24000,5510,1,00122,India
639533,2023-10-12,507,washing machine,6990,16490,9500,1,00122,India
441261,2023-10-12,504,iron,449,879,430,1,00374,India
362507,2023-10-12,505,oven,18490,24000,5510,1,00348,India
450342,2023-10-12,507,washing machine,6990,16490,9500,1,00064,India
450342,2023-10-12,504,iron,449,879,430,1,00064,India
450342,2023-10-12,503,mixer,1349,3249,1900,1,00064,India
450342,2023-10-12,506,monitor,3249,8000,4751,1,00064,India
463898,2023-10-12,505,oven,18490,24000,5510,1,00035,India
463898,2023-10-12,504,iron,449,879,430,1,00035,India
463898,2023-10-12,506,monitor,3249,8000,4751,1,00035,India
463898,2023-10-12,507,washing machine,6990,16490,9500,1,00035,India
706286,2023-10-13,504,iron,449,879,430,1,00144,India
706286,2023-10-13,502,iphone 15 pro max,100000,135000,35000,2,00144,India
706286,2023-10-13,503,mixer,1349,3249,1900,1,00144,India
706286,2023-10-13,507,washing machine,6990,16490,9500,1,00144,India
519250,2023-10-13,503,mixer,1349,3249,1900,1,00485,India
814560,2023-10-13,506,monitor,3249,8000,4751,1,00356,India
814560,2023-10-13,507,washing machine,6990,16490,9500,1,00356,India
793791,2023-10-13,503,mixer,1349,3249,1900,1,00140,India
793791,2023-10-13,505,oven,18490,24000,5510,1,00140,India
793791,2023-10-13,502,iphone 15 pro max,100000,135000,35000,2,00140,India
996116,2023-10-13,507,washing machine,6990,16490,9500,1,00059,India
996116,2023-10-13,505,oven,18490,24000,5510,1,00059,India
996116,2023-10-13,506,monitor,3249,8000,4751,1,00059,India
704071,2023-10-13,506,monitor,3249,8000,4751,1,00429,India
704071,2023-10-13,501,iphone 15,60000,80000,20000,2,00429,India
704071,2023-10-13,507,washing machine,6990,16490,9500,1,00429,India
704071,2023-10-13,503,mixer,1349,3249,1900,1,00429,India
751771,2023-10-13,504,iron,449,879,430,1,00346,India
751771,2023-10-13,502,iphone 15 pro max,100000,135000,35000,2,00346,India
751771,2023-10-13,506,monitor,3249,8000,4751,1,00346,India
651616,2023-10-13,506,monitor,3249,8000,4751,1,00044,India
651616,2023-10-13,502,iphone 15 pro max,100000,135000,35000,2,00044,India
651616,2023-10-13,504,iron,449,879,430,1,00044,India
503770,2023-10-13,505,oven,18490,24000,5510,1,00305,India
503770,2023-10-13,506,monitor,3249,8000,4751,1,00305,India
503770,2023-10-13,503,mixer,1349,3249,1900,1,00305,India
503770,2023-10-13,502,iphone 15 pro max,100000,135000,35000,2,00305,India
503770,2023-10-13,504,iron,449,879,430,1,00305,India
164503,2023-10-13,503,mixer,1349,3249,1900,1,00033,India
164503,2023-10-13,501,iphone 15,60000,80000,20000,2,00033,India
164503,2023-10-13,502,iphone 15 pro max,100000,135000,35000,2,00033,India
788091,2023-10-13,501,iphone 15,60000,80000,20000,2,00208,India
989363,2023-10-13,504,iron,449,879,430,1,00166,India
989363,2023-10-13,507,washing machine,6990,16490,9500,1,00166,India
521022,2023-10-13,503,mixer,1349,3249,1900,1,00219,India
521022,2023-10-13,501,iphone 15,60000,80000,20000,2,00219,India
521022,2023-10-13,505,oven,18490,24000,5510,1,00219,India
969764,2023-10-13,501,iphone 15,60000,80000,20000,2,00288,India
969764,2023-10-13,502,iphone 15 pro max,100000,135000,35000,2,00288,India
969764,2023-10-13,503,mixer,1349,3249,1900,1,00288,India
570761,2023-10-13,503,mixer,1349,3249,1900,1,00089,India
570761,2023-10-13,507,washing machine,6990,16490,9500,1,00089,India
464882,2023-10-13,507,washing machine,6990,16490,9500,1,00365,India
666091,2023-10-13,505,oven,18490,24000,5510,1,00094,India
173353,2023-10-13,506,monitor,3249,8000,4751,1,00271,India
314309,2023-10-13,503,mixer,1349,3249,1900,1,00430,India
314309,2023-10-13,501,iphone 15,60000,80000,20000,2,00430,India
206819,2023-10-13,505,oven,18490,24000,5510,1,00406,India
206819,2023-10-13,504,iron,449,879,430,1,00406,India
206819,2023-10-13,503,mixer,1349,3249,1900,1,00406,India
206819,2023-10-13,501,iphone 15,60000,80000,20000,2,00406,India
437856,2023-10-13,503,mixer,1349,3249,1900,1,00157,India
373930,2023-10-13,501,iphone 15,60000,80000,20000,2,00239,India
373930,2023-10-13,505,oven,18490,24000,5510,1,00239,India
373930,2023-10-13,503,mixer,1349,3249,1900,1,00239,India
279234,2023-10-13,506,monitor,3249,8000,4751,1,00355,India
279234,2023-10-13,502,iphone 15 pro max,100000,135000,35000,2,00355,India
279234,2023-10-13,504,iron,449,879,430,1,00355,India
279234,2023-10-13,501,iphone 15,60000,80000,20000,2,00355,India
413632,2023-10-13,503,mixer,1349,3249,1900,1,00010,India
413632,2023-10-13,504,iron,449,879,430,1,00010,India
413632,2023-10-13,507,washing machine,6990,16490,9500,1,00010,India
942964,2023-10-13,506,monitor,3249,8000,4751,1,00272,India
942964,2023-10-13,502,iphone 15 pro max,100000,135000,35000,2,00272,India
250881,2023-10-13,502,iphone 15 pro max,100000,135000,35000,2,00269,India
250881,2023-10-13,506,monitor,3249,8000,4751,1,00269,India
585219,2023-10-13,502,iphone 15 pro max,100000,135000,35000,2,00038,India
585219,2023-10-13,507,washing machine,6990,16490,9500,1,00038,India
585219,2023-10-13,501,iphone 15,60000,80000,20000,2,00038,India
572591,2023-10-13,507,washing machine,6990,16490,9500,1,00406,India
188729,2023-10-13,504,iron,449,879,430,1,00314,India
420092,2023-10-13,507,washing machine,6990,16490,9500,1,00272,India
249322,2023-10-13,505,oven,18490,24000,5510,1,00313,India
249322,2023-10-13,501,iphone 15,60000,80000,20000,2,00313,India
867704,2023-10-13,506,monitor,3249,8000,4751,1,00184,India
867704,2023-10-13,507,washing machine,6990,16490,9500,1,00184,India
916029,2023-10-13,507,washing machine,6990,16490,9500,1,00206,India
445424,2023-10-13,503,mixer,1349,3249,1900,1,00069,India
486108,2023-10-13,505,oven,18490,24000,5510,1,00176,India
486108,2023-10-13,507,washing machine,6990,16490,9500,1,00176,India
486108,2023-10-13,502,iphone 15 pro max,100000,135000,35000,2,00176,India
486108,2023-10-13,504,iron,449,879,430,1,00176,India
486108,2023-10-13,506,monitor,3249,8000,4751,1,00176,India
821732,2023-10-13,507,washing machine,6990,16490,9500,1,00002,India
821732,2023-10-13,504,iron,449,879,430,1,00002,India
821732,2023-10-13,506,monitor,3249,8000,4751,1,00002,India
537049,2023-10-13,505,oven,18490,24000,5510,1,00143,India
537049,2023-10-13,502,iphone 15 pro max,100000,135000,35000,2,00143,India
537049,2023-10-13,506,monitor,3249,8000,4751,1,00143,India
537049,2023-10-13,503,mixer,1349,3249,1900,1,00143,India
392514,2023-10-13,505,oven,18490,24000,5510,1,00323,India
392514,2023-10-13,502,iphone 15 pro max,100000,135000,35000,2,00323,India
878128,2023-10-13,504,iron,449,879,430,1,00344,India
878128,2023-10-13,501,iphone 15,60000,80000,20000,2,00344,India
878128,2023-10-13,505,oven,18490,24000,5510,1,00344,India
291846,2023-10-13,501,iphone 15,60000,80000,20000,2,00042,India
291846,2023-10-13,505,oven,18490,24000,5510,1,00042,India
291846,2023-10-13,503,mixer,1349,3249,1900,1,00042,India
589276,2023-10-13,501,iphone 15,60000,80000,20000,2,00047,India
589276,2023-10-13,507,washing machine,6990,16490,9500,1,00047,India
589276,2023-10-13,505,oven,18490,24000,5510,1,00047,India
907864,2023-10-13,507,washing machine,6990,16490,9500,1,00289,India
907864,2023-10-13,504,iron,449,879,430,1,00289,India
907864,2023-10-13,505,oven,18490,24000,5510,1,00289,India
115368,2023-10-13,504,iron,449,879,430,1,00253,India
115368,2023-10-13,501,iphone 15,60000,80000,20000,2,00253,India
115368,2023-10-13,506,monitor,3249,8000,4751,1,00253,India
443081,2023-10-13,501,iphone 15,60000,80000,20000,2,00057,India
443081,2023-10-13,507,washing machine,6990,16490,9500,1,00057,India
443081,2023-10-13,503,mixer,1349,3249,1900,1,00057,India
443081,2023-10-13,504,iron,449,879,430,1,00057,India
443081,2023-10-13,506,monitor,3249,8000,4751,1,00057,India
506157,2023-10-13,504,iron,449,879,430,1,00014,India
794077,2023-10-13,503,mixer,1349,3249,1900,1,00217,India
794077,2023-10-13,501,iphone 15,60000,80000,20000,2,00217,India
493025,2023-10-13,504,iron,449,879,430,1,00068,India
493025,2023-10-13,507,washing machine,6990,16490,9500,1,00068,India
493025,2023-10-13,505,oven,18490,24000,5510,1,00068,India
493025,2023-10-13,506,monitor,3249,8000,4751,1,00068,India
193256,2023-10-13,506,monitor,3249,8000,4751,1,00086,India
878753,2023-10-13,505,oven,18490,24000,5510,1,00094,India
878753,2023-10-13,507,washing machine,6990,16490,9500,1,00094,India
793254,2023-10-13,507,washing machine,6990,16490,9500,1,00441,India
671354,2023-10-13,505,oven,18490,24000,5510,1,00228,India
671354,2023-10-13,503,mixer,1349,3249,1900,1,00228,India
671354,2023-10-13,504,iron,449,879,430,1,00228,India
970425,2023-10-13,505,oven,18490,24000,5510,1,00200,India
970425,2023-10-13,503,mixer,1349,3249,1900,1,00200,India
970425,2023-10-13,507,washing machine,6990,16490,9500,1,00200,India
677443,2023-10-13,503,mixer,1349,3249,1900,1,00293,India
677443,2023-10-13,505,oven,18490,24000,5510,1,00293,India
677443,2023-10-13,502,iphone 15 pro max,100000,135000,35000,2,00293,India
929366,2023-10-13,502,iphone 15 pro max,100000,135000,35000,2,00133,India
929366,2023-10-13,505,oven,18490,24000,5510,1,00133,India
929366,2023-10-13,504,iron,449,879,430,1,00133,India
104420,2023-10-13,506,monitor,3249,8000,4751,1,00012,India
104420,2023-10-13,502,iphone 15 pro max,100000,135000,35000,2,00012,India
980213,2023-10-13,502,iphone 15 pro max,100000,135000,35000,2,00412,India
980213,2023-10-13,504,iron,449,879,430,1,00412,India
621552,2023-10-14,503,mixer,1349,3249,1900,1,00221,India
621552,2023-10-14,504,iron,449,879,430,1,00221,India
644951,2023-10-14,502,iphone 15 pro max,100000,135000,35000,2,00222,India
367504,2023-10-14,501,iphone 15,60000,80000,20000,2,00404,India
307078,2023-10-14,507,washing machine,6990,16490,9500,1,00030,India
143572,2023-10-14,501,iphone 15,60000,80000,20000,2,00283,India
143572,2023-10-14,502,iphone 15 pro max,100000,135000,35000,2,00283,India
143572,2023-10-14,506,monitor,3249,8000,4751,1,00283,India
143572,2023-10-14,503,mixer,1349,3249,1900,1,00283,India
851549,2023-10-14,501,iphone 15,60000,80000,20000,2,00065,India
790912,2023-10-14,506,monitor,3249,8000,4751,1,00044,India
790912,2023-10-14,501,iphone 15,60000,80000,20000,2,00044,India
790912,2023-10-14,507,washing machine,6990,16490,9500,1,00044,India
446912,2023-10-14,506,monitor,3249,8000,4751,1,00312,India
446912,2023-10-14,503,mixer,1349,3249,1900,1,00312,India
172914,2023-10-14,502,iphone 15 pro max,100000,135000,35000,2,00086,India
797876,2023-10-14,501,iphone 15,60000,80000,20000,2,00329,India
797876,2023-10-14,506,monitor,3249,8000,4751,1,00329,India
797876,2023-10-14,507,washing machine,6990,16490,9500,1,00329,India
342474,2023-10-14,503,mixer,1349,3249,1900,1,00229,India
986070,2023-10-14,506,monitor,3249,8000,4751,1,00326,India
986070,2023-10-14,505,oven,18490,24000,5510,1,00326,India
986070,2023-10-14,501,iphone 15,60000,80000,20000,2,00326,India
986070,2023-10-14,503,mixer,1349,3249,1900,1,00326,India
986070,2023-10-14,502,iphone 15 pro max,100000,135000,35000,2,00326,India
290737,2023-10-14,503,mixer,1349,3249,1900,1,00369,India
196372,2023-10-14,506,monitor,3249,8000,4751,1,00473,India
196372,2023-10-14,502,iphone 15 pro max,100000,135000,35000,2,00473,India
389020,2023-10-14,504,iron,449,879,430,1,00092,India
389020,2023-10-14,506,monitor,3249,8000,4751,1,00092,India
389020,2023-10-14,507,washing machine,6990,16490,9500,1,00092,India
389020,2023-10-14,503,mixer,1349,3249,1900,1,00092,India
846129,2023-10-14,502,iphone 15 pro max,100000,135000,35000,2,00170,India
846129,2023-10-14,507,washing machine,6990,16490,9500,1,00170,India
540587,2023-10-14,502,iphone 15 pro max,100000,135000,35000,2,00436,India
801032,2023-10-14,506,monitor,3249,8000,4751,1,00127,India
316892,2023-10-14,504,iron,449,879,430,1,00100,India
316892,2023-10-14,506,monitor,3249,8000,4751,1,00100,India
447003,2023-10-14,506,monitor,3249,8000,4751,1,00220,India
579764,2023-10-14,506,monitor,3249,8000,4751,1,00400,India
579764,2023-10-14,503,mixer,1349,3249,1900,1,00400,India
579764,2023-10-14,504,iron,449,879,430,1,00400,India
579764,2023-10-14,501,iphone 15,60000,80000,20000,2,00400,India
972351,2023-10-14,505,oven,18490,24000,5510,1,00092,India
972351,2023-10-14,501,iphone 15,60000,80000,20000,2,00092,India
972351,2023-10-14,507,washing machine,6990,16490,9500,1,00092,India
384973,2023-10-14,504,iron,449,879,430,1,00456,India
384973,2023-10-14,506,monitor,3249,8000,4751,1,00456,India
803027,2023-10-14,503,mixer,1349,3249,1900,1,00257,India
803027,2023-10-14,501,iphone 15,60000,80000,20000,2,00257,India
803027,2023-10-14,505,oven,18490,24000,5510,1,00257,India
803027,2023-10-14,506,monitor,3249,8000,4751,1,00257,India
286343,2023-10-14,504,iron,449,879,430,1,00032,India
286343,2023-10-14,505,oven,18490,24000,5510,1,00032,India
289293,2023-10-14,501,iphone 15,60000,80000,20000,2,00336,India
433122,2023-10-14,506,monitor,3249,8000,4751,1,00381,India
433122,2023-10-14,505,oven,18490,24000,5510,1,00381,India
433122,2023-10-14,507,washing machine,6990,16490,9500,1,00381,India
433122,2023-10-14,502,iphone 15 pro max,100000,135000,35000,2,00381,India
206613,2023-10-14,504,iron,449,879,430,1,00352,India
206613,2023-10-14,503,mixer,1349,3249,1900,1,00352,India
206613,2023-10-14,502,iphone 15 pro max,100000,135000,35000,2,00352,India
206613,2023-10-14,505,oven,18490,24000,5510,1,00352,India
206613,2023-10-14,507,washing machine,6990,16490,9500,1,00352,India
848840,2023-10-14,504,iron,449,879,430,1,00375,India
762262,2023-10-14,505,oven,18490,24000,5510,1,00115,India
762262,2023-10-14,502,iphone 15 pro max,100000,135000,35000,2,00115,India
762262,2023-10-14,507,washing machine,6990,16490,9500,1,00115,India
762262,2023-10-14,503,mixer,1349,3249,1900,1,00115,India
327358,2023-10-14,505,oven,18490,24000,5510,1,00314,India
327358,2023-10-14,506,monitor,3249,8000,4751,1,00314,India
327358,2023-10-14,503,mixer,1349,3249,1900,1,00314,India
495675,2023-10-14,502,iphone 15 pro max,100000,135000,35000,2,00150,India
495675,2023-10-14,501,iphone 15,60000,80000,20000,2,00150,India
300393,2023-10-14,504,iron,449,879,430,1,00463,India
300393,2023-10-14,503,mixer,1349,3249,1900,1,00463,India
561125,2023-10-14,501,iphone 15,60000,80000,20000,2,00208,India
561125,2023-10-14,503,mixer,1349,3249,1900,1,00208,India
561125,2023-10-14,504,iron,449,879,430,1,00208,India
149669,2023-10-14,507,washing machine,6990,16490,9500,1,00391,India
149669,2023-10-14,505,oven,18490,24000,5510,1,00391,India
149669,2023-10-14,504,iron,449,879,430,1,00391,India
974193,2023-10-14,502,iphone 15 pro max,100000,135000,35000,2,00473,India
974193,2023-10-14,503,mixer,1349,3249,1900,1,00473,India
974193,2023-10-14,506,monitor,3249,8000,4751,1,00473,India
974193,2023-10-14,507,washing machine,6990,16490,9500,1,00473,India
534757,2023-10-14,504,iron,449,879,430,1,00419,India
534757,2023-10-14,501,iphone 15,60000,80000,20000,2,00419,India
534757,2023-10-14,506,monitor,3249,8000,4751,1,00419,India
534757,2023-10-14,507,washing machine,6990,16490,9500,1,00419,India
905814,2023-10-14,503,mixer,1349,3249,1900,1,00064,India
905814,2023-10-14,502,iphone 15 pro max,100000,135000,35000,2,00064,India
865990,2023-10-14,507,washing machine,6990,16490,9500,1,00404,India
552052,2023-10-14,503,mixer,1349,3249,1900,1,00040,India
552052,2023-10-14,504,iron,449,879,430,1,00040,India
552052,2023-10-14,506,monitor,3249,8000,4751,1,00040,India
215764,2023-10-14,501,iphone 15,60000,80000,20000,2,00225,India
215764,2023-10-14,503,mixer,1349,3249,1900,1,00225,India
215764,2023-10-14,504,iron,449,879,430,1,00225,India
696040,2023-10-14,506,monitor,3249,8000,4751,1,00304,India
956947,2023-10-14,507,washing machine,6990,16490,9500,1,00183,India
433340,2023-10-14,501,iphone 15,60000,80000,20000,2,00114,India
433340,2023-10-14,507,washing machine,6990,16490,9500,1,00114,India
705714,2023-10-14,507,washing machine,6990,16490,9500,1,00122,India
983793,2023-10-14,501,iphone 15,60000,80000,20000,2,00425,India
822053,2023-10-14,502,iphone 15 pro max,100000,135000,35000,2,00488,India
822053,2023-10-14,503,mixer,1349,3249,1900,1,00488,India
842068,2023-10-14,505,oven,18490,24000,5510,1,00479,India
115154,2023-10-14,501,iphone 15,60000,80000,20000,2,00435,India
115154,2023-10-14,506,monitor,3249,8000,4751,1,00435,India
115154,2023-10-14,504,iron,449,879,430,1,00435,India
317068,2023-10-14,501,iphone 15,60000,80000,20000,2,00081,India
317068,2023-10-14,502,iphone 15 pro max,100000,135000,35000,2,00081,India
317068,2023-10-14,503,mixer,1349,3249,1900,1,00081,India
948508,2023-10-14,504,iron,449,879,430,1,00456,India
948508,2023-10-14,501,iphone 15,60000,80000,20000,2,00456,India
948508,2023-10-14,503,mixer,1349,3249,1900,1,00456,India
119975,2023-10-14,503,mixer,1349,3249,1900,1,00112,India
509502,2023-10-14,506,monitor,3249,8000,4751,1,00259,India
509502,2023-10-14,502,iphone 15 pro max,100000,135000,35000,2,00259,India
204996,2023-10-14,505,oven,18490,24000,5510,1,00496,India
204996,2023-10-14,502,iphone 15 pro max,100000,135000,35000,2,00496,India
810938,2023-10-14,507,washing machine,6990,16490,9500,1,00396,India
810938,2023-10-14,504,iron,449,879,430,1,00396,India
810938,2023-10-14,502,iphone 15 pro max,100000,135000,35000,2,00396,India
129702,2023-10-14,501,iphone 15,60000,80000,20000,2,00478,India
129702,2023-10-14,502,iphone 15 pro max,100000,135000,35000,2,00478,India
129702,2023-10-14,507,washing machine,6990,16490,9500,1,00478,India
104455,2023-10-14,502,iphone 15 pro max,100000,135000,35000,2,00244,India
652207,2023-10-14,502,iphone 15 pro max,100000,135000,35000,2,00034,India
716217,2023-10-14,506,monitor,3249,8000,4751,1,00163,India
716217,2023-10-14,501,iphone 15,60000,80000,20000,2,00163,India
716217,2023-10-14,507,washing machine,6990,16490,9500,1,00163,India
868713,2023-10-15,507,washing machine,6990,16490,9500,1,00162,India
868713,2023-10-15,502,iphone 15 pro max,100000,135000,35000,2,00162,India
868713,2023-10-15,501,iphone 15,60000,80000,20000,2,00162,India
522937,2023-10-15,502,iphone 15 pro max,100000,135000,35000,2,00378,India
579551,2023-10-15,506,monitor,3249,8000,4751,1,00013,India
579551,2023-10-15,504,iron,449,879,430,1,00013,India
249804,2023-10-15,503,mixer,1349,3249,1900,1,00489,India
249804,2023-10-15,501,iphone 15,60000,80000,20000,2,00489,India
249804,2023-10-15,505,oven,18490,24000,5510,1,00489,India
239857,2023-10-15,505,oven,18490,24000,5510,1,00215,India
239857,2023-10-15,504,iron,449,879,430,1,00215,India
684527,2023-10-15,506,monitor,3249,8000,4751,1,00202,India
684527,2023-10-15,507,washing machine,6990,16490,9500,1,00202,India
170022,2023-10-15,504,iron,449,879,430,1,00178,India
170022,2023-10-15,506,monitor,3249,8000,4751,1,00178,India
958056,2023-10-15,505,oven,18490,24000,5510,1,00063,India
958056,2023-10-15,503,mixer,1349,3249,1900,1,00063,India
602951,2023-10-15,501,iphone 15,60000,80000,20000,2,00414,India
602951,2023-10-15,502,iphone 15 pro max,100000,135000,35000,2,00414,India
602951,2023-10-15,506,monitor,3249,8000,4751,1,00414,India
218065,2023-10-15,505,oven,18490,24000,5510,1,00071,India
218065,2023-10-15,506,monitor,3249,8000,4751,1,00071,India
218065,2023-10-15,503,mixer,1349,3249,1900,1,00071,India
218065,2023-10-15,504,iron,449,879,430,1,00071,India
663391,2023-10-15,503,mixer,1349,3249,1900,1,00334,India
663391,2023-10-15,501,iphone 15,60000,80000,20000,2,00334,India
663391,2023-10-15,507,washing machine,6990,16490,9500,1,00334,India
464839,2023-10-15,506,monitor,3249,8000,4751,1,00427,India
464839,2023-10-15,501,iphone 15,60000,80000,20000,2,00427,India
759144,2023-10-15,501,iphone 15,60000,80000,20000,2,00152,India
759144,2023-10-15,504,iron,449,879,430,1,00152,India
759144,2023-10-15,506,monitor,3249,8000,4751,1,00152,India
759144,2023-10-15,505,oven,18490,24000,5510,1,00152,India
268428,2023-10-15,507,washing machine,6990,16490,9500,1,00420,India
268428,2023-10-15,505,oven,18490,24000,5510,1,00420,India
268428,2023-10-15,501,iphone 15,60000,80000,20000,2,00420,India
495896,2023-10-15,504,iron,449,879,430,1,00482,India
495896,2023-10-15,501,iphone 15,60000,80000,20000,2,00482,India
495896,2023-10-15,503,mixer,1349,3249,1900,1,00482,India
131725,2023-10-15,501,iphone 15,60000,80000,20000,2,00112,India
234194,2023-10-15,505,oven,18490,24000,5510,1,00057,India
234194,2023-10-15,503,mixer,1349,3249,1900,1,00057,India
234194,2023-10-15,501,iphone 15,60000,80000,20000,2,00057,India
333216,2023-10-15,502,iphone 15 pro max,100000,135000,35000,2,00280,India
333216,2023-10-15,504,iron,449,879,430,1,00280,India
112492,2023-10-15,504,iron,449,879,430,1,00135,India
112492,2023-10-15,503,mixer,1349,3249,1900,1,00135,India
795825,2023-10-15,506,monitor,3249,8000,4751,1,00241,India
795825,2023-10-15,505,oven,18490,24000,5510,1,00241,India
839023,2023-10-15,507,washing machine,6990,16490,9500,1,00353,India
839023,2023-10-15,505,oven,18490,24000,5510,1,00353,India
839023,2023-10-15,502,iphone 15 pro max,100000,135000,35000,2,00353,India
839023,2023-10-15,503,mixer,1349,3249,1900,1,00353,India
260351,2023-10-15,504,iron,449,879,430,1,00296,India
260351,2023-10-15,503,mixer,1349,3249,1900,1,00296,India
260351,2023-10-15,505,oven,18490,24000,5510,1,00296,India
260351,2023-10-15,507,washing machine,6990,16490,9500,1,00296,India
376263,2023-10-15,504,iron,449,879,430,1,00421,India
376263,2023-10-15,501,iphone 15,60000,80000,20000,2,00421,India
376263,2023-10-15,506,monitor,3249,8000,4751,1,00421,India
735964,2023-10-15,505,oven,18490,24000,5510,1,00193,India
735964,2023-10-15,501,iphone 15,60000,80000,20000,2,00193,India
690829,2023-10-15,506,monitor,3249,8000,4751,1,00105,India
690829,2023-10-15,503,mixer,1349,3249,1900,1,00105,India
690829,2023-10-15,507,washing machine,6990,16490,9500,1,00105,India
655070,2023-10-15,506,monitor,3249,8000,4751,1,00091,India
655070,2023-10-15,503,mixer,1349,3249,1900,1,00091,India
598789,2023-10-15,505,oven,18490,24000,5510,1,00494,India
598789,2023-10-15,501,iphone 15,60000,80000,20000,2,00494,India
598789,2023-10-15,506,monitor,3249,8000,4751,1,00494,India
598789,2023-10-15,504,iron,449,879,430,1,00494,India
598789,2023-10-15,502,iphone 15 pro max,100000,135000,35000,2,00494,India
894958,2023-10-15,501,iphone 15,60000,80000,20000,2,00477,India
894958,2023-10-15,504,iron,449,879,430,1,00477,India
894958,2023-10-15,506,monitor,3249,8000,4751,1,00477,India
894958,2023-10-15,505,oven,18490,24000,5510,1,00477,India
894958,2023-10-15,507,washing machine,6990,16490,9500,1,00477,India
133020,2023-10-15,503,mixer,1349,3249,1900,1,00052,India
133020,2023-10-15,506,monitor,3249,8000,4751,1,00052,India
120988,2023-10-15,507,washing machine,6990,16490,9500,1,00085,India
120988,2023-10-15,502,iphone 15 pro max,100000,135000,35000,2,00085,India
120988,2023-10-15,504,iron,449,879,430,1,00085,India
120988,2023-10-15,501,iphone 15,60000,80000,20000,2,00085,India
944229,2023-10-15,502,iphone 15 pro max,100000,135000,35000,2,00219,India
944229,2023-10-15,507,washing machine,6990,16490,9500,1,00219,India
694130,2023-10-15,503,mixer,1349,3249,1900,1,00035,India
694130,2023-10-15,501,iphone 15,60000,80000,20000,2,00035,India
828993,2023-10-15,501,iphone 15,60000,80000,20000,2,00473,India
828993,2023-10-15,507,washing machine,6990,16490,9500,1,00473,India
828993,2023-10-15,505,oven,18490,24000,5510,1,00473,India
585510,2023-10-15,502,iphone 15 pro max,100000,135000,35000,2,00107,India
585510,2023-10-15,501,iphone 15,60000,80000,20000,2,00107,India
695280,2023-10-15,504,iron,449,879,430,1,00093,India
695280,2023-10-15,506,monitor,3249,8000,4751,1,00093,India
518032,2023-10-15,503,mixer,1349,3249,1900,1,00166,India
518032,2023-10-15,506,monitor,3249,8000,4751,1,00166,India
300387,2023-10-15,505,oven,18490,24000,5510,1,00310,India
662559,2023-10-15,501,iphone 15,60000,80000,20000,2,00151,India
662559,2023-10-15,507,washing machine,6990,16490,9500,1,00151,India
662559,2023-10-15,503,mixer,1349,3249,1900,1,00151,India
542274,2023-10-15,503,mixer,1349,3249,1900,1,00122,India
542274,2023-10-15,501,iphone 15,60000,80000,20000,2,00122,India
542274,2023-10-15,505,oven,18490,24000,5510,1,00122,India
189756,2023-10-15,505,oven,18490,24000,5510,1,00114,India
189756,2023-10-15,507,washing machine,6990,16490,9500,1,00114,India
189756,2023-10-15,502,iphone 15 pro max,100000,135000,35000,2,00114,India
482238,2023-10-15,506,monitor,3249,8000,4751,1,00295,India
482238,2023-10-15,503,mixer,1349,3249,1900,1,00295,India
100831,2023-10-15,502,iphone 15 pro max,100000,135000,35000,2,00310,India
100831,2023-10-15,506,monitor,3249,8000,4751,1,00310,India
236394,2023-10-15,506,monitor,3249,8000,4751,1,00128,India
977220,2023-10-15,503,mixer,1349,3249,1900,1,00322,India
977220,2023-10-15,505,oven,18490,24000,5510,1,00322,India
977220,2023-10-15,507,washing machine,6990,16490,9500,1,00322,India
977220,2023-10-15,502,iphone 15 pro max,100000,135000,35000,2,00322,India
977220,2023-10-15,501,iphone 15,60000,80000,20000,2,00322,India
167968,2023-10-15,502,iphone 15 pro max,100000,135000,35000,2,00180,India
167968,2023-10-15,506,monitor,3249,8000,4751,1,00180,India
167968,2023-10-15,507,washing machine,6990,16490,9500,1,00180,India
167968,2023-10-15,505,oven,18490,24000,5510,1,00180,India
167968,2023-10-15,501,iphone 15,60000,80000,20000,2,00180,India
215396,2023-10-15,502,iphone 15 pro max,100000,135000,35000,2,00081,India
215396,2023-10-15,501,iphone 15,60000,80000,20000,2,00081,India
215396,2023-10-15,507,washing machine,6990,16490,9500,1,00081,India
215396,2023-10-15,505,oven,18490,24000,5510,1,00081,India
162906,2023-10-15,501,iphone 15,60000,80000,20000,2,00014,India
162906,2023-10-15,506,monitor,3249,8000,4751,1,00014,India
162906,2023-10-15,502,iphone 15 pro max,100000,135000,35000,2,00014,India
162906,2023-10-15,507,washing machine,6990,16490,9500,1,00014,India
162906,2023-10-15,504,iron,449,879,430,1,00014,India
759120,2023-10-15,503,mixer,1349,3249,1900,1,00171,India
759120,2023-10-15,506,monitor,3249,8000,4751,1,00171,India
132802,2023-10-15,502,iphone 15 pro max,100000,135000,35000,2,00466,India
132802,2023-10-15,506,monitor,3249,8000,4751,1,00466,India
132802,2023-10-15,507,washing machine,6990,16490,9500,1,00466,India
132802,2023-10-15,503,mixer,1349,3249,1900,1,00466,India
475891,2023-10-15,503,mixer,1349,3249,1900,1,00491,India
475891,2023-10-15,502,iphone 15 pro max,100000,135000,35000,2,00491,India
229471,2023-10-15,507,washing machine,6990,16490,9500,1,00109,India
229471,2023-10-15,501,iphone 15,60000,80000,20000,2,00109,India
983171,2023-10-15,502,iphone 15 pro max,100000,135000,35000,2,00187,India
983171,2023-10-15,505,oven,18490,24000,5510,1,00187,India
333580,2023-10-15,503,mixer,1349,3249,1900,1,00016,India
709608,2023-10-15,504,iron,449,879,430,1,00155,India
709608,2023-10-15,502,iphone 15 pro max,100000,135000,35000,2,00155,India
856738,2023-10-15,503,mixer,1349,3249,1900,1,00484,India
541786,2023-10-15,507,washing machine,6990,16490,9500,1,00428,India
541786,2023-10-15,501,iphone 15,60000,80000,20000,2,00428,India
266305,2023-10-15,505,oven,18490,24000,5510,1,00266,India
975005,2023-10-15,502,iphone 15 pro max,100000,135000,35000,2,00217,India
975005,2023-10-15,501,iphone 15,60000,80000,20000,2,00217,India
807024,2023-10-15,503,mixer,1349,3249,1900,1,00290,India
807024,2023-10-15,507,washing machine,6990,16490,9500,1,00290,India
807024,2023-10-15,505,oven,18490,24000,5510,1,00290,India
984043,2023-10-15,502,iphone 15 pro max,100000,135000,35000,2,00339,India
984043,2023-10-15,503,mixer,1349,3249,1900,1,00339,India
984043,2023-10-15,506,monitor,3249,8000,4751,1,00339,India
201413,2023-10-15,502,iphone 15 pro max,100000,135000,35000,2,00155,India
167614,2023-10-15,502,iphone 15 pro max,100000,135000,35000,2,00257,India
167614,2023-10-15,503,mixer,1349,3249,1900,1,00257,India
145558,2023-10-15,503,mixer,1349,3249,1900,1,00433,India
145558,2023-10-15,501,iphone 15,60000,80000,20000,2,00433,India
145558,2023-10-15,505,oven,18490,24000,5510,1,00433,India
333451,2023-10-15,507,washing machine,6990,16490,9500,1,00453,India
333451,2023-10-15,506,monitor,3249,8000,4751,1,00453,India
506842,2023-10-15,504,iron,449,879,430,1,00037,India
806494,2023-10-15,503,mixer,1349,3249,1900,1,00048,India
806494,2023-10-15,506,monitor,3249,8000,4751,1,00048,India
806494,2023-10-15,505,oven,18490,24000,5510,1,00048,India
792476,2023-10-15,505,oven,18490,24000,5510,1,00461,India
792476,2023-10-15,504,iron,449,879,430,1,00461,India
758731,2023-10-15,503,mixer,1349,3249,1900,1,00423,India
758731,2023-10-15,501,iphone 15,60000,80000,20000,2,00423,India
758731,2023-10-15,506,monitor,3249,8000,4751,1,00423,India
758731,2023-10-15,505,oven,18490,24000,5510,1,00423,India
804661,2023-10-15,502,iphone 15 pro max,100000,135000,35000,2,00107,India
804661,2023-10-15,501,iphone 15,60000,80000,20000,2,00107,India
804661,2023-10-15,505,oven,18490,24000,5510,1,00107,India
804661,2023-10-15,504,iron,449,879,430,1,00107,India
470309,2023-10-15,506,monitor,3249,8000,4751,1,00466,India
470309,2023-10-15,507,washing machine,6990,16490,9500,1,00466,India
787944,2023-10-15,507,washing machine,6990,16490,9500,1,00112,India
711038,2023-10-15,501,iphone 15,60000,80000,20000,2,00067,India
711038,2023-10-15,505,oven,18490,24000,5510,1,00067,India
711038,2023-10-15,506,monitor,3249,8000,4751,1,00067,India
742544,2023-10-15,502,iphone 15 pro max,100000,135000,35000,2,00253,India
742544,2023-10-15,503,mixer,1349,3249,1900,1,00253,India
742544,2023-10-15,504,iron,449,879,430,1,00253,India
488690,2023-10-15,505,oven,18490,24000,5510,1,00388,India
488690,2023-10-15,507,washing machine,6990,16490,9500,1,00388,India
488690,2023-10-15,501,iphone 15,60000,80000,20000,2,00388,India
603054,2023-10-15,507,washing machine,6990,16490,9500,1,00497,India
603054,2023-10-15,506,monitor,3249,8000,4751,1,00497,India
603054,2023-10-15,505,oven,18490,24000,5510,1,00497,India
603054,2023-10-15,504,iron,449,879,430,1,00497,India
329621,2023-10-15,506,monitor,3249,8000,4751,1,00365,India
329621,2023-10-15,501,iphone 15,60000,80000,20000,2,00365,India
427248,2023-10-15,505,oven,18490,24000,5510,1,00069,India
427248,2023-10-15,504,iron,449,879,430,1,00069,India
427248,2023-10-15,507,washing machine,6990,16490,9500,1,00069,India
567953,2023-10-15,503,mixer,1349,3249,1900,1,00295,India
567953,2023-10-15,506,monitor,3249,8000,4751,1,00295,India
567953,2023-10-15,507,washing machine,6990,16490,9500,1,00295,India
346834,2023-10-15,504,iron,449,879,430,1,00230,India
346834,2023-10-15,505,oven,18490,24000,5510,1,00230,India
346834,2023-10-15,507,washing machine,6990,16490,9500,1,00230,India
475936,2023-10-15,506,monitor,3249,8000,4751,1,00123,India
475936,2023-10-15,507,washing machine,6990,16490,9500,1,00123,India
475936,2023-10-15,501,iphone 15,60000,80000,20000,2,00123,India
475936,2023-10-15,505,oven,18490,24000,5510,1,00123,India
451021,2023-10-16,503,mixer,1349,3249,1900,1,00440,India
451021,2023-10-16,507,washing machine,6990,16490,9500,1,00440,India
451021,2023-10-16,504,iron,449,879,430,1,00440,India
722759,2023-10-16,503,mixer,1349,3249,1900,1,00075,India
722759,2023-10-16,501,iphone 15,60000,80000,20000,2,00075,India
878669,2023-10-16,505,oven,18490,24000,5510,1,00422,India
878669,2023-10-16,504,iron,449,879,430,1,00422,India
944657,2023-10-16,504,iron,449,879,430,1,00033,India
944657,2023-10-16,507,washing machine,6990,16490,9500,1,00033,India
498542,2023-10-16,505,oven,18490,24000,5510,1,00257,India
762225,2023-10-16,503,mixer,1349,3249,1900,1,00422,India
762225,2023-10-16,502,iphone 15 pro max,100000,135000,35000,2,00422,India
359423,2023-10-16,506,monitor,3249,8000,4751,1,00277,India
359423,2023-10-16,502,iphone 15 pro max,100000,135000,35000,2,00277,India
359423,2023-10-16,504,iron,449,879,430,1,00277,India
264098,2023-10-16,503,mixer,1349,3249,1900,1,00193,India
264098,2023-10-16,505,oven,18490,24000,5510,1,00193,India
264098,2023-10-16,506,monitor,3249,8000,4751,1,00193,India
264098,2023-10-16,502,iphone 15 pro max,100000,135000,35000,2,00193,India
264098,2023-10-16,507,washing machine,6990,16490,9500,1,00193,India
715318,2023-10-16,505,oven,18490,24000,5510,1,00295,India
346867,2023-10-16,506,monitor,3249,8000,4751,1,00241,India
346867,2023-10-16,501,iphone 15,60000,80000,20000,2,00241,India
346867,2023-10-16,502,iphone 15 pro max,100000,135000,35000,2,00241,India
212528,2023-10-16,501,iphone 15,60000,80000,20000,2,00395,India
212528,2023-10-16,503,mixer,1349,3249,1900,1,00395,India
212528,2023-10-16,507,washing machine,6990,16490,9500,1,00395,India
738082,2023-10-16,507,washing machine,6990,16490,9500,1,00112,India
738082,2023-10-16,506,monitor,3249,8000,4751,1,00112,India
738082,2023-10-16,504,iron,449,879,430,1,00112,India
886745,2023-10-16,507,washing machine,6990,16490,9500,1,00138,India
886745,2023-10-16,502,iphone 15 pro max,100000,135000,35000,2,00138,India
886745,2023-10-16,504,iron,449,879,430,1,00138,India
103056,2023-10-16,507,washing machine,6990,16490,9500,1,00443,India
103056,2023-10-16,502,iphone 15 pro max,100000,135000,35000,2,00443,India
619357,2023-10-16,503,mixer,1349,3249,1900,1,00045,India
619357,2023-10-16,505,oven,18490,24000,5510,1,00045,India
548315,2023-10-16,501,iphone 15,60000,80000,20000,2,00339,India
548315,2023-10-16,507,washing machine,6990,16490,9500,1,00339,India
548315,2023-10-16,502,iphone 15 pro max,100000,135000,35000,2,00339,India
548315,2023-10-16,506,monitor,3249,8000,4751,1,00339,India
548315,2023-10-16,505,oven,18490,24000,5510,1,00339,India
593125,2023-10-16,506,monitor,3249,8000,4751,1,00182,India
593125,2023-10-16,505,oven,18490,24000,5510,1,00182,India
290406,2023-10-16,501,iphone 15,60000,80000,20000,2,00463,India
494514,2023-10-16,503,mixer,1349,3249,1900,1,00171,India
494514,2023-10-16,506,monitor,3249,8000,4751,1,00171,India
559603,2023-10-16,503,mixer,1349,3249,1900,1,00372,India
559603,2023-10-16,505,oven,18490,24000,5510,1,00372,India
559603,2023-10-16,502,iphone 15 pro max,100000,135000,35000,2,00372,India
559603,2023-10-16,507,washing machine,6990,16490,9500,1,00372,India
972504,2023-10-16,506,monitor,3249,8000,4751,1,00036,India
972504,2023-10-16,504,iron,449,879,430,1,00036,India
972504,2023-10-16,502,iphone 15 pro max,100000,135000,35000,2,00036,India
999755,2023-10-16,507,washing machine,6990,16490,9500,1,00370,India
999755,2023-10-16,501,iphone 15,60000,80000,20000,2,00370,India
999755,2023-10-16,503,mixer,1349,3249,1900,1,00370,India
999755,2023-10-16,505,oven,18490,24000,5510,1,00370,India
929282,2023-10-16,507,washing machine,6990,16490,9500,1,00424,India
834903,2023-10-16,502,iphone 15 pro max,100000,135000,35000,2,00229,India
834903,2023-10-16,501,iphone 15,60000,80000,20000,2,00229,India
834903,2023-10-16,503,mixer,1349,3249,1900,1,00229,India
539449,2023-10-16,501,iphone 15,60000,80000,20000,2,00043,India
539449,2023-10-16,503,mixer,1349,3249,1900,1,00043,India
539449,2023-10-16,507,washing machine,6990,16490,9500,1,00043,India
539449,2023-10-16,502,iphone 15 pro max,100000,135000,35000,2,00043,India
926810,2023-10-16,504,iron,449,879,430,1,00188,India
926810,2023-10-16,505,oven,18490,24000,5510,1,00188,India
263332,2023-10-16,503,mixer,1349,3249,1900,1,00174,India
263332,2023-10-16,504,iron,449,879,430,1,00174,India
263332,2023-10-16,502,iphone 15 pro max,100000,135000,35000,2,00174,India
672087,2023-10-16,505,oven,18490,24000,5510,1,00484,India
963582,2023-10-16,507,washing machine,6990,16490,9500,1,00011,India
392372,2023-10-16,501,iphone 15,60000,80000,20000,2,00394,India
283653,2023-10-16,504,iron,449,879,430,1,00331,India
883089,2023-10-16,505,oven,18490,24000,5510,1,00058,India
883089,2023-10-16,501,iphone 15,60000,80000,20000,2,00058,India
490015,2023-10-16,501,iphone 15,60000,80000,20000,2,00147,India
490015,2023-10-16,503,mixer,1349,3249,1900,1,00147,India
145180,2023-10-16,503,mixer,1349,3249,1900,1,00489,India
145180,2023-10-16,506,monitor,3249,8000,4751,1,00489,India
145180,2023-10-16,505,oven,18490,24000,5510,1,00489,India
602997,2023-10-16,506,monitor,3249,8000,4751,1,00137,India
450501,2023-10-16,503,mixer,1349,3249,1900,1,00453,India
450501,2023-10-16,505,oven,18490,24000,5510,1,00453,India
450501,2023-10-16,502,iphone 15 pro max,100000,135000,35000,2,00453,India
450501,2023-10-16,501,iphone 15,60000,80000,20000,2,00453,India
524851,2023-10-16,505,oven,18490,24000,5510,1,00194,India
754757,2023-10-16,507,washing machine,6990,16490,9500,1,00347,India
628988,2023-10-16,506,monitor,3249,8000,4751,1,00131,India
628988,2023-10-16,502,iphone 15 pro max,100000,135000,35000,2,00131,India
352193,2023-10-16,506,monitor,3249,8000,4751,1,00311,India
352193,2023-10-16,502,iphone 15 pro max,100000,135000,35000,2,00311,India
740822,2023-10-16,505,oven,18490,24000,5510,1,00006,India
740822,2023-10-16,501,iphone 15,60000,80000,20000,2,00006,India
740822,2023-10-16,504,iron,449,879,430,1,00006,India
318746,2023-10-16,502,iphone 15 pro max,100000,135000,35000,2,00035,India
318746,2023-10-16,501,iphone 15,60000,80000,20000,2,00035,India
318746,2023-10-16,504,iron,449,879,430,1,00035,India
318746,2023-10-16,507,washing machine,6990,16490,9500,1,00035,India
794257,2023-10-16,501,iphone 15,60000,80000,20000,2,00457,India
794257,2023-10-16,502,iphone 15 pro max,100000,135000,35000,2,00457,India
591157,2023-10-16,507,washing machine,6990,16490,9500,1,00212,India
591157,2023-10-16,504,iron,449,879,430,1,00212,India
591157,2023-10-16,501,iphone 15,60000,80000,20000,2,00212,India
183686,2023-10-16,505,oven,18490,24000,5510,1,00395,India
183686,2023-10-16,504,iron,449,879,430,1,00395,India
465315,2023-10-16,504,iron,449,879,430,1,00297,India
465315,2023-10-16,505,oven,18490,24000,5510,1,00297,India
465315,2023-10-16,503,mixer,1349,3249,1900,1,00297,India
909556,2023-10-16,504,iron,449,879,430,1,00233,India
909556,2023-10-16,502,iphone 15 pro max,100000,135000,35000,2,00233,India
708705,2023-10-16,506,monitor,3249,8000,4751,1,00217,India
708705,2023-10-16,505,oven,18490,24000,5510,1,00217,India
341469,2023-10-16,502,iphone 15 pro max,100000,135000,35000,2,00421,India
375498,2023-10-16,503,mixer,1349,3249,1900,1,00218,India
375498,2023-10-16,507,washing machine,6990,16490,9500,1,00218,India
120111,2023-10-16,502,iphone 15 pro max,100000,135000,35000,2,00291,India
120111,2023-10-16,501,iphone 15,60000,80000,20000,2,00291,India
120111,2023-10-16,506,monitor,3249,8000,4751,1,00291,India
845136,2023-10-16,502,iphone 15 pro max,100000,135000,35000,2,00112,India
845136,2023-10-16,506,monitor,3249,8000,4751,1,00112,India
845136,2023-10-16,505,oven,18490,24000,5510,1,00112,India
192209,2023-10-16,506,monitor,3249,8000,4751,1,00224,India
192209,2023-10-16,507,washing machine,6990,16490,9500,1,00224,India
192209,2023-10-16,503,mixer,1349,3249,1900,1,00224,India
192209,2023-10-16,505,oven,18490,24000,5510,1,00224,India
708033,2023-10-16,502,iphone 15 pro max,100000,135000,35000,2,00430,India
708033,2023-10-16,507,washing machine,6990,16490,9500,1,00430,India
708033,2023-10-16,505,oven,18490,24000,5510,1,00430,India
426103,2023-10-16,507,washing machine,6990,16490,9500,1,00222,India
426103,2023-10-16,503,mixer,1349,3249,1900,1,00222,India
426103,2023-10-16,505,oven,18490,24000,5510,1,00222,India
426103,2023-10-16,502,iphone 15 pro max,100000,135000,35000,2,00222,India
460081,2023-10-16,505,oven,18490,24000,5510,1,00215,India
460081,2023-10-16,504,iron,449,879,430,1,00215,India
905044,2023-10-16,504,iron,449,879,430,1,00445,India
905044,2023-10-16,507,washing machine,6990,16490,9500,1,00445,India
905044,2023-10-16,502,iphone 15 pro max,100000,135000,35000,2,00445,India
733216,2023-10-16,506,monitor,3249,8000,4751,1,00452,India
733216,2023-10-16,502,iphone 15 pro max,100000,135000,35000,2,00452,India
718177,2023-10-16,502,iphone 15 pro max,100000,135000,35000,2,00024,India
718177,2023-10-16,501,iphone 15,60000,80000,20000,2,00024,India
674765,2023-10-16,505,oven,18490,24000,5510,1,00173,India
674765,2023-10-16,507,washing machine,6990,16490,9500,1,00173,India
674765,2023-10-16,503,mixer,1349,3249,1900,1,00173,India
674765,2023-10-16,506,monitor,3249,8000,4751,1,00173,India
440251,2023-10-16,502,iphone 15 pro max,100000,135000,35000,2,00442,India
601104,2023-10-16,505,oven,18490,24000,5510,1,00313,India
601104,2023-10-16,503,mixer,1349,3249,1900,1,00313,India
840486,2023-10-16,502,iphone 15 pro max,100000,135000,35000,2,00075,India
945228,2023-10-16,502,iphone 15 pro max,100000,135000,35000,2,00218,India
186895,2023-10-16,506,monitor,3249,8000,4751,1,00363,India
186895,2023-10-16,505,oven,18490,24000,5510,1,00363,India
186895,2023-10-16,507,washing machine,6990,16490,9500,1,00363,India
842637,2023-10-16,502,iphone 15 pro max,100000,135000,35000,2,00063,India
842637,2023-10-16,505,oven,18490,24000,5510,1,00063,India
842637,2023-10-16,506,monitor,3249,8000,4751,1,00063,India
784399,2023-10-16,506,monitor,3249,8000,4751,1,00486,India
784399,2023-10-16,503,mixer,1349,3249,1900,1,00486,India
784399,2023-10-16,505,oven,18490,24000,5510,1,00486,India
455438,2023-10-16,504,iron,449,879,430,1,00029,India
455438,2023-10-16,502,iphone 15 pro max,100000,135000,35000,2,00029,India
455438,2023-10-16,505,oven,18490,24000,5510,1,00029,India
455438,2023-10-16,501,iphone 15,60000,80000,20000,2,00029,India
554542,2023-10-16,503,mixer,1349,3249,1900,1,00044,India
399828,2023-10-16,506,monitor,3249,8000,4751,1,00238,India
399828,2023-10-16,504,iron,449,879,430,1,00238,India
399828,2023-10-16,507,washing machine,6990,16490,9500,1,00238,India
749578,2023-10-16,504,iron,449,879,430,1,00389,India
937704,2023-10-16,507,washing machine,6990,16490,9500,1,00047,India
937704,2023-10-16,502,iphone 15 pro max,100000,135000,35000,2,00047,India
576549,2023-10-16,507,washing machine,6990,16490,9500,1,00371,India
576549,2023-10-16,502,iphone 15 pro max,100000,135000,35000,2,00371,India
956967,2023-10-16,504,iron,449,879,430,1,00445,India
956967,2023-10-16,507,washing machine,6990,16490,9500,1,00445,India
956967,2023-10-16,502,iphone 15 pro max,100000,135000,35000,2,00445,India
654790,2023-10-16,507,washing machine,6990,16490,9500,1,00109,India
654790,2023-10-16,503,mixer,1349,3249,1900,1,00109,India
226509,2023-10-16,504,iron,449,879,430,1,00311,India
226509,2023-10-16,503,mixer,1349,3249,1900,1,00311,India
226509,2023-10-16,505,oven,18490,24000,5510,1,00311,India
226509,2023-10-16,502,iphone 15 pro max,100000,135000,35000,2,00311,India
933770,2023-10-16,505,oven,18490,24000,5510,1,00387,India
933770,2023-10-16,501,iphone 15,60000,80000,20000,2,00387,India
933770,2023-10-16,504,iron,449,879,430,1,00387,India
933770,2023-10-16,507,washing machine,6990,16490,9500,1,00387,India
927599,2023-10-16,503,mixer,1349,3249,1900,1,00421,India
927599,2023-10-16,504,iron,449,879,430,1,00421,India
927599,2023-10-16,505,oven,18490,24000,5510,1,00421,India
460969,2023-10-16,504,iron,449,879,430,1,00255,India
460969,2023-10-16,505,oven,18490,24000,5510,1,00255,India
460969,2023-10-16,502,iphone 15 pro max,100000,135000,35000,2,00255,India
923698,2023-10-16,502,iphone 15 pro max,100000,135000,35000,2,00311,India
923698,2023-10-16,504,iron,449,879,430,1,00311,India
923698,2023-10-16,503,mixer,1349,3249,1900,1,00311,India
923698,2023-10-16,501,iphone 15,60000,80000,20000,2,00311,India
627574,2023-10-16,504,iron,449,879,430,1,00209,India
833801,2023-10-16,501,iphone 15,60000,80000,20000,2,00419,India
833801,2023-10-16,504,iron,449,879,430,1,00419,India
163204,2023-10-17,505,oven,18490,24000,5510,1,00429,India
163204,2023-10-17,507,washing machine,6990,16490,9500,1,00429,India
163204,2023-10-17,504,iron,449,879,430,1,00429,India
987902,2023-10-17,505,oven,18490,24000,5510,1,00127,India
987902,2023-10-17,504,iron,449,879,430,1,00127,India
987902,2023-10-17,506,monitor,3249,8000,4751,1,00127,India
330122,2023-10-17,502,iphone 15 pro max,100000,135000,35000,2,00219,India
759671,2023-10-17,503,mixer,1349,3249,1900,1,00262,India
759671,2023-10-17,505,oven,18490,24000,5510,1,00262,India
150673,2023-10-17,507,washing machine,6990,16490,9500,1,00112,India
150673,2023-10-17,502,iphone 15 pro max,100000,135000,35000,2,00112,India
150673,2023-10-17,505,oven,18490,24000,5510,1,00112,India
150673,2023-10-17,503,mixer,1349,3249,1900,1,00112,India
310219,2023-10-17,505,oven,18490,24000,5510,1,00207,India
310219,2023-10-17,502,iphone 15 pro max,100000,135000,35000,2,00207,India
310219,2023-10-17,507,washing machine,6990,16490,9500,1,00207,India
719861,2023-10-17,501,iphone 15,60000,80000,20000,2,00414,India
719861,2023-10-17,505,oven,18490,24000,5510,1,00414,India
719861,2023-10-17,502,iphone 15 pro max,100000,135000,35000,2,00414,India
499783,2023-10-17,503,mixer,1349,3249,1900,1,00382,India
499783,2023-10-17,504,iron,449,879,430,1,00382,India
499783,2023-10-17,505,oven,18490,24000,5510,1,00382,India
270931,2023-10-17,505,oven,18490,24000,5510,1,00143,India
270931,2023-10-17,506,monitor,3249,8000,4751,1,00143,India
270931,2023-10-17,503,mixer,1349,3249,1900,1,00143,India
249751,2023-10-17,504,iron,449,879,430,1,00031,India
249751,2023-10-17,502,iphone 15 pro max,100000,135000,35000,2,00031,India
717395,2023-10-17,504,iron,449,879,430,1,00382,India
717395,2023-10-17,502,iphone 15 pro max,100000,135000,35000,2,00382,India
717395,2023-10-17,507,washing machine,6990,16490,9500,1,00382,India
935544,2023-10-17,505,oven,18490,24000,5510,1,00426,India
935544,2023-10-17,501,iphone 15,60000,80000,20000,2,00426,India
935544,2023-10-17,503,mixer,1349,3249,1900,1,00426,India
454606,2023-10-17,507,washing machine,6990,16490,9500,1,00205,India
295171,2023-10-17,505,oven,18490,24000,5510,1,00415,India
191001,2023-10-17,506,monitor,3249,8000,4751,1,00206,India
191001,2023-10-17,507,washing machine,6990,16490,9500,1,00206,India
191001,2023-10-17,502,iphone 15 pro max,100000,135000,35000,2,00206,India
191001,2023-10-17,504,iron,449,879,430,1,00206,India
920895,2023-10-17,503,mixer,1349,3249,1900,1,00038,India
920895,2023-10-17,504,iron,449,879,430,1,00038,India
920895,2023-10-17,502,iphone 15 pro max,100000,135000,35000,2,00038,India
427365,2023-10-17,503,mixer,1349,3249,1900,1,00417,India
427365,2023-10-17,501,iphone 15,60000,80000,20000,2,00417,India
427365,2023-10-17,504,iron,449,879,430,1,00417,India
427365,2023-10-17,506,monitor,3249,8000,4751,1,00417,India
143094,2023-10-17,507,washing machine,6990,16490,9500,1,00313,India
637006,2023-10-17,507,washing machine,6990,16490,9500,1,00497,India
128774,2023-10-17,507,washing machine,6990,16490,9500,1,00338,India
128774,2023-10-17,506,monitor,3249,8000,4751,1,00338,India
128774,2023-10-17,504,iron,449,879,430,1,00338,India
128774,2023-10-17,501,iphone 15,60000,80000,20000,2,00338,India
793558,2023-10-17,502,iphone 15 pro max,100000,135000,35000,2,00490,India
560676,2023-10-17,504,iron,449,879,430,1,00241,India
560676,2023-10-17,505,oven,18490,24000,5510,1,00241,India
560676,2023-10-17,501,iphone 15,60000,80000,20000,2,00241,India
300401,2023-10-17,507,washing machine,6990,16490,9500,1,00024,India
300401,2023-10-17,503,mixer,1349,3249,1900,1,00024,India
314676,2023-10-17,501,iphone 15,60000,80000,20000,2,00212,India
127456,2023-10-17,507,washing machine,6990,16490,9500,1,00342,India
127456,2023-10-17,504,iron,449,879,430,1,00342,India
750991,2023-10-17,507,washing machine,6990,16490,9500,1,00492,India
750991,2023-10-17,502,iphone 15 pro max,100000,135000,35000,2,00492,India
104696,2023-10-17,501,iphone 15,60000,80000,20000,2,00479,India
104696,2023-10-17,503,mixer,1349,3249,1900,1,00479,India
104696,2023-10-17,506,monitor,3249,8000,4751,1,00479,India
104696,2023-10-17,502,iphone 15 pro max,100000,135000,35000,2,00479,India
471305,2023-10-17,503,mixer,1349,3249,1900,1,00385,India
471305,2023-10-17,505,oven,18490,24000,5510,1,00385,India
471305,2023-10-17,507,washing machine,6990,16490,9500,1,00385,India
810012,2023-10-17,507,washing machine,6990,16490,9500,1,00048,India
810012,2023-10-17,503,mixer,1349,3249,1900,1,00048,India
810012,2023-10-17,505,oven,18490,24000,5510,1,00048,India
810012,2023-10-17,502,iphone 15 pro max,100000,135000,35000,2,00048,India
772530,2023-10-17,505,oven,18490,24000,5510,1,00136,India
772530,2023-10-17,504,iron,449,879,430,1,00136,India
727453,2023-10-17,503,mixer,1349,3249,1900,1,00149,India
727453,2023-10-17,501,iphone 15,60000,80000,20000,2,00149,India
782487,2023-10-17,504,iron,449,879,430,1,00146,India
153401,2023-10-17,502,iphone 15 pro max,100000,135000,35000,2,00470,India
153401,2023-10-17,503,mixer,1349,3249,1900,1,00470,India
153401,2023-10-17,505,oven,18490,24000,5510,1,00470,India
153401,2023-10-17,504,iron,449,879,430,1,00470,India
689952,2023-10-17,505,oven,18490,24000,5510,1,00296,India
689952,2023-10-17,502,iphone 15 pro max,100000,135000,35000,2,00296,India
689952,2023-10-17,503,mixer,1349,3249,1900,1,00296,India
689952,2023-10-17,504,iron,449,879,430,1,00296,India
992740,2023-10-17,505,oven,18490,24000,5510,1,00223,India
992740,2023-10-17,502,iphone 15 pro max,100000,135000,35000,2,00223,India
992740,2023-10-17,501,iphone 15,60000,80000,20000,2,00223,India
948054,2023-10-17,504,iron,449,879,430,1,00123,India
948054,2023-10-17,501,iphone 15,60000,80000,20000,2,00123,India
481120,2023-10-17,502,iphone 15 pro max,100000,135000,35000,2,00213,India
481120,2023-10-17,501,iphone 15,60000,80000,20000,2,00213,India
481120,2023-10-17,504,iron,449,879,430,1,00213,India
481120,2023-10-17,503,mixer,1349,3249,1900,1,00213,India
998380,2023-10-17,503,mixer,1349,3249,1900,1,00042,India
998380,2023-10-17,502,iphone 15 pro max,100000,135000,35000,2,00042,India
977959,2023-10-17,505,oven,18490,24000,5510,1,00105,India
977959,2023-10-17,506,monitor,3249,8000,4751,1,00105,India
977959,2023-10-17,503,mixer,1349,3249,1900,1,00105,India
288745,2023-10-17,502,iphone 15 pro max,100000,135000,35000,2,00265,India
288745,2023-10-17,504,iron,449,879,430,1,00265,India
695005,2023-10-17,505,oven,18490,24000,5510,1,00474,India
695005,2023-10-17,506,monitor,3249,8000,4751,1,00474,India
695005,2023-10-17,501,iphone 15,60000,80000,20000,2,00474,India
734785,2023-10-17,501,iphone 15,60000,80000,20000,2,00210,India
734785,2023-10-17,502,iphone 15 pro max,100000,135000,35000,2,00210,India
734785,2023-10-17,503,mixer,1349,3249,1900,1,00210,India
334433,2023-10-17,507,washing machine,6990,16490,9500,1,00149,India
438230,2023-10-17,503,mixer,1349,3249,1900,1,00420,India
438230,2023-10-17,504,iron,449,879,430,1,00420,India
809854,2023-10-17,503,mixer,1349,3249,1900,1,00323,India
809854,2023-10-17,506,monitor,3249,8000,4751,1,00323,India
809854,2023-10-17,504,iron,449,879,430,1,00323,India
331689,2023-10-17,504,iron,449,879,430,1,00337,India
664996,2023-10-17,503,mixer,1349,3249,1900,1,00234,India
226842,2023-10-17,501,iphone 15,60000,80000,20000,2,00333,India
895258,2023-10-17,504,iron,449,879,430,1,00461,India
895258,2023-10-17,502,iphone 15 pro max,100000,135000,35000,2,00461,India
895258,2023-10-17,503,mixer,1349,3249,1900,1,00461,India
895258,2023-10-17,501,iphone 15,60000,80000,20000,2,00461,India
890811,2023-10-17,503,mixer,1349,3249,1900,1,00365,India
890811,2023-10-17,506,monitor,3249,8000,4751,1,00365,India
890811,2023-10-17,501,iphone 15,60000,80000,20000,2,00365,India
358455,2023-10-17,507,washing machine,6990,16490,9500,1,00393,India
358455,2023-10-17,505,oven,18490,24000,5510,1,00393,India
378623,2023-10-17,502,iphone 15 pro max,100000,135000,35000,2,00047,India
924802,2023-10-17,504,iron,449,879,430,1,00074,India
924802,2023-10-17,501,iphone 15,60000,80000,20000,2,00074,India
924802,2023-10-17,505,oven,18490,24000,5510,1,00074,India
924802,2023-10-17,503,mixer,1349,3249,1900,1,00074,India
572351,2023-10-17,501,iphone 15,60000,80000,20000,2,00312,India
572351,2023-10-17,506,monitor,3249,8000,4751,1,00312,India
408884,2023-10-17,501,iphone 15,60000,80000,20000,2,00029,India
408884,2023-10-17,503,mixer,1349,3249,1900,1,00029,India
686311,2023-10-17,507,washing machine,6990,16490,9500,1,00245,India
686311,2023-10-17,505,oven,18490,24000,5510,1,00245,India
686311,2023-10-17,506,monitor,3249,8000,4751,1,00245,India
686311,2023-10-17,503,mixer,1349,3249,1900,1,00245,India
957571,2023-10-17,504,iron,449,879,430,1,00413,India
957571,2023-10-17,501,iphone 15,60000,80000,20000,2,00413,India
957571,2023-10-17,505,oven,18490,24000,5510,1,00413,India
557717,2023-10-17,502,iphone 15 pro max,100000,135000,35000,2,00133,India
557717,2023-10-17,507,washing machine,6990,16490,9500,1,00133,India
557717,2023-10-17,506,monitor,3249,8000,4751,1,00133,India
557717,2023-10-17,505,oven,18490,24000,5510,1,00133,India
475360,2023-10-17,506,monitor,3249,8000,4751,1,00181,India
475360,2023-10-17,505,oven,18490,24000,5510,1,00181,India
475360,2023-10-17,502,iphone 15 pro max,100000,135000,35000,2,00181,India
889670,2023-10-17,502,iphone 15 pro max,100000,135000,35000,2,00043,India
889670,2023-10-17,504,iron,449,879,430,1,00043,India
889670,2023-10-17,506,monitor,3249,8000,4751,1,00043,India
889670,2023-10-17,507,washing machine,6990,16490,9500,1,00043,India
715001,2023-10-17,501,iphone 15,60000,80000,20000,2,00474,India
715001,2023-10-17,504,iron,449,879,430,1,00474,India
715001,2023-10-17,503,mixer,1349,3249,1900,1,00474,India
715001,2023-10-17,502,iphone 15 pro max,100000,135000,35000,2,00474,India
206916,2023-10-17,504,iron,449,879,430,1,00199,India
206916,2023-10-17,503,mixer,1349,3249,1900,1,00199,India
206916,2023-10-17,501,iphone 15,60000,80000,20000,2,00199,India
522578,2023-10-17,506,monitor,3249,8000,4751,1,00184,India
489060,2023-10-17,502,iphone 15 pro max,100000,135000,35000,2,00134,India
489060,2023-10-17,507,washing machine,6990,16490,9500,1,00134,India
489060,2023-10-17,504,iron,449,879,430,1,00134,India
489060,2023-10-17,505,oven,18490,24000,5510,1,00134,India
489060,2023-10-17,501,iphone 15,60000,80000,20000,2,00134,India
715010,2023-10-17,506,monitor,3249,8000,4751,1,00412,India
715010,2023-10-17,501,iphone 15,60000,80000,20000,2,00412,India
168380,2023-10-17,504,iron,449,879,430,1,00071,India
168380,2023-10-17,506,monitor,3249,8000,4751,1,00071,India
168380,2023-10-17,505,oven,18490,24000,5510,1,00071,India
168380,2023-10-17,503,mixer,1349,3249,1900,1,00071,India
343005,2023-10-17,506,monitor,3249,8000,4751,1,00381,India
343005,2023-10-17,502,iphone 15 pro max,100000,135000,35000,2,00381,India
407759,2023-10-17,507,washing machine,6990,16490,9500,1,00110,India
407759,2023-10-17,506,monitor,3249,8000,4751,1,00110,India
262327,2023-10-17,505,oven,18490,24000,5510,1,00054,India
262327,2023-10-17,503,mixer,1349,3249,1900,1,00054,India
262327,2023-10-17,506,monitor,3249,8000,4751,1,00054,India
262327,2023-10-17,501,iphone 15,60000,80000,20000,2,00054,India
472415,2023-10-17,503,mixer,1349,3249,1900,1,00447,India
472415,2023-10-17,505,oven,18490,24000,5510,1,00447,India
340087,2023-10-17,501,iphone 15,60000,80000,20000,2,00044,India
143401,2023-10-17,503,mixer,1349,3249,1900,1,00440,India
143401,2023-10-17,504,iron,449,879,430,1,00440,India
143401,2023-10-17,505,oven,18490,24000,5510,1,00440,India
654026,2023-10-17,504,iron,449,879,430,1,00163,India
654026,2023-10-17,506,monitor,3249,8000,4751,1,00163,India
654026,2023-10-17,507,washing machine,6990,16490,9500,1,00163,India
654026,2023-10-17,505,oven,18490,24000,5510,1,00163,India
654026,2023-10-17,501,iphone 15,60000,80000,20000,2,00163,India
335762,2023-10-17,506,monitor,3249,8000,4751,1,00434,India
335762,2023-10-17,501,iphone 15,60000,80000,20000,2,00434,India
335762,2023-10-17,507,washing machine,6990,16490,9500,1,00434,India
335762,2023-10-17,505,oven,18490,24000,5510,1,00434,India
191669,2023-10-17,506,monitor,3249,8000,4751,1,00232,India
191669,2023-10-17,502,iphone 15 pro max,100000,135000,35000,2,00232,India
191669,2023-10-17,504,iron,449,879,430,1,00232,India
787899,2023-10-17,507,washing machine,6990,16490,9500,1,00159,India
787899,2023-10-17,501,iphone 15,60000,80000,20000,2,00159,India
787899,2023-10-17,503,mixer,1349,3249,1900,1,00159,India
787899,2023-10-17,506,monitor,3249,8000,4751,1,00159,India
578843,2023-10-17,506,monitor,3249,8000,4751,1,00327,India
578843,2023-10-17,505,oven,18490,24000,5510,1,00327,India
578843,2023-10-17,504,iron,449,879,430,1,00327,India
578843,2023-10-17,502,iphone 15 pro max,100000,135000,35000,2,00327,India
252698,2023-10-17,502,iphone 15 pro max,100000,135000,35000,2,00434,India
252698,2023-10-17,507,washing machine,6990,16490,9500,1,00434,India
252698,2023-10-17,504,iron,449,879,430,1,00434,India
797971,2023-10-17,505,oven,18490,24000,5510,1,00114,India
797971,2023-10-17,506,monitor,3249,8000,4751,1,00114,India
797971,2023-10-17,502,iphone 15 pro max,100000,135000,35000,2,00114,India
797971,2023-10-17,507,washing machine,6990,16490,9500,1,00114,India
636854,2023-10-17,502,iphone 15 pro max,100000,135000,35000,2,00239,India
636854,2023-10-17,507,washing machine,6990,16490,9500,1,00239,India
636854,2023-10-17,501,iphone 15,60000,80000,20000,2,00239,India
483214,2023-10-17,507,washing machine,6990,16490,9500,1,00040,India
483214,2023-10-17,501,iphone 15,60000,80000,20000,2,00040,India
882959,2023-10-17,505,oven,18490,24000,5510,1,00500,India
882959,2023-10-17,506,monitor,3249,8000,4751,1,00500,India
882959,2023-10-17,502,iphone 15 pro max,100000,135000,35000,2,00500,India
882959,2023-10-17,504,iron,449,879,430,1,00500,India
732256,2023-10-17,507,washing machine,6990,16490,9500,1,00251,India
732256,2023-10-17,503,mixer,1349,3249,1900,1,00251,India
732256,2023-10-17,504,iron,449,879,430,1,00251,India
700663,2023-10-17,507,washing machine,6990,16490,9500,1,00211,India
700663,2023-10-17,501,iphone 15,60000,80000,20000,2,00211,India
700663,2023-10-17,504,iron,449,879,430,1,00211,India
849672,2023-10-17,502,iphone 15 pro max,100000,135000,35000,2,00265,India
849672,2023-10-17,506,monitor,3249,8000,4751,1,00265,India
849672,2023-10-17,501,iphone 15,60000,80000,20000,2,00265,India
423534,2023-10-17,503,mixer,1349,3249,1900,1,00067,India
423534,2023-10-17,506,monitor,3249,8000,4751,1,00067,India
383768,2023-10-17,501,iphone 15,60000,80000,20000,2,00120,India
964674,2023-10-17,501,iphone 15,60000,80000,20000,2,00124,India
964674,2023-10-17,507,washing machine,6990,16490,9500,1,00124,India
604387,2023-10-17,502,iphone 15 pro max,100000,135000,35000,2,00128,India
604387,2023-10-17,506,monitor,3249,8000,4751,1,00128,India
604387,2023-10-17,505,oven,18490,24000,5510,1,00128,India
190261,2023-10-17,501,iphone 15,60000,80000,20000,2,00282,India
190261,2023-10-17,506,monitor,3249,8000,4751,1,00282,India
994904,2023-10-17,507,washing machine,6990,16490,9500,1,00141,India
994904,2023-10-17,505,oven,18490,24000,5510,1,00141,India
732359,2023-10-17,501,iphone 15,60000,80000,20000,2,00109,India
732359,2023-10-17,506,monitor,3249,8000,4751,1,00109,India
732359,2023-10-17,507,washing machine,6990,16490,9500,1,00109,India
732359,2023-10-17,503,mixer,1349,3249,1900,1,00109,India
961013,2023-10-17,501,iphone 15,60000,80000,20000,2,00312,India
961013,2023-10-17,503,mixer,1349,3249,1900,1,00312,India
961013,2023-10-17,504,iron,449,879,430,1,00312,India
717486,2023-10-17,502,iphone 15 pro max,100000,135000,35000,2,00013,India
717486,2023-10-17,504,iron,449,879,430,1,00013,India
717486,2023-10-17,507,washing machine,6990,16490,9500,1,00013,India
717486,2023-10-17,503,mixer,1349,3249,1900,1,00013,India
717486,2023-10-17,505,oven,18490,24000,5510,1,00013,India
764243,2023-10-18,501,iphone 15,60000,80000,20000,2,00250,India
764243,2023-10-18,507,washing machine,6990,16490,9500,1,00250,India
764243,2023-10-18,506,monitor,3249,8000,4751,1,00250,India
963453,2023-10-18,501,iphone 15,60000,80000,20000,2,00044,India
499100,2023-10-18,507,washing machine,6990,16490,9500,1,00030,India
499100,2023-10-18,503,mixer,1349,3249,1900,1,00030,India
499100,2023-10-18,502,iphone 15 pro max,100000,135000,35000,2,00030,India
235141,2023-10-18,506,monitor,3249,8000,4751,1,00112,India
235141,2023-10-18,507,washing machine,6990,16490,9500,1,00112,India
235141,2023-10-18,505,oven,18490,24000,5510,1,00112,India
235141,2023-10-18,502,iphone 15 pro max,100000,135000,35000,2,00112,India
810306,2023-10-18,507,washing machine,6990,16490,9500,1,00234,India
810306,2023-10-18,504,iron,449,879,430,1,00234,India
810306,2023-10-18,503,mixer,1349,3249,1900,1,00234,India
982249,2023-10-18,501,iphone 15,60000,80000,20000,2,00470,India
982249,2023-10-18,504,iron,449,879,430,1,00470,India
982249,2023-10-18,507,washing machine,6990,16490,9500,1,00470,India
982249,2023-10-18,503,mixer,1349,3249,1900,1,00470,India
481456,2023-10-18,501,iphone 15,60000,80000,20000,2,00204,India
481456,2023-10-18,507,washing machine,6990,16490,9500,1,00204,India
481456,2023-10-18,502,iphone 15 pro max,100000,135000,35000,2,00204,India
984161,2023-10-18,503,mixer,1349,3249,1900,1,00175,India
984161,2023-10-18,501,iphone 15,60000,80000,20000,2,00175,India
851683,2023-10-18,506,monitor,3249,8000,4751,1,00366,India
851683,2023-10-18,505,oven,18490,24000,5510,1,00366,India
851683,2023-10-18,507,washing machine,6990,16490,9500,1,00366,India
350686,2023-10-18,506,monitor,3249,8000,4751,1,00433,India
350686,2023-10-18,504,iron,449,879,430,1,00433,India
874099,2023-10-18,506,monitor,3249,8000,4751,1,00162,India
780121,2023-10-18,502,iphone 15 pro max,100000,135000,35000,2,00306,India
304337,2023-10-18,505,oven,18490,24000,5510,1,00102,India
304337,2023-10-18,503,mixer,1349,3249,1900,1,00102,India
518797,2023-10-18,505,oven,18490,24000,5510,1,00237,India
518797,2023-10-18,507,washing machine,6990,16490,9500,1,00237,India
518797,2023-10-18,502,iphone 15 pro max,100000,135000,35000,2,00237,India
163217,2023-10-18,503,mixer,1349,3249,1900,1,00477,India
163217,2023-10-18,504,iron,449,879,430,1,00477,India
731460,2023-10-18,507,washing machine,6990,16490,9500,1,00102,India
731460,2023-10-18,503,mixer,1349,3249,1900,1,00102,India
641503,2023-10-18,506,monitor,3249,8000,4751,1,00071,India
641503,2023-10-18,502,iphone 15 pro max,100000,135000,35000,2,00071,India
750806,2023-10-18,502,iphone 15 pro max,100000,135000,35000,2,00101,India
750806,2023-10-18,504,iron,449,879,430,1,00101,India
302337,2023-10-18,501,iphone 15,60000,80000,20000,2,00480,India
302337,2023-10-18,504,iron,449,879,430,1,00480,India
302337,2023-10-18,506,monitor,3249,8000,4751,1,00480,India
302337,2023-10-18,503,mixer,1349,3249,1900,1,00480,India
699293,2023-10-18,503,mixer,1349,3249,1900,1,00178,India
699293,2023-10-18,506,monitor,3249,8000,4751,1,00178,India
699293,2023-10-18,501,iphone 15,60000,80000,20000,2,00178,India
116995,2023-10-18,501,iphone 15,60000,80000,20000,2,00378,India
116995,2023-10-18,506,monitor,3249,8000,4751,1,00378,India
116995,2023-10-18,504,iron,449,879,430,1,00378,India
116995,2023-10-18,502,iphone 15 pro max,100000,135000,35000,2,00378,India
772469,2023-10-18,502,iphone 15 pro max,100000,135000,35000,2,00258,India
772469,2023-10-18,504,iron,449,879,430,1,00258,India
354966,2023-10-18,507,washing machine,6990,16490,9500,1,00333,India
354966,2023-10-18,502,iphone 15 pro max,100000,135000,35000,2,00333,India
354966,2023-10-18,503,mixer,1349,3249,1900,1,00333,India
354966,2023-10-18,504,iron,449,879,430,1,00333,India
442598,2023-10-18,505,oven,18490,24000,5510,1,00090,India
442598,2023-10-18,503,mixer,1349,3249,1900,1,00090,India
442598,2023-10-18,502,iphone 15 pro max,100000,135000,35000,2,00090,India
387160,2023-10-18,505,oven,18490,24000,5510,1,00331,India
387160,2023-10-18,504,iron,449,879,430,1,00331,India
971999,2023-10-18,501,iphone 15,60000,80000,20000,2,00202,India
298749,2023-10-18,502,iphone 15 pro max,100000,135000,35000,2,00146,India
626665,2023-10-18,501,iphone 15,60000,80000,20000,2,00048,India
626665,2023-10-18,507,washing machine,6990,16490,9500,1,00048,India
626665,2023-10-18,504,iron,449,879,430,1,00048,India
626665,2023-10-18,505,oven,18490,24000,5510,1,00048,India
322641,2023-10-18,504,iron,449,879,430,1,00462,India
322641,2023-10-18,502,iphone 15 pro max,100000,135000,35000,2,00462,India
260101,2023-10-18,506,monitor,3249,8000,4751,1,00298,India
260101,2023-10-18,505,oven,18490,24000,5510,1,00298,India
260101,2023-10-18,502,iphone 15 pro max,100000,135000,35000,2,00298,India
506585,2023-10-18,506,monitor,3249,8000,4751,1,00293,India
506585,2023-10-18,507,washing machine,6990,16490,9500,1,00293,India
506585,2023-10-18,505,oven,18490,24000,5510,1,00293,India
506585,2023-10-18,501,iphone 15,60000,80000,20000,2,00293,India
781770,2023-10-18,502,iphone 15 pro max,100000,135000,35000,2,00185,India
781770,2023-10-18,506,monitor,3249,8000,4751,1,00185,India
781770,2023-10-18,501,iphone 15,60000,80000,20000,2,00185,India
781770,2023-10-18,504,iron,449,879,430,1,00185,India
412729,2023-10-18,501,iphone 15,60000,80000,20000,2,00053,India
462423,2023-10-18,506,monitor,3249,8000,4751,1,00289,India
462423,2023-10-18,502,iphone 15 pro max,100000,135000,35000,2,00289,India
820194,2023-10-18,504,iron,449,879,430,1,00390,India
820194,2023-10-18,505,oven,18490,24000,5510,1,00390,India
272174,2023-10-18,504,iron,449,879,430,1,00086,India
272174,2023-10-18,506,monitor,3249,8000,4751,1,00086,India
215889,2023-10-18,503,mixer,1349,3249,1900,1,00250,India
215889,2023-10-18,507,washing machine,6990,16490,9500,1,00250,India
215889,2023-10-18,506,monitor,3249,8000,4751,1,00250,India
654753,2023-10-18,502,iphone 15 pro max,100000,135000,35000,2,00136,India
654753,2023-10-18,504,iron,449,879,430,1,00136,India
654753,2023-10-18,503,mixer,1349,3249,1900,1,00136,India
851644,2023-10-18,501,iphone 15,60000,80000,20000,2,00460,India
851644,2023-10-18,505,oven,18490,24000,5510,1,00460,India
355296,2023-10-18,507,washing machine,6990,16490,9500,1,00078,India
355296,2023-10-18,501,iphone 15,60000,80000,20000,2,00078,India
355296,2023-10-18,506,monitor,3249,8000,4751,1,00078,India
807399,2023-10-18,502,iphone 15 pro max,100000,135000,35000,2,00404,India
146398,2023-10-18,506,monitor,3249,8000,4751,1,00440,India
146398,2023-10-18,503,mixer,1349,3249,1900,1,00440,India
146398,2023-10-18,505,oven,18490,24000,5510,1,00440,India
500147,2023-10-18,501,iphone 15,60000,80000,20000,2,00252,India
500147,2023-10-18,505,oven,18490,24000,5510,1,00252,India
856212,2023-10-18,507,washing machine,6990,16490,9500,1,00456,India
856212,2023-10-18,505,oven,18490,24000,5510,1,00456,India
546951,2023-10-18,503,mixer,1349,3249,1900,1,00107,India
546951,2023-10-18,504,iron,449,879,430,1,00107,India
332758,2023-10-18,501,iphone 15,60000,80000,20000,2,00301,India
332758,2023-10-18,503,mixer,1349,3249,1900,1,00301,India
946435,2023-10-18,506,monitor,3249,8000,4751,1,00289,India
946435,2023-10-18,507,washing machine,6990,16490,9500,1,00289,India
946435,2023-10-18,503,mixer,1349,3249,1900,1,00289,India
946435,2023-10-18,501,iphone 15,60000,80000,20000,2,00289,India
946435,2023-10-18,505,oven,18490,24000,5510,1,00289,India
298730,2023-10-18,506,monitor,3249,8000,4751,1,00328,India
298730,2023-10-18,502,iphone 15 pro max,100000,135000,35000,2,00328,India
298730,2023-10-18,507,washing machine,6990,16490,9500,1,00328,India
298730,2023-10-18,504,iron,449,879,430,1,00328,India
992354,2023-10-18,507,washing machine,6990,16490,9500,1,00372,India
992354,2023-10-18,501,iphone 15,60000,80000,20000,2,00372,India
992354,2023-10-18,505,oven,18490,24000,5510,1,00372,India
992354,2023-10-18,506,monitor,3249,8000,4751,1,00372,India
992354,2023-10-18,502,iphone 15 pro max,100000,135000,35000,2,00372,India
975967,2023-10-18,505,oven,18490,24000,5510,1,00010,India
975967,2023-10-18,507,washing machine,6990,16490,9500,1,00010,India
309238,2023-10-18,504,iron,449,879,430,1,00344,India
309238,2023-10-18,501,iphone 15,60000,80000,20000,2,00344,India
309238,2023-10-18,503,mixer,1349,3249,1900,1,00344,India
847059,2023-10-18,504,iron,449,879,430,1,00483,India
847059,2023-10-18,505,oven,18490,24000,5510,1,00483,India
847059,2023-10-18,503,mixer,1349,3249,1900,1,00483,India
847059,2023-10-18,507,washing machine,6990,16490,9500,1,00483,India
486081,2023-10-18,505,oven,18490,24000,5510,1,00041,India
486081,2023-10-18,507,washing machine,6990,16490,9500,1,00041,India
699600,2023-10-18,501,iphone 15,60000,80000,20000,2,00021,India
699600,2023-10-18,504,iron,449,879,430,1,00021,India
699600,2023-10-18,507,washing machine,6990,16490,9500,1,00021,India
180085,2023-10-18,507,washing machine,6990,16490,9500,1,00376,India
180085,2023-10-18,501,iphone 15,60000,80000,20000,2,00376,India
180085,2023-10-18,504,iron,449,879,430,1,00376,India
222358,2023-10-18,503,mixer,1349,3249,1900,1,00170,India
909938,2023-10-18,503,mixer,1349,3249,1900,1,00224,India
909938,2023-10-18,505,oven,18490,24000,5510,1,00224,India
915944,2023-10-18,506,monitor,3249,8000,4751,1,00431,India
915944,2023-10-18,502,iphone 15 pro max,100000,135000,35000,2,00431,India
862705,2023-10-18,506,monitor,3249,8000,4751,1,00009,India
862705,2023-10-18,504,iron,449,879,430,1,00009,India
195870,2023-10-18,507,washing machine,6990,16490,9500,1,00444,India
195870,2023-10-18,501,iphone 15,60000,80000,20000,2,00444,India
890944,2023-10-18,505,oven,18490,24000,5510,1,00075,India
890944,2023-10-18,506,monitor,3249,8000,4751,1,00075,India
137378,2023-10-18,504,iron,449,879,430,1,00001,India
137378,2023-10-18,507,washing machine,6990,16490,9500,1,00001,India
137378,2023-10-18,503,mixer,1349,3249,1900,1,00001,India
966638,2023-10-18,505,oven,18490,24000,5510,1,00114,India
966638,2023-10-18,503,mixer,1349,3249,1900,1,00114,India
966638,2023-10-18,507,washing machine,6990,16490,9500,1,00114,India
231571,2023-10-18,502,iphone 15 pro max,100000,135000,35000,2,00016,India
231571,2023-10-18,503,mixer,1349,3249,1900,1,00016,India
231571,2023-10-18,505,oven,18490,24000,5510,1,00016,India
231571,2023-10-18,506,monitor,3249,8000,4751,1,00016,India
367824,2023-10-18,501,iphone 15,60000,80000,20000,2,00388,India
367824,2023-10-18,506,monitor,3249,8000,4751,1,00388,India
813022,2023-10-18,505,oven,18490,24000,5510,1,00330,India
813022,2023-10-18,507,washing machine,6990,16490,9500,1,00330,India
715711,2023-10-18,506,monitor,3249,8000,4751,1,00424,India
715711,2023-10-18,502,iphone 15 pro max,100000,135000,35000,2,00424,India
754057,2023-10-18,503,mixer,1349,3249,1900,1,00187,India
168908,2023-10-18,505,oven,18490,24000,5510,1,00108,India
168908,2023-10-18,501,iphone 15,60000,80000,20000,2,00108,India
168908,2023-10-18,506,monitor,3249,8000,4751,1,00108,India
118637,2023-10-19,507,washing machine,6990,16490,9500,1,00436,India
118637,2023-10-19,503,mixer,1349,3249,1900,1,00436,India
118637,2023-10-19,506,monitor,3249,8000,4751,1,00436,India
639312,2023-10-19,505,oven,18490,24000,5510,1,00343,India
639312,2023-10-19,502,iphone 15 pro max,100000,135000,35000,2,00343,India
639312,2023-10-19,506,monitor,3249,8000,4751,1,00343,India
651275,2023-10-19,506,monitor,3249,8000,4751,1,00247,India
152265,2023-10-19,506,monitor,3249,8000,4751,1,00189,India
152265,2023-10-19,503,mixer,1349,3249,1900,1,00189,India
152265,2023-10-19,502,iphone 15 pro max,100000,135000,35000,2,00189,India
152265,2023-10-19,501,iphone 15,60000,80000,20000,2,00189,India
152265,2023-10-19,505,oven,18490,24000,5510,1,00189,India
370010,2023-10-19,505,oven,18490,24000,5510,1,00344,India
485319,2023-10-19,502,iphone 15 pro max,100000,135000,35000,2,00235,India
485319,2023-10-19,505,oven,18490,24000,5510,1,00235,India
485319,2023-10-19,504,iron,449,879,430,1,00235,India
485319,2023-10-19,506,monitor,3249,8000,4751,1,00235,India
520545,2023-10-19,507,washing machine,6990,16490,9500,1,00131,India
474999,2023-10-19,502,iphone 15 pro max,100000,135000,35000,2,00067,India
474999,2023-10-19,506,monitor,3249,8000,4751,1,00067,India
806183,2023-10-19,506,monitor,3249,8000,4751,1,00030,India
163514,2023-10-19,501,iphone 15,60000,80000,20000,2,00471,India
163514,2023-10-19,505,oven,18490,24000,5510,1,00471,India
163514,2023-10-19,502,iphone 15 pro max,100000,135000,35000,2,00471,India
163514,2023-10-19,504,iron,449,879,430,1,00471,India
655273,2023-10-19,507,washing machine,6990,16490,9500,1,00353,India
655273,2023-10-19,505,oven,18490,24000,5510,1,00353,India
655273,2023-10-19,504,iron,449,879,430,1,00353,India
800774,2023-10-19,504,iron,449,879,430,1,00291,India
800774,2023-10-19,501,iphone 15,60000,80000,20000,2,00291,India
800774,2023-10-19,502,iphone 15 pro max,100000,135000,35000,2,00291,India
130314,2023-10-19,507,washing machine,6990,16490,9500,1,00368,India
130314,2023-10-19,504,iron,449,879,430,1,00368,India
130314,2023-10-19,505,oven,18490,24000,5510,1,00368,India
130314,2023-10-19,502,iphone 15 pro max,100000,135000,35000,2,00368,India
668982,2023-10-19,501,iphone 15,60000,80000,20000,2,00225,India
668982,2023-10-19,505,oven,18490,24000,5510,1,00225,India
668982,2023-10-19,503,mixer,1349,3249,1900,1,00225,India
475800,2023-10-19,507,washing machine,6990,16490,9500,1,00021,India
475800,2023-10-19,506,monitor,3249,8000,4751,1,00021,India
475800,2023-10-19,501,iphone 15,60000,80000,20000,2,00021,India
561223,2023-10-19,505,oven,18490,24000,5510,1,00191,India
561223,2023-10-19,507,washing machine,6990,16490,9500,1,00191,India
221154,2023-10-19,501,iphone 15,60000,80000,20000,2,00095,India
221154,2023-10-19,504,iron,449,879,430,1,00095,India
221154,2023-10-19,505,oven,18490,24000,5510,1,00095,India
461252,2023-10-19,502,iphone 15 pro max,100000,135000,35000,2,00173,India
250510,2023-10-19,501,iphone 15,60000,80000,20000,2,00427,India
250510,2023-10-19,502,iphone 15 pro max,100000,135000,35000,2,00427,India
250510,2023-10-19,504,iron,449,879,430,1,00427,India
916384,2023-10-19,502,iphone 15 pro max,100000,135000,35000,2,00499,India
525861,2023-10-19,505,oven,18490,24000,5510,1,00402,India
525861,2023-10-19,503,mixer,1349,3249,1900,1,00402,India
233955,2023-10-19,501,iphone 15,60000,80000,20000,2,00195,India
233955,2023-10-19,507,washing machine,6990,16490,9500,1,00195,India
604310,2023-10-19,506,monitor,3249,8000,4751,1,00078,India
604310,2023-10-19,505,oven,18490,24000,5510,1,00078,India
604310,2023-10-19,502,iphone 15 pro max,100000,135000,35000,2,00078,India
289435,2023-10-19,507,washing machine,6990,16490,9500,1,00100,India
289435,2023-10-19,505,oven,18490,24000,5510,1,00100,India
289435,2023-10-19,502,iphone 15 pro max,100000,135000,35000,2,00100,India
289435,2023-10-19,503,mixer,1349,3249,1900,1,00100,India
174191,2023-10-19,504,iron,449,879,430,1,00407,India
174191,2023-10-19,503,mixer,1349,3249,1900,1,00407,India
174191,2023-10-19,501,iphone 15,60000,80000,20000,2,00407,India
500166,2023-10-19,506,monitor,3249,8000,4751,1,00376,India
500166,2023-10-19,502,iphone 15 pro max,100000,135000,35000,2,00376,India
500166,2023-10-19,507,washing machine,6990,16490,9500,1,00376,India
375655,2023-10-19,506,monitor,3249,8000,4751,1,00199,India
375655,2023-10-19,505,oven,18490,24000,5510,1,00199,India
375655,2023-10-19,503,mixer,1349,3249,1900,1,00199,India
375655,2023-10-19,502,iphone 15 pro max,100000,135000,35000,2,00199,India
899371,2023-10-19,501,iphone 15,60000,80000,20000,2,00182,India
899371,2023-10-19,503,mixer,1349,3249,1900,1,00182,India
972511,2023-10-19,505,oven,18490,24000,5510,1,00416,India
972511,2023-10-19,501,iphone 15,60000,80000,20000,2,00416,India
972511,2023-10-19,502,iphone 15 pro max,100000,135000,35000,2,00416,India
972511,2023-10-19,507,washing machine,6990,16490,9500,1,00416,India
159899,2023-10-19,501,iphone 15,60000,80000,20000,2,00397,India
159899,2023-10-19,505,oven,18490,24000,5510,1,00397,India
159899,2023-10-19,503,mixer,1349,3249,1900,1,00397,India
924330,2023-10-19,503,mixer,1349,3249,1900,1,00098,India
699890,2023-10-19,507,washing machine,6990,16490,9500,1,00239,India
699890,2023-10-19,505,oven,18490,24000,5510,1,00239,India
699890,2023-10-19,501,iphone 15,60000,80000,20000,2,00239,India
699890,2023-10-19,506,monitor,3249,8000,4751,1,00239,India
905634,2023-10-19,503,mixer,1349,3249,1900,1,00109,India
905634,2023-10-19,506,monitor,3249,8000,4751,1,00109,India
905634,2023-10-19,504,iron,449,879,430,1,00109,India
791856,2023-10-19,505,oven,18490,24000,5510,1,00300,India
791856,2023-10-19,504,iron,449,879,430,1,00300,India
876891,2023-10-19,501,iphone 15,60000,80000,20000,2,00394,India
876891,2023-10-19,504,iron,449,879,430,1,00394,India
876891,2023-10-19,503,mixer,1349,3249,1900,1,00394,India
779092,2023-10-19,501,iphone 15,60000,80000,20000,2,00211,India
169605,2023-10-19,502,iphone 15 pro max,100000,135000,35000,2,00250,India
169605,2023-10-19,503,mixer,1349,3249,1900,1,00250,India
387918,2023-10-19,507,washing machine,6990,16490,9500,1,00165,India
387918,2023-10-19,501,iphone 15,60000,80000,20000,2,00165,India
387918,2023-10-19,505,oven,18490,24000,5510,1,00165,India
328678,2023-10-19,504,iron,449,879,430,1,00127,India
328678,2023-10-19,505,oven,18490,24000,5510,1,00127,India
328678,2023-10-19,503,mixer,1349,3249,1900,1,00127,India
328678,2023-10-19,501,iphone 15,60000,80000,20000,2,00127,India
300401,2023-10-19,505,oven,18490,24000,5510,1,00024,India
300401,2023-10-19,502,iphone 15 pro max,100000,135000,35000,2,00024,India
300401,2023-10-19,501,iphone 15,60000,80000,20000,2,00024,India
998721,2023-10-19,504,iron,449,879,430,1,00394,India
998721,2023-10-19,505,oven,18490,24000,5510,1,00394,India
998721,2023-10-19,502,iphone 15 pro max,100000,135000,35000,2,00394,India
513878,2023-10-19,501,iphone 15,60000,80000,20000,2,00190,India
513878,2023-10-19,504,iron,449,879,430,1,00190,India
855025,2023-10-19,506,monitor,3249,8000,4751,1,00402,India
855025,2023-10-19,504,iron,449,879,430,1,00402,India
855025,2023-10-19,507,washing machine,6990,16490,9500,1,00402,India
953185,2023-10-19,507,washing machine,6990,16490,9500,1,00130,India
953185,2023-10-19,501,iphone 15,60000,80000,20000,2,00130,India
420042,2023-10-19,507,washing machine,6990,16490,9500,1,00235,India
420042,2023-10-19,502,iphone 15 pro max,100000,135000,35000,2,00235,India
660109,2023-10-19,507,washing machine,6990,16490,9500,1,00396,India
660109,2023-10-19,503,mixer,1349,3249,1900,1,00396,India
862939,2023-10-19,504,iron,449,879,430,1,00325,India
279354,2023-10-19,507,washing machine,6990,16490,9500,1,00378,India
516752,2023-10-19,502,iphone 15 pro max,100000,135000,35000,2,00475,India
516752,2023-10-19,503,mixer,1349,3249,1900,1,00475,India
486199,2023-10-19,506,monitor,3249,8000,4751,1,00478,India
486199,2023-10-19,507,washing machine,6990,16490,9500,1,00478,India
486199,2023-10-19,503,mixer,1349,3249,1900,1,00478,India
486199,2023-10-19,505,oven,18490,24000,5510,1,00478,India
530708,2023-10-19,504,iron,449,879,430,1,00081,India
530708,2023-10-19,503,mixer,1349,3249,1900,1,00081,India
530708,2023-10-19,505,oven,18490,24000,5510,1,00081,India
530708,2023-10-19,502,iphone 15 pro max,100000,135000,35000,2,00081,India
555421,2023-10-19,503,mixer,1349,3249,1900,1,00204,India
555421,2023-10-19,502,iphone 15 pro max,100000,135000,35000,2,00204,India
392188,2023-10-19,504,iron,449,879,430,1,00096,India
392188,2023-10-19,506,monitor,3249,8000,4751,1,00096,India
392188,2023-10-19,502,iphone 15 pro max,100000,135000,35000,2,00096,India
392188,2023-10-19,507,washing machine,6990,16490,9500,1,00096,India
373840,2023-10-19,505,oven,18490,24000,5510,1,00210,India
373840,2023-10-19,507,washing machine,6990,16490,9500,1,00210,India
148391,2023-10-19,504,iron,449,879,430,1,00365,India
148391,2023-10-19,503,mixer,1349,3249,1900,1,00365,India
148391,2023-10-19,505,oven,18490,24000,5510,1,00365,India
541294,2023-10-19,501,iphone 15,60000,80000,20000,2,00022,India
541294,2023-10-19,506,monitor,3249,8000,4751,1,00022,India
541294,2023-10-19,504,iron,449,879,430,1,00022,India
541294,2023-10-19,507,washing machine,6990,16490,9500,1,00022,India
342153,2023-10-19,503,mixer,1349,3249,1900,1,00436,India
833533,2023-10-19,507,washing machine,6990,16490,9500,1,00090,India
833533,2023-10-19,505,oven,18490,24000,5510,1,00090,India
676889,2023-10-19,502,iphone 15 pro max,100000,135000,35000,2,00091,India
676889,2023-10-19,503,mixer,1349,3249,1900,1,00091,India
676889,2023-10-19,506,monitor,3249,8000,4751,1,00091,India
676889,2023-10-19,505,oven,18490,24000,5510,1,00091,India
268361,2023-10-19,505,oven,18490,24000,5510,1,00110,India
268361,2023-10-19,504,iron,449,879,430,1,00110,India
268361,2023-10-19,506,monitor,3249,8000,4751,1,00110,India
601352,2023-10-19,505,oven,18490,24000,5510,1,00105,India
601352,2023-10-19,506,monitor,3249,8000,4751,1,00105,India
601352,2023-10-19,507,washing machine,6990,16490,9500,1,00105,India
601352,2023-10-19,501,iphone 15,60000,80000,20000,2,00105,India
712151,2023-10-19,505,oven,18490,24000,5510,1,00127,India
712151,2023-10-19,507,washing machine,6990,16490,9500,1,00127,India
712151,2023-10-19,504,iron,449,879,430,1,00127,India
217322,2023-10-19,502,iphone 15 pro max,100000,135000,35000,2,00169,India
217322,2023-10-19,503,mixer,1349,3249,1900,1,00169,India
616470,2023-10-20,503,mixer,1349,3249,1900,1,00294,India
616470,2023-10-20,502,iphone 15 pro max,100000,135000,35000,2,00294,India
888878,2023-10-20,507,washing machine,6990,16490,9500,1,00187,India
888878,2023-10-20,501,iphone 15,60000,80000,20000,2,00187,India
888878,2023-10-20,502,iphone 15 pro max,100000,135000,35000,2,00187,India
801060,2023-10-20,503,mixer,1349,3249,1900,1,00250,India
233153,2023-10-20,504,iron,449,879,430,1,00119,India
233153,2023-10-20,507,washing machine,6990,16490,9500,1,00119,India
233153,2023-10-20,502,iphone 15 pro max,100000,135000,35000,2,00119,India
924715,2023-10-20,502,iphone 15 pro max,100000,135000,35000,2,00293,India
924715,2023-10-20,504,iron,449,879,430,1,00293,India
760985,2023-10-20,501,iphone 15,60000,80000,20000,2,00248,India
571915,2023-10-20,503,mixer,1349,3249,1900,1,00469,India
571915,2023-10-20,505,oven,18490,24000,5510,1,00469,India
571915,2023-10-20,504,iron,449,879,430,1,00469,India
554170,2023-10-20,507,washing machine,6990,16490,9500,1,00034,India
554170,2023-10-20,505,oven,18490,24000,5510,1,00034,India
554170,2023-10-20,503,mixer,1349,3249,1900,1,00034,India
554170,2023-10-20,506,monitor,3249,8000,4751,1,00034,India
490274,2023-10-20,501,iphone 15,60000,80000,20000,2,00463,India
490274,2023-10-20,507,washing machine,6990,16490,9500,1,00463,India
756456,2023-10-20,503,mixer,1349,3249,1900,1,00494,India
326151,2023-10-20,502,iphone 15 pro max,100000,135000,35000,2,00425,India
326151,2023-10-20,507,washing machine,6990,16490,9500,1,00425,India
326151,2023-10-20,503,mixer,1349,3249,1900,1,00425,India
960202,2023-10-20,503,mixer,1349,3249,1900,1,00280,India
960202,2023-10-20,502,iphone 15 pro max,100000,135000,35000,2,00280,India
622614,2023-10-20,504,iron,449,879,430,1,00443,India
622614,2023-10-20,501,iphone 15,60000,80000,20000,2,00443,India
622614,2023-10-20,503,mixer,1349,3249,1900,1,00443,India
622614,2023-10-20,502,iphone 15 pro max,100000,135000,35000,2,00443,India
807823,2023-10-20,501,iphone 15,60000,80000,20000,2,00010,India
245233,2023-10-20,501,iphone 15,60000,80000,20000,2,00015,India
584937,2023-10-20,501,iphone 15,60000,80000,20000,2,00436,India
584937,2023-10-20,505,oven,18490,24000,5510,1,00436,India
760797,2023-10-20,505,oven,18490,24000,5510,1,00160,India
760797,2023-10-20,507,washing machine,6990,16490,9500,1,00160,India
398517,2023-10-20,502,iphone 15 pro max,100000,135000,35000,2,00029,India
398517,2023-10-20,507,washing machine,6990,16490,9500,1,00029,India
368592,2023-10-20,503,mixer,1349,3249,1900,1,00057,India
704670,2023-10-20,503,mixer,1349,3249,1900,1,00252,India
704670,2023-10-20,501,iphone 15,60000,80000,20000,2,00252,India
206287,2023-10-20,501,iphone 15,60000,80000,20000,2,00288,India
839692,2023-10-20,502,iphone 15 pro max,100000,135000,35000,2,00261,India
839692,2023-10-20,506,monitor,3249,8000,4751,1,00261,India
839692,2023-10-20,507,washing machine,6990,16490,9500,1,00261,India
933495,2023-10-20,503,mixer,1349,3249,1900,1,00386,India
933495,2023-10-20,506,monitor,3249,8000,4751,1,00386,India
933495,2023-10-20,501,iphone 15,60000,80000,20000,2,00386,India
933495,2023-10-20,505,oven,18490,24000,5510,1,00386,India
735964,2023-10-20,507,washing machine,6990,16490,9500,1,00193,India
735964,2023-10-20,504,iron,449,879,430,1,00193,India
735964,2023-10-20,501,iphone 15,60000,80000,20000,2,00193,India
735964,2023-10-20,505,oven,18490,24000,5510,1,00193,India
157449,2023-10-20,507,washing machine,6990,16490,9500,1,00360,India
157449,2023-10-20,505,oven,18490,24000,5510,1,00360,India
157449,2023-10-20,501,iphone 15,60000,80000,20000,2,00360,India
492829,2023-10-20,507,washing machine,6990,16490,9500,1,00366,India
552725,2023-10-20,505,oven,18490,24000,5510,1,00390,India
552725,2023-10-20,504,iron,449,879,430,1,00390,India
885218,2023-10-20,502,iphone 15 pro max,100000,135000,35000,2,00435,India
885218,2023-10-20,503,mixer,1349,3249,1900,1,00435,India
885218,2023-10-20,507,washing machine,6990,16490,9500,1,00435,India
885218,2023-10-20,505,oven,18490,24000,5510,1,00435,India
972223,2023-10-20,504,iron,449,879,430,1,00080,India
972223,2023-10-20,506,monitor,3249,8000,4751,1,00080,India
972223,2023-10-20,502,iphone 15 pro max,100000,135000,35000,2,00080,India
440373,2023-10-20,503,mixer,1349,3249,1900,1,00251,India
967328,2023-10-20,506,monitor,3249,8000,4751,1,00136,India
967328,2023-10-20,504,iron,449,879,430,1,00136,India
967328,2023-10-20,501,iphone 15,60000,80000,20000,2,00136,India
624088,2023-10-20,502,iphone 15 pro max,100000,135000,35000,2,00463,India
624088,2023-10-20,501,iphone 15,60000,80000,20000,2,00463,India
624088,2023-10-20,506,monitor,3249,8000,4751,1,00463,India
624088,2023-10-20,504,iron,449,879,430,1,00463,India
546652,2023-10-20,504,iron,449,879,430,1,00132,India
802272,2023-10-20,503,mixer,1349,3249,1900,1,00352,India
802272,2023-10-20,502,iphone 15 pro max,100000,135000,35000,2,00352,India
802272,2023-10-20,505,oven,18490,24000,5510,1,00352,India
802272,2023-10-20,501,iphone 15,60000,80000,20000,2,00352,India
714482,2023-10-20,502,iphone 15 pro max,100000,135000,35000,2,00161,India
714482,2023-10-20,503,mixer,1349,3249,1900,1,00161,India
714482,2023-10-20,501,iphone 15,60000,80000,20000,2,00161,India
344709,2023-10-20,506,monitor,3249,8000,4751,1,00403,India
344709,2023-10-20,502,iphone 15 pro max,100000,135000,35000,2,00403,India
344709,2023-10-20,501,iphone 15,60000,80000,20000,2,00403,India
344709,2023-10-20,504,iron,449,879,430,1,00403,India
449335,2023-10-20,506,monitor,3249,8000,4751,1,00339,India
449335,2023-10-20,503,mixer,1349,3249,1900,1,00339,India
449335,2023-10-20,502,iphone 15 pro max,100000,135000,35000,2,00339,India
449335,2023-10-20,507,washing machine,6990,16490,9500,1,00339,India
921898,2023-10-20,504,iron,449,879,430,1,00097,India
404518,2023-10-20,507,washing machine,6990,16490,9500,1,00471,India
404518,2023-10-20,505,oven,18490,24000,5510,1,00471,India
209192,2023-10-20,504,iron,449,879,430,1,00191,India
209192,2023-10-20,502,iphone 15 pro max,100000,135000,35000,2,00191,India
209192,2023-10-20,501,iphone 15,60000,80000,20000,2,00191,India
209192,2023-10-20,505,oven,18490,24000,5510,1,00191,India
359811,2023-10-20,504,iron,449,879,430,1,00104,India
359811,2023-10-20,505,oven,18490,24000,5510,1,00104,India
359811,2023-10-20,506,monitor,3249,8000,4751,1,00104,India
501259,2023-10-20,503,mixer,1349,3249,1900,1,00028,India
501259,2023-10-20,505,oven,18490,24000,5510,1,00028,India
470835,2023-10-20,503,mixer,1349,3249,1900,1,00180,India
597309,2023-10-20,502,iphone 15 pro max,100000,135000,35000,2,00241,India
597309,2023-10-20,506,monitor,3249,8000,4751,1,00241,India
597309,2023-10-20,503,mixer,1349,3249,1900,1,00241,India
597309,2023-10-20,507,washing machine,6990,16490,9500,1,00241,India
217712,2023-10-20,502,iphone 15 pro max,100000,135000,35000,2,00209,India
217712,2023-10-20,501,iphone 15,60000,80000,20000,2,00209,India
217712,2023-10-20,506,monitor,3249,8000,4751,1,00209,India
217712,2023-10-20,504,iron,449,879,430,1,00209,India
439224,2023-10-20,501,iphone 15,60000,80000,20000,2,00051,India
439224,2023-10-20,504,iron,449,879,430,1,00051,India
439224,2023-10-20,506,monitor,3249,8000,4751,1,00051,India
439224,2023-10-20,502,iphone 15 pro max,100000,135000,35000,2,00051,India
439224,2023-10-20,507,washing machine,6990,16490,9500,1,00051,India
458475,2023-10-20,502,iphone 15 pro max,100000,135000,35000,2,00486,India
458475,2023-10-20,501,iphone 15,60000,80000,20000,2,00486,India
458475,2023-10-20,504,iron,449,879,430,1,00486,India
582802,2023-10-20,504,iron,449,879,430,1,00184,India
582802,2023-10-20,501,iphone 15,60000,80000,20000,2,00184,India
582802,2023-10-20,505,oven,18490,24000,5510,1,00184,India
582802,2023-10-20,503,mixer,1349,3249,1900,1,00184,India
734183,2023-10-20,506,monitor,3249,8000,4751,1,00328,India
734183,2023-10-20,501,iphone 15,60000,80000,20000,2,00328,India
734183,2023-10-20,505,oven,18490,24000,5510,1,00328,India
734183,2023-10-20,507,washing machine,6990,16490,9500,1,00328,India
354661,2023-10-20,503,mixer,1349,3249,1900,1,00288,India
354661,2023-10-20,505,oven,18490,24000,5510,1,00288,India
354661,2023-10-20,504,iron,449,879,430,1,00288,India
354661,2023-10-20,501,iphone 15,60000,80000,20000,2,00288,India
354661,2023-10-20,506,monitor,3249,8000,4751,1,00288,India
513322,2023-10-20,503,mixer,1349,3249,1900,1,00306,India
654255,2023-10-20,506,monitor,3249,8000,4751,1,00204,India
654255,2023-10-20,501,iphone 15,60000,80000,20000,2,00204,India
739660,2023-10-20,507,washing machine,6990,16490,9500,1,00305,India
739660,2023-10-20,506,monitor,3249,8000,4751,1,00305,India
364582,2023-10-20,507,washing machine,6990,16490,9500,1,00131,India
364582,2023-10-20,502,iphone 15 pro max,100000,135000,35000,2,00131,India
889419,2023-10-20,503,mixer,1349,3249,1900,1,00257,India
534583,2023-10-20,506,monitor,3249,8000,4751,1,00463,India
534583,2023-10-20,504,iron,449,879,430,1,00463,India
534583,2023-10-20,503,mixer,1349,3249,1900,1,00463,India
534583,2023-10-20,502,iphone 15 pro max,100000,135000,35000,2,00463,India
279926,2023-10-20,506,monitor,3249,8000,4751,1,00392,India
279926,2023-10-20,501,iphone 15,60000,80000,20000,2,00392,India
279926,2023-10-20,503,mixer,1349,3249,1900,1,00392,India
279926,2023-10-20,504,iron,449,879,430,1,00392,India
279926,2023-10-20,502,iphone 15 pro max,100000,135000,35000,2,00392,India
830857,2023-10-20,506,monitor,3249,8000,4751,1,00068,India
830857,2023-10-20,501,iphone 15,60000,80000,20000,2,00068,India
830857,2023-10-20,504,iron,449,879,430,1,00068,India
615502,2023-10-20,507,washing machine,6990,16490,9500,1,00238,India
848902,2023-10-20,504,iron,449,879,430,1,00466,India
848902,2023-10-20,505,oven,18490,24000,5510,1,00466,India
848902,2023-10-20,503,mixer,1349,3249,1900,1,00466,India
848902,2023-10-20,506,monitor,3249,8000,4751,1,00466,India
972090,2023-10-20,505,oven,18490,24000,5510,1,00114,India
972090,2023-10-20,504,iron,449,879,430,1,00114,India
972090,2023-10-20,507,washing machine,6990,16490,9500,1,00114,India
192410,2023-10-20,506,monitor,3249,8000,4751,1,00471,India
192410,2023-10-20,507,washing machine,6990,16490,9500,1,00471,India
192410,2023-10-20,503,mixer,1349,3249,1900,1,00471,India
893346,2023-10-20,505,oven,18490,24000,5510,1,00498,India
893346,2023-10-20,507,washing machine,6990,16490,9500,1,00498,India
893346,2023-10-20,503,mixer,1349,3249,1900,1,00498,India
305675,2023-10-20,502,iphone 15 pro max,100000,135000,35000,2,00351,India
305675,2023-10-20,504,iron,449,879,430,1,00351,India
305675,2023-10-20,507,washing machine,6990,16490,9500,1,00351,India
305675,2023-10-20,501,iphone 15,60000,80000,20000,2,00351,India
168796,2023-10-20,507,washing machine,6990,16490,9500,1,00389,India
770531,2023-10-20,507,washing machine,6990,16490,9500,1,00176,India
770531,2023-10-20,504,iron,449,879,430,1,00176,India
770531,2023-10-20,506,monitor,3249,8000,4751,1,00176,India
770531,2023-10-20,503,mixer,1349,3249,1900,1,00176,India
896595,2023-10-20,503,mixer,1349,3249,1900,1,00131,India
896595,2023-10-20,502,iphone 15 pro max,100000,135000,35000,2,00131,India
976032,2023-10-20,502,iphone 15 pro max,100000,135000,35000,2,00107,India
976032,2023-10-20,505,oven,18490,24000,5510,1,00107,India
976032,2023-10-20,501,iphone 15,60000,80000,20000,2,00107,India
889400,2023-10-20,506,monitor,3249,8000,4751,1,00284,India
781261,2023-10-20,505,oven,18490,24000,5510,1,00295,India
781261,2023-10-20,502,iphone 15 pro max,100000,135000,35000,2,00295,India
832375,2023-10-20,503,mixer,1349,3249,1900,1,00387,India
832375,2023-10-20,507,washing machine,6990,16490,9500,1,00387,India
832375,2023-10-20,506,monitor,3249,8000,4751,1,00387,India
832375,2023-10-20,501,iphone 15,60000,80000,20000,2,00387,India
980136,2023-10-20,506,monitor,3249,8000,4751,1,00421,India
253484,2023-10-20,505,oven,18490,24000,5510,1,00479,India
253484,2023-10-20,503,mixer,1349,3249,1900,1,00479,India
330693,2023-10-21,504,iron,449,879,430,1,00240,India
330693,2023-10-21,503,mixer,1349,3249,1900,1,00240,India
330693,2023-10-21,501,iphone 15,60000,80000,20000,2,00240,India
330693,2023-10-21,506,monitor,3249,8000,4751,1,00240,India
410306,2023-10-21,502,iphone 15 pro max,100000,135000,35000,2,00275,India
410306,2023-10-21,503,mixer,1349,3249,1900,1,00275,India
572319,2023-10-21,502,iphone 15 pro max,100000,135000,35000,2,00134,India
554397,2023-10-21,507,washing machine,6990,16490,9500,1,00287,India
554397,2023-10-21,504,iron,449,879,430,1,00287,India
554397,2023-10-21,501,iphone 15,60000,80000,20000,2,00287,India
331427,2023-10-21,505,oven,18490,24000,5510,1,00212,India
331427,2023-10-21,506,monitor,3249,8000,4751,1,00212,India
331427,2023-10-21,501,iphone 15,60000,80000,20000,2,00212,India
331427,2023-10-21,503,mixer,1349,3249,1900,1,00212,India
453849,2023-10-21,505,oven,18490,24000,5510,1,00472,India
453849,2023-10-21,502,iphone 15 pro max,100000,135000,35000,2,00472,India
717122,2023-10-21,505,oven,18490,24000,5510,1,00266,India
717122,2023-10-21,506,monitor,3249,8000,4751,1,00266,India
717122,2023-10-21,503,mixer,1349,3249,1900,1,00266,India
270708,2023-10-21,507,washing machine,6990,16490,9500,1,00099,India
732815,2023-10-21,505,oven,18490,24000,5510,1,00429,India
732815,2023-10-21,506,monitor,3249,8000,4751,1,00429,India
669292,2023-10-21,505,oven,18490,24000,5510,1,00200,India
352704,2023-10-21,504,iron,449,879,430,1,00454,India
352704,2023-10-21,507,washing machine,6990,16490,9500,1,00454,India
352704,2023-10-21,506,monitor,3249,8000,4751,1,00454,India
352704,2023-10-21,501,iphone 15,60000,80000,20000,2,00454,India
352704,2023-10-21,505,oven,18490,24000,5510,1,00454,India
509889,2023-10-21,504,iron,449,879,430,1,00070,India
509889,2023-10-21,501,iphone 15,60000,80000,20000,2,00070,India
509889,2023-10-21,503,mixer,1349,3249,1900,1,00070,India
509889,2023-10-21,506,monitor,3249,8000,4751,1,00070,India
817662,2023-10-21,505,oven,18490,24000,5510,1,00038,India
531007,2023-10-21,506,monitor,3249,8000,4751,1,00079,India
531007,2023-10-21,507,washing machine,6990,16490,9500,1,00079,India
531007,2023-10-21,505,oven,18490,24000,5510,1,00079,India
531007,2023-10-21,504,iron,449,879,430,1,00079,India
124167,2023-10-21,506,monitor,3249,8000,4751,1,00258,India
124167,2023-10-21,505,oven,18490,24000,5510,1,00258,India
124167,2023-10-21,502,iphone 15 pro max,100000,135000,35000,2,00258,India
124167,2023-10-21,507,washing machine,6990,16490,9500,1,00258,India
200225,2023-10-21,506,monitor,3249,8000,4751,1,00253,India
200225,2023-10-21,503,mixer,1349,3249,1900,1,00253,India
200225,2023-10-21,501,iphone 15,60000,80000,20000,2,00253,India
200225,2023-10-21,507,washing machine,6990,16490,9500,1,00253,India
248629,2023-10-21,501,iphone 15,60000,80000,20000,2,00117,India
248629,2023-10-21,505,oven,18490,24000,5510,1,00117,India
386073,2023-10-21,504,iron,449,879,430,1,00262,India
386073,2023-10-21,503,mixer,1349,3249,1900,1,00262,India
386073,2023-10-21,501,iphone 15,60000,80000,20000,2,00262,India
704979,2023-10-21,501,iphone 15,60000,80000,20000,2,00360,India
704979,2023-10-21,507,washing machine,6990,16490,9500,1,00360,India
704979,2023-10-21,506,monitor,3249,8000,4751,1,00360,India
704979,2023-10-21,504,iron,449,879,430,1,00360,India
925925,2023-10-21,502,iphone 15 pro max,100000,135000,35000,2,00354,India
925925,2023-10-21,507,washing machine,6990,16490,9500,1,00354,India
925925,2023-10-21,504,iron,449,879,430,1,00354,India
925925,2023-10-21,503,mixer,1349,3249,1900,1,00354,India
848267,2023-10-21,501,iphone 15,60000,80000,20000,2,00113,India
646285,2023-10-21,503,mixer,1349,3249,1900,1,00243,India
646285,2023-10-21,504,iron,449,879,430,1,00243,India
646285,2023-10-21,502,iphone 15 pro max,100000,135000,35000,2,00243,India
646285,2023-10-21,501,iphone 15,60000,80000,20000,2,00243,India
511450,2023-10-21,504,iron,449,879,430,1,00155,India
511450,2023-10-21,501,iphone 15,60000,80000,20000,2,00155,India
704287,2023-10-21,502,iphone 15 pro max,100000,135000,35000,2,00192,India
704287,2023-10-21,505,oven,18490,24000,5510,1,00192,India
704287,2023-10-21,504,iron,449,879,430,1,00192,India
864014,2023-10-21,504,iron,449,879,430,1,00293,India
468416,2023-10-21,503,mixer,1349,3249,1900,1,00483,India
468416,2023-10-21,502,iphone 15 pro max,100000,135000,35000,2,00483,India
641071,2023-10-21,506,monitor,3249,8000,4751,1,00293,India
641071,2023-10-21,502,iphone 15 pro max,100000,135000,35000,2,00293,India
641071,2023-10-21,503,mixer,1349,3249,1900,1,00293,India
641071,2023-10-21,507,washing machine,6990,16490,9500,1,00293,India
122517,2023-10-21,505,oven,18490,24000,5510,1,00040,India
638597,2023-10-21,501,iphone 15,60000,80000,20000,2,00010,India
491457,2023-10-21,503,mixer,1349,3249,1900,1,00056,India
491457,2023-10-21,506,monitor,3249,8000,4751,1,00056,India
844104,2023-10-21,507,washing machine,6990,16490,9500,1,00216,India
844104,2023-10-21,501,iphone 15,60000,80000,20000,2,00216,India
844104,2023-10-21,505,oven,18490,24000,5510,1,00216,India
857039,2023-10-21,505,oven,18490,24000,5510,1,00017,India
857039,2023-10-21,504,iron,449,879,430,1,00017,India
857039,2023-10-21,503,mixer,1349,3249,1900,1,00017,India
444865,2023-10-21,504,iron,449,879,430,1,00184,India
444865,2023-10-21,505,oven,18490,24000,5510,1,00184,India
444865,2023-10-21,502,iphone 15 pro max,100000,135000,35000,2,00184,India
303005,2023-10-21,504,iron,449,879,430,1,00148,India
303005,2023-10-21,503,mixer,1349,3249,1900,1,00148,India
734137,2023-10-21,504,iron,449,879,430,1,00027,India
734137,2023-10-21,502,iphone 15 pro max,100000,135000,35000,2,00027,India
734137,2023-10-21,506,monitor,3249,8000,4751,1,00027,India
847859,2023-10-21,501,iphone 15,60000,80000,20000,2,00220,India
847859,2023-10-21,502,iphone 15 pro max,100000,135000,35000,2,00220,India
847859,2023-10-21,503,mixer,1349,3249,1900,1,00220,India
697313,2023-10-21,505,oven,18490,24000,5510,1,00182,India
697313,2023-10-21,504,iron,449,879,430,1,00182,India
362847,2023-10-21,502,iphone 15 pro max,100000,135000,35000,2,00220,India
362847,2023-10-21,503,mixer,1349,3249,1900,1,00220,India
789297,2023-10-21,506,monitor,3249,8000,4751,1,00288,India
789297,2023-10-21,505,oven,18490,24000,5510,1,00288,India
286051,2023-10-21,501,iphone 15,60000,80000,20000,2,00053,India
286051,2023-10-21,506,monitor,3249,8000,4751,1,00053,India
286051,2023-10-21,505,oven,18490,24000,5510,1,00053,India
286051,2023-10-21,502,iphone 15 pro max,100000,135000,35000,2,00053,India
401661,2023-10-21,503,mixer,1349,3249,1900,1,00420,India
401661,2023-10-21,507,washing machine,6990,16490,9500,1,00420,India
401661,2023-10-21,501,iphone 15,60000,80000,20000,2,00420,India
401661,2023-10-21,505,oven,18490,24000,5510,1,00420,India
792320,2023-10-21,501,iphone 15,60000,80000,20000,2,00139,India
327090,2023-10-21,502,iphone 15 pro max,100000,135000,35000,2,00243,India
327090,2023-10-21,501,iphone 15,60000,80000,20000,2,00243,India
327090,2023-10-21,504,iron,449,879,430,1,00243,India
327090,2023-10-21,506,monitor,3249,8000,4751,1,00243,India
349294,2023-10-21,506,monitor,3249,8000,4751,1,00152,India
349294,2023-10-21,501,iphone 15,60000,80000,20000,2,00152,India
683260,2023-10-21,501,iphone 15,60000,80000,20000,2,00324,India
683260,2023-10-21,503,mixer,1349,3249,1900,1,00324,India
683260,2023-10-21,502,iphone 15 pro max,100000,135000,35000,2,00324,India
970823,2023-10-21,503,mixer,1349,3249,1900,1,00117,India
970823,2023-10-21,501,iphone 15,60000,80000,20000,2,00117,India
970823,2023-10-21,505,oven,18490,24000,5510,1,00117,India
970823,2023-10-21,507,washing machine,6990,16490,9500,1,00117,India
737283,2023-10-21,504,iron,449,879,430,1,00036,India
925488,2023-10-21,503,mixer,1349,3249,1900,1,00001,India
925488,2023-10-21,502,iphone 15 pro max,100000,135000,35000,2,00001,India
925488,2023-10-21,507,washing machine,6990,16490,9500,1,00001,India
973431,2023-10-21,507,washing machine,6990,16490,9500,1,00366,India
973431,2023-10-21,506,monitor,3249,8000,4751,1,00366,India
973431,2023-10-21,504,iron,449,879,430,1,00366,India
973431,2023-10-21,501,iphone 15,60000,80000,20000,2,00366,India
973431,2023-10-21,505,oven,18490,24000,5510,1,00366,India
407886,2023-10-21,505,oven,18490,24000,5510,1,00500,India
922843,2023-10-21,503,mixer,1349,3249,1900,1,00227,India
273186,2023-10-21,503,mixer,1349,3249,1900,1,00261,India
273186,2023-10-21,501,iphone 15,60000,80000,20000,2,00261,India
972298,2023-10-21,503,mixer,1349,3249,1900,1,00370,India
535666,2023-10-21,505,oven,18490,24000,5510,1,00036,India
535666,2023-10-21,506,monitor,3249,8000,4751,1,00036,India
606606,2023-10-21,506,monitor,3249,8000,4751,1,00361,India
606606,2023-10-21,505,oven,18490,24000,5510,1,00361,India
538456,2023-10-21,506,monitor,3249,8000,4751,1,00071,India
922241,2023-10-21,501,iphone 15,60000,80000,20000,2,00284,India
240430,2023-10-21,504,iron,449,879,430,1,00476,India
240430,2023-10-21,503,mixer,1349,3249,1900,1,00476,India
311302,2023-10-21,502,iphone 15 pro max,100000,135000,35000,2,00102,India
311302,2023-10-21,504,iron,449,879,430,1,00102,India
311302,2023-10-21,507,washing machine,6990,16490,9500,1,00102,India
731294,2023-10-21,506,monitor,3249,8000,4751,1,00270,India
731294,2023-10-21,501,iphone 15,60000,80000,20000,2,00270,India
731294,2023-10-21,502,iphone 15 pro max,100000,135000,35000,2,00270,India
731294,2023-10-21,503,mixer,1349,3249,1900,1,00270,India
539175,2023-10-21,505,oven,18490,24000,5510,1,00224,India
833456,2023-10-21,501,iphone 15,60000,80000,20000,2,00435,India
833456,2023-10-21,507,washing machine,6990,16490,9500,1,00435,India
833456,2023-10-21,503,mixer,1349,3249,1900,1,00435,India
833456,2023-10-21,502,iphone 15 pro max,100000,135000,35000,2,00435,India
833456,2023-10-21,505,oven,18490,24000,5510,1,00435,India
291247,2023-10-21,504,iron,449,879,430,1,00489,India
291247,2023-10-21,505,oven,18490,24000,5510,1,00489,India
291247,2023-10-21,503,mixer,1349,3249,1900,1,00489,India
789130,2023-10-21,506,monitor,3249,8000,4751,1,00408,India
789130,2023-10-21,501,iphone 15,60000,80000,20000,2,00408,India
789130,2023-10-21,504,iron,449,879,430,1,00408,India
789130,2023-10-21,503,mixer,1349,3249,1900,1,00408,India
538179,2023-10-21,503,mixer,1349,3249,1900,1,00089,India
538179,2023-10-21,507,washing machine,6990,16490,9500,1,00089,India
538179,2023-10-21,501,iphone 15,60000,80000,20000,2,00089,India
470214,2023-10-21,507,washing machine,6990,16490,9500,1,00051,India
470214,2023-10-21,504,iron,449,879,430,1,00051,India
470214,2023-10-21,505,oven,18490,24000,5510,1,00051,India
128625,2023-10-21,503,mixer,1349,3249,1900,1,00080,India
128625,2023-10-21,507,washing machine,6990,16490,9500,1,00080,India
128625,2023-10-21,501,iphone 15,60000,80000,20000,2,00080,India
478728,2023-10-21,504,iron,449,879,430,1,00135,India
478728,2023-10-21,507,washing machine,6990,16490,9500,1,00135,India
478728,2023-10-21,506,monitor,3249,8000,4751,1,00135,India
932494,2023-10-21,504,iron,449,879,430,1,00072,India
932494,2023-10-21,501,iphone 15,60000,80000,20000,2,00072,India
770096,2023-10-21,507,washing machine,6990,16490,9500,1,00460,India
770096,2023-10-21,503,mixer,1349,3249,1900,1,00460,India
770096,2023-10-21,502,iphone 15 pro max,100000,135000,35000,2,00460,India
770096,2023-10-21,504,iron,449,879,430,1,00460,India
130389,2023-10-21,501,iphone 15,60000,80000,20000,2,00188,India
130389,2023-10-21,502,iphone 15 pro max,100000,135000,35000,2,00188,India
680180,2023-10-21,505,oven,18490,24000,5510,1,00094,India
680180,2023-10-21,506,monitor,3249,8000,4751,1,00094,India
680180,2023-10-21,501,iphone 15,60000,80000,20000,2,00094,India
680180,2023-10-21,502,iphone 15 pro max,100000,135000,35000,2,00094,India
680180,2023-10-21,503,mixer,1349,3249,1900,1,00094,India
502462,2023-10-21,505,oven,18490,24000,5510,1,00191,India
818032,2023-10-21,503,mixer,1349,3249,1900,1,00355,India
818032,2023-10-21,502,iphone 15 pro max,100000,135000,35000,2,00355,India
818032,2023-10-21,505,oven,18490,24000,5510,1,00355,India
818032,2023-10-21,504,iron,449,879,430,1,00355,India
611178,2023-10-21,501,iphone 15,60000,80000,20000,2,00323,India
611178,2023-10-21,504,iron,449,879,430,1,00323,India
611178,2023-10-21,503,mixer,1349,3249,1900,1,00323,India
611178,2023-10-21,502,iphone 15 pro max,100000,135000,35000,2,00323,India
889279,2023-10-21,501,iphone 15,60000,80000,20000,2,00189,India
889279,2023-10-21,507,washing machine,6990,16490,9500,1,00189,India
889279,2023-10-21,505,oven,18490,24000,5510,1,00189,India
434417,2023-10-21,505,oven,18490,24000,5510,1,00425,India
434417,2023-10-21,503,mixer,1349,3249,1900,1,00425,India
156036,2023-10-21,504,iron,449,879,430,1,00228,India
156036,2023-10-21,503,mixer,1349,3249,1900,1,00228,India
156036,2023-10-21,502,iphone 15 pro max,100000,135000,35000,2,00228,India
186101,2023-10-21,507,washing machine,6990,16490,9500,1,00281,India
186101,2023-10-21,502,iphone 15 pro max,100000,135000,35000,2,00281,India
942783,2023-10-21,501,iphone 15,60000,80000,20000,2,00220,India
942783,2023-10-21,503,mixer,1349,3249,1900,1,00220,India
942783,2023-10-21,507,washing machine,6990,16490,9500,1,00220,India
984875,2023-10-21,503,mixer,1349,3249,1900,1,00384,India
984875,2023-10-21,504,iron,449,879,430,1,00384,India
984875,2023-10-21,501,iphone 15,60000,80000,20000,2,00384,India
130382,2023-10-21,503,mixer,1349,3249,1900,1,00071,India
130382,2023-10-21,505,oven,18490,24000,5510,1,00071,India
130382,2023-10-21,504,iron,449,879,430,1,00071,India
130382,2023-10-21,506,monitor,3249,8000,4751,1,00071,India
742279,2023-10-21,502,iphone 15 pro max,100000,135000,35000,2,00152,India
742279,2023-10-21,505,oven,18490,24000,5510,1,00152,India
742279,2023-10-21,506,monitor,3249,8000,4751,1,00152,India
742279,2023-10-21,503,mixer,1349,3249,1900,1,00152,India
989708,2023-10-21,504,iron,449,879,430,1,00430,India
303686,2023-10-21,501,iphone 15,60000,80000,20000,2,00305,India
303686,2023-10-21,506,monitor,3249,8000,4751,1,00305,India
546669,2023-10-21,507,washing machine,6990,16490,9500,1,00147,India
794434,2023-10-21,507,washing machine,6990,16490,9500,1,00085,India
710899,2023-10-21,506,monitor,3249,8000,4751,1,00213,India
933753,2023-10-21,501,iphone 15,60000,80000,20000,2,00481,India
933753,2023-10-21,505,oven,18490,24000,5510,1,00481,India
933753,2023-10-21,506,monitor,3249,8000,4751,1,00481,India
933753,2023-10-21,504,iron,449,879,430,1,00481,India
943140,2023-10-21,503,mixer,1349,3249,1900,1,00493,India
943140,2023-10-21,505,oven,18490,24000,5510,1,00493,India
943140,2023-10-21,502,iphone 15 pro max,100000,135000,35000,2,00493,India
583089,2023-10-21,504,iron,449,879,430,1,00128,India
583089,2023-10-21,502,iphone 15 pro max,100000,135000,35000,2,00128,India
583089,2023-10-21,507,washing machine,6990,16490,9500,1,00128,India
583089,2023-10-21,501,iphone 15,60000,80000,20000,2,00128,India
591673,2023-10-21,506,monitor,3249,8000,4751,1,00153,India
591673,2023-10-21,507,washing machine,6990,16490,9500,1,00153,India
591673,2023-10-21,503,mixer,1349,3249,1900,1,00153,India
591673,2023-10-21,504,iron,449,879,430,1,00153,India
737355,2023-10-22,506,monitor,3249,8000,4751,1,00419,India
737355,2023-10-22,507,washing machine,6990,16490,9500,1,00419,India
145871,2023-10-22,505,oven,18490,24000,5510,1,00163,India
145871,2023-10-22,507,washing machine,6990,16490,9500,1,00163,India
145871,2023-10-22,506,monitor,3249,8000,4751,1,00163,India
779813,2023-10-22,502,iphone 15 pro max,100000,135000,35000,2,00080,India
779813,2023-10-22,503,mixer,1349,3249,1900,1,00080,India
967775,2023-10-22,502,iphone 15 pro max,100000,135000,35000,2,00294,India
967775,2023-10-22,503,mixer,1349,3249,1900,1,00294,India
186967,2023-10-22,505,oven,18490,24000,5510,1,00132,India
186967,2023-10-22,503,mixer,1349,3249,1900,1,00132,India
186967,2023-10-22,501,iphone 15,60000,80000,20000,2,00132,India
776124,2023-10-22,505,oven,18490,24000,5510,1,00332,India
887198,2023-10-22,505,oven,18490,24000,5510,1,00168,India
887198,2023-10-22,507,washing machine,6990,16490,9500,1,00168,India
887198,2023-10-22,502,iphone 15 pro max,100000,135000,35000,2,00168,India
887198,2023-10-22,506,monitor,3249,8000,4751,1,00168,India
311713,2023-10-22,502,iphone 15 pro max,100000,135000,35000,2,00495,India
311713,2023-10-22,507,washing machine,6990,16490,9500,1,00495,India
311713,2023-10-22,501,iphone 15,60000,80000,20000,2,00495,India
311713,2023-10-22,506,monitor,3249,8000,4751,1,00495,India
756000,2023-10-22,506,monitor,3249,8000,4751,1,00208,India
756000,2023-10-22,502,iphone 15 pro max,100000,135000,35000,2,00208,India
756000,2023-10-22,503,mixer,1349,3249,1900,1,00208,India
756000,2023-10-22,505,oven,18490,24000,5510,1,00208,India
756000,2023-10-22,507,washing machine,6990,16490,9500,1,00208,India
966858,2023-10-22,501,iphone 15,60000,80000,20000,2,00419,India
924209,2023-10-22,505,oven,18490,24000,5510,1,00448,India
924209,2023-10-22,506,monitor,3249,8000,4751,1,00448,India
296850,2023-10-22,502,iphone 15 pro max,100000,135000,35000,2,00316,India
296850,2023-10-22,504,iron,449,879,430,1,00316,India
296850,2023-10-22,501,iphone 15,60000,80000,20000,2,00316,India
349666,2023-10-22,504,iron,449,879,430,1,00048,India
349666,2023-10-22,503,mixer,1349,3249,1900,1,00048,India
349666,2023-10-22,501,iphone 15,60000,80000,20000,2,00048,India
367782,2023-10-22,505,oven,18490,24000,5510,1,00221,India
367782,2023-10-22,502,iphone 15 pro max,100000,135000,35000,2,00221,India
367782,2023-10-22,501,iphone 15,60000,80000,20000,2,00221,India
367782,2023-10-22,503,mixer,1349,3249,1900,1,00221,India
154503,2023-10-22,507,washing machine,6990,16490,9500,1,00304,India
168468,2023-10-22,506,monitor,3249,8000,4751,1,00227,India
168468,2023-10-22,502,iphone 15 pro max,100000,135000,35000,2,00227,India
168468,2023-10-22,504,iron,449,879,430,1,00227,India
747251,2023-10-22,501,iphone 15,60000,80000,20000,2,00161,India
747251,2023-10-22,506,monitor,3249,8000,4751,1,00161,India
747251,2023-10-22,502,iphone 15 pro max,100000,135000,35000,2,00161,India
747251,2023-10-22,504,iron,449,879,430,1,00161,India
276606,2023-10-22,502,iphone 15 pro max,100000,135000,35000,2,00039,India
276606,2023-10-22,501,iphone 15,60000,80000,20000,2,00039,India
276606,2023-10-22,503,mixer,1349,3249,1900,1,00039,India
127328,2023-10-22,501,iphone 15,60000,80000,20000,2,00225,India
116354,2023-10-22,507,washing machine,6990,16490,9500,1,00382,India
116354,2023-10-22,505,oven,18490,24000,5510,1,00382,India
524363,2023-10-22,502,iphone 15 pro max,100000,135000,35000,2,00260,India
131502,2023-10-22,505,oven,18490,24000,5510,1,00334,India
131502,2023-10-22,501,iphone 15,60000,80000,20000,2,00334,India
131502,2023-10-22,504,iron,449,879,430,1,00334,India
131502,2023-10-22,503,mixer,1349,3249,1900,1,00334,India
290083,2023-10-22,503,mixer,1349,3249,1900,1,00324,India
630394,2023-10-22,505,oven,18490,24000,5510,1,00404,India
630394,2023-10-22,504,iron,449,879,430,1,00404,India
630394,2023-10-22,501,iphone 15,60000,80000,20000,2,00404,India
449753,2023-10-22,507,washing machine,6990,16490,9500,1,00115,India
449753,2023-10-22,504,iron,449,879,430,1,00115,India
449753,2023-10-22,506,monitor,3249,8000,4751,1,00115,India
449753,2023-10-22,502,iphone 15 pro max,100000,135000,35000,2,00115,India
449753,2023-10-22,501,iphone 15,60000,80000,20000,2,00115,India
393932,2023-10-22,503,mixer,1349,3249,1900,1,00010,India
881473,2023-10-22,507,washing machine,6990,16490,9500,1,00331,India
256840,2023-10-22,507,washing machine,6990,16490,9500,1,00090,India
719815,2023-10-22,501,iphone 15,60000,80000,20000,2,00367,India
719815,2023-10-22,502,iphone 15 pro max,100000,135000,35000,2,00367,India
719815,2023-10-22,507,washing machine,6990,16490,9500,1,00367,India
719815,2023-10-22,504,iron,449,879,430,1,00367,India
590588,2023-10-22,504,iron,449,879,430,1,00499,India
590588,2023-10-22,506,monitor,3249,8000,4751,1,00499,India
313776,2023-10-22,504,iron,449,879,430,1,00334,India
313776,2023-10-22,506,monitor,3249,8000,4751,1,00334,India
472516,2023-10-22,506,monitor,3249,8000,4751,1,00150,India
472516,2023-10-22,503,mixer,1349,3249,1900,1,00150,India
472516,2023-10-22,501,iphone 15,60000,80000,20000,2,00150,India
472516,2023-10-22,504,iron,449,879,430,1,00150,India
183457,2023-10-22,507,washing machine,6990,16490,9500,1,00043,India
183457,2023-10-22,505,oven,18490,24000,5510,1,00043,India
993196,2023-10-22,506,monitor,3249,8000,4751,1,00102,India
993196,2023-10-22,504,iron,449,879,430,1,00102,India
993196,2023-10-22,505,oven,18490,24000,5510,1,00102,India
964191,2023-10-22,505,oven,18490,24000,5510,1,00182,India
964191,2023-10-22,502,iphone 15 pro max,100000,135000,35000,2,00182,India
964191,2023-10-22,503,mixer,1349,3249,1900,1,00182,India
628447,2023-10-22,507,washing machine,6990,16490,9500,1,00041,India
628447,2023-10-22,506,monitor,3249,8000,4751,1,00041,India
628447,2023-10-22,504,iron,449,879,430,1,00041,India
628447,2023-10-22,502,iphone 15 pro max,100000,135000,35000,2,00041,India
927901,2023-10-22,506,monitor,3249,8000,4751,1,00129,India
279060,2023-10-22,501,iphone 15,60000,80000,20000,2,00292,India
279060,2023-10-22,502,iphone 15 pro max,100000,135000,35000,2,00292,India
279060,2023-10-22,505,oven,18490,24000,5510,1,00292,India
279060,2023-10-22,504,iron,449,879,430,1,00292,India
279060,2023-10-22,506,monitor,3249,8000,4751,1,00292,India
729863,2023-10-22,506,monitor,3249,8000,4751,1,00420,India
729863,2023-10-22,503,mixer,1349,3249,1900,1,00420,India
729863,2023-10-22,502,iphone 15 pro max,100000,135000,35000,2,00420,India
876462,2023-10-22,503,mixer,1349,3249,1900,1,00030,India
876462,2023-10-22,502,iphone 15 pro max,100000,135000,35000,2,00030,India
876462,2023-10-22,504,iron,449,879,430,1,00030,India
623396,2023-10-22,502,iphone 15 pro max,100000,135000,35000,2,00471,India
623396,2023-10-22,504,iron,449,879,430,1,00471,India
228898,2023-10-22,507,washing machine,6990,16490,9500,1,00144,India
228898,2023-10-22,505,oven,18490,24000,5510,1,00144,India
228898,2023-10-22,503,mixer,1349,3249,1900,1,00144,India
228898,2023-10-22,506,monitor,3249,8000,4751,1,00144,India
821586,2023-10-22,503,mixer,1349,3249,1900,1,00473,India
821586,2023-10-22,501,iphone 15,60000,80000,20000,2,00473,India
821586,2023-10-22,504,iron,449,879,430,1,00473,India
449090,2023-10-22,504,iron,449,879,430,1,00357,India
449090,2023-10-22,501,iphone 15,60000,80000,20000,2,00357,India
449090,2023-10-22,506,monitor,3249,8000,4751,1,00357,India
449090,2023-10-22,507,washing machine,6990,16490,9500,1,00357,India
525801,2023-10-22,505,oven,18490,24000,5510,1,00430,India
607569,2023-10-22,504,iron,449,879,430,1,00098,India
607569,2023-10-22,501,iphone 15,60000,80000,20000,2,00098,India
607569,2023-10-22,505,oven,18490,24000,5510,1,00098,India
607569,2023-10-22,503,mixer,1349,3249,1900,1,00098,India
960340,2023-10-22,504,iron,449,879,430,1,00435,India
448335,2023-10-22,506,monitor,3249,8000,4751,1,00182,India
888363,2023-10-22,501,iphone 15,60000,80000,20000,2,00284,India
640646,2023-10-22,504,iron,449,879,430,1,00220,India
640646,2023-10-22,505,oven,18490,24000,5510,1,00220,India
315912,2023-10-22,506,monitor,3249,8000,4751,1,00094,India
315912,2023-10-22,502,iphone 15 pro max,100000,135000,35000,2,00094,India
315912,2023-10-22,507,washing machine,6990,16490,9500,1,00094,India
195541,2023-10-22,505,oven,18490,24000,5510,1,00260,India
195541,2023-10-22,501,iphone 15,60000,80000,20000,2,00260,India
174215,2023-10-22,502,iphone 15 pro max,100000,135000,35000,2,00005,India
174215,2023-10-22,503,mixer,1349,3249,1900,1,00005,India
174215,2023-10-22,506,monitor,3249,8000,4751,1,00005,India
698081,2023-10-22,504,iron,449,879,430,1,00336,India
698081,2023-10-22,503,mixer,1349,3249,1900,1,00336,India
698081,2023-10-22,501,iphone 15,60000,80000,20000,2,00336,India
698081,2023-10-22,506,monitor,3249,8000,4751,1,00336,India
698081,2023-10-22,502,iphone 15 pro max,100000,135000,35000,2,00336,India
140554,2023-10-22,506,monitor,3249,8000,4751,1,00148,India
891819,2023-10-22,506,monitor,3249,8000,4751,1,00461,India
891819,2023-10-22,502,iphone 15 pro max,100000,135000,35000,2,00461,India
891819,2023-10-22,501,iphone 15,60000,80000,20000,2,00461,India
106463,2023-10-22,505,oven,18490,24000,5510,1,00500,India
220559,2023-10-22,501,iphone 15,60000,80000,20000,2,00179,India
220559,2023-10-22,506,monitor,3249,8000,4751,1,00179,India
167575,2023-10-22,501,iphone 15,60000,80000,20000,2,00459,India
167575,2023-10-22,504,iron,449,879,430,1,00459,India
794040,2023-10-22,502,iphone 15 pro max,100000,135000,35000,2,00241,India
794040,2023-10-22,501,iphone 15,60000,80000,20000,2,00241,India
794040,2023-10-22,506,monitor,3249,8000,4751,1,00241,India
466555,2023-10-22,507,washing machine,6990,16490,9500,1,00425,India
624599,2023-10-22,501,iphone 15,60000,80000,20000,2,00232,India
984453,2023-10-22,505,oven,18490,24000,5510,1,00286,India
819901,2023-10-22,503,mixer,1349,3249,1900,1,00462,India
819901,2023-10-22,504,iron,449,879,430,1,00462,India
819901,2023-10-22,506,monitor,3249,8000,4751,1,00462,India
530539,2023-10-22,502,iphone 15 pro max,100000,135000,35000,2,00422,India
530539,2023-10-22,507,washing machine,6990,16490,9500,1,00422,India
530539,2023-10-22,506,monitor,3249,8000,4751,1,00422,India
936313,2023-10-22,507,washing machine,6990,16490,9500,1,00068,India
936313,2023-10-22,504,iron,449,879,430,1,00068,India
204239,2023-10-22,501,iphone 15,60000,80000,20000,2,00332,India
204239,2023-10-22,507,washing machine,6990,16490,9500,1,00332,India
204239,2023-10-22,505,oven,18490,24000,5510,1,00332,India
564184,2023-10-23,504,iron,449,879,430,1,00235,India
564184,2023-10-23,507,washing machine,6990,16490,9500,1,00235,India
248215,2023-10-23,502,iphone 15 pro max,100000,135000,35000,2,00180,India
248215,2023-10-23,504,iron,449,879,430,1,00180,India
248215,2023-10-23,501,iphone 15,60000,80000,20000,2,00180,India
559770,2023-10-23,505,oven,18490,24000,5510,1,00209,India
559770,2023-10-23,506,monitor,3249,8000,4751,1,00209,India
559770,2023-10-23,503,mixer,1349,3249,1900,1,00209,India
559770,2023-10-23,501,iphone 15,60000,80000,20000,2,00209,India
813063,2023-10-23,506,monitor,3249,8000,4751,1,00157,India
220451,2023-10-23,503,mixer,1349,3249,1900,1,00064,India
220451,2023-10-23,502,iphone 15 pro max,100000,135000,35000,2,00064,India
220451,2023-10-23,506,monitor,3249,8000,4751,1,00064,India
220451,2023-10-23,504,iron,449,879,430,1,00064,India
992488,2023-10-23,502,iphone 15 pro max,100000,135000,35000,2,00482,India
992488,2023-10-23,501,iphone 15,60000,80000,20000,2,00482,India
250269,2023-10-23,503,mixer,1349,3249,1900,1,00407,India
250269,2023-10-23,502,iphone 15 pro max,100000,135000,35000,2,00407,India
140784,2023-10-23,501,iphone 15,60000,80000,20000,2,00063,India
904901,2023-10-23,507,washing machine,6990,16490,9500,1,00407,India
353487,2023-10-23,506,monitor,3249,8000,4751,1,00046,India
353487,2023-10-23,503,mixer,1349,3249,1900,1,00046,India
872087,2023-10-23,503,mixer,1349,3249,1900,1,00478,India
872087,2023-10-23,507,washing machine,6990,16490,9500,1,00478,India
345982,2023-10-23,507,washing machine,6990,16490,9500,1,00498,India
345982,2023-10-23,502,iphone 15 pro max,100000,135000,35000,2,00498,India
345982,2023-10-23,506,monitor,3249,8000,4751,1,00498,India
345982,2023-10-23,505,oven,18490,24000,5510,1,00498,India
306050,2023-10-23,503,mixer,1349,3249,1900,1,00104,India
306050,2023-10-23,505,oven,18490,24000,5510,1,00104,India
306050,2023-10-23,504,iron,449,879,430,1,00104,India
306050,2023-10-23,507,washing machine,6990,16490,9500,1,00104,India
965530,2023-10-23,502,iphone 15 pro max,100000,135000,35000,2,00040,India
965530,2023-10-23,503,mixer,1349,3249,1900,1,00040,India
965530,2023-10-23,504,iron,449,879,430,1,00040,India
686851,2023-10-23,501,iphone 15,60000,80000,20000,2,00216,India
686851,2023-10-23,504,iron,449,879,430,1,00216,India
682339,2023-10-23,504,iron,449,879,430,1,00112,India
513823,2023-10-23,504,iron,449,879,430,1,00129,India
513823,2023-10-23,505,oven,18490,24000,5510,1,00129,India
280535,2023-10-23,503,mixer,1349,3249,1900,1,00056,India
280535,2023-10-23,505,oven,18490,24000,5510,1,00056,India
280535,2023-10-23,502,iphone 15 pro max,100000,135000,35000,2,00056,India
344029,2023-10-23,503,mixer,1349,3249,1900,1,00346,India
177873,2023-10-23,501,iphone 15,60000,80000,20000,2,00021,India
177873,2023-10-23,505,oven,18490,24000,5510,1,00021,India
177873,2023-10-23,503,mixer,1349,3249,1900,1,00021,India
177873,2023-10-23,506,monitor,3249,8000,4751,1,00021,India
721337,2023-10-23,505,oven,18490,24000,5510,1,00173,India
650141,2023-10-23,505,oven,18490,24000,5510,1,00316,India
275363,2023-10-23,505,oven,18490,24000,5510,1,00240,India
275363,2023-10-23,507,washing machine,6990,16490,9500,1,00240,India
275363,2023-10-23,501,iphone 15,60000,80000,20000,2,00240,India
927018,2023-10-23,504,iron,449,879,430,1,00099,India
535023,2023-10-23,502,iphone 15 pro max,100000,135000,35000,2,00189,India
297264,2023-10-23,505,oven,18490,24000,5510,1,00273,India
297264,2023-10-23,503,mixer,1349,3249,1900,1,00273,India
297264,2023-10-23,502,iphone 15 pro max,100000,135000,35000,2,00273,India
662312,2023-10-23,504,iron,449,879,430,1,00279,India
795627,2023-10-23,504,iron,449,879,430,1,00398,India
795627,2023-10-23,506,monitor,3249,8000,4751,1,00398,India
929282,2023-10-23,504,iron,449,879,430,1,00424,India
632749,2023-10-23,502,iphone 15 pro max,100000,135000,35000,2,00264,India
632749,2023-10-23,507,washing machine,6990,16490,9500,1,00264,India
145055,2023-10-23,501,iphone 15,60000,80000,20000,2,00440,India
145055,2023-10-23,503,mixer,1349,3249,1900,1,00440,India
145055,2023-10-23,507,washing machine,6990,16490,9500,1,00440,India
145055,2023-10-23,505,oven,18490,24000,5510,1,00440,India
462147,2023-10-23,506,monitor,3249,8000,4751,1,00145,India
462147,2023-10-23,503,mixer,1349,3249,1900,1,00145,India
462147,2023-10-23,502,iphone 15 pro max,100000,135000,35000,2,00145,India
462147,2023-10-23,504,iron,449,879,430,1,00145,India
523178,2023-10-23,505,oven,18490,24000,5510,1,00016,India
409356,2023-10-23,506,monitor,3249,8000,4751,1,00144,India
409356,2023-10-23,504,iron,449,879,430,1,00144,India
409356,2023-10-23,505,oven,18490,24000,5510,1,00144,India
268730,2023-10-23,502,iphone 15 pro max,100000,135000,35000,2,00387,India
268730,2023-10-23,505,oven,18490,24000,5510,1,00387,India
288636,2023-10-23,504,iron,449,879,430,1,00232,India
288636,2023-10-23,503,mixer,1349,3249,1900,1,00232,India
288636,2023-10-23,506,monitor,3249,8000,4751,1,00232,India
341721,2023-10-23,502,iphone 15 pro max,100000,135000,35000,2,00442,India
341721,2023-10-23,507,washing machine,6990,16490,9500,1,00442,India
370280,2023-10-23,501,iphone 15,60000,80000,20000,2,00250,India
370280,2023-10-23,505,oven,18490,24000,5510,1,00250,India
370280,2023-10-23,502,iphone 15 pro max,100000,135000,35000,2,00250,India
370280,2023-10-23,504,iron,449,879,430,1,00250,India
801667,2023-10-23,507,washing machine,6990,16490,9500,1,00477,India
797073,2023-10-23,502,iphone 15 pro max,100000,135000,35000,2,00314,India
797073,2023-10-23,503,mixer,1349,3249,1900,1,00314,India
797073,2023-10-23,504,iron,449,879,430,1,00314,India
590944,2023-10-23,505,oven,18490,24000,5510,1,00081,India
590944,2023-10-23,501,iphone 15,60000,80000,20000,2,00081,India
552965,2023-10-23,504,iron,449,879,430,1,00138,India
431608,2023-10-23,506,monitor,3249,8000,4751,1,00279,India
170967,2023-10-23,506,monitor,3249,8000,4751,1,00401,India
170967,2023-10-23,502,iphone 15 pro max,100000,135000,35000,2,00401,India
170967,2023-10-23,507,washing machine,6990,16490,9500,1,00401,India
170967,2023-10-23,503,mixer,1349,3249,1900,1,00401,India
789215,2023-10-23,506,monitor,3249,8000,4751,1,00337,India
789215,2023-10-23,504,iron,449,879,430,1,00337,India
788578,2023-10-23,505,oven,18490,24000,5510,1,00018,India
788578,2023-10-23,507,washing machine,6990,16490,9500,1,00018,India
325729,2023-10-23,503,mixer,1349,3249,1900,1,00117,India
325729,2023-10-23,501,iphone 15,60000,80000,20000,2,00117,India
902894,2023-10-23,507,washing machine,6990,16490,9500,1,00208,India
795894,2023-10-23,501,iphone 15,60000,80000,20000,2,00188,India
795894,2023-10-23,506,monitor,3249,8000,4751,1,00188,India
795894,2023-10-23,505,oven,18490,24000,5510,1,00188,India
297725,2023-10-23,502,iphone 15 pro max,100000,135000,35000,2,00499,India
297725,2023-10-23,505,oven,18490,24000,5510,1,00499,India
185897,2023-10-23,503,mixer,1349,3249,1900,1,00427,India
185897,2023-10-23,501,iphone 15,60000,80000,20000,2,00427,India
334988,2023-10-23,505,oven,18490,24000,5510,1,00044,India
197296,2023-10-23,502,iphone 15 pro max,100000,135000,35000,2,00365,India
197296,2023-10-23,501,iphone 15,60000,80000,20000,2,00365,India
229077,2023-10-23,503,mixer,1349,3249,1900,1,00390,India
459918,2023-10-23,503,mixer,1349,3249,1900,1,00208,India
459918,2023-10-23,507,washing machine,6990,16490,9500,1,00208,India
459918,2023-10-23,506,monitor,3249,8000,4751,1,00208,India
812264,2023-10-23,505,oven,18490,24000,5510,1,00039,India
812264,2023-10-23,506,monitor,3249,8000,4751,1,00039,India
625423,2023-10-23,507,washing machine,6990,16490,9500,1,00422,India
625423,2023-10-23,504,iron,449,879,430,1,00422,India
905764,2023-10-23,502,iphone 15 pro max,100000,135000,35000,2,00105,India
905764,2023-10-23,501,iphone 15,60000,80000,20000,2,00105,India
905764,2023-10-23,505,oven,18490,24000,5510,1,00105,India
661419,2023-10-23,505,oven,18490,24000,5510,1,00498,India
661419,2023-10-23,504,iron,449,879,430,1,00498,India
661419,2023-10-23,503,mixer,1349,3249,1900,1,00498,India
111296,2023-10-23,502,iphone 15 pro max,100000,135000,35000,2,00236,India
111296,2023-10-23,503,mixer,1349,3249,1900,1,00236,India
111296,2023-10-23,507,washing machine,6990,16490,9500,1,00236,India
948090,2023-10-23,506,monitor,3249,8000,4751,1,00393,India
948090,2023-10-23,501,iphone 15,60000,80000,20000,2,00393,India
948090,2023-10-23,503,mixer,1349,3249,1900,1,00393,India
903050,2023-10-23,505,oven,18490,24000,5510,1,00237,India
903050,2023-10-23,502,iphone 15 pro max,100000,135000,35000,2,00237,India
903050,2023-10-23,503,mixer,1349,3249,1900,1,00237,India
276785,2023-10-23,505,oven,18490,24000,5510,1,00147,India
627136,2023-10-23,501,iphone 15,60000,80000,20000,2,00126,India
627136,2023-10-23,506,monitor,3249,8000,4751,1,00126,India
627136,2023-10-23,504,iron,449,879,430,1,00126,India
184311,2023-10-23,501,iphone 15,60000,80000,20000,2,00260,India
184311,2023-10-23,504,iron,449,879,430,1,00260,India
184311,2023-10-23,503,mixer,1349,3249,1900,1,00260,India
249434,2023-10-23,506,monitor,3249,8000,4751,1,00247,India
512324,2023-10-23,503,mixer,1349,3249,1900,1,00047,India
512324,2023-10-23,504,iron,449,879,430,1,00047,India
512324,2023-10-23,502,iphone 15 pro max,100000,135000,35000,2,00047,India
512324,2023-10-23,501,iphone 15,60000,80000,20000,2,00047,India
277694,2023-10-23,501,iphone 15,60000,80000,20000,2,00452,India
277694,2023-10-23,503,mixer,1349,3249,1900,1,00452,India
277694,2023-10-23,502,iphone 15 pro max,100000,135000,35000,2,00452,India
210840,2023-10-23,501,iphone 15,60000,80000,20000,2,00183,India
210840,2023-10-23,504,iron,449,879,430,1,00183,India
542479,2023-10-23,507,washing machine,6990,16490,9500,1,00474,India
542479,2023-10-23,503,mixer,1349,3249,1900,1,00474,India
542479,2023-10-23,504,iron,449,879,430,1,00474,India
542479,2023-10-23,505,oven,18490,24000,5510,1,00474,India
836301,2023-10-23,502,iphone 15 pro max,100000,135000,35000,2,00205,India
160019,2023-10-23,507,washing machine,6990,16490,9500,1,00313,India
372916,2023-10-23,503,mixer,1349,3249,1900,1,00019,India
372916,2023-10-23,506,monitor,3249,8000,4751,1,00019,India
673325,2023-10-23,504,iron,449,879,430,1,00226,India
167365,2023-10-23,502,iphone 15 pro max,100000,135000,35000,2,00247,India
167365,2023-10-23,506,monitor,3249,8000,4751,1,00247,India
443016,2023-10-23,501,iphone 15,60000,80000,20000,2,00141,India
775877,2023-10-23,502,iphone 15 pro max,100000,135000,35000,2,00221,India
775877,2023-10-23,504,iron,449,879,430,1,00221,India
900938,2023-10-23,506,monitor,3249,8000,4751,1,00308,India
900938,2023-10-23,503,mixer,1349,3249,1900,1,00308,India
372129,2023-10-23,505,oven,18490,24000,5510,1,00242,India
372129,2023-10-23,506,monitor,3249,8000,4751,1,00242,India
455444,2023-10-23,503,mixer,1349,3249,1900,1,00244,India
455444,2023-10-23,507,washing machine,6990,16490,9500,1,00244,India
455444,2023-10-23,506,monitor,3249,8000,4751,1,00244,India
455444,2023-10-23,502,iphone 15 pro max,100000,135000,35000,2,00244,India
455444,2023-10-23,505,oven,18490,24000,5510,1,00244,India
331026,2023-10-23,505,oven,18490,24000,5510,1,00368,India
492478,2023-10-23,506,monitor,3249,8000,4751,1,00284,India
492478,2023-10-23,501,iphone 15,60000,80000,20000,2,00284,India
492478,2023-10-23,504,iron,449,879,430,1,00284,India
492478,2023-10-23,507,washing machine,6990,16490,9500,1,00284,India
301184,2023-10-24,507,washing machine,6990,16490,9500,1,00274,India
301184,2023-10-24,504,iron,449,879,430,1,00274,India
335428,2023-10-24,507,washing machine,6990,16490,9500,1,00214,India
335428,2023-10-24,506,monitor,3249,8000,4751,1,00214,India
335428,2023-10-24,501,iphone 15,60000,80000,20000,2,00214,India
647470,2023-10-24,504,iron,449,879,430,1,00064,India
647470,2023-10-24,506,monitor,3249,8000,4751,1,00064,India
647470,2023-10-24,505,oven,18490,24000,5510,1,00064,India
854821,2023-10-24,501,iphone 15,60000,80000,20000,2,00497,India
854821,2023-10-24,507,washing machine,6990,16490,9500,1,00497,India
854821,2023-10-24,503,mixer,1349,3249,1900,1,00497,India
496539,2023-10-24,506,monitor,3249,8000,4751,1,00013,India
496539,2023-10-24,505,oven,18490,24000,5510,1,00013,India
212742,2023-10-24,506,monitor,3249,8000,4751,1,00061,India
212742,2023-10-24,504,iron,449,879,430,1,00061,India
212742,2023-10-24,501,iphone 15,60000,80000,20000,2,00061,India
322618,2023-10-24,505,oven,18490,24000,5510,1,00443,India
322618,2023-10-24,504,iron,449,879,430,1,00443,India
846476,2023-10-24,505,oven,18490,24000,5510,1,00465,India
846476,2023-10-24,506,monitor,3249,8000,4751,1,00465,India
893312,2023-10-24,501,iphone 15,60000,80000,20000,2,00300,India
893312,2023-10-24,504,iron,449,879,430,1,00300,India
893312,2023-10-24,502,iphone 15 pro max,100000,135000,35000,2,00300,India
992432,2023-10-24,505,oven,18490,24000,5510,1,00459,India
992432,2023-10-24,502,iphone 15 pro max,100000,135000,35000,2,00459,India
125031,2023-10-24,501,iphone 15,60000,80000,20000,2,00104,India
125031,2023-10-24,505,oven,18490,24000,5510,1,00104,India
125031,2023-10-24,502,iphone 15 pro max,100000,135000,35000,2,00104,India
375609,2023-10-24,505,oven,18490,24000,5510,1,00245,India
375609,2023-10-24,502,iphone 15 pro max,100000,135000,35000,2,00245,India
886097,2023-10-24,501,iphone 15,60000,80000,20000,2,00350,India
886097,2023-10-24,507,washing machine,6990,16490,9500,1,00350,India
696099,2023-10-24,503,mixer,1349,3249,1900,1,00110,India
530162,2023-10-24,502,iphone 15 pro max,100000,135000,35000,2,00490,India
530162,2023-10-24,506,monitor,3249,8000,4751,1,00490,India
917604,2023-10-24,502,iphone 15 pro max,100000,135000,35000,2,00193,India
681830,2023-10-24,507,washing machine,6990,16490,9500,1,00068,India
681830,2023-10-24,505,oven,18490,24000,5510,1,00068,India
681830,2023-10-24,504,iron,449,879,430,1,00068,India
681830,2023-10-24,502,iphone 15 pro max,100000,135000,35000,2,00068,India
588378,2023-10-24,502,iphone 15 pro max,100000,135000,35000,2,00466,India
588378,2023-10-24,507,washing machine,6990,16490,9500,1,00466,India
505300,2023-10-24,507,washing machine,6990,16490,9500,1,00121,India
505300,2023-10-24,506,monitor,3249,8000,4751,1,00121,India
739438,2023-10-24,505,oven,18490,24000,5510,1,00166,India
739438,2023-10-24,501,iphone 15,60000,80000,20000,2,00166,India
739438,2023-10-24,503,mixer,1349,3249,1900,1,00166,India
275897,2023-10-24,503,mixer,1349,3249,1900,1,00053,India
275897,2023-10-24,507,washing machine,6990,16490,9500,1,00053,India
275897,2023-10-24,506,monitor,3249,8000,4751,1,00053,India
573199,2023-10-24,503,mixer,1349,3249,1900,1,00153,India
573199,2023-10-24,506,monitor,3249,8000,4751,1,00153,India
573199,2023-10-24,501,iphone 15,60000,80000,20000,2,00153,India
573199,2023-10-24,505,oven,18490,24000,5510,1,00153,India
914320,2023-10-24,501,iphone 15,60000,80000,20000,2,00275,India
814283,2023-10-24,502,iphone 15 pro max,100000,135000,35000,2,00471,India
814283,2023-10-24,506,monitor,3249,8000,4751,1,00471,India
249244,2023-10-24,504,iron,449,879,430,1,00497,India
249244,2023-10-24,507,washing machine,6990,16490,9500,1,00497,India
303054,2023-10-24,506,monitor,3249,8000,4751,1,00174,India
529916,2023-10-24,506,monitor,3249,8000,4751,1,00467,India
529916,2023-10-24,502,iphone 15 pro max,100000,135000,35000,2,00467,India
923184,2023-10-24,502,iphone 15 pro max,100000,135000,35000,2,00451,India
923184,2023-10-24,501,iphone 15,60000,80000,20000,2,00451,India
923184,2023-10-24,505,oven,18490,24000,5510,1,00451,India
923184,2023-10-24,507,washing machine,6990,16490,9500,1,00451,India
923184,2023-10-24,506,monitor,3249,8000,4751,1,00451,India
635130,2023-10-24,506,monitor,3249,8000,4751,1,00119,India
635130,2023-10-24,507,washing machine,6990,16490,9500,1,00119,India
635130,2023-10-24,504,iron,449,879,430,1,00119,India
635130,2023-10-24,503,mixer,1349,3249,1900,1,00119,India
789380,2023-10-24,505,oven,18490,24000,5510,1,00172,India
789380,2023-10-24,504,iron,449,879,430,1,00172,India
789380,2023-10-24,502,iphone 15 pro max,100000,135000,35000,2,00172,India
789380,2023-10-24,503,mixer,1349,3249,1900,1,00172,India
156778,2023-10-24,505,oven,18490,24000,5510,1,00474,India
641982,2023-10-24,502,iphone 15 pro max,100000,135000,35000,2,00140,India
704921,2023-10-24,502,iphone 15 pro max,100000,135000,35000,2,00020,India
704921,2023-10-24,501,iphone 15,60000,80000,20000,2,00020,India
375348,2023-10-24,505,oven,18490,24000,5510,1,00415,India
805248,2023-10-24,507,washing machine,6990,16490,9500,1,00232,India
805248,2023-10-24,505,oven,18490,24000,5510,1,00232,India
805248,2023-10-24,502,iphone 15 pro max,100000,135000,35000,2,00232,India
805248,2023-10-24,501,iphone 15,60000,80000,20000,2,00232,India
179641,2023-10-24,506,monitor,3249,8000,4751,1,00069,India
856667,2023-10-24,504,iron,449,879,430,1,00071,India
207803,2023-10-24,504,iron,449,879,430,1,00013,India
207803,2023-10-24,506,monitor,3249,8000,4751,1,00013,India
207803,2023-10-24,505,oven,18490,24000,5510,1,00013,India
207803,2023-10-24,507,washing machine,6990,16490,9500,1,00013,India
274602,2023-10-24,502,iphone 15 pro max,100000,135000,35000,2,00434,India
274602,2023-10-24,501,iphone 15,60000,80000,20000,2,00434,India
357772,2023-10-24,505,oven,18490,24000,5510,1,00485,India
357772,2023-10-24,506,monitor,3249,8000,4751,1,00485,India
566465,2023-10-24,501,iphone 15,60000,80000,20000,2,00141,India
566465,2023-10-24,502,iphone 15 pro max,100000,135000,35000,2,00141,India
566465,2023-10-24,503,mixer,1349,3249,1900,1,00141,India
325446,2023-10-24,503,mixer,1349,3249,1900,1,00071,India
325446,2023-10-24,507,washing machine,6990,16490,9500,1,00071,India
325446,2023-10-24,504,iron,449,879,430,1,00071,India
651129,2023-10-24,503,mixer,1349,3249,1900,1,00017,India
651129,2023-10-24,504,iron,449,879,430,1,00017,India
651129,2023-10-24,506,monitor,3249,8000,4751,1,00017,India
523970,2023-10-24,507,washing machine,6990,16490,9500,1,00253,India
523970,2023-10-24,501,iphone 15,60000,80000,20000,2,00253,India
523970,2023-10-24,504,iron,449,879,430,1,00253,India
833111,2023-10-24,505,oven,18490,24000,5510,1,00061,India
833111,2023-10-24,504,iron,449,879,430,1,00061,India
497337,2023-10-24,504,iron,449,879,430,1,00169,India
497337,2023-10-24,503,mixer,1349,3249,1900,1,00169,India
497337,2023-10-24,506,monitor,3249,8000,4751,1,00169,India
171174,2023-10-24,501,iphone 15,60000,80000,20000,2,00119,India
171174,2023-10-24,505,oven,18490,24000,5510,1,00119,India
171174,2023-10-24,506,monitor,3249,8000,4751,1,00119,India
335798,2023-10-24,503,mixer,1349,3249,1900,1,00167,India
990392,2023-10-24,504,iron,449,879,430,1,00429,India
990392,2023-10-24,505,oven,18490,24000,5510,1,00429,India
990392,2023-10-24,501,iphone 15,60000,80000,20000,2,00429,India
852840,2023-10-24,507,washing machine,6990,16490,9500,1,00005,India
852840,2023-10-24,504,iron,449,879,430,1,00005,India
852840,2023-10-24,506,monitor,3249,8000,4751,1,00005,India
640353,2023-10-24,502,iphone 15 pro max,100000,135000,35000,2,00227,India
560934,2023-10-24,506,monitor,3249,8000,4751,1,00013,India
560934,2023-10-24,501,iphone 15,60000,80000,20000,2,00013,India
560934,2023-10-24,504,iron,449,879,430,1,00013,India
297364,2023-10-24,503,mixer,1349,3249,1900,1,00080,India
243628,2023-10-24,501,iphone 15,60000,80000,20000,2,00324,India
243628,2023-10-24,505,oven,18490,24000,5510,1,00324,India
552397,2023-10-24,506,monitor,3249,8000,4751,1,00261,India
414119,2023-10-24,506,monitor,3249,8000,4751,1,00357,India
803023,2023-10-24,505,oven,18490,24000,5510,1,00104,India
803023,2023-10-24,507,washing machine,6990,16490,9500,1,00104,India
803023,2023-10-24,502,iphone 15 pro max,100000,135000,35000,2,00104,India
803023,2023-10-24,501,iphone 15,60000,80000,20000,2,00104,India
447210,2023-10-24,505,oven,18490,24000,5510,1,00206,India
447210,2023-10-24,506,monitor,3249,8000,4751,1,00206,India
447210,2023-10-24,507,washing machine,6990,16490,9500,1,00206,India
447210,2023-10-24,501,iphone 15,60000,80000,20000,2,00206,India
413999,2023-10-24,501,iphone 15,60000,80000,20000,2,00427,India
220373,2023-10-24,502,iphone 15 pro max,100000,135000,35000,2,00052,India
220373,2023-10-24,507,washing machine,6990,16490,9500,1,00052,India
274921,2023-10-24,507,washing machine,6990,16490,9500,1,00455,India
274921,2023-10-24,501,iphone 15,60000,80000,20000,2,00455,India
223621,2023-10-24,502,iphone 15 pro max,100000,135000,35000,2,00157,India
223621,2023-10-24,505,oven,18490,24000,5510,1,00157,India
123321,2023-10-24,505,oven,18490,24000,5510,1,00286,India
109320,2023-10-24,506,monitor,3249,8000,4751,1,00407,India
109320,2023-10-24,501,iphone 15,60000,80000,20000,2,00407,India
109320,2023-10-24,507,washing machine,6990,16490,9500,1,00407,India
109320,2023-10-24,505,oven,18490,24000,5510,1,00407,India
109320,2023-10-24,502,iphone 15 pro max,100000,135000,35000,2,00407,India
982974,2023-10-24,506,monitor,3249,8000,4751,1,00500,India
982974,2023-10-24,501,iphone 15,60000,80000,20000,2,00500,India
982974,2023-10-24,502,iphone 15 pro max,100000,135000,35000,2,00500,India
713856,2023-10-24,507,washing machine,6990,16490,9500,1,00198,India
713856,2023-10-24,504,iron,449,879,430,1,00198,India
464400,2023-10-24,501,iphone 15,60000,80000,20000,2,00319,India
464400,2023-10-24,504,iron,449,879,430,1,00319,India
464400,2023-10-24,503,mixer,1349,3249,1900,1,00319,India
464400,2023-10-24,507,washing machine,6990,16490,9500,1,00319,India
323950,2023-10-24,502,iphone 15 pro max,100000,135000,35000,2,00143,India
323950,2023-10-24,503,mixer,1349,3249,1900,1,00143,India
630499,2023-10-24,502,iphone 15 pro max,100000,135000,35000,2,00411,India
630499,2023-10-24,501,iphone 15,60000,80000,20000,2,00411,India
630499,2023-10-24,505,oven,18490,24000,5510,1,00411,India
235959,2023-10-24,502,iphone 15 pro max,100000,135000,35000,2,00135,India
702169,2023-10-24,505,oven,18490,24000,5510,1,00122,India
702169,2023-10-24,502,iphone 15 pro max,100000,135000,35000,2,00122,India
702169,2023-10-24,501,iphone 15,60000,80000,20000,2,00122,India
758364,2023-10-24,505,oven,18490,24000,5510,1,00383,India
758364,2023-10-24,504,iron,449,879,430,1,00383,India
843042,2023-10-24,503,mixer,1349,3249,1900,1,00213,India
843042,2023-10-24,504,iron,449,879,430,1,00213,India
843042,2023-10-24,506,monitor,3249,8000,4751,1,00213,India
843042,2023-10-24,505,oven,18490,24000,5510,1,00213,India
807920,2023-10-24,501,iphone 15,60000,80000,20000,2,00397,India
807920,2023-10-24,505,oven,18490,24000,5510,1,00397,India
807920,2023-10-24,506,monitor,3249,8000,4751,1,00397,India
867409,2023-10-24,501,iphone 15,60000,80000,20000,2,00083,India
867409,2023-10-24,506,monitor,3249,8000,4751,1,00083,India
867409,2023-10-24,507,washing machine,6990,16490,9500,1,00083,India
522127,2023-10-24,503,mixer,1349,3249,1900,1,00243,India
176490,2023-10-24,506,monitor,3249,8000,4751,1,00269,India
908585,2023-10-24,507,washing machine,6990,16490,9500,1,00110,India
908585,2023-10-24,503,mixer,1349,3249,1900,1,00110,India
908585,2023-10-24,505,oven,18490,24000,5510,1,00110,India
387835,2023-10-24,505,oven,18490,24000,5510,1,00031,India
387835,2023-10-24,501,iphone 15,60000,80000,20000,2,00031,India
860065,2023-10-24,503,mixer,1349,3249,1900,1,00123,India
860065,2023-10-24,505,oven,18490,24000,5510,1,00123,India
860065,2023-10-24,504,iron,449,879,430,1,00123,India
860065,2023-10-24,502,iphone 15 pro max,100000,135000,35000,2,00123,India
253435,2023-10-24,501,iphone 15,60000,80000,20000,2,00023,India
253435,2023-10-24,504,iron,449,879,430,1,00023,India
253435,2023-10-24,507,washing machine,6990,16490,9500,1,00023,India
705209,2023-10-24,503,mixer,1349,3249,1900,1,00356,India
705209,2023-10-24,507,washing machine,6990,16490,9500,1,00356,India
195407,2023-10-24,506,monitor,3249,8000,4751,1,00084,India
195407,2023-10-24,501,iphone 15,60000,80000,20000,2,00084,India
195407,2023-10-24,504,iron,449,879,430,1,00084,India
195407,2023-10-24,507,washing machine,6990,16490,9500,1,00084,India
630098,2023-10-24,504,iron,449,879,430,1,00203,India
630098,2023-10-24,506,monitor,3249,8000,4751,1,00203,India
630098,2023-10-24,507,washing machine,6990,16490,9500,1,00203,India
810972,2023-10-24,503,mixer,1349,3249,1900,1,00069,India
825304,2023-10-25,507,washing machine,6990,16490,9500,1,00057,India
825304,2023-10-25,502,iphone 15 pro max,100000,135000,35000,2,00057,India
825304,2023-10-25,505,oven,18490,24000,5510,1,00057,India
842008,2023-10-25,505,oven,18490,24000,5510,1,00001,India
842008,2023-10-25,503,mixer,1349,3249,1900,1,00001,India
842008,2023-10-25,504,iron,449,879,430,1,00001,India
801580,2023-10-25,506,monitor,3249,8000,4751,1,00073,India
543684,2023-10-25,503,mixer,1349,3249,1900,1,00371,India
543684,2023-10-25,507,washing machine,6990,16490,9500,1,00371,India
543684,2023-10-25,505,oven,18490,24000,5510,1,00371,India
543684,2023-10-25,502,iphone 15 pro max,100000,135000,35000,2,00371,India
227910,2023-10-25,504,iron,449,879,430,1,00241,India
227910,2023-10-25,506,monitor,3249,8000,4751,1,00241,India
227910,2023-10-25,501,iphone 15,60000,80000,20000,2,00241,India
472811,2023-10-25,501,iphone 15,60000,80000,20000,2,00023,India
472811,2023-10-25,507,washing machine,6990,16490,9500,1,00023,India
391218,2023-10-25,505,oven,18490,24000,5510,1,00270,India
388626,2023-10-25,503,mixer,1349,3249,1900,1,00383,India
388626,2023-10-25,502,iphone 15 pro max,100000,135000,35000,2,00383,India
388626,2023-10-25,501,iphone 15,60000,80000,20000,2,00383,India
484707,2023-10-25,503,mixer,1349,3249,1900,1,00095,India
484707,2023-10-25,502,iphone 15 pro max,100000,135000,35000,2,00095,India
484707,2023-10-25,501,iphone 15,60000,80000,20000,2,00095,India
496127,2023-10-25,505,oven,18490,24000,5510,1,00155,India
180326,2023-10-25,503,mixer,1349,3249,1900,1,00302,India
180326,2023-10-25,501,iphone 15,60000,80000,20000,2,00302,India
180326,2023-10-25,505,oven,18490,24000,5510,1,00302,India
281267,2023-10-25,502,iphone 15 pro max,100000,135000,35000,2,00370,India
281267,2023-10-25,503,mixer,1349,3249,1900,1,00370,India
281267,2023-10-25,501,iphone 15,60000,80000,20000,2,00370,India
868957,2023-10-25,502,iphone 15 pro max,100000,135000,35000,2,00030,India
418587,2023-10-25,505,oven,18490,24000,5510,1,00300,India
418587,2023-10-25,504,iron,449,879,430,1,00300,India
418587,2023-10-25,503,mixer,1349,3249,1900,1,00300,India
623771,2023-10-25,504,iron,449,879,430,1,00099,India
623771,2023-10-25,506,monitor,3249,8000,4751,1,00099,India
623771,2023-10-25,501,iphone 15,60000,80000,20000,2,00099,India
623771,2023-10-25,502,iphone 15 pro max,100000,135000,35000,2,00099,India
931619,2023-10-25,502,iphone 15 pro max,100000,135000,35000,2,00290,India
931619,2023-10-25,506,monitor,3249,8000,4751,1,00290,India
792705,2023-10-25,502,iphone 15 pro max,100000,135000,35000,2,00110,India
792705,2023-10-25,507,washing machine,6990,16490,9500,1,00110,India
792705,2023-10-25,503,mixer,1349,3249,1900,1,00110,India
792705,2023-10-25,505,oven,18490,24000,5510,1,00110,India
198969,2023-10-25,503,mixer,1349,3249,1900,1,00022,India
198969,2023-10-25,502,iphone 15 pro max,100000,135000,35000,2,00022,India
243873,2023-10-25,507,washing machine,6990,16490,9500,1,00310,India
243873,2023-10-25,502,iphone 15 pro max,100000,135000,35000,2,00310,India
243873,2023-10-25,504,iron,449,879,430,1,00310,India
902895,2023-10-25,504,iron,449,879,430,1,00472,India
902895,2023-10-25,507,washing machine,6990,16490,9500,1,00472,India
902895,2023-10-25,506,monitor,3249,8000,4751,1,00472,India
342147,2023-10-25,506,monitor,3249,8000,4751,1,00395,India
342147,2023-10-25,504,iron,449,879,430,1,00395,India
342147,2023-10-25,507,washing machine,6990,16490,9500,1,00395,India
342147,2023-10-25,503,mixer,1349,3249,1900,1,00395,India
942649,2023-10-25,506,monitor,3249,8000,4751,1,00069,India
942649,2023-10-25,502,iphone 15 pro max,100000,135000,35000,2,00069,India
942649,2023-10-25,505,oven,18490,24000,5510,1,00069,India
350981,2023-10-25,501,iphone 15,60000,80000,20000,2,00123,India
350981,2023-10-25,504,iron,449,879,430,1,00123,India
350981,2023-10-25,502,iphone 15 pro max,100000,135000,35000,2,00123,India
162608,2023-10-25,501,iphone 15,60000,80000,20000,2,00016,India
162608,2023-10-25,506,monitor,3249,8000,4751,1,00016,India
162608,2023-10-25,502,iphone 15 pro max,100000,135000,35000,2,00016,India
162608,2023-10-25,505,oven,18490,24000,5510,1,00016,India
666326,2023-10-25,501,iphone 15,60000,80000,20000,2,00351,India
666326,2023-10-25,507,washing machine,6990,16490,9500,1,00351,India
666326,2023-10-25,505,oven,18490,24000,5510,1,00351,India
888575,2023-10-25,506,monitor,3249,8000,4751,1,00383,India
888575,2023-10-25,503,mixer,1349,3249,1900,1,00383,India
888575,2023-10-25,505,oven,18490,24000,5510,1,00383,India
843685,2023-10-25,501,iphone 15,60000,80000,20000,2,00323,India
845212,2023-10-25,504,iron,449,879,430,1,00293,India
325050,2023-10-25,501,iphone 15,60000,80000,20000,2,00105,India
325050,2023-10-25,507,washing machine,6990,16490,9500,1,00105,India
325050,2023-10-25,503,mixer,1349,3249,1900,1,00105,India
325050,2023-10-25,506,monitor,3249,8000,4751,1,00105,India
515713,2023-10-25,505,oven,18490,24000,5510,1,00252,India
152015,2023-10-25,507,washing machine,6990,16490,9500,1,00444,India
152015,2023-10-25,504,iron,449,879,430,1,00444,India
899133,2023-10-25,505,oven,18490,24000,5510,1,00354,India
899133,2023-10-25,502,iphone 15 pro max,100000,135000,35000,2,00354,India
899133,2023-10-25,504,iron,449,879,430,1,00354,India
899133,2023-10-25,503,mixer,1349,3249,1900,1,00354,India
239271,2023-10-25,507,washing machine,6990,16490,9500,1,00485,India
239271,2023-10-25,504,iron,449,879,430,1,00485,India
334457,2023-10-25,502,iphone 15 pro max,100000,135000,35000,2,00255,India
985578,2023-10-25,507,washing machine,6990,16490,9500,1,00093,India
985578,2023-10-25,501,iphone 15,60000,80000,20000,2,00093,India
985578,2023-10-25,502,iphone 15 pro max,100000,135000,35000,2,00093,India
676555,2023-10-25,502,iphone 15 pro max,100000,135000,35000,2,00006,India
676555,2023-10-25,505,oven,18490,24000,5510,1,00006,India
805665,2023-10-25,501,iphone 15,60000,80000,20000,2,00493,India
805665,2023-10-25,503,mixer,1349,3249,1900,1,00493,India
910804,2023-10-25,503,mixer,1349,3249,1900,1,00113,India
910804,2023-10-25,505,oven,18490,24000,5510,1,00113,India
910804,2023-10-25,507,washing machine,6990,16490,9500,1,00113,India
866093,2023-10-25,503,mixer,1349,3249,1900,1,00397,India
866093,2023-10-25,506,monitor,3249,8000,4751,1,00397,India
866093,2023-10-25,504,iron,449,879,430,1,00397,India
266333,2023-10-25,506,monitor,3249,8000,4751,1,00410,India
266333,2023-10-25,501,iphone 15,60000,80000,20000,2,00410,India
831708,2023-10-25,501,iphone 15,60000,80000,20000,2,00013,India
959318,2023-10-25,501,iphone 15,60000,80000,20000,2,00065,India
959318,2023-10-25,507,washing machine,6990,16490,9500,1,00065,India
959318,2023-10-25,504,iron,449,879,430,1,00065,India
318133,2023-10-25,505,oven,18490,24000,5510,1,00435,India
318133,2023-10-25,507,washing machine,6990,16490,9500,1,00435,India
197535,2023-10-25,503,mixer,1349,3249,1900,1,00231,India
197535,2023-10-25,507,washing machine,6990,16490,9500,1,00231,India
197535,2023-10-25,501,iphone 15,60000,80000,20000,2,00231,India
197535,2023-10-25,502,iphone 15 pro max,100000,135000,35000,2,00231,India
138721,2023-10-25,505,oven,18490,24000,5510,1,00458,India
636762,2023-10-25,507,washing machine,6990,16490,9500,1,00067,India
636762,2023-10-25,501,iphone 15,60000,80000,20000,2,00067,India
543972,2023-10-25,504,iron,449,879,430,1,00032,India
543972,2023-10-25,501,iphone 15,60000,80000,20000,2,00032,India
543972,2023-10-25,503,mixer,1349,3249,1900,1,00032,India
760785,2023-10-25,507,washing machine,6990,16490,9500,1,00116,India
760785,2023-10-25,503,mixer,1349,3249,1900,1,00116,India
346597,2023-10-25,501,iphone 15,60000,80000,20000,2,00136,India
346597,2023-10-25,503,mixer,1349,3249,1900,1,00136,India
346597,2023-10-25,504,iron,449,879,430,1,00136,India
945840,2023-10-25,501,iphone 15,60000,80000,20000,2,00140,India
945840,2023-10-25,507,washing machine,6990,16490,9500,1,00140,India
945840,2023-10-25,503,mixer,1349,3249,1900,1,00140,India
945840,2023-10-25,506,monitor,3249,8000,4751,1,00140,India
371711,2023-10-25,505,oven,18490,24000,5510,1,00460,India
371711,2023-10-25,503,mixer,1349,3249,1900,1,00460,India
312088,2023-10-25,502,iphone 15 pro max,100000,135000,35000,2,00276,India
312088,2023-10-25,506,monitor,3249,8000,4751,1,00276,India
225668,2023-10-25,501,iphone 15,60000,80000,20000,2,00473,India
225668,2023-10-25,503,mixer,1349,3249,1900,1,00473,India
225668,2023-10-25,507,washing machine,6990,16490,9500,1,00473,India
225668,2023-10-25,506,monitor,3249,8000,4751,1,00473,India
232245,2023-10-25,506,monitor,3249,8000,4751,1,00431,India
746436,2023-10-25,506,monitor,3249,8000,4751,1,00175,India
688246,2023-10-25,507,washing machine,6990,16490,9500,1,00192,India
688246,2023-10-25,503,mixer,1349,3249,1900,1,00192,India
688246,2023-10-25,502,iphone 15 pro max,100000,135000,35000,2,00192,India
688246,2023-10-25,501,iphone 15,60000,80000,20000,2,00192,India
771224,2023-10-25,505,oven,18490,24000,5510,1,00170,India
975627,2023-10-25,507,washing machine,6990,16490,9500,1,00082,India
975627,2023-10-25,506,monitor,3249,8000,4751,1,00082,India
274179,2023-10-25,502,iphone 15 pro max,100000,135000,35000,2,00037,India
274179,2023-10-25,501,iphone 15,60000,80000,20000,2,00037,India
274179,2023-10-25,504,iron,449,879,430,1,00037,India
942775,2023-10-25,505,oven,18490,24000,5510,1,00082,India
942775,2023-10-25,503,mixer,1349,3249,1900,1,00082,India
942775,2023-10-25,502,iphone 15 pro max,100000,135000,35000,2,00082,India
399625,2023-10-25,505,oven,18490,24000,5510,1,00093,India
399625,2023-10-25,507,washing machine,6990,16490,9500,1,00093,India
399625,2023-10-25,502,iphone 15 pro max,100000,135000,35000,2,00093,India
662426,2023-10-25,504,iron,449,879,430,1,00124,India
796058,2023-10-25,502,iphone 15 pro max,100000,135000,35000,2,00199,India
513194,2023-10-25,503,mixer,1349,3249,1900,1,00197,India
513194,2023-10-25,507,washing machine,6990,16490,9500,1,00197,India
772444,2023-10-25,504,iron,449,879,430,1,00151,India
772444,2023-10-25,501,iphone 15,60000,80000,20000,2,00151,India
772444,2023-10-25,503,mixer,1349,3249,1900,1,00151,India
772444,2023-10-25,502,iphone 15 pro max,100000,135000,35000,2,00151,India
840506,2023-10-25,501,iphone 15,60000,80000,20000,2,00119,India
840506,2023-10-25,502,iphone 15 pro max,100000,135000,35000,2,00119,India
395840,2023-10-25,507,washing machine,6990,16490,9500,1,00367,India
640471,2023-10-25,507,washing machine,6990,16490,9500,1,00124,India
650661,2023-10-25,502,iphone 15 pro max,100000,135000,35000,2,00329,India
650661,2023-10-25,504,iron,449,879,430,1,00329,India
584750,2023-10-25,504,iron,449,879,430,1,00207,India
584750,2023-10-25,505,oven,18490,24000,5510,1,00207,India
934186,2023-10-25,506,monitor,3249,8000,4751,1,00325,India
934186,2023-10-25,503,mixer,1349,3249,1900,1,00325,India
934186,2023-10-25,502,iphone 15 pro max,100000,135000,35000,2,00325,India
788489,2023-10-25,506,monitor,3249,8000,4751,1,00162,India
943964,2023-10-25,502,iphone 15 pro max,100000,135000,35000,2,00381,India
943964,2023-10-25,507,washing machine,6990,16490,9500,1,00381,India
943964,2023-10-25,501,iphone 15,60000,80000,20000,2,00381,India
209797,2023-10-25,504,iron,449,879,430,1,00096,India
209797,2023-10-25,506,monitor,3249,8000,4751,1,00096,India
209797,2023-10-25,503,mixer,1349,3249,1900,1,00096,India
639787,2023-10-25,507,washing machine,6990,16490,9500,1,00304,India
639787,2023-10-25,505,oven,18490,24000,5510,1,00304,India
639787,2023-10-25,504,iron,449,879,430,1,00304,India
639787,2023-10-25,503,mixer,1349,3249,1900,1,00304,India
359681,2023-10-25,507,washing machine,6990,16490,9500,1,00421,India
359681,2023-10-25,502,iphone 15 pro max,100000,135000,35000,2,00421,India
359681,2023-10-25,504,iron,449,879,430,1,00421,India
183972,2023-10-25,501,iphone 15,60000,80000,20000,2,00188,India
183972,2023-10-25,503,mixer,1349,3249,1900,1,00188,India
183972,2023-10-25,504,iron,449,879,430,1,00188,India
787376,2023-10-25,503,mixer,1349,3249,1900,1,00055,India
787376,2023-10-25,502,iphone 15 pro max,100000,135000,35000,2,00055,India
787376,2023-10-25,507,washing machine,6990,16490,9500,1,00055,India
689090,2023-10-25,503,mixer,1349,3249,1900,1,00083,India
689090,2023-10-25,505,oven,18490,24000,5510,1,00083,India
689090,2023-10-25,501,iphone 15,60000,80000,20000,2,00083,India
689090,2023-10-25,502,iphone 15 pro max,100000,135000,35000,2,00083,India
689090,2023-10-25,504,iron,449,879,430,1,00083,India
802701,2023-10-25,505,oven,18490,24000,5510,1,00262,India
802701,2023-10-25,506,monitor,3249,8000,4751,1,00262,India
802701,2023-10-25,507,washing machine,6990,16490,9500,1,00262,India
802701,2023-10-25,502,iphone 15 pro max,100000,135000,35000,2,00262,India
236829,2023-10-25,501,iphone 15,60000,80000,20000,2,00440,India
236829,2023-10-25,506,monitor,3249,8000,4751,1,00440,India
591597,2023-10-25,506,monitor,3249,8000,4751,1,00032,India
591597,2023-10-25,503,mixer,1349,3249,1900,1,00032,India
591597,2023-10-25,502,iphone 15 pro max,100000,135000,35000,2,00032,India
819232,2023-10-25,503,mixer,1349,3249,1900,1,00058,India
819232,2023-10-25,507,washing machine,6990,16490,9500,1,00058,India
235468,2023-10-25,507,washing machine,6990,16490,9500,1,00476,India
235468,2023-10-25,505,oven,18490,24000,5510,1,00476,India
512919,2023-10-25,502,iphone 15 pro max,100000,135000,35000,2,00362,India
512919,2023-10-25,505,oven,18490,24000,5510,1,00362,India
512919,2023-10-25,504,iron,449,879,430,1,00362,India
812987,2023-10-25,506,monitor,3249,8000,4751,1,00035,India
812987,2023-10-25,507,washing machine,6990,16490,9500,1,00035,India
812987,2023-10-25,505,oven,18490,24000,5510,1,00035,India
359259,2023-10-25,506,monitor,3249,8000,4751,1,00394,India
359259,2023-10-25,505,oven,18490,24000,5510,1,00394,India
359259,2023-10-25,507,washing machine,6990,16490,9500,1,00394,India
359259,2023-10-25,502,iphone 15 pro max,100000,135000,35000,2,00394,India
390819,2023-10-25,501,iphone 15,60000,80000,20000,2,00371,India
390819,2023-10-25,503,mixer,1349,3249,1900,1,00371,India
559932,2023-10-25,504,iron,449,879,430,1,00397,India
559932,2023-10-25,507,washing machine,6990,16490,9500,1,00397,India
559932,2023-10-25,503,mixer,1349,3249,1900,1,00397,India
270806,2023-10-25,502,iphone 15 pro max,100000,135000,35000,2,00478,India
223529,2023-10-25,507,washing machine,6990,16490,9500,1,00349,India
223529,2023-10-25,505,oven,18490,24000,5510,1,00349,India
223529,2023-10-25,502,iphone 15 pro max,100000,135000,35000,2,00349,India
223529,2023-10-25,501,iphone 15,60000,80000,20000,2,00349,India
175059,2023-10-25,501,iphone 15,60000,80000,20000,2,00282,India
175059,2023-10-25,504,iron,449,879,430,1,00282,India
936662,2023-10-25,502,iphone 15 pro max,100000,135000,35000,2,00382,India
805762,2023-10-25,505,oven,18490,24000,5510,1,00465,India
343695,2023-10-25,506,monitor,3249,8000,4751,1,00301,India
343695,2023-10-25,503,mixer,1349,3249,1900,1,00301,India
343695,2023-10-25,505,oven,18490,24000,5510,1,00301,India
833635,2023-10-25,501,iphone 15,60000,80000,20000,2,00277,India
833635,2023-10-25,503,mixer,1349,3249,1900,1,00277,India
833635,2023-10-25,504,iron,449,879,430,1,00277,India
833635,2023-10-25,507,washing machine,6990,16490,9500,1,00277,India
971455,2023-10-25,502,iphone 15 pro max,100000,135000,35000,2,00326,India
971455,2023-10-25,505,oven,18490,24000,5510,1,00326,India
559517,2023-10-26,506,monitor,3249,8000,4751,1,00259,India
559517,2023-10-26,501,iphone 15,60000,80000,20000,2,00259,India
559517,2023-10-26,502,iphone 15 pro max,100000,135000,35000,2,00259,India
559517,2023-10-26,503,mixer,1349,3249,1900,1,00259,India
854737,2023-10-26,505,oven,18490,24000,5510,1,00036,India
744647,2023-10-26,507,washing machine,6990,16490,9500,1,00023,India
744647,2023-10-26,504,iron,449,879,430,1,00023,India
744647,2023-10-26,501,iphone 15,60000,80000,20000,2,00023,India
744647,2023-10-26,505,oven,18490,24000,5510,1,00023,India
450668,2023-10-26,504,iron,449,879,430,1,00430,India
450668,2023-10-26,507,washing machine,6990,16490,9500,1,00430,India
954144,2023-10-26,504,iron,449,879,430,1,00218,India
954144,2023-10-26,507,washing machine,6990,16490,9500,1,00218,India
912722,2023-10-26,507,washing machine,6990,16490,9500,1,00160,India
912722,2023-10-26,504,iron,449,879,430,1,00160,India
912722,2023-10-26,506,monitor,3249,8000,4751,1,00160,India
576899,2023-10-26,505,oven,18490,24000,5510,1,00399,India
576899,2023-10-26,503,mixer,1349,3249,1900,1,00399,India
474001,2023-10-26,503,mixer,1349,3249,1900,1,00215,India
474001,2023-10-26,507,washing machine,6990,16490,9500,1,00215,India
474001,2023-10-26,504,iron,449,879,430,1,00215,India
484241,2023-10-26,505,oven,18490,24000,5510,1,00288,India
484241,2023-10-26,503,mixer,1349,3249,1900,1,00288,India
484241,2023-10-26,507,washing machine,6990,16490,9500,1,00288,India
851958,2023-10-26,505,oven,18490,24000,5510,1,00018,India
851958,2023-10-26,506,monitor,3249,8000,4751,1,00018,India
851958,2023-10-26,507,washing machine,6990,16490,9500,1,00018,India
694713,2023-10-26,503,mixer,1349,3249,1900,1,00226,India
694713,2023-10-26,504,iron,449,879,430,1,00226,India
694713,2023-10-26,501,iphone 15,60000,80000,20000,2,00226,India
694713,2023-10-26,502,iphone 15 pro max,100000,135000,35000,2,00226,India
978617,2023-10-26,507,washing machine,6990,16490,9500,1,00165,India
978617,2023-10-26,502,iphone 15 pro max,100000,135000,35000,2,00165,India
978617,2023-10-26,506,monitor,3249,8000,4751,1,00165,India
118941,2023-10-26,503,mixer,1349,3249,1900,1,00400,India
118941,2023-10-26,507,washing machine,6990,16490,9500,1,00400,India
118941,2023-10-26,504,iron,449,879,430,1,00400,India
118941,2023-10-26,502,iphone 15 pro max,100000,135000,35000,2,00400,India
862810,2023-10-26,506,monitor,3249,8000,4751,1,00267,India
862810,2023-10-26,505,oven,18490,24000,5510,1,00267,India
862810,2023-10-26,503,mixer,1349,3249,1900,1,00267,India
944039,2023-10-26,502,iphone 15 pro max,100000,135000,35000,2,00125,India
944039,2023-10-26,501,iphone 15,60000,80000,20000,2,00125,India
750697,2023-10-26,501,iphone 15,60000,80000,20000,2,00147,India
750697,2023-10-26,504,iron,449,879,430,1,00147,India
641083,2023-10-26,504,iron,449,879,430,1,00365,India
641083,2023-10-26,507,washing machine,6990,16490,9500,1,00365,India
641083,2023-10-26,506,monitor,3249,8000,4751,1,00365,India
641083,2023-10-26,505,oven,18490,24000,5510,1,00365,India
672795,2023-10-26,502,iphone 15 pro max,100000,135000,35000,2,00099,India
672795,2023-10-26,501,iphone 15,60000,80000,20000,2,00099,India
672795,2023-10-26,505,oven,18490,24000,5510,1,00099,India
940481,2023-10-26,505,oven,18490,24000,5510,1,00407,India
735071,2023-10-26,507,washing machine,6990,16490,9500,1,00453,India
735071,2023-10-26,506,monitor,3249,8000,4751,1,00453,India
735071,2023-10-26,502,iphone 15 pro max,100000,135000,35000,2,00453,India
735071,2023-10-26,503,mixer,1349,3249,1900,1,00453,India
277785,2023-10-26,502,iphone 15 pro max,100000,135000,35000,2,00495,India
277785,2023-10-26,503,mixer,1349,3249,1900,1,00495,India
148532,2023-10-26,506,monitor,3249,8000,4751,1,00384,India
148532,2023-10-26,502,iphone 15 pro max,100000,135000,35000,2,00384,India
148532,2023-10-26,501,iphone 15,60000,80000,20000,2,00384,India
439981,2023-10-26,505,oven,18490,24000,5510,1,00227,India
439981,2023-10-26,506,monitor,3249,8000,4751,1,00227,India
439981,2023-10-26,503,mixer,1349,3249,1900,1,00227,India
992212,2023-10-26,502,iphone 15 pro max,100000,135000,35000,2,00268,India
992212,2023-10-26,504,iron,449,879,430,1,00268,India
992212,2023-10-26,507,washing machine,6990,16490,9500,1,00268,India
992212,2023-10-26,505,oven,18490,24000,5510,1,00268,India
264769,2023-10-26,506,monitor,3249,8000,4751,1,00177,India
264769,2023-10-26,507,washing machine,6990,16490,9500,1,00177,India
264769,2023-10-26,505,oven,18490,24000,5510,1,00177,India
623371,2023-10-26,507,washing machine,6990,16490,9500,1,00179,India
623371,2023-10-26,503,mixer,1349,3249,1900,1,00179,India
623371,2023-10-26,502,iphone 15 pro max,100000,135000,35000,2,00179,India
798589,2023-10-26,505,oven,18490,24000,5510,1,00399,India
798589,2023-10-26,502,iphone 15 pro max,100000,135000,35000,2,00399,India
798589,2023-10-26,501,iphone 15,60000,80000,20000,2,00399,India
798589,2023-10-26,503,mixer,1349,3249,1900,1,00399,India
798589,2023-10-26,507,washing machine,6990,16490,9500,1,00399,India
854415,2023-10-26,504,iron,449,879,430,1,00039,India
854415,2023-10-26,507,washing machine,6990,16490,9500,1,00039,India
854415,2023-10-26,502,iphone 15 pro max,100000,135000,35000,2,00039,India
854415,2023-10-26,501,iphone 15,60000,80000,20000,2,00039,India
659991,2023-10-26,505,oven,18490,24000,5510,1,00385,India
659991,2023-10-26,506,monitor,3249,8000,4751,1,00385,India
479867,2023-10-26,503,mixer,1349,3249,1900,1,00376,India
479867,2023-10-26,506,monitor,3249,8000,4751,1,00376,India
479867,2023-10-26,502,iphone 15 pro max,100000,135000,35000,2,00376,India
686152,2023-10-26,505,oven,18490,24000,5510,1,00202,India
686152,2023-10-26,507,washing machine,6990,16490,9500,1,00202,India
882793,2023-10-26,507,washing machine,6990,16490,9500,1,00016,India
222112,2023-10-26,502,iphone 15 pro max,100000,135000,35000,2,00454,India
222112,2023-10-26,505,oven,18490,24000,5510,1,00454,India
222112,2023-10-26,501,iphone 15,60000,80000,20000,2,00454,India
985969,2023-10-26,504,iron,449,879,430,1,00128,India
985969,2023-10-26,502,iphone 15 pro max,100000,135000,35000,2,00128,India
985969,2023-10-26,506,monitor,3249,8000,4751,1,00128,India
985969,2023-10-26,501,iphone 15,60000,80000,20000,2,00128,India
824762,2023-10-26,506,monitor,3249,8000,4751,1,00071,India
824762,2023-10-26,503,mixer,1349,3249,1900,1,00071,India
626496,2023-10-26,502,iphone 15 pro max,100000,135000,35000,2,00270,India
626496,2023-10-26,503,mixer,1349,3249,1900,1,00270,India
626496,2023-10-26,505,oven,18490,24000,5510,1,00270,India
804226,2023-10-26,505,oven,18490,24000,5510,1,00139,India
804226,2023-10-26,502,iphone 15 pro max,100000,135000,35000,2,00139,India
804226,2023-10-26,501,iphone 15,60000,80000,20000,2,00139,India
804226,2023-10-26,506,monitor,3249,8000,4751,1,00139,India
998917,2023-10-26,506,monitor,3249,8000,4751,1,00332,India
998917,2023-10-26,505,oven,18490,24000,5510,1,00332,India
998917,2023-10-26,501,iphone 15,60000,80000,20000,2,00332,India
998917,2023-10-26,502,iphone 15 pro max,100000,135000,35000,2,00332,India
824599,2023-10-26,506,monitor,3249,8000,4751,1,00175,India
824599,2023-10-26,504,iron,449,879,430,1,00175,India
824599,2023-10-26,507,washing machine,6990,16490,9500,1,00175,India
104218,2023-10-26,506,monitor,3249,8000,4751,1,00314,India
104218,2023-10-26,507,washing machine,6990,16490,9500,1,00314,India
235306,2023-10-26,504,iron,449,879,430,1,00055,India
235306,2023-10-26,503,mixer,1349,3249,1900,1,00055,India
235306,2023-10-26,505,oven,18490,24000,5510,1,00055,India
235306,2023-10-26,506,monitor,3249,8000,4751,1,00055,India
751760,2023-10-26,503,mixer,1349,3249,1900,1,00366,India
751760,2023-10-26,506,monitor,3249,8000,4751,1,00366,India
751760,2023-10-26,505,oven,18490,24000,5510,1,00366,India
751760,2023-10-26,502,iphone 15 pro max,100000,135000,35000,2,00366,India
675368,2023-10-26,504,iron,449,879,430,1,00198,India
675368,2023-10-26,503,mixer,1349,3249,1900,1,00198,India
675368,2023-10-26,506,monitor,3249,8000,4751,1,00198,India
769207,2023-10-26,505,oven,18490,24000,5510,1,00214,India
769207,2023-10-26,504,iron,449,879,430,1,00214,India
769207,2023-10-26,503,mixer,1349,3249,1900,1,00214,India
861246,2023-10-26,506,monitor,3249,8000,4751,1,00240,India
861246,2023-10-26,507,washing machine,6990,16490,9500,1,00240,India
239206,2023-10-26,502,iphone 15 pro max,100000,135000,35000,2,00479,India
239206,2023-10-26,503,mixer,1349,3249,1900,1,00479,India
588451,2023-10-26,505,oven,18490,24000,5510,1,00256,India
588451,2023-10-26,506,monitor,3249,8000,4751,1,00256,India
588451,2023-10-26,504,iron,449,879,430,1,00256,India
394272,2023-10-26,503,mixer,1349,3249,1900,1,00037,India
394272,2023-10-26,507,washing machine,6990,16490,9500,1,00037,India
857829,2023-10-26,505,oven,18490,24000,5510,1,00222,India
857829,2023-10-26,501,iphone 15,60000,80000,20000,2,00222,India
857829,2023-10-26,504,iron,449,879,430,1,00222,India
209155,2023-10-26,505,oven,18490,24000,5510,1,00230,India
209155,2023-10-26,502,iphone 15 pro max,100000,135000,35000,2,00230,India
209155,2023-10-26,504,iron,449,879,430,1,00230,India
209155,2023-10-26,507,washing machine,6990,16490,9500,1,00230,India
419355,2023-10-26,506,monitor,3249,8000,4751,1,00344,India
419355,2023-10-26,503,mixer,1349,3249,1900,1,00344,India
419355,2023-10-26,505,oven,18490,24000,5510,1,00344,India
347118,2023-10-26,506,monitor,3249,8000,4751,1,00084,India
347118,2023-10-26,507,washing machine,6990,16490,9500,1,00084,India
347118,2023-10-26,505,oven,18490,24000,5510,1,00084,India
629902,2023-10-26,507,washing machine,6990,16490,9500,1,00361,India
786924,2023-10-26,506,monitor,3249,8000,4751,1,00287,India
696170,2023-10-26,504,iron,449,879,430,1,00308,India
314452,2023-10-26,502,iphone 15 pro max,100000,135000,35000,2,00331,India
314452,2023-10-26,503,mixer,1349,3249,1900,1,00331,India
314452,2023-10-26,506,monitor,3249,8000,4751,1,00331,India
315624,2023-10-26,504,iron,449,879,430,1,00484,India
315624,2023-10-26,505,oven,18490,24000,5510,1,00484,India
315624,2023-10-26,503,mixer,1349,3249,1900,1,00484,India
721331,2023-10-26,506,monitor,3249,8000,4751,1,00484,India
721331,2023-10-26,507,washing machine,6990,16490,9500,1,00484,India
721331,2023-10-26,501,iphone 15,60000,80000,20000,2,00484,India
875068,2023-10-26,501,iphone 15,60000,80000,20000,2,00376,India
875068,2023-10-26,502,iphone 15 pro max,100000,135000,35000,2,00376,India
875068,2023-10-26,505,oven,18490,24000,5510,1,00376,India
875068,2023-10-26,506,monitor,3249,8000,4751,1,00376,India
196917,2023-10-26,502,iphone 15 pro max,100000,135000,35000,2,00187,India
196917,2023-10-26,506,monitor,3249,8000,4751,1,00187,India
196917,2023-10-26,505,oven,18490,24000,5510,1,00187,India
114419,2023-10-26,502,iphone 15 pro max,100000,135000,35000,2,00039,India
114419,2023-10-26,501,iphone 15,60000,80000,20000,2,00039,India
114419,2023-10-26,503,mixer,1349,3249,1900,1,00039,India
866683,2023-10-26,506,monitor,3249,8000,4751,1,00378,India
866683,2023-10-26,501,iphone 15,60000,80000,20000,2,00378,India
866683,2023-10-26,504,iron,449,879,430,1,00378,India
513083,2023-10-26,504,iron,449,879,430,1,00193,India
513083,2023-10-26,505,oven,18490,24000,5510,1,00193,India
741256,2023-10-26,504,iron,449,879,430,1,00492,India
741256,2023-10-26,502,iphone 15 pro max,100000,135000,35000,2,00492,India
741256,2023-10-26,505,oven,18490,24000,5510,1,00492,India
741256,2023-10-26,506,monitor,3249,8000,4751,1,00492,India
975064,2023-10-26,501,iphone 15,60000,80000,20000,2,00170,India
975064,2023-10-26,506,monitor,3249,8000,4751,1,00170,India
975064,2023-10-26,502,iphone 15 pro max,100000,135000,35000,2,00170,India
975064,2023-10-26,505,oven,18490,24000,5510,1,00170,India
560588,2023-10-26,506,monitor,3249,8000,4751,1,00217,India
623879,2023-10-26,504,iron,449,879,430,1,00225,India
623879,2023-10-26,506,monitor,3249,8000,4751,1,00225,India
623879,2023-10-26,507,washing machine,6990,16490,9500,1,00225,India
666264,2023-10-26,501,iphone 15,60000,80000,20000,2,00282,India
666264,2023-10-26,506,monitor,3249,8000,4751,1,00282,India
666264,2023-10-26,502,iphone 15 pro max,100000,135000,35000,2,00282,India
987450,2023-10-26,507,washing machine,6990,16490,9500,1,00470,India
546879,2023-10-26,502,iphone 15 pro max,100000,135000,35000,2,00500,India
546879,2023-10-26,504,iron,449,879,430,1,00500,India
546879,2023-10-26,505,oven,18490,24000,5510,1,00500,India
573713,2023-10-26,504,iron,449,879,430,1,00032,India
573713,2023-10-26,506,monitor,3249,8000,4751,1,00032,India
573713,2023-10-26,501,iphone 15,60000,80000,20000,2,00032,India
512193,2023-10-26,504,iron,449,879,430,1,00126,India
512193,2023-10-26,503,mixer,1349,3249,1900,1,00126,India
512193,2023-10-26,502,iphone 15 pro max,100000,135000,35000,2,00126,India
465146,2023-10-26,501,iphone 15,60000,80000,20000,2,00425,India
782810,2023-10-26,506,monitor,3249,8000,4751,1,00050,India
782810,2023-10-26,507,washing machine,6990,16490,9500,1,00050,India
204004,2023-10-26,503,mixer,1349,3249,1900,1,00280,India
204004,2023-10-26,501,iphone 15,60000,80000,20000,2,00280,India
993379,2023-10-26,502,iphone 15 pro max,100000,135000,35000,2,00369,India
993379,2023-10-26,506,monitor,3249,8000,4751,1,00369,India
993379,2023-10-26,504,iron,449,879,430,1,00369,India
152544,2023-10-26,507,washing machine,6990,16490,9500,1,00029,India
152544,2023-10-26,503,mixer,1349,3249,1900,1,00029,India
152544,2023-10-26,501,iphone 15,60000,80000,20000,2,00029,India
152544,2023-10-26,505,oven,18490,24000,5510,1,00029,India
152544,2023-10-26,504,iron,449,879,430,1,00029,India
476744,2023-10-26,502,iphone 15 pro max,100000,135000,35000,2,00426,India
751454,2023-10-26,507,washing machine,6990,16490,9500,1,00376,India
751454,2023-10-26,504,iron,449,879,430,1,00376,India
751454,2023-10-26,503,mixer,1349,3249,1900,1,00376,India
751454,2023-10-26,505,oven,18490,24000,5510,1,00376,India
802964,2023-10-26,502,iphone 15 pro max,100000,135000,35000,2,00317,India
802964,2023-10-26,501,iphone 15,60000,80000,20000,2,00317,India
802964,2023-10-26,507,washing machine,6990,16490,9500,1,00317,India
802964,2023-10-26,505,oven,18490,24000,5510,1,00317,India
482536,2023-10-26,504,iron,449,879,430,1,00224,India
347406,2023-10-26,501,iphone 15,60000,80000,20000,2,00117,India
347406,2023-10-26,503,mixer,1349,3249,1900,1,00117,India
131800,2023-10-26,505,oven,18490,24000,5510,1,00005,India
131800,2023-10-26,507,washing machine,6990,16490,9500,1,00005,India
131800,2023-10-26,501,iphone 15,60000,80000,20000,2,00005,India
163934,2023-10-26,506,monitor,3249,8000,4751,1,00300,India
163934,2023-10-26,507,washing machine,6990,16490,9500,1,00300,India
163934,2023-10-26,502,iphone 15 pro max,100000,135000,35000,2,00300,India
163934,2023-10-26,504,iron,449,879,430,1,00300,India
659268,2023-10-26,504,iron,449,879,430,1,00219,India
659268,2023-10-26,506,monitor,3249,8000,4751,1,00219,India
659268,2023-10-26,503,mixer,1349,3249,1900,1,00219,India
289758,2023-10-26,501,iphone 15,60000,80000,20000,2,00059,India
243450,2023-10-26,503,mixer,1349,3249,1900,1,00466,India
243450,2023-10-26,505,oven,18490,24000,5510,1,00466,India
669825,2023-10-26,507,washing machine,6990,16490,9500,1,00173,India
669825,2023-10-26,506,monitor,3249,8000,4751,1,00173,India
669825,2023-10-26,504,iron,449,879,430,1,00173,India
669825,2023-10-26,502,iphone 15 pro max,100000,135000,35000,2,00173,India
634153,2023-10-26,505,oven,18490,24000,5510,1,00329,India
634153,2023-10-26,502,iphone 15 pro max,100000,135000,35000,2,00329,India
912736,2023-10-26,502,iphone 15 pro max,100000,135000,35000,2,00222,India
912736,2023-10-26,506,monitor,3249,8000,4751,1,00222,India
912736,2023-10-26,505,oven,18490,24000,5510,1,00222,India
364718,2023-10-26,506,monitor,3249,8000,4751,1,00036,India
364718,2023-10-26,505,oven,18490,24000,5510,1,00036,India
448435,2023-10-27,506,monitor,3249,8000,4751,1,00187,India
448435,2023-10-27,503,mixer,1349,3249,1900,1,00187,India
448435,2023-10-27,502,iphone 15 pro max,100000,135000,35000,2,00187,India
898979,2023-10-27,501,iphone 15,60000,80000,20000,2,00440,India
898979,2023-10-27,506,monitor,3249,8000,4751,1,00440,India
507358,2023-10-27,503,mixer,1349,3249,1900,1,00169,India
507358,2023-10-27,502,iphone 15 pro max,100000,135000,35000,2,00169,India
507358,2023-10-27,507,washing machine,6990,16490,9500,1,00169,India
215297,2023-10-27,503,mixer,1349,3249,1900,1,00475,India
215297,2023-10-27,506,monitor,3249,8000,4751,1,00475,India
215297,2023-10-27,505,oven,18490,24000,5510,1,00475,India
868331,2023-10-27,501,iphone 15,60000,80000,20000,2,00388,India
868331,2023-10-27,507,washing machine,6990,16490,9500,1,00388,India
537347,2023-10-27,507,washing machine,6990,16490,9500,1,00469,India
537347,2023-10-27,503,mixer,1349,3249,1900,1,00469,India
537347,2023-10-27,501,iphone 15,60000,80000,20000,2,00469,India
341721,2023-10-27,505,oven,18490,24000,5510,1,00442,India
341721,2023-10-27,506,monitor,3249,8000,4751,1,00442,India
831421,2023-10-27,501,iphone 15,60000,80000,20000,2,00305,India
831421,2023-10-27,502,iphone 15 pro max,100000,135000,35000,2,00305,India
831421,2023-10-27,505,oven,18490,24000,5510,1,00305,India
831421,2023-10-27,503,mixer,1349,3249,1900,1,00305,India
402182,2023-10-27,505,oven,18490,24000,5510,1,00106,India
402182,2023-10-27,502,iphone 15 pro max,100000,135000,35000,2,00106,India
402182,2023-10-27,501,iphone 15,60000,80000,20000,2,00106,India
230231,2023-10-27,501,iphone 15,60000,80000,20000,2,00314,India
910990,2023-10-27,505,oven,18490,24000,5510,1,00228,India
910990,2023-10-27,506,monitor,3249,8000,4751,1,00228,India
899133,2023-10-27,502,iphone 15 pro max,100000,135000,35000,2,00354,India
899133,2023-10-27,503,mixer,1349,3249,1900,1,00354,India
899133,2023-10-27,505,oven,18490,24000,5510,1,00354,India
727125,2023-10-27,504,iron,449,879,430,1,00181,India
727125,2023-10-27,506,monitor,3249,8000,4751,1,00181,India
342970,2023-10-27,504,iron,449,879,430,1,00062,India
648331,2023-10-27,501,iphone 15,60000,80000,20000,2,00344,India
955544,2023-10-27,502,iphone 15 pro max,100000,135000,35000,2,00202,India
955544,2023-10-27,507,washing machine,6990,16490,9500,1,00202,India
955544,2023-10-27,503,mixer,1349,3249,1900,1,00202,India
955544,2023-10-27,506,monitor,3249,8000,4751,1,00202,India
578608,2023-10-27,505,oven,18490,24000,5510,1,00084,India
578608,2023-10-27,502,iphone 15 pro max,100000,135000,35000,2,00084,India
578608,2023-10-27,503,mixer,1349,3249,1900,1,00084,India
578608,2023-10-27,507,washing machine,6990,16490,9500,1,00084,India
578608,2023-10-27,501,iphone 15,60000,80000,20000,2,00084,India
881464,2023-10-27,505,oven,18490,24000,5510,1,00326,India
881464,2023-10-27,507,washing machine,6990,16490,9500,1,00326,India
394736,2023-10-27,506,monitor,3249,8000,4751,1,00431,India
394736,2023-10-27,502,iphone 15 pro max,100000,135000,35000,2,00431,India
966115,2023-10-27,504,iron,449,879,430,1,00024,India
966115,2023-10-27,505,oven,18490,24000,5510,1,00024,India
966115,2023-10-27,506,monitor,3249,8000,4751,1,00024,India
157691,2023-10-27,506,monitor,3249,8000,4751,1,00403,India
157691,2023-10-27,503,mixer,1349,3249,1900,1,00403,India
619817,2023-10-27,501,iphone 15,60000,80000,20000,2,00239,India
619817,2023-10-27,505,oven,18490,24000,5510,1,00239,India
619817,2023-10-27,502,iphone 15 pro max,100000,135000,35000,2,00239,India
170520,2023-10-27,507,washing machine,6990,16490,9500,1,00297,India
436852,2023-10-27,502,iphone 15 pro max,100000,135000,35000,2,00201,India
436852,2023-10-27,507,washing machine,6990,16490,9500,1,00201,India
781752,2023-10-27,502,iphone 15 pro max,100000,135000,35000,2,00132,India
781752,2023-10-27,501,iphone 15,60000,80000,20000,2,00132,India
524960,2023-10-27,506,monitor,3249,8000,4751,1,00192,India
524960,2023-10-27,503,mixer,1349,3249,1900,1,00192,India
524960,2023-10-27,504,iron,449,879,430,1,00192,India
291522,2023-10-27,504,iron,449,879,430,1,00019,India
291522,2023-10-27,502,iphone 15 pro max,100000,135000,35000,2,00019,India
130076,2023-10-27,504,iron,449,879,430,1,00382,India
510785,2023-10-27,505,oven,18490,24000,5510,1,00012,India
510785,2023-10-27,501,iphone 15,60000,80000,20000,2,00012,India
510785,2023-10-27,504,iron,449,879,430,1,00012,India
510785,2023-10-27,506,monitor,3249,8000,4751,1,00012,India
201752,2023-10-27,504,iron,449,879,430,1,00412,India
201752,2023-10-27,502,iphone 15 pro max,100000,135000,35000,2,00412,India
201752,2023-10-27,503,mixer,1349,3249,1900,1,00412,India
914183,2023-10-27,505,oven,18490,24000,5510,1,00094,India
914183,2023-10-27,506,monitor,3249,8000,4751,1,00094,India
558807,2023-10-27,503,mixer,1349,3249,1900,1,00463,India
558807,2023-10-27,506,monitor,3249,8000,4751,1,00463,India
558807,2023-10-27,504,iron,449,879,430,1,00463,India
341375,2023-10-27,507,washing machine,6990,16490,9500,1,00156,India
727239,2023-10-27,506,monitor,3249,8000,4751,1,00021,India
727239,2023-10-27,504,iron,449,879,430,1,00021,India
727239,2023-10-27,503,mixer,1349,3249,1900,1,00021,India
727239,2023-10-27,502,iphone 15 pro max,100000,135000,35000,2,00021,India
935172,2023-10-27,503,mixer,1349,3249,1900,1,00465,India
935172,2023-10-27,502,iphone 15 pro max,100000,135000,35000,2,00465,India
935172,2023-10-27,507,washing machine,6990,16490,9500,1,00465,India
397184,2023-10-27,502,iphone 15 pro max,100000,135000,35000,2,00402,India
397184,2023-10-27,501,iphone 15,60000,80000,20000,2,00402,India
397184,2023-10-27,503,mixer,1349,3249,1900,1,00402,India
318210,2023-10-27,504,iron,449,879,430,1,00144,India
318210,2023-10-27,502,iphone 15 pro max,100000,135000,35000,2,00144,India
332833,2023-10-27,505,oven,18490,24000,5510,1,00281,India
332833,2023-10-27,503,mixer,1349,3249,1900,1,00281,India
905250,2023-10-27,502,iphone 15 pro max,100000,135000,35000,2,00256,India
905250,2023-10-27,503,mixer,1349,3249,1900,1,00256,India
784114,2023-10-27,505,oven,18490,24000,5510,1,00235,India
784114,2023-10-27,501,iphone 15,60000,80000,20000,2,00235,India
984501,2023-10-27,506,monitor,3249,8000,4751,1,00383,India
984501,2023-10-27,502,iphone 15 pro max,100000,135000,35000,2,00383,India
227162,2023-10-27,505,oven,18490,24000,5510,1,00197,India
227162,2023-10-27,507,washing machine,6990,16490,9500,1,00197,India
227162,2023-10-27,504,iron,449,879,430,1,00197,India
227162,2023-10-27,501,iphone 15,60000,80000,20000,2,00197,India
642644,2023-10-27,502,iphone 15 pro max,100000,135000,35000,2,00148,India
642644,2023-10-27,504,iron,449,879,430,1,00148,India
642644,2023-10-27,505,oven,18490,24000,5510,1,00148,India
642644,2023-10-27,506,monitor,3249,8000,4751,1,00148,India
283988,2023-10-27,501,iphone 15,60000,80000,20000,2,00304,India
283988,2023-10-27,505,oven,18490,24000,5510,1,00304,India
800780,2023-10-27,502,iphone 15 pro max,100000,135000,35000,2,00225,India
449669,2023-10-27,501,iphone 15,60000,80000,20000,2,00128,India
225402,2023-10-27,503,mixer,1349,3249,1900,1,00205,India
225402,2023-10-27,505,oven,18490,24000,5510,1,00205,India
225402,2023-10-27,506,monitor,3249,8000,4751,1,00205,India
878230,2023-10-27,501,iphone 15,60000,80000,20000,2,00384,India
562759,2023-10-27,506,monitor,3249,8000,4751,1,00291,India
562759,2023-10-27,505,oven,18490,24000,5510,1,00291,India
562759,2023-10-27,501,iphone 15,60000,80000,20000,2,00291,India
214948,2023-10-27,502,iphone 15 pro max,100000,135000,35000,2,00407,India
874243,2023-10-27,501,iphone 15,60000,80000,20000,2,00123,India
874243,2023-10-27,505,oven,18490,24000,5510,1,00123,India
874243,2023-10-27,504,iron,449,879,430,1,00123,India
487228,2023-10-27,507,washing machine,6990,16490,9500,1,00406,India
487228,2023-10-27,501,iphone 15,60000,80000,20000,2,00406,India
860330,2023-10-27,506,monitor,3249,8000,4751,1,00327,India
860330,2023-10-27,504,iron,449,879,430,1,00327,India
805621,2023-10-27,507,washing machine,6990,16490,9500,1,00177,India
805621,2023-10-27,506,monitor,3249,8000,4751,1,00177,India
662425,2023-10-27,503,mixer,1349,3249,1900,1,00181,India
662425,2023-10-27,501,iphone 15,60000,80000,20000,2,00181,India
662425,2023-10-27,506,monitor,3249,8000,4751,1,00181,India
372484,2023-10-27,502,iphone 15 pro max,100000,135000,35000,2,00431,India
429210,2023-10-27,501,iphone 15,60000,80000,20000,2,00167,India
429210,2023-10-27,507,washing machine,6990,16490,9500,1,00167,India
429210,2023-10-27,503,mixer,1349,3249,1900,1,00167,India
429210,2023-10-27,506,monitor,3249,8000,4751,1,00167,India
429210,2023-10-27,505,oven,18490,24000,5510,1,00167,India
576094,2023-10-27,506,monitor,3249,8000,4751,1,00278,India
576094,2023-10-27,504,iron,449,879,430,1,00278,India
576094,2023-10-27,501,iphone 15,60000,80000,20000,2,00278,India
384898,2023-10-27,507,washing machine,6990,16490,9500,1,00416,India
384898,2023-10-27,504,iron,449,879,430,1,00416,India
384898,2023-10-27,502,iphone 15 pro max,100000,135000,35000,2,00416,India
481113,2023-10-27,501,iphone 15,60000,80000,20000,2,00385,India
481113,2023-10-27,507,washing machine,6990,16490,9500,1,00385,India
481113,2023-10-27,506,monitor,3249,8000,4751,1,00385,India
904463,2023-10-27,505,oven,18490,24000,5510,1,00438,India
904463,2023-10-27,503,mixer,1349,3249,1900,1,00438,India
904463,2023-10-27,507,washing machine,6990,16490,9500,1,00438,India
685059,2023-10-27,506,monitor,3249,8000,4751,1,00196,India
685059,2023-10-27,504,iron,449,879,430,1,00196,India
685059,2023-10-27,501,iphone 15,60000,80000,20000,2,00196,India
523457,2023-10-27,505,oven,18490,24000,5510,1,00129,India
523457,2023-10-27,503,mixer,1349,3249,1900,1,00129,India
523457,2023-10-27,501,iphone 15,60000,80000,20000,2,00129,India
523457,2023-10-27,504,iron,449,879,430,1,00129,India
523457,2023-10-27,506,monitor,3249,8000,4751,1,00129,India
450327,2023-10-27,504,iron,449,879,430,1,00355,India
450327,2023-10-27,507,washing machine,6990,16490,9500,1,00355,India
450327,2023-10-27,503,mixer,1349,3249,1900,1,00355,India
450327,2023-10-27,502,iphone 15 pro max,100000,135000,35000,2,00355,India
993509,2023-10-27,506,monitor,3249,8000,4751,1,00016,India
993509,2023-10-27,507,washing machine,6990,16490,9500,1,00016,India
993509,2023-10-27,503,mixer,1349,3249,1900,1,00016,India
329054,2023-10-27,504,iron,449,879,430,1,00337,India
329054,2023-10-27,501,iphone 15,60000,80000,20000,2,00337,India
329054,2023-10-27,506,monitor,3249,8000,4751,1,00337,India
329054,2023-10-27,507,washing machine,6990,16490,9500,1,00337,India
329054,2023-10-27,502,iphone 15 pro max,100000,135000,35000,2,00337,India
430748,2023-10-27,501,iphone 15,60000,80000,20000,2,00109,India
430748,2023-10-27,505,oven,18490,24000,5510,1,00109,India
430748,2023-10-27,507,washing machine,6990,16490,9500,1,00109,India
650508,2023-10-27,505,oven,18490,24000,5510,1,00358,India
376056,2023-10-27,506,monitor,3249,8000,4751,1,00102,India
376056,2023-10-27,504,iron,449,879,430,1,00102,India
124494,2023-10-27,502,iphone 15 pro max,100000,135000,35000,2,00062,India
124494,2023-10-27,504,iron,449,879,430,1,00062,India
124494,2023-10-27,501,iphone 15,60000,80000,20000,2,00062,India
829437,2023-10-27,503,mixer,1349,3249,1900,1,00287,India
829437,2023-10-27,504,iron,449,879,430,1,00287,India
829437,2023-10-27,506,monitor,3249,8000,4751,1,00287,India
829437,2023-10-27,502,iphone 15 pro max,100000,135000,35000,2,00287,India
100609,2023-10-27,506,monitor,3249,8000,4751,1,00106,India
100609,2023-10-27,507,washing machine,6990,16490,9500,1,00106,India
313986,2023-10-27,501,iphone 15,60000,80000,20000,2,00199,India
313986,2023-10-27,506,monitor,3249,8000,4751,1,00199,India
313986,2023-10-27,504,iron,449,879,430,1,00199,India
242081,2023-10-27,502,iphone 15 pro max,100000,135000,35000,2,00101,India
242081,2023-10-27,505,oven,18490,24000,5510,1,00101,India
242081,2023-10-27,503,mixer,1349,3249,1900,1,00101,India
242081,2023-10-27,506,monitor,3249,8000,4751,1,00101,India
242081,2023-10-27,501,iphone 15,60000,80000,20000,2,00101,India
723116,2023-10-27,501,iphone 15,60000,80000,20000,2,00278,India
316043,2023-10-27,501,iphone 15,60000,80000,20000,2,00470,India
316043,2023-10-27,504,iron,449,879,430,1,00470,India
316043,2023-10-27,506,monitor,3249,8000,4751,1,00470,India
316043,2023-10-27,505,oven,18490,24000,5510,1,00470,India
908927,2023-10-27,506,monitor,3249,8000,4751,1,00465,India
908927,2023-10-27,501,iphone 15,60000,80000,20000,2,00465,India
859653,2023-10-28,506,monitor,3249,8000,4751,1,00464,India
859653,2023-10-28,505,oven,18490,24000,5510,1,00464,India
859653,2023-10-28,507,washing machine,6990,16490,9500,1,00464,India
394231,2023-10-28,506,monitor,3249,8000,4751,1,00275,India
394231,2023-10-28,505,oven,18490,24000,5510,1,00275,India
363221,2023-10-28,506,monitor,3249,8000,4751,1,00467,India
363221,2023-10-28,503,mixer,1349,3249,1900,1,00467,India
363221,2023-10-28,502,iphone 15 pro max,100000,135000,35000,2,00467,India
783174,2023-10-28,506,monitor,3249,8000,4751,1,00013,India
529099,2023-10-28,501,iphone 15,60000,80000,20000,2,00272,India
529099,2023-10-28,507,washing machine,6990,16490,9500,1,00272,India
529099,2023-10-28,506,monitor,3249,8000,4751,1,00272,India
529099,2023-10-28,505,oven,18490,24000,5510,1,00272,India
144259,2023-10-28,501,iphone 15,60000,80000,20000,2,00292,India
144259,2023-10-28,507,washing machine,6990,16490,9500,1,00292,India
187993,2023-10-28,502,iphone 15 pro max,100000,135000,35000,2,00487,India
187993,2023-10-28,504,iron,449,879,430,1,00487,India
335925,2023-10-28,504,iron,449,879,430,1,00181,India
335925,2023-10-28,505,oven,18490,24000,5510,1,00181,India
335925,2023-10-28,506,monitor,3249,8000,4751,1,00181,India
335925,2023-10-28,503,mixer,1349,3249,1900,1,00181,India
153845,2023-10-28,502,iphone 15 pro max,100000,135000,35000,2,00220,India
153845,2023-10-28,504,iron,449,879,430,1,00220,India
153845,2023-10-28,507,washing machine,6990,16490,9500,1,00220,India
153845,2023-10-28,501,iphone 15,60000,80000,20000,2,00220,India
353891,2023-10-28,505,oven,18490,24000,5510,1,00377,India
353891,2023-10-28,507,washing machine,6990,16490,9500,1,00377,India
353891,2023-10-28,502,iphone 15 pro max,100000,135000,35000,2,00377,India
787212,2023-10-28,506,monitor,3249,8000,4751,1,00414,India
787212,2023-10-28,505,oven,18490,24000,5510,1,00414,India
787212,2023-10-28,504,iron,449,879,430,1,00414,India
787212,2023-10-28,503,mixer,1349,3249,1900,1,00414,India
114630,2023-10-28,504,iron,449,879,430,1,00270,India
114630,2023-10-28,505,oven,18490,24000,5510,1,00270,India
114630,2023-10-28,506,monitor,3249,8000,4751,1,00270,India
631946,2023-10-28,501,iphone 15,60000,80000,20000,2,00058,India
631946,2023-10-28,507,washing machine,6990,16490,9500,1,00058,India
631946,2023-10-28,502,iphone 15 pro max,100000,135000,35000,2,00058,India
631946,2023-10-28,503,mixer,1349,3249,1900,1,00058,India
877708,2023-10-28,502,iphone 15 pro max,100000,135000,35000,2,00274,India
664241,2023-10-28,502,iphone 15 pro max,100000,135000,35000,2,00128,India
608114,2023-10-28,504,iron,449,879,430,1,00453,India
608114,2023-10-28,503,mixer,1349,3249,1900,1,00453,India
608114,2023-10-28,501,iphone 15,60000,80000,20000,2,00453,India
480755,2023-10-28,502,iphone 15 pro max,100000,135000,35000,2,00121,India
480755,2023-10-28,507,washing machine,6990,16490,9500,1,00121,India
480755,2023-10-28,503,mixer,1349,3249,1900,1,00121,India
900226,2023-10-28,507,washing machine,6990,16490,9500,1,00369,India
900226,2023-10-28,503,mixer,1349,3249,1900,1,00369,India
347645,2023-10-28,505,oven,18490,24000,5510,1,00094,India
347645,2023-10-28,504,iron,449,879,430,1,00094,India
497662,2023-10-28,504,iron,449,879,430,1,00284,India
497662,2023-10-28,506,monitor,3249,8000,4751,1,00284,India
497662,2023-10-28,507,washing machine,6990,16490,9500,1,00284,India
497662,2023-10-28,505,oven,18490,24000,5510,1,00284,India
976362,2023-10-28,505,oven,18490,24000,5510,1,00103,India
976362,2023-10-28,502,iphone 15 pro max,100000,135000,35000,2,00103,India
673669,2023-10-28,505,oven,18490,24000,5510,1,00408,India
673669,2023-10-28,502,iphone 15 pro max,100000,135000,35000,2,00408,India
603597,2023-10-28,501,iphone 15,60000,80000,20000,2,00138,India
603597,2023-10-28,505,oven,18490,24000,5510,1,00138,India
603597,2023-10-28,506,monitor,3249,8000,4751,1,00138,India
877218,2023-10-28,502,iphone 15 pro max,100000,135000,35000,2,00204,India
877218,2023-10-28,501,iphone 15,60000,80000,20000,2,00204,India
877218,2023-10-28,505,oven,18490,24000,5510,1,00204,India
135007,2023-10-28,502,iphone 15 pro max,100000,135000,35000,2,00083,India
135007,2023-10-28,506,monitor,3249,8000,4751,1,00083,India
135007,2023-10-28,505,oven,18490,24000,5510,1,00083,India
877806,2023-10-28,506,monitor,3249,8000,4751,1,00236,India
592834,2023-10-28,503,mixer,1349,3249,1900,1,00024,India
592834,2023-10-28,502,iphone 15 pro max,100000,135000,35000,2,00024,India
746749,2023-10-28,504,iron,449,879,430,1,00499,India
746749,2023-10-28,506,monitor,3249,8000,4751,1,00499,India
746749,2023-10-28,503,mixer,1349,3249,1900,1,00499,India
797368,2023-10-28,501,iphone 15,60000,80000,20000,2,00171,India
699161,2023-10-28,506,monitor,3249,8000,4751,1,00424,India
699161,2023-10-28,501,iphone 15,60000,80000,20000,2,00424,India
699161,2023-10-28,504,iron,449,879,430,1,00424,India
699161,2023-10-28,505,oven,18490,24000,5510,1,00424,India
536695,2023-10-28,503,mixer,1349,3249,1900,1,00257,India
536695,2023-10-28,502,iphone 15 pro max,100000,135000,35000,2,00257,India
536695,2023-10-28,504,iron,449,879,430,1,00257,India
536695,2023-10-28,506,monitor,3249,8000,4751,1,00257,India
992645,2023-10-28,507,washing machine,6990,16490,9500,1,00224,India
992645,2023-10-28,505,oven,18490,24000,5510,1,00224,India
992645,2023-10-28,504,iron,449,879,430,1,00224,India
861047,2023-10-28,501,iphone 15,60000,80000,20000,2,00397,India
861047,2023-10-28,504,iron,449,879,430,1,00397,India
861047,2023-10-28,506,monitor,3249,8000,4751,1,00397,India
289019,2023-10-28,505,oven,18490,24000,5510,1,00470,India
289019,2023-10-28,502,iphone 15 pro max,100000,135000,35000,2,00470,India
289019,2023-10-28,507,washing machine,6990,16490,9500,1,00470,India
927960,2023-10-28,504,iron,449,879,430,1,00164,India
586936,2023-10-28,505,oven,18490,24000,5510,1,00421,India
241638,2023-10-28,503,mixer,1349,3249,1900,1,00454,India
241638,2023-10-28,501,iphone 15,60000,80000,20000,2,00454,India
779564,2023-10-28,501,iphone 15,60000,80000,20000,2,00320,India
779564,2023-10-28,503,mixer,1349,3249,1900,1,00320,India
361306,2023-10-28,502,iphone 15 pro max,100000,135000,35000,2,00258,India
650162,2023-10-28,501,iphone 15,60000,80000,20000,2,00469,India
309335,2023-10-28,506,monitor,3249,8000,4751,1,00174,India
309335,2023-10-28,503,mixer,1349,3249,1900,1,00174,India
708727,2023-10-28,503,mixer,1349,3249,1900,1,00263,India
708727,2023-10-28,504,iron,449,879,430,1,00263,India
708727,2023-10-28,502,iphone 15 pro max,100000,135000,35000,2,00263,India
556599,2023-10-28,503,mixer,1349,3249,1900,1,00006,India
718051,2023-10-28,504,iron,449,879,430,1,00211,India
865779,2023-10-28,506,monitor,3249,8000,4751,1,00276,India
865779,2023-10-28,504,iron,449,879,430,1,00276,India
865779,2023-10-28,505,oven,18490,24000,5510,1,00276,India
427092,2023-10-28,505,oven,18490,24000,5510,1,00217,India
427092,2023-10-28,502,iphone 15 pro max,100000,135000,35000,2,00217,India
806985,2023-10-28,503,mixer,1349,3249,1900,1,00170,India
806985,2023-10-28,505,oven,18490,24000,5510,1,00170,India
806985,2023-10-28,502,iphone 15 pro max,100000,135000,35000,2,00170,India
950892,2023-10-28,504,iron,449,879,430,1,00466,India
950892,2023-10-28,505,oven,18490,24000,5510,1,00466,India
116601,2023-10-28,502,iphone 15 pro max,100000,135000,35000,2,00348,India
116601,2023-10-28,505,oven,18490,24000,5510,1,00348,India
116601,2023-10-28,503,mixer,1349,3249,1900,1,00348,India
116601,2023-10-28,504,iron,449,879,430,1,00348,India
719494,2023-10-28,503,mixer,1349,3249,1900,1,00035,India
226523,2023-10-28,501,iphone 15,60000,80000,20000,2,00406,India
226523,2023-10-28,502,iphone 15 pro max,100000,135000,35000,2,00406,India
226523,2023-10-28,504,iron,449,879,430,1,00406,India
886138,2023-10-28,506,monitor,3249,8000,4751,1,00369,India
886138,2023-10-28,505,oven,18490,24000,5510,1,00369,India
926234,2023-10-28,505,oven,18490,24000,5510,1,00397,India
926234,2023-10-28,501,iphone 15,60000,80000,20000,2,00397,India
926234,2023-10-28,506,monitor,3249,8000,4751,1,00397,India
240743,2023-10-29,504,iron,449,879,430,1,00482,India
240743,2023-10-29,505,oven,18490,24000,5510,1,00482,India
240743,2023-10-29,501,iphone 15,60000,80000,20000,2,00482,India
933123,2023-10-29,507,washing machine,6990,16490,9500,1,00098,India
933123,2023-10-29,503,mixer,1349,3249,1900,1,00098,India
933123,2023-10-29,504,iron,449,879,430,1,00098,India
933123,2023-10-29,505,oven,18490,24000,5510,1,00098,India
933123,2023-10-29,501,iphone 15,60000,80000,20000,2,00098,India
136295,2023-10-29,502,iphone 15 pro max,100000,135000,35000,2,00390,India
136295,2023-10-29,501,iphone 15,60000,80000,20000,2,00390,India
136295,2023-10-29,506,monitor,3249,8000,4751,1,00390,India
274364,2023-10-29,507,washing machine,6990,16490,9500,1,00196,India
274364,2023-10-29,505,oven,18490,24000,5510,1,00196,India
274364,2023-10-29,504,iron,449,879,430,1,00196,India
481228,2023-10-29,506,monitor,3249,8000,4751,1,00236,India
481228,2023-10-29,507,washing machine,6990,16490,9500,1,00236,India
481228,2023-10-29,505,oven,18490,24000,5510,1,00236,India
814373,2023-10-29,503,mixer,1349,3249,1900,1,00175,India
814373,2023-10-29,505,oven,18490,24000,5510,1,00175,India
814373,2023-10-29,504,iron,449,879,430,1,00175,India
878213,2023-10-29,503,mixer,1349,3249,1900,1,00418,India
878213,2023-10-29,502,iphone 15 pro max,100000,135000,35000,2,00418,India
507135,2023-10-29,506,monitor,3249,8000,4751,1,00147,India
755715,2023-10-29,505,oven,18490,24000,5510,1,00274,India
951782,2023-10-29,501,iphone 15,60000,80000,20000,2,00215,India
878877,2023-10-29,504,iron,449,879,430,1,00247,India
878877,2023-10-29,502,iphone 15 pro max,100000,135000,35000,2,00247,India
282281,2023-10-29,507,washing machine,6990,16490,9500,1,00383,India
282281,2023-10-29,504,iron,449,879,430,1,00383,India
568339,2023-10-29,505,oven,18490,24000,5510,1,00065,India
568339,2023-10-29,506,monitor,3249,8000,4751,1,00065,India
568339,2023-10-29,507,washing machine,6990,16490,9500,1,00065,India
897835,2023-10-29,503,mixer,1349,3249,1900,1,00374,India
897835,2023-10-29,506,monitor,3249,8000,4751,1,00374,India
897835,2023-10-29,501,iphone 15,60000,80000,20000,2,00374,India
586397,2023-10-29,504,iron,449,879,430,1,00394,India
586397,2023-10-29,502,iphone 15 pro max,100000,135000,35000,2,00394,India
906543,2023-10-29,505,oven,18490,24000,5510,1,00487,India
124672,2023-10-29,502,iphone 15 pro max,100000,135000,35000,2,00384,India
124672,2023-10-29,503,mixer,1349,3249,1900,1,00384,India
124672,2023-10-29,507,washing machine,6990,16490,9500,1,00384,India
424751,2023-10-29,505,oven,18490,24000,5510,1,00083,India
424751,2023-10-29,507,washing machine,6990,16490,9500,1,00083,India
705945,2023-10-29,503,mixer,1349,3249,1900,1,00445,India
705945,2023-10-29,501,iphone 15,60000,80000,20000,2,00445,India
286748,2023-10-29,502,iphone 15 pro max,100000,135000,35000,2,00317,India
286748,2023-10-29,504,iron,449,879,430,1,00317,India
286748,2023-10-29,505,oven,18490,24000,5510,1,00317,India
255380,2023-10-29,507,washing machine,6990,16490,9500,1,00233,India
880704,2023-10-29,504,iron,449,879,430,1,00025,India
880704,2023-10-29,506,monitor,3249,8000,4751,1,00025,India
880704,2023-10-29,507,washing machine,6990,16490,9500,1,00025,India
148646,2023-10-29,506,monitor,3249,8000,4751,1,00058,India
148646,2023-10-29,503,mixer,1349,3249,1900,1,00058,India
148646,2023-10-29,507,washing machine,6990,16490,9500,1,00058,India
701346,2023-10-29,502,iphone 15 pro max,100000,135000,35000,2,00325,India
701346,2023-10-29,507,washing machine,6990,16490,9500,1,00325,India
345624,2023-10-29,505,oven,18490,24000,5510,1,00117,India
345624,2023-10-29,504,iron,449,879,430,1,00117,India
345624,2023-10-29,501,iphone 15,60000,80000,20000,2,00117,India
625127,2023-10-29,501,iphone 15,60000,80000,20000,2,00415,India
625127,2023-10-29,502,iphone 15 pro max,100000,135000,35000,2,00415,India
877509,2023-10-29,505,oven,18490,24000,5510,1,00286,India
877509,2023-10-29,502,iphone 15 pro max,100000,135000,35000,2,00286,India
806917,2023-10-29,507,washing machine,6990,16490,9500,1,00373,India
806917,2023-10-29,505,oven,18490,24000,5510,1,00373,India
806917,2023-10-29,503,mixer,1349,3249,1900,1,00373,India
806917,2023-10-29,501,iphone 15,60000,80000,20000,2,00373,India
633753,2023-10-29,507,washing machine,6990,16490,9500,1,00037,India
633753,2023-10-29,503,mixer,1349,3249,1900,1,00037,India
198712,2023-10-29,505,oven,18490,24000,5510,1,00238,India
522672,2023-10-29,503,mixer,1349,3249,1900,1,00219,India
522672,2023-10-29,502,iphone 15 pro max,100000,135000,35000,2,00219,India
522672,2023-10-29,501,iphone 15,60000,80000,20000,2,00219,India
567615,2023-10-29,507,washing machine,6990,16490,9500,1,00104,India
166515,2023-10-29,505,oven,18490,24000,5510,1,00422,India
604157,2023-10-29,502,iphone 15 pro max,100000,135000,35000,2,00201,India
604157,2023-10-29,506,monitor,3249,8000,4751,1,00201,India
948207,2023-10-29,502,iphone 15 pro max,100000,135000,35000,2,00451,India
680200,2023-10-29,501,iphone 15,60000,80000,20000,2,00153,India
584722,2023-10-29,501,iphone 15,60000,80000,20000,2,00454,India
584722,2023-10-29,503,mixer,1349,3249,1900,1,00454,India
114286,2023-10-29,501,iphone 15,60000,80000,20000,2,00421,India
412420,2023-10-29,506,monitor,3249,8000,4751,1,00016,India
412420,2023-10-29,507,washing machine,6990,16490,9500,1,00016,India
412420,2023-10-29,502,iphone 15 pro max,100000,135000,35000,2,00016,India
412420,2023-10-29,505,oven,18490,24000,5510,1,00016,India
570438,2023-10-29,501,iphone 15,60000,80000,20000,2,00373,India
570438,2023-10-29,502,iphone 15 pro max,100000,135000,35000,2,00373,India
315202,2023-10-29,504,iron,449,879,430,1,00173,India
315202,2023-10-29,507,washing machine,6990,16490,9500,1,00173,India
315202,2023-10-29,502,iphone 15 pro max,100000,135000,35000,2,00173,India
898980,2023-10-29,506,monitor,3249,8000,4751,1,00208,India
898980,2023-10-29,504,iron,449,879,430,1,00208,India
898980,2023-10-29,505,oven,18490,24000,5510,1,00208,India
457379,2023-10-29,502,iphone 15 pro max,100000,135000,35000,2,00019,India
457379,2023-10-29,507,washing machine,6990,16490,9500,1,00019,India
457379,2023-10-29,506,monitor,3249,8000,4751,1,00019,India
481843,2023-10-29,501,iphone 15,60000,80000,20000,2,00439,India
481843,2023-10-29,505,oven,18490,24000,5510,1,00439,India
481843,2023-10-29,506,monitor,3249,8000,4751,1,00439,India
609008,2023-10-29,501,iphone 15,60000,80000,20000,2,00408,India
609008,2023-10-29,504,iron,449,879,430,1,00408,India
609008,2023-10-29,503,mixer,1349,3249,1900,1,00408,India
228054,2023-10-29,503,mixer,1349,3249,1900,1,00253,India
228054,2023-10-29,501,iphone 15,60000,80000,20000,2,00253,India
228054,2023-10-29,506,monitor,3249,8000,4751,1,00253,India
328548,2023-10-29,507,washing machine,6990,16490,9500,1,00076,India
328548,2023-10-29,501,iphone 15,60000,80000,20000,2,00076,India
328548,2023-10-29,504,iron,449,879,430,1,00076,India
934798,2023-10-29,502,iphone 15 pro max,100000,135000,35000,2,00404,India
541671,2023-10-29,504,iron,449,879,430,1,00411,India
541671,2023-10-29,506,monitor,3249,8000,4751,1,00411,India
541671,2023-10-29,505,oven,18490,24000,5510,1,00411,India
964268,2023-10-29,507,washing machine,6990,16490,9500,1,00183,India
964268,2023-10-29,501,iphone 15,60000,80000,20000,2,00183,India
358692,2023-10-29,502,iphone 15 pro max,100000,135000,35000,2,00269,India
358692,2023-10-29,505,oven,18490,24000,5510,1,00269,India
125557,2023-10-29,502,iphone 15 pro max,100000,135000,35000,2,00156,India
125557,2023-10-29,504,iron,449,879,430,1,00156,India
771162,2023-10-29,507,washing machine,6990,16490,9500,1,00123,India
159459,2023-10-29,501,iphone 15,60000,80000,20000,2,00028,India
159459,2023-10-29,506,monitor,3249,8000,4751,1,00028,India
159459,2023-10-29,505,oven,18490,24000,5510,1,00028,India
159459,2023-10-29,504,iron,449,879,430,1,00028,India
159459,2023-10-29,502,iphone 15 pro max,100000,135000,35000,2,00028,India
437486,2023-10-29,504,iron,449,879,430,1,00259,India
100587,2023-10-29,501,iphone 15,60000,80000,20000,2,00317,India
100587,2023-10-29,502,iphone 15 pro max,100000,135000,35000,2,00317,India
871616,2023-10-29,506,monitor,3249,8000,4751,1,00215,India
274233,2023-10-29,504,iron,449,879,430,1,00492,India
274233,2023-10-29,503,mixer,1349,3249,1900,1,00492,India
274233,2023-10-29,501,iphone 15,60000,80000,20000,2,00492,India
836129,2023-10-29,506,monitor,3249,8000,4751,1,00438,India
970036,2023-10-29,501,iphone 15,60000,80000,20000,2,00022,India
970036,2023-10-29,505,oven,18490,24000,5510,1,00022,India
528641,2023-10-29,504,iron,449,879,430,1,00212,India
528641,2023-10-29,505,oven,18490,24000,5510,1,00212,India
528641,2023-10-29,502,iphone 15 pro max,100000,135000,35000,2,00212,India
334135,2023-10-29,503,mixer,1349,3249,1900,1,00063,India
334135,2023-10-29,502,iphone 15 pro max,100000,135000,35000,2,00063,India
334135,2023-10-29,506,monitor,3249,8000,4751,1,00063,India
334135,2023-10-29,501,iphone 15,60000,80000,20000,2,00063,India
334135,2023-10-29,504,iron,449,879,430,1,00063,India
396874,2023-10-29,507,washing machine,6990,16490,9500,1,00038,India
396874,2023-10-29,503,mixer,1349,3249,1900,1,00038,India
396874,2023-10-29,502,iphone 15 pro max,100000,135000,35000,2,00038,India
937191,2023-10-29,503,mixer,1349,3249,1900,1,00200,India
480858,2023-10-29,502,iphone 15 pro max,100000,135000,35000,2,00110,India
480858,2023-10-29,506,monitor,3249,8000,4751,1,00110,India
480858,2023-10-29,503,mixer,1349,3249,1900,1,00110,India
480858,2023-10-29,504,iron,449,879,430,1,00110,India
885257,2023-10-29,506,monitor,3249,8000,4751,1,00230,India
885257,2023-10-29,504,iron,449,879,430,1,00230,India
885257,2023-10-29,501,iphone 15,60000,80000,20000,2,00230,India
900077,2023-10-29,505,oven,18490,24000,5510,1,00132,India
277429,2023-10-29,503,mixer,1349,3249,1900,1,00376,India
718380,2023-10-29,502,iphone 15 pro max,100000,135000,35000,2,00111,India
718380,2023-10-29,504,iron,449,879,430,1,00111,India
487131,2023-10-29,501,iphone 15,60000,80000,20000,2,00234,India
487131,2023-10-29,502,iphone 15 pro max,100000,135000,35000,2,00234,India
963868,2023-10-29,505,oven,18490,24000,5510,1,00364,India
963868,2023-10-29,507,washing machine,6990,16490,9500,1,00364,India
915844,2023-10-29,501,iphone 15,60000,80000,20000,2,00362,India
915844,2023-10-29,503,mixer,1349,3249,1900,1,00362,India
287675,2023-10-29,502,iphone 15 pro max,100000,135000,35000,2,00138,India
287675,2023-10-29,506,monitor,3249,8000,4751,1,00138,India
287675,2023-10-29,505,oven,18490,24000,5510,1,00138,India
287675,2023-10-29,503,mixer,1349,3249,1900,1,00138,India
763251,2023-10-29,505,oven,18490,24000,5510,1,00319,India
763251,2023-10-29,504,iron,449,879,430,1,00319,India
763251,2023-10-29,507,washing machine,6990,16490,9500,1,00319,India
763251,2023-10-29,503,mixer,1349,3249,1900,1,00319,India
569225,2023-10-30,501,iphone 15,60000,80000,20000,2,00464,India
554783,2023-10-30,501,iphone 15,60000,80000,20000,2,00105,India
763616,2023-10-30,507,washing machine,6990,16490,9500,1,00216,India
763616,2023-10-30,505,oven,18490,24000,5510,1,00216,India
351352,2023-10-30,504,iron,449,879,430,1,00047,India
351352,2023-10-30,503,mixer,1349,3249,1900,1,00047,India
122001,2023-10-30,505,oven,18490,24000,5510,1,00128,India
122001,2023-10-30,503,mixer,1349,3249,1900,1,00128,India
122001,2023-10-30,506,monitor,3249,8000,4751,1,00128,India
122001,2023-10-30,504,iron,449,879,430,1,00128,India
393709,2023-10-30,502,iphone 15 pro max,100000,135000,35000,2,00475,India
393709,2023-10-30,507,washing machine,6990,16490,9500,1,00475,India
393709,2023-10-30,504,iron,449,879,430,1,00475,India
674775,2023-10-30,502,iphone 15 pro max,100000,135000,35000,2,00338,India
674775,2023-10-30,505,oven,18490,24000,5510,1,00338,India
384453,2023-10-30,505,oven,18490,24000,5510,1,00323,India
384453,2023-10-30,503,mixer,1349,3249,1900,1,00323,India
384453,2023-10-30,506,monitor,3249,8000,4751,1,00323,India
512929,2023-10-30,506,monitor,3249,8000,4751,1,00155,India
512929,2023-10-30,504,iron,449,879,430,1,00155,India
769747,2023-10-30,507,washing machine,6990,16490,9500,1,00178,India
815330,2023-10-30,504,iron,449,879,430,1,00315,India
826803,2023-10-30,506,monitor,3249,8000,4751,1,00429,India
826803,2023-10-30,504,iron,449,879,430,1,00429,India
179224,2023-10-30,504,iron,449,879,430,1,00365,India
306401,2023-10-30,505,oven,18490,24000,5510,1,00427,India
306401,2023-10-30,503,mixer,1349,3249,1900,1,00427,India
654700,2023-10-30,505,oven,18490,24000,5510,1,00156,India
254870,2023-10-30,506,monitor,3249,8000,4751,1,00156,India
254870,2023-10-30,505,oven,18490,24000,5510,1,00156,India
254870,2023-10-30,503,mixer,1349,3249,1900,1,00156,India
582780,2023-10-30,505,oven,18490,24000,5510,1,00500,India
536102,2023-10-30,502,iphone 15 pro max,100000,135000,35000,2,00037,India
536102,2023-10-30,504,iron,449,879,430,1,00037,India
536102,2023-10-30,505,oven,18490,24000,5510,1,00037,India
536102,2023-10-30,506,monitor,3249,8000,4751,1,00037,India
823067,2023-10-30,507,washing machine,6990,16490,9500,1,00059,India
823067,2023-10-30,501,iphone 15,60000,80000,20000,2,00059,India
823067,2023-10-30,506,monitor,3249,8000,4751,1,00059,India
823067,2023-10-30,504,iron,449,879,430,1,00059,India
823067,2023-10-30,503,mixer,1349,3249,1900,1,00059,India
990348,2023-10-30,504,iron,449,879,430,1,00442,India
990348,2023-10-30,506,monitor,3249,8000,4751,1,00442,India
990348,2023-10-30,505,oven,18490,24000,5510,1,00442,India
632709,2023-10-30,503,mixer,1349,3249,1900,1,00356,India
632709,2023-10-30,501,iphone 15,60000,80000,20000,2,00356,India
788709,2023-10-30,506,monitor,3249,8000,4751,1,00343,India
316051,2023-10-30,502,iphone 15 pro max,100000,135000,35000,2,00498,India
316051,2023-10-30,507,washing machine,6990,16490,9500,1,00498,India
316051,2023-10-30,506,monitor,3249,8000,4751,1,00498,India
740165,2023-10-30,504,iron,449,879,430,1,00424,India
740165,2023-10-30,507,washing machine,6990,16490,9500,1,00424,India
562066,2023-10-30,503,mixer,1349,3249,1900,1,00317,India
562066,2023-10-30,505,oven,18490,24000,5510,1,00317,India
677791,2023-10-30,506,monitor,3249,8000,4751,1,00187,India
677791,2023-10-30,502,iphone 15 pro max,100000,135000,35000,2,00187,India
220396,2023-10-30,503,mixer,1349,3249,1900,1,00147,India
452179,2023-10-30,507,washing machine,6990,16490,9500,1,00316,India
452179,2023-10-30,501,iphone 15,60000,80000,20000,2,00316,India
452179,2023-10-30,503,mixer,1349,3249,1900,1,00316,India
452179,2023-10-30,502,iphone 15 pro max,100000,135000,35000,2,00316,India
549503,2023-10-30,504,iron,449,879,430,1,00184,India
549503,2023-10-30,507,washing machine,6990,16490,9500,1,00184,India
753570,2023-10-30,505,oven,18490,24000,5510,1,00129,India
753570,2023-10-30,506,monitor,3249,8000,4751,1,00129,India
164866,2023-10-30,507,washing machine,6990,16490,9500,1,00058,India
836344,2023-10-30,507,washing machine,6990,16490,9500,1,00426,India
347795,2023-10-30,507,washing machine,6990,16490,9500,1,00261,India
347795,2023-10-30,506,monitor,3249,8000,4751,1,00261,India
528460,2023-10-30,504,iron,449,879,430,1,00323,India
528460,2023-10-30,506,monitor,3249,8000,4751,1,00323,India
652621,2023-10-30,507,washing machine,6990,16490,9500,1,00222,India
517168,2023-10-30,505,oven,18490,24000,5510,1,00066,India
803635,2023-10-30,502,iphone 15 pro max,100000,135000,35000,2,00114,India
803635,2023-10-30,505,oven,18490,24000,5510,1,00114,India
803635,2023-10-30,504,iron,449,879,430,1,00114,India
803635,2023-10-30,501,iphone 15,60000,80000,20000,2,00114,India
803635,2023-10-30,503,mixer,1349,3249,1900,1,00114,India
824413,2023-10-30,503,mixer,1349,3249,1900,1,00007,India
824413,2023-10-30,506,monitor,3249,8000,4751,1,00007,India
824413,2023-10-30,507,washing machine,6990,16490,9500,1,00007,India
107129,2023-10-30,503,mixer,1349,3249,1900,1,00116,India
980133,2023-10-30,506,monitor,3249,8000,4751,1,00103,India
980133,2023-10-30,505,oven,18490,24000,5510,1,00103,India
980133,2023-10-30,503,mixer,1349,3249,1900,1,00103,India
980133,2023-10-30,501,iphone 15,60000,80000,20000,2,00103,India
577373,2023-10-30,505,oven,18490,24000,5510,1,00305,India
251088,2023-10-30,504,iron,449,879,430,1,00339,India
813919,2023-10-30,505,oven,18490,24000,5510,1,00081,India
813919,2023-10-30,501,iphone 15,60000,80000,20000,2,00081,India
813919,2023-10-30,507,washing machine,6990,16490,9500,1,00081,India
813919,2023-10-30,504,iron,449,879,430,1,00081,India
448254,2023-10-30,501,iphone 15,60000,80000,20000,2,00149,India
448254,2023-10-30,503,mixer,1349,3249,1900,1,00149,India
448254,2023-10-30,506,monitor,3249,8000,4751,1,00149,India
448254,2023-10-30,504,iron,449,879,430,1,00149,India
920125,2023-10-30,505,oven,18490,24000,5510,1,00186,India
920125,2023-10-30,506,monitor,3249,8000,4751,1,00186,India
920125,2023-10-30,507,washing machine,6990,16490,9500,1,00186,India
778350,2023-10-30,507,washing machine,6990,16490,9500,1,00329,India
778350,2023-10-30,504,iron,449,879,430,1,00329,India
778350,2023-10-30,503,mixer,1349,3249,1900,1,00329,India
449174,2023-10-30,503,mixer,1349,3249,1900,1,00203,India
449174,2023-10-30,502,iphone 15 pro max,100000,135000,35000,2,00203,India
449174,2023-10-30,506,monitor,3249,8000,4751,1,00203,India
121026,2023-10-30,506,monitor,3249,8000,4751,1,00167,India
792061,2023-10-30,504,iron,449,879,430,1,00207,India
826521,2023-10-30,502,iphone 15 pro max,100000,135000,35000,2,00259,India
826521,2023-10-30,501,iphone 15,60000,80000,20000,2,00259,India
673899,2023-10-30,504,iron,449,879,430,1,00006,India
673899,2023-10-30,503,mixer,1349,3249,1900,1,00006,India
673899,2023-10-30,507,washing machine,6990,16490,9500,1,00006,India
356328,2023-10-30,507,washing machine,6990,16490,9500,1,00361,India
356328,2023-10-30,503,mixer,1349,3249,1900,1,00361,India
356328,2023-10-30,502,iphone 15 pro max,100000,135000,35000,2,00361,India
703436,2023-10-30,502,iphone 15 pro max,100000,135000,35000,2,00454,India
703436,2023-10-30,501,iphone 15,60000,80000,20000,2,00454,India
703436,2023-10-30,507,washing machine,6990,16490,9500,1,00454,India
280742,2023-10-30,502,iphone 15 pro max,100000,135000,35000,2,00073,India
280742,2023-10-30,501,iphone 15,60000,80000,20000,2,00073,India
764481,2023-10-30,506,monitor,3249,8000,4751,1,00182,India
126420,2023-10-30,507,washing machine,6990,16490,9500,1,00089,India
376911,2023-10-30,507,washing machine,6990,16490,9500,1,00147,India
376911,2023-10-30,503,mixer,1349,3249,1900,1,00147,India
960772,2023-10-30,507,washing machine,6990,16490,9500,1,00249,India
960772,2023-10-30,506,monitor,3249,8000,4751,1,00249,India
255717,2023-10-30,504,iron,449,879,430,1,00075,India
255717,2023-10-30,501,iphone 15,60000,80000,20000,2,00075,India
255717,2023-10-30,506,monitor,3249,8000,4751,1,00075,India
667075,2023-10-30,502,iphone 15 pro max,100000,135000,35000,2,00185,India
667075,2023-10-30,506,monitor,3249,8000,4751,1,00185,India
691353,2023-10-30,506,monitor,3249,8000,4751,1,00255,India
691353,2023-10-30,503,mixer,1349,3249,1900,1,00255,India
951343,2023-10-30,506,monitor,3249,8000,4751,1,00223,India
951343,2023-10-30,505,oven,18490,24000,5510,1,00223,India
951343,2023-10-30,507,washing machine,6990,16490,9500,1,00223,India
114477,2023-10-30,505,oven,18490,24000,5510,1,00193,India
114477,2023-10-30,507,washing machine,6990,16490,9500,1,00193,India
114477,2023-10-30,503,mixer,1349,3249,1900,1,00193,India
114477,2023-10-30,504,iron,449,879,430,1,00193,India
804025,2023-10-30,501,iphone 15,60000,80000,20000,2,00124,India
804025,2023-10-30,506,monitor,3249,8000,4751,1,00124,India
804025,2023-10-30,505,oven,18490,24000,5510,1,00124,India
169737,2023-10-30,501,iphone 15,60000,80000,20000,2,00301,India
169737,2023-10-30,504,iron,449,879,430,1,00301,India
169737,2023-10-30,503,mixer,1349,3249,1900,1,00301,India
169737,2023-10-30,502,iphone 15 pro max,100000,135000,35000,2,00301,India
462948,2023-10-30,501,iphone 15,60000,80000,20000,2,00061,India
462948,2023-10-30,505,oven,18490,24000,5510,1,00061,India
462948,2023-10-30,504,iron,449,879,430,1,00061,India
488061,2023-10-30,502,iphone 15 pro max,100000,135000,35000,2,00299,India
488061,2023-10-30,501,iphone 15,60000,80000,20000,2,00299,India
488061,2023-10-30,504,iron,449,879,430,1,00299,India
488061,2023-10-30,505,oven,18490,24000,5510,1,00299,India
409882,2023-10-30,504,iron,449,879,430,1,00061,India
959747,2023-10-30,503,mixer,1349,3249,1900,1,00258,India
959747,2023-10-30,502,iphone 15 pro max,100000,135000,35000,2,00258,India
959747,2023-10-30,505,oven,18490,24000,5510,1,00258,India
214410,2023-10-30,503,mixer,1349,3249,1900,1,00317,India
214410,2023-10-30,507,washing machine,6990,16490,9500,1,00317,India
214410,2023-10-30,505,oven,18490,24000,5510,1,00317,India
360683,2023-10-30,502,iphone 15 pro max,100000,135000,35000,2,00117,India
360683,2023-10-30,503,mixer,1349,3249,1900,1,00117,India
166111,2023-10-30,502,iphone 15 pro max,100000,135000,35000,2,00350,India
413721,2023-10-30,507,washing machine,6990,16490,9500,1,00371,India
413721,2023-10-30,505,oven,18490,24000,5510,1,00371,India
413721,2023-10-30,506,monitor,3249,8000,4751,1,00371,India
149693,2023-10-30,505,oven,18490,24000,5510,1,00376,India
114048,2023-10-30,507,washing machine,6990,16490,9500,1,00112,India
114048,2023-10-30,506,monitor,3249,8000,4751,1,00112,India
114048,2023-10-30,502,iphone 15 pro max,100000,135000,35000,2,00112,India
114048,2023-10-30,503,mixer,1349,3249,1900,1,00112,India
546873,2023-10-30,505,oven,18490,24000,5510,1,00163,India
546873,2023-10-30,503,mixer,1349,3249,1900,1,00163,India
546873,2023-10-30,507,washing machine,6990,16490,9500,1,00163,India
222862,2023-10-30,507,washing machine,6990,16490,9500,1,00211,India
222862,2023-10-30,506,monitor,3249,8000,4751,1,00211,India
345150,2023-10-31,503,mixer,1349,3249,1900,1,00180,India
345150,2023-10-31,501,iphone 15,60000,80000,20000,2,00180,India
417858,2023-10-31,501,iphone 15,60000,80000,20000,2,00171,India
417858,2023-10-31,502,iphone 15 pro max,100000,135000,35000,2,00171,India
984616,2023-10-31,506,monitor,3249,8000,4751,1,00401,India
984616,2023-10-31,504,iron,449,879,430,1,00401,India
984616,2023-10-31,505,oven,18490,24000,5510,1,00401,India
984616,2023-10-31,503,mixer,1349,3249,1900,1,00401,India
419469,2023-10-31,502,iphone 15 pro max,100000,135000,35000,2,00448,India
419469,2023-10-31,506,monitor,3249,8000,4751,1,00448,India
419469,2023-10-31,504,iron,449,879,430,1,00448,India
931342,2023-10-31,504,iron,449,879,430,1,00249,India
931342,2023-10-31,506,monitor,3249,8000,4751,1,00249,India
931342,2023-10-31,505,oven,18490,24000,5510,1,00249,India
390239,2023-10-31,504,iron,449,879,430,1,00492,India
390239,2023-10-31,503,mixer,1349,3249,1900,1,00492,India
390239,2023-10-31,502,iphone 15 pro max,100000,135000,35000,2,00492,India
390239,2023-10-31,506,monitor,3249,8000,4751,1,00492,India
390239,2023-10-31,501,iphone 15,60000,80000,20000,2,00492,India
684594,2023-10-31,501,iphone 15,60000,80000,20000,2,00483,India
684594,2023-10-31,505,oven,18490,24000,5510,1,00483,India
684594,2023-10-31,502,iphone 15 pro max,100000,135000,35000,2,00483,India
671340,2023-10-31,505,oven,18490,24000,5510,1,00241,India
671340,2023-10-31,507,washing machine,6990,16490,9500,1,00241,India
123626,2023-10-31,504,iron,449,879,430,1,00315,India
123626,2023-10-31,506,monitor,3249,8000,4751,1,00315,India
477265,2023-10-31,502,iphone 15 pro max,100000,135000,35000,2,00071,India
477265,2023-10-31,501,iphone 15,60000,80000,20000,2,00071,India
392046,2023-10-31,502,iphone 15 pro max,100000,135000,35000,2,00163,India
392046,2023-10-31,507,washing machine,6990,16490,9500,1,00163,India
137933,2023-10-31,507,washing machine,6990,16490,9500,1,00200,India
137933,2023-10-31,502,iphone 15 pro max,100000,135000,35000,2,00200,India
137933,2023-10-31,505,oven,18490,24000,5510,1,00200,India
137933,2023-10-31,501,iphone 15,60000,80000,20000,2,00200,India
423648,2023-10-31,502,iphone 15 pro max,100000,135000,35000,2,00127,India
423648,2023-10-31,505,oven,18490,24000,5510,1,00127,India
423648,2023-10-31,504,iron,449,879,430,1,00127,India
328205,2023-10-31,504,iron,449,879,430,1,00102,India
328205,2023-10-31,506,monitor,3249,8000,4751,1,00102,India
776310,2023-10-31,506,monitor,3249,8000,4751,1,00029,India
111098,2023-10-31,506,monitor,3249,8000,4751,1,00333,India
111098,2023-10-31,504,iron,449,879,430,1,00333,India
111098,2023-10-31,501,iphone 15,60000,80000,20000,2,00333,India
120063,2023-10-31,506,monitor,3249,8000,4751,1,00173,India
120063,2023-10-31,502,iphone 15 pro max,100000,135000,35000,2,00173,India
407482,2023-10-31,505,oven,18490,24000,5510,1,00390,India
559951,2023-10-31,502,iphone 15 pro max,100000,135000,35000,2,00479,India
559951,2023-10-31,507,washing machine,6990,16490,9500,1,00479,India
559951,2023-10-31,505,oven,18490,24000,5510,1,00479,India
559951,2023-10-31,501,iphone 15,60000,80000,20000,2,00479,India
559951,2023-10-31,503,mixer,1349,3249,1900,1,00479,India
707149,2023-10-31,505,oven,18490,24000,5510,1,00343,India
707149,2023-10-31,507,washing machine,6990,16490,9500,1,00343,India
707149,2023-10-31,506,monitor,3249,8000,4751,1,00343,India
707149,2023-10-31,502,iphone 15 pro max,100000,135000,35000,2,00343,India
707149,2023-10-31,504,iron,449,879,430,1,00343,India
576042,2023-10-31,502,iphone 15 pro max,100000,135000,35000,2,00418,India
576042,2023-10-31,503,mixer,1349,3249,1900,1,00418,India
391328,2023-10-31,506,monitor,3249,8000,4751,1,00215,India
332256,2023-10-31,507,washing machine,6990,16490,9500,1,00094,India
332256,2023-10-31,502,iphone 15 pro max,100000,135000,35000,2,00094,India
450370,2023-10-31,502,iphone 15 pro max,100000,135000,35000,2,00481,India
450370,2023-10-31,505,oven,18490,24000,5510,1,00481,India
450370,2023-10-31,504,iron,449,879,430,1,00481,India
553544,2023-10-31,504,iron,449,879,430,1,00340,India
333602,2023-10-31,506,monitor,3249,8000,4751,1,00064,India
333602,2023-10-31,503,mixer,1349,3249,1900,1,00064,India
375768,2023-10-31,501,iphone 15,60000,80000,20000,2,00284,India
375768,2023-10-31,507,washing machine,6990,16490,9500,1,00284,India
257251,2023-10-31,501,iphone 15,60000,80000,20000,2,00068,India
903403,2023-10-31,502,iphone 15 pro max,100000,135000,35000,2,00170,India
903403,2023-10-31,503,mixer,1349,3249,1900,1,00170,India
903403,2023-10-31,504,iron,449,879,430,1,00170,India
518381,2023-10-31,502,iphone 15 pro max,100000,135000,35000,2,00340,India
518381,2023-10-31,504,iron,449,879,430,1,00340,India
204293,2023-10-31,506,monitor,3249,8000,4751,1,00040,India
204293,2023-10-31,504,iron,449,879,430,1,00040,India
204293,2023-10-31,503,mixer,1349,3249,1900,1,00040,India
604207,2023-10-31,507,washing machine,6990,16490,9500,1,00461,India
604207,2023-10-31,504,iron,449,879,430,1,00461,India
239258,2023-10-31,501,iphone 15,60000,80000,20000,2,00256,India
239258,2023-10-31,505,oven,18490,24000,5510,1,00256,India
355926,2023-10-31,506,monitor,3249,8000,4751,1,00088,India
355926,2023-10-31,505,oven,18490,24000,5510,1,00088,India
865401,2023-10-31,503,mixer,1349,3249,1900,1,00455,India
865401,2023-10-31,506,monitor,3249,8000,4751,1,00455,India
865401,2023-10-31,505,oven,18490,24000,5510,1,00455,India
360858,2023-10-31,506,monitor,3249,8000,4751,1,00294,India
360858,2023-10-31,502,iphone 15 pro max,100000,135000,35000,2,00294,India
968806,2023-10-31,503,mixer,1349,3249,1900,1,00071,India
968806,2023-10-31,504,iron,449,879,430,1,00071,India
968806,2023-10-31,506,monitor,3249,8000,4751,1,00071,India
567961,2023-10-31,504,iron,449,879,430,1,00313,India
567961,2023-10-31,501,iphone 15,60000,80000,20000,2,00313,India
685143,2023-10-31,504,iron,449,879,430,1,00196,India
685143,2023-10-31,506,monitor,3249,8000,4751,1,00196,India
685143,2023-10-31,507,washing machine,6990,16490,9500,1,00196,India
719282,2023-10-31,504,iron,449,879,430,1,00407,India
719282,2023-10-31,506,monitor,3249,8000,4751,1,00407,India
775921,2023-10-31,504,iron,449,879,430,1,00422,India
775921,2023-10-31,501,iphone 15,60000,80000,20000,2,00422,India
775921,2023-10-31,503,mixer,1349,3249,1900,1,00422,India
713808,2023-10-31,503,mixer,1349,3249,1900,1,00179,India
713808,2023-10-31,507,washing machine,6990,16490,9500,1,00179,India
713808,2023-10-31,504,iron,449,879,430,1,00179,India
630891,2023-10-31,503,mixer,1349,3249,1900,1,00364,India
630891,2023-10-31,502,iphone 15 pro max,100000,135000,35000,2,00364,India
630891,2023-10-31,501,iphone 15,60000,80000,20000,2,00364,India
630891,2023-10-31,507,washing machine,6990,16490,9500,1,00364,India
630891,2023-10-31,505,oven,18490,24000,5510,1,00364,India
204527,2023-10-31,504,iron,449,879,430,1,00219,India
204527,2023-10-31,507,washing machine,6990,16490,9500,1,00219,India
538512,2023-10-31,506,monitor,3249,8000,4751,1,00478,India
538512,2023-10-31,505,oven,18490,24000,5510,1,00478,India
538512,2023-10-31,501,iphone 15,60000,80000,20000,2,00478,India
538512,2023-10-31,503,mixer,1349,3249,1900,1,00478,India
981272,2023-10-31,507,washing machine,6990,16490,9500,1,00489,India
125036,2023-10-31,504,iron,449,879,430,1,00241,India
125036,2023-10-31,502,iphone 15 pro max,100000,135000,35000,2,00241,India
125036,2023-10-31,503,mixer,1349,3249,1900,1,00241,India
446205,2023-10-31,503,mixer,1349,3249,1900,1,00094,India
233101,2023-10-31,501,iphone 15,60000,80000,20000,2,00281,India
233101,2023-10-31,503,mixer,1349,3249,1900,1,00281,India
233101,2023-10-31,504,iron,449,879,430,1,00281,India
233101,2023-10-31,505,oven,18490,24000,5510,1,00281,India
782659,2023-10-31,507,washing machine,6990,16490,9500,1,00413,India
782659,2023-10-31,505,oven,18490,24000,5510,1,00413,India
782659,2023-10-31,504,iron,449,879,430,1,00413,India
579650,2023-10-31,506,monitor,3249,8000,4751,1,00416,India
579650,2023-10-31,501,iphone 15,60000,80000,20000,2,00416,India
579650,2023-10-31,504,iron,449,879,430,1,00416,India
579650,2023-10-31,502,iphone 15 pro max,100000,135000,35000,2,00416,India
335914,2023-10-31,502,iphone 15 pro max,100000,135000,35000,2,00014,India
335914,2023-10-31,506,monitor,3249,8000,4751,1,00014,India
611052,2023-10-31,503,mixer,1349,3249,1900,1,00453,India
611052,2023-10-31,501,iphone 15,60000,80000,20000,2,00453,India
493137,2023-10-31,504,iron,449,879,430,1,00268,India
497104,2023-10-31,502,iphone 15 pro max,100000,135000,35000,2,00189,India
497104,2023-10-31,507,washing machine,6990,16490,9500,1,00189,India
497104,2023-10-31,506,monitor,3249,8000,4751,1,00189,India
230408,2023-10-31,501,iphone 15,60000,80000,20000,2,00485,India
230408,2023-10-31,507,washing machine,6990,16490,9500,1,00485,India
955804,2023-10-31,504,iron,449,879,430,1,00002,India
562849,2023-10-31,505,oven,18490,24000,5510,1,00429,India
562849,2023-10-31,506,monitor,3249,8000,4751,1,00429,India
474276,2023-10-31,501,iphone 15,60000,80000,20000,2,00220,India
474276,2023-10-31,507,washing machine,6990,16490,9500,1,00220,India
631783,2023-10-31,504,iron,449,879,430,1,00064,India
631783,2023-10-31,503,mixer,1349,3249,1900,1,00064,India
631783,2023-10-31,501,iphone 15,60000,80000,20000,2,00064,India
631783,2023-10-31,505,oven,18490,24000,5510,1,00064,India
531053,2023-10-31,501,iphone 15,60000,80000,20000,2,00391,India
531053,2023-10-31,506,monitor,3249,8000,4751,1,00391,India
531053,2023-10-31,502,iphone 15 pro max,100000,135000,35000,2,00391,India
956639,2023-10-31,504,iron,449,879,430,1,00384,India
956639,2023-10-31,501,iphone 15,60000,80000,20000,2,00384,India
553562,2023-10-31,507,washing machine,6990,16490,9500,1,00307,India
553562,2023-10-31,503,mixer,1349,3249,1900,1,00307,India
553562,2023-10-31,504,iron,449,879,430,1,00307,India
553562,2023-10-31,501,iphone 15,60000,80000,20000,2,00307,India
835857,2023-10-31,505,oven,18490,24000,5510,1,00326,India
764479,2023-10-31,503,mixer,1349,3249,1900,1,00255,India
764479,2023-10-31,507,washing machine,6990,16490,9500,1,00255,India
764479,2023-10-31,504,iron,449,879,430,1,00255,India
629979,2023-10-31,505,oven,18490,24000,5510,1,00448,India
629979,2023-10-31,504,iron,449,879,430,1,00448,India
872109,2023-10-31,502,iphone 15 pro max,100000,135000,35000,2,00200,India
872109,2023-10-31,507,washing machine,6990,16490,9500,1,00200,India
872109,2023-10-31,501,iphone 15,60000,80000,20000,2,00200,India
348964,2023-10-31,505,oven,18490,24000,5510,1,00252,India
348964,2023-10-31,502,iphone 15 pro max,100000,135000,35000,2,00252,India
465839,2023-10-31,507,washing machine,6990,16490,9500,1,00435,India
603960,2023-11-01,504,iron,449,879,430,2,00026,India
603960,2023-11-01,505,oven,18490,24000,5510,2,00026,India
603960,2023-11-01,502,iphone 15 pro max,100000,135000,35000,2,00026,India
769420,2023-11-01,503,mixer,1349,3249,1900,2,00306,India
769420,2023-11-01,505,oven,18490,24000,5510,2,00306,India
769420,2023-11-01,507,washing machine,6990,16490,9500,2,00306,India
192650,2023-11-01,505,oven,18490,24000,5510,2,00058,India
934635,2023-11-01,501,iphone 15,60000,80000,20000,2,00328,India
934635,2023-11-01,506,monitor,3249,8000,4751,2,00328,India
332343,2023-11-01,504,iron,449,879,430,2,00427,India
939635,2023-11-01,506,monitor,3249,8000,4751,2,00158,India
939635,2023-11-01,502,iphone 15 pro max,100000,135000,35000,2,00158,India
728504,2023-11-01,503,mixer,1349,3249,1900,2,00069,India
769962,2023-11-01,501,iphone 15,60000,80000,20000,2,00380,India
769962,2023-11-01,503,mixer,1349,3249,1900,2,00380,India
868895,2023-11-01,502,iphone 15 pro max,100000,135000,35000,2,00417,India
868895,2023-11-01,506,monitor,3249,8000,4751,2,00417,India
515955,2023-11-01,502,iphone 15 pro max,100000,135000,35000,2,00344,India
515955,2023-11-01,505,oven,18490,24000,5510,2,00344,India
515955,2023-11-01,504,iron,449,879,430,2,00344,India
515955,2023-11-01,503,mixer,1349,3249,1900,2,00344,India
328766,2023-11-01,504,iron,449,879,430,2,00405,India
328766,2023-11-01,501,iphone 15,60000,80000,20000,2,00405,India
873403,2023-11-01,503,mixer,1349,3249,1900,2,00251,India
873403,2023-11-01,506,monitor,3249,8000,4751,2,00251,India
873403,2023-11-01,504,iron,449,879,430,2,00251,India
869008,2023-11-01,507,washing machine,6990,16490,9500,2,00219,India
327565,2023-11-01,502,iphone 15 pro max,100000,135000,35000,2,00442,India
327565,2023-11-01,503,mixer,1349,3249,1900,2,00442,India
327565,2023-11-01,504,iron,449,879,430,2,00442,India
772459,2023-11-01,507,washing machine,6990,16490,9500,2,00455,India
560791,2023-11-01,505,oven,18490,24000,5510,2,00067,India
560791,2023-11-01,504,iron,449,879,430,2,00067,India
369314,2023-11-01,503,mixer,1349,3249,1900,2,00369,India
369314,2023-11-01,506,monitor,3249,8000,4751,2,00369,India
787532,2023-11-01,503,mixer,1349,3249,1900,2,00305,India
606163,2023-11-01,507,washing machine,6990,16490,9500,2,00032,India
606163,2023-11-01,505,oven,18490,24000,5510,2,00032,India
539915,2023-11-01,501,iphone 15,60000,80000,20000,2,00388,India
700204,2023-11-01,504,iron,449,879,430,2,00328,India
873453,2023-11-01,502,iphone 15 pro max,100000,135000,35000,2,00223,India
873453,2023-11-01,507,washing machine,6990,16490,9500,2,00223,India
873453,2023-11-01,506,monitor,3249,8000,4751,2,00223,India
452553,2023-11-01,507,washing machine,6990,16490,9500,2,00271,India
452553,2023-11-01,502,iphone 15 pro max,100000,135000,35000,2,00271,India
364109,2023-11-01,504,iron,449,879,430,2,00272,India
364109,2023-11-01,503,mixer,1349,3249,1900,2,00272,India
364109,2023-11-01,505,oven,18490,24000,5510,2,00272,India
720352,2023-11-01,501,iphone 15,60000,80000,20000,2,00313,India
720352,2023-11-01,503,mixer,1349,3249,1900,2,00313,India
395717,2023-11-01,507,washing machine,6990,16490,9500,2,00003,India
395717,2023-11-01,506,monitor,3249,8000,4751,2,00003,India
395717,2023-11-01,504,iron,449,879,430,2,00003,India
395717,2023-11-01,503,mixer,1349,3249,1900,2,00003,India
577221,2023-11-01,502,iphone 15 pro max,100000,135000,35000,2,00377,India
577221,2023-11-01,503,mixer,1349,3249,1900,2,00377,India
577221,2023-11-01,506,monitor,3249,8000,4751,2,00377,India
577221,2023-11-01,507,washing machine,6990,16490,9500,2,00377,India
168229,2023-11-01,504,iron,449,879,430,2,00432,India
168229,2023-11-01,503,mixer,1349,3249,1900,2,00432,India
726072,2023-11-01,506,monitor,3249,8000,4751,2,00388,India
176156,2023-11-01,501,iphone 15,60000,80000,20000,2,00404,India
176156,2023-11-01,505,oven,18490,24000,5510,2,00404,India
176156,2023-11-01,507,washing machine,6990,16490,9500,2,00404,India
660021,2023-11-01,502,iphone 15 pro max,100000,135000,35000,2,00354,India
660021,2023-11-01,504,iron,449,879,430,2,00354,India
660021,2023-11-01,503,mixer,1349,3249,1900,2,00354,India
207949,2023-11-01,503,mixer,1349,3249,1900,2,00374,India
207949,2023-11-01,501,iphone 15,60000,80000,20000,2,00374,India
981164,2023-11-01,505,oven,18490,24000,5510,2,00463,India
981164,2023-11-01,502,iphone 15 pro max,100000,135000,35000,2,00463,India
118158,2023-11-01,503,mixer,1349,3249,1900,2,00060,India
118158,2023-11-01,507,washing machine,6990,16490,9500,2,00060,India
118158,2023-11-01,502,iphone 15 pro max,100000,135000,35000,2,00060,India
118158,2023-11-01,506,monitor,3249,8000,4751,2,00060,India
349909,2023-11-01,501,iphone 15,60000,80000,20000,2,00243,India
349909,2023-11-01,506,monitor,3249,8000,4751,2,00243,India
349909,2023-11-01,502,iphone 15 pro max,100000,135000,35000,2,00243,India
349909,2023-11-01,505,oven,18490,24000,5510,2,00243,India
751348,2023-11-01,502,iphone 15 pro max,100000,135000,35000,2,00019,India
751348,2023-11-01,501,iphone 15,60000,80000,20000,2,00019,India
751348,2023-11-01,504,iron,449,879,430,2,00019,India
433607,2023-11-01,506,monitor,3249,8000,4751,2,00168,India
433607,2023-11-01,502,iphone 15 pro max,100000,135000,35000,2,00168,India
433607,2023-11-01,501,iphone 15,60000,80000,20000,2,00168,India
962933,2023-11-01,501,iphone 15,60000,80000,20000,2,00078,India
496952,2023-11-01,501,iphone 15,60000,80000,20000,2,00398,India
482365,2023-11-01,505,oven,18490,24000,5510,2,00106,India
482365,2023-11-01,504,iron,449,879,430,2,00106,India
842734,2023-11-01,505,oven,18490,24000,5510,2,00195,India
842734,2023-11-01,502,iphone 15 pro max,100000,135000,35000,2,00195,India
555743,2023-11-01,503,mixer,1349,3249,1900,2,00312,India
715646,2023-11-01,501,iphone 15,60000,80000,20000,2,00276,India
715646,2023-11-01,506,monitor,3249,8000,4751,2,00276,India
715646,2023-11-01,502,iphone 15 pro max,100000,135000,35000,2,00276,India
715646,2023-11-01,503,mixer,1349,3249,1900,2,00276,India
303374,2023-11-01,501,iphone 15,60000,80000,20000,2,00078,India
303374,2023-11-01,505,oven,18490,24000,5510,2,00078,India
593620,2023-11-01,506,monitor,3249,8000,4751,2,00473,India
593620,2023-11-01,501,iphone 15,60000,80000,20000,2,00473,India
154850,2023-11-01,504,iron,449,879,430,2,00279,India
447367,2023-11-01,501,iphone 15,60000,80000,20000,2,00462,India
447367,2023-11-01,503,mixer,1349,3249,1900,2,00462,India
447367,2023-11-01,505,oven,18490,24000,5510,2,00462,India
825562,2023-11-01,502,iphone 15 pro max,100000,135000,35000,2,00134,India
825562,2023-11-01,501,iphone 15,60000,80000,20000,2,00134,India
825562,2023-11-01,504,iron,449,879,430,2,00134,India
468826,2023-11-01,506,monitor,3249,8000,4751,2,00448,India
468826,2023-11-01,501,iphone 15,60000,80000,20000,2,00448,India
468826,2023-11-01,504,iron,449,879,430,2,00448,India
468826,2023-11-01,505,oven,18490,24000,5510,2,00448,India
468826,2023-11-01,502,iphone 15 pro max,100000,135000,35000,2,00448,India
474545,2023-11-01,502,iphone 15 pro max,100000,135000,35000,2,00486,India
474545,2023-11-01,503,mixer,1349,3249,1900,2,00486,India
474545,2023-11-01,501,iphone 15,60000,80000,20000,2,00486,India
910418,2023-11-01,503,mixer,1349,3249,1900,2,00292,India
910418,2023-11-01,506,monitor,3249,8000,4751,2,00292,India
910418,2023-11-01,505,oven,18490,24000,5510,2,00292,India
350734,2023-11-01,501,iphone 15,60000,80000,20000,2,00442,India
350734,2023-11-01,505,oven,18490,24000,5510,2,00442,India
797141,2023-11-01,506,monitor,3249,8000,4751,2,00005,India
161836,2023-11-01,504,iron,449,879,430,2,00369,India
161836,2023-11-01,503,mixer,1349,3249,1900,2,00369,India
161836,2023-11-01,501,iphone 15,60000,80000,20000,2,00369,India
161836,2023-11-01,507,washing machine,6990,16490,9500,2,00369,India
500802,2023-11-01,504,iron,449,879,430,2,00488,India
500802,2023-11-01,505,oven,18490,24000,5510,2,00488,India
676459,2023-11-01,506,monitor,3249,8000,4751,2,00064,India
676459,2023-11-01,505,oven,18490,24000,5510,2,00064,India
764929,2023-11-01,501,iphone 15,60000,80000,20000,2,00322,India
764929,2023-11-01,504,iron,449,879,430,2,00322,India
448392,2023-11-01,503,mixer,1349,3249,1900,2,00302,India
448392,2023-11-01,504,iron,449,879,430,2,00302,India
789300,2023-11-01,505,oven,18490,24000,5510,2,00435,India
570663,2023-11-01,501,iphone 15,60000,80000,20000,2,00140,India
570663,2023-11-01,505,oven,18490,24000,5510,2,00140,India
570663,2023-11-01,506,monitor,3249,8000,4751,2,00140,India
570663,2023-11-01,507,washing machine,6990,16490,9500,2,00140,India
314031,2023-11-01,503,mixer,1349,3249,1900,2,00226,India
314031,2023-11-01,504,iron,449,879,430,2,00226,India
667418,2023-11-01,501,iphone 15,60000,80000,20000,2,00096,India
783540,2023-11-01,506,monitor,3249,8000,4751,2,00371,India
783540,2023-11-01,502,iphone 15 pro max,100000,135000,35000,2,00371,India
783540,2023-11-01,503,mixer,1349,3249,1900,2,00371,India
645255,2023-11-01,501,iphone 15,60000,80000,20000,2,00362,India
645255,2023-11-01,507,washing machine,6990,16490,9500,2,00362,India
155676,2023-11-01,506,monitor,3249,8000,4751,2,00302,India
443441,2023-11-01,506,monitor,3249,8000,4751,2,00234,India
443441,2023-11-01,503,mixer,1349,3249,1900,2,00234,India
641372,2023-11-01,506,monitor,3249,8000,4751,2,00234,India
641372,2023-11-01,502,iphone 15 pro max,100000,135000,35000,2,00234,India
641372,2023-11-01,501,iphone 15,60000,80000,20000,2,00234,India
343917,2023-11-01,502,iphone 15 pro max,100000,135000,35000,2,00411,India
343917,2023-11-01,506,monitor,3249,8000,4751,2,00411,India
687173,2023-11-01,503,mixer,1349,3249,1900,2,00091,India
661548,2023-11-01,502,iphone 15 pro max,100000,135000,35000,2,00437,India
661548,2023-11-01,503,mixer,1349,3249,1900,2,00437,India
661548,2023-11-01,504,iron,449,879,430,2,00437,India
198130,2023-11-01,504,iron,449,879,430,2,00101,India
198130,2023-11-01,507,washing machine,6990,16490,9500,2,00101,India
198130,2023-11-01,505,oven,18490,24000,5510,2,00101,India
198130,2023-11-01,506,monitor,3249,8000,4751,2,00101,India
542993,2023-11-01,506,monitor,3249,8000,4751,2,00093,India
542993,2023-11-01,507,washing machine,6990,16490,9500,2,00093,India
446034,2023-11-01,507,washing machine,6990,16490,9500,2,00007,India
394781,2023-11-01,505,oven,18490,24000,5510,2,00348,India
394781,2023-11-01,506,monitor,3249,8000,4751,2,00348,India
704026,2023-11-01,503,mixer,1349,3249,1900,2,00085,India
704026,2023-11-01,507,washing machine,6990,16490,9500,2,00085,India
704026,2023-11-01,501,iphone 15,60000,80000,20000,2,00085,India
704026,2023-11-01,502,iphone 15 pro max,100000,135000,35000,2,00085,India
762233,2023-11-01,505,oven,18490,24000,5510,2,00389,India
762233,2023-11-01,506,monitor,3249,8000,4751,2,00389,India
762233,2023-11-01,507,washing machine,6990,16490,9500,2,00389,India
762233,2023-11-01,502,iphone 15 pro max,100000,135000,35000,2,00389,India
424495,2023-11-01,507,washing machine,6990,16490,9500,2,00316,India
424495,2023-11-01,502,iphone 15 pro max,100000,135000,35000,2,00316,India
358618,2023-11-01,507,washing machine,6990,16490,9500,2,00035,India
358618,2023-11-01,502,iphone 15 pro max,100000,135000,35000,2,00035,India
799992,2023-11-01,507,washing machine,6990,16490,9500,2,00225,India
799992,2023-11-01,501,iphone 15,60000,80000,20000,2,00225,India
885540,2023-11-01,501,iphone 15,60000,80000,20000,2,00272,India
885540,2023-11-01,504,iron,449,879,430,2,00272,India
885540,2023-11-01,502,iphone 15 pro max,100000,135000,35000,2,00272,India
885540,2023-11-01,507,washing machine,6990,16490,9500,2,00272,India
891897,2023-11-01,501,iphone 15,60000,80000,20000,2,00250,India
891897,2023-11-01,505,oven,18490,24000,5510,2,00250,India
329314,2023-11-01,506,monitor,3249,8000,4751,2,00204,India
329314,2023-11-01,503,mixer,1349,3249,1900,2,00204,India
329314,2023-11-01,501,iphone 15,60000,80000,20000,2,00204,India
370532,2023-11-01,506,monitor,3249,8000,4751,2,00043,India
370532,2023-11-01,503,mixer,1349,3249,1900,2,00043,India
370532,2023-11-01,502,iphone 15 pro max,100000,135000,35000,2,00043,India
500459,2023-11-01,507,washing machine,6990,16490,9500,2,00348,India
328445,2023-11-01,505,oven,18490,24000,5510,2,00313,India
328445,2023-11-01,507,washing machine,6990,16490,9500,2,00313,India
328445,2023-11-01,502,iphone 15 pro max,100000,135000,35000,2,00313,India
435396,2023-11-01,502,iphone 15 pro max,100000,135000,35000,2,00364,India
435396,2023-11-01,507,washing machine,6990,16490,9500,2,00364,India
435396,2023-11-01,506,monitor,3249,8000,4751,2,00364,India
917366,2023-11-02,502,iphone 15 pro max,100000,135000,35000,2,00084,India
917366,2023-11-02,506,monitor,3249,8000,4751,2,00084,India
917366,2023-11-02,505,oven,18490,24000,5510,2,00084,India
178252,2023-11-02,502,iphone 15 pro max,100000,135000,35000,2,00095,India
178252,2023-11-02,501,iphone 15,60000,80000,20000,2,00095,India
178252,2023-11-02,504,iron,449,879,430,2,00095,India
178252,2023-11-02,506,monitor,3249,8000,4751,2,00095,India
200332,2023-11-02,501,iphone 15,60000,80000,20000,2,00028,India
200332,2023-11-02,504,iron,449,879,430,2,00028,India
200332,2023-11-02,507,washing machine,6990,16490,9500,2,00028,India
753421,2023-11-02,505,oven,18490,24000,5510,2,00078,India
753421,2023-11-02,507,washing machine,6990,16490,9500,2,00078,India
579428,2023-11-02,505,oven,18490,24000,5510,2,00384,India
579428,2023-11-02,506,monitor,3249,8000,4751,2,00384,India
579428,2023-11-02,504,iron,449,879,430,2,00384,India
221587,2023-11-02,504,iron,449,879,430,2,00457,India
221587,2023-11-02,501,iphone 15,60000,80000,20000,2,00457,India
221587,2023-11-02,505,oven,18490,24000,5510,2,00457,India
431214,2023-11-02,501,iphone 15,60000,80000,20000,2,00199,India
431214,2023-11-02,503,mixer,1349,3249,1900,2,00199,India
166674,2023-11-02,503,mixer,1349,3249,1900,2,00070,India
166674,2023-11-02,505,oven,18490,24000,5510,2,00070,India
184858,2023-11-02,505,oven,18490,24000,5510,2,00314,India
184858,2023-11-02,501,iphone 15,60000,80000,20000,2,00314,India
184858,2023-11-02,503,mixer,1349,3249,1900,2,00314,India
914841,2023-11-02,504,iron,449,879,430,2,00408,India
914841,2023-11-02,502,iphone 15 pro max,100000,135000,35000,2,00408,India
914841,2023-11-02,503,mixer,1349,3249,1900,2,00408,India
897636,2023-11-02,507,washing machine,6990,16490,9500,2,00269,India
897636,2023-11-02,505,oven,18490,24000,5510,2,00269,India
974539,2023-11-02,502,iphone 15 pro max,100000,135000,35000,2,00067,India
974539,2023-11-02,505,oven,18490,24000,5510,2,00067,India
974539,2023-11-02,501,iphone 15,60000,80000,20000,2,00067,India
487521,2023-11-02,502,iphone 15 pro max,100000,135000,35000,2,00499,India
645388,2023-11-02,502,iphone 15 pro max,100000,135000,35000,2,00034,India
645388,2023-11-02,504,iron,449,879,430,2,00034,India
645388,2023-11-02,506,monitor,3249,8000,4751,2,00034,India
645388,2023-11-02,505,oven,18490,24000,5510,2,00034,India
378499,2023-11-02,507,washing machine,6990,16490,9500,2,00234,India
378499,2023-11-02,502,iphone 15 pro max,100000,135000,35000,2,00234,India
711151,2023-11-02,504,iron,449,879,430,2,00294,India
711151,2023-11-02,503,mixer,1349,3249,1900,2,00294,India
711151,2023-11-02,505,oven,18490,24000,5510,2,00294,India
711151,2023-11-02,502,iphone 15 pro max,100000,135000,35000,2,00294,India
550752,2023-11-02,505,oven,18490,24000,5510,2,00221,India
550752,2023-11-02,502,iphone 15 pro max,100000,135000,35000,2,00221,India
833852,2023-11-02,504,iron,449,879,430,2,00262,India
833852,2023-11-02,501,iphone 15,60000,80000,20000,2,00262,India
833852,2023-11-02,507,washing machine,6990,16490,9500,2,00262,India
833852,2023-11-02,505,oven,18490,24000,5510,2,00262,India
741415,2023-11-02,502,iphone 15 pro max,100000,135000,35000,2,00209,India
741415,2023-11-02,503,mixer,1349,3249,1900,2,00209,India
741415,2023-11-02,504,iron,449,879,430,2,00209,India
167234,2023-11-02,503,mixer,1349,3249,1900,2,00450,India
167234,2023-11-02,506,monitor,3249,8000,4751,2,00450,India
167234,2023-11-02,501,iphone 15,60000,80000,20000,2,00450,India
965455,2023-11-02,503,mixer,1349,3249,1900,2,00121,India
965455,2023-11-02,506,monitor,3249,8000,4751,2,00121,India
965455,2023-11-02,501,iphone 15,60000,80000,20000,2,00121,India
598209,2023-11-02,502,iphone 15 pro max,100000,135000,35000,2,00130,India
598209,2023-11-02,501,iphone 15,60000,80000,20000,2,00130,India
598209,2023-11-02,503,mixer,1349,3249,1900,2,00130,India
598209,2023-11-02,505,oven,18490,24000,5510,2,00130,India
598209,2023-11-02,506,monitor,3249,8000,4751,2,00130,India
757935,2023-11-02,504,iron,449,879,430,2,00023,India
219330,2023-11-02,503,mixer,1349,3249,1900,2,00358,India
219330,2023-11-02,506,monitor,3249,8000,4751,2,00358,India
218576,2023-11-02,503,mixer,1349,3249,1900,2,00493,India
684626,2023-11-02,507,washing machine,6990,16490,9500,2,00055,India
620290,2023-11-02,507,washing machine,6990,16490,9500,2,00395,India
620290,2023-11-02,506,monitor,3249,8000,4751,2,00395,India
620290,2023-11-02,501,iphone 15,60000,80000,20000,2,00395,India
558991,2023-11-02,501,iphone 15,60000,80000,20000,2,00202,India
558991,2023-11-02,507,washing machine,6990,16490,9500,2,00202,India
558991,2023-11-02,506,monitor,3249,8000,4751,2,00202,India
558991,2023-11-02,505,oven,18490,24000,5510,2,00202,India
407679,2023-11-02,507,washing machine,6990,16490,9500,2,00015,India
407679,2023-11-02,503,mixer,1349,3249,1900,2,00015,India
407679,2023-11-02,504,iron,449,879,430,2,00015,India
883714,2023-11-02,501,iphone 15,60000,80000,20000,2,00242,India
883714,2023-11-02,506,monitor,3249,8000,4751,2,00242,India
883714,2023-11-02,502,iphone 15 pro max,100000,135000,35000,2,00242,India
883714,2023-11-02,505,oven,18490,24000,5510,2,00242,India
723758,2023-11-02,507,washing machine,6990,16490,9500,2,00484,India
723758,2023-11-02,503,mixer,1349,3249,1900,2,00484,India
723758,2023-11-02,505,oven,18490,24000,5510,2,00484,India
729230,2023-11-02,502,iphone 15 pro max,100000,135000,35000,2,00344,India
729230,2023-11-02,504,iron,449,879,430,2,00344,India
736758,2023-11-02,502,iphone 15 pro max,100000,135000,35000,2,00323,India
736758,2023-11-02,504,iron,449,879,430,2,00323,India
736758,2023-11-02,503,mixer,1349,3249,1900,2,00323,India
736758,2023-11-02,507,washing machine,6990,16490,9500,2,00323,India
395967,2023-11-02,506,monitor,3249,8000,4751,2,00427,India
395967,2023-11-02,503,mixer,1349,3249,1900,2,00427,India
395967,2023-11-02,501,iphone 15,60000,80000,20000,2,00427,India
101953,2023-11-02,506,monitor,3249,8000,4751,2,00453,India
101953,2023-11-02,507,washing machine,6990,16490,9500,2,00453,India
101953,2023-11-02,504,iron,449,879,430,2,00453,India
766340,2023-11-02,501,iphone 15,60000,80000,20000,2,00312,India
766340,2023-11-02,503,mixer,1349,3249,1900,2,00312,India
766340,2023-11-02,502,iphone 15 pro max,100000,135000,35000,2,00312,India
766340,2023-11-02,506,monitor,3249,8000,4751,2,00312,India
622692,2023-11-02,504,iron,449,879,430,2,00019,India
810179,2023-11-02,501,iphone 15,60000,80000,20000,2,00052,India
376490,2023-11-02,501,iphone 15,60000,80000,20000,2,00140,India
376490,2023-11-02,507,washing machine,6990,16490,9500,2,00140,India
376490,2023-11-02,504,iron,449,879,430,2,00140,India
553698,2023-11-02,503,mixer,1349,3249,1900,2,00217,India
553698,2023-11-02,501,iphone 15,60000,80000,20000,2,00217,India
685421,2023-11-02,504,iron,449,879,430,2,00401,India
685421,2023-11-02,503,mixer,1349,3249,1900,2,00401,India
841752,2023-11-02,501,iphone 15,60000,80000,20000,2,00153,India
841752,2023-11-02,506,monitor,3249,8000,4751,2,00153,India
624347,2023-11-02,501,iphone 15,60000,80000,20000,2,00464,India
624347,2023-11-02,507,washing machine,6990,16490,9500,2,00464,India
624347,2023-11-02,505,oven,18490,24000,5510,2,00464,India
624347,2023-11-02,506,monitor,3249,8000,4751,2,00464,India
656988,2023-11-02,501,iphone 15,60000,80000,20000,2,00287,India
656988,2023-11-02,505,oven,18490,24000,5510,2,00287,India
354369,2023-11-02,507,washing machine,6990,16490,9500,2,00080,India
354369,2023-11-02,506,monitor,3249,8000,4751,2,00080,India
354369,2023-11-02,501,iphone 15,60000,80000,20000,2,00080,India
812041,2023-11-02,502,iphone 15 pro max,100000,135000,35000,2,00365,India
260189,2023-11-02,507,washing machine,6990,16490,9500,2,00379,India
260189,2023-11-02,506,monitor,3249,8000,4751,2,00379,India
260189,2023-11-02,502,iphone 15 pro max,100000,135000,35000,2,00379,India
260189,2023-11-02,504,iron,449,879,430,2,00379,India
759303,2023-11-02,501,iphone 15,60000,80000,20000,2,00489,India
759303,2023-11-02,505,oven,18490,24000,5510,2,00489,India
759303,2023-11-02,507,washing machine,6990,16490,9500,2,00489,India
759303,2023-11-02,503,mixer,1349,3249,1900,2,00489,India
759303,2023-11-02,506,monitor,3249,8000,4751,2,00489,India
863515,2023-11-02,507,washing machine,6990,16490,9500,2,00109,India
863515,2023-11-02,505,oven,18490,24000,5510,2,00109,India
863515,2023-11-02,506,monitor,3249,8000,4751,2,00109,India
863515,2023-11-02,503,mixer,1349,3249,1900,2,00109,India
863515,2023-11-02,504,iron,449,879,430,2,00109,India
699336,2023-11-02,507,washing machine,6990,16490,9500,2,00147,India
699336,2023-11-02,505,oven,18490,24000,5510,2,00147,India
154130,2023-11-02,503,mixer,1349,3249,1900,2,00056,India
154130,2023-11-02,502,iphone 15 pro max,100000,135000,35000,2,00056,India
154130,2023-11-02,504,iron,449,879,430,2,00056,India
792569,2023-11-02,507,washing machine,6990,16490,9500,2,00324,India
792569,2023-11-02,505,oven,18490,24000,5510,2,00324,India
452051,2023-11-02,507,washing machine,6990,16490,9500,2,00054,India
718873,2023-11-02,507,washing machine,6990,16490,9500,2,00205,India
718873,2023-11-02,502,iphone 15 pro max,100000,135000,35000,2,00205,India
718873,2023-11-02,503,mixer,1349,3249,1900,2,00205,India
202811,2023-11-02,503,mixer,1349,3249,1900,2,00120,India
202811,2023-11-02,507,washing machine,6990,16490,9500,2,00120,India
668221,2023-11-02,501,iphone 15,60000,80000,20000,2,00087,India
473091,2023-11-02,507,washing machine,6990,16490,9500,2,00285,India
473091,2023-11-02,502,iphone 15 pro max,100000,135000,35000,2,00285,India
473091,2023-11-02,504,iron,449,879,430,2,00285,India
473091,2023-11-02,503,mixer,1349,3249,1900,2,00285,India
174836,2023-11-02,502,iphone 15 pro max,100000,135000,35000,2,00175,India
174836,2023-11-02,501,iphone 15,60000,80000,20000,2,00175,India
174836,2023-11-02,503,mixer,1349,3249,1900,2,00175,India
174836,2023-11-02,506,monitor,3249,8000,4751,2,00175,India
383082,2023-11-02,506,monitor,3249,8000,4751,2,00288,India
383082,2023-11-02,503,mixer,1349,3249,1900,2,00288,India
398277,2023-11-02,506,monitor,3249,8000,4751,2,00198,India
398277,2023-11-02,505,oven,18490,24000,5510,2,00198,India
398277,2023-11-02,501,iphone 15,60000,80000,20000,2,00198,India
513362,2023-11-02,501,iphone 15,60000,80000,20000,2,00239,India
513362,2023-11-02,505,oven,18490,24000,5510,2,00239,India
513362,2023-11-02,503,mixer,1349,3249,1900,2,00239,India
122859,2023-11-02,502,iphone 15 pro max,100000,135000,35000,2,00242,India
122859,2023-11-02,503,mixer,1349,3249,1900,2,00242,India
350225,2023-11-02,507,washing machine,6990,16490,9500,2,00359,India
350225,2023-11-02,506,monitor,3249,8000,4751,2,00359,India
963932,2023-11-02,504,iron,449,879,430,2,00197,India
146029,2023-11-02,502,iphone 15 pro max,100000,135000,35000,2,00130,India
146029,2023-11-02,506,monitor,3249,8000,4751,2,00130,India
615161,2023-11-02,504,iron,449,879,430,2,00044,India
887640,2023-11-02,506,monitor,3249,8000,4751,2,00143,India
887640,2023-11-02,505,oven,18490,24000,5510,2,00143,India
119192,2023-11-02,501,iphone 15,60000,80000,20000,2,00348,India
119192,2023-11-02,503,mixer,1349,3249,1900,2,00348,India
119192,2023-11-02,502,iphone 15 pro max,100000,135000,35000,2,00348,India
353686,2023-11-02,503,mixer,1349,3249,1900,2,00368,India
353686,2023-11-02,505,oven,18490,24000,5510,2,00368,India
353686,2023-11-02,507,washing machine,6990,16490,9500,2,00368,India
353686,2023-11-02,501,iphone 15,60000,80000,20000,2,00368,India
776453,2023-11-02,501,iphone 15,60000,80000,20000,2,00218,India
776453,2023-11-02,503,mixer,1349,3249,1900,2,00218,India
433542,2023-11-02,504,iron,449,879,430,2,00285,India
654379,2023-11-02,503,mixer,1349,3249,1900,2,00348,India
654379,2023-11-02,505,oven,18490,24000,5510,2,00348,India
756609,2023-11-02,503,mixer,1349,3249,1900,2,00113,India
756609,2023-11-02,505,oven,18490,24000,5510,2,00113,India
799456,2023-11-02,505,oven,18490,24000,5510,2,00493,India
799456,2023-11-02,503,mixer,1349,3249,1900,2,00493,India
799456,2023-11-02,504,iron,449,879,430,2,00493,India
799456,2023-11-02,506,monitor,3249,8000,4751,2,00493,India
979359,2023-11-02,502,iphone 15 pro max,100000,135000,35000,2,00420,India
979359,2023-11-02,506,monitor,3249,8000,4751,2,00420,India
255007,2023-11-02,501,iphone 15,60000,80000,20000,2,00378,India
445397,2023-11-02,503,mixer,1349,3249,1900,2,00147,India
445397,2023-11-02,504,iron,449,879,430,2,00147,India
445397,2023-11-02,506,monitor,3249,8000,4751,2,00147,India
411139,2023-11-02,506,monitor,3249,8000,4751,2,00139,India
411139,2023-11-02,505,oven,18490,24000,5510,2,00139,India
411139,2023-11-02,503,mixer,1349,3249,1900,2,00139,India
395728,2023-11-02,506,monitor,3249,8000,4751,2,00026,India
395728,2023-11-02,501,iphone 15,60000,80000,20000,2,00026,India
267522,2023-11-02,505,oven,18490,24000,5510,2,00180,India
778748,2023-11-02,506,monitor,3249,8000,4751,2,00049,India
778748,2023-11-02,505,oven,18490,24000,5510,2,00049,India
778748,2023-11-02,507,washing machine,6990,16490,9500,2,00049,India
619148,2023-11-03,507,washing machine,6990,16490,9500,2,00361,India
619148,2023-11-03,505,oven,18490,24000,5510,2,00361,India
395171,2023-11-03,501,iphone 15,60000,80000,20000,2,00192,India
551699,2023-11-03,507,washing machine,6990,16490,9500,2,00338,India
551699,2023-11-03,503,mixer,1349,3249,1900,2,00338,India
551699,2023-11-03,505,oven,18490,24000,5510,2,00338,India
291213,2023-11-03,502,iphone 15 pro max,100000,135000,35000,2,00256,India
320166,2023-11-03,502,iphone 15 pro max,100000,135000,35000,2,00315,India
320166,2023-11-03,505,oven,18490,24000,5510,2,00315,India
320166,2023-11-03,506,monitor,3249,8000,4751,2,00315,India
418127,2023-11-03,507,washing machine,6990,16490,9500,2,00376,India
418127,2023-11-03,502,iphone 15 pro max,100000,135000,35000,2,00376,India
418127,2023-11-03,506,monitor,3249,8000,4751,2,00376,India
418127,2023-11-03,504,iron,449,879,430,2,00376,India
713162,2023-11-03,503,mixer,1349,3249,1900,2,00205,India
113333,2023-11-03,502,iphone 15 pro max,100000,135000,35000,2,00447,India
113333,2023-11-03,501,iphone 15,60000,80000,20000,2,00447,India
458152,2023-11-03,503,mixer,1349,3249,1900,2,00297,India
761679,2023-11-03,503,mixer,1349,3249,1900,2,00002,India
761679,2023-11-03,504,iron,449,879,430,2,00002,India
734491,2023-11-03,507,washing machine,6990,16490,9500,2,00225,India
734491,2023-11-03,502,iphone 15 pro max,100000,135000,35000,2,00225,India
734491,2023-11-03,503,mixer,1349,3249,1900,2,00225,India
734491,2023-11-03,504,iron,449,879,430,2,00225,India
147381,2023-11-03,505,oven,18490,24000,5510,2,00228,India
147381,2023-11-03,501,iphone 15,60000,80000,20000,2,00228,India
319778,2023-11-03,505,oven,18490,24000,5510,2,00126,India
108954,2023-11-03,506,monitor,3249,8000,4751,2,00154,India
108954,2023-11-03,501,iphone 15,60000,80000,20000,2,00154,India
358314,2023-11-03,507,washing machine,6990,16490,9500,2,00009,India
673698,2023-11-03,502,iphone 15 pro max,100000,135000,35000,2,00217,India
191213,2023-11-03,507,washing machine,6990,16490,9500,2,00368,India
191213,2023-11-03,505,oven,18490,24000,5510,2,00368,India
191213,2023-11-03,503,mixer,1349,3249,1900,2,00368,India
191213,2023-11-03,504,iron,449,879,430,2,00368,India
191213,2023-11-03,506,monitor,3249,8000,4751,2,00368,India
979878,2023-11-03,507,washing machine,6990,16490,9500,2,00423,India
979878,2023-11-03,505,oven,18490,24000,5510,2,00423,India
113409,2023-11-03,503,mixer,1349,3249,1900,2,00480,India
113409,2023-11-03,501,iphone 15,60000,80000,20000,2,00480,India
442744,2023-11-03,507,washing machine,6990,16490,9500,2,00365,India
840720,2023-11-03,507,washing machine,6990,16490,9500,2,00090,India
840720,2023-11-03,503,mixer,1349,3249,1900,2,00090,India
840720,2023-11-03,502,iphone 15 pro max,100000,135000,35000,2,00090,India
840720,2023-11-03,505,oven,18490,24000,5510,2,00090,India
840720,2023-11-03,506,monitor,3249,8000,4751,2,00090,India
151107,2023-11-03,507,washing machine,6990,16490,9500,2,00364,India
151107,2023-11-03,505,oven,18490,24000,5510,2,00364,India
151107,2023-11-03,501,iphone 15,60000,80000,20000,2,00364,India
152319,2023-11-03,501,iphone 15,60000,80000,20000,2,00492,India
152319,2023-11-03,505,oven,18490,24000,5510,2,00492,India
152319,2023-11-03,506,monitor,3249,8000,4751,2,00492,India
573958,2023-11-03,507,washing machine,6990,16490,9500,2,00284,India
573958,2023-11-03,505,oven,18490,24000,5510,2,00284,India
138882,2023-11-03,501,iphone 15,60000,80000,20000,2,00221,India
138882,2023-11-03,505,oven,18490,24000,5510,2,00221,India
330327,2023-11-03,504,iron,449,879,430,2,00336,India
330327,2023-11-03,503,mixer,1349,3249,1900,2,00336,India
219417,2023-11-03,507,washing machine,6990,16490,9500,2,00071,India
219417,2023-11-03,502,iphone 15 pro max,100000,135000,35000,2,00071,India
219417,2023-11-03,503,mixer,1349,3249,1900,2,00071,India
219417,2023-11-03,501,iphone 15,60000,80000,20000,2,00071,India
722522,2023-11-03,504,iron,449,879,430,2,00348,India
569104,2023-11-03,501,iphone 15,60000,80000,20000,2,00309,India
569104,2023-11-03,506,monitor,3249,8000,4751,2,00309,India
569104,2023-11-03,507,washing machine,6990,16490,9500,2,00309,India
569104,2023-11-03,505,oven,18490,24000,5510,2,00309,India
209628,2023-11-03,507,washing machine,6990,16490,9500,2,00496,India
209628,2023-11-03,502,iphone 15 pro max,100000,135000,35000,2,00496,India
209628,2023-11-03,501,iphone 15,60000,80000,20000,2,00496,India
209628,2023-11-03,505,oven,18490,24000,5510,2,00496,India
197514,2023-11-03,505,oven,18490,24000,5510,2,00322,India
185813,2023-11-03,505,oven,18490,24000,5510,2,00153,India
185813,2023-11-03,502,iphone 15 pro max,100000,135000,35000,2,00153,India
185813,2023-11-03,504,iron,449,879,430,2,00153,India
185813,2023-11-03,501,iphone 15,60000,80000,20000,2,00153,India
802137,2023-11-03,502,iphone 15 pro max,100000,135000,35000,2,00195,India
277072,2023-11-03,504,iron,449,879,430,2,00027,India
277072,2023-11-03,506,monitor,3249,8000,4751,2,00027,India
277072,2023-11-03,502,iphone 15 pro max,100000,135000,35000,2,00027,India
236469,2023-11-03,501,iphone 15,60000,80000,20000,2,00254,India
236469,2023-11-03,506,monitor,3249,8000,4751,2,00254,India
725430,2023-11-03,503,mixer,1349,3249,1900,2,00153,India
725430,2023-11-03,507,washing machine,6990,16490,9500,2,00153,India
725430,2023-11-03,506,monitor,3249,8000,4751,2,00153,India
336237,2023-11-03,502,iphone 15 pro max,100000,135000,35000,2,00453,India
336237,2023-11-03,506,monitor,3249,8000,4751,2,00453,India
634148,2023-11-03,506,monitor,3249,8000,4751,2,00205,India
865611,2023-11-03,507,washing machine,6990,16490,9500,2,00027,India
865611,2023-11-03,502,iphone 15 pro max,100000,135000,35000,2,00027,India
250327,2023-11-03,503,mixer,1349,3249,1900,2,00412,India
250327,2023-11-03,506,monitor,3249,8000,4751,2,00412,India
465711,2023-11-03,504,iron,449,879,430,2,00481,India
465711,2023-11-03,502,iphone 15 pro max,100000,135000,35000,2,00481,India
679947,2023-11-03,505,oven,18490,24000,5510,2,00203,India
679947,2023-11-03,501,iphone 15,60000,80000,20000,2,00203,India
924843,2023-11-03,503,mixer,1349,3249,1900,2,00348,India
924843,2023-11-03,502,iphone 15 pro max,100000,135000,35000,2,00348,India
924843,2023-11-03,504,iron,449,879,430,2,00348,India
464083,2023-11-03,504,iron,449,879,430,2,00015,India
464083,2023-11-03,507,washing machine,6990,16490,9500,2,00015,India
464083,2023-11-03,502,iphone 15 pro max,100000,135000,35000,2,00015,India
464083,2023-11-03,501,iphone 15,60000,80000,20000,2,00015,India
574564,2023-11-03,506,monitor,3249,8000,4751,2,00430,India
574564,2023-11-03,501,iphone 15,60000,80000,20000,2,00430,India
574564,2023-11-03,503,mixer,1349,3249,1900,2,00430,India
462293,2023-11-03,501,iphone 15,60000,80000,20000,2,00368,India
462293,2023-11-03,502,iphone 15 pro max,100000,135000,35000,2,00368,India
813257,2023-11-03,506,monitor,3249,8000,4751,2,00350,India
769586,2023-11-03,505,oven,18490,24000,5510,2,00052,India
859379,2023-11-03,505,oven,18490,24000,5510,2,00163,India
859379,2023-11-03,503,mixer,1349,3249,1900,2,00163,India
252908,2023-11-03,502,iphone 15 pro max,100000,135000,35000,2,00380,India
252908,2023-11-03,506,monitor,3249,8000,4751,2,00380,India
252908,2023-11-03,505,oven,18490,24000,5510,2,00380,India
846998,2023-11-03,501,iphone 15,60000,80000,20000,2,00403,India
688986,2023-11-03,507,washing machine,6990,16490,9500,2,00289,India
688986,2023-11-03,506,monitor,3249,8000,4751,2,00289,India
934269,2023-11-03,506,monitor,3249,8000,4751,2,00423,India
934269,2023-11-03,504,iron,449,879,430,2,00423,India
934269,2023-11-03,503,mixer,1349,3249,1900,2,00423,India
934269,2023-11-03,502,iphone 15 pro max,100000,135000,35000,2,00423,India
250707,2023-11-03,504,iron,449,879,430,2,00035,India
250707,2023-11-03,503,mixer,1349,3249,1900,2,00035,India
250707,2023-11-03,505,oven,18490,24000,5510,2,00035,India
473807,2023-11-03,503,mixer,1349,3249,1900,2,00305,India
401779,2023-11-03,504,iron,449,879,430,2,00172,India
401779,2023-11-03,506,monitor,3249,8000,4751,2,00172,India
401779,2023-11-03,503,mixer,1349,3249,1900,2,00172,India
401779,2023-11-03,505,oven,18490,24000,5510,2,00172,India
401779,2023-11-03,507,washing machine,6990,16490,9500,2,00172,India
136020,2023-11-03,502,iphone 15 pro max,100000,135000,35000,2,00359,India
857267,2023-11-03,506,monitor,3249,8000,4751,2,00123,India
857267,2023-11-03,503,mixer,1349,3249,1900,2,00123,India
285791,2023-11-03,506,monitor,3249,8000,4751,2,00438,India
256622,2023-11-03,504,iron,449,879,430,2,00351,India
256622,2023-11-03,501,iphone 15,60000,80000,20000,2,00351,India
256622,2023-11-03,505,oven,18490,24000,5510,2,00351,India
456797,2023-11-03,501,iphone 15,60000,80000,20000,2,00289,India
456797,2023-11-03,504,iron,449,879,430,2,00289,India
456797,2023-11-03,502,iphone 15 pro max,100000,135000,35000,2,00289,India
240643,2023-11-03,507,washing machine,6990,16490,9500,2,00212,India
249818,2023-11-03,505,oven,18490,24000,5510,2,00307,India
249818,2023-11-03,501,iphone 15,60000,80000,20000,2,00307,India
122964,2023-11-03,505,oven,18490,24000,5510,2,00460,India
122964,2023-11-03,501,iphone 15,60000,80000,20000,2,00460,India
122964,2023-11-03,507,washing machine,6990,16490,9500,2,00460,India
122964,2023-11-03,506,monitor,3249,8000,4751,2,00460,India
618638,2023-11-03,506,monitor,3249,8000,4751,2,00448,India
618638,2023-11-03,503,mixer,1349,3249,1900,2,00448,India
208313,2023-11-03,506,monitor,3249,8000,4751,2,00425,India
208313,2023-11-03,507,washing machine,6990,16490,9500,2,00425,India
208313,2023-11-03,503,mixer,1349,3249,1900,2,00425,India
208313,2023-11-03,502,iphone 15 pro max,100000,135000,35000,2,00425,India
277372,2023-11-03,506,monitor,3249,8000,4751,2,00197,India
277372,2023-11-03,504,iron,449,879,430,2,00197,India
277372,2023-11-03,507,washing machine,6990,16490,9500,2,00197,India
277372,2023-11-03,501,iphone 15,60000,80000,20000,2,00197,India
908664,2023-11-03,503,mixer,1349,3249,1900,2,00488,India
908664,2023-11-03,504,iron,449,879,430,2,00488,India
908664,2023-11-03,507,washing machine,6990,16490,9500,2,00488,India
248297,2023-11-03,503,mixer,1349,3249,1900,2,00164,India
248297,2023-11-03,505,oven,18490,24000,5510,2,00164,India
248297,2023-11-03,504,iron,449,879,430,2,00164,India
248297,2023-11-03,506,monitor,3249,8000,4751,2,00164,India
248297,2023-11-03,502,iphone 15 pro max,100000,135000,35000,2,00164,India
506560,2023-11-03,505,oven,18490,24000,5510,2,00203,India
876756,2023-11-03,503,mixer,1349,3249,1900,2,00085,India
876756,2023-11-03,502,iphone 15 pro max,100000,135000,35000,2,00085,India
182301,2023-11-03,507,washing machine,6990,16490,9500,2,00348,India
182301,2023-11-03,504,iron,449,879,430,2,00348,India
856999,2023-11-03,503,mixer,1349,3249,1900,2,00358,India
856999,2023-11-03,505,oven,18490,24000,5510,2,00358,India
224924,2023-11-03,504,iron,449,879,430,2,00083,India
224924,2023-11-03,502,iphone 15 pro max,100000,135000,35000,2,00083,India
224924,2023-11-03,507,washing machine,6990,16490,9500,2,00083,India
665927,2023-11-03,507,washing machine,6990,16490,9500,2,00163,India
870773,2023-11-03,505,oven,18490,24000,5510,2,00048,India
928086,2023-11-03,505,oven,18490,24000,5510,2,00423,India
928086,2023-11-03,507,washing machine,6990,16490,9500,2,00423,India
401466,2023-11-04,507,washing machine,6990,16490,9500,2,00242,India
401466,2023-11-04,504,iron,449,879,430,2,00242,India
481745,2023-11-04,507,washing machine,6990,16490,9500,2,00488,India
481745,2023-11-04,501,iphone 15,60000,80000,20000,2,00488,India
481745,2023-11-04,504,iron,449,879,430,2,00488,India
481745,2023-11-04,502,iphone 15 pro max,100000,135000,35000,2,00488,India
218428,2023-11-04,505,oven,18490,24000,5510,2,00016,India
358887,2023-11-04,505,oven,18490,24000,5510,2,00082,India
358887,2023-11-04,506,monitor,3249,8000,4751,2,00082,India
491488,2023-11-04,507,washing machine,6990,16490,9500,2,00436,India
491488,2023-11-04,505,oven,18490,24000,5510,2,00436,India
429847,2023-11-04,505,oven,18490,24000,5510,2,00367,India
535523,2023-11-04,502,iphone 15 pro max,100000,135000,35000,2,00043,India
535523,2023-11-04,504,iron,449,879,430,2,00043,India
535523,2023-11-04,507,washing machine,6990,16490,9500,2,00043,India
535523,2023-11-04,501,iphone 15,60000,80000,20000,2,00043,India
219197,2023-11-04,501,iphone 15,60000,80000,20000,2,00221,India
166080,2023-11-04,507,washing machine,6990,16490,9500,2,00245,India
166080,2023-11-04,506,monitor,3249,8000,4751,2,00245,India
166080,2023-11-04,504,iron,449,879,430,2,00245,India
565168,2023-11-04,505,oven,18490,24000,5510,2,00494,India
565168,2023-11-04,507,washing machine,6990,16490,9500,2,00494,India
565168,2023-11-04,502,iphone 15 pro max,100000,135000,35000,2,00494,India
996268,2023-11-04,505,oven,18490,24000,5510,2,00349,India
996268,2023-11-04,507,washing machine,6990,16490,9500,2,00349,India
996268,2023-11-04,501,iphone 15,60000,80000,20000,2,00349,India
915451,2023-11-04,503,mixer,1349,3249,1900,2,00010,India
915451,2023-11-04,505,oven,18490,24000,5510,2,00010,India
915451,2023-11-04,504,iron,449,879,430,2,00010,India
915451,2023-11-04,501,iphone 15,60000,80000,20000,2,00010,India
501284,2023-11-04,504,iron,449,879,430,2,00409,India
501284,2023-11-04,505,oven,18490,24000,5510,2,00409,India
501284,2023-11-04,507,washing machine,6990,16490,9500,2,00409,India
203110,2023-11-04,504,iron,449,879,430,2,00017,India
728976,2023-11-04,507,washing machine,6990,16490,9500,2,00026,India
728976,2023-11-04,503,mixer,1349,3249,1900,2,00026,India
728976,2023-11-04,504,iron,449,879,430,2,00026,India
728976,2023-11-04,506,monitor,3249,8000,4751,2,00026,India
653467,2023-11-04,505,oven,18490,24000,5510,2,00204,India
152451,2023-11-04,506,monitor,3249,8000,4751,2,00364,India
152451,2023-11-04,501,iphone 15,60000,80000,20000,2,00364,India
510411,2023-11-04,503,mixer,1349,3249,1900,2,00007,India
510411,2023-11-04,504,iron,449,879,430,2,00007,India
510411,2023-11-04,507,washing machine,6990,16490,9500,2,00007,India
843725,2023-11-04,507,washing machine,6990,16490,9500,2,00184,India
843725,2023-11-04,506,monitor,3249,8000,4751,2,00184,India
389287,2023-11-04,503,mixer,1349,3249,1900,2,00007,India
389287,2023-11-04,505,oven,18490,24000,5510,2,00007,India
389287,2023-11-04,504,iron,449,879,430,2,00007,India
389287,2023-11-04,507,washing machine,6990,16490,9500,2,00007,India
982768,2023-11-04,506,monitor,3249,8000,4751,2,00072,India
982768,2023-11-04,502,iphone 15 pro max,100000,135000,35000,2,00072,India
119760,2023-11-04,506,monitor,3249,8000,4751,2,00235,India
119760,2023-11-04,503,mixer,1349,3249,1900,2,00235,India
119760,2023-11-04,504,iron,449,879,430,2,00235,India
911969,2023-11-04,503,mixer,1349,3249,1900,2,00302,India
911969,2023-11-04,502,iphone 15 pro max,100000,135000,35000,2,00302,India
496753,2023-11-04,505,oven,18490,24000,5510,2,00362,India
496753,2023-11-04,503,mixer,1349,3249,1900,2,00362,India
501781,2023-11-04,501,iphone 15,60000,80000,20000,2,00422,India
501781,2023-11-04,503,mixer,1349,3249,1900,2,00422,India
501781,2023-11-04,504,iron,449,879,430,2,00422,India
501781,2023-11-04,502,iphone 15 pro max,100000,135000,35000,2,00422,India
501781,2023-11-04,506,monitor,3249,8000,4751,2,00422,India
561289,2023-11-04,507,washing machine,6990,16490,9500,2,00150,India
561289,2023-11-04,503,mixer,1349,3249,1900,2,00150,India
561289,2023-11-04,504,iron,449,879,430,2,00150,India
337902,2023-11-04,503,mixer,1349,3249,1900,2,00054,India
337902,2023-11-04,507,washing machine,6990,16490,9500,2,00054,India
337902,2023-11-04,502,iphone 15 pro max,100000,135000,35000,2,00054,India
649061,2023-11-04,507,washing machine,6990,16490,9500,2,00451,India
649061,2023-11-04,504,iron,449,879,430,2,00451,India
649061,2023-11-04,501,iphone 15,60000,80000,20000,2,00451,India
640933,2023-11-04,502,iphone 15 pro max,100000,135000,35000,2,00213,India
128516,2023-11-04,506,monitor,3249,8000,4751,2,00428,India
359929,2023-11-04,502,iphone 15 pro max,100000,135000,35000,2,00490,India
321181,2023-11-04,507,washing machine,6990,16490,9500,2,00344,India
321181,2023-11-04,506,monitor,3249,8000,4751,2,00344,India
321181,2023-11-04,502,iphone 15 pro max,100000,135000,35000,2,00344,India
321181,2023-11-04,501,iphone 15,60000,80000,20000,2,00344,India
858152,2023-11-04,506,monitor,3249,8000,4751,2,00452,India
858152,2023-11-04,502,iphone 15 pro max,100000,135000,35000,2,00452,India
858152,2023-11-04,505,oven,18490,24000,5510,2,00452,India
208628,2023-11-04,505,oven,18490,24000,5510,2,00008,India
963639,2023-11-04,507,washing machine,6990,16490,9500,2,00373,India
963639,2023-11-04,502,iphone 15 pro max,100000,135000,35000,2,00373,India
963639,2023-11-04,505,oven,18490,24000,5510,2,00373,India
963639,2023-11-04,506,monitor,3249,8000,4751,2,00373,India
269727,2023-11-04,507,washing machine,6990,16490,9500,2,00247,India
887827,2023-11-04,503,mixer,1349,3249,1900,2,00385,India
887827,2023-11-04,505,oven,18490,24000,5510,2,00385,India
359886,2023-11-04,505,oven,18490,24000,5510,2,00055,India
359886,2023-11-04,504,iron,449,879,430,2,00055,India
359886,2023-11-04,507,washing machine,6990,16490,9500,2,00055,India
102928,2023-11-04,507,washing machine,6990,16490,9500,2,00483,India
102928,2023-11-04,503,mixer,1349,3249,1900,2,00483,India
145221,2023-11-04,507,washing machine,6990,16490,9500,2,00436,India
937046,2023-11-04,505,oven,18490,24000,5510,2,00080,India
937046,2023-11-04,503,mixer,1349,3249,1900,2,00080,India
937046,2023-11-04,504,iron,449,879,430,2,00080,India
808873,2023-11-04,501,iphone 15,60000,80000,20000,2,00058,India
216259,2023-11-04,505,oven,18490,24000,5510,2,00385,India
216259,2023-11-04,502,iphone 15 pro max,100000,135000,35000,2,00385,India
129491,2023-11-04,501,iphone 15,60000,80000,20000,2,00115,India
129491,2023-11-04,503,mixer,1349,3249,1900,2,00115,India
351966,2023-11-04,501,iphone 15,60000,80000,20000,2,00146,India
351966,2023-11-04,507,washing machine,6990,16490,9500,2,00146,India
351966,2023-11-04,505,oven,18490,24000,5510,2,00146,India
351966,2023-11-04,506,monitor,3249,8000,4751,2,00146,India
173028,2023-11-04,503,mixer,1349,3249,1900,2,00232,India
173028,2023-11-04,502,iphone 15 pro max,100000,135000,35000,2,00232,India
173028,2023-11-04,501,iphone 15,60000,80000,20000,2,00232,India
995251,2023-11-04,507,washing machine,6990,16490,9500,2,00014,India
995251,2023-11-04,506,monitor,3249,8000,4751,2,00014,India
995251,2023-11-04,504,iron,449,879,430,2,00014,India
150459,2023-11-04,506,monitor,3249,8000,4751,2,00035,India
714336,2023-11-04,504,iron,449,879,430,2,00173,India
714336,2023-11-04,506,monitor,3249,8000,4751,2,00173,India
714336,2023-11-04,501,iphone 15,60000,80000,20000,2,00173,India
851474,2023-11-04,505,oven,18490,24000,5510,2,00115,India
851474,2023-11-04,501,iphone 15,60000,80000,20000,2,00115,India
851474,2023-11-04,507,washing machine,6990,16490,9500,2,00115,India
838480,2023-11-04,501,iphone 15,60000,80000,20000,2,00360,India
838480,2023-11-04,503,mixer,1349,3249,1900,2,00360,India
838480,2023-11-04,506,monitor,3249,8000,4751,2,00360,India
838480,2023-11-04,507,washing machine,6990,16490,9500,2,00360,India
527066,2023-11-04,502,iphone 15 pro max,100000,135000,35000,2,00390,India
603638,2023-11-04,505,oven,18490,24000,5510,2,00208,India
603638,2023-11-04,503,mixer,1349,3249,1900,2,00208,India
521537,2023-11-04,505,oven,18490,24000,5510,2,00383,India
521537,2023-11-04,504,iron,449,879,430,2,00383,India
814858,2023-11-04,502,iphone 15 pro max,100000,135000,35000,2,00432,India
385257,2023-11-04,503,mixer,1349,3249,1900,2,00273,India
385257,2023-11-04,505,oven,18490,24000,5510,2,00273,India
929789,2023-11-04,501,iphone 15,60000,80000,20000,2,00452,India
659747,2023-11-04,506,monitor,3249,8000,4751,2,00368,India
659747,2023-11-04,504,iron,449,879,430,2,00368,India
659747,2023-11-04,505,oven,18490,24000,5510,2,00368,India
659747,2023-11-04,507,washing machine,6990,16490,9500,2,00368,India
699683,2023-11-04,504,iron,449,879,430,2,00386,India
271499,2023-11-04,502,iphone 15 pro max,100000,135000,35000,2,00379,India
415583,2023-11-04,504,iron,449,879,430,2,00112,India
415583,2023-11-04,507,washing machine,6990,16490,9500,2,00112,India
874146,2023-11-04,505,oven,18490,24000,5510,2,00293,India
874146,2023-11-04,503,mixer,1349,3249,1900,2,00293,India
874146,2023-11-04,504,iron,449,879,430,2,00293,India
296245,2023-11-04,506,monitor,3249,8000,4751,2,00240,India
330505,2023-11-04,507,washing machine,6990,16490,9500,2,00263,India
330505,2023-11-04,506,monitor,3249,8000,4751,2,00263,India
330505,2023-11-04,504,iron,449,879,430,2,00263,India
330505,2023-11-04,503,mixer,1349,3249,1900,2,00263,India
917742,2023-11-04,507,washing machine,6990,16490,9500,2,00474,India
917742,2023-11-04,506,monitor,3249,8000,4751,2,00474,India
917742,2023-11-04,501,iphone 15,60000,80000,20000,2,00474,India
459099,2023-11-04,507,washing machine,6990,16490,9500,2,00315,India
459099,2023-11-04,501,iphone 15,60000,80000,20000,2,00315,India
459099,2023-11-04,505,oven,18490,24000,5510,2,00315,India
955620,2023-11-04,506,monitor,3249,8000,4751,2,00291,India
955620,2023-11-04,507,washing machine,6990,16490,9500,2,00291,India
366768,2023-11-04,504,iron,449,879,430,2,00091,India
366768,2023-11-04,501,iphone 15,60000,80000,20000,2,00091,India
366768,2023-11-04,505,oven,18490,24000,5510,2,00091,India
366768,2023-11-04,503,mixer,1349,3249,1900,2,00091,India
203265,2023-11-04,505,oven,18490,24000,5510,2,00101,India
203265,2023-11-04,503,mixer,1349,3249,1900,2,00101,India
488175,2023-11-04,507,washing machine,6990,16490,9500,2,00304,India
488175,2023-11-04,504,iron,449,879,430,2,00304,India
488175,2023-11-04,502,iphone 15 pro max,100000,135000,35000,2,00304,India
354907,2023-11-04,501,iphone 15,60000,80000,20000,2,00170,India
354907,2023-11-04,503,mixer,1349,3249,1900,2,00170,India
495175,2023-11-04,505,oven,18490,24000,5510,2,00119,India
495175,2023-11-04,506,monitor,3249,8000,4751,2,00119,India
206077,2023-11-04,503,mixer,1349,3249,1900,2,00267,India
206077,2023-11-04,506,monitor,3249,8000,4751,2,00267,India
206077,2023-11-04,501,iphone 15,60000,80000,20000,2,00267,India
206077,2023-11-04,504,iron,449,879,430,2,00267,India
682669,2023-11-04,501,iphone 15,60000,80000,20000,2,00408,India
682669,2023-11-04,505,oven,18490,24000,5510,2,00408,India
682669,2023-11-04,502,iphone 15 pro max,100000,135000,35000,2,00408,India
682669,2023-11-04,503,mixer,1349,3249,1900,2,00408,India
910036,2023-11-04,503,mixer,1349,3249,1900,2,00260,India
910036,2023-11-04,502,iphone 15 pro max,100000,135000,35000,2,00260,India
910036,2023-11-04,501,iphone 15,60000,80000,20000,2,00260,India
910036,2023-11-04,505,oven,18490,24000,5510,2,00260,India
612070,2023-11-04,501,iphone 15,60000,80000,20000,2,00393,India
612070,2023-11-04,504,iron,449,879,430,2,00393,India
907317,2023-11-04,504,iron,449,879,430,2,00407,India
907317,2023-11-04,501,iphone 15,60000,80000,20000,2,00407,India
824653,2023-11-04,507,washing machine,6990,16490,9500,2,00112,India
824653,2023-11-04,503,mixer,1349,3249,1900,2,00112,India
824653,2023-11-04,501,iphone 15,60000,80000,20000,2,00112,India
785526,2023-11-04,502,iphone 15 pro max,100000,135000,35000,2,00472,India
664050,2023-11-04,503,mixer,1349,3249,1900,2,00119,India
664050,2023-11-04,506,monitor,3249,8000,4751,2,00119,India
664050,2023-11-04,507,washing machine,6990,16490,9500,2,00119,India
664050,2023-11-04,505,oven,18490,24000,5510,2,00119,India
725246,2023-11-04,501,iphone 15,60000,80000,20000,2,00347,India
725246,2023-11-04,505,oven,18490,24000,5510,2,00347,India
725246,2023-11-04,504,iron,449,879,430,2,00347,India
530687,2023-11-04,502,iphone 15 pro max,100000,135000,35000,2,00407,India
530687,2023-11-04,506,monitor,3249,8000,4751,2,00407,India
530687,2023-11-04,505,oven,18490,24000,5510,2,00407,India
810461,2023-11-04,506,monitor,3249,8000,4751,2,00230,India
810461,2023-11-04,504,iron,449,879,430,2,00230,India
810461,2023-11-04,501,iphone 15,60000,80000,20000,2,00230,India
810461,2023-11-04,502,iphone 15 pro max,100000,135000,35000,2,00230,India
596627,2023-11-04,504,iron,449,879,430,2,00221,India
826095,2023-11-04,507,washing machine,6990,16490,9500,2,00319,India
826095,2023-11-04,506,monitor,3249,8000,4751,2,00319,India
579329,2023-11-04,507,washing machine,6990,16490,9500,2,00269,India
579329,2023-11-04,505,oven,18490,24000,5510,2,00269,India
579329,2023-11-04,501,iphone 15,60000,80000,20000,2,00269,India
956160,2023-11-04,504,iron,449,879,430,2,00179,India
242720,2023-11-04,505,oven,18490,24000,5510,2,00107,India
242720,2023-11-04,506,monitor,3249,8000,4751,2,00107,India
242720,2023-11-04,507,washing machine,6990,16490,9500,2,00107,India
242720,2023-11-04,501,iphone 15,60000,80000,20000,2,00107,India
990699,2023-11-04,505,oven,18490,24000,5510,2,00119,India
990699,2023-11-04,504,iron,449,879,430,2,00119,India
990699,2023-11-04,506,monitor,3249,8000,4751,2,00119,India
990699,2023-11-04,507,washing machine,6990,16490,9500,2,00119,India
914756,2023-11-04,506,monitor,3249,8000,4751,2,00054,India
914756,2023-11-04,505,oven,18490,24000,5510,2,00054,India
531273,2023-11-04,504,iron,449,879,430,2,00223,India
375836,2023-11-04,504,iron,449,879,430,2,00406,India
375836,2023-11-04,502,iphone 15 pro max,100000,135000,35000,2,00406,India
375836,2023-11-04,506,monitor,3249,8000,4751,2,00406,India
375836,2023-11-04,505,oven,18490,24000,5510,2,00406,India
311818,2023-11-04,501,iphone 15,60000,80000,20000,2,00052,India
311818,2023-11-04,504,iron,449,879,430,2,00052,India
311818,2023-11-04,506,monitor,3249,8000,4751,2,00052,India
334462,2023-11-04,502,iphone 15 pro max,100000,135000,35000,2,00372,India
334462,2023-11-04,504,iron,449,879,430,2,00372,India
334462,2023-11-04,506,monitor,3249,8000,4751,2,00372,India
334462,2023-11-04,501,iphone 15,60000,80000,20000,2,00372,India
515238,2023-11-04,506,monitor,3249,8000,4751,2,00015,India
782520,2023-11-04,501,iphone 15,60000,80000,20000,2,00068,India
782520,2023-11-04,503,mixer,1349,3249,1900,2,00068,India
782520,2023-11-04,502,iphone 15 pro max,100000,135000,35000,2,00068,India
782520,2023-11-04,507,washing machine,6990,16490,9500,2,00068,India
110637,2023-11-04,504,iron,449,879,430,2,00157,India
110637,2023-11-04,507,washing machine,6990,16490,9500,2,00157,India
110637,2023-11-04,503,mixer,1349,3249,1900,2,00157,India
110637,2023-11-04,502,iphone 15 pro max,100000,135000,35000,2,00157,India
739070,2023-11-05,506,monitor,3249,8000,4751,2,00104,India
739070,2023-11-05,507,washing machine,6990,16490,9500,2,00104,India
739070,2023-11-05,501,iphone 15,60000,80000,20000,2,00104,India
263553,2023-11-05,505,oven,18490,24000,5510,2,00319,India
814918,2023-11-05,506,monitor,3249,8000,4751,2,00476,India
814918,2023-11-05,503,mixer,1349,3249,1900,2,00476,India
967301,2023-11-05,507,washing machine,6990,16490,9500,2,00068,India
967301,2023-11-05,501,iphone 15,60000,80000,20000,2,00068,India
967301,2023-11-05,505,oven,18490,24000,5510,2,00068,India
967301,2023-11-05,506,monitor,3249,8000,4751,2,00068,India
479658,2023-11-05,503,mixer,1349,3249,1900,2,00093,India
479658,2023-11-05,506,monitor,3249,8000,4751,2,00093,India
479658,2023-11-05,502,iphone 15 pro max,100000,135000,35000,2,00093,India
313074,2023-11-05,507,washing machine,6990,16490,9500,2,00235,India
313074,2023-11-05,505,oven,18490,24000,5510,2,00235,India
313074,2023-11-05,506,monitor,3249,8000,4751,2,00235,India
313074,2023-11-05,502,iphone 15 pro max,100000,135000,35000,2,00235,India
313074,2023-11-05,503,mixer,1349,3249,1900,2,00235,India
492121,2023-11-05,501,iphone 15,60000,80000,20000,2,00178,India
800955,2023-11-05,504,iron,449,879,430,2,00354,India
800955,2023-11-05,503,mixer,1349,3249,1900,2,00354,India
800955,2023-11-05,506,monitor,3249,8000,4751,2,00354,India
239204,2023-11-05,504,iron,449,879,430,2,00066,India
239204,2023-11-05,503,mixer,1349,3249,1900,2,00066,India
494589,2023-11-05,507,washing machine,6990,16490,9500,2,00164,India
494589,2023-11-05,504,iron,449,879,430,2,00164,India
557478,2023-11-05,501,iphone 15,60000,80000,20000,2,00359,India
557478,2023-11-05,502,iphone 15 pro max,100000,135000,35000,2,00359,India
557478,2023-11-05,504,iron,449,879,430,2,00359,India
142379,2023-11-05,502,iphone 15 pro max,100000,135000,35000,2,00047,India
970534,2023-11-05,504,iron,449,879,430,2,00337,India
941672,2023-11-05,506,monitor,3249,8000,4751,2,00010,India
941672,2023-11-05,503,mixer,1349,3249,1900,2,00010,India
941672,2023-11-05,507,washing machine,6990,16490,9500,2,00010,India
941672,2023-11-05,505,oven,18490,24000,5510,2,00010,India
941672,2023-11-05,501,iphone 15,60000,80000,20000,2,00010,India
737437,2023-11-05,505,oven,18490,24000,5510,2,00350,India
737437,2023-11-05,506,monitor,3249,8000,4751,2,00350,India
737437,2023-11-05,502,iphone 15 pro max,100000,135000,35000,2,00350,India
737437,2023-11-05,507,washing machine,6990,16490,9500,2,00350,India
919061,2023-11-05,501,iphone 15,60000,80000,20000,2,00282,India
919061,2023-11-05,507,washing machine,6990,16490,9500,2,00282,India
919061,2023-11-05,506,monitor,3249,8000,4751,2,00282,India
919061,2023-11-05,505,oven,18490,24000,5510,2,00282,India
262621,2023-11-05,503,mixer,1349,3249,1900,2,00044,India
262621,2023-11-05,506,monitor,3249,8000,4751,2,00044,India
944597,2023-11-05,505,oven,18490,24000,5510,2,00299,India
944597,2023-11-05,502,iphone 15 pro max,100000,135000,35000,2,00299,India
944597,2023-11-05,507,washing machine,6990,16490,9500,2,00299,India
944597,2023-11-05,506,monitor,3249,8000,4751,2,00299,India
723309,2023-11-05,506,monitor,3249,8000,4751,2,00008,India
723309,2023-11-05,503,mixer,1349,3249,1900,2,00008,India
723309,2023-11-05,501,iphone 15,60000,80000,20000,2,00008,India
494572,2023-11-05,504,iron,449,879,430,2,00297,India
494572,2023-11-05,505,oven,18490,24000,5510,2,00297,India
236957,2023-11-05,503,mixer,1349,3249,1900,2,00147,India
236957,2023-11-05,505,oven,18490,24000,5510,2,00147,India
236957,2023-11-05,507,washing machine,6990,16490,9500,2,00147,India
236957,2023-11-05,502,iphone 15 pro max,100000,135000,35000,2,00147,India
236957,2023-11-05,501,iphone 15,60000,80000,20000,2,00147,India
836930,2023-11-05,503,mixer,1349,3249,1900,2,00467,India
836930,2023-11-05,506,monitor,3249,8000,4751,2,00467,India
836930,2023-11-05,504,iron,449,879,430,2,00467,India
836930,2023-11-05,502,iphone 15 pro max,100000,135000,35000,2,00467,India
920618,2023-11-05,506,monitor,3249,8000,4751,2,00433,India
920618,2023-11-05,507,washing machine,6990,16490,9500,2,00433,India
263206,2023-11-05,505,oven,18490,24000,5510,2,00215,India
263206,2023-11-05,506,monitor,3249,8000,4751,2,00215,India
269803,2023-11-05,501,iphone 15,60000,80000,20000,2,00465,India
269803,2023-11-05,503,mixer,1349,3249,1900,2,00465,India
270935,2023-11-05,507,washing machine,6990,16490,9500,2,00439,India
874070,2023-11-05,505,oven,18490,24000,5510,2,00151,India
874070,2023-11-05,501,iphone 15,60000,80000,20000,2,00151,India
874070,2023-11-05,503,mixer,1349,3249,1900,2,00151,India
737499,2023-11-05,503,mixer,1349,3249,1900,2,00021,India
737499,2023-11-05,505,oven,18490,24000,5510,2,00021,India
873893,2023-11-05,507,washing machine,6990,16490,9500,2,00460,India
873893,2023-11-05,503,mixer,1349,3249,1900,2,00460,India
873893,2023-11-05,501,iphone 15,60000,80000,20000,2,00460,India
118366,2023-11-05,503,mixer,1349,3249,1900,2,00421,India
118366,2023-11-05,505,oven,18490,24000,5510,2,00421,India
862453,2023-11-05,503,mixer,1349,3249,1900,2,00083,India
862453,2023-11-05,504,iron,449,879,430,2,00083,India
862453,2023-11-05,505,oven,18490,24000,5510,2,00083,India
862453,2023-11-05,507,washing machine,6990,16490,9500,2,00083,India
526296,2023-11-05,504,iron,449,879,430,2,00285,India
526296,2023-11-05,503,mixer,1349,3249,1900,2,00285,India
526296,2023-11-05,506,monitor,3249,8000,4751,2,00285,India
526296,2023-11-05,507,washing machine,6990,16490,9500,2,00285,India
431707,2023-11-05,503,mixer,1349,3249,1900,2,00127,India
431707,2023-11-05,507,washing machine,6990,16490,9500,2,00127,India
431707,2023-11-05,505,oven,18490,24000,5510,2,00127,India
431707,2023-11-05,506,monitor,3249,8000,4751,2,00127,India
967163,2023-11-05,505,oven,18490,24000,5510,2,00157,India
967163,2023-11-05,503,mixer,1349,3249,1900,2,00157,India
967163,2023-11-05,504,iron,449,879,430,2,00157,India
767677,2023-11-05,503,mixer,1349,3249,1900,2,00373,India
767677,2023-11-05,506,monitor,3249,8000,4751,2,00373,India
767677,2023-11-05,502,iphone 15 pro max,100000,135000,35000,2,00373,India
767677,2023-11-05,507,washing machine,6990,16490,9500,2,00373,India
121965,2023-11-05,506,monitor,3249,8000,4751,2,00467,India
121965,2023-11-05,505,oven,18490,24000,5510,2,00467,India
121965,2023-11-05,502,iphone 15 pro max,100000,135000,35000,2,00467,India
581473,2023-11-05,505,oven,18490,24000,5510,2,00177,India
476583,2023-11-05,506,monitor,3249,8000,4751,2,00350,India
476583,2023-11-05,503,mixer,1349,3249,1900,2,00350,India
476583,2023-11-05,501,iphone 15,60000,80000,20000,2,00350,India
573219,2023-11-05,506,monitor,3249,8000,4751,2,00325,India
392108,2023-11-05,507,washing machine,6990,16490,9500,2,00003,India
220272,2023-11-05,505,oven,18490,24000,5510,2,00172,India
220272,2023-11-05,502,iphone 15 pro max,100000,135000,35000,2,00172,India
125723,2023-11-05,507,washing machine,6990,16490,9500,2,00390,India
125723,2023-11-05,505,oven,18490,24000,5510,2,00390,India
125723,2023-11-05,503,mixer,1349,3249,1900,2,00390,India
913982,2023-11-05,501,iphone 15,60000,80000,20000,2,00479,India
913982,2023-11-05,505,oven,18490,24000,5510,2,00479,India
913982,2023-11-05,504,iron,449,879,430,2,00479,India
836565,2023-11-05,501,iphone 15,60000,80000,20000,2,00480,India
165581,2023-11-05,507,washing machine,6990,16490,9500,2,00120,India
165581,2023-11-05,506,monitor,3249,8000,4751,2,00120,India
165581,2023-11-05,502,iphone 15 pro max,100000,135000,35000,2,00120,India
381808,2023-11-05,505,oven,18490,24000,5510,2,00264,India
934826,2023-11-05,505,oven,18490,24000,5510,2,00499,India
934826,2023-11-05,507,washing machine,6990,16490,9500,2,00499,India
279655,2023-11-05,506,monitor,3249,8000,4751,2,00205,India
552997,2023-11-05,504,iron,449,879,430,2,00124,India
552997,2023-11-05,505,oven,18490,24000,5510,2,00124,India
552997,2023-11-05,503,mixer,1349,3249,1900,2,00124,India
552997,2023-11-05,501,iphone 15,60000,80000,20000,2,00124,India
910862,2023-11-05,503,mixer,1349,3249,1900,2,00091,India
910862,2023-11-05,501,iphone 15,60000,80000,20000,2,00091,India
756989,2023-11-05,502,iphone 15 pro max,100000,135000,35000,2,00002,India
328098,2023-11-05,502,iphone 15 pro max,100000,135000,35000,2,00285,India
449096,2023-11-05,501,iphone 15,60000,80000,20000,2,00014,India
449096,2023-11-05,505,oven,18490,24000,5510,2,00014,India
653124,2023-11-05,505,oven,18490,24000,5510,2,00004,India
653124,2023-11-05,506,monitor,3249,8000,4751,2,00004,India
653124,2023-11-05,502,iphone 15 pro max,100000,135000,35000,2,00004,India
653124,2023-11-05,504,iron,449,879,430,2,00004,India
351159,2023-11-05,501,iphone 15,60000,80000,20000,2,00321,India
351159,2023-11-05,507,washing machine,6990,16490,9500,2,00321,India
900032,2023-11-05,505,oven,18490,24000,5510,2,00449,India
900032,2023-11-05,503,mixer,1349,3249,1900,2,00449,India
891270,2023-11-05,504,iron,449,879,430,2,00408,India
891270,2023-11-05,502,iphone 15 pro max,100000,135000,35000,2,00408,India
977414,2023-11-05,504,iron,449,879,430,2,00433,India
977414,2023-11-05,505,oven,18490,24000,5510,2,00433,India
977414,2023-11-05,502,iphone 15 pro max,100000,135000,35000,2,00433,India
463827,2023-11-05,504,iron,449,879,430,2,00203,India
463827,2023-11-05,505,oven,18490,24000,5510,2,00203,India
576789,2023-11-05,501,iphone 15,60000,80000,20000,2,00342,India
576789,2023-11-05,507,washing machine,6990,16490,9500,2,00342,India
576789,2023-11-05,505,oven,18490,24000,5510,2,00342,India
199832,2023-11-05,507,washing machine,6990,16490,9500,2,00446,India
199832,2023-11-05,505,oven,18490,24000,5510,2,00446,India
199832,2023-11-05,501,iphone 15,60000,80000,20000,2,00446,India
199832,2023-11-05,503,mixer,1349,3249,1900,2,00446,India
555306,2023-11-05,503,mixer,1349,3249,1900,2,00075,India
555306,2023-11-05,501,iphone 15,60000,80000,20000,2,00075,India
555306,2023-11-05,507,washing machine,6990,16490,9500,2,00075,India
130745,2023-11-05,502,iphone 15 pro max,100000,135000,35000,2,00453,India
130745,2023-11-05,507,washing machine,6990,16490,9500,2,00453,India
130745,2023-11-05,504,iron,449,879,430,2,00453,India
130745,2023-11-05,503,mixer,1349,3249,1900,2,00453,India
903228,2023-11-05,502,iphone 15 pro max,100000,135000,35000,2,00267,India
903228,2023-11-05,504,iron,449,879,430,2,00267,India
903228,2023-11-05,507,washing machine,6990,16490,9500,2,00267,India
776980,2023-11-05,501,iphone 15,60000,80000,20000,2,00082,India
776980,2023-11-05,507,washing machine,6990,16490,9500,2,00082,India
776980,2023-11-05,503,mixer,1349,3249,1900,2,00082,India
390755,2023-11-05,506,monitor,3249,8000,4751,2,00394,India
346352,2023-11-05,505,oven,18490,24000,5510,2,00175,India
346352,2023-11-05,502,iphone 15 pro max,100000,135000,35000,2,00175,India
346352,2023-11-05,504,iron,449,879,430,2,00175,India
547511,2023-11-05,507,washing machine,6990,16490,9500,2,00279,India
313044,2023-11-05,502,iphone 15 pro max,100000,135000,35000,2,00245,India
547386,2023-11-05,505,oven,18490,24000,5510,2,00335,India
547386,2023-11-05,502,iphone 15 pro max,100000,135000,35000,2,00335,India
547386,2023-11-05,504,iron,449,879,430,2,00335,India
764590,2023-11-05,503,mixer,1349,3249,1900,2,00379,India
146500,2023-11-05,501,iphone 15,60000,80000,20000,2,00284,India
146500,2023-11-05,504,iron,449,879,430,2,00284,India
146500,2023-11-05,502,iphone 15 pro max,100000,135000,35000,2,00284,India
551757,2023-11-05,503,mixer,1349,3249,1900,2,00175,India
551757,2023-11-05,505,oven,18490,24000,5510,2,00175,India
551757,2023-11-05,502,iphone 15 pro max,100000,135000,35000,2,00175,India
890169,2023-11-05,501,iphone 15,60000,80000,20000,2,00061,India
794456,2023-11-05,506,monitor,3249,8000,4751,2,00011,India
794456,2023-11-05,501,iphone 15,60000,80000,20000,2,00011,India
794456,2023-11-05,507,washing machine,6990,16490,9500,2,00011,India
463567,2023-11-05,501,iphone 15,60000,80000,20000,2,00394,India
463567,2023-11-05,505,oven,18490,24000,5510,2,00394,India
463567,2023-11-05,507,washing machine,6990,16490,9500,2,00394,India
962234,2023-11-05,501,iphone 15,60000,80000,20000,2,00384,India
247834,2023-11-05,505,oven,18490,24000,5510,2,00056,India
247834,2023-11-05,501,iphone 15,60000,80000,20000,2,00056,India
845755,2023-11-05,501,iphone 15,60000,80000,20000,2,00012,India
411286,2023-11-05,501,iphone 15,60000,80000,20000,2,00196,India
411286,2023-11-05,503,mixer,1349,3249,1900,2,00196,India
411286,2023-11-05,504,iron,449,879,430,2,00196,India
411286,2023-11-05,505,oven,18490,24000,5510,2,00196,India
523974,2023-11-05,502,iphone 15 pro max,100000,135000,35000,2,00208,India
523974,2023-11-05,505,oven,18490,24000,5510,2,00208,India
488601,2023-11-05,507,washing machine,6990,16490,9500,2,00234,India
488601,2023-11-05,505,oven,18490,24000,5510,2,00234,India
488601,2023-11-05,506,monitor,3249,8000,4751,2,00234,India
120626,2023-11-05,501,iphone 15,60000,80000,20000,2,00176,India
398245,2023-11-05,506,monitor,3249,8000,4751,2,00024,India
398245,2023-11-05,502,iphone 15 pro max,100000,135000,35000,2,00024,India
798565,2023-11-05,503,mixer,1349,3249,1900,2,00173,India
798565,2023-11-05,506,monitor,3249,8000,4751,2,00173,India
798565,2023-11-05,504,iron,449,879,430,2,00173,India
868680,2023-11-05,507,washing machine,6990,16490,9500,2,00010,India
868680,2023-11-05,501,iphone 15,60000,80000,20000,2,00010,India
868680,2023-11-05,504,iron,449,879,430,2,00010,India
804680,2023-11-05,501,iphone 15,60000,80000,20000,2,00021,India
804680,2023-11-05,503,mixer,1349,3249,1900,2,00021,India
804680,2023-11-05,505,oven,18490,24000,5510,2,00021,India
804680,2023-11-05,504,iron,449,879,430,2,00021,India
576235,2023-11-05,507,washing machine,6990,16490,9500,2,00298,India
576235,2023-11-05,504,iron,449,879,430,2,00298,India
975237,2023-11-05,502,iphone 15 pro max,100000,135000,35000,2,00229,India
975237,2023-11-05,507,washing machine,6990,16490,9500,2,00229,India
493094,2023-11-05,503,mixer,1349,3249,1900,2,00380,India
493094,2023-11-05,506,monitor,3249,8000,4751,2,00380,India
493094,2023-11-05,501,iphone 15,60000,80000,20000,2,00380,India
493094,2023-11-05,505,oven,18490,24000,5510,2,00380,India
477827,2023-11-05,505,oven,18490,24000,5510,2,00475,India
977709,2023-11-05,503,mixer,1349,3249,1900,2,00487,India
159059,2023-11-05,507,washing machine,6990,16490,9500,2,00339,India
159059,2023-11-05,506,monitor,3249,8000,4751,2,00339,India
529748,2023-11-05,505,oven,18490,24000,5510,2,00006,India
838594,2023-11-05,505,oven,18490,24000,5510,2,00253,India
838594,2023-11-05,506,monitor,3249,8000,4751,2,00253,India
838594,2023-11-05,507,washing machine,6990,16490,9500,2,00253,India
242705,2023-11-05,503,mixer,1349,3249,1900,2,00182,India
242705,2023-11-05,507,washing machine,6990,16490,9500,2,00182,India
879565,2023-11-05,506,monitor,3249,8000,4751,2,00304,India
796622,2023-11-05,505,oven,18490,24000,5510,2,00308,India
796622,2023-11-05,501,iphone 15,60000,80000,20000,2,00308,India
796622,2023-11-05,504,iron,449,879,430,2,00308,India
796622,2023-11-05,506,monitor,3249,8000,4751,2,00308,India
155664,2023-11-06,505,oven,18490,24000,5510,2,00476,India
155664,2023-11-06,502,iphone 15 pro max,100000,135000,35000,2,00476,India
155664,2023-11-06,507,washing machine,6990,16490,9500,2,00476,India
468667,2023-11-06,503,mixer,1349,3249,1900,2,00254,India
468667,2023-11-06,506,monitor,3249,8000,4751,2,00254,India
468667,2023-11-06,501,iphone 15,60000,80000,20000,2,00254,India
468667,2023-11-06,502,iphone 15 pro max,100000,135000,35000,2,00254,India
468667,2023-11-06,507,washing machine,6990,16490,9500,2,00254,India
599609,2023-11-06,503,mixer,1349,3249,1900,2,00127,India
599609,2023-11-06,505,oven,18490,24000,5510,2,00127,India
599609,2023-11-06,506,monitor,3249,8000,4751,2,00127,India
786590,2023-11-06,505,oven,18490,24000,5510,2,00483,India
786590,2023-11-06,503,mixer,1349,3249,1900,2,00483,India
786590,2023-11-06,504,iron,449,879,430,2,00483,India
220086,2023-11-06,501,iphone 15,60000,80000,20000,2,00103,India
220086,2023-11-06,505,oven,18490,24000,5510,2,00103,India
220086,2023-11-06,502,iphone 15 pro max,100000,135000,35000,2,00103,India
220086,2023-11-06,504,iron,449,879,430,2,00103,India
493067,2023-11-06,506,monitor,3249,8000,4751,2,00233,India
493067,2023-11-06,501,iphone 15,60000,80000,20000,2,00233,India
493067,2023-11-06,505,oven,18490,24000,5510,2,00233,India
379441,2023-11-06,502,iphone 15 pro max,100000,135000,35000,2,00057,India
697215,2023-11-06,505,oven,18490,24000,5510,2,00415,India
697215,2023-11-06,501,iphone 15,60000,80000,20000,2,00415,India
697215,2023-11-06,504,iron,449,879,430,2,00415,India
270555,2023-11-06,507,washing machine,6990,16490,9500,2,00288,India
270555,2023-11-06,502,iphone 15 pro max,100000,135000,35000,2,00288,India
513563,2023-11-06,503,mixer,1349,3249,1900,2,00182,India
513563,2023-11-06,506,monitor,3249,8000,4751,2,00182,India
513563,2023-11-06,507,washing machine,6990,16490,9500,2,00182,India
379271,2023-11-06,503,mixer,1349,3249,1900,2,00122,India
945252,2023-11-06,504,iron,449,879,430,2,00060,India
945252,2023-11-06,501,iphone 15,60000,80000,20000,2,00060,India
945252,2023-11-06,506,monitor,3249,8000,4751,2,00060,India
945252,2023-11-06,502,iphone 15 pro max,100000,135000,35000,2,00060,India
241410,2023-11-06,507,washing machine,6990,16490,9500,2,00255,India
241410,2023-11-06,503,mixer,1349,3249,1900,2,00255,India
609282,2023-11-06,504,iron,449,879,430,2,00258,India
609282,2023-11-06,502,iphone 15 pro max,100000,135000,35000,2,00258,India
609282,2023-11-06,505,oven,18490,24000,5510,2,00258,India
406299,2023-11-06,507,washing machine,6990,16490,9500,2,00228,India
406299,2023-11-06,502,iphone 15 pro max,100000,135000,35000,2,00228,India
829621,2023-11-06,506,monitor,3249,8000,4751,2,00182,India
829621,2023-11-06,505,oven,18490,24000,5510,2,00182,India
306391,2023-11-06,505,oven,18490,24000,5510,2,00036,India
306391,2023-11-06,501,iphone 15,60000,80000,20000,2,00036,India
151977,2023-11-06,506,monitor,3249,8000,4751,2,00292,India
151977,2023-11-06,504,iron,449,879,430,2,00292,India
102679,2023-11-06,505,oven,18490,24000,5510,2,00164,India
847212,2023-11-06,501,iphone 15,60000,80000,20000,2,00081,India
847212,2023-11-06,507,washing machine,6990,16490,9500,2,00081,India
508575,2023-11-06,507,washing machine,6990,16490,9500,2,00340,India
508575,2023-11-06,505,oven,18490,24000,5510,2,00340,India
508575,2023-11-06,501,iphone 15,60000,80000,20000,2,00340,India
508575,2023-11-06,504,iron,449,879,430,2,00340,India
500179,2023-11-06,506,monitor,3249,8000,4751,2,00491,India
310145,2023-11-06,502,iphone 15 pro max,100000,135000,35000,2,00485,India
310145,2023-11-06,507,washing machine,6990,16490,9500,2,00485,India
310145,2023-11-06,505,oven,18490,24000,5510,2,00485,India
310145,2023-11-06,506,monitor,3249,8000,4751,2,00485,India
383649,2023-11-06,504,iron,449,879,430,2,00035,India
383649,2023-11-06,502,iphone 15 pro max,100000,135000,35000,2,00035,India
383649,2023-11-06,501,iphone 15,60000,80000,20000,2,00035,India
366658,2023-11-06,505,oven,18490,24000,5510,2,00360,India
366658,2023-11-06,501,iphone 15,60000,80000,20000,2,00360,India
366658,2023-11-06,502,iphone 15 pro max,100000,135000,35000,2,00360,India
366658,2023-11-06,503,mixer,1349,3249,1900,2,00360,India
364792,2023-11-06,505,oven,18490,24000,5510,2,00101,India
364792,2023-11-06,502,iphone 15 pro max,100000,135000,35000,2,00101,India
364792,2023-11-06,506,monitor,3249,8000,4751,2,00101,India
705792,2023-11-06,503,mixer,1349,3249,1900,2,00023,India
325751,2023-11-06,501,iphone 15,60000,80000,20000,2,00107,India
325751,2023-11-06,504,iron,449,879,430,2,00107,India
325751,2023-11-06,507,washing machine,6990,16490,9500,2,00107,India
469876,2023-11-06,504,iron,449,879,430,2,00188,India
469876,2023-11-06,505,oven,18490,24000,5510,2,00188,India
997110,2023-11-06,502,iphone 15 pro max,100000,135000,35000,2,00310,India
997110,2023-11-06,506,monitor,3249,8000,4751,2,00310,India
506038,2023-11-06,502,iphone 15 pro max,100000,135000,35000,2,00318,India
506038,2023-11-06,507,washing machine,6990,16490,9500,2,00318,India
506038,2023-11-06,501,iphone 15,60000,80000,20000,2,00318,India
378357,2023-11-06,507,washing machine,6990,16490,9500,2,00467,India
934228,2023-11-06,505,oven,18490,24000,5510,2,00433,India
562961,2023-11-06,502,iphone 15 pro max,100000,135000,35000,2,00131,India
873055,2023-11-06,507,washing machine,6990,16490,9500,2,00270,India
873055,2023-11-06,504,iron,449,879,430,2,00270,India
447257,2023-11-06,502,iphone 15 pro max,100000,135000,35000,2,00303,India
447257,2023-11-06,504,iron,449,879,430,2,00303,India
447257,2023-11-06,506,monitor,3249,8000,4751,2,00303,India
758161,2023-11-06,505,oven,18490,24000,5510,2,00486,India
758161,2023-11-06,502,iphone 15 pro max,100000,135000,35000,2,00486,India
758161,2023-11-06,507,washing machine,6990,16490,9500,2,00486,India
758161,2023-11-06,504,iron,449,879,430,2,00486,India
693490,2023-11-06,504,iron,449,879,430,2,00328,India
693490,2023-11-06,501,iphone 15,60000,80000,20000,2,00328,India
693490,2023-11-06,506,monitor,3249,8000,4751,2,00328,India
293028,2023-11-06,503,mixer,1349,3249,1900,2,00490,India
293028,2023-11-06,507,washing machine,6990,16490,9500,2,00490,India
293028,2023-11-06,501,iphone 15,60000,80000,20000,2,00490,India
957418,2023-11-06,503,mixer,1349,3249,1900,2,00318,India
957418,2023-11-06,505,oven,18490,24000,5510,2,00318,India
455413,2023-11-06,501,iphone 15,60000,80000,20000,2,00463,India
455413,2023-11-06,503,mixer,1349,3249,1900,2,00463,India
455413,2023-11-06,506,monitor,3249,8000,4751,2,00463,India
455413,2023-11-06,507,washing machine,6990,16490,9500,2,00463,India
844894,2023-11-06,507,washing machine,6990,16490,9500,2,00131,India
165465,2023-11-06,504,iron,449,879,430,2,00272,India
165465,2023-11-06,505,oven,18490,24000,5510,2,00272,India
314630,2023-11-06,503,mixer,1349,3249,1900,2,00229,India
314630,2023-11-06,502,iphone 15 pro max,100000,135000,35000,2,00229,India
889937,2023-11-06,502,iphone 15 pro max,100000,135000,35000,2,00209,India
360246,2023-11-06,507,washing machine,6990,16490,9500,2,00440,India
287889,2023-11-06,503,mixer,1349,3249,1900,2,00381,India
287889,2023-11-06,507,washing machine,6990,16490,9500,2,00381,India
474430,2023-11-06,503,mixer,1349,3249,1900,2,00156,India
474430,2023-11-06,501,iphone 15,60000,80000,20000,2,00156,India
474430,2023-11-06,502,iphone 15 pro max,100000,135000,35000,2,00156,India
952522,2023-11-06,504,iron,449,879,430,2,00420,India
952522,2023-11-06,506,monitor,3249,8000,4751,2,00420,India
952522,2023-11-06,502,iphone 15 pro max,100000,135000,35000,2,00420,India
952522,2023-11-06,501,iphone 15,60000,80000,20000,2,00420,India
879634,2023-11-06,503,mixer,1349,3249,1900,2,00242,India
969527,2023-11-06,503,mixer,1349,3249,1900,2,00192,India
969527,2023-11-06,502,iphone 15 pro max,100000,135000,35000,2,00192,India
943757,2023-11-06,502,iphone 15 pro max,100000,135000,35000,2,00291,India
943757,2023-11-06,507,washing machine,6990,16490,9500,2,00291,India
943757,2023-11-06,501,iphone 15,60000,80000,20000,2,00291,India
201132,2023-11-07,505,oven,18490,24000,5510,2,00212,India
201132,2023-11-07,507,washing machine,6990,16490,9500,2,00212,India
495704,2023-11-07,504,iron,449,879,430,2,00346,India
495704,2023-11-07,505,oven,18490,24000,5510,2,00346,India
495704,2023-11-07,507,washing machine,6990,16490,9500,2,00346,India
495704,2023-11-07,506,monitor,3249,8000,4751,2,00346,India
556120,2023-11-07,501,iphone 15,60000,80000,20000,2,00004,India
556120,2023-11-07,502,iphone 15 pro max,100000,135000,35000,2,00004,India
556120,2023-11-07,507,washing machine,6990,16490,9500,2,00004,India
169410,2023-11-07,503,mixer,1349,3249,1900,2,00428,India
169410,2023-11-07,502,iphone 15 pro max,100000,135000,35000,2,00428,India
796976,2023-11-07,504,iron,449,879,430,2,00430,India
796976,2023-11-07,505,oven,18490,24000,5510,2,00430,India
796976,2023-11-07,507,washing machine,6990,16490,9500,2,00430,India
796976,2023-11-07,502,iphone 15 pro max,100000,135000,35000,2,00430,India
320368,2023-11-07,507,washing machine,6990,16490,9500,2,00101,India
320368,2023-11-07,501,iphone 15,60000,80000,20000,2,00101,India
320368,2023-11-07,504,iron,449,879,430,2,00101,India
112101,2023-11-07,502,iphone 15 pro max,100000,135000,35000,2,00244,India
112101,2023-11-07,506,monitor,3249,8000,4751,2,00244,India
112101,2023-11-07,503,mixer,1349,3249,1900,2,00244,India
112101,2023-11-07,505,oven,18490,24000,5510,2,00244,India
784715,2023-11-07,506,monitor,3249,8000,4751,2,00237,India
784715,2023-11-07,507,washing machine,6990,16490,9500,2,00237,India
784715,2023-11-07,505,oven,18490,24000,5510,2,00237,India
315786,2023-11-07,501,iphone 15,60000,80000,20000,2,00494,India
315786,2023-11-07,503,mixer,1349,3249,1900,2,00494,India
315786,2023-11-07,507,washing machine,6990,16490,9500,2,00494,India
315786,2023-11-07,505,oven,18490,24000,5510,2,00494,India
150495,2023-11-07,501,iphone 15,60000,80000,20000,2,00351,India
150495,2023-11-07,502,iphone 15 pro max,100000,135000,35000,2,00351,India
150495,2023-11-07,504,iron,449,879,430,2,00351,India
115436,2023-11-07,505,oven,18490,24000,5510,2,00311,India
917612,2023-11-07,502,iphone 15 pro max,100000,135000,35000,2,00229,India
917612,2023-11-07,501,iphone 15,60000,80000,20000,2,00229,India
917612,2023-11-07,507,washing machine,6990,16490,9500,2,00229,India
411841,2023-11-07,502,iphone 15 pro max,100000,135000,35000,2,00030,India
411841,2023-11-07,501,iphone 15,60000,80000,20000,2,00030,India
938900,2023-11-07,506,monitor,3249,8000,4751,2,00320,India
938900,2023-11-07,507,washing machine,6990,16490,9500,2,00320,India
893026,2023-11-07,505,oven,18490,24000,5510,2,00447,India
893026,2023-11-07,507,washing machine,6990,16490,9500,2,00447,India
893026,2023-11-07,502,iphone 15 pro max,100000,135000,35000,2,00447,India
535601,2023-11-07,505,oven,18490,24000,5510,2,00026,India
789728,2023-11-07,502,iphone 15 pro max,100000,135000,35000,2,00177,India
789728,2023-11-07,506,monitor,3249,8000,4751,2,00177,India
789728,2023-11-07,501,iphone 15,60000,80000,20000,2,00177,India
486022,2023-11-07,503,mixer,1349,3249,1900,2,00075,India
486022,2023-11-07,507,washing machine,6990,16490,9500,2,00075,India
138939,2023-11-07,501,iphone 15,60000,80000,20000,2,00321,India
138939,2023-11-07,503,mixer,1349,3249,1900,2,00321,India
138939,2023-11-07,506,monitor,3249,8000,4751,2,00321,India
204907,2023-11-07,507,washing machine,6990,16490,9500,2,00343,India
313748,2023-11-07,503,mixer,1349,3249,1900,2,00055,India
313748,2023-11-07,502,iphone 15 pro max,100000,135000,35000,2,00055,India
764201,2023-11-07,504,iron,449,879,430,2,00054,India
764201,2023-11-07,501,iphone 15,60000,80000,20000,2,00054,India
764201,2023-11-07,502,iphone 15 pro max,100000,135000,35000,2,00054,India
764201,2023-11-07,503,mixer,1349,3249,1900,2,00054,India
895724,2023-11-07,506,monitor,3249,8000,4751,2,00210,India
298447,2023-11-07,506,monitor,3249,8000,4751,2,00385,India
298447,2023-11-07,504,iron,449,879,430,2,00385,India
298447,2023-11-07,505,oven,18490,24000,5510,2,00385,India
603140,2023-11-07,504,iron,449,879,430,2,00483,India
603140,2023-11-07,506,monitor,3249,8000,4751,2,00483,India
603140,2023-11-07,505,oven,18490,24000,5510,2,00483,India
603140,2023-11-07,502,iphone 15 pro max,100000,135000,35000,2,00483,India
729084,2023-11-07,504,iron,449,879,430,2,00132,India
670381,2023-11-07,506,monitor,3249,8000,4751,2,00364,India
670381,2023-11-07,504,iron,449,879,430,2,00364,India
368544,2023-11-07,505,oven,18490,24000,5510,2,00304,India
367967,2023-11-07,507,washing machine,6990,16490,9500,2,00101,India
367967,2023-11-07,501,iphone 15,60000,80000,20000,2,00101,India
367967,2023-11-07,504,iron,449,879,430,2,00101,India
367967,2023-11-07,502,iphone 15 pro max,100000,135000,35000,2,00101,India
646249,2023-11-07,505,oven,18490,24000,5510,2,00254,India
646249,2023-11-07,502,iphone 15 pro max,100000,135000,35000,2,00254,India
646249,2023-11-07,507,washing machine,6990,16490,9500,2,00254,India
295729,2023-11-07,505,oven,18490,24000,5510,2,00167,India
295729,2023-11-07,501,iphone 15,60000,80000,20000,2,00167,India
158949,2023-11-07,507,washing machine,6990,16490,9500,2,00135,India
158949,2023-11-07,504,iron,449,879,430,2,00135,India
765342,2023-11-07,507,washing machine,6990,16490,9500,2,00118,India
850350,2023-11-07,504,iron,449,879,430,2,00337,India
850350,2023-11-07,507,washing machine,6990,16490,9500,2,00337,India
981092,2023-11-07,505,oven,18490,24000,5510,2,00105,India
981092,2023-11-07,502,iphone 15 pro max,100000,135000,35000,2,00105,India
981092,2023-11-07,501,iphone 15,60000,80000,20000,2,00105,India
329159,2023-11-07,505,oven,18490,24000,5510,2,00109,India
266710,2023-11-07,505,oven,18490,24000,5510,2,00222,India
819303,2023-11-07,504,iron,449,879,430,2,00164,India
819303,2023-11-07,503,mixer,1349,3249,1900,2,00164,India
819303,2023-11-07,506,monitor,3249,8000,4751,2,00164,India
819303,2023-11-07,505,oven,18490,24000,5510,2,00164,India
566271,2023-11-07,502,iphone 15 pro max,100000,135000,35000,2,00084,India
566271,2023-11-07,503,mixer,1349,3249,1900,2,00084,India
425524,2023-11-07,506,monitor,3249,8000,4751,2,00364,India
425524,2023-11-07,503,mixer,1349,3249,1900,2,00364,India
114801,2023-11-07,503,mixer,1349,3249,1900,2,00412,India
114801,2023-11-07,504,iron,449,879,430,2,00412,India
114801,2023-11-07,501,iphone 15,60000,80000,20000,2,00412,India
683600,2023-11-07,504,iron,449,879,430,2,00082,India
689546,2023-11-07,505,oven,18490,24000,5510,2,00448,India
257792,2023-11-07,502,iphone 15 pro max,100000,135000,35000,2,00472,India
793081,2023-11-07,507,washing machine,6990,16490,9500,2,00148,India
793081,2023-11-07,506,monitor,3249,8000,4751,2,00148,India
251819,2023-11-07,504,iron,449,879,430,2,00088,India
251819,2023-11-07,503,mixer,1349,3249,1900,2,00088,India
362047,2023-11-07,503,mixer,1349,3249,1900,2,00146,India
362047,2023-11-07,506,monitor,3249,8000,4751,2,00146,India
362047,2023-11-07,507,washing machine,6990,16490,9500,2,00146,India
362047,2023-11-07,502,iphone 15 pro max,100000,135000,35000,2,00146,India
362047,2023-11-07,501,iphone 15,60000,80000,20000,2,00146,India
813185,2023-11-07,506,monitor,3249,8000,4751,2,00006,India
824721,2023-11-07,505,oven,18490,24000,5510,2,00442,India
824721,2023-11-07,504,iron,449,879,430,2,00442,India
824721,2023-11-07,502,iphone 15 pro max,100000,135000,35000,2,00442,India
714680,2023-11-07,505,oven,18490,24000,5510,2,00416,India
714680,2023-11-07,504,iron,449,879,430,2,00416,India
714680,2023-11-07,506,monitor,3249,8000,4751,2,00416,India
520913,2023-11-07,507,washing machine,6990,16490,9500,2,00485,India
520913,2023-11-07,502,iphone 15 pro max,100000,135000,35000,2,00485,India
520913,2023-11-07,505,oven,18490,24000,5510,2,00485,India
520913,2023-11-07,506,monitor,3249,8000,4751,2,00485,India
806668,2023-11-07,507,washing machine,6990,16490,9500,2,00131,India
806668,2023-11-07,504,iron,449,879,430,2,00131,India
806668,2023-11-07,505,oven,18490,24000,5510,2,00131,India
145655,2023-11-07,501,iphone 15,60000,80000,20000,2,00058,India
145655,2023-11-07,504,iron,449,879,430,2,00058,India
989322,2023-11-07,507,washing machine,6990,16490,9500,2,00328,India
596837,2023-11-07,501,iphone 15,60000,80000,20000,2,00180,India
596837,2023-11-07,502,iphone 15 pro max,100000,135000,35000,2,00180,India
596837,2023-11-07,503,mixer,1349,3249,1900,2,00180,India
596837,2023-11-07,505,oven,18490,24000,5510,2,00180,India
596837,2023-11-07,504,iron,449,879,430,2,00180,India
807001,2023-11-07,503,mixer,1349,3249,1900,2,00241,India
807001,2023-11-07,505,oven,18490,24000,5510,2,00241,India
807001,2023-11-07,501,iphone 15,60000,80000,20000,2,00241,India
360349,2023-11-07,501,iphone 15,60000,80000,20000,2,00181,India
360349,2023-11-07,505,oven,18490,24000,5510,2,00181,India
360349,2023-11-07,502,iphone 15 pro max,100000,135000,35000,2,00181,India
572462,2023-11-07,501,iphone 15,60000,80000,20000,2,00332,India
572462,2023-11-07,507,washing machine,6990,16490,9500,2,00332,India
572462,2023-11-07,505,oven,18490,24000,5510,2,00332,India
128005,2023-11-07,501,iphone 15,60000,80000,20000,2,00280,India
128005,2023-11-07,507,washing machine,6990,16490,9500,2,00280,India
337679,2023-11-07,505,oven,18490,24000,5510,2,00449,India
337679,2023-11-07,504,iron,449,879,430,2,00449,India
337679,2023-11-07,501,iphone 15,60000,80000,20000,2,00449,India
337679,2023-11-07,507,washing machine,6990,16490,9500,2,00449,India
239342,2023-11-07,506,monitor,3249,8000,4751,2,00455,India
239342,2023-11-07,502,iphone 15 pro max,100000,135000,35000,2,00455,India
239342,2023-11-07,505,oven,18490,24000,5510,2,00455,India
219072,2023-11-07,507,washing machine,6990,16490,9500,2,00388,India
219072,2023-11-07,502,iphone 15 pro max,100000,135000,35000,2,00388,India
219072,2023-11-07,505,oven,18490,24000,5510,2,00388,India
841844,2023-11-07,501,iphone 15,60000,80000,20000,2,00245,India
621373,2023-11-07,505,oven,18490,24000,5510,2,00060,India
621373,2023-11-07,503,mixer,1349,3249,1900,2,00060,India
621373,2023-11-07,502,iphone 15 pro max,100000,135000,35000,2,00060,India
562097,2023-11-07,502,iphone 15 pro max,100000,135000,35000,2,00359,India
562097,2023-11-07,505,oven,18490,24000,5510,2,00359,India
562097,2023-11-07,504,iron,449,879,430,2,00359,India
562097,2023-11-07,503,mixer,1349,3249,1900,2,00359,India
803593,2023-11-07,501,iphone 15,60000,80000,20000,2,00352,India
803593,2023-11-07,504,iron,449,879,430,2,00352,India
630461,2023-11-07,505,oven,18490,24000,5510,2,00094,India
630461,2023-11-07,502,iphone 15 pro max,100000,135000,35000,2,00094,India
630461,2023-11-07,506,monitor,3249,8000,4751,2,00094,India
668749,2023-11-07,503,mixer,1349,3249,1900,2,00393,India
668749,2023-11-07,502,iphone 15 pro max,100000,135000,35000,2,00393,India
668749,2023-11-07,505,oven,18490,24000,5510,2,00393,India
863799,2023-11-07,507,washing machine,6990,16490,9500,2,00091,India
863799,2023-11-07,506,monitor,3249,8000,4751,2,00091,India
272942,2023-11-07,507,washing machine,6990,16490,9500,2,00246,India
272942,2023-11-07,505,oven,18490,24000,5510,2,00246,India
272942,2023-11-07,504,iron,449,879,430,2,00246,India
632937,2023-11-07,502,iphone 15 pro max,100000,135000,35000,2,00012,India
632937,2023-11-07,507,washing machine,6990,16490,9500,2,00012,India
632937,2023-11-07,503,mixer,1349,3249,1900,2,00012,India
632937,2023-11-07,506,monitor,3249,8000,4751,2,00012,India
935947,2023-11-07,504,iron,449,879,430,2,00306,India
935947,2023-11-07,505,oven,18490,24000,5510,2,00306,India
133774,2023-11-07,501,iphone 15,60000,80000,20000,2,00124,India
133774,2023-11-07,502,iphone 15 pro max,100000,135000,35000,2,00124,India
100265,2023-11-07,502,iphone 15 pro max,100000,135000,35000,2,00251,India
100265,2023-11-07,501,iphone 15,60000,80000,20000,2,00251,India
100265,2023-11-07,503,mixer,1349,3249,1900,2,00251,India
100265,2023-11-07,506,monitor,3249,8000,4751,2,00251,India
251461,2023-11-07,503,mixer,1349,3249,1900,2,00415,India
251461,2023-11-07,505,oven,18490,24000,5510,2,00415,India
141223,2023-11-07,504,iron,449,879,430,2,00395,India
141223,2023-11-07,501,iphone 15,60000,80000,20000,2,00395,India
632153,2023-11-07,507,washing machine,6990,16490,9500,2,00158,India
632153,2023-11-07,502,iphone 15 pro max,100000,135000,35000,2,00158,India
665877,2023-11-07,506,monitor,3249,8000,4751,2,00404,India
665877,2023-11-07,502,iphone 15 pro max,100000,135000,35000,2,00404,India
983240,2023-11-07,506,monitor,3249,8000,4751,2,00070,India
983240,2023-11-07,504,iron,449,879,430,2,00070,India
983240,2023-11-07,505,oven,18490,24000,5510,2,00070,India
983240,2023-11-07,502,iphone 15 pro max,100000,135000,35000,2,00070,India
983240,2023-11-07,503,mixer,1349,3249,1900,2,00070,India
672278,2023-11-07,501,iphone 15,60000,80000,20000,2,00307,India
672278,2023-11-07,506,monitor,3249,8000,4751,2,00307,India
672278,2023-11-07,505,oven,18490,24000,5510,2,00307,India
672278,2023-11-07,504,iron,449,879,430,2,00307,India
893787,2023-11-07,507,washing machine,6990,16490,9500,2,00209,India
893787,2023-11-07,506,monitor,3249,8000,4751,2,00209,India
200362,2023-11-07,504,iron,449,879,430,2,00412,India
200362,2023-11-07,505,oven,18490,24000,5510,2,00412,India
130813,2023-11-07,501,iphone 15,60000,80000,20000,2,00031,India
130813,2023-11-07,507,washing machine,6990,16490,9500,2,00031,India
130813,2023-11-07,504,iron,449,879,430,2,00031,India
764018,2023-11-07,507,washing machine,6990,16490,9500,2,00448,India
764018,2023-11-07,501,iphone 15,60000,80000,20000,2,00448,India
764018,2023-11-07,505,oven,18490,24000,5510,2,00448,India
764018,2023-11-07,502,iphone 15 pro max,100000,135000,35000,2,00448,India
863178,2023-11-07,506,monitor,3249,8000,4751,2,00110,India
863178,2023-11-07,504,iron,449,879,430,2,00110,India
931359,2023-11-07,503,mixer,1349,3249,1900,2,00091,India
931359,2023-11-07,501,iphone 15,60000,80000,20000,2,00091,India
827935,2023-11-07,502,iphone 15 pro max,100000,135000,35000,2,00347,India
410526,2023-11-08,506,monitor,3249,8000,4751,2,00062,India
410526,2023-11-08,507,washing machine,6990,16490,9500,2,00062,India
851335,2023-11-08,504,iron,449,879,430,2,00118,India
851335,2023-11-08,502,iphone 15 pro max,100000,135000,35000,2,00118,India
851335,2023-11-08,501,iphone 15,60000,80000,20000,2,00118,India
851335,2023-11-08,505,oven,18490,24000,5510,2,00118,India
805561,2023-11-08,503,mixer,1349,3249,1900,2,00488,India
805561,2023-11-08,502,iphone 15 pro max,100000,135000,35000,2,00488,India
805561,2023-11-08,507,washing machine,6990,16490,9500,2,00488,India
805561,2023-11-08,504,iron,449,879,430,2,00488,India
860417,2023-11-08,504,iron,449,879,430,2,00331,India
860417,2023-11-08,507,washing machine,6990,16490,9500,2,00331,India
860417,2023-11-08,503,mixer,1349,3249,1900,2,00331,India
860417,2023-11-08,506,monitor,3249,8000,4751,2,00331,India
860417,2023-11-08,505,oven,18490,24000,5510,2,00331,India
799074,2023-11-08,507,washing machine,6990,16490,9500,2,00132,India
799074,2023-11-08,504,iron,449,879,430,2,00132,India
143229,2023-11-08,501,iphone 15,60000,80000,20000,2,00405,India
143229,2023-11-08,502,iphone 15 pro max,100000,135000,35000,2,00405,India
633439,2023-11-08,504,iron,449,879,430,2,00263,India
523688,2023-11-08,503,mixer,1349,3249,1900,2,00294,India
523688,2023-11-08,506,monitor,3249,8000,4751,2,00294,India
523688,2023-11-08,501,iphone 15,60000,80000,20000,2,00294,India
523688,2023-11-08,504,iron,449,879,430,2,00294,India
523688,2023-11-08,507,washing machine,6990,16490,9500,2,00294,India
282116,2023-11-08,506,monitor,3249,8000,4751,2,00098,India
282116,2023-11-08,503,mixer,1349,3249,1900,2,00098,India
786269,2023-11-08,505,oven,18490,24000,5510,2,00347,India
786269,2023-11-08,507,washing machine,6990,16490,9500,2,00347,India
167095,2023-11-08,503,mixer,1349,3249,1900,2,00487,India
167095,2023-11-08,501,iphone 15,60000,80000,20000,2,00487,India
167095,2023-11-08,504,iron,449,879,430,2,00487,India
601370,2023-11-08,504,iron,449,879,430,2,00142,India
492336,2023-11-08,507,washing machine,6990,16490,9500,2,00118,India
492336,2023-11-08,501,iphone 15,60000,80000,20000,2,00118,India
331831,2023-11-08,507,washing machine,6990,16490,9500,2,00499,India
342698,2023-11-08,504,iron,449,879,430,2,00419,India
832585,2023-11-08,505,oven,18490,24000,5510,2,00077,India
832585,2023-11-08,506,monitor,3249,8000,4751,2,00077,India
730472,2023-11-08,502,iphone 15 pro max,100000,135000,35000,2,00216,India
730472,2023-11-08,506,monitor,3249,8000,4751,2,00216,India
730472,2023-11-08,504,iron,449,879,430,2,00216,India
208060,2023-11-08,506,monitor,3249,8000,4751,2,00489,India
208060,2023-11-08,503,mixer,1349,3249,1900,2,00489,India
208060,2023-11-08,507,washing machine,6990,16490,9500,2,00489,India
382443,2023-11-08,504,iron,449,879,430,2,00150,India
382443,2023-11-08,505,oven,18490,24000,5510,2,00150,India
382443,2023-11-08,506,monitor,3249,8000,4751,2,00150,India
168342,2023-11-08,506,monitor,3249,8000,4751,2,00005,India
168342,2023-11-08,503,mixer,1349,3249,1900,2,00005,India
168342,2023-11-08,501,iphone 15,60000,80000,20000,2,00005,India
168342,2023-11-08,507,washing machine,6990,16490,9500,2,00005,India
168342,2023-11-08,505,oven,18490,24000,5510,2,00005,India
681597,2023-11-08,506,monitor,3249,8000,4751,2,00408,India
681597,2023-11-08,505,oven,18490,24000,5510,2,00408,India
681597,2023-11-08,501,iphone 15,60000,80000,20000,2,00408,India
824523,2023-11-08,504,iron,449,879,430,2,00074,India
824523,2023-11-08,507,washing machine,6990,16490,9500,2,00074,India
824523,2023-11-08,501,iphone 15,60000,80000,20000,2,00074,India
711380,2023-11-08,504,iron,449,879,430,2,00061,India
409427,2023-11-08,502,iphone 15 pro max,100000,135000,35000,2,00473,India
668295,2023-11-08,503,mixer,1349,3249,1900,2,00069,India
668295,2023-11-08,505,oven,18490,24000,5510,2,00069,India
655112,2023-11-08,506,monitor,3249,8000,4751,2,00036,India
655112,2023-11-08,507,washing machine,6990,16490,9500,2,00036,India
655112,2023-11-08,502,iphone 15 pro max,100000,135000,35000,2,00036,India
668316,2023-11-08,506,monitor,3249,8000,4751,2,00008,India
668316,2023-11-08,505,oven,18490,24000,5510,2,00008,India
668316,2023-11-08,503,mixer,1349,3249,1900,2,00008,India
668316,2023-11-08,507,washing machine,6990,16490,9500,2,00008,India
876187,2023-11-08,503,mixer,1349,3249,1900,2,00369,India
876187,2023-11-08,506,monitor,3249,8000,4751,2,00369,India
775447,2023-11-08,506,monitor,3249,8000,4751,2,00136,India
775447,2023-11-08,505,oven,18490,24000,5510,2,00136,India
775447,2023-11-08,503,mixer,1349,3249,1900,2,00136,India
114175,2023-11-08,501,iphone 15,60000,80000,20000,2,00203,India
774929,2023-11-08,501,iphone 15,60000,80000,20000,2,00327,India
363807,2023-11-08,502,iphone 15 pro max,100000,135000,35000,2,00193,India
363807,2023-11-08,501,iphone 15,60000,80000,20000,2,00193,India
389008,2023-11-08,502,iphone 15 pro max,100000,135000,35000,2,00359,India
389008,2023-11-08,505,oven,18490,24000,5510,2,00359,India
389008,2023-11-08,503,mixer,1349,3249,1900,2,00359,India
389008,2023-11-08,501,iphone 15,60000,80000,20000,2,00359,India
389008,2023-11-08,506,monitor,3249,8000,4751,2,00359,India
106268,2023-11-08,503,mixer,1349,3249,1900,2,00166,India
106268,2023-11-08,505,oven,18490,24000,5510,2,00166,India
106268,2023-11-08,504,iron,449,879,430,2,00166,India
781138,2023-11-08,505,oven,18490,24000,5510,2,00113,India
204619,2023-11-08,507,washing machine,6990,16490,9500,2,00328,India
204619,2023-11-08,501,iphone 15,60000,80000,20000,2,00328,India
204619,2023-11-08,505,oven,18490,24000,5510,2,00328,India
444664,2023-11-08,506,monitor,3249,8000,4751,2,00217,India
444664,2023-11-08,503,mixer,1349,3249,1900,2,00217,India
340726,2023-11-08,502,iphone 15 pro max,100000,135000,35000,2,00359,India
340726,2023-11-08,501,iphone 15,60000,80000,20000,2,00359,India
340726,2023-11-08,507,washing machine,6990,16490,9500,2,00359,India
340726,2023-11-08,506,monitor,3249,8000,4751,2,00359,India
337721,2023-11-08,503,mixer,1349,3249,1900,2,00325,India
337721,2023-11-08,504,iron,449,879,430,2,00325,India
337721,2023-11-08,505,oven,18490,24000,5510,2,00325,India
337721,2023-11-08,507,washing machine,6990,16490,9500,2,00325,India
129064,2023-11-08,501,iphone 15,60000,80000,20000,2,00158,India
129064,2023-11-08,507,washing machine,6990,16490,9500,2,00158,India
481728,2023-11-08,504,iron,449,879,430,2,00093,India
481728,2023-11-08,507,washing machine,6990,16490,9500,2,00093,India
481728,2023-11-08,503,mixer,1349,3249,1900,2,00093,India
481728,2023-11-08,502,iphone 15 pro max,100000,135000,35000,2,00093,India
464270,2023-11-08,504,iron,449,879,430,2,00018,India
464270,2023-11-08,507,washing machine,6990,16490,9500,2,00018,India
464270,2023-11-08,501,iphone 15,60000,80000,20000,2,00018,India
874860,2023-11-08,504,iron,449,879,430,2,00169,India
961422,2023-11-08,501,iphone 15,60000,80000,20000,2,00262,India
961422,2023-11-08,503,mixer,1349,3249,1900,2,00262,India
571772,2023-11-08,505,oven,18490,24000,5510,2,00498,India
571772,2023-11-08,506,monitor,3249,8000,4751,2,00498,India
571772,2023-11-08,503,mixer,1349,3249,1900,2,00498,India
540446,2023-11-08,502,iphone 15 pro max,100000,135000,35000,2,00276,India
540446,2023-11-08,506,monitor,3249,8000,4751,2,00276,India
540446,2023-11-08,504,iron,449,879,430,2,00276,India
429320,2023-11-08,506,monitor,3249,8000,4751,2,00209,India
429320,2023-11-08,504,iron,449,879,430,2,00209,India
429320,2023-11-08,505,oven,18490,24000,5510,2,00209,India
466179,2023-11-08,507,washing machine,6990,16490,9500,2,00343,India
466179,2023-11-08,502,iphone 15 pro max,100000,135000,35000,2,00343,India
466179,2023-11-08,506,monitor,3249,8000,4751,2,00343,India
102456,2023-11-08,501,iphone 15,60000,80000,20000,2,00467,India
753685,2023-11-08,501,iphone 15,60000,80000,20000,2,00131,India
753685,2023-11-08,504,iron,449,879,430,2,00131,India
597594,2023-11-08,507,washing machine,6990,16490,9500,2,00201,India
675540,2023-11-08,504,iron,449,879,430,2,00427,India
675540,2023-11-08,503,mixer,1349,3249,1900,2,00427,India
675540,2023-11-08,507,washing machine,6990,16490,9500,2,00427,India
129616,2023-11-08,502,iphone 15 pro max,100000,135000,35000,2,00139,India
129616,2023-11-08,507,washing machine,6990,16490,9500,2,00139,India
895853,2023-11-08,504,iron,449,879,430,2,00094,India
895853,2023-11-08,501,iphone 15,60000,80000,20000,2,00094,India
895853,2023-11-08,506,monitor,3249,8000,4751,2,00094,India
702718,2023-11-08,506,monitor,3249,8000,4751,2,00255,India
404684,2023-11-08,507,washing machine,6990,16490,9500,2,00094,India
404684,2023-11-08,505,oven,18490,24000,5510,2,00094,India
824367,2023-11-08,507,washing machine,6990,16490,9500,2,00235,India
824367,2023-11-08,503,mixer,1349,3249,1900,2,00235,India
824367,2023-11-08,505,oven,18490,24000,5510,2,00235,India
824367,2023-11-08,501,iphone 15,60000,80000,20000,2,00235,India
980930,2023-11-08,501,iphone 15,60000,80000,20000,2,00234,India
980930,2023-11-08,504,iron,449,879,430,2,00234,India
360702,2023-11-08,504,iron,449,879,430,2,00013,India
360702,2023-11-08,503,mixer,1349,3249,1900,2,00013,India
360702,2023-11-08,507,washing machine,6990,16490,9500,2,00013,India
360702,2023-11-08,501,iphone 15,60000,80000,20000,2,00013,India
711049,2023-11-08,502,iphone 15 pro max,100000,135000,35000,2,00131,India
253388,2023-11-08,505,oven,18490,24000,5510,2,00444,India
253388,2023-11-08,504,iron,449,879,430,2,00444,India
253388,2023-11-08,502,iphone 15 pro max,100000,135000,35000,2,00444,India
163167,2023-11-08,502,iphone 15 pro max,100000,135000,35000,2,00459,India
163167,2023-11-08,505,oven,18490,24000,5510,2,00459,India
292170,2023-11-08,504,iron,449,879,430,2,00177,India
292170,2023-11-08,502,iphone 15 pro max,100000,135000,35000,2,00177,India
610756,2023-11-08,503,mixer,1349,3249,1900,2,00200,India
610756,2023-11-08,504,iron,449,879,430,2,00200,India
103983,2023-11-08,503,mixer,1349,3249,1900,2,00110,India
103983,2023-11-08,506,monitor,3249,8000,4751,2,00110,India
128493,2023-11-08,505,oven,18490,24000,5510,2,00357,India
128493,2023-11-08,507,washing machine,6990,16490,9500,2,00357,India
128493,2023-11-08,501,iphone 15,60000,80000,20000,2,00357,India
552400,2023-11-08,503,mixer,1349,3249,1900,2,00293,India
624906,2023-11-08,501,iphone 15,60000,80000,20000,2,00399,India
624906,2023-11-08,504,iron,449,879,430,2,00399,India
982323,2023-11-09,501,iphone 15,60000,80000,20000,2,00114,India
982323,2023-11-09,507,washing machine,6990,16490,9500,2,00114,India
982323,2023-11-09,503,mixer,1349,3249,1900,2,00114,India
982323,2023-11-09,504,iron,449,879,430,2,00114,India
458262,2023-11-09,502,iphone 15 pro max,100000,135000,35000,2,00496,India
458262,2023-11-09,505,oven,18490,24000,5510,2,00496,India
458262,2023-11-09,507,washing machine,6990,16490,9500,2,00496,India
458262,2023-11-09,504,iron,449,879,430,2,00496,India
544129,2023-11-09,506,monitor,3249,8000,4751,2,00131,India
639864,2023-11-09,503,mixer,1349,3249,1900,2,00297,India
639864,2023-11-09,505,oven,18490,24000,5510,2,00297,India
570098,2023-11-09,505,oven,18490,24000,5510,2,00139,India
570098,2023-11-09,507,washing machine,6990,16490,9500,2,00139,India
707693,2023-11-09,503,mixer,1349,3249,1900,2,00010,India
192085,2023-11-09,502,iphone 15 pro max,100000,135000,35000,2,00334,India
192085,2023-11-09,503,mixer,1349,3249,1900,2,00334,India
626664,2023-11-09,506,monitor,3249,8000,4751,2,00246,India
626664,2023-11-09,501,iphone 15,60000,80000,20000,2,00246,India
735547,2023-11-09,503,mixer,1349,3249,1900,2,00109,India
686061,2023-11-09,502,iphone 15 pro max,100000,135000,35000,2,00252,India
686061,2023-11-09,506,monitor,3249,8000,4751,2,00252,India
686061,2023-11-09,505,oven,18490,24000,5510,2,00252,India
157892,2023-11-09,502,iphone 15 pro max,100000,135000,35000,2,00460,India
157892,2023-11-09,504,iron,449,879,430,2,00460,India
157892,2023-11-09,501,iphone 15,60000,80000,20000,2,00460,India
157892,2023-11-09,505,oven,18490,24000,5510,2,00460,India
928803,2023-11-09,501,iphone 15,60000,80000,20000,2,00105,India
928803,2023-11-09,505,oven,18490,24000,5510,2,00105,India
928803,2023-11-09,504,iron,449,879,430,2,00105,India
928803,2023-11-09,503,mixer,1349,3249,1900,2,00105,India
566609,2023-11-09,507,washing machine,6990,16490,9500,2,00431,India
161561,2023-11-09,507,washing machine,6990,16490,9500,2,00497,India
161561,2023-11-09,502,iphone 15 pro max,100000,135000,35000,2,00497,India
161561,2023-11-09,503,mixer,1349,3249,1900,2,00497,India
553607,2023-11-09,501,iphone 15,60000,80000,20000,2,00323,India
553607,2023-11-09,503,mixer,1349,3249,1900,2,00323,India
646938,2023-11-09,506,monitor,3249,8000,4751,2,00082,India
646938,2023-11-09,501,iphone 15,60000,80000,20000,2,00082,India
810740,2023-11-09,504,iron,449,879,430,2,00403,India
810740,2023-11-09,501,iphone 15,60000,80000,20000,2,00403,India
337707,2023-11-09,504,iron,449,879,430,2,00437,India
729513,2023-11-09,503,mixer,1349,3249,1900,2,00100,India
729513,2023-11-09,506,monitor,3249,8000,4751,2,00100,India
729513,2023-11-09,502,iphone 15 pro max,100000,135000,35000,2,00100,India
729513,2023-11-09,504,iron,449,879,430,2,00100,India
376959,2023-11-09,501,iphone 15,60000,80000,20000,2,00300,India
376959,2023-11-09,507,washing machine,6990,16490,9500,2,00300,India
376959,2023-11-09,504,iron,449,879,430,2,00300,India
531576,2023-11-09,503,mixer,1349,3249,1900,2,00499,India
531576,2023-11-09,504,iron,449,879,430,2,00499,India
885516,2023-11-09,501,iphone 15,60000,80000,20000,2,00135,India
885516,2023-11-09,502,iphone 15 pro max,100000,135000,35000,2,00135,India
885516,2023-11-09,503,mixer,1349,3249,1900,2,00135,India
885516,2023-11-09,506,monitor,3249,8000,4751,2,00135,India
268859,2023-11-09,504,iron,449,879,430,2,00142,India
271506,2023-11-09,507,washing machine,6990,16490,9500,2,00266,India
271506,2023-11-09,504,iron,449,879,430,2,00266,India
254460,2023-11-09,504,iron,449,879,430,2,00368,India
683367,2023-11-09,505,oven,18490,24000,5510,2,00178,India
683367,2023-11-09,506,monitor,3249,8000,4751,2,00178,India
683367,2023-11-09,502,iphone 15 pro max,100000,135000,35000,2,00178,India
683367,2023-11-09,503,mixer,1349,3249,1900,2,00178,India
739852,2023-11-09,507,washing machine,6990,16490,9500,2,00426,India
739852,2023-11-09,506,monitor,3249,8000,4751,2,00426,India
739852,2023-11-09,505,oven,18490,24000,5510,2,00426,India
432538,2023-11-09,505,oven,18490,24000,5510,2,00218,India
432538,2023-11-09,507,washing machine,6990,16490,9500,2,00218,India
432538,2023-11-09,501,iphone 15,60000,80000,20000,2,00218,India
399606,2023-11-09,502,iphone 15 pro max,100000,135000,35000,2,00461,India
399606,2023-11-09,506,monitor,3249,8000,4751,2,00461,India
847455,2023-11-09,507,washing machine,6990,16490,9500,2,00254,India
847455,2023-11-09,501,iphone 15,60000,80000,20000,2,00254,India
407698,2023-11-09,507,washing machine,6990,16490,9500,2,00434,India
347858,2023-11-09,503,mixer,1349,3249,1900,2,00284,India
347858,2023-11-09,505,oven,18490,24000,5510,2,00284,India
411712,2023-11-09,501,iphone 15,60000,80000,20000,2,00236,India
253340,2023-11-09,505,oven,18490,24000,5510,2,00263,India
253340,2023-11-09,502,iphone 15 pro max,100000,135000,35000,2,00263,India
253340,2023-11-09,504,iron,449,879,430,2,00263,India
253340,2023-11-09,503,mixer,1349,3249,1900,2,00263,India
271642,2023-11-09,506,monitor,3249,8000,4751,2,00332,India
271642,2023-11-09,503,mixer,1349,3249,1900,2,00332,India
271642,2023-11-09,504,iron,449,879,430,2,00332,India
405895,2023-11-09,501,iphone 15,60000,80000,20000,2,00284,India
405895,2023-11-09,506,monitor,3249,8000,4751,2,00284,India
405895,2023-11-09,503,mixer,1349,3249,1900,2,00284,India
405895,2023-11-09,504,iron,449,879,430,2,00284,India
882769,2023-11-09,507,washing machine,6990,16490,9500,2,00229,India
882769,2023-11-09,505,oven,18490,24000,5510,2,00229,India
310720,2023-11-09,507,washing machine,6990,16490,9500,2,00255,India
310720,2023-11-09,502,iphone 15 pro max,100000,135000,35000,2,00255,India
310720,2023-11-09,501,iphone 15,60000,80000,20000,2,00255,India
310720,2023-11-09,503,mixer,1349,3249,1900,2,00255,India
310720,2023-11-09,504,iron,449,879,430,2,00255,India
360202,2023-11-09,502,iphone 15 pro max,100000,135000,35000,2,00253,India
258937,2023-11-09,506,monitor,3249,8000,4751,2,00167,India
258937,2023-11-09,504,iron,449,879,430,2,00167,India
258937,2023-11-09,503,mixer,1349,3249,1900,2,00167,India
667876,2023-11-09,501,iphone 15,60000,80000,20000,2,00003,India
122091,2023-11-09,504,iron,449,879,430,2,00002,India
122091,2023-11-09,502,iphone 15 pro max,100000,135000,35000,2,00002,India
122091,2023-11-09,505,oven,18490,24000,5510,2,00002,India
122091,2023-11-09,501,iphone 15,60000,80000,20000,2,00002,India
542850,2023-11-09,502,iphone 15 pro max,100000,135000,35000,2,00496,India
542850,2023-11-09,506,monitor,3249,8000,4751,2,00496,India
256875,2023-11-09,504,iron,449,879,430,2,00186,India
296876,2023-11-09,505,oven,18490,24000,5510,2,00127,India
296876,2023-11-09,501,iphone 15,60000,80000,20000,2,00127,India
296876,2023-11-09,502,iphone 15 pro max,100000,135000,35000,2,00127,India
296876,2023-11-09,504,iron,449,879,430,2,00127,India
156938,2023-11-09,507,washing machine,6990,16490,9500,2,00394,India
156938,2023-11-09,506,monitor,3249,8000,4751,2,00394,India
156938,2023-11-09,504,iron,449,879,430,2,00394,India
156938,2023-11-09,503,mixer,1349,3249,1900,2,00394,India
112205,2023-11-09,504,iron,449,879,430,2,00435,India
112205,2023-11-09,503,mixer,1349,3249,1900,2,00435,India
112205,2023-11-09,502,iphone 15 pro max,100000,135000,35000,2,00435,India
112205,2023-11-09,506,monitor,3249,8000,4751,2,00435,India
309795,2023-11-09,506,monitor,3249,8000,4751,2,00342,India
309795,2023-11-09,503,mixer,1349,3249,1900,2,00342,India
309795,2023-11-09,501,iphone 15,60000,80000,20000,2,00342,India
506791,2023-11-09,506,monitor,3249,8000,4751,2,00130,India
506791,2023-11-09,507,washing machine,6990,16490,9500,2,00130,India
816480,2023-11-09,504,iron,449,879,430,2,00195,India
816480,2023-11-09,507,washing machine,6990,16490,9500,2,00195,India
816480,2023-11-09,506,monitor,3249,8000,4751,2,00195,India
816480,2023-11-09,502,iphone 15 pro max,100000,135000,35000,2,00195,India
984214,2023-11-09,503,mixer,1349,3249,1900,2,00020,India
984214,2023-11-09,506,monitor,3249,8000,4751,2,00020,India
984214,2023-11-09,502,iphone 15 pro max,100000,135000,35000,2,00020,India
984214,2023-11-09,501,iphone 15,60000,80000,20000,2,00020,India
586086,2023-11-09,504,iron,449,879,430,2,00170,India
586086,2023-11-09,506,monitor,3249,8000,4751,2,00170,India
497508,2023-11-09,507,washing machine,6990,16490,9500,2,00360,India
497508,2023-11-09,503,mixer,1349,3249,1900,2,00360,India
897050,2023-11-09,506,monitor,3249,8000,4751,2,00207,India
897050,2023-11-09,501,iphone 15,60000,80000,20000,2,00207,India
897050,2023-11-09,507,washing machine,6990,16490,9500,2,00207,India
733158,2023-11-09,507,washing machine,6990,16490,9500,2,00256,India
733158,2023-11-09,504,iron,449,879,430,2,00256,India
733158,2023-11-09,502,iphone 15 pro max,100000,135000,35000,2,00256,India
244734,2023-11-09,505,oven,18490,24000,5510,2,00344,India
244734,2023-11-09,507,washing machine,6990,16490,9500,2,00344,India
244734,2023-11-09,504,iron,449,879,430,2,00344,India
244734,2023-11-09,503,mixer,1349,3249,1900,2,00344,India
244734,2023-11-09,502,iphone 15 pro max,100000,135000,35000,2,00344,India
456225,2023-11-09,505,oven,18490,24000,5510,2,00255,India
456225,2023-11-09,503,mixer,1349,3249,1900,2,00255,India
456225,2023-11-09,504,iron,449,879,430,2,00255,India
927233,2023-11-09,501,iphone 15,60000,80000,20000,2,00116,India
927233,2023-11-09,505,oven,18490,24000,5510,2,00116,India
927233,2023-11-09,502,iphone 15 pro max,100000,135000,35000,2,00116,India
927233,2023-11-09,504,iron,449,879,430,2,00116,India
809886,2023-11-09,502,iphone 15 pro max,100000,135000,35000,2,00049,India
809886,2023-11-09,503,mixer,1349,3249,1900,2,00049,India
809886,2023-11-09,504,iron,449,879,430,2,00049,India
972616,2023-11-09,501,iphone 15,60000,80000,20000,2,00391,India
539246,2023-11-09,503,mixer,1349,3249,1900,2,00311,India
539246,2023-11-09,502,iphone 15 pro max,100000,135000,35000,2,00311,India
539246,2023-11-09,506,monitor,3249,8000,4751,2,00311,India
173873,2023-11-09,506,monitor,3249,8000,4751,2,00150,India
173873,2023-11-09,504,iron,449,879,430,2,00150,India
911521,2023-11-09,503,mixer,1349,3249,1900,2,00031,India
956356,2023-11-09,505,oven,18490,24000,5510,2,00225,India
956356,2023-11-09,503,mixer,1349,3249,1900,2,00225,India
956356,2023-11-09,506,monitor,3249,8000,4751,2,00225,India
956356,2023-11-09,502,iphone 15 pro max,100000,135000,35000,2,00225,India
891215,2023-11-09,507,washing machine,6990,16490,9500,2,00479,India
891215,2023-11-09,505,oven,18490,24000,5510,2,00479,India
891215,2023-11-09,506,monitor,3249,8000,4751,2,00479,India
891215,2023-11-09,502,iphone 15 pro max,100000,135000,35000,2,00479,India
242869,2023-11-09,503,mixer,1349,3249,1900,2,00483,India
242869,2023-11-09,502,iphone 15 pro max,100000,135000,35000,2,00483,India
242869,2023-11-09,504,iron,449,879,430,2,00483,India
584784,2023-11-09,502,iphone 15 pro max,100000,135000,35000,2,00157,India
639567,2023-11-09,506,monitor,3249,8000,4751,2,00046,India
639567,2023-11-09,504,iron,449,879,430,2,00046,India
639567,2023-11-09,501,iphone 15,60000,80000,20000,2,00046,India
639567,2023-11-09,505,oven,18490,24000,5510,2,00046,India
639567,2023-11-09,502,iphone 15 pro max,100000,135000,35000,2,00046,India
437624,2023-11-09,507,washing machine,6990,16490,9500,2,00032,India
462669,2023-11-09,503,mixer,1349,3249,1900,2,00248,India
462669,2023-11-09,504,iron,449,879,430,2,00248,India
462669,2023-11-09,502,iphone 15 pro max,100000,135000,35000,2,00248,India
435652,2023-11-09,501,iphone 15,60000,80000,20000,2,00257,India
435652,2023-11-09,503,mixer,1349,3249,1900,2,00257,India
435652,2023-11-09,507,washing machine,6990,16490,9500,2,00257,India
435652,2023-11-09,504,iron,449,879,430,2,00257,India
786264,2023-11-09,501,iphone 15,60000,80000,20000,2,00286,India
786264,2023-11-09,505,oven,18490,24000,5510,2,00286,India
119865,2023-11-09,502,iphone 15 pro max,100000,135000,35000,2,00325,India
119865,2023-11-09,505,oven,18490,24000,5510,2,00325,India
460577,2023-11-09,502,iphone 15 pro max,100000,135000,35000,2,00388,India
829784,2023-11-09,503,mixer,1349,3249,1900,2,00229,India
829784,2023-11-09,502,iphone 15 pro max,100000,135000,35000,2,00229,India
829784,2023-11-09,506,monitor,3249,8000,4751,2,00229,India
850852,2023-11-09,504,iron,449,879,430,2,00048,India
850852,2023-11-09,505,oven,18490,24000,5510,2,00048,India
850852,2023-11-09,506,monitor,3249,8000,4751,2,00048,India
244207,2023-11-09,507,washing machine,6990,16490,9500,2,00100,India
244207,2023-11-09,504,iron,449,879,430,2,00100,India
608566,2023-11-09,502,iphone 15 pro max,100000,135000,35000,2,00221,India
608566,2023-11-09,504,iron,449,879,430,2,00221,India
610712,2023-11-09,503,mixer,1349,3249,1900,2,00335,India
610712,2023-11-09,501,iphone 15,60000,80000,20000,2,00335,India
610712,2023-11-09,507,washing machine,6990,16490,9500,2,00335,India
610712,2023-11-09,505,oven,18490,24000,5510,2,00335,India
191155,2023-11-10,503,mixer,1349,3249,1900,2,00315,India
191155,2023-11-10,504,iron,449,879,430,2,00315,India
834719,2023-11-10,507,washing machine,6990,16490,9500,2,00288,India
643717,2023-11-10,503,mixer,1349,3249,1900,2,00323,India
643717,2023-11-10,507,washing machine,6990,16490,9500,2,00323,India
351295,2023-11-10,506,monitor,3249,8000,4751,2,00191,India
351295,2023-11-10,503,mixer,1349,3249,1900,2,00191,India
351295,2023-11-10,502,iphone 15 pro max,100000,135000,35000,2,00191,India
171659,2023-11-10,507,washing machine,6990,16490,9500,2,00360,India
171659,2023-11-10,504,iron,449,879,430,2,00360,India
171659,2023-11-10,506,monitor,3249,8000,4751,2,00360,India
356080,2023-11-10,502,iphone 15 pro max,100000,135000,35000,2,00048,India
838640,2023-11-10,505,oven,18490,24000,5510,2,00225,India
194543,2023-11-10,502,iphone 15 pro max,100000,135000,35000,2,00421,India
194543,2023-11-10,507,washing machine,6990,16490,9500,2,00421,India
194543,2023-11-10,506,monitor,3249,8000,4751,2,00421,India
436321,2023-11-10,502,iphone 15 pro max,100000,135000,35000,2,00239,India
436321,2023-11-10,505,oven,18490,24000,5510,2,00239,India
436321,2023-11-10,501,iphone 15,60000,80000,20000,2,00239,India
840438,2023-11-10,503,mixer,1349,3249,1900,2,00039,India
840438,2023-11-10,504,iron,449,879,430,2,00039,India
840438,2023-11-10,501,iphone 15,60000,80000,20000,2,00039,India
859500,2023-11-10,503,mixer,1349,3249,1900,2,00387,India
859500,2023-11-10,502,iphone 15 pro max,100000,135000,35000,2,00387,India
859500,2023-11-10,507,washing machine,6990,16490,9500,2,00387,India
339926,2023-11-10,506,monitor,3249,8000,4751,2,00102,India
339926,2023-11-10,507,washing machine,6990,16490,9500,2,00102,India
339926,2023-11-10,501,iphone 15,60000,80000,20000,2,00102,India
939431,2023-11-10,503,mixer,1349,3249,1900,2,00363,India
939431,2023-11-10,505,oven,18490,24000,5510,2,00363,India
939431,2023-11-10,506,monitor,3249,8000,4751,2,00363,India
939431,2023-11-10,502,iphone 15 pro max,100000,135000,35000,2,00363,India
420737,2023-11-10,505,oven,18490,24000,5510,2,00176,India
420737,2023-11-10,501,iphone 15,60000,80000,20000,2,00176,India
420737,2023-11-10,503,mixer,1349,3249,1900,2,00176,India
852835,2023-11-10,502,iphone 15 pro max,100000,135000,35000,2,00490,India
852835,2023-11-10,503,mixer,1349,3249,1900,2,00490,India
852835,2023-11-10,505,oven,18490,24000,5510,2,00490,India
852835,2023-11-10,507,washing machine,6990,16490,9500,2,00490,India
242942,2023-11-10,506,monitor,3249,8000,4751,2,00005,India
969827,2023-11-10,502,iphone 15 pro max,100000,135000,35000,2,00492,India
969827,2023-11-10,501,iphone 15,60000,80000,20000,2,00492,India
372640,2023-11-10,507,washing machine,6990,16490,9500,2,00499,India
306318,2023-11-10,506,monitor,3249,8000,4751,2,00289,India
717750,2023-11-10,505,oven,18490,24000,5510,2,00293,India
717750,2023-11-10,503,mixer,1349,3249,1900,2,00293,India
816748,2023-11-10,504,iron,449,879,430,2,00298,India
191425,2023-11-10,507,washing machine,6990,16490,9500,2,00224,India
191425,2023-11-10,504,iron,449,879,430,2,00224,India
191425,2023-11-10,503,mixer,1349,3249,1900,2,00224,India
844283,2023-11-10,502,iphone 15 pro max,100000,135000,35000,2,00386,India
844283,2023-11-10,501,iphone 15,60000,80000,20000,2,00386,India
844283,2023-11-10,507,washing machine,6990,16490,9500,2,00386,India
691682,2023-11-10,504,iron,449,879,430,2,00454,India
691682,2023-11-10,505,oven,18490,24000,5510,2,00454,India
190329,2023-11-10,503,mixer,1349,3249,1900,2,00118,India
190329,2023-11-10,501,iphone 15,60000,80000,20000,2,00118,India
190329,2023-11-10,504,iron,449,879,430,2,00118,India
566189,2023-11-10,502,iphone 15 pro max,100000,135000,35000,2,00160,India
566189,2023-11-10,503,mixer,1349,3249,1900,2,00160,India
566189,2023-11-10,505,oven,18490,24000,5510,2,00160,India
566189,2023-11-10,507,washing machine,6990,16490,9500,2,00160,India
376714,2023-11-10,506,monitor,3249,8000,4751,2,00381,India
376714,2023-11-10,505,oven,18490,24000,5510,2,00381,India
376714,2023-11-10,507,washing machine,6990,16490,9500,2,00381,India
577477,2023-11-10,505,oven,18490,24000,5510,2,00266,India
577477,2023-11-10,501,iphone 15,60000,80000,20000,2,00266,India
577477,2023-11-10,502,iphone 15 pro max,100000,135000,35000,2,00266,India
577477,2023-11-10,503,mixer,1349,3249,1900,2,00266,India
421399,2023-11-10,501,iphone 15,60000,80000,20000,2,00186,India
421399,2023-11-10,502,iphone 15 pro max,100000,135000,35000,2,00186,India
421399,2023-11-10,506,monitor,3249,8000,4751,2,00186,India
421399,2023-11-10,507,washing machine,6990,16490,9500,2,00186,India
859770,2023-11-10,502,iphone 15 pro max,100000,135000,35000,2,00244,India
859770,2023-11-10,503,mixer,1349,3249,1900,2,00244,India
859770,2023-11-10,505,oven,18490,24000,5510,2,00244,India
741411,2023-11-10,503,mixer,1349,3249,1900,2,00160,India
741411,2023-11-10,506,monitor,3249,8000,4751,2,00160,India
903719,2023-11-10,502,iphone 15 pro max,100000,135000,35000,2,00059,India
903719,2023-11-10,507,washing machine,6990,16490,9500,2,00059,India
903719,2023-11-10,501,iphone 15,60000,80000,20000,2,00059,India
903719,2023-11-10,503,mixer,1349,3249,1900,2,00059,India
698801,2023-11-10,502,iphone 15 pro max,100000,135000,35000,2,00176,India
698801,2023-11-10,505,oven,18490,24000,5510,2,00176,India
698801,2023-11-10,506,monitor,3249,8000,4751,2,00176,India
155174,2023-11-10,507,washing machine,6990,16490,9500,2,00125,India
155174,2023-11-10,501,iphone 15,60000,80000,20000,2,00125,India
155174,2023-11-10,502,iphone 15 pro max,100000,135000,35000,2,00125,India
155174,2023-11-10,504,iron,449,879,430,2,00125,India
762994,2023-11-10,507,washing machine,6990,16490,9500,2,00218,India
762994,2023-11-10,503,mixer,1349,3249,1900,2,00218,India
961376,2023-11-10,507,washing machine,6990,16490,9500,2,00384,India
961376,2023-11-10,502,iphone 15 pro max,100000,135000,35000,2,00384,India
409038,2023-11-10,501,iphone 15,60000,80000,20000,2,00327,India
409038,2023-11-10,503,mixer,1349,3249,1900,2,00327,India
409038,2023-11-10,502,iphone 15 pro max,100000,135000,35000,2,00327,India
748177,2023-11-10,501,iphone 15,60000,80000,20000,2,00424,India
748177,2023-11-10,502,iphone 15 pro max,100000,135000,35000,2,00424,India
748177,2023-11-10,506,monitor,3249,8000,4751,2,00424,India
748177,2023-11-10,503,mixer,1349,3249,1900,2,00424,India
962572,2023-11-10,502,iphone 15 pro max,100000,135000,35000,2,00106,India
962572,2023-11-10,506,monitor,3249,8000,4751,2,00106,India
483001,2023-11-10,504,iron,449,879,430,2,00311,India
483001,2023-11-10,507,washing machine,6990,16490,9500,2,00311,India
483001,2023-11-10,505,oven,18490,24000,5510,2,00311,India
483001,2023-11-10,502,iphone 15 pro max,100000,135000,35000,2,00311,India
933939,2023-11-10,502,iphone 15 pro max,100000,135000,35000,2,00207,India
933939,2023-11-10,501,iphone 15,60000,80000,20000,2,00207,India
933939,2023-11-10,507,washing machine,6990,16490,9500,2,00207,India
760536,2023-11-10,506,monitor,3249,8000,4751,2,00172,India
942588,2023-11-10,501,iphone 15,60000,80000,20000,2,00251,India
942588,2023-11-10,503,mixer,1349,3249,1900,2,00251,India
144483,2023-11-10,507,washing machine,6990,16490,9500,2,00424,India
144483,2023-11-10,502,iphone 15 pro max,100000,135000,35000,2,00424,India
144483,2023-11-10,505,oven,18490,24000,5510,2,00424,India
144483,2023-11-10,504,iron,449,879,430,2,00424,India
673980,2023-11-10,504,iron,449,879,430,2,00249,India
673980,2023-11-10,505,oven,18490,24000,5510,2,00249,India
673980,2023-11-10,507,washing machine,6990,16490,9500,2,00249,India
914383,2023-11-10,503,mixer,1349,3249,1900,2,00026,India
451690,2023-11-10,506,monitor,3249,8000,4751,2,00389,India
451690,2023-11-10,502,iphone 15 pro max,100000,135000,35000,2,00389,India
609368,2023-11-10,504,iron,449,879,430,2,00152,India
609368,2023-11-10,502,iphone 15 pro max,100000,135000,35000,2,00152,India
609368,2023-11-10,503,mixer,1349,3249,1900,2,00152,India
609368,2023-11-10,507,washing machine,6990,16490,9500,2,00152,India
250468,2023-11-10,506,monitor,3249,8000,4751,2,00069,India
569664,2023-11-10,507,washing machine,6990,16490,9500,2,00124,India
905006,2023-11-10,502,iphone 15 pro max,100000,135000,35000,2,00112,India
325283,2023-11-10,504,iron,449,879,430,2,00103,India
325283,2023-11-10,503,mixer,1349,3249,1900,2,00103,India
325283,2023-11-10,502,iphone 15 pro max,100000,135000,35000,2,00103,India
325283,2023-11-10,501,iphone 15,60000,80000,20000,2,00103,India
138532,2023-11-10,505,oven,18490,24000,5510,2,00011,India
138532,2023-11-10,501,iphone 15,60000,80000,20000,2,00011,India
138532,2023-11-10,504,iron,449,879,430,2,00011,India
200809,2023-11-10,505,oven,18490,24000,5510,2,00027,India
200809,2023-11-10,506,monitor,3249,8000,4751,2,00027,India
200809,2023-11-10,504,iron,449,879,430,2,00027,India
200809,2023-11-10,507,washing machine,6990,16490,9500,2,00027,India
567820,2023-11-10,503,mixer,1349,3249,1900,2,00361,India
189893,2023-11-10,501,iphone 15,60000,80000,20000,2,00058,India
189893,2023-11-10,503,mixer,1349,3249,1900,2,00058,India
189893,2023-11-10,505,oven,18490,24000,5510,2,00058,India
189893,2023-11-10,504,iron,449,879,430,2,00058,India
137386,2023-11-10,503,mixer,1349,3249,1900,2,00183,India
232436,2023-11-10,501,iphone 15,60000,80000,20000,2,00468,India
445279,2023-11-10,507,washing machine,6990,16490,9500,2,00246,India
445279,2023-11-10,502,iphone 15 pro max,100000,135000,35000,2,00246,India
445279,2023-11-10,506,monitor,3249,8000,4751,2,00246,India
223561,2023-11-10,502,iphone 15 pro max,100000,135000,35000,2,00211,India
223561,2023-11-10,504,iron,449,879,430,2,00211,India
223561,2023-11-10,505,oven,18490,24000,5510,2,00211,India
637958,2023-11-10,501,iphone 15,60000,80000,20000,2,00321,India
637958,2023-11-10,505,oven,18490,24000,5510,2,00321,India
637958,2023-11-10,507,washing machine,6990,16490,9500,2,00321,India
637958,2023-11-10,502,iphone 15 pro max,100000,135000,35000,2,00321,India
574434,2023-11-10,506,monitor,3249,8000,4751,2,00112,India
896612,2023-11-10,507,washing machine,6990,16490,9500,2,00415,India
284745,2023-11-10,501,iphone 15,60000,80000,20000,2,00259,India
284745,2023-11-10,506,monitor,3249,8000,4751,2,00259,India
284745,2023-11-10,504,iron,449,879,430,2,00259,India
284745,2023-11-10,503,mixer,1349,3249,1900,2,00259,India
114952,2023-11-10,505,oven,18490,24000,5510,2,00101,India
114952,2023-11-10,501,iphone 15,60000,80000,20000,2,00101,India
114952,2023-11-10,504,iron,449,879,430,2,00101,India
114952,2023-11-10,506,monitor,3249,8000,4751,2,00101,India
101234,2023-11-10,507,washing machine,6990,16490,9500,2,00367,India
101234,2023-11-10,501,iphone 15,60000,80000,20000,2,00367,India
101234,2023-11-10,502,iphone 15 pro max,100000,135000,35000,2,00367,India
370194,2023-11-10,506,monitor,3249,8000,4751,2,00225,India
370194,2023-11-10,503,mixer,1349,3249,1900,2,00225,India
171191,2023-11-10,504,iron,449,879,430,2,00136,India
967968,2023-11-10,507,washing machine,6990,16490,9500,2,00327,India
967968,2023-11-10,502,iphone 15 pro max,100000,135000,35000,2,00327,India
113137,2023-11-10,503,mixer,1349,3249,1900,2,00187,India
113137,2023-11-10,502,iphone 15 pro max,100000,135000,35000,2,00187,India
684259,2023-11-10,503,mixer,1349,3249,1900,2,00217,India
684259,2023-11-10,507,washing machine,6990,16490,9500,2,00217,India
684259,2023-11-10,504,iron,449,879,430,2,00217,India
684259,2023-11-10,502,iphone 15 pro max,100000,135000,35000,2,00217,India
395507,2023-11-10,503,mixer,1349,3249,1900,2,00288,India
395507,2023-11-10,505,oven,18490,24000,5510,2,00288,India
395507,2023-11-10,502,iphone 15 pro max,100000,135000,35000,2,00288,India
697954,2023-11-10,504,iron,449,879,430,2,00409,India
697954,2023-11-10,506,monitor,3249,8000,4751,2,00409,India
697954,2023-11-10,507,washing machine,6990,16490,9500,2,00409,India
504617,2023-11-10,506,monitor,3249,8000,4751,2,00018,India
504617,2023-11-10,503,mixer,1349,3249,1900,2,00018,India
245079,2023-11-10,503,mixer,1349,3249,1900,2,00114,India
245079,2023-11-10,501,iphone 15,60000,80000,20000,2,00114,India
587389,2023-11-10,504,iron,449,879,430,2,00244,India
129751,2023-11-10,506,monitor,3249,8000,4751,2,00296,India
129751,2023-11-10,504,iron,449,879,430,2,00296,India
590936,2023-11-10,501,iphone 15,60000,80000,20000,2,00447,India
590936,2023-11-10,504,iron,449,879,430,2,00447,India
590936,2023-11-10,503,mixer,1349,3249,1900,2,00447,India
512043,2023-11-10,504,iron,449,879,430,2,00325,India
972351,2023-11-10,502,iphone 15 pro max,100000,135000,35000,2,00092,India
972351,2023-11-10,506,monitor,3249,8000,4751,2,00092,India
972351,2023-11-10,505,oven,18490,24000,5510,2,00092,India
500741,2023-11-10,507,washing machine,6990,16490,9500,2,00463,India
500741,2023-11-10,503,mixer,1349,3249,1900,2,00463,India
500741,2023-11-10,506,monitor,3249,8000,4751,2,00463,India
953541,2023-11-10,505,oven,18490,24000,5510,2,00247,India
953541,2023-11-10,502,iphone 15 pro max,100000,135000,35000,2,00247,India
792839,2023-11-10,503,mixer,1349,3249,1900,2,00361,India
271736,2023-11-10,502,iphone 15 pro max,100000,135000,35000,2,00202,India
271736,2023-11-10,507,washing machine,6990,16490,9500,2,00202,India
271736,2023-11-10,501,iphone 15,60000,80000,20000,2,00202,India
271736,2023-11-10,503,mixer,1349,3249,1900,2,00202,India
237175,2023-11-10,504,iron,449,879,430,2,00085,India
932141,2023-11-10,503,mixer,1349,3249,1900,2,00461,India
932141,2023-11-10,501,iphone 15,60000,80000,20000,2,00461,India
686658,2023-11-11,505,oven,18490,24000,5510,2,00460,India
686658,2023-11-11,504,iron,449,879,430,2,00460,India
686658,2023-11-11,506,monitor,3249,8000,4751,2,00460,India
686658,2023-11-11,502,iphone 15 pro max,100000,135000,35000,2,00460,India
120073,2023-11-11,502,iphone 15 pro max,100000,135000,35000,2,00471,India
903478,2023-11-11,506,monitor,3249,8000,4751,2,00342,India
903478,2023-11-11,504,iron,449,879,430,2,00342,India
217060,2023-11-11,506,monitor,3249,8000,4751,2,00446,India
217060,2023-11-11,501,iphone 15,60000,80000,20000,2,00446,India
217060,2023-11-11,505,oven,18490,24000,5510,2,00446,India
229206,2023-11-11,502,iphone 15 pro max,100000,135000,35000,2,00449,India
229206,2023-11-11,503,mixer,1349,3249,1900,2,00449,India
229206,2023-11-11,501,iphone 15,60000,80000,20000,2,00449,India
229206,2023-11-11,505,oven,18490,24000,5510,2,00449,India
443103,2023-11-11,502,iphone 15 pro max,100000,135000,35000,2,00117,India
443103,2023-11-11,501,iphone 15,60000,80000,20000,2,00117,India
443103,2023-11-11,506,monitor,3249,8000,4751,2,00117,India
443103,2023-11-11,507,washing machine,6990,16490,9500,2,00117,India
443103,2023-11-11,503,mixer,1349,3249,1900,2,00117,India
825591,2023-11-11,502,iphone 15 pro max,100000,135000,35000,2,00220,India
825591,2023-11-11,506,monitor,3249,8000,4751,2,00220,India
825591,2023-11-11,505,oven,18490,24000,5510,2,00220,India
825591,2023-11-11,507,washing machine,6990,16490,9500,2,00220,India
825591,2023-11-11,503,mixer,1349,3249,1900,2,00220,India
774028,2023-11-11,507,washing machine,6990,16490,9500,2,00338,India
774028,2023-11-11,501,iphone 15,60000,80000,20000,2,00338,India
102237,2023-11-11,502,iphone 15 pro max,100000,135000,35000,2,00266,India
258531,2023-11-11,501,iphone 15,60000,80000,20000,2,00283,India
258531,2023-11-11,503,mixer,1349,3249,1900,2,00283,India
258531,2023-11-11,507,washing machine,6990,16490,9500,2,00283,India
258531,2023-11-11,505,oven,18490,24000,5510,2,00283,India
501975,2023-11-11,502,iphone 15 pro max,100000,135000,35000,2,00428,India
501975,2023-11-11,505,oven,18490,24000,5510,2,00428,India
501975,2023-11-11,504,iron,449,879,430,2,00428,India
666380,2023-11-11,505,oven,18490,24000,5510,2,00065,India
666380,2023-11-11,502,iphone 15 pro max,100000,135000,35000,2,00065,India
487494,2023-11-11,504,iron,449,879,430,2,00061,India
487494,2023-11-11,507,washing machine,6990,16490,9500,2,00061,India
160361,2023-11-11,504,iron,449,879,430,2,00205,India
133513,2023-11-11,503,mixer,1349,3249,1900,2,00071,India
133513,2023-11-11,501,iphone 15,60000,80000,20000,2,00071,India
992373,2023-11-11,502,iphone 15 pro max,100000,135000,35000,2,00120,India
992373,2023-11-11,505,oven,18490,24000,5510,2,00120,India
992373,2023-11-11,506,monitor,3249,8000,4751,2,00120,India
300948,2023-11-11,505,oven,18490,24000,5510,2,00436,India
382511,2023-11-11,501,iphone 15,60000,80000,20000,2,00015,India
382511,2023-11-11,503,mixer,1349,3249,1900,2,00015,India
150383,2023-11-11,501,iphone 15,60000,80000,20000,2,00191,India
150383,2023-11-11,503,mixer,1349,3249,1900,2,00191,India
704567,2023-11-11,505,oven,18490,24000,5510,2,00018,India
704567,2023-11-11,504,iron,449,879,430,2,00018,India
704567,2023-11-11,501,iphone 15,60000,80000,20000,2,00018,India
548182,2023-11-11,504,iron,449,879,430,2,00184,India
548182,2023-11-11,502,iphone 15 pro max,100000,135000,35000,2,00184,India
111616,2023-11-11,502,iphone 15 pro max,100000,135000,35000,2,00217,India
111616,2023-11-11,507,washing machine,6990,16490,9500,2,00217,India
111616,2023-11-11,503,mixer,1349,3249,1900,2,00217,India
714689,2023-11-11,504,iron,449,879,430,2,00381,India
714689,2023-11-11,505,oven,18490,24000,5510,2,00381,India
935979,2023-11-11,502,iphone 15 pro max,100000,135000,35000,2,00183,India
491028,2023-11-11,507,washing machine,6990,16490,9500,2,00052,India
391580,2023-11-11,503,mixer,1349,3249,1900,2,00065,India
391580,2023-11-11,506,monitor,3249,8000,4751,2,00065,India
391580,2023-11-11,504,iron,449,879,430,2,00065,India
391580,2023-11-11,507,washing machine,6990,16490,9500,2,00065,India
886834,2023-11-11,501,iphone 15,60000,80000,20000,2,00283,India
831080,2023-11-11,505,oven,18490,24000,5510,2,00391,India
831080,2023-11-11,501,iphone 15,60000,80000,20000,2,00391,India
831080,2023-11-11,504,iron,449,879,430,2,00391,India
831080,2023-11-11,503,mixer,1349,3249,1900,2,00391,India
630604,2023-11-11,501,iphone 15,60000,80000,20000,2,00248,India
630604,2023-11-11,504,iron,449,879,430,2,00248,India
630604,2023-11-11,503,mixer,1349,3249,1900,2,00248,India
630604,2023-11-11,502,iphone 15 pro max,100000,135000,35000,2,00248,India
504592,2023-11-11,502,iphone 15 pro max,100000,135000,35000,2,00084,India
504592,2023-11-11,503,mixer,1349,3249,1900,2,00084,India
372540,2023-11-11,507,washing machine,6990,16490,9500,2,00159,India
372540,2023-11-11,504,iron,449,879,430,2,00159,India
372540,2023-11-11,502,iphone 15 pro max,100000,135000,35000,2,00159,India
401262,2023-11-11,503,mixer,1349,3249,1900,2,00175,India
401262,2023-11-11,504,iron,449,879,430,2,00175,India
508464,2023-11-11,503,mixer,1349,3249,1900,2,00350,India
508464,2023-11-11,507,washing machine,6990,16490,9500,2,00350,India
508464,2023-11-11,504,iron,449,879,430,2,00350,India
322866,2023-11-11,505,oven,18490,24000,5510,2,00135,India
322866,2023-11-11,506,monitor,3249,8000,4751,2,00135,India
804810,2023-11-11,507,washing machine,6990,16490,9500,2,00350,India
804810,2023-11-11,506,monitor,3249,8000,4751,2,00350,India
804810,2023-11-11,503,mixer,1349,3249,1900,2,00350,India
898834,2023-11-11,502,iphone 15 pro max,100000,135000,35000,2,00236,India
898834,2023-11-11,507,washing machine,6990,16490,9500,2,00236,India
420980,2023-11-11,506,monitor,3249,8000,4751,2,00050,India
743600,2023-11-11,502,iphone 15 pro max,100000,135000,35000,2,00101,India
743600,2023-11-11,505,oven,18490,24000,5510,2,00101,India
743600,2023-11-11,507,washing machine,6990,16490,9500,2,00101,India
129931,2023-11-11,507,washing machine,6990,16490,9500,2,00097,India
236012,2023-11-11,502,iphone 15 pro max,100000,135000,35000,2,00332,India
109810,2023-11-11,502,iphone 15 pro max,100000,135000,35000,2,00486,India
109810,2023-11-11,501,iphone 15,60000,80000,20000,2,00486,India
109810,2023-11-11,503,mixer,1349,3249,1900,2,00486,India
392912,2023-11-11,507,washing machine,6990,16490,9500,2,00485,India
392912,2023-11-11,501,iphone 15,60000,80000,20000,2,00485,India
392912,2023-11-11,505,oven,18490,24000,5510,2,00485,India
392912,2023-11-11,506,monitor,3249,8000,4751,2,00485,India
260892,2023-11-11,504,iron,449,879,430,2,00253,India
260892,2023-11-11,503,mixer,1349,3249,1900,2,00253,India
260892,2023-11-11,502,iphone 15 pro max,100000,135000,35000,2,00253,India
568890,2023-11-11,505,oven,18490,24000,5510,2,00120,India
568890,2023-11-11,506,monitor,3249,8000,4751,2,00120,India
568890,2023-11-11,507,washing machine,6990,16490,9500,2,00120,India
568890,2023-11-11,504,iron,449,879,430,2,00120,India
568890,2023-11-11,503,mixer,1349,3249,1900,2,00120,India
447884,2023-11-11,507,washing machine,6990,16490,9500,2,00090,India
447884,2023-11-11,501,iphone 15,60000,80000,20000,2,00090,India
447884,2023-11-11,504,iron,449,879,430,2,00090,India
447884,2023-11-11,502,iphone 15 pro max,100000,135000,35000,2,00090,India
810750,2023-11-11,506,monitor,3249,8000,4751,2,00061,India
810750,2023-11-11,502,iphone 15 pro max,100000,135000,35000,2,00061,India
810750,2023-11-11,505,oven,18490,24000,5510,2,00061,India
810750,2023-11-11,507,washing machine,6990,16490,9500,2,00061,India
779917,2023-11-11,507,washing machine,6990,16490,9500,2,00071,India
779917,2023-11-11,504,iron,449,879,430,2,00071,India
779917,2023-11-11,505,oven,18490,24000,5510,2,00071,India
307195,2023-11-11,506,monitor,3249,8000,4751,2,00120,India
307195,2023-11-11,507,washing machine,6990,16490,9500,2,00120,India
307195,2023-11-11,505,oven,18490,24000,5510,2,00120,India
546104,2023-11-11,504,iron,449,879,430,2,00075,India
546104,2023-11-11,501,iphone 15,60000,80000,20000,2,00075,India
546104,2023-11-11,502,iphone 15 pro max,100000,135000,35000,2,00075,India
541966,2023-11-11,504,iron,449,879,430,2,00382,India
541966,2023-11-11,506,monitor,3249,8000,4751,2,00382,India
541966,2023-11-11,503,mixer,1349,3249,1900,2,00382,India
437330,2023-11-11,504,iron,449,879,430,2,00138,India
437330,2023-11-11,505,oven,18490,24000,5510,2,00138,India
330080,2023-11-11,503,mixer,1349,3249,1900,2,00014,India
330080,2023-11-11,506,monitor,3249,8000,4751,2,00014,India
483393,2023-11-11,505,oven,18490,24000,5510,2,00410,India
483393,2023-11-11,503,mixer,1349,3249,1900,2,00410,India
483393,2023-11-11,507,washing machine,6990,16490,9500,2,00410,India
431790,2023-11-11,501,iphone 15,60000,80000,20000,2,00138,India
431790,2023-11-11,502,iphone 15 pro max,100000,135000,35000,2,00138,India
882797,2023-11-11,502,iphone 15 pro max,100000,135000,35000,2,00119,India
882797,2023-11-11,501,iphone 15,60000,80000,20000,2,00119,India
690167,2023-11-11,504,iron,449,879,430,2,00357,India
690167,2023-11-11,502,iphone 15 pro max,100000,135000,35000,2,00357,India
690167,2023-11-11,507,washing machine,6990,16490,9500,2,00357,India
690167,2023-11-11,505,oven,18490,24000,5510,2,00357,India
656354,2023-11-11,505,oven,18490,24000,5510,2,00116,India
656354,2023-11-11,507,washing machine,6990,16490,9500,2,00116,India
656354,2023-11-11,503,mixer,1349,3249,1900,2,00116,India
656354,2023-11-11,506,monitor,3249,8000,4751,2,00116,India
514220,2023-11-12,502,iphone 15 pro max,100000,135000,35000,2,00051,India
456519,2023-11-12,506,monitor,3249,8000,4751,2,00084,India
456519,2023-11-12,507,washing machine,6990,16490,9500,2,00084,India
456519,2023-11-12,501,iphone 15,60000,80000,20000,2,00084,India
533190,2023-11-12,501,iphone 15,60000,80000,20000,2,00163,India
533190,2023-11-12,505,oven,18490,24000,5510,2,00163,India
533190,2023-11-12,503,mixer,1349,3249,1900,2,00163,India
507978,2023-11-12,507,washing machine,6990,16490,9500,2,00095,India
589377,2023-11-12,504,iron,449,879,430,2,00001,India
589377,2023-11-12,502,iphone 15 pro max,100000,135000,35000,2,00001,India
589377,2023-11-12,503,mixer,1349,3249,1900,2,00001,India
885688,2023-11-12,504,iron,449,879,430,2,00421,India
885688,2023-11-12,506,monitor,3249,8000,4751,2,00421,India
885688,2023-11-12,505,oven,18490,24000,5510,2,00421,India
149774,2023-11-12,507,washing machine,6990,16490,9500,2,00132,India
995780,2023-11-12,504,iron,449,879,430,2,00381,India
995780,2023-11-12,505,oven,18490,24000,5510,2,00381,India
565205,2023-11-12,503,mixer,1349,3249,1900,2,00025,India
565205,2023-11-12,507,washing machine,6990,16490,9500,2,00025,India
565205,2023-11-12,505,oven,18490,24000,5510,2,00025,India
565205,2023-11-12,502,iphone 15 pro max,100000,135000,35000,2,00025,India
657725,2023-11-12,503,mixer,1349,3249,1900,2,00032,India
428002,2023-11-12,505,oven,18490,24000,5510,2,00409,India
428002,2023-11-12,502,iphone 15 pro max,100000,135000,35000,2,00409,India
428002,2023-11-12,501,iphone 15,60000,80000,20000,2,00409,India
790489,2023-11-12,503,mixer,1349,3249,1900,2,00377,India
790489,2023-11-12,504,iron,449,879,430,2,00377,India
348000,2023-11-12,501,iphone 15,60000,80000,20000,2,00483,India
348000,2023-11-12,506,monitor,3249,8000,4751,2,00483,India
348000,2023-11-12,503,mixer,1349,3249,1900,2,00483,India
750646,2023-11-12,503,mixer,1349,3249,1900,2,00112,India
750646,2023-11-12,505,oven,18490,24000,5510,2,00112,India
298200,2023-11-12,505,oven,18490,24000,5510,2,00224,India
991808,2023-11-12,504,iron,449,879,430,2,00248,India
991808,2023-11-12,507,washing machine,6990,16490,9500,2,00248,India
673444,2023-11-12,503,mixer,1349,3249,1900,2,00063,India
673444,2023-11-12,504,iron,449,879,430,2,00063,India
673444,2023-11-12,502,iphone 15 pro max,100000,135000,35000,2,00063,India
715603,2023-11-12,504,iron,449,879,430,2,00490,India
715603,2023-11-12,502,iphone 15 pro max,100000,135000,35000,2,00490,India
715603,2023-11-12,507,washing machine,6990,16490,9500,2,00490,India
715603,2023-11-12,503,mixer,1349,3249,1900,2,00490,India
715603,2023-11-12,505,oven,18490,24000,5510,2,00490,India
743497,2023-11-12,507,washing machine,6990,16490,9500,2,00462,India
743497,2023-11-12,503,mixer,1349,3249,1900,2,00462,India
743497,2023-11-12,502,iphone 15 pro max,100000,135000,35000,2,00462,India
743497,2023-11-12,504,iron,449,879,430,2,00462,India
160182,2023-11-12,506,monitor,3249,8000,4751,2,00328,India
160182,2023-11-12,504,iron,449,879,430,2,00328,India
541722,2023-11-12,503,mixer,1349,3249,1900,2,00250,India
541722,2023-11-12,504,iron,449,879,430,2,00250,India
908209,2023-11-12,506,monitor,3249,8000,4751,2,00260,India
908209,2023-11-12,502,iphone 15 pro max,100000,135000,35000,2,00260,India
908209,2023-11-12,501,iphone 15,60000,80000,20000,2,00260,India
174764,2023-11-12,503,mixer,1349,3249,1900,2,00276,India
174764,2023-11-12,501,iphone 15,60000,80000,20000,2,00276,India
174764,2023-11-12,505,oven,18490,24000,5510,2,00276,India
342633,2023-11-12,501,iphone 15,60000,80000,20000,2,00113,India
342633,2023-11-12,503,mixer,1349,3249,1900,2,00113,India
733072,2023-11-12,501,iphone 15,60000,80000,20000,2,00181,India
252289,2023-11-12,501,iphone 15,60000,80000,20000,2,00293,India
252289,2023-11-12,504,iron,449,879,430,2,00293,India
252289,2023-11-12,505,oven,18490,24000,5510,2,00293,India
252289,2023-11-12,502,iphone 15 pro max,100000,135000,35000,2,00293,India
374128,2023-11-12,501,iphone 15,60000,80000,20000,2,00058,India
374128,2023-11-12,502,iphone 15 pro max,100000,135000,35000,2,00058,India
636494,2023-11-12,504,iron,449,879,430,2,00038,India
636494,2023-11-12,505,oven,18490,24000,5510,2,00038,India
676650,2023-11-12,502,iphone 15 pro max,100000,135000,35000,2,00039,India
554565,2023-11-12,503,mixer,1349,3249,1900,2,00499,India
554565,2023-11-12,506,monitor,3249,8000,4751,2,00499,India
554565,2023-11-12,501,iphone 15,60000,80000,20000,2,00499,India
554565,2023-11-12,502,iphone 15 pro max,100000,135000,35000,2,00499,India
252755,2023-11-12,505,oven,18490,24000,5510,2,00035,India
252755,2023-11-12,503,mixer,1349,3249,1900,2,00035,India
252755,2023-11-12,504,iron,449,879,430,2,00035,India
331724,2023-11-12,502,iphone 15 pro max,100000,135000,35000,2,00194,India
331724,2023-11-12,506,monitor,3249,8000,4751,2,00194,India
281517,2023-11-12,504,iron,449,879,430,2,00199,India
281517,2023-11-12,506,monitor,3249,8000,4751,2,00199,India
121117,2023-11-12,502,iphone 15 pro max,100000,135000,35000,2,00076,India
216481,2023-11-12,502,iphone 15 pro max,100000,135000,35000,2,00066,India
216481,2023-11-12,501,iphone 15,60000,80000,20000,2,00066,India
189162,2023-11-12,505,oven,18490,24000,5510,2,00105,India
189162,2023-11-12,504,iron,449,879,430,2,00105,India
189162,2023-11-12,503,mixer,1349,3249,1900,2,00105,India
651449,2023-11-12,503,mixer,1349,3249,1900,2,00234,India
651449,2023-11-12,506,monitor,3249,8000,4751,2,00234,India
651449,2023-11-12,501,iphone 15,60000,80000,20000,2,00234,India
168474,2023-11-12,507,washing machine,6990,16490,9500,2,00400,India
713308,2023-11-12,504,iron,449,879,430,2,00346,India
713308,2023-11-12,503,mixer,1349,3249,1900,2,00346,India
435523,2023-11-12,504,iron,449,879,430,2,00085,India
435523,2023-11-12,505,oven,18490,24000,5510,2,00085,India
214711,2023-11-12,506,monitor,3249,8000,4751,2,00461,India
214711,2023-11-12,505,oven,18490,24000,5510,2,00461,India
214711,2023-11-12,502,iphone 15 pro max,100000,135000,35000,2,00461,India
981725,2023-11-12,502,iphone 15 pro max,100000,135000,35000,2,00224,India
981725,2023-11-12,505,oven,18490,24000,5510,2,00224,India
981725,2023-11-12,507,washing machine,6990,16490,9500,2,00224,India
305234,2023-11-12,505,oven,18490,24000,5510,2,00400,India
305234,2023-11-12,506,monitor,3249,8000,4751,2,00400,India
305234,2023-11-12,502,iphone 15 pro max,100000,135000,35000,2,00400,India
737939,2023-11-12,501,iphone 15,60000,80000,20000,2,00200,India
737939,2023-11-12,503,mixer,1349,3249,1900,2,00200,India
213209,2023-11-12,507,washing machine,6990,16490,9500,2,00408,India
100388,2023-11-12,505,oven,18490,24000,5510,2,00390,India
100388,2023-11-12,507,washing machine,6990,16490,9500,2,00390,India
100388,2023-11-12,506,monitor,3249,8000,4751,2,00390,India
950362,2023-11-12,507,washing machine,6990,16490,9500,2,00190,India
582199,2023-11-12,501,iphone 15,60000,80000,20000,2,00294,India
802550,2023-11-12,502,iphone 15 pro max,100000,135000,35000,2,00093,India
802550,2023-11-12,506,monitor,3249,8000,4751,2,00093,India
384235,2023-11-12,502,iphone 15 pro max,100000,135000,35000,2,00328,India
384235,2023-11-12,507,washing machine,6990,16490,9500,2,00328,India
298665,2023-11-12,505,oven,18490,24000,5510,2,00214,India
298665,2023-11-12,504,iron,449,879,430,2,00214,India
298665,2023-11-12,506,monitor,3249,8000,4751,2,00214,India
122171,2023-11-12,507,washing machine,6990,16490,9500,2,00239,India
122171,2023-11-12,503,mixer,1349,3249,1900,2,00239,India
122171,2023-11-12,501,iphone 15,60000,80000,20000,2,00239,India
878397,2023-11-12,505,oven,18490,24000,5510,2,00072,India
878397,2023-11-12,502,iphone 15 pro max,100000,135000,35000,2,00072,India
878397,2023-11-12,506,monitor,3249,8000,4751,2,00072,India
878397,2023-11-12,501,iphone 15,60000,80000,20000,2,00072,India
485437,2023-11-12,506,monitor,3249,8000,4751,2,00384,India
485437,2023-11-12,501,iphone 15,60000,80000,20000,2,00384,India
751436,2023-11-13,505,oven,18490,24000,5510,2,00283,India
751436,2023-11-13,507,washing machine,6990,16490,9500,2,00283,India
609471,2023-11-13,507,washing machine,6990,16490,9500,2,00216,India
609471,2023-11-13,501,iphone 15,60000,80000,20000,2,00216,India
196187,2023-11-13,501,iphone 15,60000,80000,20000,2,00344,India
196187,2023-11-13,505,oven,18490,24000,5510,2,00344,India
196187,2023-11-13,507,washing machine,6990,16490,9500,2,00344,India
196187,2023-11-13,504,iron,449,879,430,2,00344,India
264554,2023-11-13,503,mixer,1349,3249,1900,2,00336,India
264554,2023-11-13,502,iphone 15 pro max,100000,135000,35000,2,00336,India
264554,2023-11-13,504,iron,449,879,430,2,00336,India
863237,2023-11-13,504,iron,449,879,430,2,00063,India
863237,2023-11-13,507,washing machine,6990,16490,9500,2,00063,India
863237,2023-11-13,505,oven,18490,24000,5510,2,00063,India
471430,2023-11-13,501,iphone 15,60000,80000,20000,2,00400,India
685726,2023-11-13,507,washing machine,6990,16490,9500,2,00286,India
685726,2023-11-13,506,monitor,3249,8000,4751,2,00286,India
240778,2023-11-13,504,iron,449,879,430,2,00190,India
240778,2023-11-13,502,iphone 15 pro max,100000,135000,35000,2,00190,India
240778,2023-11-13,505,oven,18490,24000,5510,2,00190,India
334636,2023-11-13,505,oven,18490,24000,5510,2,00308,India
334636,2023-11-13,506,monitor,3249,8000,4751,2,00308,India
334636,2023-11-13,504,iron,449,879,430,2,00308,India
334636,2023-11-13,507,washing machine,6990,16490,9500,2,00308,India
936753,2023-11-13,506,monitor,3249,8000,4751,2,00195,India
936753,2023-11-13,501,iphone 15,60000,80000,20000,2,00195,India
518229,2023-11-13,503,mixer,1349,3249,1900,2,00095,India
518229,2023-11-13,505,oven,18490,24000,5510,2,00095,India
211975,2023-11-13,503,mixer,1349,3249,1900,2,00278,India
211975,2023-11-13,507,washing machine,6990,16490,9500,2,00278,India
760350,2023-11-13,506,monitor,3249,8000,4751,2,00131,India
760350,2023-11-13,503,mixer,1349,3249,1900,2,00131,India
760350,2023-11-13,501,iphone 15,60000,80000,20000,2,00131,India
607338,2023-11-13,503,mixer,1349,3249,1900,2,00172,India
607338,2023-11-13,501,iphone 15,60000,80000,20000,2,00172,India
637328,2023-11-13,505,oven,18490,24000,5510,2,00059,India
637328,2023-11-13,502,iphone 15 pro max,100000,135000,35000,2,00059,India
754219,2023-11-13,501,iphone 15,60000,80000,20000,2,00417,India
754219,2023-11-13,505,oven,18490,24000,5510,2,00417,India
221694,2023-11-13,507,washing machine,6990,16490,9500,2,00134,India
221694,2023-11-13,501,iphone 15,60000,80000,20000,2,00134,India
221694,2023-11-13,506,monitor,3249,8000,4751,2,00134,India
221694,2023-11-13,505,oven,18490,24000,5510,2,00134,India
218517,2023-11-13,504,iron,449,879,430,2,00116,India
218517,2023-11-13,507,washing machine,6990,16490,9500,2,00116,India
893684,2023-11-13,506,monitor,3249,8000,4751,2,00417,India
893684,2023-11-13,507,washing machine,6990,16490,9500,2,00417,India
819603,2023-11-13,501,iphone 15,60000,80000,20000,2,00425,India
819603,2023-11-13,505,oven,18490,24000,5510,2,00425,India
907336,2023-11-13,502,iphone 15 pro max,100000,135000,35000,2,00144,India
299503,2023-11-13,504,iron,449,879,430,2,00252,India
299503,2023-11-13,502,iphone 15 pro max,100000,135000,35000,2,00252,India
299503,2023-11-13,505,oven,18490,24000,5510,2,00252,India
334932,2023-11-13,503,mixer,1349,3249,1900,2,00274,India
881813,2023-11-13,507,washing machine,6990,16490,9500,2,00380,India
388672,2023-11-13,505,oven,18490,24000,5510,2,00138,India
388672,2023-11-13,507,washing machine,6990,16490,9500,2,00138,India
240804,2023-11-13,503,mixer,1349,3249,1900,2,00067,India
240804,2023-11-13,502,iphone 15 pro max,100000,135000,35000,2,00067,India
963459,2023-11-13,505,oven,18490,24000,5510,2,00439,India
963459,2023-11-13,504,iron,449,879,430,2,00439,India
536729,2023-11-13,501,iphone 15,60000,80000,20000,2,00117,India
536729,2023-11-13,503,mixer,1349,3249,1900,2,00117,India
536729,2023-11-13,507,washing machine,6990,16490,9500,2,00117,India
851959,2023-11-13,507,washing machine,6990,16490,9500,2,00461,India
851959,2023-11-13,501,iphone 15,60000,80000,20000,2,00461,India
724959,2023-11-13,504,iron,449,879,430,2,00053,India
724959,2023-11-13,503,mixer,1349,3249,1900,2,00053,India
724959,2023-11-13,502,iphone 15 pro max,100000,135000,35000,2,00053,India
724959,2023-11-13,507,washing machine,6990,16490,9500,2,00053,India
618885,2023-11-13,501,iphone 15,60000,80000,20000,2,00078,India
618885,2023-11-13,506,monitor,3249,8000,4751,2,00078,India
955297,2023-11-13,505,oven,18490,24000,5510,2,00396,India
955297,2023-11-13,507,washing machine,6990,16490,9500,2,00396,India
957648,2023-11-13,503,mixer,1349,3249,1900,2,00121,India
957648,2023-11-13,502,iphone 15 pro max,100000,135000,35000,2,00121,India
957648,2023-11-13,507,washing machine,6990,16490,9500,2,00121,India
957648,2023-11-13,506,monitor,3249,8000,4751,2,00121,India
396287,2023-11-13,506,monitor,3249,8000,4751,2,00390,India
396287,2023-11-13,502,iphone 15 pro max,100000,135000,35000,2,00390,India
396287,2023-11-13,503,mixer,1349,3249,1900,2,00390,India
702145,2023-11-13,504,iron,449,879,430,2,00434,India
415735,2023-11-13,501,iphone 15,60000,80000,20000,2,00078,India
415735,2023-11-13,506,monitor,3249,8000,4751,2,00078,India
415735,2023-11-13,502,iphone 15 pro max,100000,135000,35000,2,00078,India
793361,2023-11-13,504,iron,449,879,430,2,00280,India
380702,2023-11-13,505,oven,18490,24000,5510,2,00457,India
380702,2023-11-13,502,iphone 15 pro max,100000,135000,35000,2,00457,India
926067,2023-11-13,504,iron,449,879,430,2,00316,India
926067,2023-11-13,506,monitor,3249,8000,4751,2,00316,India
926067,2023-11-13,505,oven,18490,24000,5510,2,00316,India
926067,2023-11-13,501,iphone 15,60000,80000,20000,2,00316,India
361244,2023-11-13,504,iron,449,879,430,2,00034,India
361244,2023-11-13,507,washing machine,6990,16490,9500,2,00034,India
361244,2023-11-13,501,iphone 15,60000,80000,20000,2,00034,India
361244,2023-11-13,506,monitor,3249,8000,4751,2,00034,India
685036,2023-11-13,501,iphone 15,60000,80000,20000,2,00066,India
685036,2023-11-13,505,oven,18490,24000,5510,2,00066,India
685036,2023-11-13,502,iphone 15 pro max,100000,135000,35000,2,00066,India
392769,2023-11-13,505,oven,18490,24000,5510,2,00358,India
392769,2023-11-13,507,washing machine,6990,16490,9500,2,00358,India
392769,2023-11-13,502,iphone 15 pro max,100000,135000,35000,2,00358,India
681695,2023-11-13,505,oven,18490,24000,5510,2,00365,India
681695,2023-11-13,504,iron,449,879,430,2,00365,India
681695,2023-11-13,506,monitor,3249,8000,4751,2,00365,India
681695,2023-11-13,501,iphone 15,60000,80000,20000,2,00365,India
731593,2023-11-13,505,oven,18490,24000,5510,2,00093,India
731593,2023-11-13,501,iphone 15,60000,80000,20000,2,00093,India
731593,2023-11-13,507,washing machine,6990,16490,9500,2,00093,India
566173,2023-11-13,504,iron,449,879,430,2,00288,India
566173,2023-11-13,505,oven,18490,24000,5510,2,00288,India
566173,2023-11-13,506,monitor,3249,8000,4751,2,00288,India
566173,2023-11-13,502,iphone 15 pro max,100000,135000,35000,2,00288,India
102966,2023-11-13,503,mixer,1349,3249,1900,2,00075,India
334743,2023-11-13,507,washing machine,6990,16490,9500,2,00133,India
334743,2023-11-13,501,iphone 15,60000,80000,20000,2,00133,India
334743,2023-11-13,503,mixer,1349,3249,1900,2,00133,India
789609,2023-11-13,506,monitor,3249,8000,4751,2,00303,India
789609,2023-11-13,502,iphone 15 pro max,100000,135000,35000,2,00303,India
312516,2023-11-13,503,mixer,1349,3249,1900,2,00192,India
312516,2023-11-13,502,iphone 15 pro max,100000,135000,35000,2,00192,India
312516,2023-11-13,504,iron,449,879,430,2,00192,India
827507,2023-11-13,501,iphone 15,60000,80000,20000,2,00441,India
827507,2023-11-13,504,iron,449,879,430,2,00441,India
827507,2023-11-13,506,monitor,3249,8000,4751,2,00441,India
648497,2023-11-13,501,iphone 15,60000,80000,20000,2,00181,India
978593,2023-11-13,507,washing machine,6990,16490,9500,2,00383,India
942996,2023-11-13,502,iphone 15 pro max,100000,135000,35000,2,00105,India
578188,2023-11-13,507,washing machine,6990,16490,9500,2,00115,India
578188,2023-11-13,503,mixer,1349,3249,1900,2,00115,India
547883,2023-11-13,502,iphone 15 pro max,100000,135000,35000,2,00049,India
547883,2023-11-13,501,iphone 15,60000,80000,20000,2,00049,India
615900,2023-11-13,502,iphone 15 pro max,100000,135000,35000,2,00111,India
759593,2023-11-13,507,washing machine,6990,16490,9500,2,00255,India
759593,2023-11-13,504,iron,449,879,430,2,00255,India
759593,2023-11-13,503,mixer,1349,3249,1900,2,00255,India
759593,2023-11-13,501,iphone 15,60000,80000,20000,2,00255,India
121530,2023-11-13,505,oven,18490,24000,5510,2,00239,India
206367,2023-11-13,503,mixer,1349,3249,1900,2,00189,India
206367,2023-11-13,504,iron,449,879,430,2,00189,India
206367,2023-11-13,507,washing machine,6990,16490,9500,2,00189,India
160384,2023-11-13,504,iron,449,879,430,2,00486,India
160384,2023-11-13,502,iphone 15 pro max,100000,135000,35000,2,00486,India
355382,2023-11-13,505,oven,18490,24000,5510,2,00399,India
355382,2023-11-13,502,iphone 15 pro max,100000,135000,35000,2,00399,India
628275,2023-11-13,503,mixer,1349,3249,1900,2,00110,India
628275,2023-11-13,505,oven,18490,24000,5510,2,00110,India
628275,2023-11-13,501,iphone 15,60000,80000,20000,2,00110,India
812815,2023-11-13,502,iphone 15 pro max,100000,135000,35000,2,00052,India
812815,2023-11-13,501,iphone 15,60000,80000,20000,2,00052,India
812815,2023-11-13,507,washing machine,6990,16490,9500,2,00052,India
314191,2023-11-13,503,mixer,1349,3249,1900,2,00198,India
314191,2023-11-13,507,washing machine,6990,16490,9500,2,00198,India
314191,2023-11-13,502,iphone 15 pro max,100000,135000,35000,2,00198,India
314191,2023-11-13,505,oven,18490,24000,5510,2,00198,India
253061,2023-11-13,506,monitor,3249,8000,4751,2,00314,India
253061,2023-11-13,502,iphone 15 pro max,100000,135000,35000,2,00314,India
253061,2023-11-13,503,mixer,1349,3249,1900,2,00314,India
930522,2023-11-13,506,monitor,3249,8000,4751,2,00301,India
282172,2023-11-13,502,iphone 15 pro max,100000,135000,35000,2,00141,India
282172,2023-11-13,501,iphone 15,60000,80000,20000,2,00141,India
282172,2023-11-13,504,iron,449,879,430,2,00141,India
708931,2023-11-13,506,monitor,3249,8000,4751,2,00429,India
708931,2023-11-13,502,iphone 15 pro max,100000,135000,35000,2,00429,India
133147,2023-11-13,503,mixer,1349,3249,1900,2,00020,India
133147,2023-11-13,505,oven,18490,24000,5510,2,00020,India
133147,2023-11-13,502,iphone 15 pro max,100000,135000,35000,2,00020,India
133147,2023-11-13,501,iphone 15,60000,80000,20000,2,00020,India
968589,2023-11-13,504,iron,449,879,430,2,00247,India
968589,2023-11-13,501,iphone 15,60000,80000,20000,2,00247,India
968589,2023-11-13,507,washing machine,6990,16490,9500,2,00247,India
968589,2023-11-13,503,mixer,1349,3249,1900,2,00247,India
968589,2023-11-13,502,iphone 15 pro max,100000,135000,35000,2,00247,India
261182,2023-11-13,502,iphone 15 pro max,100000,135000,35000,2,00359,India
261182,2023-11-13,504,iron,449,879,430,2,00359,India
709255,2023-11-13,507,washing machine,6990,16490,9500,2,00363,India
709255,2023-11-13,502,iphone 15 pro max,100000,135000,35000,2,00363,India
709255,2023-11-13,506,monitor,3249,8000,4751,2,00363,India
722446,2023-11-13,506,monitor,3249,8000,4751,2,00351,India
722446,2023-11-13,501,iphone 15,60000,80000,20000,2,00351,India
722446,2023-11-13,504,iron,449,879,430,2,00351,India
990330,2023-11-13,505,oven,18490,24000,5510,2,00298,India
990330,2023-11-13,501,iphone 15,60000,80000,20000,2,00298,India
990330,2023-11-13,502,iphone 15 pro max,100000,135000,35000,2,00298,India
945932,2023-11-13,502,iphone 15 pro max,100000,135000,35000,2,00349,India
945932,2023-11-13,505,oven,18490,24000,5510,2,00349,India
247009,2023-11-13,504,iron,449,879,430,2,00052,India
382979,2023-11-13,505,oven,18490,24000,5510,2,00146,India
382979,2023-11-13,504,iron,449,879,430,2,00146,India
382979,2023-11-13,501,iphone 15,60000,80000,20000,2,00146,India
319324,2023-11-13,506,monitor,3249,8000,4751,2,00178,India
319324,2023-11-13,503,mixer,1349,3249,1900,2,00178,India
863847,2023-11-13,501,iphone 15,60000,80000,20000,2,00267,India
863847,2023-11-13,503,mixer,1349,3249,1900,2,00267,India
863847,2023-11-13,504,iron,449,879,430,2,00267,India
863847,2023-11-13,505,oven,18490,24000,5510,2,00267,India
608261,2023-11-13,502,iphone 15 pro max,100000,135000,35000,2,00105,India
608261,2023-11-13,504,iron,449,879,430,2,00105,India
608261,2023-11-13,501,iphone 15,60000,80000,20000,2,00105,India
310083,2023-11-13,502,iphone 15 pro max,100000,135000,35000,2,00274,India
335660,2023-11-13,506,monitor,3249,8000,4751,2,00262,India
512737,2023-11-13,502,iphone 15 pro max,100000,135000,35000,2,00174,India
512737,2023-11-13,507,washing machine,6990,16490,9500,2,00174,India
512737,2023-11-13,505,oven,18490,24000,5510,2,00174,India
512737,2023-11-13,506,monitor,3249,8000,4751,2,00174,India
592896,2023-11-13,507,washing machine,6990,16490,9500,2,00067,India
592896,2023-11-13,505,oven,18490,24000,5510,2,00067,India
592896,2023-11-13,501,iphone 15,60000,80000,20000,2,00067,India
826060,2023-11-14,501,iphone 15,60000,80000,20000,2,00306,India
109652,2023-11-14,506,monitor,3249,8000,4751,2,00382,India
330618,2023-11-14,505,oven,18490,24000,5510,2,00416,India
330618,2023-11-14,504,iron,449,879,430,2,00416,India
926232,2023-11-14,507,washing machine,6990,16490,9500,2,00443,India
926232,2023-11-14,501,iphone 15,60000,80000,20000,2,00443,India
587063,2023-11-14,506,monitor,3249,8000,4751,2,00146,India
587063,2023-11-14,501,iphone 15,60000,80000,20000,2,00146,India
772441,2023-11-14,505,oven,18490,24000,5510,2,00413,India
772441,2023-11-14,504,iron,449,879,430,2,00413,India
772441,2023-11-14,502,iphone 15 pro max,100000,135000,35000,2,00413,India
368339,2023-11-14,506,monitor,3249,8000,4751,2,00465,India
368339,2023-11-14,507,washing machine,6990,16490,9500,2,00465,India
368339,2023-11-14,505,oven,18490,24000,5510,2,00465,India
368339,2023-11-14,504,iron,449,879,430,2,00465,India
456051,2023-11-14,501,iphone 15,60000,80000,20000,2,00345,India
456051,2023-11-14,504,iron,449,879,430,2,00345,India
456051,2023-11-14,506,monitor,3249,8000,4751,2,00345,India
113766,2023-11-14,507,washing machine,6990,16490,9500,2,00171,India
188976,2023-11-14,507,washing machine,6990,16490,9500,2,00157,India
188976,2023-11-14,505,oven,18490,24000,5510,2,00157,India
188976,2023-11-14,501,iphone 15,60000,80000,20000,2,00157,India
188976,2023-11-14,506,monitor,3249,8000,4751,2,00157,India
188976,2023-11-14,504,iron,449,879,430,2,00157,India
248073,2023-11-14,506,monitor,3249,8000,4751,2,00014,India
645360,2023-11-14,503,mixer,1349,3249,1900,2,00243,India
645360,2023-11-14,506,monitor,3249,8000,4751,2,00243,India
645360,2023-11-14,505,oven,18490,24000,5510,2,00243,India
807758,2023-11-14,503,mixer,1349,3249,1900,2,00379,India
807758,2023-11-14,504,iron,449,879,430,2,00379,India
565801,2023-11-14,506,monitor,3249,8000,4751,2,00417,India
565801,2023-11-14,503,mixer,1349,3249,1900,2,00417,India
393289,2023-11-14,504,iron,449,879,430,2,00049,India
393289,2023-11-14,502,iphone 15 pro max,100000,135000,35000,2,00049,India
393289,2023-11-14,507,washing machine,6990,16490,9500,2,00049,India
946116,2023-11-14,501,iphone 15,60000,80000,20000,2,00443,India
946116,2023-11-14,503,mixer,1349,3249,1900,2,00443,India
946116,2023-11-14,505,oven,18490,24000,5510,2,00443,India
613492,2023-11-14,506,monitor,3249,8000,4751,2,00141,India
613492,2023-11-14,501,iphone 15,60000,80000,20000,2,00141,India
613492,2023-11-14,502,iphone 15 pro max,100000,135000,35000,2,00141,India
266893,2023-11-14,505,oven,18490,24000,5510,2,00235,India
237582,2023-11-14,505,oven,18490,24000,5510,2,00340,India
974303,2023-11-14,506,monitor,3249,8000,4751,2,00449,India
974303,2023-11-14,507,washing machine,6990,16490,9500,2,00449,India
264430,2023-11-14,502,iphone 15 pro max,100000,135000,35000,2,00125,India
264430,2023-11-14,507,washing machine,6990,16490,9500,2,00125,India
560676,2023-11-14,503,mixer,1349,3249,1900,2,00241,India
560676,2023-11-14,505,oven,18490,24000,5510,2,00241,India
420823,2023-11-14,505,oven,18490,24000,5510,2,00249,India
420823,2023-11-14,504,iron,449,879,430,2,00249,India
420823,2023-11-14,506,monitor,3249,8000,4751,2,00249,India
214195,2023-11-14,502,iphone 15 pro max,100000,135000,35000,2,00308,India
214195,2023-11-14,501,iphone 15,60000,80000,20000,2,00308,India
214195,2023-11-14,503,mixer,1349,3249,1900,2,00308,India
275219,2023-11-14,501,iphone 15,60000,80000,20000,2,00397,India
275219,2023-11-14,506,monitor,3249,8000,4751,2,00397,India
275219,2023-11-14,504,iron,449,879,430,2,00397,India
275219,2023-11-14,505,oven,18490,24000,5510,2,00397,India
730631,2023-11-14,504,iron,449,879,430,2,00340,India
730631,2023-11-14,506,monitor,3249,8000,4751,2,00340,India
730631,2023-11-14,501,iphone 15,60000,80000,20000,2,00340,India
812402,2023-11-14,506,monitor,3249,8000,4751,2,00312,India
812402,2023-11-14,502,iphone 15 pro max,100000,135000,35000,2,00312,India
420725,2023-11-14,504,iron,449,879,430,2,00254,India
576515,2023-11-14,503,mixer,1349,3249,1900,2,00283,India
576515,2023-11-14,504,iron,449,879,430,2,00283,India
576515,2023-11-14,506,monitor,3249,8000,4751,2,00283,India
576515,2023-11-14,507,washing machine,6990,16490,9500,2,00283,India
576515,2023-11-14,501,iphone 15,60000,80000,20000,2,00283,India
853161,2023-11-14,505,oven,18490,24000,5510,2,00378,India
853161,2023-11-14,504,iron,449,879,430,2,00378,India
853161,2023-11-14,507,washing machine,6990,16490,9500,2,00378,India
923672,2023-11-14,507,washing machine,6990,16490,9500,2,00452,India
923672,2023-11-14,503,mixer,1349,3249,1900,2,00452,India
923672,2023-11-14,506,monitor,3249,8000,4751,2,00452,India
289368,2023-11-14,503,mixer,1349,3249,1900,2,00063,India
289368,2023-11-14,501,iphone 15,60000,80000,20000,2,00063,India
199207,2023-11-14,507,washing machine,6990,16490,9500,2,00477,India
642439,2023-11-14,503,mixer,1349,3249,1900,2,00462,India
642439,2023-11-14,506,monitor,3249,8000,4751,2,00462,India
360030,2023-11-14,504,iron,449,879,430,2,00463,India
360030,2023-11-14,503,mixer,1349,3249,1900,2,00463,India
822811,2023-11-14,506,monitor,3249,8000,4751,2,00071,India
822811,2023-11-14,505,oven,18490,24000,5510,2,00071,India
291249,2023-11-14,507,washing machine,6990,16490,9500,2,00475,India
149282,2023-11-14,506,monitor,3249,8000,4751,2,00384,India
997032,2023-11-14,505,oven,18490,24000,5510,2,00316,India
997032,2023-11-14,503,mixer,1349,3249,1900,2,00316,India
997032,2023-11-14,504,iron,449,879,430,2,00316,India
393329,2023-11-14,504,iron,449,879,430,2,00492,India
634959,2023-11-14,503,mixer,1349,3249,1900,2,00193,India
634959,2023-11-14,502,iphone 15 pro max,100000,135000,35000,2,00193,India
634959,2023-11-14,507,washing machine,6990,16490,9500,2,00193,India
634959,2023-11-14,504,iron,449,879,430,2,00193,India
634959,2023-11-14,506,monitor,3249,8000,4751,2,00193,India
734215,2023-11-14,502,iphone 15 pro max,100000,135000,35000,2,00127,India
734215,2023-11-14,504,iron,449,879,430,2,00127,India
522749,2023-11-14,505,oven,18490,24000,5510,2,00240,India
522749,2023-11-14,502,iphone 15 pro max,100000,135000,35000,2,00240,India
763385,2023-11-14,505,oven,18490,24000,5510,2,00376,India
763385,2023-11-14,503,mixer,1349,3249,1900,2,00376,India
763385,2023-11-14,507,washing machine,6990,16490,9500,2,00376,India
763385,2023-11-14,506,monitor,3249,8000,4751,2,00376,India
911200,2023-11-14,505,oven,18490,24000,5510,2,00349,India
911200,2023-11-14,501,iphone 15,60000,80000,20000,2,00349,India
911200,2023-11-14,507,washing machine,6990,16490,9500,2,00349,India
911200,2023-11-14,502,iphone 15 pro max,100000,135000,35000,2,00349,India
376353,2023-11-14,503,mixer,1349,3249,1900,2,00083,India
376353,2023-11-14,506,monitor,3249,8000,4751,2,00083,India
376353,2023-11-14,502,iphone 15 pro max,100000,135000,35000,2,00083,India
376353,2023-11-14,507,washing machine,6990,16490,9500,2,00083,India
556257,2023-11-14,504,iron,449,879,430,2,00363,India
556257,2023-11-14,507,washing machine,6990,16490,9500,2,00363,India
556257,2023-11-14,503,mixer,1349,3249,1900,2,00363,India
617987,2023-11-14,505,oven,18490,24000,5510,2,00343,India
842275,2023-11-14,501,iphone 15,60000,80000,20000,2,00425,India
842275,2023-11-14,503,mixer,1349,3249,1900,2,00425,India
213416,2023-11-14,503,mixer,1349,3249,1900,2,00049,India
639451,2023-11-14,503,mixer,1349,3249,1900,2,00069,India
639451,2023-11-14,504,iron,449,879,430,2,00069,India
639451,2023-11-14,501,iphone 15,60000,80000,20000,2,00069,India
852842,2023-11-14,503,mixer,1349,3249,1900,2,00076,India
852842,2023-11-14,501,iphone 15,60000,80000,20000,2,00076,India
852842,2023-11-14,504,iron,449,879,430,2,00076,India
852842,2023-11-14,506,monitor,3249,8000,4751,2,00076,India
852842,2023-11-14,505,oven,18490,24000,5510,2,00076,India
455013,2023-11-14,506,monitor,3249,8000,4751,2,00490,India
455013,2023-11-14,507,washing machine,6990,16490,9500,2,00490,India
455013,2023-11-14,501,iphone 15,60000,80000,20000,2,00490,India
707494,2023-11-14,503,mixer,1349,3249,1900,2,00082,India
707494,2023-11-14,501,iphone 15,60000,80000,20000,2,00082,India
707494,2023-11-14,507,washing machine,6990,16490,9500,2,00082,India
906310,2023-11-14,501,iphone 15,60000,80000,20000,2,00382,India
906310,2023-11-14,502,iphone 15 pro max,100000,135000,35000,2,00382,India
906310,2023-11-14,505,oven,18490,24000,5510,2,00382,India
767009,2023-11-14,504,iron,449,879,430,2,00371,India
767009,2023-11-14,505,oven,18490,24000,5510,2,00371,India
767009,2023-11-14,501,iphone 15,60000,80000,20000,2,00371,India
767009,2023-11-14,506,monitor,3249,8000,4751,2,00371,India
692609,2023-11-14,504,iron,449,879,430,2,00185,India
692609,2023-11-14,503,mixer,1349,3249,1900,2,00185,India
692609,2023-11-14,501,iphone 15,60000,80000,20000,2,00185,India
692609,2023-11-14,502,iphone 15 pro max,100000,135000,35000,2,00185,India
100913,2023-11-14,503,mixer,1349,3249,1900,2,00382,India
100913,2023-11-14,501,iphone 15,60000,80000,20000,2,00382,India
292540,2023-11-14,501,iphone 15,60000,80000,20000,2,00466,India
292540,2023-11-14,507,washing machine,6990,16490,9500,2,00466,India
691955,2023-11-14,505,oven,18490,24000,5510,2,00103,India
691955,2023-11-14,506,monitor,3249,8000,4751,2,00103,India
691955,2023-11-14,504,iron,449,879,430,2,00103,India
547055,2023-11-14,501,iphone 15,60000,80000,20000,2,00300,India
547055,2023-11-14,504,iron,449,879,430,2,00300,India
547055,2023-11-14,505,oven,18490,24000,5510,2,00300,India
151073,2023-11-14,501,iphone 15,60000,80000,20000,2,00299,India
151073,2023-11-14,502,iphone 15 pro max,100000,135000,35000,2,00299,India
728745,2023-11-14,507,washing machine,6990,16490,9500,2,00137,India
626638,2023-11-14,503,mixer,1349,3249,1900,2,00076,India
626638,2023-11-14,501,iphone 15,60000,80000,20000,2,00076,India
128104,2023-11-14,507,washing machine,6990,16490,9500,2,00057,India
339346,2023-11-14,502,iphone 15 pro max,100000,135000,35000,2,00030,India
742919,2023-11-14,502,iphone 15 pro max,100000,135000,35000,2,00359,India
742919,2023-11-14,507,washing machine,6990,16490,9500,2,00359,India
742919,2023-11-14,505,oven,18490,24000,5510,2,00359,India
615846,2023-11-14,501,iphone 15,60000,80000,20000,2,00439,India
615846,2023-11-14,503,mixer,1349,3249,1900,2,00439,India
615846,2023-11-14,505,oven,18490,24000,5510,2,00439,India
725136,2023-11-14,502,iphone 15 pro max,100000,135000,35000,2,00076,India
725136,2023-11-14,501,iphone 15,60000,80000,20000,2,00076,India
365896,2023-11-14,501,iphone 15,60000,80000,20000,2,00140,India
365896,2023-11-14,507,washing machine,6990,16490,9500,2,00140,India
365896,2023-11-14,505,oven,18490,24000,5510,2,00140,India
685371,2023-11-14,501,iphone 15,60000,80000,20000,2,00430,India
685371,2023-11-14,506,monitor,3249,8000,4751,2,00430,India
685371,2023-11-14,507,washing machine,6990,16490,9500,2,00430,India
685371,2023-11-14,503,mixer,1349,3249,1900,2,00430,India
606525,2023-11-14,501,iphone 15,60000,80000,20000,2,00019,India
606525,2023-11-14,505,oven,18490,24000,5510,2,00019,India
627102,2023-11-14,503,mixer,1349,3249,1900,2,00419,India
627102,2023-11-14,506,monitor,3249,8000,4751,2,00419,India
627102,2023-11-14,507,washing machine,6990,16490,9500,2,00419,India
729477,2023-11-14,503,mixer,1349,3249,1900,2,00051,India
729477,2023-11-14,506,monitor,3249,8000,4751,2,00051,India
729477,2023-11-14,502,iphone 15 pro max,100000,135000,35000,2,00051,India
729477,2023-11-14,501,iphone 15,60000,80000,20000,2,00051,India
366280,2023-11-14,501,iphone 15,60000,80000,20000,2,00006,India
923600,2023-11-14,501,iphone 15,60000,80000,20000,2,00446,India
923600,2023-11-14,505,oven,18490,24000,5510,2,00446,India
923600,2023-11-14,504,iron,449,879,430,2,00446,India
185039,2023-11-14,503,mixer,1349,3249,1900,2,00026,India
645302,2023-11-14,506,monitor,3249,8000,4751,2,00392,India
330814,2023-11-14,505,oven,18490,24000,5510,2,00388,India
724642,2023-11-14,504,iron,449,879,430,2,00331,India
724642,2023-11-14,505,oven,18490,24000,5510,2,00331,India
451722,2023-11-14,505,oven,18490,24000,5510,2,00193,India
451722,2023-11-14,502,iphone 15 pro max,100000,135000,35000,2,00193,India
451722,2023-11-14,506,monitor,3249,8000,4751,2,00193,India
664844,2023-11-15,506,monitor,3249,8000,4751,2,00237,India
527451,2023-11-15,505,oven,18490,24000,5510,2,00072,India
527451,2023-11-15,502,iphone 15 pro max,100000,135000,35000,2,00072,India
419245,2023-11-15,503,mixer,1349,3249,1900,2,00381,India
419245,2023-11-15,506,monitor,3249,8000,4751,2,00381,India
872955,2023-11-15,502,iphone 15 pro max,100000,135000,35000,2,00173,India
872955,2023-11-15,501,iphone 15,60000,80000,20000,2,00173,India
872955,2023-11-15,503,mixer,1349,3249,1900,2,00173,India
872955,2023-11-15,505,oven,18490,24000,5510,2,00173,India
882218,2023-11-15,507,washing machine,6990,16490,9500,2,00033,India
882218,2023-11-15,506,monitor,3249,8000,4751,2,00033,India
882218,2023-11-15,505,oven,18490,24000,5510,2,00033,India
889337,2023-11-15,505,oven,18490,24000,5510,2,00400,India
648414,2023-11-15,507,washing machine,6990,16490,9500,2,00359,India
648414,2023-11-15,504,iron,449,879,430,2,00359,India
648414,2023-11-15,506,monitor,3249,8000,4751,2,00359,India
690794,2023-11-15,505,oven,18490,24000,5510,2,00009,India
690794,2023-11-15,504,iron,449,879,430,2,00009,India
690794,2023-11-15,501,iphone 15,60000,80000,20000,2,00009,India
690794,2023-11-15,507,washing machine,6990,16490,9500,2,00009,India
152043,2023-11-15,507,washing machine,6990,16490,9500,2,00073,India
152043,2023-11-15,501,iphone 15,60000,80000,20000,2,00073,India
893099,2023-11-15,506,monitor,3249,8000,4751,2,00404,India
893099,2023-11-15,507,washing machine,6990,16490,9500,2,00404,India
462813,2023-11-15,506,monitor,3249,8000,4751,2,00317,India
607676,2023-11-15,503,mixer,1349,3249,1900,2,00414,India
607676,2023-11-15,505,oven,18490,24000,5510,2,00414,India
418782,2023-11-15,501,iphone 15,60000,80000,20000,2,00064,India
418782,2023-11-15,506,monitor,3249,8000,4751,2,00064,India
418782,2023-11-15,507,washing machine,6990,16490,9500,2,00064,India
869964,2023-11-15,505,oven,18490,24000,5510,2,00256,India
325423,2023-11-15,503,mixer,1349,3249,1900,2,00306,India
554406,2023-11-15,505,oven,18490,24000,5510,2,00184,India
554406,2023-11-15,506,monitor,3249,8000,4751,2,00184,India
554406,2023-11-15,502,iphone 15 pro max,100000,135000,35000,2,00184,India
539298,2023-11-15,501,iphone 15,60000,80000,20000,2,00382,India
124111,2023-11-15,507,washing machine,6990,16490,9500,2,00372,India
697380,2023-11-15,507,washing machine,6990,16490,9500,2,00375,India
693882,2023-11-15,504,iron,449,879,430,2,00399,India
693882,2023-11-15,503,mixer,1349,3249,1900,2,00399,India
693882,2023-11-15,507,washing machine,6990,16490,9500,2,00399,India
693882,2023-11-15,502,iphone 15 pro max,100000,135000,35000,2,00399,India
222635,2023-11-15,503,mixer,1349,3249,1900,2,00269,India
690015,2023-11-15,503,mixer,1349,3249,1900,2,00398,India
690015,2023-11-15,504,iron,449,879,430,2,00398,India
115868,2023-11-15,501,iphone 15,60000,80000,20000,2,00430,India
115868,2023-11-15,502,iphone 15 pro max,100000,135000,35000,2,00430,India
115868,2023-11-15,504,iron,449,879,430,2,00430,India
115868,2023-11-15,503,mixer,1349,3249,1900,2,00430,India
792071,2023-11-15,507,washing machine,6990,16490,9500,2,00307,India
792071,2023-11-15,502,iphone 15 pro max,100000,135000,35000,2,00307,India
792071,2023-11-15,501,iphone 15,60000,80000,20000,2,00307,India
792071,2023-11-15,506,monitor,3249,8000,4751,2,00307,India
445953,2023-11-15,504,iron,449,879,430,2,00336,India
699218,2023-11-15,504,iron,449,879,430,2,00427,India
699218,2023-11-15,505,oven,18490,24000,5510,2,00427,India
391272,2023-11-15,504,iron,449,879,430,2,00054,India
391272,2023-11-15,506,monitor,3249,8000,4751,2,00054,India
242330,2023-11-15,501,iphone 15,60000,80000,20000,2,00305,India
242330,2023-11-15,504,iron,449,879,430,2,00305,India
226468,2023-11-15,503,mixer,1349,3249,1900,2,00074,India
226468,2023-11-15,502,iphone 15 pro max,100000,135000,35000,2,00074,India
226468,2023-11-15,504,iron,449,879,430,2,00074,India
226468,2023-11-15,501,iphone 15,60000,80000,20000,2,00074,India
259736,2023-11-15,503,mixer,1349,3249,1900,2,00060,India
286517,2023-11-15,503,mixer,1349,3249,1900,2,00025,India
730917,2023-11-15,507,washing machine,6990,16490,9500,2,00293,India
730917,2023-11-15,502,iphone 15 pro max,100000,135000,35000,2,00293,India
724955,2023-11-15,506,monitor,3249,8000,4751,2,00261,India
371389,2023-11-15,506,monitor,3249,8000,4751,2,00346,India
371389,2023-11-15,503,mixer,1349,3249,1900,2,00346,India
371389,2023-11-15,507,washing machine,6990,16490,9500,2,00346,India
775083,2023-11-15,505,oven,18490,24000,5510,2,00255,India
775083,2023-11-15,507,washing machine,6990,16490,9500,2,00255,India
775083,2023-11-15,501,iphone 15,60000,80000,20000,2,00255,India
775083,2023-11-15,502,iphone 15 pro max,100000,135000,35000,2,00255,India
506827,2023-11-15,505,oven,18490,24000,5510,2,00235,India
506827,2023-11-15,504,iron,449,879,430,2,00235,India
315626,2023-11-15,506,monitor,3249,8000,4751,2,00219,India
315626,2023-11-15,505,oven,18490,24000,5510,2,00219,India
315968,2023-11-15,507,washing machine,6990,16490,9500,2,00426,India
315968,2023-11-15,504,iron,449,879,430,2,00426,India
315968,2023-11-15,506,monitor,3249,8000,4751,2,00426,India
315968,2023-11-15,502,iphone 15 pro max,100000,135000,35000,2,00426,India
154730,2023-11-15,507,washing machine,6990,16490,9500,2,00029,India
154730,2023-11-15,502,iphone 15 pro max,100000,135000,35000,2,00029,India
317713,2023-11-15,504,iron,449,879,430,2,00369,India
317713,2023-11-15,503,mixer,1349,3249,1900,2,00369,India
317713,2023-11-15,502,iphone 15 pro max,100000,135000,35000,2,00369,India
485587,2023-11-15,504,iron,449,879,430,2,00229,India
485587,2023-11-15,503,mixer,1349,3249,1900,2,00229,India
171100,2023-11-15,507,washing machine,6990,16490,9500,2,00392,India
171100,2023-11-15,503,mixer,1349,3249,1900,2,00392,India
171100,2023-11-15,501,iphone 15,60000,80000,20000,2,00392,India
171100,2023-11-15,504,iron,449,879,430,2,00392,India
930667,2023-11-15,503,mixer,1349,3249,1900,2,00467,India
930667,2023-11-15,502,iphone 15 pro max,100000,135000,35000,2,00467,India
930667,2023-11-15,501,iphone 15,60000,80000,20000,2,00467,India
496274,2023-11-15,505,oven,18490,24000,5510,2,00196,India
496274,2023-11-15,506,monitor,3249,8000,4751,2,00196,India
496274,2023-11-15,503,mixer,1349,3249,1900,2,00196,India
496274,2023-11-15,504,iron,449,879,430,2,00196,India
232408,2023-11-15,501,iphone 15,60000,80000,20000,2,00167,India
232408,2023-11-15,507,washing machine,6990,16490,9500,2,00167,India
590473,2023-11-15,501,iphone 15,60000,80000,20000,2,00499,India
590473,2023-11-15,506,monitor,3249,8000,4751,2,00499,India
590473,2023-11-15,507,washing machine,6990,16490,9500,2,00499,India
853798,2023-11-15,507,washing machine,6990,16490,9500,2,00368,India
449663,2023-11-15,504,iron,449,879,430,2,00241,India
449663,2023-11-15,503,mixer,1349,3249,1900,2,00241,India
123236,2023-11-15,503,mixer,1349,3249,1900,2,00126,India
123236,2023-11-15,506,monitor,3249,8000,4751,2,00126,India
123236,2023-11-15,504,iron,449,879,430,2,00126,India
123236,2023-11-15,505,oven,18490,24000,5510,2,00126,India
518120,2023-11-15,503,mixer,1349,3249,1900,2,00149,India
518120,2023-11-15,506,monitor,3249,8000,4751,2,00149,India
725983,2023-11-15,504,iron,449,879,430,2,00192,India
725983,2023-11-15,505,oven,18490,24000,5510,2,00192,India
725983,2023-11-15,503,mixer,1349,3249,1900,2,00192,India
136631,2023-11-15,501,iphone 15,60000,80000,20000,2,00494,India
136631,2023-11-15,502,iphone 15 pro max,100000,135000,35000,2,00494,India
136631,2023-11-15,507,washing machine,6990,16490,9500,2,00494,India
480007,2023-11-15,507,washing machine,6990,16490,9500,2,00130,India
480007,2023-11-15,506,monitor,3249,8000,4751,2,00130,India
208028,2023-11-15,505,oven,18490,24000,5510,2,00061,India
208028,2023-11-15,502,iphone 15 pro max,100000,135000,35000,2,00061,India
357503,2023-11-15,502,iphone 15 pro max,100000,135000,35000,2,00089,India
371780,2023-11-15,505,oven,18490,24000,5510,2,00230,India
371780,2023-11-15,504,iron,449,879,430,2,00230,India
371780,2023-11-15,503,mixer,1349,3249,1900,2,00230,India
371780,2023-11-15,501,iphone 15,60000,80000,20000,2,00230,India
532160,2023-11-15,504,iron,449,879,430,2,00302,India
532160,2023-11-15,501,iphone 15,60000,80000,20000,2,00302,India
532160,2023-11-15,506,monitor,3249,8000,4751,2,00302,India
532160,2023-11-15,502,iphone 15 pro max,100000,135000,35000,2,00302,India
194946,2023-11-16,503,mixer,1349,3249,1900,2,00244,India
194946,2023-11-16,504,iron,449,879,430,2,00244,India
628933,2023-11-16,502,iphone 15 pro max,100000,135000,35000,2,00119,India
421915,2023-11-16,501,iphone 15,60000,80000,20000,2,00325,India
421915,2023-11-16,507,washing machine,6990,16490,9500,2,00325,India
803983,2023-11-16,503,mixer,1349,3249,1900,2,00113,India
111483,2023-11-16,502,iphone 15 pro max,100000,135000,35000,2,00378,India
111483,2023-11-16,505,oven,18490,24000,5510,2,00378,India
378604,2023-11-16,506,monitor,3249,8000,4751,2,00148,India
378604,2023-11-16,501,iphone 15,60000,80000,20000,2,00148,India
378604,2023-11-16,503,mixer,1349,3249,1900,2,00148,India
531133,2023-11-16,504,iron,449,879,430,2,00246,India
531133,2023-11-16,503,mixer,1349,3249,1900,2,00246,India
644466,2023-11-16,506,monitor,3249,8000,4751,2,00423,India
644466,2023-11-16,504,iron,449,879,430,2,00423,India
644466,2023-11-16,502,iphone 15 pro max,100000,135000,35000,2,00423,India
908879,2023-11-16,501,iphone 15,60000,80000,20000,2,00299,India
908879,2023-11-16,507,washing machine,6990,16490,9500,2,00299,India
908879,2023-11-16,503,mixer,1349,3249,1900,2,00299,India
908879,2023-11-16,502,iphone 15 pro max,100000,135000,35000,2,00299,India
425392,2023-11-16,504,iron,449,879,430,2,00399,India
425392,2023-11-16,507,washing machine,6990,16490,9500,2,00399,India
425392,2023-11-16,503,mixer,1349,3249,1900,2,00399,India
425392,2023-11-16,506,monitor,3249,8000,4751,2,00399,India
816622,2023-11-16,507,washing machine,6990,16490,9500,2,00284,India
455545,2023-11-16,507,washing machine,6990,16490,9500,2,00498,India
455545,2023-11-16,505,oven,18490,24000,5510,2,00498,India
455545,2023-11-16,504,iron,449,879,430,2,00498,India
455545,2023-11-16,506,monitor,3249,8000,4751,2,00498,India
497654,2023-11-16,506,monitor,3249,8000,4751,2,00284,India
497654,2023-11-16,503,mixer,1349,3249,1900,2,00284,India
497654,2023-11-16,507,washing machine,6990,16490,9500,2,00284,India
497654,2023-11-16,505,oven,18490,24000,5510,2,00284,India
666903,2023-11-16,503,mixer,1349,3249,1900,2,00158,India
666903,2023-11-16,501,iphone 15,60000,80000,20000,2,00158,India
420633,2023-11-16,503,mixer,1349,3249,1900,2,00064,India
420633,2023-11-16,505,oven,18490,24000,5510,2,00064,India
420633,2023-11-16,506,monitor,3249,8000,4751,2,00064,India
909163,2023-11-16,501,iphone 15,60000,80000,20000,2,00013,India
909163,2023-11-16,502,iphone 15 pro max,100000,135000,35000,2,00013,India
909163,2023-11-16,504,iron,449,879,430,2,00013,India
926299,2023-11-16,505,oven,18490,24000,5510,2,00410,India
926299,2023-11-16,504,iron,449,879,430,2,00410,India
131893,2023-11-16,504,iron,449,879,430,2,00001,India
131893,2023-11-16,505,oven,18490,24000,5510,2,00001,India
131893,2023-11-16,501,iphone 15,60000,80000,20000,2,00001,India
289288,2023-11-16,503,mixer,1349,3249,1900,2,00191,India
289288,2023-11-16,504,iron,449,879,430,2,00191,India
955064,2023-11-16,506,monitor,3249,8000,4751,2,00067,India
955064,2023-11-16,507,washing machine,6990,16490,9500,2,00067,India
916985,2023-11-16,502,iphone 15 pro max,100000,135000,35000,2,00009,India
925239,2023-11-16,504,iron,449,879,430,2,00430,India
925239,2023-11-16,506,monitor,3249,8000,4751,2,00430,India
925239,2023-11-16,501,iphone 15,60000,80000,20000,2,00430,India
925239,2023-11-16,507,washing machine,6990,16490,9500,2,00430,India
188278,2023-11-16,506,monitor,3249,8000,4751,2,00386,India
188278,2023-11-16,502,iphone 15 pro max,100000,135000,35000,2,00386,India
188278,2023-11-16,505,oven,18490,24000,5510,2,00386,India
167160,2023-11-16,505,oven,18490,24000,5510,2,00105,India
334160,2023-11-16,505,oven,18490,24000,5510,2,00271,India
334160,2023-11-16,503,mixer,1349,3249,1900,2,00271,India
334160,2023-11-16,504,iron,449,879,430,2,00271,India
246876,2023-11-16,502,iphone 15 pro max,100000,135000,35000,2,00327,India
246876,2023-11-16,505,oven,18490,24000,5510,2,00327,India
246876,2023-11-16,501,iphone 15,60000,80000,20000,2,00327,India
946847,2023-11-16,503,mixer,1349,3249,1900,2,00156,India
946847,2023-11-16,506,monitor,3249,8000,4751,2,00156,India
707594,2023-11-16,505,oven,18490,24000,5510,2,00125,India
707594,2023-11-16,506,monitor,3249,8000,4751,2,00125,India
287796,2023-11-16,504,iron,449,879,430,2,00499,India
287796,2023-11-16,503,mixer,1349,3249,1900,2,00499,India
287796,2023-11-16,507,washing machine,6990,16490,9500,2,00499,India
351175,2023-11-16,507,washing machine,6990,16490,9500,2,00235,India
351175,2023-11-16,504,iron,449,879,430,2,00235,India
351175,2023-11-16,503,mixer,1349,3249,1900,2,00235,India
351175,2023-11-16,502,iphone 15 pro max,100000,135000,35000,2,00235,India
972018,2023-11-16,507,washing machine,6990,16490,9500,2,00098,India
475921,2023-11-16,505,oven,18490,24000,5510,2,00464,India
475921,2023-11-16,502,iphone 15 pro max,100000,135000,35000,2,00464,India
475921,2023-11-16,501,iphone 15,60000,80000,20000,2,00464,India
382018,2023-11-16,503,mixer,1349,3249,1900,2,00459,India
512419,2023-11-16,505,oven,18490,24000,5510,2,00490,India
512419,2023-11-16,503,mixer,1349,3249,1900,2,00490,India
512419,2023-11-16,504,iron,449,879,430,2,00490,India
158447,2023-11-16,503,mixer,1349,3249,1900,2,00175,India
158447,2023-11-16,507,washing machine,6990,16490,9500,2,00175,India
158447,2023-11-16,504,iron,449,879,430,2,00175,India
158447,2023-11-16,501,iphone 15,60000,80000,20000,2,00175,India
603552,2023-11-16,502,iphone 15 pro max,100000,135000,35000,2,00472,India
603552,2023-11-16,507,washing machine,6990,16490,9500,2,00472,India
603552,2023-11-16,503,mixer,1349,3249,1900,2,00472,India
780569,2023-11-16,503,mixer,1349,3249,1900,2,00174,India
780569,2023-11-16,507,washing machine,6990,16490,9500,2,00174,India
408681,2023-11-16,502,iphone 15 pro max,100000,135000,35000,2,00301,India
408681,2023-11-16,504,iron,449,879,430,2,00301,India
776284,2023-11-16,501,iphone 15,60000,80000,20000,2,00194,India
776284,2023-11-16,507,washing machine,6990,16490,9500,2,00194,India
955523,2023-11-16,502,iphone 15 pro max,100000,135000,35000,2,00134,India
955523,2023-11-16,507,washing machine,6990,16490,9500,2,00134,India
845394,2023-11-16,503,mixer,1349,3249,1900,2,00262,India
343262,2023-11-16,502,iphone 15 pro max,100000,135000,35000,2,00440,India
343262,2023-11-16,506,monitor,3249,8000,4751,2,00440,India
367803,2023-11-16,502,iphone 15 pro max,100000,135000,35000,2,00319,India
484701,2023-11-16,505,oven,18490,24000,5510,2,00237,India
628391,2023-11-16,505,oven,18490,24000,5510,2,00228,India
544139,2023-11-16,504,iron,449,879,430,2,00375,India
544139,2023-11-16,506,monitor,3249,8000,4751,2,00375,India
895224,2023-11-16,503,mixer,1349,3249,1900,2,00300,India
703452,2023-11-16,506,monitor,3249,8000,4751,2,00490,India
844576,2023-11-16,506,monitor,3249,8000,4751,2,00086,India
844576,2023-11-16,505,oven,18490,24000,5510,2,00086,India
844576,2023-11-16,501,iphone 15,60000,80000,20000,2,00086,India
687841,2023-11-16,506,monitor,3249,8000,4751,2,00016,India
687841,2023-11-16,503,mixer,1349,3249,1900,2,00016,India
565369,2023-11-16,505,oven,18490,24000,5510,2,00112,India
565369,2023-11-16,503,mixer,1349,3249,1900,2,00112,India
554882,2023-11-16,504,iron,449,879,430,2,00338,India
637728,2023-11-16,504,iron,449,879,430,2,00286,India
637728,2023-11-16,506,monitor,3249,8000,4751,2,00286,India
637728,2023-11-16,505,oven,18490,24000,5510,2,00286,India
637728,2023-11-16,507,washing machine,6990,16490,9500,2,00286,India
185224,2023-11-16,506,monitor,3249,8000,4751,2,00365,India
185224,2023-11-16,501,iphone 15,60000,80000,20000,2,00365,India
185224,2023-11-16,504,iron,449,879,430,2,00365,India
185224,2023-11-16,503,mixer,1349,3249,1900,2,00365,India
373318,2023-11-16,503,mixer,1349,3249,1900,2,00122,India
373318,2023-11-16,504,iron,449,879,430,2,00122,India
373318,2023-11-16,502,iphone 15 pro max,100000,135000,35000,2,00122,India
667244,2023-11-16,501,iphone 15,60000,80000,20000,2,00455,India
667244,2023-11-16,505,oven,18490,24000,5510,2,00455,India
667244,2023-11-16,503,mixer,1349,3249,1900,2,00455,India
667244,2023-11-16,507,washing machine,6990,16490,9500,2,00455,India
667244,2023-11-16,504,iron,449,879,430,2,00455,India
402078,2023-11-16,501,iphone 15,60000,80000,20000,2,00303,India
402078,2023-11-16,505,oven,18490,24000,5510,2,00303,India
415656,2023-11-16,506,monitor,3249,8000,4751,2,00103,India
901340,2023-11-16,506,monitor,3249,8000,4751,2,00276,India
901340,2023-11-16,507,washing machine,6990,16490,9500,2,00276,India
482694,2023-11-17,506,monitor,3249,8000,4751,2,00390,India
482694,2023-11-17,502,iphone 15 pro max,100000,135000,35000,2,00390,India
743348,2023-11-17,506,monitor,3249,8000,4751,2,00182,India
743348,2023-11-17,505,oven,18490,24000,5510,2,00182,India
841934,2023-11-17,503,mixer,1349,3249,1900,2,00072,India
841934,2023-11-17,501,iphone 15,60000,80000,20000,2,00072,India
841934,2023-11-17,507,washing machine,6990,16490,9500,2,00072,India
660726,2023-11-17,505,oven,18490,24000,5510,2,00029,India
660726,2023-11-17,502,iphone 15 pro max,100000,135000,35000,2,00029,India
660726,2023-11-17,507,washing machine,6990,16490,9500,2,00029,India
122671,2023-11-17,505,oven,18490,24000,5510,2,00133,India
122671,2023-11-17,504,iron,449,879,430,2,00133,India
122671,2023-11-17,502,iphone 15 pro max,100000,135000,35000,2,00133,India
122671,2023-11-17,507,washing machine,6990,16490,9500,2,00133,India
488809,2023-11-17,504,iron,449,879,430,2,00376,India
488809,2023-11-17,502,iphone 15 pro max,100000,135000,35000,2,00376,India
488809,2023-11-17,507,washing machine,6990,16490,9500,2,00376,India
590677,2023-11-17,505,oven,18490,24000,5510,2,00189,India
590677,2023-11-17,506,monitor,3249,8000,4751,2,00189,India
590677,2023-11-17,502,iphone 15 pro max,100000,135000,35000,2,00189,India
590677,2023-11-17,507,washing machine,6990,16490,9500,2,00189,India
775502,2023-11-17,502,iphone 15 pro max,100000,135000,35000,2,00343,India
775502,2023-11-17,506,monitor,3249,8000,4751,2,00343,India
775502,2023-11-17,507,washing machine,6990,16490,9500,2,00343,India
775502,2023-11-17,501,iphone 15,60000,80000,20000,2,00343,India
220790,2023-11-17,506,monitor,3249,8000,4751,2,00254,India
220790,2023-11-17,503,mixer,1349,3249,1900,2,00254,India
220790,2023-11-17,501,iphone 15,60000,80000,20000,2,00254,India
605127,2023-11-17,504,iron,449,879,430,2,00351,India
355747,2023-11-17,503,mixer,1349,3249,1900,2,00282,India
355747,2023-11-17,507,washing machine,6990,16490,9500,2,00282,India
205809,2023-11-17,503,mixer,1349,3249,1900,2,00465,India
214900,2023-11-17,501,iphone 15,60000,80000,20000,2,00159,India
252206,2023-11-17,507,washing machine,6990,16490,9500,2,00488,India
986150,2023-11-17,503,mixer,1349,3249,1900,2,00134,India
986150,2023-11-17,507,washing machine,6990,16490,9500,2,00134,India
373311,2023-11-17,504,iron,449,879,430,2,00001,India
373311,2023-11-17,501,iphone 15,60000,80000,20000,2,00001,India
373311,2023-11-17,505,oven,18490,24000,5510,2,00001,India
192500,2023-11-17,506,monitor,3249,8000,4751,2,00344,India
192500,2023-11-17,504,iron,449,879,430,2,00344,India
537069,2023-11-17,501,iphone 15,60000,80000,20000,2,00354,India
537069,2023-11-17,503,mixer,1349,3249,1900,2,00354,India
410260,2023-11-17,503,mixer,1349,3249,1900,2,00177,India
410260,2023-11-17,501,iphone 15,60000,80000,20000,2,00177,India
410260,2023-11-17,504,iron,449,879,430,2,00177,India
885931,2023-11-17,503,mixer,1349,3249,1900,2,00021,India
901434,2023-11-17,502,iphone 15 pro max,100000,135000,35000,2,00481,India
394140,2023-11-17,504,iron,449,879,430,2,00188,India
753732,2023-11-17,504,iron,449,879,430,2,00434,India
753732,2023-11-17,506,monitor,3249,8000,4751,2,00434,India
813374,2023-11-17,506,monitor,3249,8000,4751,2,00290,India
813374,2023-11-17,504,iron,449,879,430,2,00290,India
894058,2023-11-17,502,iphone 15 pro max,100000,135000,35000,2,00042,India
355522,2023-11-17,502,iphone 15 pro max,100000,135000,35000,2,00117,India
355522,2023-11-17,503,mixer,1349,3249,1900,2,00117,India
524453,2023-11-17,507,washing machine,6990,16490,9500,2,00358,India
524453,2023-11-17,504,iron,449,879,430,2,00358,India
524453,2023-11-17,503,mixer,1349,3249,1900,2,00358,India
212286,2023-11-17,506,monitor,3249,8000,4751,2,00214,India
212286,2023-11-17,501,iphone 15,60000,80000,20000,2,00214,India
833322,2023-11-17,503,mixer,1349,3249,1900,2,00152,India
833322,2023-11-17,506,monitor,3249,8000,4751,2,00152,India
658731,2023-11-17,502,iphone 15 pro max,100000,135000,35000,2,00314,India
658731,2023-11-17,503,mixer,1349,3249,1900,2,00314,India
658731,2023-11-17,501,iphone 15,60000,80000,20000,2,00314,India
658731,2023-11-17,507,washing machine,6990,16490,9500,2,00314,India
945034,2023-11-17,507,washing machine,6990,16490,9500,2,00145,India
945034,2023-11-17,503,mixer,1349,3249,1900,2,00145,India
124504,2023-11-17,507,washing machine,6990,16490,9500,2,00462,India
894156,2023-11-17,507,washing machine,6990,16490,9500,2,00414,India
894156,2023-11-17,505,oven,18490,24000,5510,2,00414,India
894156,2023-11-17,503,mixer,1349,3249,1900,2,00414,India
894156,2023-11-17,502,iphone 15 pro max,100000,135000,35000,2,00414,India
954452,2023-11-17,507,washing machine,6990,16490,9500,2,00069,India
954452,2023-11-17,503,mixer,1349,3249,1900,2,00069,India
954452,2023-11-17,506,monitor,3249,8000,4751,2,00069,India
784610,2023-11-17,507,washing machine,6990,16490,9500,2,00024,India
784610,2023-11-17,506,monitor,3249,8000,4751,2,00024,India
784610,2023-11-17,505,oven,18490,24000,5510,2,00024,India
784610,2023-11-17,504,iron,449,879,430,2,00024,India
536620,2023-11-17,502,iphone 15 pro max,100000,135000,35000,2,00424,India
536620,2023-11-17,507,washing machine,6990,16490,9500,2,00424,India
544997,2023-11-17,501,iphone 15,60000,80000,20000,2,00439,India
544997,2023-11-17,505,oven,18490,24000,5510,2,00439,India
544997,2023-11-17,506,monitor,3249,8000,4751,2,00439,India
366580,2023-11-17,505,oven,18490,24000,5510,2,00273,India
366580,2023-11-17,504,iron,449,879,430,2,00273,India
825406,2023-11-17,503,mixer,1349,3249,1900,2,00377,India
969333,2023-11-17,505,oven,18490,24000,5510,2,00306,India
969333,2023-11-17,502,iphone 15 pro max,100000,135000,35000,2,00306,India
969333,2023-11-17,507,washing machine,6990,16490,9500,2,00306,India
969333,2023-11-17,504,iron,449,879,430,2,00306,India
528892,2023-11-17,505,oven,18490,24000,5510,2,00136,India
942238,2023-11-17,506,monitor,3249,8000,4751,2,00096,India
743546,2023-11-17,502,iphone 15 pro max,100000,135000,35000,2,00425,India
249864,2023-11-17,502,iphone 15 pro max,100000,135000,35000,2,00307,India
249864,2023-11-17,507,washing machine,6990,16490,9500,2,00307,India
475300,2023-11-17,502,iphone 15 pro max,100000,135000,35000,2,00224,India
475300,2023-11-17,506,monitor,3249,8000,4751,2,00224,India
475300,2023-11-17,503,mixer,1349,3249,1900,2,00224,India
698835,2023-11-17,505,oven,18490,24000,5510,2,00301,India
410326,2023-11-17,502,iphone 15 pro max,100000,135000,35000,2,00408,India
357725,2023-11-17,505,oven,18490,24000,5510,2,00203,India
483344,2023-11-17,504,iron,449,879,430,2,00268,India
483344,2023-11-17,502,iphone 15 pro max,100000,135000,35000,2,00268,India
430367,2023-11-17,505,oven,18490,24000,5510,2,00248,India
537290,2023-11-17,505,oven,18490,24000,5510,2,00064,India
112577,2023-11-17,505,oven,18490,24000,5510,2,00133,India
112577,2023-11-17,507,washing machine,6990,16490,9500,2,00133,India
112577,2023-11-17,506,monitor,3249,8000,4751,2,00133,India
112577,2023-11-17,503,mixer,1349,3249,1900,2,00133,India
474035,2023-11-17,501,iphone 15,60000,80000,20000,2,00127,India
644994,2023-11-17,501,iphone 15,60000,80000,20000,2,00369,India
644994,2023-11-17,507,washing machine,6990,16490,9500,2,00369,India
719358,2023-11-17,504,iron,449,879,430,2,00116,India
719358,2023-11-17,501,iphone 15,60000,80000,20000,2,00116,India
464727,2023-11-17,505,oven,18490,24000,5510,2,00361,India
543350,2023-11-17,504,iron,449,879,430,2,00401,India
120746,2023-11-17,503,mixer,1349,3249,1900,2,00091,India
120746,2023-11-17,505,oven,18490,24000,5510,2,00091,India
120746,2023-11-17,507,washing machine,6990,16490,9500,2,00091,India
120746,2023-11-17,502,iphone 15 pro max,100000,135000,35000,2,00091,India
221698,2023-11-17,504,iron,449,879,430,2,00286,India
221698,2023-11-17,507,washing machine,6990,16490,9500,2,00286,India
221698,2023-11-17,506,monitor,3249,8000,4751,2,00286,India
977394,2023-11-17,504,iron,449,879,430,2,00243,India
977394,2023-11-17,502,iphone 15 pro max,100000,135000,35000,2,00243,India
345651,2023-11-17,504,iron,449,879,430,2,00168,India
345651,2023-11-17,502,iphone 15 pro max,100000,135000,35000,2,00168,India
345651,2023-11-17,501,iphone 15,60000,80000,20000,2,00168,India
379045,2023-11-17,506,monitor,3249,8000,4751,2,00007,India
379045,2023-11-17,504,iron,449,879,430,2,00007,India
379045,2023-11-17,507,washing machine,6990,16490,9500,2,00007,India
379045,2023-11-17,505,oven,18490,24000,5510,2,00007,India
484559,2023-11-17,507,washing machine,6990,16490,9500,2,00180,India
567867,2023-11-17,504,iron,449,879,430,2,00109,India
567867,2023-11-17,502,iphone 15 pro max,100000,135000,35000,2,00109,India
567867,2023-11-17,503,mixer,1349,3249,1900,2,00109,India
863117,2023-11-17,502,iphone 15 pro max,100000,135000,35000,2,00300,India
863117,2023-11-17,507,washing machine,6990,16490,9500,2,00300,India
931324,2023-11-17,502,iphone 15 pro max,100000,135000,35000,2,00318,India
931324,2023-11-17,506,monitor,3249,8000,4751,2,00318,India
146663,2023-11-17,504,iron,449,879,430,2,00212,India
146663,2023-11-17,501,iphone 15,60000,80000,20000,2,00212,India
146663,2023-11-17,507,washing machine,6990,16490,9500,2,00212,India
146663,2023-11-17,502,iphone 15 pro max,100000,135000,35000,2,00212,India
239363,2023-11-17,507,washing machine,6990,16490,9500,2,00230,India
239363,2023-11-17,505,oven,18490,24000,5510,2,00230,India
369323,2023-11-17,506,monitor,3249,8000,4751,2,00276,India
369323,2023-11-17,505,oven,18490,24000,5510,2,00276,India
369323,2023-11-17,502,iphone 15 pro max,100000,135000,35000,2,00276,India
369323,2023-11-17,504,iron,449,879,430,2,00276,India
156018,2023-11-17,501,iphone 15,60000,80000,20000,2,00054,India
156018,2023-11-17,505,oven,18490,24000,5510,2,00054,India
156018,2023-11-17,507,washing machine,6990,16490,9500,2,00054,India
186384,2023-11-17,502,iphone 15 pro max,100000,135000,35000,2,00065,India
186384,2023-11-17,503,mixer,1349,3249,1900,2,00065,India
186384,2023-11-17,506,monitor,3249,8000,4751,2,00065,India
973852,2023-11-17,507,washing machine,6990,16490,9500,2,00012,India
973852,2023-11-17,501,iphone 15,60000,80000,20000,2,00012,India
973852,2023-11-17,504,iron,449,879,430,2,00012,India
363256,2023-11-17,504,iron,449,879,430,2,00419,India
363256,2023-11-17,506,monitor,3249,8000,4751,2,00419,India
641632,2023-11-17,505,oven,18490,24000,5510,2,00368,India
641632,2023-11-17,501,iphone 15,60000,80000,20000,2,00368,India
641632,2023-11-17,503,mixer,1349,3249,1900,2,00368,India
437181,2023-11-17,501,iphone 15,60000,80000,20000,2,00490,India
437181,2023-11-17,506,monitor,3249,8000,4751,2,00490,India
437181,2023-11-17,507,washing machine,6990,16490,9500,2,00490,India
437181,2023-11-17,503,mixer,1349,3249,1900,2,00490,India
437181,2023-11-17,505,oven,18490,24000,5510,2,00490,India
855453,2023-11-18,504,iron,449,879,430,2,00214,India
855453,2023-11-18,502,iphone 15 pro max,100000,135000,35000,2,00214,India
855453,2023-11-18,503,mixer,1349,3249,1900,2,00214,India
568356,2023-11-18,501,iphone 15,60000,80000,20000,2,00157,India
568356,2023-11-18,507,washing machine,6990,16490,9500,2,00157,India
568356,2023-11-18,502,iphone 15 pro max,100000,135000,35000,2,00157,India
450932,2023-11-18,506,monitor,3249,8000,4751,2,00351,India
450932,2023-11-18,503,mixer,1349,3249,1900,2,00351,India
307524,2023-11-18,502,iphone 15 pro max,100000,135000,35000,2,00268,India
307524,2023-11-18,503,mixer,1349,3249,1900,2,00268,India
307524,2023-11-18,506,monitor,3249,8000,4751,2,00268,India
307524,2023-11-18,505,oven,18490,24000,5510,2,00268,India
635697,2023-11-18,507,washing machine,6990,16490,9500,2,00234,India
635697,2023-11-18,503,mixer,1349,3249,1900,2,00234,India
265334,2023-11-18,501,iphone 15,60000,80000,20000,2,00103,India
573170,2023-11-18,506,monitor,3249,8000,4751,2,00351,India
370030,2023-11-18,501,iphone 15,60000,80000,20000,2,00380,India
370030,2023-11-18,502,iphone 15 pro max,100000,135000,35000,2,00380,India
370030,2023-11-18,507,washing machine,6990,16490,9500,2,00380,India
544682,2023-11-18,505,oven,18490,24000,5510,2,00246,India
544682,2023-11-18,507,washing machine,6990,16490,9500,2,00246,India
553356,2023-11-18,503,mixer,1349,3249,1900,2,00256,India
553356,2023-11-18,502,iphone 15 pro max,100000,135000,35000,2,00256,India
553356,2023-11-18,504,iron,449,879,430,2,00256,India
227505,2023-11-18,503,mixer,1349,3249,1900,2,00364,India
227505,2023-11-18,502,iphone 15 pro max,100000,135000,35000,2,00364,India
851667,2023-11-18,504,iron,449,879,430,2,00324,India
851667,2023-11-18,503,mixer,1349,3249,1900,2,00324,India
851667,2023-11-18,506,monitor,3249,8000,4751,2,00324,India
480493,2023-11-18,504,iron,449,879,430,2,00355,India
702459,2023-11-18,504,iron,449,879,430,2,00441,India
702459,2023-11-18,503,mixer,1349,3249,1900,2,00441,India
702459,2023-11-18,502,iphone 15 pro max,100000,135000,35000,2,00441,India
702459,2023-11-18,505,oven,18490,24000,5510,2,00441,India
599624,2023-11-18,504,iron,449,879,430,2,00495,India
599624,2023-11-18,506,monitor,3249,8000,4751,2,00495,India
599624,2023-11-18,501,iphone 15,60000,80000,20000,2,00495,India
974864,2023-11-18,501,iphone 15,60000,80000,20000,2,00143,India
187682,2023-11-18,502,iphone 15 pro max,100000,135000,35000,2,00086,India
187682,2023-11-18,504,iron,449,879,430,2,00086,India
388944,2023-11-18,506,monitor,3249,8000,4751,2,00356,India
895792,2023-11-18,502,iphone 15 pro max,100000,135000,35000,2,00120,India
895792,2023-11-18,505,oven,18490,24000,5510,2,00120,India
895792,2023-11-18,507,washing machine,6990,16490,9500,2,00120,India
221336,2023-11-18,503,mixer,1349,3249,1900,2,00262,India
221336,2023-11-18,504,iron,449,879,430,2,00262,India
221336,2023-11-18,506,monitor,3249,8000,4751,2,00262,India
668833,2023-11-18,505,oven,18490,24000,5510,2,00349,India
668833,2023-11-18,503,mixer,1349,3249,1900,2,00349,India
668833,2023-11-18,507,washing machine,6990,16490,9500,2,00349,India
246162,2023-11-18,507,washing machine,6990,16490,9500,2,00349,India
246162,2023-11-18,502,iphone 15 pro max,100000,135000,35000,2,00349,India
246162,2023-11-18,503,mixer,1349,3249,1900,2,00349,India
145139,2023-11-18,505,oven,18490,24000,5510,2,00085,India
724693,2023-11-18,502,iphone 15 pro max,100000,135000,35000,2,00162,India
724693,2023-11-18,505,oven,18490,24000,5510,2,00162,India
724693,2023-11-18,504,iron,449,879,430,2,00162,India
724693,2023-11-18,503,mixer,1349,3249,1900,2,00162,India
724693,2023-11-18,507,washing machine,6990,16490,9500,2,00162,India
127092,2023-11-18,507,washing machine,6990,16490,9500,2,00004,India
127092,2023-11-18,501,iphone 15,60000,80000,20000,2,00004,India
127092,2023-11-18,506,monitor,3249,8000,4751,2,00004,India
936227,2023-11-18,503,mixer,1349,3249,1900,2,00402,India
936227,2023-11-18,506,monitor,3249,8000,4751,2,00402,India
936227,2023-11-18,504,iron,449,879,430,2,00402,India
936227,2023-11-18,501,iphone 15,60000,80000,20000,2,00402,India
936227,2023-11-18,502,iphone 15 pro max,100000,135000,35000,2,00402,India
698818,2023-11-18,507,washing machine,6990,16490,9500,2,00449,India
879817,2023-11-18,506,monitor,3249,8000,4751,2,00028,India
879817,2023-11-18,507,washing machine,6990,16490,9500,2,00028,India
167721,2023-11-18,505,oven,18490,24000,5510,2,00336,India
167721,2023-11-18,503,mixer,1349,3249,1900,2,00336,India
167721,2023-11-18,502,iphone 15 pro max,100000,135000,35000,2,00336,India
167721,2023-11-18,501,iphone 15,60000,80000,20000,2,00336,India
306915,2023-11-18,504,iron,449,879,430,2,00313,India
306915,2023-11-18,505,oven,18490,24000,5510,2,00313,India
815484,2023-11-18,504,iron,449,879,430,2,00125,India
815484,2023-11-18,505,oven,18490,24000,5510,2,00125,India
815484,2023-11-18,506,monitor,3249,8000,4751,2,00125,India
815484,2023-11-18,507,washing machine,6990,16490,9500,2,00125,India
295687,2023-11-18,501,iphone 15,60000,80000,20000,2,00217,India
295687,2023-11-18,503,mixer,1349,3249,1900,2,00217,India
295687,2023-11-18,505,oven,18490,24000,5510,2,00217,India
295687,2023-11-18,504,iron,449,879,430,2,00217,India
854498,2023-11-18,502,iphone 15 pro max,100000,135000,35000,2,00022,India
854498,2023-11-18,505,oven,18490,24000,5510,2,00022,India
854498,2023-11-18,501,iphone 15,60000,80000,20000,2,00022,India
734368,2023-11-18,507,washing machine,6990,16490,9500,2,00081,India
698536,2023-11-18,501,iphone 15,60000,80000,20000,2,00198,India
698536,2023-11-18,504,iron,449,879,430,2,00198,India
133568,2023-11-18,502,iphone 15 pro max,100000,135000,35000,2,00484,India
133568,2023-11-18,506,monitor,3249,8000,4751,2,00484,India
133568,2023-11-18,501,iphone 15,60000,80000,20000,2,00484,India
491790,2023-11-18,505,oven,18490,24000,5510,2,00232,India
491790,2023-11-18,506,monitor,3249,8000,4751,2,00232,India
491790,2023-11-18,507,washing machine,6990,16490,9500,2,00232,India
890821,2023-11-18,503,mixer,1349,3249,1900,2,00087,India
890821,2023-11-18,501,iphone 15,60000,80000,20000,2,00087,India
567794,2023-11-18,504,iron,449,879,430,2,00044,India
567794,2023-11-18,506,monitor,3249,8000,4751,2,00044,India
271375,2023-11-18,507,washing machine,6990,16490,9500,2,00085,India
978961,2023-11-18,503,mixer,1349,3249,1900,2,00408,India
978961,2023-11-18,504,iron,449,879,430,2,00408,India
978961,2023-11-18,507,washing machine,6990,16490,9500,2,00408,India
978961,2023-11-18,502,iphone 15 pro max,100000,135000,35000,2,00408,India
979360,2023-11-18,504,iron,449,879,430,2,00212,India
979360,2023-11-18,505,oven,18490,24000,5510,2,00212,India
979120,2023-11-18,507,washing machine,6990,16490,9500,2,00355,India
900544,2023-11-18,501,iphone 15,60000,80000,20000,2,00079,India
900544,2023-11-18,507,washing machine,6990,16490,9500,2,00079,India
876382,2023-11-18,503,mixer,1349,3249,1900,2,00132,India
694604,2023-11-18,501,iphone 15,60000,80000,20000,2,00424,India
694604,2023-11-18,504,iron,449,879,430,2,00424,India
694604,2023-11-18,507,washing machine,6990,16490,9500,2,00424,India
694604,2023-11-18,505,oven,18490,24000,5510,2,00424,India
812295,2023-11-18,501,iphone 15,60000,80000,20000,2,00424,India
785525,2023-11-18,507,washing machine,6990,16490,9500,2,00392,India
674727,2023-11-18,503,mixer,1349,3249,1900,2,00223,India
674727,2023-11-18,504,iron,449,879,430,2,00223,India
674727,2023-11-18,501,iphone 15,60000,80000,20000,2,00223,India
253552,2023-11-18,504,iron,449,879,430,2,00492,India
253552,2023-11-18,501,iphone 15,60000,80000,20000,2,00492,India
253552,2023-11-18,506,monitor,3249,8000,4751,2,00492,India
253552,2023-11-18,502,iphone 15 pro max,100000,135000,35000,2,00492,India
823355,2023-11-18,503,mixer,1349,3249,1900,2,00431,India
838083,2023-11-18,504,iron,449,879,430,2,00287,India
838083,2023-11-18,502,iphone 15 pro max,100000,135000,35000,2,00287,India
838083,2023-11-18,501,iphone 15,60000,80000,20000,2,00287,India
300269,2023-11-18,502,iphone 15 pro max,100000,135000,35000,2,00124,India
924862,2023-11-18,501,iphone 15,60000,80000,20000,2,00170,India
924862,2023-11-18,503,mixer,1349,3249,1900,2,00170,India
372678,2023-11-18,501,iphone 15,60000,80000,20000,2,00441,India
372678,2023-11-18,504,iron,449,879,430,2,00441,India
167996,2023-11-18,502,iphone 15 pro max,100000,135000,35000,2,00247,India
167996,2023-11-18,501,iphone 15,60000,80000,20000,2,00247,India
167996,2023-11-18,505,oven,18490,24000,5510,2,00247,India
167996,2023-11-18,504,iron,449,879,430,2,00247,India
397024,2023-11-18,507,washing machine,6990,16490,9500,2,00025,India
397024,2023-11-18,502,iphone 15 pro max,100000,135000,35000,2,00025,India
961161,2023-11-18,503,mixer,1349,3249,1900,2,00012,India
961161,2023-11-18,505,oven,18490,24000,5510,2,00012,India
961161,2023-11-18,506,monitor,3249,8000,4751,2,00012,India
961161,2023-11-18,507,washing machine,6990,16490,9500,2,00012,India
961161,2023-11-18,502,iphone 15 pro max,100000,135000,35000,2,00012,India
726460,2023-11-18,506,monitor,3249,8000,4751,2,00288,India
930353,2023-11-18,507,washing machine,6990,16490,9500,2,00357,India
930353,2023-11-18,505,oven,18490,24000,5510,2,00357,India
447978,2023-11-18,501,iphone 15,60000,80000,20000,2,00109,India
447978,2023-11-18,502,iphone 15 pro max,100000,135000,35000,2,00109,India
447978,2023-11-18,507,washing machine,6990,16490,9500,2,00109,India
791195,2023-11-18,506,monitor,3249,8000,4751,2,00425,India
791195,2023-11-18,505,oven,18490,24000,5510,2,00425,India
791195,2023-11-18,502,iphone 15 pro max,100000,135000,35000,2,00425,India
459867,2023-11-18,505,oven,18490,24000,5510,2,00409,India
459867,2023-11-18,506,monitor,3249,8000,4751,2,00409,India
459867,2023-11-18,501,iphone 15,60000,80000,20000,2,00409,India
459867,2023-11-18,503,mixer,1349,3249,1900,2,00409,India
925025,2023-11-18,504,iron,449,879,430,2,00404,India
740815,2023-11-18,506,monitor,3249,8000,4751,2,00272,India
740815,2023-11-18,505,oven,18490,24000,5510,2,00272,India
922107,2023-11-18,501,iphone 15,60000,80000,20000,2,00264,India
922107,2023-11-18,505,oven,18490,24000,5510,2,00264,India
922107,2023-11-18,507,washing machine,6990,16490,9500,2,00264,India
706471,2023-11-18,502,iphone 15 pro max,100000,135000,35000,2,00257,India
706471,2023-11-18,504,iron,449,879,430,2,00257,India
706471,2023-11-18,503,mixer,1349,3249,1900,2,00257,India
765557,2023-11-18,506,monitor,3249,8000,4751,2,00459,India
765557,2023-11-18,507,washing machine,6990,16490,9500,2,00459,India
434520,2023-11-18,507,washing machine,6990,16490,9500,2,00258,India
598862,2023-11-18,501,iphone 15,60000,80000,20000,2,00366,India
598862,2023-11-18,503,mixer,1349,3249,1900,2,00366,India
928263,2023-11-18,505,oven,18490,24000,5510,2,00199,India
114525,2023-11-18,502,iphone 15 pro max,100000,135000,35000,2,00479,India
114525,2023-11-18,505,oven,18490,24000,5510,2,00479,India
114525,2023-11-18,504,iron,449,879,430,2,00479,India
121275,2023-11-18,502,iphone 15 pro max,100000,135000,35000,2,00332,India
121275,2023-11-18,504,iron,449,879,430,2,00332,India
121275,2023-11-18,501,iphone 15,60000,80000,20000,2,00332,India
503855,2023-11-18,502,iphone 15 pro max,100000,135000,35000,2,00187,India
503855,2023-11-18,504,iron,449,879,430,2,00187,India
277465,2023-11-18,507,washing machine,6990,16490,9500,2,00237,India
277465,2023-11-18,504,iron,449,879,430,2,00237,India
277465,2023-11-18,503,mixer,1349,3249,1900,2,00237,India
795535,2023-11-18,504,iron,449,879,430,2,00033,India
795535,2023-11-18,502,iphone 15 pro max,100000,135000,35000,2,00033,India
795535,2023-11-18,506,monitor,3249,8000,4751,2,00033,India
519499,2023-11-18,507,washing machine,6990,16490,9500,2,00499,India
519499,2023-11-18,501,iphone 15,60000,80000,20000,2,00499,India
487845,2023-11-18,507,washing machine,6990,16490,9500,2,00103,India
487845,2023-11-18,505,oven,18490,24000,5510,2,00103,India
708148,2023-11-18,505,oven,18490,24000,5510,2,00142,India
708148,2023-11-18,507,washing machine,6990,16490,9500,2,00142,India
708148,2023-11-18,503,mixer,1349,3249,1900,2,00142,India
273144,2023-11-18,503,mixer,1349,3249,1900,2,00374,India
273144,2023-11-18,501,iphone 15,60000,80000,20000,2,00374,India
273144,2023-11-18,506,monitor,3249,8000,4751,2,00374,India
379504,2023-11-18,504,iron,449,879,430,2,00126,India
591530,2023-11-18,504,iron,449,879,430,2,00459,India
591530,2023-11-18,502,iphone 15 pro max,100000,135000,35000,2,00459,India
543347,2023-11-18,502,iphone 15 pro max,100000,135000,35000,2,00490,India
543347,2023-11-18,503,mixer,1349,3249,1900,2,00490,India
543347,2023-11-18,505,oven,18490,24000,5510,2,00490,India
286289,2023-11-18,507,washing machine,6990,16490,9500,2,00182,India
286289,2023-11-18,503,mixer,1349,3249,1900,2,00182,India
286289,2023-11-18,504,iron,449,879,430,2,00182,India
286289,2023-11-18,502,iphone 15 pro max,100000,135000,35000,2,00182,India
893326,2023-11-18,506,monitor,3249,8000,4751,2,00164,India
893326,2023-11-18,502,iphone 15 pro max,100000,135000,35000,2,00164,India
893326,2023-11-18,501,iphone 15,60000,80000,20000,2,00164,India
594981,2023-11-18,501,iphone 15,60000,80000,20000,2,00019,India
861778,2023-11-19,503,mixer,1349,3249,1900,2,00168,India
758160,2023-11-19,505,oven,18490,24000,5510,2,00168,India
497036,2023-11-19,507,washing machine,6990,16490,9500,2,00430,India
497036,2023-11-19,501,iphone 15,60000,80000,20000,2,00430,India
497036,2023-11-19,506,monitor,3249,8000,4751,2,00430,India
308110,2023-11-19,503,mixer,1349,3249,1900,2,00051,India
308110,2023-11-19,504,iron,449,879,430,2,00051,India
308110,2023-11-19,505,oven,18490,24000,5510,2,00051,India
848458,2023-11-19,502,iphone 15 pro max,100000,135000,35000,2,00491,India
848458,2023-11-19,504,iron,449,879,430,2,00491,India
624280,2023-11-19,506,monitor,3249,8000,4751,2,00289,India
611247,2023-11-19,503,mixer,1349,3249,1900,2,00355,India
611247,2023-11-19,502,iphone 15 pro max,100000,135000,35000,2,00355,India
611247,2023-11-19,507,washing machine,6990,16490,9500,2,00355,India
611247,2023-11-19,505,oven,18490,24000,5510,2,00355,India
533929,2023-11-19,506,monitor,3249,8000,4751,2,00099,India
476580,2023-11-19,504,iron,449,879,430,2,00385,India
476580,2023-11-19,506,monitor,3249,8000,4751,2,00385,India
476580,2023-11-19,505,oven,18490,24000,5510,2,00385,India
177156,2023-11-19,501,iphone 15,60000,80000,20000,2,00263,India
177156,2023-11-19,503,mixer,1349,3249,1900,2,00263,India
718787,2023-11-19,507,washing machine,6990,16490,9500,2,00327,India
718787,2023-11-19,505,oven,18490,24000,5510,2,00327,India
718787,2023-11-19,504,iron,449,879,430,2,00327,India
718787,2023-11-19,506,monitor,3249,8000,4751,2,00327,India
509386,2023-11-19,505,oven,18490,24000,5510,2,00381,India
966899,2023-11-19,506,monitor,3249,8000,4751,2,00348,India
966899,2023-11-19,505,oven,18490,24000,5510,2,00348,India
966899,2023-11-19,501,iphone 15,60000,80000,20000,2,00348,India
966899,2023-11-19,504,iron,449,879,430,2,00348,India
192370,2023-11-19,504,iron,449,879,430,2,00297,India
192370,2023-11-19,505,oven,18490,24000,5510,2,00297,India
192370,2023-11-19,503,mixer,1349,3249,1900,2,00297,India
553229,2023-11-19,507,washing machine,6990,16490,9500,2,00267,India
553229,2023-11-19,502,iphone 15 pro max,100000,135000,35000,2,00267,India
553229,2023-11-19,501,iphone 15,60000,80000,20000,2,00267,India
954637,2023-11-19,505,oven,18490,24000,5510,2,00110,India
954637,2023-11-19,507,washing machine,6990,16490,9500,2,00110,India
954637,2023-11-19,506,monitor,3249,8000,4751,2,00110,India
486089,2023-11-19,501,iphone 15,60000,80000,20000,2,00270,India
486089,2023-11-19,504,iron,449,879,430,2,00270,India
486089,2023-11-19,502,iphone 15 pro max,100000,135000,35000,2,00270,India
152346,2023-11-19,501,iphone 15,60000,80000,20000,2,00324,India
152346,2023-11-19,505,oven,18490,24000,5510,2,00324,India
456200,2023-11-19,501,iphone 15,60000,80000,20000,2,00031,India
108817,2023-11-19,507,washing machine,6990,16490,9500,2,00499,India
108817,2023-11-19,506,monitor,3249,8000,4751,2,00499,India
225005,2023-11-19,503,mixer,1349,3249,1900,2,00349,India
328226,2023-11-19,504,iron,449,879,430,2,00028,India
328226,2023-11-19,505,oven,18490,24000,5510,2,00028,India
819383,2023-11-19,505,oven,18490,24000,5510,2,00365,India
819383,2023-11-19,503,mixer,1349,3249,1900,2,00365,India
819383,2023-11-19,504,iron,449,879,430,2,00365,India
866284,2023-11-19,505,oven,18490,24000,5510,2,00407,India
866284,2023-11-19,506,monitor,3249,8000,4751,2,00407,India
373798,2023-11-19,506,monitor,3249,8000,4751,2,00384,India
734471,2023-11-19,505,oven,18490,24000,5510,2,00444,India
734471,2023-11-19,507,washing machine,6990,16490,9500,2,00444,India
705292,2023-11-19,506,monitor,3249,8000,4751,2,00369,India
705292,2023-11-19,507,washing machine,6990,16490,9500,2,00369,India
705292,2023-11-19,505,oven,18490,24000,5510,2,00369,India
181749,2023-11-19,503,mixer,1349,3249,1900,2,00144,India
181749,2023-11-19,501,iphone 15,60000,80000,20000,2,00144,India
813053,2023-11-19,502,iphone 15 pro max,100000,135000,35000,2,00013,India
813053,2023-11-19,506,monitor,3249,8000,4751,2,00013,India
882961,2023-11-19,503,mixer,1349,3249,1900,2,00167,India
408360,2023-11-19,501,iphone 15,60000,80000,20000,2,00131,India
408360,2023-11-19,504,iron,449,879,430,2,00131,India
701825,2023-11-19,506,monitor,3249,8000,4751,2,00241,India
701825,2023-11-19,507,washing machine,6990,16490,9500,2,00241,India
701825,2023-11-19,502,iphone 15 pro max,100000,135000,35000,2,00241,India
701825,2023-11-19,504,iron,449,879,430,2,00241,India
992961,2023-11-19,507,washing machine,6990,16490,9500,2,00123,India
325253,2023-11-19,503,mixer,1349,3249,1900,2,00038,India
325253,2023-11-19,506,monitor,3249,8000,4751,2,00038,India
390041,2023-11-19,506,monitor,3249,8000,4751,2,00405,India
390041,2023-11-19,507,washing machine,6990,16490,9500,2,00405,India
390041,2023-11-19,503,mixer,1349,3249,1900,2,00405,India
726835,2023-11-19,505,oven,18490,24000,5510,2,00017,India
726835,2023-11-19,507,washing machine,6990,16490,9500,2,00017,India
726835,2023-11-19,504,iron,449,879,430,2,00017,India
638928,2023-11-19,505,oven,18490,24000,5510,2,00059,India
638928,2023-11-19,507,washing machine,6990,16490,9500,2,00059,India
638928,2023-11-19,506,monitor,3249,8000,4751,2,00059,India
814503,2023-11-19,502,iphone 15 pro max,100000,135000,35000,2,00123,India
147463,2023-11-19,506,monitor,3249,8000,4751,2,00008,India
288645,2023-11-19,507,washing machine,6990,16490,9500,2,00103,India
288645,2023-11-19,503,mixer,1349,3249,1900,2,00103,India
288645,2023-11-19,506,monitor,3249,8000,4751,2,00103,India
320960,2023-11-19,506,monitor,3249,8000,4751,2,00226,India
577300,2023-11-19,507,washing machine,6990,16490,9500,2,00429,India
548994,2023-11-19,504,iron,449,879,430,2,00371,India
689177,2023-11-19,505,oven,18490,24000,5510,2,00281,India
689177,2023-11-19,502,iphone 15 pro max,100000,135000,35000,2,00281,India
689177,2023-11-19,504,iron,449,879,430,2,00281,India
656304,2023-11-19,504,iron,449,879,430,2,00296,India
656304,2023-11-19,503,mixer,1349,3249,1900,2,00296,India
656304,2023-11-19,507,washing machine,6990,16490,9500,2,00296,India
186503,2023-11-19,507,washing machine,6990,16490,9500,2,00491,India
271016,2023-11-19,502,iphone 15 pro max,100000,135000,35000,2,00495,India
564040,2023-11-19,502,iphone 15 pro max,100000,135000,35000,2,00087,India
564040,2023-11-19,503,mixer,1349,3249,1900,2,00087,India
564040,2023-11-19,501,iphone 15,60000,80000,20000,2,00087,India
564040,2023-11-19,506,monitor,3249,8000,4751,2,00087,India
164518,2023-11-19,506,monitor,3249,8000,4751,2,00139,India
164518,2023-11-19,501,iphone 15,60000,80000,20000,2,00139,India
161791,2023-11-19,501,iphone 15,60000,80000,20000,2,00216,India
375593,2023-11-19,504,iron,449,879,430,2,00322,India
899096,2023-11-19,503,mixer,1349,3249,1900,2,00144,India
899096,2023-11-19,504,iron,449,879,430,2,00144,India
455756,2023-11-19,503,mixer,1349,3249,1900,2,00236,India
455756,2023-11-19,507,washing machine,6990,16490,9500,2,00236,India
296330,2023-11-19,507,washing machine,6990,16490,9500,2,00181,India
296330,2023-11-19,504,iron,449,879,430,2,00181,India
906789,2023-11-19,502,iphone 15 pro max,100000,135000,35000,2,00205,India
906789,2023-11-19,501,iphone 15,60000,80000,20000,2,00205,India
906789,2023-11-19,506,monitor,3249,8000,4751,2,00205,India
875403,2023-11-19,504,iron,449,879,430,2,00186,India
172623,2023-11-19,502,iphone 15 pro max,100000,135000,35000,2,00358,India
172623,2023-11-19,503,mixer,1349,3249,1900,2,00358,India
172623,2023-11-19,505,oven,18490,24000,5510,2,00358,India
330088,2023-11-19,503,mixer,1349,3249,1900,2,00378,India
330088,2023-11-19,502,iphone 15 pro max,100000,135000,35000,2,00378,India
330088,2023-11-19,505,oven,18490,24000,5510,2,00378,India
226768,2023-11-19,507,washing machine,6990,16490,9500,2,00182,India
226768,2023-11-19,501,iphone 15,60000,80000,20000,2,00182,India
226768,2023-11-19,502,iphone 15 pro max,100000,135000,35000,2,00182,India
226768,2023-11-19,506,monitor,3249,8000,4751,2,00182,India
275334,2023-11-20,502,iphone 15 pro max,100000,135000,35000,2,00034,India
275334,2023-11-20,504,iron,449,879,430,2,00034,India
275334,2023-11-20,505,oven,18490,24000,5510,2,00034,India
275334,2023-11-20,501,iphone 15,60000,80000,20000,2,00034,India
842517,2023-11-20,503,mixer,1349,3249,1900,2,00154,India
842517,2023-11-20,507,washing machine,6990,16490,9500,2,00154,India
842517,2023-11-20,504,iron,449,879,430,2,00154,India
419757,2023-11-20,503,mixer,1349,3249,1900,2,00248,India
419757,2023-11-20,502,iphone 15 pro max,100000,135000,35000,2,00248,India
419757,2023-11-20,501,iphone 15,60000,80000,20000,2,00248,India
392764,2023-11-20,502,iphone 15 pro max,100000,135000,35000,2,00096,India
392764,2023-11-20,507,washing machine,6990,16490,9500,2,00096,India
977508,2023-11-20,507,washing machine,6990,16490,9500,2,00088,India
977508,2023-11-20,503,mixer,1349,3249,1900,2,00088,India
977508,2023-11-20,505,oven,18490,24000,5510,2,00088,India
977508,2023-11-20,501,iphone 15,60000,80000,20000,2,00088,India
815360,2023-11-20,506,monitor,3249,8000,4751,2,00360,India
815360,2023-11-20,501,iphone 15,60000,80000,20000,2,00360,India
815360,2023-11-20,505,oven,18490,24000,5510,2,00360,India
507008,2023-11-20,504,iron,449,879,430,2,00494,India
507008,2023-11-20,506,monitor,3249,8000,4751,2,00494,India
356369,2023-11-20,501,iphone 15,60000,80000,20000,2,00340,India
782890,2023-11-20,507,washing machine,6990,16490,9500,2,00190,India
782890,2023-11-20,501,iphone 15,60000,80000,20000,2,00190,India
782890,2023-11-20,504,iron,449,879,430,2,00190,India
537498,2023-11-20,503,mixer,1349,3249,1900,2,00410,India
537498,2023-11-20,506,monitor,3249,8000,4751,2,00410,India
537498,2023-11-20,507,washing machine,6990,16490,9500,2,00410,India
537498,2023-11-20,501,iphone 15,60000,80000,20000,2,00410,India
851345,2023-11-20,501,iphone 15,60000,80000,20000,2,00373,India
851345,2023-11-20,505,oven,18490,24000,5510,2,00373,India
851345,2023-11-20,503,mixer,1349,3249,1900,2,00373,India
851345,2023-11-20,507,washing machine,6990,16490,9500,2,00373,India
367625,2023-11-20,506,monitor,3249,8000,4751,2,00393,India
367625,2023-11-20,507,washing machine,6990,16490,9500,2,00393,India
110560,2023-11-20,505,oven,18490,24000,5510,2,00102,India
110560,2023-11-20,503,mixer,1349,3249,1900,2,00102,India
110560,2023-11-20,507,washing machine,6990,16490,9500,2,00102,India
110560,2023-11-20,504,iron,449,879,430,2,00102,India
459298,2023-11-20,502,iphone 15 pro max,100000,135000,35000,2,00278,India
459298,2023-11-20,506,monitor,3249,8000,4751,2,00278,India
953537,2023-11-20,504,iron,449,879,430,2,00143,India
953537,2023-11-20,507,washing machine,6990,16490,9500,2,00143,India
953537,2023-11-20,503,mixer,1349,3249,1900,2,00143,India
756198,2023-11-20,504,iron,449,879,430,2,00168,India
756198,2023-11-20,506,monitor,3249,8000,4751,2,00168,India
104738,2023-11-20,503,mixer,1349,3249,1900,2,00072,India
104738,2023-11-20,505,oven,18490,24000,5510,2,00072,India
569019,2023-11-20,503,mixer,1349,3249,1900,2,00017,India
903881,2023-11-20,507,washing machine,6990,16490,9500,2,00193,India
903881,2023-11-20,505,oven,18490,24000,5510,2,00193,India
903881,2023-11-20,506,monitor,3249,8000,4751,2,00193,India
504908,2023-11-20,507,washing machine,6990,16490,9500,2,00496,India
504908,2023-11-20,504,iron,449,879,430,2,00496,India
405635,2023-11-20,506,monitor,3249,8000,4751,2,00234,India
480236,2023-11-20,507,washing machine,6990,16490,9500,2,00435,India
480236,2023-11-20,503,mixer,1349,3249,1900,2,00435,India
679755,2023-11-20,505,oven,18490,24000,5510,2,00302,India
974491,2023-11-20,507,washing machine,6990,16490,9500,2,00296,India
974491,2023-11-20,506,monitor,3249,8000,4751,2,00296,India
974491,2023-11-20,504,iron,449,879,430,2,00296,India
974491,2023-11-20,502,iphone 15 pro max,100000,135000,35000,2,00296,India
974491,2023-11-20,505,oven,18490,24000,5510,2,00296,India
874486,2023-11-20,504,iron,449,879,430,2,00104,India
639301,2023-11-20,507,washing machine,6990,16490,9500,2,00445,India
639301,2023-11-20,503,mixer,1349,3249,1900,2,00445,India
621701,2023-11-20,501,iphone 15,60000,80000,20000,2,00407,India
621701,2023-11-20,507,washing machine,6990,16490,9500,2,00407,India
621701,2023-11-20,505,oven,18490,24000,5510,2,00407,India
377306,2023-11-20,504,iron,449,879,430,2,00125,India
377306,2023-11-20,502,iphone 15 pro max,100000,135000,35000,2,00125,India
377306,2023-11-20,503,mixer,1349,3249,1900,2,00125,India
377306,2023-11-20,506,monitor,3249,8000,4751,2,00125,India
524525,2023-11-20,507,washing machine,6990,16490,9500,2,00026,India
168210,2023-11-20,504,iron,449,879,430,2,00328,India
168210,2023-11-20,505,oven,18490,24000,5510,2,00328,India
168210,2023-11-20,503,mixer,1349,3249,1900,2,00328,India
439344,2023-11-20,501,iphone 15,60000,80000,20000,2,00489,India
439344,2023-11-20,503,mixer,1349,3249,1900,2,00489,India
439344,2023-11-20,502,iphone 15 pro max,100000,135000,35000,2,00489,India
439344,2023-11-20,506,monitor,3249,8000,4751,2,00489,India
820032,2023-11-20,507,washing machine,6990,16490,9500,2,00012,India
820032,2023-11-20,506,monitor,3249,8000,4751,2,00012,India
762887,2023-11-20,507,washing machine,6990,16490,9500,2,00354,India
864203,2023-11-20,506,monitor,3249,8000,4751,2,00017,India
864203,2023-11-20,502,iphone 15 pro max,100000,135000,35000,2,00017,India
864203,2023-11-20,501,iphone 15,60000,80000,20000,2,00017,India
864203,2023-11-20,504,iron,449,879,430,2,00017,India
254499,2023-11-20,501,iphone 15,60000,80000,20000,2,00343,India
254499,2023-11-20,504,iron,449,879,430,2,00343,India
254499,2023-11-20,503,mixer,1349,3249,1900,2,00343,India
815012,2023-11-20,505,oven,18490,24000,5510,2,00321,India
815012,2023-11-20,507,washing machine,6990,16490,9500,2,00321,India
672448,2023-11-20,504,iron,449,879,430,2,00165,India
672448,2023-11-20,501,iphone 15,60000,80000,20000,2,00165,India
672448,2023-11-20,507,washing machine,6990,16490,9500,2,00165,India
672448,2023-11-20,505,oven,18490,24000,5510,2,00165,India
453999,2023-11-20,504,iron,449,879,430,2,00082,India
453999,2023-11-20,501,iphone 15,60000,80000,20000,2,00082,India
453999,2023-11-20,507,washing machine,6990,16490,9500,2,00082,India
453999,2023-11-20,503,mixer,1349,3249,1900,2,00082,India
260689,2023-11-20,506,monitor,3249,8000,4751,2,00314,India
260689,2023-11-20,507,washing machine,6990,16490,9500,2,00314,India
260689,2023-11-20,504,iron,449,879,430,2,00314,India
260689,2023-11-20,505,oven,18490,24000,5510,2,00314,India
260689,2023-11-20,501,iphone 15,60000,80000,20000,2,00314,India
294240,2023-11-20,503,mixer,1349,3249,1900,2,00211,India
294240,2023-11-20,501,iphone 15,60000,80000,20000,2,00211,India
472941,2023-11-20,504,iron,449,879,430,2,00205,India
472941,2023-11-20,505,oven,18490,24000,5510,2,00205,India
580299,2023-11-20,501,iphone 15,60000,80000,20000,2,00186,India
868816,2023-11-20,506,monitor,3249,8000,4751,2,00421,India
932595,2023-11-20,507,washing machine,6990,16490,9500,2,00449,India
932595,2023-11-20,504,iron,449,879,430,2,00449,India
292850,2023-11-20,507,washing machine,6990,16490,9500,2,00055,India
292850,2023-11-20,506,monitor,3249,8000,4751,2,00055,India
292850,2023-11-20,504,iron,449,879,430,2,00055,India
292850,2023-11-20,503,mixer,1349,3249,1900,2,00055,India
323705,2023-11-20,507,washing machine,6990,16490,9500,2,00350,India
323705,2023-11-20,502,iphone 15 pro max,100000,135000,35000,2,00350,India
323705,2023-11-20,501,iphone 15,60000,80000,20000,2,00350,India
328320,2023-11-20,501,iphone 15,60000,80000,20000,2,00375,India
152871,2023-11-20,507,washing machine,6990,16490,9500,2,00068,India
585912,2023-11-20,503,mixer,1349,3249,1900,2,00368,India
585912,2023-11-20,501,iphone 15,60000,80000,20000,2,00368,India
585912,2023-11-20,507,washing machine,6990,16490,9500,2,00368,India
263148,2023-11-20,503,mixer,1349,3249,1900,2,00217,India
263148,2023-11-20,502,iphone 15 pro max,100000,135000,35000,2,00217,India
263148,2023-11-20,506,monitor,3249,8000,4751,2,00217,India
972985,2023-11-20,507,washing machine,6990,16490,9500,2,00432,India
985945,2023-11-20,507,washing machine,6990,16490,9500,2,00291,India
985945,2023-11-20,505,oven,18490,24000,5510,2,00291,India
164507,2023-11-20,504,iron,449,879,430,2,00456,India
164507,2023-11-20,503,mixer,1349,3249,1900,2,00456,India
926846,2023-11-20,502,iphone 15 pro max,100000,135000,35000,2,00249,India
926846,2023-11-20,504,iron,449,879,430,2,00249,India
797144,2023-11-20,507,washing machine,6990,16490,9500,2,00481,India
739502,2023-11-20,504,iron,449,879,430,2,00235,India
163530,2023-11-20,504,iron,449,879,430,2,00340,India
163530,2023-11-20,501,iphone 15,60000,80000,20000,2,00340,India
615049,2023-11-20,501,iphone 15,60000,80000,20000,2,00420,India
615049,2023-11-20,506,monitor,3249,8000,4751,2,00420,India
615049,2023-11-20,504,iron,449,879,430,2,00420,India
477328,2023-11-20,502,iphone 15 pro max,100000,135000,35000,2,00396,India
477328,2023-11-20,504,iron,449,879,430,2,00396,India
477328,2023-11-20,505,oven,18490,24000,5510,2,00396,India
284062,2023-11-20,506,monitor,3249,8000,4751,2,00130,India
284062,2023-11-20,501,iphone 15,60000,80000,20000,2,00130,India
284062,2023-11-20,502,iphone 15 pro max,100000,135000,35000,2,00130,India
677510,2023-11-20,503,mixer,1349,3249,1900,2,00305,India
677510,2023-11-20,504,iron,449,879,430,2,00305,India
104878,2023-11-20,504,iron,449,879,430,2,00220,India
104878,2023-11-20,507,washing machine,6990,16490,9500,2,00220,India
104878,2023-11-20,505,oven,18490,24000,5510,2,00220,India
104878,2023-11-20,506,monitor,3249,8000,4751,2,00220,India
104878,2023-11-20,503,mixer,1349,3249,1900,2,00220,India
168142,2023-11-20,506,monitor,3249,8000,4751,2,00202,India
168142,2023-11-20,502,iphone 15 pro max,100000,135000,35000,2,00202,India
168142,2023-11-20,505,oven,18490,24000,5510,2,00202,India
184328,2023-11-20,507,washing machine,6990,16490,9500,2,00131,India
184328,2023-11-20,505,oven,18490,24000,5510,2,00131,India
184328,2023-11-20,506,monitor,3249,8000,4751,2,00131,India
960977,2023-11-20,506,monitor,3249,8000,4751,2,00385,India
960977,2023-11-20,505,oven,18490,24000,5510,2,00385,India
960977,2023-11-20,501,iphone 15,60000,80000,20000,2,00385,India
246602,2023-11-20,501,iphone 15,60000,80000,20000,2,00175,India
246602,2023-11-20,506,monitor,3249,8000,4751,2,00175,India
466002,2023-11-20,507,washing machine,6990,16490,9500,2,00292,India
622542,2023-11-20,507,washing machine,6990,16490,9500,2,00027,India
622542,2023-11-20,503,mixer,1349,3249,1900,2,00027,India
622542,2023-11-20,504,iron,449,879,430,2,00027,India
206951,2023-11-20,501,iphone 15,60000,80000,20000,2,00475,India
206951,2023-11-20,507,washing machine,6990,16490,9500,2,00475,India
669051,2023-11-20,506,monitor,3249,8000,4751,2,00349,India
669051,2023-11-20,505,oven,18490,24000,5510,2,00349,India
150871,2023-11-20,501,iphone 15,60000,80000,20000,2,00344,India
410238,2023-11-20,502,iphone 15 pro max,100000,135000,35000,2,00166,India
410238,2023-11-20,505,oven,18490,24000,5510,2,00166,India
891124,2023-11-20,507,washing machine,6990,16490,9500,2,00376,India
891124,2023-11-20,505,oven,18490,24000,5510,2,00376,India
891124,2023-11-20,501,iphone 15,60000,80000,20000,2,00376,India
434163,2023-11-20,502,iphone 15 pro max,100000,135000,35000,2,00268,India
434163,2023-11-20,501,iphone 15,60000,80000,20000,2,00268,India
434163,2023-11-20,505,oven,18490,24000,5510,2,00268,India
681654,2023-11-20,505,oven,18490,24000,5510,2,00342,India
681654,2023-11-20,502,iphone 15 pro max,100000,135000,35000,2,00342,India
681654,2023-11-20,507,washing machine,6990,16490,9500,2,00342,India
297835,2023-11-20,506,monitor,3249,8000,4751,2,00206,India
297835,2023-11-20,505,oven,18490,24000,5510,2,00206,India
740479,2023-11-20,506,monitor,3249,8000,4751,2,00081,India
740479,2023-11-20,503,mixer,1349,3249,1900,2,00081,India
522153,2023-11-20,504,iron,449,879,430,2,00025,India
522153,2023-11-20,501,iphone 15,60000,80000,20000,2,00025,India
522153,2023-11-20,502,iphone 15 pro max,100000,135000,35000,2,00025,India
522153,2023-11-20,506,monitor,3249,8000,4751,2,00025,India
356622,2023-11-20,506,monitor,3249,8000,4751,2,00348,India
356622,2023-11-20,504,iron,449,879,430,2,00348,India
356622,2023-11-20,507,washing machine,6990,16490,9500,2,00348,India
356622,2023-11-20,502,iphone 15 pro max,100000,135000,35000,2,00348,India
938678,2023-11-20,504,iron,449,879,430,2,00070,India
746274,2023-11-20,507,washing machine,6990,16490,9500,2,00287,India
155280,2023-11-20,504,iron,449,879,430,2,00203,India
559447,2023-11-20,502,iphone 15 pro max,100000,135000,35000,2,00190,India
559447,2023-11-20,506,monitor,3249,8000,4751,2,00190,India
559447,2023-11-20,503,mixer,1349,3249,1900,2,00190,India
453933,2023-11-20,501,iphone 15,60000,80000,20000,2,00487,India
453933,2023-11-20,507,washing machine,6990,16490,9500,2,00487,India
453933,2023-11-20,506,monitor,3249,8000,4751,2,00487,India
714080,2023-11-20,502,iphone 15 pro max,100000,135000,35000,2,00428,India
681474,2023-11-20,503,mixer,1349,3249,1900,2,00354,India
437487,2023-11-20,507,washing machine,6990,16490,9500,2,00359,India
437487,2023-11-20,503,mixer,1349,3249,1900,2,00359,India
437487,2023-11-20,502,iphone 15 pro max,100000,135000,35000,2,00359,India
437487,2023-11-20,504,iron,449,879,430,2,00359,India
556215,2023-11-20,507,washing machine,6990,16490,9500,2,00303,India
556215,2023-11-20,506,monitor,3249,8000,4751,2,00303,India
874033,2023-11-20,507,washing machine,6990,16490,9500,2,00250,India
576932,2023-11-20,501,iphone 15,60000,80000,20000,2,00388,India
576932,2023-11-20,504,iron,449,879,430,2,00388,India
576932,2023-11-20,503,mixer,1349,3249,1900,2,00388,India
691258,2023-11-21,501,iphone 15,60000,80000,20000,2,00475,India
691258,2023-11-21,503,mixer,1349,3249,1900,2,00475,India
611190,2023-11-21,504,iron,449,879,430,2,00339,India
798370,2023-11-21,503,mixer,1349,3249,1900,2,00035,India
798370,2023-11-21,504,iron,449,879,430,2,00035,India
798370,2023-11-21,501,iphone 15,60000,80000,20000,2,00035,India
973320,2023-11-21,507,washing machine,6990,16490,9500,2,00066,India
973320,2023-11-21,506,monitor,3249,8000,4751,2,00066,India
973320,2023-11-21,502,iphone 15 pro max,100000,135000,35000,2,00066,India
973320,2023-11-21,505,oven,18490,24000,5510,2,00066,India
448215,2023-11-21,501,iphone 15,60000,80000,20000,2,00438,India
448215,2023-11-21,503,mixer,1349,3249,1900,2,00438,India
448215,2023-11-21,504,iron,449,879,430,2,00438,India
299158,2023-11-21,502,iphone 15 pro max,100000,135000,35000,2,00407,India
912393,2023-11-21,505,oven,18490,24000,5510,2,00416,India
408424,2023-11-21,506,monitor,3249,8000,4751,2,00162,India
408424,2023-11-21,501,iphone 15,60000,80000,20000,2,00162,India
408424,2023-11-21,505,oven,18490,24000,5510,2,00162,India
371736,2023-11-21,501,iphone 15,60000,80000,20000,2,00064,India
371736,2023-11-21,503,mixer,1349,3249,1900,2,00064,India
371736,2023-11-21,507,washing machine,6990,16490,9500,2,00064,India
371736,2023-11-21,504,iron,449,879,430,2,00064,India
212250,2023-11-21,505,oven,18490,24000,5510,2,00286,India
212250,2023-11-21,502,iphone 15 pro max,100000,135000,35000,2,00286,India
212250,2023-11-21,506,monitor,3249,8000,4751,2,00286,India
777514,2023-11-21,506,monitor,3249,8000,4751,2,00091,India
195940,2023-11-21,501,iphone 15,60000,80000,20000,2,00249,India
195940,2023-11-21,504,iron,449,879,430,2,00249,India
195940,2023-11-21,503,mixer,1349,3249,1900,2,00249,India
195940,2023-11-21,506,monitor,3249,8000,4751,2,00249,India
667119,2023-11-21,501,iphone 15,60000,80000,20000,2,00305,India
133578,2023-11-21,507,washing machine,6990,16490,9500,2,00355,India
133578,2023-11-21,504,iron,449,879,430,2,00355,India
133578,2023-11-21,502,iphone 15 pro max,100000,135000,35000,2,00355,India
312862,2023-11-21,502,iphone 15 pro max,100000,135000,35000,2,00013,India
312862,2023-11-21,504,iron,449,879,430,2,00013,India
312862,2023-11-21,506,monitor,3249,8000,4751,2,00013,India
507430,2023-11-21,504,iron,449,879,430,2,00289,India
663219,2023-11-21,503,mixer,1349,3249,1900,2,00266,India
663219,2023-11-21,507,washing machine,6990,16490,9500,2,00266,India
663219,2023-11-21,506,monitor,3249,8000,4751,2,00266,India
663219,2023-11-21,505,oven,18490,24000,5510,2,00266,India
696309,2023-11-21,501,iphone 15,60000,80000,20000,2,00478,India
696309,2023-11-21,504,iron,449,879,430,2,00478,India
455467,2023-11-21,505,oven,18490,24000,5510,2,00218,India
455467,2023-11-21,506,monitor,3249,8000,4751,2,00218,India
455467,2023-11-21,507,washing machine,6990,16490,9500,2,00218,India
826706,2023-11-21,501,iphone 15,60000,80000,20000,2,00411,India
826706,2023-11-21,502,iphone 15 pro max,100000,135000,35000,2,00411,India
965250,2023-11-21,502,iphone 15 pro max,100000,135000,35000,2,00399,India
965250,2023-11-21,504,iron,449,879,430,2,00399,India
965250,2023-11-21,503,mixer,1349,3249,1900,2,00399,India
187543,2023-11-21,507,washing machine,6990,16490,9500,2,00145,India
187543,2023-11-21,502,iphone 15 pro max,100000,135000,35000,2,00145,India
187543,2023-11-21,505,oven,18490,24000,5510,2,00145,India
486958,2023-11-21,502,iphone 15 pro max,100000,135000,35000,2,00274,India
656929,2023-11-21,505,oven,18490,24000,5510,2,00445,India
656929,2023-11-21,501,iphone 15,60000,80000,20000,2,00445,India
656929,2023-11-21,502,iphone 15 pro max,100000,135000,35000,2,00445,India
159083,2023-11-21,502,iphone 15 pro max,100000,135000,35000,2,00289,India
159083,2023-11-21,503,mixer,1349,3249,1900,2,00289,India
159083,2023-11-21,506,monitor,3249,8000,4751,2,00289,India
176278,2023-11-21,503,mixer,1349,3249,1900,2,00084,India
176278,2023-11-21,505,oven,18490,24000,5510,2,00084,India
176278,2023-11-21,501,iphone 15,60000,80000,20000,2,00084,India
460221,2023-11-21,507,washing machine,6990,16490,9500,2,00052,India
460221,2023-11-21,506,monitor,3249,8000,4751,2,00052,India
304719,2023-11-21,507,washing machine,6990,16490,9500,2,00208,India
200004,2023-11-21,504,iron,449,879,430,2,00238,India
200004,2023-11-21,501,iphone 15,60000,80000,20000,2,00238,India
200004,2023-11-21,502,iphone 15 pro max,100000,135000,35000,2,00238,India
372448,2023-11-21,504,iron,449,879,430,2,00374,India
372448,2023-11-21,506,monitor,3249,8000,4751,2,00374,India
372448,2023-11-21,507,washing machine,6990,16490,9500,2,00374,India
372448,2023-11-21,502,iphone 15 pro max,100000,135000,35000,2,00374,India
472893,2023-11-21,503,mixer,1349,3249,1900,2,00351,India
472893,2023-11-21,502,iphone 15 pro max,100000,135000,35000,2,00351,India
472893,2023-11-21,505,oven,18490,24000,5510,2,00351,India
472893,2023-11-21,504,iron,449,879,430,2,00351,India
636972,2023-11-21,505,oven,18490,24000,5510,2,00253,India
636972,2023-11-21,504,iron,449,879,430,2,00253,India
636972,2023-11-21,502,iphone 15 pro max,100000,135000,35000,2,00253,India
636972,2023-11-21,506,monitor,3249,8000,4751,2,00253,India
961782,2023-11-21,507,washing machine,6990,16490,9500,2,00344,India
961782,2023-11-21,505,oven,18490,24000,5510,2,00344,India
961782,2023-11-21,503,mixer,1349,3249,1900,2,00344,India
531123,2023-11-21,503,mixer,1349,3249,1900,2,00238,India
731151,2023-11-21,503,mixer,1349,3249,1900,2,00186,India
731151,2023-11-21,501,iphone 15,60000,80000,20000,2,00186,India
751508,2023-11-21,506,monitor,3249,8000,4751,2,00455,India
751508,2023-11-21,507,washing machine,6990,16490,9500,2,00455,India
751508,2023-11-21,505,oven,18490,24000,5510,2,00455,India
168237,2023-11-21,501,iphone 15,60000,80000,20000,2,00183,India
168237,2023-11-21,507,washing machine,6990,16490,9500,2,00183,India
168237,2023-11-21,505,oven,18490,24000,5510,2,00183,India
168237,2023-11-21,504,iron,449,879,430,2,00183,India
684683,2023-11-21,506,monitor,3249,8000,4751,2,00353,India
684683,2023-11-21,503,mixer,1349,3249,1900,2,00353,India
374919,2023-11-21,503,mixer,1349,3249,1900,2,00369,India
374919,2023-11-21,506,monitor,3249,8000,4751,2,00369,India
374919,2023-11-21,501,iphone 15,60000,80000,20000,2,00369,India
374919,2023-11-21,504,iron,449,879,430,2,00369,India
379514,2023-11-21,505,oven,18490,24000,5510,2,00179,India
379514,2023-11-21,501,iphone 15,60000,80000,20000,2,00179,India
729690,2023-11-21,504,iron,449,879,430,2,00298,India
729690,2023-11-21,503,mixer,1349,3249,1900,2,00298,India
729690,2023-11-21,501,iphone 15,60000,80000,20000,2,00298,India
729690,2023-11-21,507,washing machine,6990,16490,9500,2,00298,India
545920,2023-11-21,507,washing machine,6990,16490,9500,2,00203,India
545920,2023-11-21,505,oven,18490,24000,5510,2,00203,India
545920,2023-11-21,501,iphone 15,60000,80000,20000,2,00203,India
176464,2023-11-21,502,iphone 15 pro max,100000,135000,35000,2,00108,India
176464,2023-11-21,506,monitor,3249,8000,4751,2,00108,India
528402,2023-11-21,501,iphone 15,60000,80000,20000,2,00477,India
528402,2023-11-21,503,mixer,1349,3249,1900,2,00477,India
528402,2023-11-21,505,oven,18490,24000,5510,2,00477,India
215246,2023-11-21,503,mixer,1349,3249,1900,2,00475,India
215246,2023-11-21,507,washing machine,6990,16490,9500,2,00475,India
215246,2023-11-21,502,iphone 15 pro max,100000,135000,35000,2,00475,India
215246,2023-11-21,506,monitor,3249,8000,4751,2,00475,India
112021,2023-11-21,502,iphone 15 pro max,100000,135000,35000,2,00134,India
112021,2023-11-21,503,mixer,1349,3249,1900,2,00134,India
112021,2023-11-21,501,iphone 15,60000,80000,20000,2,00134,India
150725,2023-11-21,505,oven,18490,24000,5510,2,00231,India
150725,2023-11-21,503,mixer,1349,3249,1900,2,00231,India
756497,2023-11-21,505,oven,18490,24000,5510,2,00306,India
756497,2023-11-21,502,iphone 15 pro max,100000,135000,35000,2,00306,India
756497,2023-11-21,501,iphone 15,60000,80000,20000,2,00306,India
756497,2023-11-21,504,iron,449,879,430,2,00306,India
650576,2023-11-21,502,iphone 15 pro max,100000,135000,35000,2,00172,India
650576,2023-11-21,506,monitor,3249,8000,4751,2,00172,India
650576,2023-11-21,501,iphone 15,60000,80000,20000,2,00172,India
650576,2023-11-21,503,mixer,1349,3249,1900,2,00172,India
332400,2023-11-21,501,iphone 15,60000,80000,20000,2,00266,India
332400,2023-11-21,502,iphone 15 pro max,100000,135000,35000,2,00266,India
332400,2023-11-21,503,mixer,1349,3249,1900,2,00266,India
905262,2023-11-21,507,washing machine,6990,16490,9500,2,00492,India
446297,2023-11-21,503,mixer,1349,3249,1900,2,00431,India
446297,2023-11-21,501,iphone 15,60000,80000,20000,2,00431,India
219032,2023-11-21,506,monitor,3249,8000,4751,2,00224,India
219032,2023-11-21,502,iphone 15 pro max,100000,135000,35000,2,00224,India
219032,2023-11-21,507,washing machine,6990,16490,9500,2,00224,India
219032,2023-11-21,501,iphone 15,60000,80000,20000,2,00224,India
746795,2023-11-21,502,iphone 15 pro max,100000,135000,35000,2,00165,India
470109,2023-11-21,502,iphone 15 pro max,100000,135000,35000,2,00305,India
470109,2023-11-21,501,iphone 15,60000,80000,20000,2,00305,India
122069,2023-11-21,505,oven,18490,24000,5510,2,00199,India
698323,2023-11-21,507,washing machine,6990,16490,9500,2,00061,India
698323,2023-11-21,505,oven,18490,24000,5510,2,00061,India
698323,2023-11-21,504,iron,449,879,430,2,00061,India
698323,2023-11-21,502,iphone 15 pro max,100000,135000,35000,2,00061,India
327537,2023-11-21,503,mixer,1349,3249,1900,2,00403,India
327537,2023-11-21,505,oven,18490,24000,5510,2,00403,India
482554,2023-11-21,506,monitor,3249,8000,4751,2,00096,India
482554,2023-11-21,503,mixer,1349,3249,1900,2,00096,India
482554,2023-11-21,505,oven,18490,24000,5510,2,00096,India
122375,2023-11-21,501,iphone 15,60000,80000,20000,2,00155,India
122375,2023-11-21,503,mixer,1349,3249,1900,2,00155,India
122375,2023-11-21,505,oven,18490,24000,5510,2,00155,India
197376,2023-11-21,501,iphone 15,60000,80000,20000,2,00154,India
197376,2023-11-21,506,monitor,3249,8000,4751,2,00154,India
197376,2023-11-21,504,iron,449,879,430,2,00154,India
197376,2023-11-21,503,mixer,1349,3249,1900,2,00154,India
225921,2023-11-21,504,iron,449,879,430,2,00096,India
225921,2023-11-21,506,monitor,3249,8000,4751,2,00096,India
708281,2023-11-21,501,iphone 15,60000,80000,20000,2,00345,India
217774,2023-11-21,505,oven,18490,24000,5510,2,00447,India
217774,2023-11-21,507,washing machine,6990,16490,9500,2,00447,India
305522,2023-11-21,505,oven,18490,24000,5510,2,00210,India
305522,2023-11-21,501,iphone 15,60000,80000,20000,2,00210,India
662022,2023-11-21,503,mixer,1349,3249,1900,2,00370,India
437114,2023-11-21,502,iphone 15 pro max,100000,135000,35000,2,00408,India
437114,2023-11-21,507,washing machine,6990,16490,9500,2,00408,India
437114,2023-11-21,505,oven,18490,24000,5510,2,00408,India
470726,2023-11-21,504,iron,449,879,430,2,00014,India
241585,2023-11-21,505,oven,18490,24000,5510,2,00100,India
241585,2023-11-21,501,iphone 15,60000,80000,20000,2,00100,India
241585,2023-11-21,504,iron,449,879,430,2,00100,India
241585,2023-11-21,507,washing machine,6990,16490,9500,2,00100,India
245600,2023-11-21,506,monitor,3249,8000,4751,2,00399,India
969935,2023-11-21,504,iron,449,879,430,2,00042,India
844001,2023-11-21,501,iphone 15,60000,80000,20000,2,00044,India
844001,2023-11-21,502,iphone 15 pro max,100000,135000,35000,2,00044,India
844001,2023-11-21,507,washing machine,6990,16490,9500,2,00044,India
888070,2023-11-21,507,washing machine,6990,16490,9500,2,00120,India
888070,2023-11-21,502,iphone 15 pro max,100000,135000,35000,2,00120,India
888070,2023-11-21,504,iron,449,879,430,2,00120,India
888070,2023-11-21,506,monitor,3249,8000,4751,2,00120,India
308021,2023-11-21,501,iphone 15,60000,80000,20000,2,00484,India
308021,2023-11-21,503,mixer,1349,3249,1900,2,00484,India
308021,2023-11-21,507,washing machine,6990,16490,9500,2,00484,India
949522,2023-11-21,506,monitor,3249,8000,4751,2,00425,India
949522,2023-11-21,503,mixer,1349,3249,1900,2,00425,India
692846,2023-11-21,504,iron,449,879,430,2,00344,India
692846,2023-11-21,502,iphone 15 pro max,100000,135000,35000,2,00344,India
692846,2023-11-21,506,monitor,3249,8000,4751,2,00344,India
692846,2023-11-21,503,mixer,1349,3249,1900,2,00344,India
564043,2023-11-21,502,iphone 15 pro max,100000,135000,35000,2,00059,India
564043,2023-11-21,503,mixer,1349,3249,1900,2,00059,India
564043,2023-11-21,507,washing machine,6990,16490,9500,2,00059,India
564043,2023-11-21,506,monitor,3249,8000,4751,2,00059,India
873986,2023-11-21,506,monitor,3249,8000,4751,2,00225,India
155389,2023-11-21,503,mixer,1349,3249,1900,2,00324,India
155389,2023-11-21,502,iphone 15 pro max,100000,135000,35000,2,00324,India
155389,2023-11-21,507,washing machine,6990,16490,9500,2,00324,India
837914,2023-11-21,502,iphone 15 pro max,100000,135000,35000,2,00380,India
837914,2023-11-21,505,oven,18490,24000,5510,2,00380,India
837914,2023-11-21,507,washing machine,6990,16490,9500,2,00380,India
405416,2023-11-21,504,iron,449,879,430,2,00358,India
616320,2023-11-21,501,iphone 15,60000,80000,20000,2,00446,India
616320,2023-11-21,507,washing machine,6990,16490,9500,2,00446,India
616320,2023-11-21,505,oven,18490,24000,5510,2,00446,India
721327,2023-11-21,505,oven,18490,24000,5510,2,00245,India
721327,2023-11-21,501,iphone 15,60000,80000,20000,2,00245,India
721327,2023-11-21,503,mixer,1349,3249,1900,2,00245,India
220845,2023-11-21,501,iphone 15,60000,80000,20000,2,00364,India
220845,2023-11-21,504,iron,449,879,430,2,00364,India
220845,2023-11-21,503,mixer,1349,3249,1900,2,00364,India
490306,2023-11-21,502,iphone 15 pro max,100000,135000,35000,2,00008,India
490306,2023-11-21,503,mixer,1349,3249,1900,2,00008,India
490306,2023-11-21,507,washing machine,6990,16490,9500,2,00008,India
667643,2023-11-21,502,iphone 15 pro max,100000,135000,35000,2,00472,India
667643,2023-11-21,503,mixer,1349,3249,1900,2,00472,India
667643,2023-11-21,504,iron,449,879,430,2,00472,India
667643,2023-11-21,505,oven,18490,24000,5510,2,00472,India
625606,2023-11-21,505,oven,18490,24000,5510,2,00426,India
625606,2023-11-21,503,mixer,1349,3249,1900,2,00426,India
449394,2023-11-21,506,monitor,3249,8000,4751,2,00110,India
449394,2023-11-21,505,oven,18490,24000,5510,2,00110,India
125781,2023-11-21,503,mixer,1349,3249,1900,2,00098,India
125781,2023-11-21,506,monitor,3249,8000,4751,2,00098,India
125781,2023-11-21,504,iron,449,879,430,2,00098,India
661981,2023-11-21,505,oven,18490,24000,5510,2,00012,India
661981,2023-11-21,502,iphone 15 pro max,100000,135000,35000,2,00012,India
661981,2023-11-21,507,washing machine,6990,16490,9500,2,00012,India
708712,2023-11-21,501,iphone 15,60000,80000,20000,2,00219,India
392184,2023-11-21,501,iphone 15,60000,80000,20000,2,00177,India
392184,2023-11-21,506,monitor,3249,8000,4751,2,00177,India
891913,2023-11-21,501,iphone 15,60000,80000,20000,2,00239,India
891913,2023-11-21,505,oven,18490,24000,5510,2,00239,India
891913,2023-11-21,507,washing machine,6990,16490,9500,2,00239,India
891913,2023-11-21,502,iphone 15 pro max,100000,135000,35000,2,00239,India
577725,2023-11-22,507,washing machine,6990,16490,9500,2,00276,India
577725,2023-11-22,502,iphone 15 pro max,100000,135000,35000,2,00276,India
577725,2023-11-22,501,iphone 15,60000,80000,20000,2,00276,India
241917,2023-11-22,507,washing machine,6990,16490,9500,2,00495,India
241917,2023-11-22,502,iphone 15 pro max,100000,135000,35000,2,00495,India
241917,2023-11-22,503,mixer,1349,3249,1900,2,00495,India
219152,2023-11-22,503,mixer,1349,3249,1900,2,00084,India
219152,2023-11-22,507,washing machine,6990,16490,9500,2,00084,India
310346,2023-11-22,503,mixer,1349,3249,1900,2,00227,India
898704,2023-11-22,503,mixer,1349,3249,1900,2,00395,India
898704,2023-11-22,501,iphone 15,60000,80000,20000,2,00395,India
494599,2023-11-22,504,iron,449,879,430,2,00079,India
494599,2023-11-22,503,mixer,1349,3249,1900,2,00079,India
494599,2023-11-22,502,iphone 15 pro max,100000,135000,35000,2,00079,India
547007,2023-11-22,506,monitor,3249,8000,4751,2,00285,India
547007,2023-11-22,507,washing machine,6990,16490,9500,2,00285,India
547007,2023-11-22,503,mixer,1349,3249,1900,2,00285,India
547007,2023-11-22,505,oven,18490,24000,5510,2,00285,India
547007,2023-11-22,501,iphone 15,60000,80000,20000,2,00285,India
726680,2023-11-22,503,mixer,1349,3249,1900,2,00352,India
726680,2023-11-22,502,iphone 15 pro max,100000,135000,35000,2,00352,India
726680,2023-11-22,504,iron,449,879,430,2,00352,India
726680,2023-11-22,506,monitor,3249,8000,4751,2,00352,India
767229,2023-11-22,506,monitor,3249,8000,4751,2,00421,India
771200,2023-11-22,505,oven,18490,24000,5510,2,00097,India
771200,2023-11-22,503,mixer,1349,3249,1900,2,00097,India
771200,2023-11-22,504,iron,449,879,430,2,00097,India
197185,2023-11-22,504,iron,449,879,430,2,00360,India
197185,2023-11-22,503,mixer,1349,3249,1900,2,00360,India
197185,2023-11-22,501,iphone 15,60000,80000,20000,2,00360,India
197185,2023-11-22,505,oven,18490,24000,5510,2,00360,India
767152,2023-11-22,503,mixer,1349,3249,1900,2,00183,India
767152,2023-11-22,507,washing machine,6990,16490,9500,2,00183,India
767152,2023-11-22,504,iron,449,879,430,2,00183,India
767152,2023-11-22,501,iphone 15,60000,80000,20000,2,00183,India
784618,2023-11-22,507,washing machine,6990,16490,9500,2,00294,India
784618,2023-11-22,504,iron,449,879,430,2,00294,India
784618,2023-11-22,502,iphone 15 pro max,100000,135000,35000,2,00294,India
960050,2023-11-22,506,monitor,3249,8000,4751,2,00409,India
960050,2023-11-22,505,oven,18490,24000,5510,2,00409,India
960050,2023-11-22,503,mixer,1349,3249,1900,2,00409,India
960050,2023-11-22,504,iron,449,879,430,2,00409,India
293030,2023-11-22,505,oven,18490,24000,5510,2,00349,India
905273,2023-11-22,502,iphone 15 pro max,100000,135000,35000,2,00173,India
905273,2023-11-22,505,oven,18490,24000,5510,2,00173,India
905273,2023-11-22,503,mixer,1349,3249,1900,2,00173,India
905273,2023-11-22,506,monitor,3249,8000,4751,2,00173,India
905273,2023-11-22,504,iron,449,879,430,2,00173,India
570100,2023-11-22,507,washing machine,6990,16490,9500,2,00048,India
570100,2023-11-22,504,iron,449,879,430,2,00048,India
847752,2023-11-22,502,iphone 15 pro max,100000,135000,35000,2,00126,India
975967,2023-11-22,505,oven,18490,24000,5510,2,00010,India
313017,2023-11-22,501,iphone 15,60000,80000,20000,2,00472,India
313017,2023-11-22,505,oven,18490,24000,5510,2,00472,India
313017,2023-11-22,504,iron,449,879,430,2,00472,India
825323,2023-11-22,502,iphone 15 pro max,100000,135000,35000,2,00055,India
825323,2023-11-22,501,iphone 15,60000,80000,20000,2,00055,India
342350,2023-11-22,505,oven,18490,24000,5510,2,00366,India
342350,2023-11-22,506,monitor,3249,8000,4751,2,00366,India
342350,2023-11-22,504,iron,449,879,430,2,00366,India
453186,2023-11-22,506,monitor,3249,8000,4751,2,00429,India
921229,2023-11-22,507,washing machine,6990,16490,9500,2,00357,India
921229,2023-11-22,503,mixer,1349,3249,1900,2,00357,India
921229,2023-11-22,502,iphone 15 pro max,100000,135000,35000,2,00357,India
555499,2023-11-22,506,monitor,3249,8000,4751,2,00241,India
555499,2023-11-22,504,iron,449,879,430,2,00241,India
555499,2023-11-22,501,iphone 15,60000,80000,20000,2,00241,India
555499,2023-11-22,502,iphone 15 pro max,100000,135000,35000,2,00241,India
555499,2023-11-22,507,washing machine,6990,16490,9500,2,00241,India
915157,2023-11-22,504,iron,449,879,430,2,00253,India
915157,2023-11-22,507,washing machine,6990,16490,9500,2,00253,India
915157,2023-11-22,505,oven,18490,24000,5510,2,00253,India
915157,2023-11-22,501,iphone 15,60000,80000,20000,2,00253,India
455307,2023-11-22,504,iron,449,879,430,2,00110,India
455307,2023-11-22,505,oven,18490,24000,5510,2,00110,India
455307,2023-11-22,507,washing machine,6990,16490,9500,2,00110,India
796901,2023-11-22,504,iron,449,879,430,2,00138,India
796901,2023-11-22,505,oven,18490,24000,5510,2,00138,India
796901,2023-11-22,501,iphone 15,60000,80000,20000,2,00138,India
796901,2023-11-22,502,iphone 15 pro max,100000,135000,35000,2,00138,India
618567,2023-11-22,502,iphone 15 pro max,100000,135000,35000,2,00390,India
859370,2023-11-22,506,monitor,3249,8000,4751,2,00162,India
859370,2023-11-22,507,washing machine,6990,16490,9500,2,00162,India
859370,2023-11-22,503,mixer,1349,3249,1900,2,00162,India
726414,2023-11-22,504,iron,449,879,430,2,00431,India
726414,2023-11-22,501,iphone 15,60000,80000,20000,2,00431,India
134113,2023-11-22,507,washing machine,6990,16490,9500,2,00110,India
134113,2023-11-22,504,iron,449,879,430,2,00110,India
952067,2023-11-22,505,oven,18490,24000,5510,2,00207,India
952067,2023-11-22,503,mixer,1349,3249,1900,2,00207,India
952067,2023-11-22,506,monitor,3249,8000,4751,2,00207,India
231010,2023-11-22,501,iphone 15,60000,80000,20000,2,00316,India
774372,2023-11-22,504,iron,449,879,430,2,00431,India
668208,2023-11-22,507,washing machine,6990,16490,9500,2,00423,India
811937,2023-11-22,506,monitor,3249,8000,4751,2,00199,India
561145,2023-11-22,502,iphone 15 pro max,100000,135000,35000,2,00427,India
561145,2023-11-22,506,monitor,3249,8000,4751,2,00427,India
561145,2023-11-22,501,iphone 15,60000,80000,20000,2,00427,India
611915,2023-11-22,501,iphone 15,60000,80000,20000,2,00230,India
980557,2023-11-22,504,iron,449,879,430,2,00441,India
980557,2023-11-22,507,washing machine,6990,16490,9500,2,00441,India
980557,2023-11-22,502,iphone 15 pro max,100000,135000,35000,2,00441,India
980557,2023-11-22,506,monitor,3249,8000,4751,2,00441,India
980557,2023-11-22,501,iphone 15,60000,80000,20000,2,00441,India
237177,2023-11-22,501,iphone 15,60000,80000,20000,2,00403,India
237177,2023-11-22,505,oven,18490,24000,5510,2,00403,India
237177,2023-11-22,502,iphone 15 pro max,100000,135000,35000,2,00403,India
279386,2023-11-22,502,iphone 15 pro max,100000,135000,35000,2,00298,India
279386,2023-11-22,507,washing machine,6990,16490,9500,2,00298,India
279386,2023-11-22,506,monitor,3249,8000,4751,2,00298,India
591462,2023-11-22,507,washing machine,6990,16490,9500,2,00149,India
591462,2023-11-22,506,monitor,3249,8000,4751,2,00149,India
591462,2023-11-22,504,iron,449,879,430,2,00149,India
646668,2023-11-22,504,iron,449,879,430,2,00468,India
646668,2023-11-22,505,oven,18490,24000,5510,2,00468,India
646668,2023-11-22,502,iphone 15 pro max,100000,135000,35000,2,00468,India
116756,2023-11-22,507,washing machine,6990,16490,9500,2,00468,India
106941,2023-11-22,501,iphone 15,60000,80000,20000,2,00163,India
106941,2023-11-22,505,oven,18490,24000,5510,2,00163,India
837520,2023-11-22,503,mixer,1349,3249,1900,2,00029,India
197574,2023-11-22,503,mixer,1349,3249,1900,2,00441,India
197574,2023-11-22,505,oven,18490,24000,5510,2,00441,India
197574,2023-11-22,507,washing machine,6990,16490,9500,2,00441,India
830945,2023-11-22,502,iphone 15 pro max,100000,135000,35000,2,00319,India
830945,2023-11-22,505,oven,18490,24000,5510,2,00319,India
830945,2023-11-22,501,iphone 15,60000,80000,20000,2,00319,India
830945,2023-11-22,503,mixer,1349,3249,1900,2,00319,India
924865,2023-11-22,505,oven,18490,24000,5510,2,00192,India
924865,2023-11-22,502,iphone 15 pro max,100000,135000,35000,2,00192,India
961138,2023-11-22,505,oven,18490,24000,5510,2,00445,India
961138,2023-11-22,507,washing machine,6990,16490,9500,2,00445,India
961138,2023-11-22,506,monitor,3249,8000,4751,2,00445,India
961138,2023-11-22,503,mixer,1349,3249,1900,2,00445,India
891586,2023-11-22,503,mixer,1349,3249,1900,2,00136,India
442554,2023-11-22,501,iphone 15,60000,80000,20000,2,00496,India
815390,2023-11-22,502,iphone 15 pro max,100000,135000,35000,2,00401,India
815390,2023-11-22,506,monitor,3249,8000,4751,2,00401,India
801480,2023-11-22,507,washing machine,6990,16490,9500,2,00267,India
801480,2023-11-22,506,monitor,3249,8000,4751,2,00267,India
243974,2023-11-22,507,washing machine,6990,16490,9500,2,00071,India
243974,2023-11-22,504,iron,449,879,430,2,00071,India
452498,2023-11-22,501,iphone 15,60000,80000,20000,2,00237,India
452498,2023-11-22,503,mixer,1349,3249,1900,2,00237,India
452498,2023-11-22,504,iron,449,879,430,2,00237,India
452498,2023-11-22,506,monitor,3249,8000,4751,2,00237,India
312060,2023-11-22,503,mixer,1349,3249,1900,2,00418,India
312060,2023-11-22,506,monitor,3249,8000,4751,2,00418,India
312060,2023-11-22,507,washing machine,6990,16490,9500,2,00418,India
160378,2023-11-22,503,mixer,1349,3249,1900,2,00076,India
160378,2023-11-22,505,oven,18490,24000,5510,2,00076,India
160378,2023-11-22,507,washing machine,6990,16490,9500,2,00076,India
160378,2023-11-22,501,iphone 15,60000,80000,20000,2,00076,India
529859,2023-11-22,503,mixer,1349,3249,1900,2,00147,India
529859,2023-11-22,501,iphone 15,60000,80000,20000,2,00147,India
529859,2023-11-22,506,monitor,3249,8000,4751,2,00147,India
529859,2023-11-22,505,oven,18490,24000,5510,2,00147,India
349425,2023-11-22,504,iron,449,879,430,2,00281,India
349425,2023-11-22,503,mixer,1349,3249,1900,2,00281,India
349425,2023-11-22,501,iphone 15,60000,80000,20000,2,00281,India
349425,2023-11-22,507,washing machine,6990,16490,9500,2,00281,India
762184,2023-11-22,502,iphone 15 pro max,100000,135000,35000,2,00227,India
395529,2023-11-22,501,iphone 15,60000,80000,20000,2,00218,India
409297,2023-11-22,502,iphone 15 pro max,100000,135000,35000,2,00292,India
409297,2023-11-22,507,washing machine,6990,16490,9500,2,00292,India
251425,2023-11-22,507,washing machine,6990,16490,9500,2,00019,India
251425,2023-11-22,501,iphone 15,60000,80000,20000,2,00019,India
251425,2023-11-22,503,mixer,1349,3249,1900,2,00019,India
575978,2023-11-22,501,iphone 15,60000,80000,20000,2,00458,India
575978,2023-11-22,504,iron,449,879,430,2,00458,India
575978,2023-11-22,502,iphone 15 pro max,100000,135000,35000,2,00458,India
575978,2023-11-22,503,mixer,1349,3249,1900,2,00458,India
575978,2023-11-22,507,washing machine,6990,16490,9500,2,00458,India
625936,2023-11-22,503,mixer,1349,3249,1900,2,00269,India
625936,2023-11-22,507,washing machine,6990,16490,9500,2,00269,India
980812,2023-11-22,506,monitor,3249,8000,4751,2,00216,India
980812,2023-11-22,502,iphone 15 pro max,100000,135000,35000,2,00216,India
980812,2023-11-22,503,mixer,1349,3249,1900,2,00216,India
980812,2023-11-22,507,washing machine,6990,16490,9500,2,00216,India
164137,2023-11-22,507,washing machine,6990,16490,9500,2,00408,India
164137,2023-11-22,502,iphone 15 pro max,100000,135000,35000,2,00408,India
164137,2023-11-22,501,iphone 15,60000,80000,20000,2,00408,India
164137,2023-11-22,505,oven,18490,24000,5510,2,00408,India
104805,2023-11-22,507,washing machine,6990,16490,9500,2,00490,India
104805,2023-11-22,501,iphone 15,60000,80000,20000,2,00490,India
104805,2023-11-22,504,iron,449,879,430,2,00490,India
897118,2023-11-23,501,iphone 15,60000,80000,20000,2,00100,India
181137,2023-11-23,507,washing machine,6990,16490,9500,2,00235,India
181137,2023-11-23,506,monitor,3249,8000,4751,2,00235,India
181137,2023-11-23,504,iron,449,879,430,2,00235,India
572845,2023-11-23,502,iphone 15 pro max,100000,135000,35000,2,00068,India
572845,2023-11-23,507,washing machine,6990,16490,9500,2,00068,India
958209,2023-11-23,504,iron,449,879,430,2,00419,India
958209,2023-11-23,502,iphone 15 pro max,100000,135000,35000,2,00419,India
958209,2023-11-23,501,iphone 15,60000,80000,20000,2,00419,India
958209,2023-11-23,507,washing machine,6990,16490,9500,2,00419,India
138580,2023-11-23,501,iphone 15,60000,80000,20000,2,00396,India
138580,2023-11-23,503,mixer,1349,3249,1900,2,00396,India
138580,2023-11-23,502,iphone 15 pro max,100000,135000,35000,2,00396,India
138580,2023-11-23,507,washing machine,6990,16490,9500,2,00396,India
738078,2023-11-23,506,monitor,3249,8000,4751,2,00430,India
699838,2023-11-23,503,mixer,1349,3249,1900,2,00357,India
699838,2023-11-23,505,oven,18490,24000,5510,2,00357,India
699838,2023-11-23,506,monitor,3249,8000,4751,2,00357,India
680163,2023-11-23,505,oven,18490,24000,5510,2,00177,India
371476,2023-11-23,507,washing machine,6990,16490,9500,2,00079,India
371476,2023-11-23,505,oven,18490,24000,5510,2,00079,India
371476,2023-11-23,506,monitor,3249,8000,4751,2,00079,India
371476,2023-11-23,504,iron,449,879,430,2,00079,India
366425,2023-11-23,505,oven,18490,24000,5510,2,00092,India
366425,2023-11-23,502,iphone 15 pro max,100000,135000,35000,2,00092,India
366425,2023-11-23,507,washing machine,6990,16490,9500,2,00092,India
366425,2023-11-23,501,iphone 15,60000,80000,20000,2,00092,India
801127,2023-11-23,502,iphone 15 pro max,100000,135000,35000,2,00474,India
801127,2023-11-23,506,monitor,3249,8000,4751,2,00474,India
427443,2023-11-23,504,iron,449,879,430,2,00013,India
427443,2023-11-23,507,washing machine,6990,16490,9500,2,00013,India
427443,2023-11-23,502,iphone 15 pro max,100000,135000,35000,2,00013,India
811122,2023-11-23,505,oven,18490,24000,5510,2,00209,India
811122,2023-11-23,501,iphone 15,60000,80000,20000,2,00209,India
811122,2023-11-23,504,iron,449,879,430,2,00209,India
640515,2023-11-23,501,iphone 15,60000,80000,20000,2,00227,India
640515,2023-11-23,502,iphone 15 pro max,100000,135000,35000,2,00227,India
640515,2023-11-23,504,iron,449,879,430,2,00227,India
140307,2023-11-23,506,monitor,3249,8000,4751,2,00038,India
140307,2023-11-23,501,iphone 15,60000,80000,20000,2,00038,India
140307,2023-11-23,503,mixer,1349,3249,1900,2,00038,India
547439,2023-11-23,504,iron,449,879,430,2,00398,India
547439,2023-11-23,502,iphone 15 pro max,100000,135000,35000,2,00398,India
547439,2023-11-23,506,monitor,3249,8000,4751,2,00398,India
397943,2023-11-23,507,washing machine,6990,16490,9500,2,00254,India
397943,2023-11-23,503,mixer,1349,3249,1900,2,00254,India
895561,2023-11-23,504,iron,449,879,430,2,00240,India
452244,2023-11-23,503,mixer,1349,3249,1900,2,00377,India
452244,2023-11-23,502,iphone 15 pro max,100000,135000,35000,2,00377,India
452244,2023-11-23,505,oven,18490,24000,5510,2,00377,India
452244,2023-11-23,504,iron,449,879,430,2,00377,India
452244,2023-11-23,501,iphone 15,60000,80000,20000,2,00377,India
823568,2023-11-23,505,oven,18490,24000,5510,2,00262,India
823568,2023-11-23,504,iron,449,879,430,2,00262,India
197694,2023-11-23,502,iphone 15 pro max,100000,135000,35000,2,00378,India
197694,2023-11-23,506,monitor,3249,8000,4751,2,00378,India
197694,2023-11-23,503,mixer,1349,3249,1900,2,00378,India
197694,2023-11-23,501,iphone 15,60000,80000,20000,2,00378,India
540287,2023-11-23,506,monitor,3249,8000,4751,2,00137,India
107607,2023-11-23,502,iphone 15 pro max,100000,135000,35000,2,00101,India
107607,2023-11-23,506,monitor,3249,8000,4751,2,00101,India
107607,2023-11-23,501,iphone 15,60000,80000,20000,2,00101,India
698735,2023-11-23,506,monitor,3249,8000,4751,2,00465,India
986291,2023-11-23,503,mixer,1349,3249,1900,2,00265,India
843425,2023-11-23,505,oven,18490,24000,5510,2,00389,India
843425,2023-11-23,506,monitor,3249,8000,4751,2,00389,India
421569,2023-11-23,503,mixer,1349,3249,1900,2,00040,India
421569,2023-11-23,506,monitor,3249,8000,4751,2,00040,India
879416,2023-11-23,503,mixer,1349,3249,1900,2,00171,India
879416,2023-11-23,507,washing machine,6990,16490,9500,2,00171,India
879416,2023-11-23,505,oven,18490,24000,5510,2,00171,India
348554,2023-11-23,505,oven,18490,24000,5510,2,00191,India
348554,2023-11-23,501,iphone 15,60000,80000,20000,2,00191,India
348554,2023-11-23,502,iphone 15 pro max,100000,135000,35000,2,00191,India
711459,2023-11-23,501,iphone 15,60000,80000,20000,2,00483,India
711459,2023-11-23,506,monitor,3249,8000,4751,2,00483,India
711459,2023-11-23,502,iphone 15 pro max,100000,135000,35000,2,00483,India
711459,2023-11-23,504,iron,449,879,430,2,00483,India
979212,2023-11-23,503,mixer,1349,3249,1900,2,00205,India
979212,2023-11-23,502,iphone 15 pro max,100000,135000,35000,2,00205,India
718334,2023-11-23,506,monitor,3249,8000,4751,2,00372,India
718334,2023-11-23,507,washing machine,6990,16490,9500,2,00372,India
253947,2023-11-23,504,iron,449,879,430,2,00247,India
253947,2023-11-23,503,mixer,1349,3249,1900,2,00247,India
253947,2023-11-23,505,oven,18490,24000,5510,2,00247,India
922169,2023-11-23,501,iphone 15,60000,80000,20000,2,00195,India
922169,2023-11-23,503,mixer,1349,3249,1900,2,00195,India
195922,2023-11-23,504,iron,449,879,430,2,00280,India
980286,2023-11-23,501,iphone 15,60000,80000,20000,2,00171,India
980286,2023-11-23,506,monitor,3249,8000,4751,2,00171,India
980286,2023-11-23,502,iphone 15 pro max,100000,135000,35000,2,00171,India
980286,2023-11-23,504,iron,449,879,430,2,00171,India
808525,2023-11-23,503,mixer,1349,3249,1900,2,00317,India
808525,2023-11-23,504,iron,449,879,430,2,00317,India
808525,2023-11-23,502,iphone 15 pro max,100000,135000,35000,2,00317,India
808525,2023-11-23,506,monitor,3249,8000,4751,2,00317,India
846825,2023-11-23,502,iphone 15 pro max,100000,135000,35000,2,00403,India
846825,2023-11-23,505,oven,18490,24000,5510,2,00403,India
658212,2023-11-23,504,iron,449,879,430,2,00324,India
658212,2023-11-23,507,washing machine,6990,16490,9500,2,00324,India
658212,2023-11-23,505,oven,18490,24000,5510,2,00324,India
658212,2023-11-23,502,iphone 15 pro max,100000,135000,35000,2,00324,India
433903,2023-11-23,507,washing machine,6990,16490,9500,2,00474,India
433903,2023-11-23,503,mixer,1349,3249,1900,2,00474,India
433903,2023-11-23,501,iphone 15,60000,80000,20000,2,00474,India
833116,2023-11-23,504,iron,449,879,430,2,00026,India
833116,2023-11-23,505,oven,18490,24000,5510,2,00026,India
919418,2023-11-23,502,iphone 15 pro max,100000,135000,35000,2,00478,India
115151,2023-11-23,507,washing machine,6990,16490,9500,2,00034,India
115151,2023-11-23,503,mixer,1349,3249,1900,2,00034,India
115151,2023-11-23,504,iron,449,879,430,2,00034,India
115151,2023-11-23,501,iphone 15,60000,80000,20000,2,00034,India
578077,2023-11-23,501,iphone 15,60000,80000,20000,2,00445,India
578077,2023-11-23,502,iphone 15 pro max,100000,135000,35000,2,00445,India
578077,2023-11-23,506,monitor,3249,8000,4751,2,00445,India
578077,2023-11-23,503,mixer,1349,3249,1900,2,00445,India
578077,2023-11-23,505,oven,18490,24000,5510,2,00445,India
771171,2023-11-23,506,monitor,3249,8000,4751,2,00241,India
499570,2023-11-23,507,washing machine,6990,16490,9500,2,00306,India
499570,2023-11-23,506,monitor,3249,8000,4751,2,00306,India
499570,2023-11-23,502,iphone 15 pro max,100000,135000,35000,2,00306,India
217285,2023-11-23,503,mixer,1349,3249,1900,2,00085,India
217285,2023-11-23,505,oven,18490,24000,5510,2,00085,India
217285,2023-11-23,506,monitor,3249,8000,4751,2,00085,India
512434,2023-11-23,505,oven,18490,24000,5510,2,00015,India
512434,2023-11-23,507,washing machine,6990,16490,9500,2,00015,India
577516,2023-11-23,502,iphone 15 pro max,100000,135000,35000,2,00357,India
577516,2023-11-23,504,iron,449,879,430,2,00357,India
577516,2023-11-23,507,washing machine,6990,16490,9500,2,00357,India
577516,2023-11-23,505,oven,18490,24000,5510,2,00357,India
911386,2023-11-23,502,iphone 15 pro max,100000,135000,35000,2,00301,India
124336,2023-11-23,504,iron,449,879,430,2,00200,India
124336,2023-11-23,502,iphone 15 pro max,100000,135000,35000,2,00200,India
914399,2023-11-23,504,iron,449,879,430,2,00234,India
875604,2023-11-23,505,oven,18490,24000,5510,2,00240,India
875604,2023-11-23,504,iron,449,879,430,2,00240,India
875604,2023-11-23,507,washing machine,6990,16490,9500,2,00240,India
504171,2023-11-23,506,monitor,3249,8000,4751,2,00399,India
504171,2023-11-23,507,washing machine,6990,16490,9500,2,00399,India
504171,2023-11-23,501,iphone 15,60000,80000,20000,2,00399,India
104874,2023-11-23,507,washing machine,6990,16490,9500,2,00374,India
104874,2023-11-23,503,mixer,1349,3249,1900,2,00374,India
104874,2023-11-23,505,oven,18490,24000,5510,2,00374,India
155709,2023-11-23,502,iphone 15 pro max,100000,135000,35000,2,00294,India
155709,2023-11-23,501,iphone 15,60000,80000,20000,2,00294,India
988868,2023-11-23,507,washing machine,6990,16490,9500,2,00144,India
988868,2023-11-23,502,iphone 15 pro max,100000,135000,35000,2,00144,India
988868,2023-11-23,503,mixer,1349,3249,1900,2,00144,India
400428,2023-11-23,506,monitor,3249,8000,4751,2,00211,India
400428,2023-11-23,505,oven,18490,24000,5510,2,00211,India
400428,2023-11-23,501,iphone 15,60000,80000,20000,2,00211,India
446546,2023-11-23,507,washing machine,6990,16490,9500,2,00486,India
446546,2023-11-23,501,iphone 15,60000,80000,20000,2,00486,India
446546,2023-11-23,504,iron,449,879,430,2,00486,India
446546,2023-11-23,503,mixer,1349,3249,1900,2,00486,India
486891,2023-11-23,503,mixer,1349,3249,1900,2,00179,India
722624,2023-11-23,507,washing machine,6990,16490,9500,2,00277,India
722624,2023-11-23,506,monitor,3249,8000,4751,2,00277,India
722624,2023-11-23,504,iron,449,879,430,2,00277,India
722624,2023-11-23,501,iphone 15,60000,80000,20000,2,00277,India
833725,2023-11-23,502,iphone 15 pro max,100000,135000,35000,2,00470,India
833725,2023-11-23,505,oven,18490,24000,5510,2,00470,India
954659,2023-11-23,506,monitor,3249,8000,4751,2,00468,India
954659,2023-11-23,502,iphone 15 pro max,100000,135000,35000,2,00468,India
637453,2023-11-23,501,iphone 15,60000,80000,20000,2,00167,India
637453,2023-11-23,504,iron,449,879,430,2,00167,India
637453,2023-11-23,502,iphone 15 pro max,100000,135000,35000,2,00167,India
379589,2023-11-23,503,mixer,1349,3249,1900,2,00177,India
379589,2023-11-23,505,oven,18490,24000,5510,2,00177,India
379589,2023-11-23,502,iphone 15 pro max,100000,135000,35000,2,00177,India
379589,2023-11-23,506,monitor,3249,8000,4751,2,00177,India
379589,2023-11-23,501,iphone 15,60000,80000,20000,2,00177,India
885540,2023-11-23,506,monitor,3249,8000,4751,2,00272,India
526660,2023-11-23,501,iphone 15,60000,80000,20000,2,00337,India
526660,2023-11-23,502,iphone 15 pro max,100000,135000,35000,2,00337,India
526660,2023-11-23,507,washing machine,6990,16490,9500,2,00337,India
138624,2023-11-23,503,mixer,1349,3249,1900,2,00281,India
138624,2023-11-23,506,monitor,3249,8000,4751,2,00281,India
138624,2023-11-23,501,iphone 15,60000,80000,20000,2,00281,India
138624,2023-11-23,507,washing machine,6990,16490,9500,2,00281,India
534955,2023-11-23,502,iphone 15 pro max,100000,135000,35000,2,00072,India
218706,2023-11-23,505,oven,18490,24000,5510,2,00165,India
218706,2023-11-23,502,iphone 15 pro max,100000,135000,35000,2,00165,India
218706,2023-11-23,507,washing machine,6990,16490,9500,2,00165,India
218706,2023-11-23,506,monitor,3249,8000,4751,2,00165,India
639547,2023-11-23,501,iphone 15,60000,80000,20000,2,00220,India
639547,2023-11-23,502,iphone 15 pro max,100000,135000,35000,2,00220,India
639547,2023-11-23,504,iron,449,879,430,2,00220,India
675191,2023-11-23,501,iphone 15,60000,80000,20000,2,00363,India
675191,2023-11-23,504,iron,449,879,430,2,00363,India
288701,2023-11-23,501,iphone 15,60000,80000,20000,2,00324,India
288701,2023-11-23,504,iron,449,879,430,2,00324,India
288701,2023-11-23,507,washing machine,6990,16490,9500,2,00324,India
262372,2023-11-23,507,washing machine,6990,16490,9500,2,00384,India
262372,2023-11-23,502,iphone 15 pro max,100000,135000,35000,2,00384,India
193408,2023-11-23,503,mixer,1349,3249,1900,2,00396,India
193408,2023-11-23,501,iphone 15,60000,80000,20000,2,00396,India
193408,2023-11-23,507,washing machine,6990,16490,9500,2,00396,India
193408,2023-11-23,504,iron,449,879,430,2,00396,India
340094,2023-11-23,505,oven,18490,24000,5510,2,00068,India
340094,2023-11-23,507,washing machine,6990,16490,9500,2,00068,India
340094,2023-11-23,503,mixer,1349,3249,1900,2,00068,India
693060,2023-11-23,501,iphone 15,60000,80000,20000,2,00173,India
693060,2023-11-23,507,washing machine,6990,16490,9500,2,00173,India
693060,2023-11-23,506,monitor,3249,8000,4751,2,00173,India
254648,2023-11-23,503,mixer,1349,3249,1900,2,00480,India
254648,2023-11-23,501,iphone 15,60000,80000,20000,2,00480,India
376797,2023-11-23,502,iphone 15 pro max,100000,135000,35000,2,00121,India
376797,2023-11-23,505,oven,18490,24000,5510,2,00121,India
376797,2023-11-23,507,washing machine,6990,16490,9500,2,00121,India
376797,2023-11-23,501,iphone 15,60000,80000,20000,2,00121,India
661936,2023-11-23,502,iphone 15 pro max,100000,135000,35000,2,00241,India
661936,2023-11-23,507,washing machine,6990,16490,9500,2,00241,India
661936,2023-11-23,504,iron,449,879,430,2,00241,India
374900,2023-11-23,507,washing machine,6990,16490,9500,2,00082,India
374900,2023-11-23,506,monitor,3249,8000,4751,2,00082,India
706221,2023-11-23,506,monitor,3249,8000,4751,2,00473,India
706221,2023-11-23,502,iphone 15 pro max,100000,135000,35000,2,00473,India
706221,2023-11-23,501,iphone 15,60000,80000,20000,2,00473,India
802401,2023-11-23,502,iphone 15 pro max,100000,135000,35000,2,00447,India
183719,2023-11-23,504,iron,449,879,430,2,00486,India
183719,2023-11-23,505,oven,18490,24000,5510,2,00486,India
183719,2023-11-23,506,monitor,3249,8000,4751,2,00486,India
183719,2023-11-23,502,iphone 15 pro max,100000,135000,35000,2,00486,India
828763,2023-11-23,502,iphone 15 pro max,100000,135000,35000,2,00220,India
828763,2023-11-23,507,washing machine,6990,16490,9500,2,00220,India
828763,2023-11-23,506,monitor,3249,8000,4751,2,00220,India
674894,2023-11-23,505,oven,18490,24000,5510,2,00259,India
674894,2023-11-23,501,iphone 15,60000,80000,20000,2,00259,India
674894,2023-11-23,507,washing machine,6990,16490,9500,2,00259,India
674894,2023-11-23,506,monitor,3249,8000,4751,2,00259,India
674894,2023-11-23,502,iphone 15 pro max,100000,135000,35000,2,00259,India
201055,2023-11-23,501,iphone 15,60000,80000,20000,2,00016,India
465041,2023-11-23,502,iphone 15 pro max,100000,135000,35000,2,00051,India
465041,2023-11-23,505,oven,18490,24000,5510,2,00051,India
976064,2023-11-23,507,washing machine,6990,16490,9500,2,00483,India
976064,2023-11-23,505,oven,18490,24000,5510,2,00483,India
838269,2023-11-23,502,iphone 15 pro max,100000,135000,35000,2,00109,India
239337,2023-11-23,507,washing machine,6990,16490,9500,2,00429,India
239337,2023-11-23,503,mixer,1349,3249,1900,2,00429,India
892883,2023-11-23,507,washing machine,6990,16490,9500,2,00111,India
892883,2023-11-23,502,iphone 15 pro max,100000,135000,35000,2,00111,India
892883,2023-11-23,501,iphone 15,60000,80000,20000,2,00111,India
779200,2023-11-23,506,monitor,3249,8000,4751,2,00157,India
779200,2023-11-23,503,mixer,1349,3249,1900,2,00157,India
779200,2023-11-23,505,oven,18490,24000,5510,2,00157,India
779200,2023-11-23,507,washing machine,6990,16490,9500,2,00157,India
672450,2023-11-23,506,monitor,3249,8000,4751,2,00286,India
672450,2023-11-23,503,mixer,1349,3249,1900,2,00286,India
672450,2023-11-23,504,iron,449,879,430,2,00286,India
672450,2023-11-23,501,iphone 15,60000,80000,20000,2,00286,India
180286,2023-11-23,507,washing machine,6990,16490,9500,2,00279,India
180286,2023-11-23,504,iron,449,879,430,2,00279,India
180286,2023-11-23,506,monitor,3249,8000,4751,2,00279,India
114457,2023-11-23,507,washing machine,6990,16490,9500,2,00408,India
114457,2023-11-23,503,mixer,1349,3249,1900,2,00408,India
726437,2023-11-23,502,iphone 15 pro max,100000,135000,35000,2,00075,India
726437,2023-11-23,507,washing machine,6990,16490,9500,2,00075,India
726437,2023-11-23,506,monitor,3249,8000,4751,2,00075,India
226537,2023-11-23,501,iphone 15,60000,80000,20000,2,00127,India
226537,2023-11-23,504,iron,449,879,430,2,00127,India
226537,2023-11-23,505,oven,18490,24000,5510,2,00127,India
226537,2023-11-23,502,iphone 15 pro max,100000,135000,35000,2,00127,India
226537,2023-11-23,506,monitor,3249,8000,4751,2,00127,India
643545,2023-11-24,505,oven,18490,24000,5510,2,00174,India
643545,2023-11-24,502,iphone 15 pro max,100000,135000,35000,2,00174,India
643545,2023-11-24,503,mixer,1349,3249,1900,2,00174,India
686813,2023-11-24,503,mixer,1349,3249,1900,2,00281,India
686813,2023-11-24,506,monitor,3249,8000,4751,2,00281,India
686813,2023-11-24,502,iphone 15 pro max,100000,135000,35000,2,00281,India
686813,2023-11-24,501,iphone 15,60000,80000,20000,2,00281,India
941628,2023-11-24,506,monitor,3249,8000,4751,2,00477,India
941628,2023-11-24,504,iron,449,879,430,2,00477,India
912440,2023-11-24,504,iron,449,879,430,2,00291,India
912440,2023-11-24,505,oven,18490,24000,5510,2,00291,India
972456,2023-11-24,507,washing machine,6990,16490,9500,2,00402,India
972456,2023-11-24,502,iphone 15 pro max,100000,135000,35000,2,00402,India
972456,2023-11-24,505,oven,18490,24000,5510,2,00402,India
868615,2023-11-24,502,iphone 15 pro max,100000,135000,35000,2,00369,India
868615,2023-11-24,501,iphone 15,60000,80000,20000,2,00369,India
868615,2023-11-24,506,monitor,3249,8000,4751,2,00369,India
868615,2023-11-24,507,washing machine,6990,16490,9500,2,00369,India
726409,2023-11-24,506,monitor,3249,8000,4751,2,00213,India
331491,2023-11-24,503,mixer,1349,3249,1900,2,00490,India
331491,2023-11-24,501,iphone 15,60000,80000,20000,2,00490,India
331491,2023-11-24,504,iron,449,879,430,2,00490,India
405146,2023-11-24,507,washing machine,6990,16490,9500,2,00156,India
433569,2023-11-24,502,iphone 15 pro max,100000,135000,35000,2,00004,India
433569,2023-11-24,503,mixer,1349,3249,1900,2,00004,India
433569,2023-11-24,507,washing machine,6990,16490,9500,2,00004,India
598742,2023-11-24,501,iphone 15,60000,80000,20000,2,00408,India
598742,2023-11-24,503,mixer,1349,3249,1900,2,00408,India
895257,2023-11-24,505,oven,18490,24000,5510,2,00221,India
895257,2023-11-24,507,washing machine,6990,16490,9500,2,00221,India
895257,2023-11-24,506,monitor,3249,8000,4751,2,00221,India
895257,2023-11-24,501,iphone 15,60000,80000,20000,2,00221,India
526905,2023-11-24,505,oven,18490,24000,5510,2,00164,India
526905,2023-11-24,506,monitor,3249,8000,4751,2,00164,India
526905,2023-11-24,502,iphone 15 pro max,100000,135000,35000,2,00164,India
526905,2023-11-24,503,mixer,1349,3249,1900,2,00164,India
383325,2023-11-24,502,iphone 15 pro max,100000,135000,35000,2,00398,India
383325,2023-11-24,503,mixer,1349,3249,1900,2,00398,India
383325,2023-11-24,505,oven,18490,24000,5510,2,00398,India
383325,2023-11-24,506,monitor,3249,8000,4751,2,00398,India
491067,2023-11-24,501,iphone 15,60000,80000,20000,2,00411,India
491067,2023-11-24,506,monitor,3249,8000,4751,2,00411,India
546623,2023-11-24,503,mixer,1349,3249,1900,2,00148,India
546623,2023-11-24,506,monitor,3249,8000,4751,2,00148,India
546623,2023-11-24,507,washing machine,6990,16490,9500,2,00148,India
546623,2023-11-24,501,iphone 15,60000,80000,20000,2,00148,India
711511,2023-11-24,501,iphone 15,60000,80000,20000,2,00176,India
391874,2023-11-24,502,iphone 15 pro max,100000,135000,35000,2,00073,India
391874,2023-11-24,501,iphone 15,60000,80000,20000,2,00073,India
391874,2023-11-24,505,oven,18490,24000,5510,2,00073,India
391874,2023-11-24,506,monitor,3249,8000,4751,2,00073,India
180674,2023-11-24,506,monitor,3249,8000,4751,2,00437,India
180674,2023-11-24,502,iphone 15 pro max,100000,135000,35000,2,00437,India
180674,2023-11-24,504,iron,449,879,430,2,00437,India
511144,2023-11-24,501,iphone 15,60000,80000,20000,2,00177,India
725211,2023-11-24,507,washing machine,6990,16490,9500,2,00110,India
269322,2023-11-24,502,iphone 15 pro max,100000,135000,35000,2,00325,India
269322,2023-11-24,504,iron,449,879,430,2,00325,India
269322,2023-11-24,501,iphone 15,60000,80000,20000,2,00325,India
269322,2023-11-24,503,mixer,1349,3249,1900,2,00325,India
671939,2023-11-24,502,iphone 15 pro max,100000,135000,35000,2,00067,India
671939,2023-11-24,506,monitor,3249,8000,4751,2,00067,India
606951,2023-11-24,506,monitor,3249,8000,4751,2,00067,India
606951,2023-11-24,504,iron,449,879,430,2,00067,India
606951,2023-11-24,505,oven,18490,24000,5510,2,00067,India
746134,2023-11-24,501,iphone 15,60000,80000,20000,2,00111,India
746134,2023-11-24,502,iphone 15 pro max,100000,135000,35000,2,00111,India
746134,2023-11-24,503,mixer,1349,3249,1900,2,00111,India
746134,2023-11-24,505,oven,18490,24000,5510,2,00111,India
421248,2023-11-24,506,monitor,3249,8000,4751,2,00352,India
421248,2023-11-24,504,iron,449,879,430,2,00352,India
421248,2023-11-24,507,washing machine,6990,16490,9500,2,00352,India
421248,2023-11-24,502,iphone 15 pro max,100000,135000,35000,2,00352,India
970231,2023-11-24,503,mixer,1349,3249,1900,2,00097,India
970231,2023-11-24,505,oven,18490,24000,5510,2,00097,India
651832,2023-11-24,507,washing machine,6990,16490,9500,2,00060,India
651832,2023-11-24,505,oven,18490,24000,5510,2,00060,India
539179,2023-11-24,506,monitor,3249,8000,4751,2,00318,India
611791,2023-11-24,501,iphone 15,60000,80000,20000,2,00396,India
611791,2023-11-24,507,washing machine,6990,16490,9500,2,00396,India
611791,2023-11-24,504,iron,449,879,430,2,00396,India
753109,2023-11-24,502,iphone 15 pro max,100000,135000,35000,2,00247,India
753109,2023-11-24,503,mixer,1349,3249,1900,2,00247,India
331241,2023-11-24,501,iphone 15,60000,80000,20000,2,00040,India
331241,2023-11-24,507,washing machine,6990,16490,9500,2,00040,India
191111,2023-11-24,504,iron,449,879,430,2,00465,India
191111,2023-11-24,506,monitor,3249,8000,4751,2,00465,India
314933,2023-11-24,502,iphone 15 pro max,100000,135000,35000,2,00214,India
314933,2023-11-24,505,oven,18490,24000,5510,2,00214,India
314933,2023-11-24,501,iphone 15,60000,80000,20000,2,00214,India
314933,2023-11-24,503,mixer,1349,3249,1900,2,00214,India
612020,2023-11-24,503,mixer,1349,3249,1900,2,00031,India
612020,2023-11-24,506,monitor,3249,8000,4751,2,00031,India
612020,2023-11-24,505,oven,18490,24000,5510,2,00031,India
212985,2023-11-24,505,oven,18490,24000,5510,2,00311,India
212985,2023-11-24,501,iphone 15,60000,80000,20000,2,00311,India
212985,2023-11-24,502,iphone 15 pro max,100000,135000,35000,2,00311,India
265977,2023-11-24,504,iron,449,879,430,2,00037,India
265977,2023-11-24,505,oven,18490,24000,5510,2,00037,India
265977,2023-11-24,507,washing machine,6990,16490,9500,2,00037,India
265977,2023-11-24,502,iphone 15 pro max,100000,135000,35000,2,00037,India
265977,2023-11-24,503,mixer,1349,3249,1900,2,00037,India
739430,2023-11-24,503,mixer,1349,3249,1900,2,00055,India
739430,2023-11-24,506,monitor,3249,8000,4751,2,00055,India
739430,2023-11-24,505,oven,18490,24000,5510,2,00055,India
739430,2023-11-24,507,washing machine,6990,16490,9500,2,00055,India
432413,2023-11-24,503,mixer,1349,3249,1900,2,00336,India
432413,2023-11-24,501,iphone 15,60000,80000,20000,2,00336,India
242214,2023-11-24,504,iron,449,879,430,2,00438,India
502963,2023-11-24,502,iphone 15 pro max,100000,135000,35000,2,00035,India
502963,2023-11-24,503,mixer,1349,3249,1900,2,00035,India
562800,2023-11-24,502,iphone 15 pro max,100000,135000,35000,2,00335,India
562800,2023-11-24,501,iphone 15,60000,80000,20000,2,00335,India
562800,2023-11-24,507,washing machine,6990,16490,9500,2,00335,India
562800,2023-11-24,503,mixer,1349,3249,1900,2,00335,India
971064,2023-11-24,503,mixer,1349,3249,1900,2,00105,India
971064,2023-11-24,505,oven,18490,24000,5510,2,00105,India
687438,2023-11-24,506,monitor,3249,8000,4751,2,00459,India
509359,2023-11-24,503,mixer,1349,3249,1900,2,00479,India
509359,2023-11-24,501,iphone 15,60000,80000,20000,2,00479,India
509359,2023-11-24,507,washing machine,6990,16490,9500,2,00479,India
509359,2023-11-24,504,iron,449,879,430,2,00479,India
252485,2023-11-24,501,iphone 15,60000,80000,20000,2,00053,India
252485,2023-11-24,505,oven,18490,24000,5510,2,00053,India
252485,2023-11-24,507,washing machine,6990,16490,9500,2,00053,India
252485,2023-11-24,506,monitor,3249,8000,4751,2,00053,India
562359,2023-11-24,506,monitor,3249,8000,4751,2,00444,India
562359,2023-11-24,505,oven,18490,24000,5510,2,00444,India
502490,2023-11-24,507,washing machine,6990,16490,9500,2,00122,India
502490,2023-11-24,501,iphone 15,60000,80000,20000,2,00122,India
502490,2023-11-24,505,oven,18490,24000,5510,2,00122,India
543618,2023-11-24,504,iron,449,879,430,2,00036,India
543618,2023-11-24,507,washing machine,6990,16490,9500,2,00036,India
685767,2023-11-24,506,monitor,3249,8000,4751,2,00157,India
685767,2023-11-24,507,washing machine,6990,16490,9500,2,00157,India
892552,2023-11-24,502,iphone 15 pro max,100000,135000,35000,2,00449,India
892552,2023-11-24,501,iphone 15,60000,80000,20000,2,00449,India
892552,2023-11-24,505,oven,18490,24000,5510,2,00449,India
892552,2023-11-24,504,iron,449,879,430,2,00449,India
892552,2023-11-24,503,mixer,1349,3249,1900,2,00449,India
723435,2023-11-24,505,oven,18490,24000,5510,2,00366,India
723435,2023-11-24,501,iphone 15,60000,80000,20000,2,00366,India
723435,2023-11-24,503,mixer,1349,3249,1900,2,00366,India
324651,2023-11-24,504,iron,449,879,430,2,00014,India
499357,2023-11-24,505,oven,18490,24000,5510,2,00441,India
499357,2023-11-24,501,iphone 15,60000,80000,20000,2,00441,India
336781,2023-11-24,504,iron,449,879,430,2,00206,India
336781,2023-11-24,503,mixer,1349,3249,1900,2,00206,India
336781,2023-11-24,502,iphone 15 pro max,100000,135000,35000,2,00206,India
140793,2023-11-24,507,washing machine,6990,16490,9500,2,00160,India
727472,2023-11-24,503,mixer,1349,3249,1900,2,00399,India
727472,2023-11-24,502,iphone 15 pro max,100000,135000,35000,2,00399,India
727472,2023-11-24,504,iron,449,879,430,2,00399,India
727472,2023-11-24,507,washing machine,6990,16490,9500,2,00399,India
554282,2023-11-24,507,washing machine,6990,16490,9500,2,00439,India
748460,2023-11-24,501,iphone 15,60000,80000,20000,2,00123,India
748460,2023-11-24,506,monitor,3249,8000,4751,2,00123,India
748460,2023-11-24,507,washing machine,6990,16490,9500,2,00123,India
747881,2023-11-24,505,oven,18490,24000,5510,2,00364,India
747881,2023-11-24,503,mixer,1349,3249,1900,2,00364,India
747881,2023-11-24,507,washing machine,6990,16490,9500,2,00364,India
411404,2023-11-24,507,washing machine,6990,16490,9500,2,00111,India
411404,2023-11-24,504,iron,449,879,430,2,00111,India
185610,2023-11-24,502,iphone 15 pro max,100000,135000,35000,2,00416,India
185610,2023-11-24,507,washing machine,6990,16490,9500,2,00416,India
999358,2023-11-24,501,iphone 15,60000,80000,20000,2,00298,India
539047,2023-11-24,502,iphone 15 pro max,100000,135000,35000,2,00328,India
673082,2023-11-24,504,iron,449,879,430,2,00308,India
279382,2023-11-24,502,iphone 15 pro max,100000,135000,35000,2,00346,India
279382,2023-11-24,501,iphone 15,60000,80000,20000,2,00346,India
279382,2023-11-24,505,oven,18490,24000,5510,2,00346,India
279382,2023-11-24,504,iron,449,879,430,2,00346,India
302258,2023-11-24,504,iron,449,879,430,2,00078,India
302258,2023-11-24,506,monitor,3249,8000,4751,2,00078,India
302258,2023-11-24,503,mixer,1349,3249,1900,2,00078,India
302258,2023-11-24,502,iphone 15 pro max,100000,135000,35000,2,00078,India
485775,2023-11-24,502,iphone 15 pro max,100000,135000,35000,2,00346,India
504430,2023-11-24,503,mixer,1349,3249,1900,2,00332,India
504430,2023-11-24,502,iphone 15 pro max,100000,135000,35000,2,00332,India
504430,2023-11-24,504,iron,449,879,430,2,00332,India
960631,2023-11-24,507,washing machine,6990,16490,9500,2,00101,India
960631,2023-11-24,501,iphone 15,60000,80000,20000,2,00101,India
114569,2023-11-24,504,iron,449,879,430,2,00190,India
472428,2023-11-24,501,iphone 15,60000,80000,20000,2,00314,India
472428,2023-11-24,504,iron,449,879,430,2,00314,India
472428,2023-11-24,506,monitor,3249,8000,4751,2,00314,India
472428,2023-11-24,502,iphone 15 pro max,100000,135000,35000,2,00314,India
510762,2023-11-24,501,iphone 15,60000,80000,20000,2,00393,India
510762,2023-11-24,504,iron,449,879,430,2,00393,India
510762,2023-11-24,503,mixer,1349,3249,1900,2,00393,India
505743,2023-11-24,505,oven,18490,24000,5510,2,00216,India
505743,2023-11-24,506,monitor,3249,8000,4751,2,00216,India
561127,2023-11-24,507,washing machine,6990,16490,9500,2,00356,India
561127,2023-11-24,506,monitor,3249,8000,4751,2,00356,India
561127,2023-11-24,504,iron,449,879,430,2,00356,India
643947,2023-11-24,501,iphone 15,60000,80000,20000,2,00262,India
720193,2023-11-24,501,iphone 15,60000,80000,20000,2,00483,India
459625,2023-11-24,501,iphone 15,60000,80000,20000,2,00171,India
459625,2023-11-24,503,mixer,1349,3249,1900,2,00171,India
281401,2023-11-24,507,washing machine,6990,16490,9500,2,00045,India
281401,2023-11-24,502,iphone 15 pro max,100000,135000,35000,2,00045,India
281401,2023-11-24,501,iphone 15,60000,80000,20000,2,00045,India
593306,2023-11-24,507,washing machine,6990,16490,9500,2,00161,India
309384,2023-11-24,501,iphone 15,60000,80000,20000,2,00066,India
309384,2023-11-24,503,mixer,1349,3249,1900,2,00066,India
309384,2023-11-24,507,washing machine,6990,16490,9500,2,00066,India
614600,2023-11-24,503,mixer,1349,3249,1900,2,00256,India
614600,2023-11-24,506,monitor,3249,8000,4751,2,00256,India
614600,2023-11-24,507,washing machine,6990,16490,9500,2,00256,India
907090,2023-11-24,505,oven,18490,24000,5510,2,00019,India
907090,2023-11-24,504,iron,449,879,430,2,00019,India
907090,2023-11-24,507,washing machine,6990,16490,9500,2,00019,India
456084,2023-11-24,507,washing machine,6990,16490,9500,2,00356,India
456084,2023-11-24,503,mixer,1349,3249,1900,2,00356,India
456084,2023-11-24,502,iphone 15 pro max,100000,135000,35000,2,00356,India
456084,2023-11-24,501,iphone 15,60000,80000,20000,2,00356,India
274219,2023-11-24,502,iphone 15 pro max,100000,135000,35000,2,00441,India
274219,2023-11-24,505,oven,18490,24000,5510,2,00441,India
274219,2023-11-24,506,monitor,3249,8000,4751,2,00441,India
942403,2023-11-24,503,mixer,1349,3249,1900,2,00170,India
942403,2023-11-24,502,iphone 15 pro max,100000,135000,35000,2,00170,India
856122,2023-11-24,503,mixer,1349,3249,1900,2,00379,India
283870,2023-11-24,502,iphone 15 pro max,100000,135000,35000,2,00372,India
283870,2023-11-24,507,washing machine,6990,16490,9500,2,00372,India
206007,2023-11-24,503,mixer,1349,3249,1900,2,00478,India
760277,2023-11-24,503,mixer,1349,3249,1900,2,00256,India
678960,2023-11-24,505,oven,18490,24000,5510,2,00175,India
678960,2023-11-24,501,iphone 15,60000,80000,20000,2,00175,India
678960,2023-11-24,507,washing machine,6990,16490,9500,2,00175,India
970190,2023-11-24,505,oven,18490,24000,5510,2,00234,India
970190,2023-11-24,502,iphone 15 pro max,100000,135000,35000,2,00234,India
754543,2023-11-24,505,oven,18490,24000,5510,2,00052,India
754543,2023-11-24,507,washing machine,6990,16490,9500,2,00052,India
922541,2023-11-24,506,monitor,3249,8000,4751,2,00499,India
922541,2023-11-24,504,iron,449,879,430,2,00499,India
144022,2023-11-24,504,iron,449,879,430,2,00488,India
638167,2023-11-24,505,oven,18490,24000,5510,2,00366,India
638167,2023-11-24,502,iphone 15 pro max,100000,135000,35000,2,00366,India
211521,2023-11-24,504,iron,449,879,430,2,00412,India
211521,2023-11-24,507,washing machine,6990,16490,9500,2,00412,India
719631,2023-11-24,503,mixer,1349,3249,1900,2,00308,India
608891,2023-11-24,507,washing machine,6990,16490,9500,2,00295,India
608891,2023-11-24,503,mixer,1349,3249,1900,2,00295,India
608891,2023-11-24,506,monitor,3249,8000,4751,2,00295,India
455102,2023-11-25,503,mixer,1349,3249,1900,2,00171,India
455102,2023-11-25,504,iron,449,879,430,2,00171,India
455102,2023-11-25,506,monitor,3249,8000,4751,2,00171,India
455102,2023-11-25,505,oven,18490,24000,5510,2,00171,India
178896,2023-11-25,503,mixer,1349,3249,1900,2,00240,India
557091,2023-11-25,504,iron,449,879,430,2,00137,India
557091,2023-11-25,506,monitor,3249,8000,4751,2,00137,India
557091,2023-11-25,502,iphone 15 pro max,100000,135000,35000,2,00137,India
604815,2023-11-25,507,washing machine,6990,16490,9500,2,00172,India
372266,2023-11-25,503,mixer,1349,3249,1900,2,00453,India
645538,2023-11-25,504,iron,449,879,430,2,00162,India
645538,2023-11-25,507,washing machine,6990,16490,9500,2,00162,India
645538,2023-11-25,503,mixer,1349,3249,1900,2,00162,India
729475,2023-11-25,504,iron,449,879,430,2,00157,India
729475,2023-11-25,501,iphone 15,60000,80000,20000,2,00157,India
729475,2023-11-25,506,monitor,3249,8000,4751,2,00157,India
274915,2023-11-25,501,iphone 15,60000,80000,20000,2,00273,India
274915,2023-11-25,505,oven,18490,24000,5510,2,00273,India
274915,2023-11-25,506,monitor,3249,8000,4751,2,00273,India
835433,2023-11-25,506,monitor,3249,8000,4751,2,00384,India
835433,2023-11-25,502,iphone 15 pro max,100000,135000,35000,2,00384,India
835433,2023-11-25,503,mixer,1349,3249,1900,2,00384,India
489453,2023-11-25,505,oven,18490,24000,5510,2,00224,India
489453,2023-11-25,501,iphone 15,60000,80000,20000,2,00224,India
489453,2023-11-25,502,iphone 15 pro max,100000,135000,35000,2,00224,India
121210,2023-11-25,501,iphone 15,60000,80000,20000,2,00434,India
121210,2023-11-25,504,iron,449,879,430,2,00434,India
589745,2023-11-25,504,iron,449,879,430,2,00426,India
923022,2023-11-25,501,iphone 15,60000,80000,20000,2,00374,India
923022,2023-11-25,502,iphone 15 pro max,100000,135000,35000,2,00374,India
923022,2023-11-25,504,iron,449,879,430,2,00374,India
394248,2023-11-25,503,mixer,1349,3249,1900,2,00253,India
394248,2023-11-25,507,washing machine,6990,16490,9500,2,00253,India
394248,2023-11-25,505,oven,18490,24000,5510,2,00253,India
981149,2023-11-25,501,iphone 15,60000,80000,20000,2,00012,India
981149,2023-11-25,506,monitor,3249,8000,4751,2,00012,India
427994,2023-11-25,505,oven,18490,24000,5510,2,00330,India
427994,2023-11-25,506,monitor,3249,8000,4751,2,00330,India
177555,2023-11-25,506,monitor,3249,8000,4751,2,00485,India
177555,2023-11-25,504,iron,449,879,430,2,00485,India
551164,2023-11-25,507,washing machine,6990,16490,9500,2,00432,India
551164,2023-11-25,503,mixer,1349,3249,1900,2,00432,India
952234,2023-11-25,503,mixer,1349,3249,1900,2,00249,India
107721,2023-11-25,503,mixer,1349,3249,1900,2,00138,India
107721,2023-11-25,502,iphone 15 pro max,100000,135000,35000,2,00138,India
821422,2023-11-25,503,mixer,1349,3249,1900,2,00493,India
821422,2023-11-25,504,iron,449,879,430,2,00493,India
821422,2023-11-25,507,washing machine,6990,16490,9500,2,00493,India
277924,2023-11-25,503,mixer,1349,3249,1900,2,00415,India
279588,2023-11-25,503,mixer,1349,3249,1900,2,00459,India
279588,2023-11-25,504,iron,449,879,430,2,00459,India
239946,2023-11-25,502,iphone 15 pro max,100000,135000,35000,2,00102,India
239946,2023-11-25,506,monitor,3249,8000,4751,2,00102,India
239946,2023-11-25,503,mixer,1349,3249,1900,2,00102,India
239946,2023-11-25,504,iron,449,879,430,2,00102,India
134177,2023-11-25,504,iron,449,879,430,2,00340,India
813696,2023-11-25,507,washing machine,6990,16490,9500,2,00050,India
813696,2023-11-25,505,oven,18490,24000,5510,2,00050,India
578093,2023-11-25,502,iphone 15 pro max,100000,135000,35000,2,00356,India
578093,2023-11-25,505,oven,18490,24000,5510,2,00356,India
578093,2023-11-25,506,monitor,3249,8000,4751,2,00356,India
745118,2023-11-25,506,monitor,3249,8000,4751,2,00437,India
745118,2023-11-25,501,iphone 15,60000,80000,20000,2,00437,India
478361,2023-11-25,506,monitor,3249,8000,4751,2,00335,India
478361,2023-11-25,501,iphone 15,60000,80000,20000,2,00335,India
442196,2023-11-25,504,iron,449,879,430,2,00389,India
836766,2023-11-25,502,iphone 15 pro max,100000,135000,35000,2,00441,India
610698,2023-11-25,503,mixer,1349,3249,1900,2,00158,India
155593,2023-11-25,502,iphone 15 pro max,100000,135000,35000,2,00348,India
155593,2023-11-25,507,washing machine,6990,16490,9500,2,00348,India
155593,2023-11-25,505,oven,18490,24000,5510,2,00348,India
155593,2023-11-25,501,iphone 15,60000,80000,20000,2,00348,India
780727,2023-11-25,505,oven,18490,24000,5510,2,00434,India
780727,2023-11-25,503,mixer,1349,3249,1900,2,00434,India
780727,2023-11-25,504,iron,449,879,430,2,00434,India
760867,2023-11-25,505,oven,18490,24000,5510,2,00391,India
760867,2023-11-25,506,monitor,3249,8000,4751,2,00391,India
488541,2023-11-25,503,mixer,1349,3249,1900,2,00425,India
910412,2023-11-25,502,iphone 15 pro max,100000,135000,35000,2,00246,India
910412,2023-11-25,501,iphone 15,60000,80000,20000,2,00246,India
910412,2023-11-25,507,washing machine,6990,16490,9500,2,00246,India
813350,2023-11-25,501,iphone 15,60000,80000,20000,2,00474,India
813350,2023-11-25,506,monitor,3249,8000,4751,2,00474,India
813350,2023-11-25,502,iphone 15 pro max,100000,135000,35000,2,00474,India
958511,2023-11-25,501,iphone 15,60000,80000,20000,2,00152,India
958511,2023-11-25,505,oven,18490,24000,5510,2,00152,India
958511,2023-11-25,504,iron,449,879,430,2,00152,India
358640,2023-11-25,505,oven,18490,24000,5510,2,00309,India
665321,2023-11-25,503,mixer,1349,3249,1900,2,00363,India
665321,2023-11-25,504,iron,449,879,430,2,00363,India
665321,2023-11-25,505,oven,18490,24000,5510,2,00363,India
909323,2023-11-25,506,monitor,3249,8000,4751,2,00163,India
909323,2023-11-25,507,washing machine,6990,16490,9500,2,00163,India
266747,2023-11-25,506,monitor,3249,8000,4751,2,00458,India
266747,2023-11-25,505,oven,18490,24000,5510,2,00458,India
200030,2023-11-25,503,mixer,1349,3249,1900,2,00387,India
200030,2023-11-25,504,iron,449,879,430,2,00387,India
759823,2023-11-25,501,iphone 15,60000,80000,20000,2,00170,India
759823,2023-11-25,502,iphone 15 pro max,100000,135000,35000,2,00170,India
217600,2023-11-25,505,oven,18490,24000,5510,2,00310,India
217600,2023-11-25,504,iron,449,879,430,2,00310,India
217600,2023-11-25,503,mixer,1349,3249,1900,2,00310,India
166632,2023-11-25,501,iphone 15,60000,80000,20000,2,00137,India
166632,2023-11-25,503,mixer,1349,3249,1900,2,00137,India
166632,2023-11-25,506,monitor,3249,8000,4751,2,00137,India
166632,2023-11-25,504,iron,449,879,430,2,00137,India
166632,2023-11-25,507,washing machine,6990,16490,9500,2,00137,India
197542,2023-11-25,507,washing machine,6990,16490,9500,2,00122,India
197542,2023-11-25,505,oven,18490,24000,5510,2,00122,India
333551,2023-11-25,505,oven,18490,24000,5510,2,00446,India
333551,2023-11-25,507,washing machine,6990,16490,9500,2,00446,India
333551,2023-11-25,501,iphone 15,60000,80000,20000,2,00446,India
333551,2023-11-25,502,iphone 15 pro max,100000,135000,35000,2,00446,India
267717,2023-11-25,505,oven,18490,24000,5510,2,00040,India
267717,2023-11-25,501,iphone 15,60000,80000,20000,2,00040,India
698698,2023-11-25,501,iphone 15,60000,80000,20000,2,00084,India
698698,2023-11-25,502,iphone 15 pro max,100000,135000,35000,2,00084,India
698698,2023-11-25,507,washing machine,6990,16490,9500,2,00084,India
698698,2023-11-25,504,iron,449,879,430,2,00084,India
219686,2023-11-25,504,iron,449,879,430,2,00484,India
219686,2023-11-25,505,oven,18490,24000,5510,2,00484,India
263462,2023-11-25,505,oven,18490,24000,5510,2,00219,India
263462,2023-11-25,507,washing machine,6990,16490,9500,2,00219,India
100256,2023-11-25,505,oven,18490,24000,5510,2,00220,India
100256,2023-11-25,503,mixer,1349,3249,1900,2,00220,India
100256,2023-11-25,501,iphone 15,60000,80000,20000,2,00220,India
552361,2023-11-25,505,oven,18490,24000,5510,2,00353,India
552361,2023-11-25,502,iphone 15 pro max,100000,135000,35000,2,00353,India
659129,2023-11-25,503,mixer,1349,3249,1900,2,00098,India
659129,2023-11-25,506,monitor,3249,8000,4751,2,00098,India
659129,2023-11-25,507,washing machine,6990,16490,9500,2,00098,India
659129,2023-11-25,504,iron,449,879,430,2,00098,India
203683,2023-11-25,507,washing machine,6990,16490,9500,2,00040,India
203683,2023-11-25,505,oven,18490,24000,5510,2,00040,India
203683,2023-11-25,503,mixer,1349,3249,1900,2,00040,India
203683,2023-11-25,501,iphone 15,60000,80000,20000,2,00040,India
574886,2023-11-25,501,iphone 15,60000,80000,20000,2,00222,India
574886,2023-11-25,506,monitor,3249,8000,4751,2,00222,India
697519,2023-11-25,505,oven,18490,24000,5510,2,00295,India
697519,2023-11-25,507,washing machine,6990,16490,9500,2,00295,India
697519,2023-11-25,504,iron,449,879,430,2,00295,India
386129,2023-11-25,502,iphone 15 pro max,100000,135000,35000,2,00345,India
386129,2023-11-25,505,oven,18490,24000,5510,2,00345,India
386129,2023-11-25,504,iron,449,879,430,2,00345,India
386129,2023-11-25,503,mixer,1349,3249,1900,2,00345,India
340346,2023-11-25,506,monitor,3249,8000,4751,2,00475,India
340346,2023-11-25,507,washing machine,6990,16490,9500,2,00475,India
539964,2023-11-25,503,mixer,1349,3249,1900,2,00352,India
539964,2023-11-25,501,iphone 15,60000,80000,20000,2,00352,India
539964,2023-11-25,505,oven,18490,24000,5510,2,00352,India
539964,2023-11-25,506,monitor,3249,8000,4751,2,00352,India
539964,2023-11-25,504,iron,449,879,430,2,00352,India
575324,2023-11-25,502,iphone 15 pro max,100000,135000,35000,2,00418,India
575324,2023-11-25,506,monitor,3249,8000,4751,2,00418,India
193202,2023-11-25,503,mixer,1349,3249,1900,2,00036,India
193202,2023-11-25,504,iron,449,879,430,2,00036,India
193202,2023-11-25,506,monitor,3249,8000,4751,2,00036,India
888131,2023-11-25,502,iphone 15 pro max,100000,135000,35000,2,00213,India
888131,2023-11-25,507,washing machine,6990,16490,9500,2,00213,India
103479,2023-11-25,503,mixer,1349,3249,1900,2,00475,India
361132,2023-11-25,504,iron,449,879,430,2,00408,India
361132,2023-11-25,501,iphone 15,60000,80000,20000,2,00408,India
361132,2023-11-25,502,iphone 15 pro max,100000,135000,35000,2,00408,India
567444,2023-11-26,507,washing machine,6990,16490,9500,2,00368,India
567444,2023-11-26,504,iron,449,879,430,2,00368,India
508996,2023-11-26,507,washing machine,6990,16490,9500,2,00197,India
508996,2023-11-26,502,iphone 15 pro max,100000,135000,35000,2,00197,India
508996,2023-11-26,504,iron,449,879,430,2,00197,India
557597,2023-11-26,505,oven,18490,24000,5510,2,00430,India
557597,2023-11-26,504,iron,449,879,430,2,00430,India
557597,2023-11-26,507,washing machine,6990,16490,9500,2,00430,India
557597,2023-11-26,503,mixer,1349,3249,1900,2,00430,India
557597,2023-11-26,501,iphone 15,60000,80000,20000,2,00430,India
448220,2023-11-26,502,iphone 15 pro max,100000,135000,35000,2,00363,India
448220,2023-11-26,503,mixer,1349,3249,1900,2,00363,India
667287,2023-11-26,507,washing machine,6990,16490,9500,2,00487,India
667287,2023-11-26,504,iron,449,879,430,2,00487,India
667287,2023-11-26,501,iphone 15,60000,80000,20000,2,00487,India
611696,2023-11-26,504,iron,449,879,430,2,00270,India
611696,2023-11-26,502,iphone 15 pro max,100000,135000,35000,2,00270,India
611696,2023-11-26,505,oven,18490,24000,5510,2,00270,India
478059,2023-11-26,506,monitor,3249,8000,4751,2,00409,India
677980,2023-11-26,503,mixer,1349,3249,1900,2,00151,India
896734,2023-11-26,502,iphone 15 pro max,100000,135000,35000,2,00150,India
571617,2023-11-26,503,mixer,1349,3249,1900,2,00104,India
571617,2023-11-26,507,washing machine,6990,16490,9500,2,00104,India
529925,2023-11-26,505,oven,18490,24000,5510,2,00469,India
529925,2023-11-26,506,monitor,3249,8000,4751,2,00469,India
674186,2023-11-26,507,washing machine,6990,16490,9500,2,00301,India
674186,2023-11-26,501,iphone 15,60000,80000,20000,2,00301,India
674186,2023-11-26,502,iphone 15 pro max,100000,135000,35000,2,00301,India
774063,2023-11-26,501,iphone 15,60000,80000,20000,2,00496,India
774063,2023-11-26,505,oven,18490,24000,5510,2,00496,India
173821,2023-11-26,505,oven,18490,24000,5510,2,00125,India
173821,2023-11-26,507,washing machine,6990,16490,9500,2,00125,India
173821,2023-11-26,501,iphone 15,60000,80000,20000,2,00125,India
173821,2023-11-26,503,mixer,1349,3249,1900,2,00125,India
554545,2023-11-26,506,monitor,3249,8000,4751,2,00158,India
623657,2023-11-26,507,washing machine,6990,16490,9500,2,00451,India
623657,2023-11-26,504,iron,449,879,430,2,00451,India
623657,2023-11-26,502,iphone 15 pro max,100000,135000,35000,2,00451,India
500239,2023-11-26,507,washing machine,6990,16490,9500,2,00075,India
500239,2023-11-26,506,monitor,3249,8000,4751,2,00075,India
765290,2023-11-26,506,monitor,3249,8000,4751,2,00042,India
765290,2023-11-26,501,iphone 15,60000,80000,20000,2,00042,India
856343,2023-11-26,504,iron,449,879,430,2,00414,India
856343,2023-11-26,505,oven,18490,24000,5510,2,00414,India
962988,2023-11-26,507,washing machine,6990,16490,9500,2,00023,India
962988,2023-11-26,506,monitor,3249,8000,4751,2,00023,India
962988,2023-11-26,504,iron,449,879,430,2,00023,India
962988,2023-11-26,503,mixer,1349,3249,1900,2,00023,India
590940,2023-11-26,501,iphone 15,60000,80000,20000,2,00362,India
590940,2023-11-26,504,iron,449,879,430,2,00362,India
590940,2023-11-26,507,washing machine,6990,16490,9500,2,00362,India
815178,2023-11-26,504,iron,449,879,430,2,00209,India
815178,2023-11-26,505,oven,18490,24000,5510,2,00209,India
505435,2023-11-26,505,oven,18490,24000,5510,2,00024,India
411734,2023-11-26,502,iphone 15 pro max,100000,135000,35000,2,00372,India
411734,2023-11-26,505,oven,18490,24000,5510,2,00372,India
411734,2023-11-26,507,washing machine,6990,16490,9500,2,00372,India
243507,2023-11-26,505,oven,18490,24000,5510,2,00076,India
243507,2023-11-26,507,washing machine,6990,16490,9500,2,00076,India
243507,2023-11-26,502,iphone 15 pro max,100000,135000,35000,2,00076,India
243507,2023-11-26,501,iphone 15,60000,80000,20000,2,00076,India
846304,2023-11-26,504,iron,449,879,430,2,00103,India
593942,2023-11-26,507,washing machine,6990,16490,9500,2,00129,India
791518,2023-11-26,503,mixer,1349,3249,1900,2,00370,India
791518,2023-11-26,505,oven,18490,24000,5510,2,00370,India
791518,2023-11-26,502,iphone 15 pro max,100000,135000,35000,2,00370,India
791518,2023-11-26,504,iron,449,879,430,2,00370,India
487606,2023-11-26,506,monitor,3249,8000,4751,2,00189,India
487606,2023-11-26,502,iphone 15 pro max,100000,135000,35000,2,00189,India
487606,2023-11-26,504,iron,449,879,430,2,00189,India
487606,2023-11-26,505,oven,18490,24000,5510,2,00189,India
487606,2023-11-26,507,washing machine,6990,16490,9500,2,00189,India
101809,2023-11-26,501,iphone 15,60000,80000,20000,2,00366,India
292243,2023-11-26,507,washing machine,6990,16490,9500,2,00043,India
292243,2023-11-26,506,monitor,3249,8000,4751,2,00043,India
188593,2023-11-26,502,iphone 15 pro max,100000,135000,35000,2,00313,India
188593,2023-11-26,501,iphone 15,60000,80000,20000,2,00313,India
279969,2023-11-26,503,mixer,1349,3249,1900,2,00101,India
279969,2023-11-26,505,oven,18490,24000,5510,2,00101,India
272086,2023-11-26,507,washing machine,6990,16490,9500,2,00443,India
275323,2023-11-26,507,washing machine,6990,16490,9500,2,00383,India
275323,2023-11-26,501,iphone 15,60000,80000,20000,2,00383,India
703474,2023-11-26,506,monitor,3249,8000,4751,2,00098,India
451724,2023-11-26,505,oven,18490,24000,5510,2,00397,India
175443,2023-11-26,507,washing machine,6990,16490,9500,2,00238,India
175443,2023-11-26,502,iphone 15 pro max,100000,135000,35000,2,00238,India
175443,2023-11-26,504,iron,449,879,430,2,00238,India
190866,2023-11-26,505,oven,18490,24000,5510,2,00276,India
190866,2023-11-26,501,iphone 15,60000,80000,20000,2,00276,India
190866,2023-11-26,502,iphone 15 pro max,100000,135000,35000,2,00276,India
206879,2023-11-26,507,washing machine,6990,16490,9500,2,00029,India
206879,2023-11-26,506,monitor,3249,8000,4751,2,00029,India
997982,2023-11-26,501,iphone 15,60000,80000,20000,2,00150,India
997982,2023-11-26,505,oven,18490,24000,5510,2,00150,India
997982,2023-11-26,506,monitor,3249,8000,4751,2,00150,India
997982,2023-11-26,502,iphone 15 pro max,100000,135000,35000,2,00150,India
230052,2023-11-26,507,washing machine,6990,16490,9500,2,00486,India
230052,2023-11-26,503,mixer,1349,3249,1900,2,00486,India
883147,2023-11-26,505,oven,18490,24000,5510,2,00030,India
883147,2023-11-26,507,washing machine,6990,16490,9500,2,00030,India
883147,2023-11-26,502,iphone 15 pro max,100000,135000,35000,2,00030,India
883147,2023-11-26,503,mixer,1349,3249,1900,2,00030,India
406590,2023-11-26,504,iron,449,879,430,2,00441,India
628191,2023-11-26,503,mixer,1349,3249,1900,2,00428,India
628191,2023-11-26,507,washing machine,6990,16490,9500,2,00428,India
628191,2023-11-26,504,iron,449,879,430,2,00428,India
628191,2023-11-26,505,oven,18490,24000,5510,2,00428,India
323703,2023-11-26,502,iphone 15 pro max,100000,135000,35000,2,00010,India
323703,2023-11-26,503,mixer,1349,3249,1900,2,00010,India
323703,2023-11-26,501,iphone 15,60000,80000,20000,2,00010,India
470460,2023-11-26,507,washing machine,6990,16490,9500,2,00019,India
470460,2023-11-26,501,iphone 15,60000,80000,20000,2,00019,India
470460,2023-11-26,504,iron,449,879,430,2,00019,India
515002,2023-11-26,503,mixer,1349,3249,1900,2,00092,India
515002,2023-11-26,504,iron,449,879,430,2,00092,India
515002,2023-11-26,501,iphone 15,60000,80000,20000,2,00092,India
443852,2023-11-26,505,oven,18490,24000,5510,2,00351,India
399732,2023-11-26,507,washing machine,6990,16490,9500,2,00123,India
399732,2023-11-26,504,iron,449,879,430,2,00123,India
399732,2023-11-26,501,iphone 15,60000,80000,20000,2,00123,India
550355,2023-11-26,507,washing machine,6990,16490,9500,2,00402,India
550355,2023-11-26,501,iphone 15,60000,80000,20000,2,00402,India
550355,2023-11-26,505,oven,18490,24000,5510,2,00402,India
550355,2023-11-26,504,iron,449,879,430,2,00402,India
550355,2023-11-26,506,monitor,3249,8000,4751,2,00402,India
298957,2023-11-26,504,iron,449,879,430,2,00152,India
266534,2023-11-26,505,oven,18490,24000,5510,2,00082,India
328389,2023-11-26,501,iphone 15,60000,80000,20000,2,00457,India
328389,2023-11-26,506,monitor,3249,8000,4751,2,00457,India
328389,2023-11-26,502,iphone 15 pro max,100000,135000,35000,2,00457,India
415785,2023-11-26,504,iron,449,879,430,2,00463,India
415785,2023-11-26,507,washing machine,6990,16490,9500,2,00463,India
415785,2023-11-26,502,iphone 15 pro max,100000,135000,35000,2,00463,India
415785,2023-11-26,506,monitor,3249,8000,4751,2,00463,India
415785,2023-11-26,503,mixer,1349,3249,1900,2,00463,India
649463,2023-11-26,507,washing machine,6990,16490,9500,2,00084,India
649463,2023-11-26,506,monitor,3249,8000,4751,2,00084,India
649463,2023-11-26,503,mixer,1349,3249,1900,2,00084,India
649463,2023-11-26,505,oven,18490,24000,5510,2,00084,India
649463,2023-11-26,502,iphone 15 pro max,100000,135000,35000,2,00084,India
340809,2023-11-26,505,oven,18490,24000,5510,2,00376,India
340809,2023-11-26,504,iron,449,879,430,2,00376,India
340809,2023-11-26,502,iphone 15 pro max,100000,135000,35000,2,00376,India
340809,2023-11-26,503,mixer,1349,3249,1900,2,00376,India
693848,2023-11-26,507,washing machine,6990,16490,9500,2,00436,India
516962,2023-11-26,503,mixer,1349,3249,1900,2,00228,India
942730,2023-11-26,502,iphone 15 pro max,100000,135000,35000,2,00089,India
942730,2023-11-26,505,oven,18490,24000,5510,2,00089,India
708677,2023-11-26,503,mixer,1349,3249,1900,2,00185,India
708677,2023-11-26,502,iphone 15 pro max,100000,135000,35000,2,00185,India
708677,2023-11-26,505,oven,18490,24000,5510,2,00185,India
340072,2023-11-26,506,monitor,3249,8000,4751,2,00488,India
340072,2023-11-26,502,iphone 15 pro max,100000,135000,35000,2,00488,India
340072,2023-11-26,501,iphone 15,60000,80000,20000,2,00488,India
531984,2023-11-26,506,monitor,3249,8000,4751,2,00159,India
531984,2023-11-26,502,iphone 15 pro max,100000,135000,35000,2,00159,India
531984,2023-11-26,503,mixer,1349,3249,1900,2,00159,India
701316,2023-11-26,507,washing machine,6990,16490,9500,2,00318,India
701316,2023-11-26,502,iphone 15 pro max,100000,135000,35000,2,00318,India
701316,2023-11-26,506,monitor,3249,8000,4751,2,00318,India
145766,2023-11-26,504,iron,449,879,430,2,00420,India
145766,2023-11-26,503,mixer,1349,3249,1900,2,00420,India
145766,2023-11-26,501,iphone 15,60000,80000,20000,2,00420,India
800420,2023-11-26,501,iphone 15,60000,80000,20000,2,00482,India
800420,2023-11-26,502,iphone 15 pro max,100000,135000,35000,2,00482,India
527838,2023-11-26,507,washing machine,6990,16490,9500,2,00176,India
527838,2023-11-26,505,oven,18490,24000,5510,2,00176,India
462249,2023-11-26,501,iphone 15,60000,80000,20000,2,00425,India
462249,2023-11-26,505,oven,18490,24000,5510,2,00425,India
634324,2023-11-26,504,iron,449,879,430,2,00356,India
571588,2023-11-26,502,iphone 15 pro max,100000,135000,35000,2,00038,India
571588,2023-11-26,507,washing machine,6990,16490,9500,2,00038,India
571588,2023-11-26,506,monitor,3249,8000,4751,2,00038,India
571588,2023-11-26,505,oven,18490,24000,5510,2,00038,India
821756,2023-11-26,507,washing machine,6990,16490,9500,2,00298,India
821756,2023-11-26,502,iphone 15 pro max,100000,135000,35000,2,00298,India
821756,2023-11-26,503,mixer,1349,3249,1900,2,00298,India
473773,2023-11-26,501,iphone 15,60000,80000,20000,2,00494,India
937065,2023-11-26,506,monitor,3249,8000,4751,2,00492,India
937065,2023-11-26,503,mixer,1349,3249,1900,2,00492,India
937065,2023-11-26,501,iphone 15,60000,80000,20000,2,00492,India
937065,2023-11-26,502,iphone 15 pro max,100000,135000,35000,2,00492,India
523024,2023-11-26,504,iron,449,879,430,2,00489,India
188836,2023-11-26,507,washing machine,6990,16490,9500,2,00060,India
188836,2023-11-26,506,monitor,3249,8000,4751,2,00060,India
188836,2023-11-26,505,oven,18490,24000,5510,2,00060,India
420428,2023-11-26,502,iphone 15 pro max,100000,135000,35000,2,00366,India
420428,2023-11-26,507,washing machine,6990,16490,9500,2,00366,India
420428,2023-11-26,505,oven,18490,24000,5510,2,00366,India
490360,2023-11-27,505,oven,18490,24000,5510,2,00078,India
490360,2023-11-27,504,iron,449,879,430,2,00078,India
215571,2023-11-27,502,iphone 15 pro max,100000,135000,35000,2,00338,India
357137,2023-11-27,505,oven,18490,24000,5510,2,00239,India
357137,2023-11-27,501,iphone 15,60000,80000,20000,2,00239,India
955356,2023-11-27,504,iron,449,879,430,2,00329,India
955356,2023-11-27,507,washing machine,6990,16490,9500,2,00329,India
955356,2023-11-27,501,iphone 15,60000,80000,20000,2,00329,India
949295,2023-11-27,507,washing machine,6990,16490,9500,2,00498,India
949295,2023-11-27,501,iphone 15,60000,80000,20000,2,00498,India
949295,2023-11-27,504,iron,449,879,430,2,00498,India
949295,2023-11-27,503,mixer,1349,3249,1900,2,00498,India
833494,2023-11-27,502,iphone 15 pro max,100000,135000,35000,2,00055,India
833494,2023-11-27,505,oven,18490,24000,5510,2,00055,India
833494,2023-11-27,503,mixer,1349,3249,1900,2,00055,India
906515,2023-11-27,506,monitor,3249,8000,4751,2,00012,India
906515,2023-11-27,505,oven,18490,24000,5510,2,00012,India
244591,2023-11-27,503,mixer,1349,3249,1900,2,00413,India
357436,2023-11-27,505,oven,18490,24000,5510,2,00437,India
514548,2023-11-27,502,iphone 15 pro max,100000,135000,35000,2,00353,India
514548,2023-11-27,507,washing machine,6990,16490,9500,2,00353,India
514548,2023-11-27,504,iron,449,879,430,2,00353,India
891109,2023-11-27,507,washing machine,6990,16490,9500,2,00297,India
891109,2023-11-27,501,iphone 15,60000,80000,20000,2,00297,India
891109,2023-11-27,504,iron,449,879,430,2,00297,India
891109,2023-11-27,505,oven,18490,24000,5510,2,00297,India
891109,2023-11-27,503,mixer,1349,3249,1900,2,00297,India
545834,2023-11-27,501,iphone 15,60000,80000,20000,2,00350,India
545834,2023-11-27,504,iron,449,879,430,2,00350,India
488018,2023-11-27,506,monitor,3249,8000,4751,2,00341,India
621746,2023-11-27,506,monitor,3249,8000,4751,2,00391,India
621746,2023-11-27,507,washing machine,6990,16490,9500,2,00391,India
950495,2023-11-27,505,oven,18490,24000,5510,2,00299,India
457162,2023-11-27,503,mixer,1349,3249,1900,2,00020,India
457162,2023-11-27,504,iron,449,879,430,2,00020,India
457162,2023-11-27,507,washing machine,6990,16490,9500,2,00020,India
999701,2023-11-27,502,iphone 15 pro max,100000,135000,35000,2,00213,India
999701,2023-11-27,504,iron,449,879,430,2,00213,India
999701,2023-11-27,503,mixer,1349,3249,1900,2,00213,India
585129,2023-11-27,505,oven,18490,24000,5510,2,00468,India
659807,2023-11-27,502,iphone 15 pro max,100000,135000,35000,2,00447,India
538425,2023-11-27,507,washing machine,6990,16490,9500,2,00212,India
538425,2023-11-27,505,oven,18490,24000,5510,2,00212,India
556023,2023-11-27,503,mixer,1349,3249,1900,2,00170,India
191451,2023-11-27,506,monitor,3249,8000,4751,2,00331,India
191451,2023-11-27,505,oven,18490,24000,5510,2,00331,India
854122,2023-11-27,504,iron,449,879,430,2,00054,India
912951,2023-11-27,506,monitor,3249,8000,4751,2,00416,India
912951,2023-11-27,501,iphone 15,60000,80000,20000,2,00416,India
912951,2023-11-27,505,oven,18490,24000,5510,2,00416,India
912951,2023-11-27,502,iphone 15 pro max,100000,135000,35000,2,00416,India
558170,2023-11-27,505,oven,18490,24000,5510,2,00082,India
558170,2023-11-27,501,iphone 15,60000,80000,20000,2,00082,India
500151,2023-11-27,501,iphone 15,60000,80000,20000,2,00211,India
500151,2023-11-27,506,monitor,3249,8000,4751,2,00211,India
192281,2023-11-27,507,washing machine,6990,16490,9500,2,00290,India
192281,2023-11-27,502,iphone 15 pro max,100000,135000,35000,2,00290,India
192281,2023-11-27,504,iron,449,879,430,2,00290,India
192281,2023-11-27,503,mixer,1349,3249,1900,2,00290,India
277424,2023-11-27,504,iron,449,879,430,2,00210,India
101033,2023-11-27,505,oven,18490,24000,5510,2,00425,India
101033,2023-11-27,506,monitor,3249,8000,4751,2,00425,India
956167,2023-11-27,504,iron,449,879,430,2,00340,India
956167,2023-11-27,505,oven,18490,24000,5510,2,00340,India
956167,2023-11-27,501,iphone 15,60000,80000,20000,2,00340,India
568131,2023-11-27,501,iphone 15,60000,80000,20000,2,00348,India
568131,2023-11-27,502,iphone 15 pro max,100000,135000,35000,2,00348,India
568131,2023-11-27,506,monitor,3249,8000,4751,2,00348,India
955430,2023-11-27,505,oven,18490,24000,5510,2,00221,India
955430,2023-11-27,504,iron,449,879,430,2,00221,India
953733,2023-11-27,501,iphone 15,60000,80000,20000,2,00118,India
953733,2023-11-27,503,mixer,1349,3249,1900,2,00118,India
328472,2023-11-27,505,oven,18490,24000,5510,2,00246,India
815277,2023-11-27,506,monitor,3249,8000,4751,2,00053,India
815277,2023-11-27,501,iphone 15,60000,80000,20000,2,00053,India
120951,2023-11-27,503,mixer,1349,3249,1900,2,00033,India
975485,2023-11-27,505,oven,18490,24000,5510,2,00028,India
110680,2023-11-27,504,iron,449,879,430,2,00207,India
110680,2023-11-27,505,oven,18490,24000,5510,2,00207,India
110680,2023-11-27,501,iphone 15,60000,80000,20000,2,00207,India
989609,2023-11-27,502,iphone 15 pro max,100000,135000,35000,2,00271,India
989609,2023-11-27,501,iphone 15,60000,80000,20000,2,00271,India
749422,2023-11-27,507,washing machine,6990,16490,9500,2,00071,India
321717,2023-11-27,503,mixer,1349,3249,1900,2,00133,India
321717,2023-11-27,507,washing machine,6990,16490,9500,2,00133,India
321717,2023-11-27,504,iron,449,879,430,2,00133,India
321717,2023-11-27,502,iphone 15 pro max,100000,135000,35000,2,00133,India
927935,2023-11-27,502,iphone 15 pro max,100000,135000,35000,2,00116,India
927935,2023-11-27,501,iphone 15,60000,80000,20000,2,00116,India
927935,2023-11-27,503,mixer,1349,3249,1900,2,00116,India
627477,2023-11-27,506,monitor,3249,8000,4751,2,00470,India
172496,2023-11-27,503,mixer,1349,3249,1900,2,00155,India
172496,2023-11-27,505,oven,18490,24000,5510,2,00155,India
164886,2023-11-27,505,oven,18490,24000,5510,2,00349,India
164886,2023-11-27,503,mixer,1349,3249,1900,2,00349,India
365752,2023-11-27,503,mixer,1349,3249,1900,2,00003,India
365752,2023-11-27,502,iphone 15 pro max,100000,135000,35000,2,00003,India
270820,2023-11-27,503,mixer,1349,3249,1900,2,00307,India
270820,2023-11-27,506,monitor,3249,8000,4751,2,00307,India
270820,2023-11-27,507,washing machine,6990,16490,9500,2,00307,India
270820,2023-11-27,502,iphone 15 pro max,100000,135000,35000,2,00307,India
270820,2023-11-27,501,iphone 15,60000,80000,20000,2,00307,India
626012,2023-11-27,506,monitor,3249,8000,4751,2,00474,India
626012,2023-11-27,502,iphone 15 pro max,100000,135000,35000,2,00474,India
626012,2023-11-27,505,oven,18490,24000,5510,2,00474,India
626012,2023-11-27,503,mixer,1349,3249,1900,2,00474,India
317412,2023-11-27,507,washing machine,6990,16490,9500,2,00017,India
382691,2023-11-27,505,oven,18490,24000,5510,2,00435,India
382691,2023-11-27,506,monitor,3249,8000,4751,2,00435,India
382691,2023-11-27,503,mixer,1349,3249,1900,2,00435,India
382691,2023-11-27,507,washing machine,6990,16490,9500,2,00435,India
494116,2023-11-27,507,washing machine,6990,16490,9500,2,00091,India
494116,2023-11-27,503,mixer,1349,3249,1900,2,00091,India
528154,2023-11-27,502,iphone 15 pro max,100000,135000,35000,2,00427,India
938524,2023-11-27,505,oven,18490,24000,5510,2,00129,India
938524,2023-11-27,504,iron,449,879,430,2,00129,India
938524,2023-11-27,503,mixer,1349,3249,1900,2,00129,India
701873,2023-11-27,503,mixer,1349,3249,1900,2,00184,India
701873,2023-11-27,502,iphone 15 pro max,100000,135000,35000,2,00184,India
838639,2023-11-27,507,washing machine,6990,16490,9500,2,00231,India
838639,2023-11-27,504,iron,449,879,430,2,00231,India
838639,2023-11-27,503,mixer,1349,3249,1900,2,00231,India
387526,2023-11-27,507,washing machine,6990,16490,9500,2,00239,India
387526,2023-11-27,503,mixer,1349,3249,1900,2,00239,India
387526,2023-11-27,504,iron,449,879,430,2,00239,India
387526,2023-11-27,506,monitor,3249,8000,4751,2,00239,India
213291,2023-11-28,507,washing machine,6990,16490,9500,2,00010,India
213291,2023-11-28,505,oven,18490,24000,5510,2,00010,India
213291,2023-11-28,503,mixer,1349,3249,1900,2,00010,India
781985,2023-11-28,503,mixer,1349,3249,1900,2,00425,India
781985,2023-11-28,504,iron,449,879,430,2,00425,India
781985,2023-11-28,506,monitor,3249,8000,4751,2,00425,India
341376,2023-11-28,506,monitor,3249,8000,4751,2,00467,India
341376,2023-11-28,505,oven,18490,24000,5510,2,00467,India
341376,2023-11-28,504,iron,449,879,430,2,00467,India
839371,2023-11-28,503,mixer,1349,3249,1900,2,00385,India
839371,2023-11-28,501,iphone 15,60000,80000,20000,2,00385,India
839371,2023-11-28,506,monitor,3249,8000,4751,2,00385,India
839371,2023-11-28,504,iron,449,879,430,2,00385,India
105255,2023-11-28,503,mixer,1349,3249,1900,2,00132,India
105255,2023-11-28,505,oven,18490,24000,5510,2,00132,India
105255,2023-11-28,507,washing machine,6990,16490,9500,2,00132,India
105255,2023-11-28,504,iron,449,879,430,2,00132,India
105255,2023-11-28,502,iphone 15 pro max,100000,135000,35000,2,00132,India
181073,2023-11-28,503,mixer,1349,3249,1900,2,00248,India
573842,2023-11-28,505,oven,18490,24000,5510,2,00287,India
573842,2023-11-28,503,mixer,1349,3249,1900,2,00287,India
573842,2023-11-28,507,washing machine,6990,16490,9500,2,00287,India
805035,2023-11-28,507,washing machine,6990,16490,9500,2,00178,India
233717,2023-11-28,507,washing machine,6990,16490,9500,2,00181,India
233717,2023-11-28,503,mixer,1349,3249,1900,2,00181,India
233717,2023-11-28,502,iphone 15 pro max,100000,135000,35000,2,00181,India
753269,2023-11-28,501,iphone 15,60000,80000,20000,2,00145,India
753269,2023-11-28,502,iphone 15 pro max,100000,135000,35000,2,00145,India
753269,2023-11-28,504,iron,449,879,430,2,00145,India
753269,2023-11-28,506,monitor,3249,8000,4751,2,00145,India
928978,2023-11-28,507,washing machine,6990,16490,9500,2,00289,India
928978,2023-11-28,502,iphone 15 pro max,100000,135000,35000,2,00289,India
106078,2023-11-28,507,washing machine,6990,16490,9500,2,00126,India
106078,2023-11-28,503,mixer,1349,3249,1900,2,00126,India
106078,2023-11-28,506,monitor,3249,8000,4751,2,00126,India
484391,2023-11-28,505,oven,18490,24000,5510,2,00282,India
484391,2023-11-28,506,monitor,3249,8000,4751,2,00282,India
662722,2023-11-28,501,iphone 15,60000,80000,20000,2,00403,India
662722,2023-11-28,506,monitor,3249,8000,4751,2,00403,India
662722,2023-11-28,505,oven,18490,24000,5510,2,00403,India
662722,2023-11-28,504,iron,449,879,430,2,00403,India
691979,2023-11-28,503,mixer,1349,3249,1900,2,00149,India
691979,2023-11-28,507,washing machine,6990,16490,9500,2,00149,India
691979,2023-11-28,504,iron,449,879,430,2,00149,India
942402,2023-11-28,503,mixer,1349,3249,1900,2,00398,India
942402,2023-11-28,506,monitor,3249,8000,4751,2,00398,India
529365,2023-11-28,501,iphone 15,60000,80000,20000,2,00032,India
529365,2023-11-28,502,iphone 15 pro max,100000,135000,35000,2,00032,India
529365,2023-11-28,507,washing machine,6990,16490,9500,2,00032,India
824692,2023-11-28,501,iphone 15,60000,80000,20000,2,00146,India
824692,2023-11-28,502,iphone 15 pro max,100000,135000,35000,2,00146,India
109441,2023-11-28,501,iphone 15,60000,80000,20000,2,00422,India
109441,2023-11-28,507,washing machine,6990,16490,9500,2,00422,India
109441,2023-11-28,505,oven,18490,24000,5510,2,00422,India
257884,2023-11-28,501,iphone 15,60000,80000,20000,2,00348,India
358383,2023-11-28,501,iphone 15,60000,80000,20000,2,00202,India
358383,2023-11-28,502,iphone 15 pro max,100000,135000,35000,2,00202,India
358383,2023-11-28,505,oven,18490,24000,5510,2,00202,India
337820,2023-11-28,502,iphone 15 pro max,100000,135000,35000,2,00054,India
337820,2023-11-28,507,washing machine,6990,16490,9500,2,00054,India
337820,2023-11-28,505,oven,18490,24000,5510,2,00054,India
829630,2023-11-28,505,oven,18490,24000,5510,2,00016,India
829630,2023-11-28,506,monitor,3249,8000,4751,2,00016,India
691674,2023-11-28,504,iron,449,879,430,2,00270,India
691674,2023-11-28,507,washing machine,6990,16490,9500,2,00270,India
508091,2023-11-28,507,washing machine,6990,16490,9500,2,00070,India
508091,2023-11-28,503,mixer,1349,3249,1900,2,00070,India
198273,2023-11-28,503,mixer,1349,3249,1900,2,00040,India
198273,2023-11-28,504,iron,449,879,430,2,00040,India
415450,2023-11-28,506,monitor,3249,8000,4751,2,00336,India
982537,2023-11-28,502,iphone 15 pro max,100000,135000,35000,2,00020,India
665415,2023-11-28,501,iphone 15,60000,80000,20000,2,00149,India
841255,2023-11-28,503,mixer,1349,3249,1900,2,00302,India
841255,2023-11-28,501,iphone 15,60000,80000,20000,2,00302,India
841255,2023-11-28,504,iron,449,879,430,2,00302,India
841255,2023-11-28,507,washing machine,6990,16490,9500,2,00302,India
912061,2023-11-28,505,oven,18490,24000,5510,2,00009,India
912061,2023-11-28,502,iphone 15 pro max,100000,135000,35000,2,00009,India
912061,2023-11-28,501,iphone 15,60000,80000,20000,2,00009,India
912061,2023-11-28,506,monitor,3249,8000,4751,2,00009,India
990208,2023-11-28,505,oven,18490,24000,5510,2,00446,India
909790,2023-11-28,506,monitor,3249,8000,4751,2,00267,India
909790,2023-11-28,503,mixer,1349,3249,1900,2,00267,India
775431,2023-11-28,501,iphone 15,60000,80000,20000,2,00152,India
775431,2023-11-28,507,washing machine,6990,16490,9500,2,00152,India
775431,2023-11-28,503,mixer,1349,3249,1900,2,00152,India
775431,2023-11-28,502,iphone 15 pro max,100000,135000,35000,2,00152,India
587592,2023-11-28,501,iphone 15,60000,80000,20000,2,00382,India
978076,2023-11-28,504,iron,449,879,430,2,00164,India
978076,2023-11-28,501,iphone 15,60000,80000,20000,2,00164,India
978076,2023-11-28,503,mixer,1349,3249,1900,2,00164,India
285304,2023-11-28,502,iphone 15 pro max,100000,135000,35000,2,00065,India
285304,2023-11-28,506,monitor,3249,8000,4751,2,00065,India
285304,2023-11-28,501,iphone 15,60000,80000,20000,2,00065,India
383284,2023-11-28,501,iphone 15,60000,80000,20000,2,00250,India
169798,2023-11-28,501,iphone 15,60000,80000,20000,2,00445,India
169798,2023-11-28,505,oven,18490,24000,5510,2,00445,India
169798,2023-11-28,503,mixer,1349,3249,1900,2,00445,India
822747,2023-11-28,507,washing machine,6990,16490,9500,2,00124,India
822747,2023-11-28,505,oven,18490,24000,5510,2,00124,India
653550,2023-11-28,504,iron,449,879,430,2,00093,India
653550,2023-11-28,506,monitor,3249,8000,4751,2,00093,India
653550,2023-11-28,503,mixer,1349,3249,1900,2,00093,India
527822,2023-11-28,503,mixer,1349,3249,1900,2,00471,India
527822,2023-11-28,501,iphone 15,60000,80000,20000,2,00471,India
527822,2023-11-28,506,monitor,3249,8000,4751,2,00471,India
527822,2023-11-28,504,iron,449,879,430,2,00471,India
513523,2023-11-28,503,mixer,1349,3249,1900,2,00450,India
885937,2023-11-28,505,oven,18490,24000,5510,2,00115,India
885937,2023-11-28,507,washing machine,6990,16490,9500,2,00115,India
885937,2023-11-28,506,monitor,3249,8000,4751,2,00115,India
885937,2023-11-28,501,iphone 15,60000,80000,20000,2,00115,India
415164,2023-11-28,507,washing machine,6990,16490,9500,2,00112,India
415164,2023-11-28,505,oven,18490,24000,5510,2,00112,India
426836,2023-11-28,506,monitor,3249,8000,4751,2,00233,India
426836,2023-11-28,505,oven,18490,24000,5510,2,00233,India
962834,2023-11-28,503,mixer,1349,3249,1900,2,00132,India
962834,2023-11-28,506,monitor,3249,8000,4751,2,00132,India
962834,2023-11-28,504,iron,449,879,430,2,00132,India
364544,2023-11-28,506,monitor,3249,8000,4751,2,00402,India
713112,2023-11-28,505,oven,18490,24000,5510,2,00467,India
713112,2023-11-28,502,iphone 15 pro max,100000,135000,35000,2,00467,India
713112,2023-11-28,504,iron,449,879,430,2,00467,India
131022,2023-11-28,502,iphone 15 pro max,100000,135000,35000,2,00351,India
131022,2023-11-28,503,mixer,1349,3249,1900,2,00351,India
130907,2023-11-28,504,iron,449,879,430,2,00128,India
130907,2023-11-28,507,washing machine,6990,16490,9500,2,00128,India
130907,2023-11-28,503,mixer,1349,3249,1900,2,00128,India
130907,2023-11-28,506,monitor,3249,8000,4751,2,00128,India
992501,2023-11-28,507,washing machine,6990,16490,9500,2,00359,India
992501,2023-11-28,503,mixer,1349,3249,1900,2,00359,India
490233,2023-11-28,503,mixer,1349,3249,1900,2,00073,India
490233,2023-11-28,506,monitor,3249,8000,4751,2,00073,India
800182,2023-11-28,503,mixer,1349,3249,1900,2,00412,India
800182,2023-11-28,505,oven,18490,24000,5510,2,00412,India
800182,2023-11-28,507,washing machine,6990,16490,9500,2,00412,India
283868,2023-11-28,505,oven,18490,24000,5510,2,00006,India
300526,2023-11-28,504,iron,449,879,430,2,00026,India
300526,2023-11-28,505,oven,18490,24000,5510,2,00026,India
300526,2023-11-28,502,iphone 15 pro max,100000,135000,35000,2,00026,India
300526,2023-11-28,506,monitor,3249,8000,4751,2,00026,India
300526,2023-11-28,501,iphone 15,60000,80000,20000,2,00026,India
497092,2023-11-28,504,iron,449,879,430,2,00254,India
822593,2023-11-28,507,washing machine,6990,16490,9500,2,00302,India
822593,2023-11-28,506,monitor,3249,8000,4751,2,00302,India
835411,2023-11-28,504,iron,449,879,430,2,00101,India
835411,2023-11-28,502,iphone 15 pro max,100000,135000,35000,2,00101,India
835411,2023-11-28,506,monitor,3249,8000,4751,2,00101,India
450211,2023-11-28,507,washing machine,6990,16490,9500,2,00425,India
450211,2023-11-28,505,oven,18490,24000,5510,2,00425,India
450211,2023-11-28,504,iron,449,879,430,2,00425,India
754166,2023-11-28,507,washing machine,6990,16490,9500,2,00060,India
754166,2023-11-28,503,mixer,1349,3249,1900,2,00060,India
754166,2023-11-28,505,oven,18490,24000,5510,2,00060,India
754166,2023-11-28,501,iphone 15,60000,80000,20000,2,00060,India
123334,2023-11-28,505,oven,18490,24000,5510,2,00093,India
123334,2023-11-28,501,iphone 15,60000,80000,20000,2,00093,India
123334,2023-11-28,504,iron,449,879,430,2,00093,India
850606,2023-11-28,507,washing machine,6990,16490,9500,2,00105,India
850606,2023-11-28,503,mixer,1349,3249,1900,2,00105,India
965219,2023-11-28,502,iphone 15 pro max,100000,135000,35000,2,00204,India
965219,2023-11-28,504,iron,449,879,430,2,00204,India
965219,2023-11-28,505,oven,18490,24000,5510,2,00204,India
901882,2023-11-28,502,iphone 15 pro max,100000,135000,35000,2,00279,India
901882,2023-11-28,507,washing machine,6990,16490,9500,2,00279,India
877202,2023-11-28,504,iron,449,879,430,2,00202,India
877202,2023-11-28,506,monitor,3249,8000,4751,2,00202,India
877202,2023-11-28,503,mixer,1349,3249,1900,2,00202,India
447360,2023-11-28,505,oven,18490,24000,5510,2,00164,India
447360,2023-11-28,504,iron,449,879,430,2,00164,India
447360,2023-11-28,507,washing machine,6990,16490,9500,2,00164,India
902311,2023-11-28,502,iphone 15 pro max,100000,135000,35000,2,00256,India
466239,2023-11-28,505,oven,18490,24000,5510,2,00340,India
466239,2023-11-28,507,washing machine,6990,16490,9500,2,00340,India
466239,2023-11-28,506,monitor,3249,8000,4751,2,00340,India
466239,2023-11-28,503,mixer,1349,3249,1900,2,00340,India
466239,2023-11-28,501,iphone 15,60000,80000,20000,2,00340,India
111088,2023-11-28,504,iron,449,879,430,2,00377,India
111088,2023-11-28,505,oven,18490,24000,5510,2,00377,India
111088,2023-11-28,506,monitor,3249,8000,4751,2,00377,India
268159,2023-11-28,502,iphone 15 pro max,100000,135000,35000,2,00192,India
268159,2023-11-28,506,monitor,3249,8000,4751,2,00192,India
268159,2023-11-28,501,iphone 15,60000,80000,20000,2,00192,India
268159,2023-11-28,503,mixer,1349,3249,1900,2,00192,India
580125,2023-11-28,504,iron,449,879,430,2,00392,India
580125,2023-11-28,502,iphone 15 pro max,100000,135000,35000,2,00392,India
580125,2023-11-28,507,washing machine,6990,16490,9500,2,00392,India
387326,2023-11-28,501,iphone 15,60000,80000,20000,2,00381,India
416444,2023-11-28,502,iphone 15 pro max,100000,135000,35000,2,00197,India
329188,2023-11-28,507,washing machine,6990,16490,9500,2,00114,India
256758,2023-11-28,505,oven,18490,24000,5510,2,00109,India
256758,2023-11-28,507,washing machine,6990,16490,9500,2,00109,India
256758,2023-11-28,503,mixer,1349,3249,1900,2,00109,India
111777,2023-11-28,505,oven,18490,24000,5510,2,00368,India
111777,2023-11-28,501,iphone 15,60000,80000,20000,2,00368,India
111777,2023-11-28,502,iphone 15 pro max,100000,135000,35000,2,00368,India
771272,2023-11-28,501,iphone 15,60000,80000,20000,2,00114,India
771272,2023-11-28,503,mixer,1349,3249,1900,2,00114,India
771272,2023-11-28,506,monitor,3249,8000,4751,2,00114,India
771272,2023-11-28,505,oven,18490,24000,5510,2,00114,India
439105,2023-11-28,506,monitor,3249,8000,4751,2,00493,India
439105,2023-11-28,505,oven,18490,24000,5510,2,00493,India
439105,2023-11-28,504,iron,449,879,430,2,00493,India
439105,2023-11-28,503,mixer,1349,3249,1900,2,00493,India
640185,2023-11-28,507,washing machine,6990,16490,9500,2,00167,India
647075,2023-11-28,503,mixer,1349,3249,1900,2,00478,India
647075,2023-11-28,504,iron,449,879,430,2,00478,India
647075,2023-11-28,506,monitor,3249,8000,4751,2,00478,India
595398,2023-11-28,503,mixer,1349,3249,1900,2,00286,India
595398,2023-11-28,502,iphone 15 pro max,100000,135000,35000,2,00286,India
233112,2023-11-28,506,monitor,3249,8000,4751,2,00037,India
233112,2023-11-28,503,mixer,1349,3249,1900,2,00037,India
776585,2023-11-28,504,iron,449,879,430,2,00009,India
131464,2023-11-28,502,iphone 15 pro max,100000,135000,35000,2,00500,India
131464,2023-11-28,507,washing machine,6990,16490,9500,2,00500,India
131464,2023-11-28,503,mixer,1349,3249,1900,2,00500,India
131464,2023-11-28,506,monitor,3249,8000,4751,2,00500,India
652486,2023-11-28,502,iphone 15 pro max,100000,135000,35000,2,00263,India
652486,2023-11-28,505,oven,18490,24000,5510,2,00263,India
652486,2023-11-28,501,iphone 15,60000,80000,20000,2,00263,India
712717,2023-11-28,505,oven,18490,24000,5510,2,00488,India
712717,2023-11-28,503,mixer,1349,3249,1900,2,00488,India
361345,2023-11-28,501,iphone 15,60000,80000,20000,2,00082,India
361345,2023-11-28,507,washing machine,6990,16490,9500,2,00082,India
686843,2023-11-28,506,monitor,3249,8000,4751,2,00112,India
686843,2023-11-28,503,mixer,1349,3249,1900,2,00112,India
686843,2023-11-28,502,iphone 15 pro max,100000,135000,35000,2,00112,India
686843,2023-11-28,507,washing machine,6990,16490,9500,2,00112,India
958395,2023-11-28,503,mixer,1349,3249,1900,2,00433,India
958395,2023-11-28,505,oven,18490,24000,5510,2,00433,India
958395,2023-11-28,507,washing machine,6990,16490,9500,2,00433,India
958395,2023-11-28,506,monitor,3249,8000,4751,2,00433,India
512957,2023-11-28,502,iphone 15 pro max,100000,135000,35000,2,00225,India
512957,2023-11-28,504,iron,449,879,430,2,00225,India
757585,2023-11-28,502,iphone 15 pro max,100000,135000,35000,2,00215,India
757585,2023-11-28,503,mixer,1349,3249,1900,2,00215,India
757585,2023-11-28,504,iron,449,879,430,2,00215,India
857297,2023-11-28,503,mixer,1349,3249,1900,2,00239,India
857297,2023-11-28,507,washing machine,6990,16490,9500,2,00239,India
932746,2023-11-28,501,iphone 15,60000,80000,20000,2,00412,India
932746,2023-11-28,507,washing machine,6990,16490,9500,2,00412,India
932746,2023-11-28,503,mixer,1349,3249,1900,2,00412,India
284716,2023-11-28,503,mixer,1349,3249,1900,2,00343,India
284716,2023-11-28,504,iron,449,879,430,2,00343,India
284716,2023-11-28,507,washing machine,6990,16490,9500,2,00343,India
424951,2023-11-29,504,iron,449,879,430,2,00438,India
424951,2023-11-29,502,iphone 15 pro max,100000,135000,35000,2,00438,India
424951,2023-11-29,501,iphone 15,60000,80000,20000,2,00438,India
424951,2023-11-29,506,monitor,3249,8000,4751,2,00438,India
345072,2023-11-29,502,iphone 15 pro max,100000,135000,35000,2,00413,India
345072,2023-11-29,506,monitor,3249,8000,4751,2,00413,India
345072,2023-11-29,507,washing machine,6990,16490,9500,2,00413,India
969401,2023-11-29,507,washing machine,6990,16490,9500,2,00182,India
969401,2023-11-29,504,iron,449,879,430,2,00182,India
969401,2023-11-29,501,iphone 15,60000,80000,20000,2,00182,India
790433,2023-11-29,503,mixer,1349,3249,1900,2,00463,India
790433,2023-11-29,506,monitor,3249,8000,4751,2,00463,India
790433,2023-11-29,502,iphone 15 pro max,100000,135000,35000,2,00463,India
463506,2023-11-29,502,iphone 15 pro max,100000,135000,35000,2,00272,India
463506,2023-11-29,504,iron,449,879,430,2,00272,India
463506,2023-11-29,506,monitor,3249,8000,4751,2,00272,India
463506,2023-11-29,503,mixer,1349,3249,1900,2,00272,India
433113,2023-11-29,506,monitor,3249,8000,4751,2,00256,India
433113,2023-11-29,507,washing machine,6990,16490,9500,2,00256,India
433113,2023-11-29,505,oven,18490,24000,5510,2,00256,India
956489,2023-11-29,503,mixer,1349,3249,1900,2,00467,India
956489,2023-11-29,505,oven,18490,24000,5510,2,00467,India
956489,2023-11-29,504,iron,449,879,430,2,00467,India
171395,2023-11-29,504,iron,449,879,430,2,00166,India
181239,2023-11-29,504,iron,449,879,430,2,00027,India
181239,2023-11-29,501,iphone 15,60000,80000,20000,2,00027,India
311274,2023-11-29,507,washing machine,6990,16490,9500,2,00108,India
311274,2023-11-29,505,oven,18490,24000,5510,2,00108,India
311274,2023-11-29,502,iphone 15 pro max,100000,135000,35000,2,00108,India
336177,2023-11-29,501,iphone 15,60000,80000,20000,2,00167,India
916350,2023-11-29,505,oven,18490,24000,5510,2,00380,India
916350,2023-11-29,503,mixer,1349,3249,1900,2,00380,India
368395,2023-11-29,507,washing machine,6990,16490,9500,2,00422,India
368395,2023-11-29,502,iphone 15 pro max,100000,135000,35000,2,00422,India
368395,2023-11-29,503,mixer,1349,3249,1900,2,00422,India
707502,2023-11-29,505,oven,18490,24000,5510,2,00473,India
707502,2023-11-29,504,iron,449,879,430,2,00473,India
427303,2023-11-29,501,iphone 15,60000,80000,20000,2,00024,India
427303,2023-11-29,502,iphone 15 pro max,100000,135000,35000,2,00024,India
427303,2023-11-29,504,iron,449,879,430,2,00024,India
949275,2023-11-29,501,iphone 15,60000,80000,20000,2,00309,India
949275,2023-11-29,506,monitor,3249,8000,4751,2,00309,India
949275,2023-11-29,505,oven,18490,24000,5510,2,00309,India
264861,2023-11-29,502,iphone 15 pro max,100000,135000,35000,2,00052,India
264861,2023-11-29,505,oven,18490,24000,5510,2,00052,India
264861,2023-11-29,503,mixer,1349,3249,1900,2,00052,India
264861,2023-11-29,504,iron,449,879,430,2,00052,India
215935,2023-11-29,501,iphone 15,60000,80000,20000,2,00304,India
215935,2023-11-29,507,washing machine,6990,16490,9500,2,00304,India
255464,2023-11-29,501,iphone 15,60000,80000,20000,2,00370,India
372732,2023-11-29,505,oven,18490,24000,5510,2,00492,India
372732,2023-11-29,502,iphone 15 pro max,100000,135000,35000,2,00492,India
372732,2023-11-29,507,washing machine,6990,16490,9500,2,00492,India
372732,2023-11-29,501,iphone 15,60000,80000,20000,2,00492,India
735200,2023-11-29,506,monitor,3249,8000,4751,2,00020,India
173467,2023-11-29,502,iphone 15 pro max,100000,135000,35000,2,00263,India
173467,2023-11-29,503,mixer,1349,3249,1900,2,00263,India
761440,2023-11-29,503,mixer,1349,3249,1900,2,00190,India
567909,2023-11-29,507,washing machine,6990,16490,9500,2,00326,India
567909,2023-11-29,502,iphone 15 pro max,100000,135000,35000,2,00326,India
567909,2023-11-29,505,oven,18490,24000,5510,2,00326,India
567909,2023-11-29,504,iron,449,879,430,2,00326,India
567909,2023-11-29,506,monitor,3249,8000,4751,2,00326,India
753567,2023-11-29,506,monitor,3249,8000,4751,2,00247,India
552879,2023-11-29,504,iron,449,879,430,2,00438,India
886221,2023-11-29,503,mixer,1349,3249,1900,2,00302,India
886221,2023-11-29,504,iron,449,879,430,2,00302,India
827069,2023-11-29,501,iphone 15,60000,80000,20000,2,00243,India
827069,2023-11-29,505,oven,18490,24000,5510,2,00243,India
827069,2023-11-29,502,iphone 15 pro max,100000,135000,35000,2,00243,India
827069,2023-11-29,507,washing machine,6990,16490,9500,2,00243,India
499426,2023-11-29,506,monitor,3249,8000,4751,2,00239,India
499426,2023-11-29,503,mixer,1349,3249,1900,2,00239,India
499426,2023-11-29,502,iphone 15 pro max,100000,135000,35000,2,00239,India
499426,2023-11-29,507,washing machine,6990,16490,9500,2,00239,India
354408,2023-11-29,502,iphone 15 pro max,100000,135000,35000,2,00312,India
354408,2023-11-29,505,oven,18490,24000,5510,2,00312,India
560457,2023-11-29,502,iphone 15 pro max,100000,135000,35000,2,00458,India
560457,2023-11-29,503,mixer,1349,3249,1900,2,00458,India
909132,2023-11-29,503,mixer,1349,3249,1900,2,00012,India
762532,2023-11-29,503,mixer,1349,3249,1900,2,00172,India
762532,2023-11-29,505,oven,18490,24000,5510,2,00172,India
762532,2023-11-29,506,monitor,3249,8000,4751,2,00172,India
235705,2023-11-29,506,monitor,3249,8000,4751,2,00023,India
235705,2023-11-29,502,iphone 15 pro max,100000,135000,35000,2,00023,India
235705,2023-11-29,507,washing machine,6990,16490,9500,2,00023,India
873793,2023-11-29,506,monitor,3249,8000,4751,2,00305,India
873793,2023-11-29,505,oven,18490,24000,5510,2,00305,India
873793,2023-11-29,504,iron,449,879,430,2,00305,India
642811,2023-11-29,505,oven,18490,24000,5510,2,00110,India
642811,2023-11-29,501,iphone 15,60000,80000,20000,2,00110,India
642811,2023-11-29,503,mixer,1349,3249,1900,2,00110,India
642811,2023-11-29,502,iphone 15 pro max,100000,135000,35000,2,00110,India
329447,2023-11-29,501,iphone 15,60000,80000,20000,2,00026,India
329447,2023-11-29,503,mixer,1349,3249,1900,2,00026,India
329447,2023-11-29,507,washing machine,6990,16490,9500,2,00026,India
329447,2023-11-29,505,oven,18490,24000,5510,2,00026,India
329447,2023-11-29,502,iphone 15 pro max,100000,135000,35000,2,00026,India
718470,2023-11-29,505,oven,18490,24000,5510,2,00085,India
718470,2023-11-29,507,washing machine,6990,16490,9500,2,00085,India
718470,2023-11-29,504,iron,449,879,430,2,00085,India
904483,2023-11-29,503,mixer,1349,3249,1900,2,00462,India
904483,2023-11-29,502,iphone 15 pro max,100000,135000,35000,2,00462,India
904483,2023-11-29,501,iphone 15,60000,80000,20000,2,00462,India
325825,2023-11-29,503,mixer,1349,3249,1900,2,00066,India
642243,2023-11-29,504,iron,449,879,430,2,00318,India
256548,2023-11-29,505,oven,18490,24000,5510,2,00159,India
256548,2023-11-29,502,iphone 15 pro max,100000,135000,35000,2,00159,India
256548,2023-11-29,507,washing machine,6990,16490,9500,2,00159,India
289376,2023-11-29,506,monitor,3249,8000,4751,2,00279,India
289376,2023-11-29,504,iron,449,879,430,2,00279,India
289376,2023-11-29,507,washing machine,6990,16490,9500,2,00279,India
289376,2023-11-29,501,iphone 15,60000,80000,20000,2,00279,India
183359,2023-11-29,504,iron,449,879,430,2,00125,India
183359,2023-11-29,505,oven,18490,24000,5510,2,00125,India
183359,2023-11-29,507,washing machine,6990,16490,9500,2,00125,India
183359,2023-11-29,506,monitor,3249,8000,4751,2,00125,India
183359,2023-11-29,501,iphone 15,60000,80000,20000,2,00125,India
355991,2023-11-29,504,iron,449,879,430,2,00296,India
355991,2023-11-29,506,monitor,3249,8000,4751,2,00296,India
355991,2023-11-29,505,oven,18490,24000,5510,2,00296,India
693324,2023-11-29,507,washing machine,6990,16490,9500,2,00138,India
782848,2023-11-29,506,monitor,3249,8000,4751,2,00002,India
782848,2023-11-29,505,oven,18490,24000,5510,2,00002,India
782848,2023-11-29,507,washing machine,6990,16490,9500,2,00002,India
782848,2023-11-29,501,iphone 15,60000,80000,20000,2,00002,India
782848,2023-11-29,502,iphone 15 pro max,100000,135000,35000,2,00002,India
807071,2023-11-29,504,iron,449,879,430,2,00442,India
807071,2023-11-29,507,washing machine,6990,16490,9500,2,00442,India
807071,2023-11-29,503,mixer,1349,3249,1900,2,00442,India
807071,2023-11-29,501,iphone 15,60000,80000,20000,2,00442,India
390741,2023-11-29,506,monitor,3249,8000,4751,2,00066,India
804539,2023-11-29,502,iphone 15 pro max,100000,135000,35000,2,00418,India
804539,2023-11-29,501,iphone 15,60000,80000,20000,2,00418,India
262042,2023-11-29,507,washing machine,6990,16490,9500,2,00169,India
262042,2023-11-29,504,iron,449,879,430,2,00169,India
567635,2023-11-29,502,iphone 15 pro max,100000,135000,35000,2,00304,India
567635,2023-11-29,506,monitor,3249,8000,4751,2,00304,India
567635,2023-11-29,503,mixer,1349,3249,1900,2,00304,India
567635,2023-11-29,501,iphone 15,60000,80000,20000,2,00304,India
228531,2023-11-29,504,iron,449,879,430,2,00148,India
228531,2023-11-29,506,monitor,3249,8000,4751,2,00148,India
228531,2023-11-29,501,iphone 15,60000,80000,20000,2,00148,India
171782,2023-11-29,506,monitor,3249,8000,4751,2,00375,India
171782,2023-11-29,501,iphone 15,60000,80000,20000,2,00375,India
633847,2023-11-29,501,iphone 15,60000,80000,20000,2,00386,India
633847,2023-11-29,503,mixer,1349,3249,1900,2,00386,India
633847,2023-11-29,505,oven,18490,24000,5510,2,00386,India
633847,2023-11-29,504,iron,449,879,430,2,00386,India
858547,2023-11-29,505,oven,18490,24000,5510,2,00124,India
803974,2023-11-29,501,iphone 15,60000,80000,20000,2,00377,India
590748,2023-11-29,503,mixer,1349,3249,1900,2,00214,India
590748,2023-11-29,507,washing machine,6990,16490,9500,2,00214,India
590748,2023-11-29,504,iron,449,879,430,2,00214,India
590725,2023-11-29,501,iphone 15,60000,80000,20000,2,00280,India
590725,2023-11-29,505,oven,18490,24000,5510,2,00280,India
590725,2023-11-29,504,iron,449,879,430,2,00280,India
590725,2023-11-29,506,monitor,3249,8000,4751,2,00280,India
461838,2023-11-29,501,iphone 15,60000,80000,20000,2,00200,India
924276,2023-11-29,504,iron,449,879,430,2,00330,India
520392,2023-11-29,503,mixer,1349,3249,1900,2,00225,India
520392,2023-11-29,506,monitor,3249,8000,4751,2,00225,India
520392,2023-11-29,501,iphone 15,60000,80000,20000,2,00225,India
717676,2023-11-29,505,oven,18490,24000,5510,2,00183,India
717676,2023-11-29,506,monitor,3249,8000,4751,2,00183,India
684753,2023-11-29,503,mixer,1349,3249,1900,2,00292,India
684753,2023-11-29,505,oven,18490,24000,5510,2,00292,India
262466,2023-11-29,503,mixer,1349,3249,1900,2,00108,India
262466,2023-11-29,501,iphone 15,60000,80000,20000,2,00108,India
262466,2023-11-29,505,oven,18490,24000,5510,2,00108,India
262466,2023-11-29,504,iron,449,879,430,2,00108,India
341660,2023-11-29,503,mixer,1349,3249,1900,2,00261,India
341660,2023-11-29,505,oven,18490,24000,5510,2,00261,India
755233,2023-11-29,503,mixer,1349,3249,1900,2,00023,India
755233,2023-11-29,505,oven,18490,24000,5510,2,00023,India
755233,2023-11-29,506,monitor,3249,8000,4751,2,00023,India
755233,2023-11-29,502,iphone 15 pro max,100000,135000,35000,2,00023,India
755233,2023-11-29,504,iron,449,879,430,2,00023,India
154664,2023-11-29,503,mixer,1349,3249,1900,2,00116,India
154664,2023-11-29,502,iphone 15 pro max,100000,135000,35000,2,00116,India
154664,2023-11-29,505,oven,18490,24000,5510,2,00116,India
104629,2023-11-29,506,monitor,3249,8000,4751,2,00220,India
104629,2023-11-29,503,mixer,1349,3249,1900,2,00220,India
611410,2023-11-29,503,mixer,1349,3249,1900,2,00299,India
611410,2023-11-29,504,iron,449,879,430,2,00299,India
611410,2023-11-29,502,iphone 15 pro max,100000,135000,35000,2,00299,India
839242,2023-11-29,507,washing machine,6990,16490,9500,2,00287,India
898622,2023-11-30,502,iphone 15 pro max,100000,135000,35000,2,00280,India
898622,2023-11-30,501,iphone 15,60000,80000,20000,2,00280,India
812342,2023-11-30,507,washing machine,6990,16490,9500,2,00429,India
812342,2023-11-30,501,iphone 15,60000,80000,20000,2,00429,India
812342,2023-11-30,504,iron,449,879,430,2,00429,India
385982,2023-11-30,502,iphone 15 pro max,100000,135000,35000,2,00275,India
385982,2023-11-30,505,oven,18490,24000,5510,2,00275,India
385982,2023-11-30,506,monitor,3249,8000,4751,2,00275,India
341575,2023-11-30,504,iron,449,879,430,2,00034,India
341575,2023-11-30,506,monitor,3249,8000,4751,2,00034,India
341575,2023-11-30,503,mixer,1349,3249,1900,2,00034,India
341575,2023-11-30,502,iphone 15 pro max,100000,135000,35000,2,00034,India
855908,2023-11-30,505,oven,18490,24000,5510,2,00263,India
683339,2023-11-30,506,monitor,3249,8000,4751,2,00280,India
683339,2023-11-30,503,mixer,1349,3249,1900,2,00280,India
683339,2023-11-30,504,iron,449,879,430,2,00280,India
683339,2023-11-30,502,iphone 15 pro max,100000,135000,35000,2,00280,India
764126,2023-11-30,505,oven,18490,24000,5510,2,00125,India
764126,2023-11-30,504,iron,449,879,430,2,00125,India
764126,2023-11-30,502,iphone 15 pro max,100000,135000,35000,2,00125,India
142071,2023-11-30,503,mixer,1349,3249,1900,2,00298,India
142071,2023-11-30,505,oven,18490,24000,5510,2,00298,India
142071,2023-11-30,504,iron,449,879,430,2,00298,India
353724,2023-11-30,504,iron,449,879,430,2,00116,India
353724,2023-11-30,506,monitor,3249,8000,4751,2,00116,India
451306,2023-11-30,507,washing machine,6990,16490,9500,2,00364,India
429116,2023-11-30,503,mixer,1349,3249,1900,2,00258,India
429116,2023-11-30,502,iphone 15 pro max,100000,135000,35000,2,00258,India
429116,2023-11-30,504,iron,449,879,430,2,00258,India
429116,2023-11-30,507,washing machine,6990,16490,9500,2,00258,India
275684,2023-11-30,505,oven,18490,24000,5510,2,00119,India
275684,2023-11-30,503,mixer,1349,3249,1900,2,00119,India
275684,2023-11-30,507,washing machine,6990,16490,9500,2,00119,India
867982,2023-11-30,507,washing machine,6990,16490,9500,2,00032,India
690081,2023-11-30,506,monitor,3249,8000,4751,2,00095,India
690081,2023-11-30,505,oven,18490,24000,5510,2,00095,India
690081,2023-11-30,501,iphone 15,60000,80000,20000,2,00095,India
671725,2023-11-30,501,iphone 15,60000,80000,20000,2,00334,India
671725,2023-11-30,503,mixer,1349,3249,1900,2,00334,India
671725,2023-11-30,507,washing machine,6990,16490,9500,2,00334,India
137340,2023-11-30,507,washing machine,6990,16490,9500,2,00046,India
137340,2023-11-30,504,iron,449,879,430,2,00046,India
137340,2023-11-30,502,iphone 15 pro max,100000,135000,35000,2,00046,India
137340,2023-11-30,506,monitor,3249,8000,4751,2,00046,India
680769,2023-11-30,505,oven,18490,24000,5510,2,00490,India
680769,2023-11-30,503,mixer,1349,3249,1900,2,00490,India
680769,2023-11-30,501,iphone 15,60000,80000,20000,2,00490,India
970323,2023-11-30,507,washing machine,6990,16490,9500,2,00437,India
970323,2023-11-30,502,iphone 15 pro max,100000,135000,35000,2,00437,India
365288,2023-11-30,506,monitor,3249,8000,4751,2,00202,India
365288,2023-11-30,507,washing machine,6990,16490,9500,2,00202,India
365288,2023-11-30,501,iphone 15,60000,80000,20000,2,00202,India
624072,2023-11-30,503,mixer,1349,3249,1900,2,00098,India
624072,2023-11-30,506,monitor,3249,8000,4751,2,00098,India
501724,2023-11-30,501,iphone 15,60000,80000,20000,2,00126,India
501724,2023-11-30,504,iron,449,879,430,2,00126,India
501724,2023-11-30,502,iphone 15 pro max,100000,135000,35000,2,00126,India
753050,2023-11-30,501,iphone 15,60000,80000,20000,2,00428,India
753050,2023-11-30,504,iron,449,879,430,2,00428,India
753050,2023-11-30,503,mixer,1349,3249,1900,2,00428,India
937537,2023-11-30,503,mixer,1349,3249,1900,2,00473,India
468041,2023-11-30,503,mixer,1349,3249,1900,2,00284,India
468041,2023-11-30,502,iphone 15 pro max,100000,135000,35000,2,00284,India
468041,2023-11-30,506,monitor,3249,8000,4751,2,00284,India
913816,2023-11-30,505,oven,18490,24000,5510,2,00406,India
913816,2023-11-30,507,washing machine,6990,16490,9500,2,00406,India
913816,2023-11-30,503,mixer,1349,3249,1900,2,00406,India
913816,2023-11-30,501,iphone 15,60000,80000,20000,2,00406,India
147629,2023-11-30,504,iron,449,879,430,2,00462,India
730371,2023-11-30,504,iron,449,879,430,2,00107,India
730371,2023-11-30,506,monitor,3249,8000,4751,2,00107,India
730371,2023-11-30,502,iphone 15 pro max,100000,135000,35000,2,00107,India
931077,2023-11-30,506,monitor,3249,8000,4751,2,00342,India
779933,2023-11-30,504,iron,449,879,430,2,00222,India
534439,2023-11-30,507,washing machine,6990,16490,9500,2,00158,India
534439,2023-11-30,506,monitor,3249,8000,4751,2,00158,India
534439,2023-11-30,503,mixer,1349,3249,1900,2,00158,India
519967,2023-11-30,501,iphone 15,60000,80000,20000,2,00122,India
519967,2023-11-30,502,iphone 15 pro max,100000,135000,35000,2,00122,India
519967,2023-11-30,506,monitor,3249,8000,4751,2,00122,India
526454,2023-11-30,502,iphone 15 pro max,100000,135000,35000,2,00106,India
745129,2023-11-30,502,iphone 15 pro max,100000,135000,35000,2,00422,India
745129,2023-11-30,507,washing machine,6990,16490,9500,2,00422,India
745129,2023-11-30,501,iphone 15,60000,80000,20000,2,00422,India
745129,2023-11-30,504,iron,449,879,430,2,00422,India
787019,2023-11-30,501,iphone 15,60000,80000,20000,2,00392,India
787019,2023-11-30,506,monitor,3249,8000,4751,2,00392,India
836459,2023-11-30,505,oven,18490,24000,5510,2,00270,India
836459,2023-11-30,503,mixer,1349,3249,1900,2,00270,India
836459,2023-11-30,507,washing machine,6990,16490,9500,2,00270,India
531618,2023-11-30,507,washing machine,6990,16490,9500,2,00150,India
761175,2023-11-30,503,mixer,1349,3249,1900,2,00375,India
761175,2023-11-30,501,iphone 15,60000,80000,20000,2,00375,India
761175,2023-11-30,505,oven,18490,24000,5510,2,00375,India
931655,2023-11-30,502,iphone 15 pro max,100000,135000,35000,2,00359,India
931655,2023-11-30,506,monitor,3249,8000,4751,2,00359,India
931655,2023-11-30,503,mixer,1349,3249,1900,2,00359,India
604925,2023-11-30,502,iphone 15 pro max,100000,135000,35000,2,00458,India
695445,2023-11-30,501,iphone 15,60000,80000,20000,2,00443,India
695445,2023-11-30,505,oven,18490,24000,5510,2,00443,India
352275,2023-11-30,505,oven,18490,24000,5510,2,00130,India
132847,2023-11-30,503,mixer,1349,3249,1900,2,00027,India
388134,2023-11-30,504,iron,449,879,430,2,00191,India
388134,2023-11-30,506,monitor,3249,8000,4751,2,00191,India
388134,2023-11-30,505,oven,18490,24000,5510,2,00191,India
812060,2023-11-30,505,oven,18490,24000,5510,2,00109,India
874334,2023-11-30,507,washing machine,6990,16490,9500,2,00379,India
874334,2023-11-30,505,oven,18490,24000,5510,2,00379,India
874334,2023-11-30,502,iphone 15 pro max,100000,135000,35000,2,00379,India
666379,2023-11-30,506,monitor,3249,8000,4751,2,00242,India
302876,2023-11-30,507,washing machine,6990,16490,9500,2,00302,India
302876,2023-11-30,503,mixer,1349,3249,1900,2,00302,India
302876,2023-11-30,504,iron,449,879,430,2,00302,India
302876,2023-11-30,505,oven,18490,24000,5510,2,00302,India
340143,2023-11-30,504,iron,449,879,430,2,00191,India
340143,2023-11-30,505,oven,18490,24000,5510,2,00191,India
340143,2023-11-30,502,iphone 15 pro max,100000,135000,35000,2,00191,India
798262,2023-11-30,503,mixer,1349,3249,1900,2,00264,India
798262,2023-11-30,506,monitor,3249,8000,4751,2,00264,India
282289,2023-11-30,501,iphone 15,60000,80000,20000,2,00325,India
282289,2023-11-30,506,monitor,3249,8000,4751,2,00325,India
282289,2023-11-30,502,iphone 15 pro max,100000,135000,35000,2,00325,India
282289,2023-11-30,504,iron,449,879,430,2,00325,India
109370,2023-11-30,504,iron,449,879,430,2,00148,India
599076,2023-11-30,507,washing machine,6990,16490,9500,2,00160,India
599076,2023-11-30,502,iphone 15 pro max,100000,135000,35000,2,00160,India
354743,2023-11-30,502,iphone 15 pro max,100000,135000,35000,2,00352,India
302682,2023-11-30,505,oven,18490,24000,5510,2,00208,India
302682,2023-11-30,501,iphone 15,60000,80000,20000,2,00208,India
302682,2023-11-30,503,mixer,1349,3249,1900,2,00208,India
630655,2023-11-30,501,iphone 15,60000,80000,20000,2,00067,India
630655,2023-11-30,504,iron,449,879,430,2,00067,India
630655,2023-11-30,507,washing machine,6990,16490,9500,2,00067,India
275592,2023-11-30,503,mixer,1349,3249,1900,2,00047,India
275592,2023-11-30,505,oven,18490,24000,5510,2,00047,India
285511,2023-11-30,506,monitor,3249,8000,4751,2,00268,India
285511,2023-11-30,504,iron,449,879,430,2,00268,India
285511,2023-11-30,505,oven,18490,24000,5510,2,00268,India
901958,2023-11-30,504,iron,449,879,430,2,00154,India
901958,2023-11-30,503,mixer,1349,3249,1900,2,00154,India
560625,2023-11-30,504,iron,449,879,430,2,00487,India
560625,2023-11-30,501,iphone 15,60000,80000,20000,2,00487,India
225576,2023-11-30,501,iphone 15,60000,80000,20000,2,00021,India
895064,2023-11-30,507,washing machine,6990,16490,9500,2,00248,India
895064,2023-11-30,504,iron,449,879,430,2,00248,India
983771,2023-11-30,507,washing machine,6990,16490,9500,2,00215,India
411936,2023-11-30,501,iphone 15,60000,80000,20000,2,00142,India
411936,2023-11-30,507,washing machine,6990,16490,9500,2,00142,India
770391,2023-11-30,506,monitor,3249,8000,4751,2,00294,India
770391,2023-11-30,501,iphone 15,60000,80000,20000,2,00294,India
721367,2023-11-30,504,iron,449,879,430,2,00035,India
721367,2023-11-30,501,iphone 15,60000,80000,20000,2,00035,India
721367,2023-11-30,506,monitor,3249,8000,4751,2,00035,India
721367,2023-11-30,505,oven,18490,24000,5510,2,00035,India
321817,2023-11-30,505,oven,18490,24000,5510,2,00088,India
321817,2023-11-30,506,monitor,3249,8000,4751,2,00088,India
907979,2023-11-30,503,mixer,1349,3249,1900,2,00139,India
907979,2023-11-30,507,washing machine,6990,16490,9500,2,00139,India
907979,2023-11-30,504,iron,449,879,430,2,00139,India
118800,2023-11-30,506,monitor,3249,8000,4751,2,00438,India
755664,2023-11-30,506,monitor,3249,8000,4751,2,00167,India
755664,2023-11-30,507,washing machine,6990,16490,9500,2,00167,India
755664,2023-11-30,503,mixer,1349,3249,1900,2,00167,India
466750,2023-11-30,506,monitor,3249,8000,4751,2,00106,India
466750,2023-11-30,505,oven,18490,24000,5510,2,00106,India
625113,2023-11-30,505,oven,18490,24000,5510,2,00447,India
625113,2023-11-30,502,iphone 15 pro max,100000,135000,35000,2,00447,India
625113,2023-11-30,504,iron,449,879,430,2,00447,India
623492,2023-11-30,503,mixer,1349,3249,1900,2,00304,India
623492,2023-11-30,504,iron,449,879,430,2,00304,India
432097,2023-11-30,503,mixer,1349,3249,1900,2,00006,India
432097,2023-11-30,505,oven,18490,24000,5510,2,00006,India
432097,2023-11-30,506,monitor,3249,8000,4751,2,00006,India
465586,2023-11-30,503,mixer,1349,3249,1900,2,00060,India
218879,2023-11-30,506,monitor,3249,8000,4751,2,00469,India
218879,2023-11-30,503,mixer,1349,3249,1900,2,00469,India
511758,2023-12-01,504,iron,449,879,430,1,00419,India
511758,2023-12-01,502,iphone 15 pro max,100000,135000,35000,1,00419,India
548649,2023-12-01,504,iron,449,879,430,1,00229,India
548649,2023-12-01,501,iphone 15,60000,80000,20000,1,00229,India
545128,2023-12-01,504,iron,449,879,430,1,00261,India
545128,2023-12-01,506,monitor,3249,8000,4751,1,00261,India
896304,2023-12-01,507,washing machine,6990,16490,9500,1,00168,India
896304,2023-12-01,504,iron,449,879,430,1,00168,India
468706,2023-12-01,506,monitor,3249,8000,4751,1,00409,India
468706,2023-12-01,501,iphone 15,60000,80000,20000,1,00409,India
335254,2023-12-01,501,iphone 15,60000,80000,20000,1,00181,India
335254,2023-12-01,507,washing machine,6990,16490,9500,1,00181,India
335254,2023-12-01,505,oven,18490,24000,5510,1,00181,India
335254,2023-12-01,502,iphone 15 pro max,100000,135000,35000,1,00181,India
335254,2023-12-01,506,monitor,3249,8000,4751,1,00181,India
354452,2023-12-01,502,iphone 15 pro max,100000,135000,35000,1,00062,India
354452,2023-12-01,507,washing machine,6990,16490,9500,1,00062,India
281404,2023-12-01,504,iron,449,879,430,1,00247,India
597954,2023-12-01,505,oven,18490,24000,5510,1,00073,India
665308,2023-12-01,503,mixer,1349,3249,1900,1,00233,India
665308,2023-12-01,505,oven,18490,24000,5510,1,00233,India
665308,2023-12-01,506,monitor,3249,8000,4751,1,00233,India
206604,2023-12-01,501,iphone 15,60000,80000,20000,1,00409,India
206604,2023-12-01,507,washing machine,6990,16490,9500,1,00409,India
395299,2023-12-01,503,mixer,1349,3249,1900,1,00097,India
489323,2023-12-01,505,oven,18490,24000,5510,1,00120,India
489323,2023-12-01,507,washing machine,6990,16490,9500,1,00120,India
489323,2023-12-01,501,iphone 15,60000,80000,20000,1,00120,India
489323,2023-12-01,504,iron,449,879,430,1,00120,India
502751,2023-12-01,506,monitor,3249,8000,4751,1,00368,India
502751,2023-12-01,505,oven,18490,24000,5510,1,00368,India
181584,2023-12-01,504,iron,449,879,430,1,00071,India
181584,2023-12-01,506,monitor,3249,8000,4751,1,00071,India
181584,2023-12-01,505,oven,18490,24000,5510,1,00071,India
181584,2023-12-01,507,washing machine,6990,16490,9500,1,00071,India
181584,2023-12-01,502,iphone 15 pro max,100000,135000,35000,1,00071,India
510097,2023-12-01,501,iphone 15,60000,80000,20000,1,00425,India
510097,2023-12-01,504,iron,449,879,430,1,00425,India
822782,2023-12-01,506,monitor,3249,8000,4751,1,00431,India
895776,2023-12-01,503,mixer,1349,3249,1900,1,00259,India
113449,2023-12-01,507,washing machine,6990,16490,9500,1,00459,India
113449,2023-12-01,505,oven,18490,24000,5510,1,00459,India
113449,2023-12-01,502,iphone 15 pro max,100000,135000,35000,1,00459,India
702045,2023-12-01,501,iphone 15,60000,80000,20000,1,00211,India
702045,2023-12-01,507,washing machine,6990,16490,9500,1,00211,India
702045,2023-12-01,506,monitor,3249,8000,4751,1,00211,India
417695,2023-12-01,507,washing machine,6990,16490,9500,1,00180,India
417695,2023-12-01,502,iphone 15 pro max,100000,135000,35000,1,00180,India
417695,2023-12-01,504,iron,449,879,430,1,00180,India
417695,2023-12-01,503,mixer,1349,3249,1900,1,00180,India
417695,2023-12-01,505,oven,18490,24000,5510,1,00180,India
605368,2023-12-01,507,washing machine,6990,16490,9500,1,00306,India
474678,2023-12-01,506,monitor,3249,8000,4751,1,00084,India
474678,2023-12-01,505,oven,18490,24000,5510,1,00084,India
474678,2023-12-01,507,washing machine,6990,16490,9500,1,00084,India
725256,2023-12-01,502,iphone 15 pro max,100000,135000,35000,1,00246,India
725256,2023-12-01,503,mixer,1349,3249,1900,1,00246,India
790794,2023-12-01,501,iphone 15,60000,80000,20000,1,00214,India
790794,2023-12-01,507,washing machine,6990,16490,9500,1,00214,India
790794,2023-12-01,506,monitor,3249,8000,4751,1,00214,India
253524,2023-12-01,505,oven,18490,24000,5510,1,00277,India
253524,2023-12-01,502,iphone 15 pro max,100000,135000,35000,1,00277,India
410791,2023-12-01,501,iphone 15,60000,80000,20000,1,00107,India
326989,2023-12-01,501,iphone 15,60000,80000,20000,1,00024,India
326989,2023-12-01,502,iphone 15 pro max,100000,135000,35000,1,00024,India
326989,2023-12-01,507,washing machine,6990,16490,9500,1,00024,India
129991,2023-12-01,503,mixer,1349,3249,1900,1,00310,India
129991,2023-12-01,501,iphone 15,60000,80000,20000,1,00310,India
129991,2023-12-01,507,washing machine,6990,16490,9500,1,00310,India
129991,2023-12-01,506,monitor,3249,8000,4751,1,00310,India
144599,2023-12-01,501,iphone 15,60000,80000,20000,1,00066,India
144599,2023-12-01,502,iphone 15 pro max,100000,135000,35000,1,00066,India
144599,2023-12-01,507,washing machine,6990,16490,9500,1,00066,India
106366,2023-12-01,502,iphone 15 pro max,100000,135000,35000,1,00016,India
910422,2023-12-01,502,iphone 15 pro max,100000,135000,35000,1,00006,India
910422,2023-12-01,507,washing machine,6990,16490,9500,1,00006,India
664791,2023-12-01,506,monitor,3249,8000,4751,1,00278,India
664791,2023-12-01,505,oven,18490,24000,5510,1,00278,India
214989,2023-12-01,505,oven,18490,24000,5510,1,00235,India
203593,2023-12-01,502,iphone 15 pro max,100000,135000,35000,1,00196,India
203593,2023-12-01,504,iron,449,879,430,1,00196,India
944946,2023-12-01,503,mixer,1349,3249,1900,1,00205,India
944946,2023-12-01,505,oven,18490,24000,5510,1,00205,India
944946,2023-12-01,507,washing machine,6990,16490,9500,1,00205,India
944946,2023-12-01,504,iron,449,879,430,1,00205,India
634630,2023-12-01,504,iron,449,879,430,1,00192,India
634630,2023-12-01,507,washing machine,6990,16490,9500,1,00192,India
893120,2023-12-01,504,iron,449,879,430,1,00273,India
893120,2023-12-01,503,mixer,1349,3249,1900,1,00273,India
893120,2023-12-01,501,iphone 15,60000,80000,20000,1,00273,India
893120,2023-12-01,506,monitor,3249,8000,4751,1,00273,India
111338,2023-12-01,501,iphone 15,60000,80000,20000,1,00020,India
111338,2023-12-01,505,oven,18490,24000,5510,1,00020,India
577566,2023-12-01,501,iphone 15,60000,80000,20000,1,00395,India
577566,2023-12-01,504,iron,449,879,430,1,00395,India
577566,2023-12-01,502,iphone 15 pro max,100000,135000,35000,1,00395,India
450475,2023-12-01,506,monitor,3249,8000,4751,1,00185,India
450475,2023-12-01,503,mixer,1349,3249,1900,1,00185,India
879288,2023-12-01,506,monitor,3249,8000,4751,1,00150,India
879288,2023-12-01,505,oven,18490,24000,5510,1,00150,India
505522,2023-12-01,505,oven,18490,24000,5510,1,00180,India
505522,2023-12-01,507,washing machine,6990,16490,9500,1,00180,India
505522,2023-12-01,502,iphone 15 pro max,100000,135000,35000,1,00180,India
162762,2023-12-01,502,iphone 15 pro max,100000,135000,35000,1,00330,India
167222,2023-12-01,506,monitor,3249,8000,4751,1,00034,India
167222,2023-12-01,502,iphone 15 pro max,100000,135000,35000,1,00034,India
162317,2023-12-01,506,monitor,3249,8000,4751,1,00251,India
162317,2023-12-01,505,oven,18490,24000,5510,1,00251,India
660279,2023-12-01,505,oven,18490,24000,5510,1,00334,India
660279,2023-12-01,504,iron,449,879,430,1,00334,India
660279,2023-12-01,506,monitor,3249,8000,4751,1,00334,India
706812,2023-12-01,507,washing machine,6990,16490,9500,1,00221,India
706812,2023-12-01,505,oven,18490,24000,5510,1,00221,India
706812,2023-12-01,501,iphone 15,60000,80000,20000,1,00221,India
946849,2023-12-01,504,iron,449,879,430,1,00159,India
946849,2023-12-01,507,washing machine,6990,16490,9500,1,00159,India
564626,2023-12-01,501,iphone 15,60000,80000,20000,1,00297,India
564626,2023-12-01,504,iron,449,879,430,1,00297,India
564626,2023-12-01,503,mixer,1349,3249,1900,1,00297,India
483048,2023-12-02,502,iphone 15 pro max,100000,135000,35000,1,00116,India
483048,2023-12-02,501,iphone 15,60000,80000,20000,1,00116,India
483048,2023-12-02,507,washing machine,6990,16490,9500,1,00116,India
400602,2023-12-02,505,oven,18490,24000,5510,1,00042,India
596245,2023-12-02,506,monitor,3249,8000,4751,1,00274,India
710573,2023-12-02,503,mixer,1349,3249,1900,1,00259,India
710573,2023-12-02,506,monitor,3249,8000,4751,1,00259,India
350449,2023-12-02,503,mixer,1349,3249,1900,1,00363,India
350449,2023-12-02,502,iphone 15 pro max,100000,135000,35000,1,00363,India
350449,2023-12-02,501,iphone 15,60000,80000,20000,1,00363,India
357432,2023-12-02,504,iron,449,879,430,1,00385,India
357432,2023-12-02,503,mixer,1349,3249,1900,1,00385,India
749224,2023-12-02,501,iphone 15,60000,80000,20000,1,00122,India
749224,2023-12-02,505,oven,18490,24000,5510,1,00122,India
749224,2023-12-02,504,iron,449,879,430,1,00122,India
464540,2023-12-02,501,iphone 15,60000,80000,20000,1,00069,India
464540,2023-12-02,503,mixer,1349,3249,1900,1,00069,India
213617,2023-12-02,504,iron,449,879,430,1,00058,India
213617,2023-12-02,501,iphone 15,60000,80000,20000,1,00058,India
213617,2023-12-02,506,monitor,3249,8000,4751,1,00058,India
824397,2023-12-02,506,monitor,3249,8000,4751,1,00052,India
514191,2023-12-02,505,oven,18490,24000,5510,1,00147,India
972092,2023-12-02,503,mixer,1349,3249,1900,1,00381,India
972092,2023-12-02,505,oven,18490,24000,5510,1,00381,India
972092,2023-12-02,502,iphone 15 pro max,100000,135000,35000,1,00381,India
972092,2023-12-02,504,iron,449,879,430,1,00381,India
324503,2023-12-02,505,oven,18490,24000,5510,1,00471,India
324503,2023-12-02,501,iphone 15,60000,80000,20000,1,00471,India
182081,2023-12-02,504,iron,449,879,430,1,00019,India
182081,2023-12-02,506,monitor,3249,8000,4751,1,00019,India
404400,2023-12-02,507,washing machine,6990,16490,9500,1,00142,India
404400,2023-12-02,506,monitor,3249,8000,4751,1,00142,India
404400,2023-12-02,503,mixer,1349,3249,1900,1,00142,India
404400,2023-12-02,501,iphone 15,60000,80000,20000,1,00142,India
631146,2023-12-02,501,iphone 15,60000,80000,20000,1,00254,India
631146,2023-12-02,504,iron,449,879,430,1,00254,India
935200,2023-12-02,503,mixer,1349,3249,1900,1,00065,India
935200,2023-12-02,502,iphone 15 pro max,100000,135000,35000,1,00065,India
935200,2023-12-02,505,oven,18490,24000,5510,1,00065,India
913108,2023-12-02,502,iphone 15 pro max,100000,135000,35000,1,00468,India
913108,2023-12-02,501,iphone 15,60000,80000,20000,1,00468,India
913108,2023-12-02,506,monitor,3249,8000,4751,1,00468,India
726621,2023-12-02,505,oven,18490,24000,5510,1,00353,India
706975,2023-12-02,504,iron,449,879,430,1,00243,India
706975,2023-12-02,503,mixer,1349,3249,1900,1,00243,India
249225,2023-12-02,507,washing machine,6990,16490,9500,1,00181,India
249225,2023-12-02,504,iron,449,879,430,1,00181,India
249225,2023-12-02,506,monitor,3249,8000,4751,1,00181,India
249225,2023-12-02,502,iphone 15 pro max,100000,135000,35000,1,00181,India
701547,2023-12-02,504,iron,449,879,430,1,00254,India
332753,2023-12-02,502,iphone 15 pro max,100000,135000,35000,1,00161,India
354527,2023-12-02,506,monitor,3249,8000,4751,1,00213,India
354527,2023-12-02,501,iphone 15,60000,80000,20000,1,00213,India
354527,2023-12-02,504,iron,449,879,430,1,00213,India
354527,2023-12-02,502,iphone 15 pro max,100000,135000,35000,1,00213,India
443106,2023-12-02,502,iphone 15 pro max,100000,135000,35000,1,00013,India
443106,2023-12-02,506,monitor,3249,8000,4751,1,00013,India
443106,2023-12-02,507,washing machine,6990,16490,9500,1,00013,India
443106,2023-12-02,505,oven,18490,24000,5510,1,00013,India
443106,2023-12-02,504,iron,449,879,430,1,00013,India
346762,2023-12-02,504,iron,449,879,430,1,00053,India
346762,2023-12-02,501,iphone 15,60000,80000,20000,1,00053,India
346762,2023-12-02,505,oven,18490,24000,5510,1,00053,India
939589,2023-12-02,501,iphone 15,60000,80000,20000,1,00112,India
939589,2023-12-02,507,washing machine,6990,16490,9500,1,00112,India
439656,2023-12-02,502,iphone 15 pro max,100000,135000,35000,1,00399,India
439656,2023-12-02,505,oven,18490,24000,5510,1,00399,India
439656,2023-12-02,501,iphone 15,60000,80000,20000,1,00399,India
695668,2023-12-02,502,iphone 15 pro max,100000,135000,35000,1,00474,India
695668,2023-12-02,504,iron,449,879,430,1,00474,India
695668,2023-12-02,503,mixer,1349,3249,1900,1,00474,India
118052,2023-12-02,505,oven,18490,24000,5510,1,00367,India
118052,2023-12-02,506,monitor,3249,8000,4751,1,00367,India
118052,2023-12-02,507,washing machine,6990,16490,9500,1,00367,India
916060,2023-12-02,505,oven,18490,24000,5510,1,00139,India
916060,2023-12-02,506,monitor,3249,8000,4751,1,00139,India
555944,2023-12-02,503,mixer,1349,3249,1900,1,00136,India
555944,2023-12-02,502,iphone 15 pro max,100000,135000,35000,1,00136,India
555944,2023-12-02,506,monitor,3249,8000,4751,1,00136,India
317002,2023-12-02,505,oven,18490,24000,5510,1,00347,India
471861,2023-12-02,502,iphone 15 pro max,100000,135000,35000,1,00072,India
471861,2023-12-02,503,mixer,1349,3249,1900,1,00072,India
471861,2023-12-02,507,washing machine,6990,16490,9500,1,00072,India
471861,2023-12-02,506,monitor,3249,8000,4751,1,00072,India
141002,2023-12-02,504,iron,449,879,430,1,00463,India
761167,2023-12-02,507,washing machine,6990,16490,9500,1,00043,India
761167,2023-12-02,504,iron,449,879,430,1,00043,India
739396,2023-12-02,502,iphone 15 pro max,100000,135000,35000,1,00041,India
739396,2023-12-02,503,mixer,1349,3249,1900,1,00041,India
739396,2023-12-02,505,oven,18490,24000,5510,1,00041,India
739396,2023-12-02,501,iphone 15,60000,80000,20000,1,00041,India
413929,2023-12-02,507,washing machine,6990,16490,9500,1,00405,India
413929,2023-12-02,502,iphone 15 pro max,100000,135000,35000,1,00405,India
413929,2023-12-02,506,monitor,3249,8000,4751,1,00405,India
219742,2023-12-02,503,mixer,1349,3249,1900,1,00112,India
846535,2023-12-02,504,iron,449,879,430,1,00232,India
846535,2023-12-02,507,washing machine,6990,16490,9500,1,00232,India
558988,2023-12-02,504,iron,449,879,430,1,00040,India
558988,2023-12-02,503,mixer,1349,3249,1900,1,00040,India
104442,2023-12-02,503,mixer,1349,3249,1900,1,00180,India
104442,2023-12-02,505,oven,18490,24000,5510,1,00180,India
520196,2023-12-02,502,iphone 15 pro max,100000,135000,35000,1,00448,India
192396,2023-12-02,507,washing machine,6990,16490,9500,1,00393,India
192396,2023-12-02,505,oven,18490,24000,5510,1,00393,India
192396,2023-12-02,502,iphone 15 pro max,100000,135000,35000,1,00393,India
192396,2023-12-02,501,iphone 15,60000,80000,20000,1,00393,India
157593,2023-12-02,503,mixer,1349,3249,1900,1,00004,India
157593,2023-12-02,505,oven,18490,24000,5510,1,00004,India
157593,2023-12-02,506,monitor,3249,8000,4751,1,00004,India
534441,2023-12-02,503,mixer,1349,3249,1900,1,00416,India
448897,2023-12-02,504,iron,449,879,430,1,00204,India
448897,2023-12-02,501,iphone 15,60000,80000,20000,1,00204,India
448897,2023-12-02,502,iphone 15 pro max,100000,135000,35000,1,00204,India
448897,2023-12-02,505,oven,18490,24000,5510,1,00204,India
799443,2023-12-02,503,mixer,1349,3249,1900,1,00470,India
799443,2023-12-02,507,washing machine,6990,16490,9500,1,00470,India
799443,2023-12-02,505,oven,18490,24000,5510,1,00470,India
805547,2023-12-02,502,iphone 15 pro max,100000,135000,35000,1,00417,India
805547,2023-12-02,504,iron,449,879,430,1,00417,India
788825,2023-12-02,507,washing machine,6990,16490,9500,1,00178,India
188179,2023-12-02,503,mixer,1349,3249,1900,1,00428,India
188179,2023-12-02,501,iphone 15,60000,80000,20000,1,00428,India
188179,2023-12-02,507,washing machine,6990,16490,9500,1,00428,India
681453,2023-12-02,504,iron,449,879,430,1,00424,India
681453,2023-12-02,505,oven,18490,24000,5510,1,00424,India
719234,2023-12-02,501,iphone 15,60000,80000,20000,1,00352,India
719234,2023-12-02,504,iron,449,879,430,1,00352,India
719234,2023-12-02,503,mixer,1349,3249,1900,1,00352,India
719234,2023-12-02,507,washing machine,6990,16490,9500,1,00352,India
611456,2023-12-02,504,iron,449,879,430,1,00017,India
251686,2023-12-02,502,iphone 15 pro max,100000,135000,35000,1,00317,India
251686,2023-12-02,507,washing machine,6990,16490,9500,1,00317,India
251686,2023-12-02,505,oven,18490,24000,5510,1,00317,India
728585,2023-12-02,506,monitor,3249,8000,4751,1,00074,India
728585,2023-12-02,503,mixer,1349,3249,1900,1,00074,India
728585,2023-12-02,502,iphone 15 pro max,100000,135000,35000,1,00074,India
208178,2023-12-02,504,iron,449,879,430,1,00009,India
208178,2023-12-02,507,washing machine,6990,16490,9500,1,00009,India
208178,2023-12-02,501,iphone 15,60000,80000,20000,1,00009,India
587646,2023-12-02,502,iphone 15 pro max,100000,135000,35000,1,00314,India
725187,2023-12-02,506,monitor,3249,8000,4751,1,00366,India
725187,2023-12-02,503,mixer,1349,3249,1900,1,00366,India
210692,2023-12-02,503,mixer,1349,3249,1900,1,00059,India
437221,2023-12-02,501,iphone 15,60000,80000,20000,1,00222,India
437221,2023-12-02,503,mixer,1349,3249,1900,1,00222,India
437221,2023-12-02,502,iphone 15 pro max,100000,135000,35000,1,00222,India
292499,2023-12-02,503,mixer,1349,3249,1900,1,00148,India
292499,2023-12-02,501,iphone 15,60000,80000,20000,1,00148,India
251485,2023-12-02,505,oven,18490,24000,5510,1,00042,India
251485,2023-12-02,504,iron,449,879,430,1,00042,India
500405,2023-12-02,505,oven,18490,24000,5510,1,00500,India
500405,2023-12-02,507,washing machine,6990,16490,9500,1,00500,India
266230,2023-12-02,505,oven,18490,24000,5510,1,00277,India
266230,2023-12-02,507,washing machine,6990,16490,9500,1,00277,India
203309,2023-12-02,506,monitor,3249,8000,4751,1,00209,India
203309,2023-12-02,504,iron,449,879,430,1,00209,India
203309,2023-12-02,502,iphone 15 pro max,100000,135000,35000,1,00209,India
579154,2023-12-02,503,mixer,1349,3249,1900,1,00038,India
579154,2023-12-02,505,oven,18490,24000,5510,1,00038,India
579154,2023-12-02,504,iron,449,879,430,1,00038,India
579154,2023-12-02,501,iphone 15,60000,80000,20000,1,00038,India
579154,2023-12-02,507,washing machine,6990,16490,9500,1,00038,India
691046,2023-12-02,507,washing machine,6990,16490,9500,1,00425,India
691046,2023-12-02,505,oven,18490,24000,5510,1,00425,India
691046,2023-12-02,503,mixer,1349,3249,1900,1,00425,India
691046,2023-12-02,504,iron,449,879,430,1,00425,India
134098,2023-12-02,505,oven,18490,24000,5510,1,00294,India
134098,2023-12-02,503,mixer,1349,3249,1900,1,00294,India
552202,2023-12-02,502,iphone 15 pro max,100000,135000,35000,1,00257,India
552202,2023-12-02,505,oven,18490,24000,5510,1,00257,India
681751,2023-12-02,501,iphone 15,60000,80000,20000,1,00101,India
681751,2023-12-02,503,mixer,1349,3249,1900,1,00101,India
681751,2023-12-02,502,iphone 15 pro max,100000,135000,35000,1,00101,India
721060,2023-12-02,507,washing machine,6990,16490,9500,1,00474,India
721060,2023-12-02,503,mixer,1349,3249,1900,1,00474,India
721060,2023-12-02,505,oven,18490,24000,5510,1,00474,India
113464,2023-12-02,507,washing machine,6990,16490,9500,1,00447,India
113464,2023-12-02,506,monitor,3249,8000,4751,1,00447,India
113464,2023-12-02,502,iphone 15 pro max,100000,135000,35000,1,00447,India
821908,2023-12-02,502,iphone 15 pro max,100000,135000,35000,1,00198,India
821908,2023-12-02,503,mixer,1349,3249,1900,1,00198,India
821908,2023-12-02,505,oven,18490,24000,5510,1,00198,India
821908,2023-12-02,501,iphone 15,60000,80000,20000,1,00198,India
762633,2023-12-02,502,iphone 15 pro max,100000,135000,35000,1,00122,India
516118,2023-12-02,505,oven,18490,24000,5510,1,00341,India
516118,2023-12-02,503,mixer,1349,3249,1900,1,00341,India
516118,2023-12-02,504,iron,449,879,430,1,00341,India
516118,2023-12-02,501,iphone 15,60000,80000,20000,1,00341,India
966353,2023-12-02,504,iron,449,879,430,1,00472,India
966353,2023-12-02,507,washing machine,6990,16490,9500,1,00472,India
261517,2023-12-02,505,oven,18490,24000,5510,1,00225,India
261517,2023-12-02,507,washing machine,6990,16490,9500,1,00225,India
398956,2023-12-02,504,iron,449,879,430,1,00107,India
398956,2023-12-02,505,oven,18490,24000,5510,1,00107,India
417389,2023-12-02,504,iron,449,879,430,1,00389,India
417389,2023-12-02,506,monitor,3249,8000,4751,1,00389,India
417389,2023-12-02,503,mixer,1349,3249,1900,1,00389,India
417389,2023-12-02,507,washing machine,6990,16490,9500,1,00389,India
943328,2023-12-02,505,oven,18490,24000,5510,1,00103,India
943328,2023-12-02,503,mixer,1349,3249,1900,1,00103,India
943328,2023-12-02,507,washing machine,6990,16490,9500,1,00103,India
739223,2023-12-02,507,washing machine,6990,16490,9500,1,00399,India
278341,2023-12-02,501,iphone 15,60000,80000,20000,1,00089,India
278341,2023-12-02,507,washing machine,6990,16490,9500,1,00089,India
278341,2023-12-02,503,mixer,1349,3249,1900,1,00089,India
979729,2023-12-02,506,monitor,3249,8000,4751,1,00407,India
750456,2023-12-02,504,iron,449,879,430,1,00289,India
750456,2023-12-02,506,monitor,3249,8000,4751,1,00289,India
750456,2023-12-02,503,mixer,1349,3249,1900,1,00289,India
750456,2023-12-02,501,iphone 15,60000,80000,20000,1,00289,India
373389,2023-12-02,506,monitor,3249,8000,4751,1,00439,India
373389,2023-12-02,507,washing machine,6990,16490,9500,1,00439,India
373389,2023-12-02,503,mixer,1349,3249,1900,1,00439,India
837116,2023-12-02,505,oven,18490,24000,5510,1,00332,India
936100,2023-12-02,504,iron,449,879,430,1,00248,India
936100,2023-12-02,501,iphone 15,60000,80000,20000,1,00248,India
936100,2023-12-02,506,monitor,3249,8000,4751,1,00248,India
902689,2023-12-02,503,mixer,1349,3249,1900,1,00079,India
902689,2023-12-02,504,iron,449,879,430,1,00079,India
902689,2023-12-02,502,iphone 15 pro max,100000,135000,35000,1,00079,India
679813,2023-12-02,501,iphone 15,60000,80000,20000,1,00236,India
197185,2023-12-02,504,iron,449,879,430,1,00360,India
197185,2023-12-02,503,mixer,1349,3249,1900,1,00360,India
554887,2023-12-03,502,iphone 15 pro max,100000,135000,35000,1,00246,India
554887,2023-12-03,507,washing machine,6990,16490,9500,1,00246,India
554887,2023-12-03,504,iron,449,879,430,1,00246,India
918255,2023-12-03,507,washing machine,6990,16490,9500,1,00114,India
150457,2023-12-03,504,iron,449,879,430,1,00231,India
150457,2023-12-03,506,monitor,3249,8000,4751,1,00231,India
149846,2023-12-03,504,iron,449,879,430,1,00460,India
479153,2023-12-03,504,iron,449,879,430,1,00156,India
479153,2023-12-03,501,iphone 15,60000,80000,20000,1,00156,India
479153,2023-12-03,506,monitor,3249,8000,4751,1,00156,India
170159,2023-12-03,501,iphone 15,60000,80000,20000,1,00413,India
170159,2023-12-03,503,mixer,1349,3249,1900,1,00413,India
170159,2023-12-03,502,iphone 15 pro max,100000,135000,35000,1,00413,India
924764,2023-12-03,501,iphone 15,60000,80000,20000,1,00385,India
924764,2023-12-03,506,monitor,3249,8000,4751,1,00385,India
924764,2023-12-03,502,iphone 15 pro max,100000,135000,35000,1,00385,India
924764,2023-12-03,504,iron,449,879,430,1,00385,India
205749,2023-12-03,503,mixer,1349,3249,1900,1,00046,India
205749,2023-12-03,504,iron,449,879,430,1,00046,India
205749,2023-12-03,502,iphone 15 pro max,100000,135000,35000,1,00046,India
205749,2023-12-03,507,washing machine,6990,16490,9500,1,00046,India
686646,2023-12-03,505,oven,18490,24000,5510,1,00240,India
686646,2023-12-03,503,mixer,1349,3249,1900,1,00240,India
115765,2023-12-03,506,monitor,3249,8000,4751,1,00390,India
115765,2023-12-03,505,oven,18490,24000,5510,1,00390,India
115765,2023-12-03,503,mixer,1349,3249,1900,1,00390,India
774715,2023-12-03,504,iron,449,879,430,1,00469,India
539793,2023-12-03,503,mixer,1349,3249,1900,1,00121,India
127335,2023-12-03,502,iphone 15 pro max,100000,135000,35000,1,00456,India
127335,2023-12-03,507,washing machine,6990,16490,9500,1,00456,India
127335,2023-12-03,501,iphone 15,60000,80000,20000,1,00456,India
750691,2023-12-03,506,monitor,3249,8000,4751,1,00456,India
750691,2023-12-03,503,mixer,1349,3249,1900,1,00456,India
425080,2023-12-03,507,washing machine,6990,16490,9500,1,00201,India
425080,2023-12-03,503,mixer,1349,3249,1900,1,00201,India
976635,2023-12-03,502,iphone 15 pro max,100000,135000,35000,1,00335,India
976635,2023-12-03,503,mixer,1349,3249,1900,1,00335,India
976635,2023-12-03,501,iphone 15,60000,80000,20000,1,00335,India
976635,2023-12-03,507,washing machine,6990,16490,9500,1,00335,India
574408,2023-12-03,502,iphone 15 pro max,100000,135000,35000,1,00166,India
574408,2023-12-03,506,monitor,3249,8000,4751,1,00166,India
200652,2023-12-03,506,monitor,3249,8000,4751,1,00414,India
200652,2023-12-03,501,iphone 15,60000,80000,20000,1,00414,India
277754,2023-12-03,503,mixer,1349,3249,1900,1,00173,India
277754,2023-12-03,505,oven,18490,24000,5510,1,00173,India
277754,2023-12-03,506,monitor,3249,8000,4751,1,00173,India
120641,2023-12-03,505,oven,18490,24000,5510,1,00047,India
120641,2023-12-03,506,monitor,3249,8000,4751,1,00047,India
120641,2023-12-03,501,iphone 15,60000,80000,20000,1,00047,India
120641,2023-12-03,507,washing machine,6990,16490,9500,1,00047,India
313537,2023-12-03,507,washing machine,6990,16490,9500,1,00173,India
313537,2023-12-03,501,iphone 15,60000,80000,20000,1,00173,India
313537,2023-12-03,506,monitor,3249,8000,4751,1,00173,India
662689,2023-12-03,506,monitor,3249,8000,4751,1,00278,India
662689,2023-12-03,505,oven,18490,24000,5510,1,00278,India
662689,2023-12-03,502,iphone 15 pro max,100000,135000,35000,1,00278,India
951476,2023-12-03,504,iron,449,879,430,1,00492,India
951476,2023-12-03,507,washing machine,6990,16490,9500,1,00492,India
951476,2023-12-03,502,iphone 15 pro max,100000,135000,35000,1,00492,India
504815,2023-12-03,504,iron,449,879,430,1,00145,India
504815,2023-12-03,506,monitor,3249,8000,4751,1,00145,India
504815,2023-12-03,505,oven,18490,24000,5510,1,00145,India
504815,2023-12-03,501,iphone 15,60000,80000,20000,1,00145,India
279902,2023-12-03,501,iphone 15,60000,80000,20000,1,00491,India
279902,2023-12-03,505,oven,18490,24000,5510,1,00491,India
539716,2023-12-03,504,iron,449,879,430,1,00192,India
539716,2023-12-03,507,washing machine,6990,16490,9500,1,00192,India
539716,2023-12-03,502,iphone 15 pro max,100000,135000,35000,1,00192,India
539716,2023-12-03,503,mixer,1349,3249,1900,1,00192,India
869532,2023-12-03,507,washing machine,6990,16490,9500,1,00133,India
869532,2023-12-03,506,monitor,3249,8000,4751,1,00133,India
166289,2023-12-03,505,oven,18490,24000,5510,1,00449,India
532041,2023-12-03,502,iphone 15 pro max,100000,135000,35000,1,00115,India
532041,2023-12-03,507,washing machine,6990,16490,9500,1,00115,India
532041,2023-12-03,504,iron,449,879,430,1,00115,India
749813,2023-12-03,502,iphone 15 pro max,100000,135000,35000,1,00409,India
749813,2023-12-03,505,oven,18490,24000,5510,1,00409,India
749813,2023-12-03,503,mixer,1349,3249,1900,1,00409,India
358088,2023-12-03,504,iron,449,879,430,1,00168,India
358088,2023-12-03,501,iphone 15,60000,80000,20000,1,00168,India
503907,2023-12-03,503,mixer,1349,3249,1900,1,00008,India
503907,2023-12-03,506,monitor,3249,8000,4751,1,00008,India
503907,2023-12-03,505,oven,18490,24000,5510,1,00008,India
503907,2023-12-03,507,washing machine,6990,16490,9500,1,00008,India
913111,2023-12-03,502,iphone 15 pro max,100000,135000,35000,1,00340,India
913111,2023-12-03,506,monitor,3249,8000,4751,1,00340,India
913111,2023-12-03,504,iron,449,879,430,1,00340,India
913111,2023-12-03,507,washing machine,6990,16490,9500,1,00340,India
936292,2023-12-03,503,mixer,1349,3249,1900,1,00483,India
936292,2023-12-03,507,washing machine,6990,16490,9500,1,00483,India
936292,2023-12-03,506,monitor,3249,8000,4751,1,00483,India
912780,2023-12-03,506,monitor,3249,8000,4751,1,00115,India
912780,2023-12-03,505,oven,18490,24000,5510,1,00115,India
649496,2023-12-03,504,iron,449,879,430,1,00480,India
786230,2023-12-03,504,iron,449,879,430,1,00057,India
786230,2023-12-03,502,iphone 15 pro max,100000,135000,35000,1,00057,India
786230,2023-12-03,501,iphone 15,60000,80000,20000,1,00057,India
786230,2023-12-03,505,oven,18490,24000,5510,1,00057,India
251157,2023-12-03,503,mixer,1349,3249,1900,1,00154,India
251157,2023-12-03,505,oven,18490,24000,5510,1,00154,India
251157,2023-12-03,501,iphone 15,60000,80000,20000,1,00154,India
251157,2023-12-03,507,washing machine,6990,16490,9500,1,00154,India
844892,2023-12-03,507,washing machine,6990,16490,9500,1,00214,India
549211,2023-12-03,504,iron,449,879,430,1,00485,India
549211,2023-12-03,507,washing machine,6990,16490,9500,1,00485,India
139622,2023-12-03,501,iphone 15,60000,80000,20000,1,00140,India
139622,2023-12-03,504,iron,449,879,430,1,00140,India
139622,2023-12-03,503,mixer,1349,3249,1900,1,00140,India
803120,2023-12-03,504,iron,449,879,430,1,00362,India
803120,2023-12-03,502,iphone 15 pro max,100000,135000,35000,1,00362,India
592185,2023-12-03,503,mixer,1349,3249,1900,1,00486,India
843112,2023-12-03,505,oven,18490,24000,5510,1,00117,India
180752,2023-12-03,507,washing machine,6990,16490,9500,1,00089,India
555970,2023-12-03,502,iphone 15 pro max,100000,135000,35000,1,00170,India
555970,2023-12-03,505,oven,18490,24000,5510,1,00170,India
776025,2023-12-03,505,oven,18490,24000,5510,1,00054,India
776025,2023-12-03,507,washing machine,6990,16490,9500,1,00054,India
776025,2023-12-03,502,iphone 15 pro max,100000,135000,35000,1,00054,India
664102,2023-12-03,503,mixer,1349,3249,1900,1,00044,India
664102,2023-12-03,502,iphone 15 pro max,100000,135000,35000,1,00044,India
664102,2023-12-03,501,iphone 15,60000,80000,20000,1,00044,India
524491,2023-12-03,501,iphone 15,60000,80000,20000,1,00087,India
972532,2023-12-03,504,iron,449,879,430,1,00046,India
855417,2023-12-03,506,monitor,3249,8000,4751,1,00154,India
855417,2023-12-03,502,iphone 15 pro max,100000,135000,35000,1,00154,India
855417,2023-12-03,503,mixer,1349,3249,1900,1,00154,India
477768,2023-12-03,503,mixer,1349,3249,1900,1,00444,India
477768,2023-12-03,507,washing machine,6990,16490,9500,1,00444,India
477768,2023-12-03,501,iphone 15,60000,80000,20000,1,00444,India
863823,2023-12-03,501,iphone 15,60000,80000,20000,1,00303,India
863823,2023-12-03,504,iron,449,879,430,1,00303,India
719170,2023-12-03,505,oven,18490,24000,5510,1,00337,India
978654,2023-12-03,504,iron,449,879,430,1,00156,India
978654,2023-12-03,506,monitor,3249,8000,4751,1,00156,India
692199,2023-12-03,504,iron,449,879,430,1,00028,India
692199,2023-12-03,502,iphone 15 pro max,100000,135000,35000,1,00028,India
139035,2023-12-03,506,monitor,3249,8000,4751,1,00355,India
139035,2023-12-03,503,mixer,1349,3249,1900,1,00355,India
412813,2023-12-03,507,washing machine,6990,16490,9500,1,00003,India
383958,2023-12-03,506,monitor,3249,8000,4751,1,00298,India
383958,2023-12-03,501,iphone 15,60000,80000,20000,1,00298,India
383958,2023-12-03,504,iron,449,879,430,1,00298,India
861433,2023-12-03,502,iphone 15 pro max,100000,135000,35000,1,00348,India
861433,2023-12-03,507,washing machine,6990,16490,9500,1,00348,India
861433,2023-12-03,504,iron,449,879,430,1,00348,India
861433,2023-12-03,503,mixer,1349,3249,1900,1,00348,India
861433,2023-12-03,501,iphone 15,60000,80000,20000,1,00348,India
663367,2023-12-03,506,monitor,3249,8000,4751,1,00294,India
197735,2023-12-03,503,mixer,1349,3249,1900,1,00208,India
840310,2023-12-03,505,oven,18490,24000,5510,1,00446,India
840310,2023-12-03,507,washing machine,6990,16490,9500,1,00446,India
695549,2023-12-03,506,monitor,3249,8000,4751,1,00153,India
695549,2023-12-03,507,washing machine,6990,16490,9500,1,00153,India
551486,2023-12-03,504,iron,449,879,430,1,00479,India
551486,2023-12-03,506,monitor,3249,8000,4751,1,00479,India
551486,2023-12-03,503,mixer,1349,3249,1900,1,00479,India
509542,2023-12-03,507,washing machine,6990,16490,9500,1,00400,India
509542,2023-12-03,505,oven,18490,24000,5510,1,00400,India
512037,2023-12-03,501,iphone 15,60000,80000,20000,1,00420,India
512037,2023-12-03,505,oven,18490,24000,5510,1,00420,India
512037,2023-12-03,506,monitor,3249,8000,4751,1,00420,India
669383,2023-12-04,506,monitor,3249,8000,4751,1,00028,India
669383,2023-12-04,507,washing machine,6990,16490,9500,1,00028,India
658889,2023-12-04,506,monitor,3249,8000,4751,1,00129,India
696758,2023-12-04,504,iron,449,879,430,1,00227,India
696758,2023-12-04,502,iphone 15 pro max,100000,135000,35000,1,00227,India
696758,2023-12-04,506,monitor,3249,8000,4751,1,00227,India
696758,2023-12-04,501,iphone 15,60000,80000,20000,1,00227,India
327634,2023-12-04,504,iron,449,879,430,1,00397,India
327634,2023-12-04,505,oven,18490,24000,5510,1,00397,India
327634,2023-12-04,506,monitor,3249,8000,4751,1,00397,India
327634,2023-12-04,501,iphone 15,60000,80000,20000,1,00397,India
765763,2023-12-04,501,iphone 15,60000,80000,20000,1,00099,India
765763,2023-12-04,507,washing machine,6990,16490,9500,1,00099,India
208151,2023-12-04,506,monitor,3249,8000,4751,1,00026,India
321017,2023-12-04,502,iphone 15 pro max,100000,135000,35000,1,00171,India
693395,2023-12-04,506,monitor,3249,8000,4751,1,00377,India
693395,2023-12-04,503,mixer,1349,3249,1900,1,00377,India
146571,2023-12-04,507,washing machine,6990,16490,9500,1,00405,India
146571,2023-12-04,504,iron,449,879,430,1,00405,India
146571,2023-12-04,505,oven,18490,24000,5510,1,00405,India
216116,2023-12-04,504,iron,449,879,430,1,00229,India
216116,2023-12-04,507,washing machine,6990,16490,9500,1,00229,India
216116,2023-12-04,505,oven,18490,24000,5510,1,00229,India
216116,2023-12-04,506,monitor,3249,8000,4751,1,00229,India
965224,2023-12-04,502,iphone 15 pro max,100000,135000,35000,1,00481,India
965224,2023-12-04,503,mixer,1349,3249,1900,1,00481,India
965224,2023-12-04,507,washing machine,6990,16490,9500,1,00481,India
965224,2023-12-04,504,iron,449,879,430,1,00481,India
784363,2023-12-04,502,iphone 15 pro max,100000,135000,35000,1,00467,India
784363,2023-12-04,505,oven,18490,24000,5510,1,00467,India
529194,2023-12-04,503,mixer,1349,3249,1900,1,00235,India
529194,2023-12-04,501,iphone 15,60000,80000,20000,1,00235,India
529194,2023-12-04,506,monitor,3249,8000,4751,1,00235,India
529194,2023-12-04,504,iron,449,879,430,1,00235,India
759332,2023-12-04,501,iphone 15,60000,80000,20000,1,00358,India
831379,2023-12-04,504,iron,449,879,430,1,00033,India
831379,2023-12-04,505,oven,18490,24000,5510,1,00033,India
831379,2023-12-04,506,monitor,3249,8000,4751,1,00033,India
265817,2023-12-04,501,iphone 15,60000,80000,20000,1,00257,India
824294,2023-12-04,503,mixer,1349,3249,1900,1,00262,India
824294,2023-12-04,504,iron,449,879,430,1,00262,India
824294,2023-12-04,507,washing machine,6990,16490,9500,1,00262,India
883582,2023-12-04,505,oven,18490,24000,5510,1,00047,India
883582,2023-12-04,504,iron,449,879,430,1,00047,India
464713,2023-12-04,503,mixer,1349,3249,1900,1,00485,India
464713,2023-12-04,501,iphone 15,60000,80000,20000,1,00485,India
464713,2023-12-04,507,washing machine,6990,16490,9500,1,00485,India
840256,2023-12-04,501,iphone 15,60000,80000,20000,1,00437,India
840256,2023-12-04,504,iron,449,879,430,1,00437,India
972548,2023-12-04,501,iphone 15,60000,80000,20000,1,00212,India
972548,2023-12-04,507,washing machine,6990,16490,9500,1,00212,India
972548,2023-12-04,505,oven,18490,24000,5510,1,00212,India
110305,2023-12-04,506,monitor,3249,8000,4751,1,00152,India
110305,2023-12-04,501,iphone 15,60000,80000,20000,1,00152,India
344501,2023-12-04,504,iron,449,879,430,1,00133,India
344501,2023-12-04,501,iphone 15,60000,80000,20000,1,00133,India
344501,2023-12-04,506,monitor,3249,8000,4751,1,00133,India
344501,2023-12-04,507,washing machine,6990,16490,9500,1,00133,India
922596,2023-12-04,507,washing machine,6990,16490,9500,1,00250,India
922596,2023-12-04,502,iphone 15 pro max,100000,135000,35000,1,00250,India
395774,2023-12-04,502,iphone 15 pro max,100000,135000,35000,1,00283,India
395774,2023-12-04,503,mixer,1349,3249,1900,1,00283,India
395774,2023-12-04,501,iphone 15,60000,80000,20000,1,00283,India
395774,2023-12-04,505,oven,18490,24000,5510,1,00283,India
263234,2023-12-04,505,oven,18490,24000,5510,1,00189,India
263234,2023-12-04,507,washing machine,6990,16490,9500,1,00189,India
263234,2023-12-04,501,iphone 15,60000,80000,20000,1,00189,India
304925,2023-12-04,502,iphone 15 pro max,100000,135000,35000,1,00318,India
304925,2023-12-04,506,monitor,3249,8000,4751,1,00318,India
805107,2023-12-04,501,iphone 15,60000,80000,20000,1,00079,India
805107,2023-12-04,505,oven,18490,24000,5510,1,00079,India
192901,2023-12-04,505,oven,18490,24000,5510,1,00066,India
192901,2023-12-04,504,iron,449,879,430,1,00066,India
164356,2023-12-04,507,washing machine,6990,16490,9500,1,00491,India
164356,2023-12-04,506,monitor,3249,8000,4751,1,00491,India
824533,2023-12-04,505,oven,18490,24000,5510,1,00389,India
824533,2023-12-04,503,mixer,1349,3249,1900,1,00389,India
824533,2023-12-04,507,washing machine,6990,16490,9500,1,00389,India
824533,2023-12-04,501,iphone 15,60000,80000,20000,1,00389,India
607967,2023-12-04,506,monitor,3249,8000,4751,1,00185,India
607967,2023-12-04,501,iphone 15,60000,80000,20000,1,00185,India
607967,2023-12-04,502,iphone 15 pro max,100000,135000,35000,1,00185,India
897417,2023-12-04,507,washing machine,6990,16490,9500,1,00299,India
897417,2023-12-04,502,iphone 15 pro max,100000,135000,35000,1,00299,India
897417,2023-12-04,501,iphone 15,60000,80000,20000,1,00299,India
897417,2023-12-04,505,oven,18490,24000,5510,1,00299,India
897417,2023-12-04,504,iron,449,879,430,1,00299,India
745455,2023-12-04,507,washing machine,6990,16490,9500,1,00324,India
745455,2023-12-04,505,oven,18490,24000,5510,1,00324,India
745455,2023-12-04,506,monitor,3249,8000,4751,1,00324,India
745455,2023-12-04,504,iron,449,879,430,1,00324,India
745455,2023-12-04,502,iphone 15 pro max,100000,135000,35000,1,00324,India
955679,2023-12-04,505,oven,18490,24000,5510,1,00437,India
955679,2023-12-04,502,iphone 15 pro max,100000,135000,35000,1,00437,India
361831,2023-12-04,501,iphone 15,60000,80000,20000,1,00050,India
361831,2023-12-04,503,mixer,1349,3249,1900,1,00050,India
361831,2023-12-04,507,washing machine,6990,16490,9500,1,00050,India
669131,2023-12-04,505,oven,18490,24000,5510,1,00175,India
669131,2023-12-04,506,monitor,3249,8000,4751,1,00175,India
669131,2023-12-04,503,mixer,1349,3249,1900,1,00175,India
279043,2023-12-04,507,washing machine,6990,16490,9500,1,00181,India
279043,2023-12-04,506,monitor,3249,8000,4751,1,00181,India
417879,2023-12-04,502,iphone 15 pro max,100000,135000,35000,1,00290,India
417879,2023-12-04,507,washing machine,6990,16490,9500,1,00290,India
417879,2023-12-04,503,mixer,1349,3249,1900,1,00290,India
359698,2023-12-04,503,mixer,1349,3249,1900,1,00325,India
359698,2023-12-04,506,monitor,3249,8000,4751,1,00325,India
359698,2023-12-04,501,iphone 15,60000,80000,20000,1,00325,India
185193,2023-12-04,504,iron,449,879,430,1,00064,India
185193,2023-12-04,501,iphone 15,60000,80000,20000,1,00064,India
119401,2023-12-04,505,oven,18490,24000,5510,1,00290,India
119401,2023-12-04,504,iron,449,879,430,1,00290,India
119401,2023-12-04,501,iphone 15,60000,80000,20000,1,00290,India
748727,2023-12-04,502,iphone 15 pro max,100000,135000,35000,1,00452,India
748727,2023-12-04,507,washing machine,6990,16490,9500,1,00452,India
748727,2023-12-04,503,mixer,1349,3249,1900,1,00452,India
486508,2023-12-04,502,iphone 15 pro max,100000,135000,35000,1,00191,India
486508,2023-12-04,505,oven,18490,24000,5510,1,00191,India
815784,2023-12-04,505,oven,18490,24000,5510,1,00121,India
815784,2023-12-04,502,iphone 15 pro max,100000,135000,35000,1,00121,India
815784,2023-12-04,507,washing machine,6990,16490,9500,1,00121,India
859869,2023-12-04,507,washing machine,6990,16490,9500,1,00412,India
859869,2023-12-04,503,mixer,1349,3249,1900,1,00412,India
947853,2023-12-04,504,iron,449,879,430,1,00146,India
947853,2023-12-04,505,oven,18490,24000,5510,1,00146,India
947853,2023-12-04,502,iphone 15 pro max,100000,135000,35000,1,00146,India
947853,2023-12-04,503,mixer,1349,3249,1900,1,00146,India
714945,2023-12-04,506,monitor,3249,8000,4751,1,00087,India
714945,2023-12-04,502,iphone 15 pro max,100000,135000,35000,1,00087,India
362007,2023-12-04,507,washing machine,6990,16490,9500,1,00345,India
362007,2023-12-04,504,iron,449,879,430,1,00345,India
163987,2023-12-04,506,monitor,3249,8000,4751,1,00056,India
163987,2023-12-04,502,iphone 15 pro max,100000,135000,35000,1,00056,India
163987,2023-12-04,503,mixer,1349,3249,1900,1,00056,India
163987,2023-12-04,505,oven,18490,24000,5510,1,00056,India
163213,2023-12-05,502,iphone 15 pro max,100000,135000,35000,1,00127,India
192401,2023-12-05,507,washing machine,6990,16490,9500,1,00262,India
192401,2023-12-05,506,monitor,3249,8000,4751,1,00262,India
226558,2023-12-05,507,washing machine,6990,16490,9500,1,00275,India
226558,2023-12-05,503,mixer,1349,3249,1900,1,00275,India
226558,2023-12-05,506,monitor,3249,8000,4751,1,00275,India
905328,2023-12-05,503,mixer,1349,3249,1900,1,00437,India
905328,2023-12-05,505,oven,18490,24000,5510,1,00437,India
905328,2023-12-05,504,iron,449,879,430,1,00437,India
322769,2023-12-05,501,iphone 15,60000,80000,20000,1,00203,India
322769,2023-12-05,503,mixer,1349,3249,1900,1,00203,India
322769,2023-12-05,504,iron,449,879,430,1,00203,India
415351,2023-12-05,505,oven,18490,24000,5510,1,00030,India
415351,2023-12-05,501,iphone 15,60000,80000,20000,1,00030,India
415351,2023-12-05,506,monitor,3249,8000,4751,1,00030,India
195386,2023-12-05,503,mixer,1349,3249,1900,1,00322,India
195386,2023-12-05,504,iron,449,879,430,1,00322,India
195386,2023-12-05,502,iphone 15 pro max,100000,135000,35000,1,00322,India
195386,2023-12-05,505,oven,18490,24000,5510,1,00322,India
799738,2023-12-05,504,iron,449,879,430,1,00026,India
799738,2023-12-05,506,monitor,3249,8000,4751,1,00026,India
799738,2023-12-05,502,iphone 15 pro max,100000,135000,35000,1,00026,India
620475,2023-12-05,504,iron,449,879,430,1,00047,India
844525,2023-12-05,505,oven,18490,24000,5510,1,00090,India
648026,2023-12-05,504,iron,449,879,430,1,00361,India
648026,2023-12-05,506,monitor,3249,8000,4751,1,00361,India
525733,2023-12-05,505,oven,18490,24000,5510,1,00284,India
525733,2023-12-05,504,iron,449,879,430,1,00284,India
636559,2023-12-05,507,washing machine,6990,16490,9500,1,00189,India
636559,2023-12-05,501,iphone 15,60000,80000,20000,1,00189,India
636559,2023-12-05,503,mixer,1349,3249,1900,1,00189,India
636559,2023-12-05,502,iphone 15 pro max,100000,135000,35000,1,00189,India
590780,2023-12-05,502,iphone 15 pro max,100000,135000,35000,1,00287,India
590780,2023-12-05,507,washing machine,6990,16490,9500,1,00287,India
590780,2023-12-05,501,iphone 15,60000,80000,20000,1,00287,India
692153,2023-12-05,506,monitor,3249,8000,4751,1,00281,India
692153,2023-12-05,502,iphone 15 pro max,100000,135000,35000,1,00281,India
692153,2023-12-05,507,washing machine,6990,16490,9500,1,00281,India
528833,2023-12-05,507,washing machine,6990,16490,9500,1,00419,India
112012,2023-12-05,507,washing machine,6990,16490,9500,1,00322,India
112012,2023-12-05,506,monitor,3249,8000,4751,1,00322,India
723798,2023-12-05,503,mixer,1349,3249,1900,1,00363,India
723798,2023-12-05,506,monitor,3249,8000,4751,1,00363,India
723798,2023-12-05,504,iron,449,879,430,1,00363,India
825967,2023-12-05,501,iphone 15,60000,80000,20000,1,00271,India
704681,2023-12-05,507,washing machine,6990,16490,9500,1,00178,India
704681,2023-12-05,504,iron,449,879,430,1,00178,India
704681,2023-12-05,506,monitor,3249,8000,4751,1,00178,India
183324,2023-12-05,503,mixer,1349,3249,1900,1,00134,India
944830,2023-12-05,502,iphone 15 pro max,100000,135000,35000,1,00031,India
944830,2023-12-05,506,monitor,3249,8000,4751,1,00031,India
978212,2023-12-05,505,oven,18490,24000,5510,1,00368,India
643220,2023-12-05,506,monitor,3249,8000,4751,1,00044,India
643220,2023-12-05,505,oven,18490,24000,5510,1,00044,India
708106,2023-12-05,505,oven,18490,24000,5510,1,00433,India
708106,2023-12-05,502,iphone 15 pro max,100000,135000,35000,1,00433,India
708106,2023-12-05,504,iron,449,879,430,1,00433,India
462858,2023-12-05,502,iphone 15 pro max,100000,135000,35000,1,00182,India
462858,2023-12-05,501,iphone 15,60000,80000,20000,1,00182,India
102608,2023-12-05,501,iphone 15,60000,80000,20000,1,00415,India
576738,2023-12-05,506,monitor,3249,8000,4751,1,00224,India
576738,2023-12-05,501,iphone 15,60000,80000,20000,1,00224,India
576738,2023-12-05,504,iron,449,879,430,1,00224,India
962121,2023-12-05,502,iphone 15 pro max,100000,135000,35000,1,00089,India
962121,2023-12-05,507,washing machine,6990,16490,9500,1,00089,India
189386,2023-12-05,504,iron,449,879,430,1,00310,India
189386,2023-12-05,501,iphone 15,60000,80000,20000,1,00310,India
210935,2023-12-05,504,iron,449,879,430,1,00053,India
210935,2023-12-05,507,washing machine,6990,16490,9500,1,00053,India
210935,2023-12-05,501,iphone 15,60000,80000,20000,1,00053,India
507487,2023-12-05,502,iphone 15 pro max,100000,135000,35000,1,00244,India
507487,2023-12-05,507,washing machine,6990,16490,9500,1,00244,India
507487,2023-12-05,501,iphone 15,60000,80000,20000,1,00244,India
581318,2023-12-05,504,iron,449,879,430,1,00070,India
581318,2023-12-05,505,oven,18490,24000,5510,1,00070,India
581318,2023-12-05,502,iphone 15 pro max,100000,135000,35000,1,00070,India
294438,2023-12-05,504,iron,449,879,430,1,00311,India
386042,2023-12-05,506,monitor,3249,8000,4751,1,00302,India
386042,2023-12-05,505,oven,18490,24000,5510,1,00302,India
386042,2023-12-05,503,mixer,1349,3249,1900,1,00302,India
771175,2023-12-05,504,iron,449,879,430,1,00035,India
771175,2023-12-05,503,mixer,1349,3249,1900,1,00035,India
771175,2023-12-05,506,monitor,3249,8000,4751,1,00035,India
213623,2023-12-05,501,iphone 15,60000,80000,20000,1,00018,India
213623,2023-12-05,507,washing machine,6990,16490,9500,1,00018,India
213623,2023-12-05,506,monitor,3249,8000,4751,1,00018,India
773566,2023-12-05,504,iron,449,879,430,1,00298,India
773566,2023-12-05,506,monitor,3249,8000,4751,1,00298,India
297046,2023-12-05,504,iron,449,879,430,1,00236,India
952192,2023-12-05,503,mixer,1349,3249,1900,1,00074,India
279371,2023-12-05,501,iphone 15,60000,80000,20000,1,00192,India
279371,2023-12-05,506,monitor,3249,8000,4751,1,00192,India
497338,2023-12-05,502,iphone 15 pro max,100000,135000,35000,1,00345,India
497338,2023-12-05,506,monitor,3249,8000,4751,1,00345,India
497338,2023-12-05,503,mixer,1349,3249,1900,1,00345,India
497338,2023-12-05,501,iphone 15,60000,80000,20000,1,00345,India
441659,2023-12-05,503,mixer,1349,3249,1900,1,00145,India
346886,2023-12-05,501,iphone 15,60000,80000,20000,1,00181,India
346886,2023-12-05,506,monitor,3249,8000,4751,1,00181,India
779585,2023-12-05,504,iron,449,879,430,1,00195,India
779585,2023-12-05,503,mixer,1349,3249,1900,1,00195,India
779585,2023-12-05,505,oven,18490,24000,5510,1,00195,India
779585,2023-12-05,501,iphone 15,60000,80000,20000,1,00195,India
248642,2023-12-05,501,iphone 15,60000,80000,20000,1,00133,India
248642,2023-12-05,505,oven,18490,24000,5510,1,00133,India
248642,2023-12-05,503,mixer,1349,3249,1900,1,00133,India
248642,2023-12-05,506,monitor,3249,8000,4751,1,00133,India
246147,2023-12-05,506,monitor,3249,8000,4751,1,00266,India
246147,2023-12-05,503,mixer,1349,3249,1900,1,00266,India
246147,2023-12-05,507,washing machine,6990,16490,9500,1,00266,India
871131,2023-12-05,503,mixer,1349,3249,1900,1,00247,India
871131,2023-12-05,502,iphone 15 pro max,100000,135000,35000,1,00247,India
871131,2023-12-05,506,monitor,3249,8000,4751,1,00247,India
218949,2023-12-05,501,iphone 15,60000,80000,20000,1,00320,India
218949,2023-12-05,504,iron,449,879,430,1,00320,India
218949,2023-12-05,507,washing machine,6990,16490,9500,1,00320,India
424467,2023-12-05,505,oven,18490,24000,5510,1,00070,India
424467,2023-12-05,503,mixer,1349,3249,1900,1,00070,India
424467,2023-12-05,506,monitor,3249,8000,4751,1,00070,India
725097,2023-12-05,507,washing machine,6990,16490,9500,1,00464,India
725097,2023-12-05,502,iphone 15 pro max,100000,135000,35000,1,00464,India
725097,2023-12-05,504,iron,449,879,430,1,00464,India
583337,2023-12-05,507,washing machine,6990,16490,9500,1,00032,India
583337,2023-12-05,501,iphone 15,60000,80000,20000,1,00032,India
550237,2023-12-05,506,monitor,3249,8000,4751,1,00379,India
550237,2023-12-05,501,iphone 15,60000,80000,20000,1,00379,India
628927,2023-12-05,503,mixer,1349,3249,1900,1,00331,India
777793,2023-12-05,504,iron,449,879,430,1,00205,India
777793,2023-12-05,507,washing machine,6990,16490,9500,1,00205,India
193998,2023-12-05,501,iphone 15,60000,80000,20000,1,00141,India
193998,2023-12-05,507,washing machine,6990,16490,9500,1,00141,India
193998,2023-12-05,503,mixer,1349,3249,1900,1,00141,India
291540,2023-12-05,507,washing machine,6990,16490,9500,1,00281,India
291540,2023-12-05,505,oven,18490,24000,5510,1,00281,India
291540,2023-12-05,501,iphone 15,60000,80000,20000,1,00281,India
785109,2023-12-05,503,mixer,1349,3249,1900,1,00329,India
785109,2023-12-05,502,iphone 15 pro max,100000,135000,35000,1,00329,India
785109,2023-12-05,505,oven,18490,24000,5510,1,00329,India
958853,2023-12-05,507,washing machine,6990,16490,9500,1,00481,India
958853,2023-12-05,506,monitor,3249,8000,4751,1,00481,India
958853,2023-12-05,505,oven,18490,24000,5510,1,00481,India
128825,2023-12-05,506,monitor,3249,8000,4751,1,00027,India
128825,2023-12-05,501,iphone 15,60000,80000,20000,1,00027,India
128825,2023-12-05,505,oven,18490,24000,5510,1,00027,India
607832,2023-12-05,503,mixer,1349,3249,1900,1,00305,India
868833,2023-12-05,507,washing machine,6990,16490,9500,1,00272,India
868833,2023-12-05,501,iphone 15,60000,80000,20000,1,00272,India
868833,2023-12-05,503,mixer,1349,3249,1900,1,00272,India
868833,2023-12-05,506,monitor,3249,8000,4751,1,00272,India
868833,2023-12-05,504,iron,449,879,430,1,00272,India
351091,2023-12-05,503,mixer,1349,3249,1900,1,00213,India
351091,2023-12-05,504,iron,449,879,430,1,00213,India
351091,2023-12-05,501,iphone 15,60000,80000,20000,1,00213,India
351091,2023-12-05,506,monitor,3249,8000,4751,1,00213,India
140143,2023-12-05,502,iphone 15 pro max,100000,135000,35000,1,00283,India
730591,2023-12-05,504,iron,449,879,430,1,00129,India
730591,2023-12-05,501,iphone 15,60000,80000,20000,1,00129,India
730591,2023-12-05,507,washing machine,6990,16490,9500,1,00129,India
778278,2023-12-05,503,mixer,1349,3249,1900,1,00352,India
818836,2023-12-05,504,iron,449,879,430,1,00171,India
818836,2023-12-05,502,iphone 15 pro max,100000,135000,35000,1,00171,India
818836,2023-12-05,507,washing machine,6990,16490,9500,1,00171,India
818836,2023-12-05,505,oven,18490,24000,5510,1,00171,India
687132,2023-12-05,502,iphone 15 pro max,100000,135000,35000,1,00280,India
690950,2023-12-05,502,iphone 15 pro max,100000,135000,35000,1,00308,India
690950,2023-12-05,504,iron,449,879,430,1,00308,India
690950,2023-12-05,506,monitor,3249,8000,4751,1,00308,India
690950,2023-12-05,501,iphone 15,60000,80000,20000,1,00308,India
742768,2023-12-05,506,monitor,3249,8000,4751,1,00495,India
742768,2023-12-05,503,mixer,1349,3249,1900,1,00495,India
742768,2023-12-05,501,iphone 15,60000,80000,20000,1,00495,India
742768,2023-12-05,504,iron,449,879,430,1,00495,India
805666,2023-12-05,503,mixer,1349,3249,1900,1,00087,India
805666,2023-12-05,507,washing machine,6990,16490,9500,1,00087,India
264812,2023-12-05,503,mixer,1349,3249,1900,1,00379,India
264812,2023-12-05,506,monitor,3249,8000,4751,1,00379,India
968127,2023-12-05,501,iphone 15,60000,80000,20000,1,00199,India
968127,2023-12-05,507,washing machine,6990,16490,9500,1,00199,India
369003,2023-12-05,504,iron,449,879,430,1,00277,India
243082,2023-12-05,502,iphone 15 pro max,100000,135000,35000,1,00437,India
243082,2023-12-05,504,iron,449,879,430,1,00437,India
807108,2023-12-05,504,iron,449,879,430,1,00304,India
807108,2023-12-05,505,oven,18490,24000,5510,1,00304,India
807108,2023-12-05,503,mixer,1349,3249,1900,1,00304,India
807108,2023-12-05,502,iphone 15 pro max,100000,135000,35000,1,00304,India
437621,2023-12-05,501,iphone 15,60000,80000,20000,1,00084,India
437621,2023-12-05,502,iphone 15 pro max,100000,135000,35000,1,00084,India
437621,2023-12-05,506,monitor,3249,8000,4751,1,00084,India
437621,2023-12-05,507,washing machine,6990,16490,9500,1,00084,India
437621,2023-12-05,504,iron,449,879,430,1,00084,India
789629,2023-12-05,506,monitor,3249,8000,4751,1,00302,India
495866,2023-12-05,502,iphone 15 pro max,100000,135000,35000,1,00445,India
316882,2023-12-05,506,monitor,3249,8000,4751,1,00412,India
316882,2023-12-05,505,oven,18490,24000,5510,1,00412,India
852517,2023-12-05,503,mixer,1349,3249,1900,1,00152,India
852517,2023-12-05,502,iphone 15 pro max,100000,135000,35000,1,00152,India
852517,2023-12-05,505,oven,18490,24000,5510,1,00152,India
431555,2023-12-06,504,iron,449,879,430,1,00105,India
431555,2023-12-06,501,iphone 15,60000,80000,20000,1,00105,India
402874,2023-12-06,506,monitor,3249,8000,4751,1,00392,India
788932,2023-12-06,503,mixer,1349,3249,1900,1,00212,India
788932,2023-12-06,505,oven,18490,24000,5510,1,00212,India
946661,2023-12-06,507,washing machine,6990,16490,9500,1,00385,India
210866,2023-12-06,505,oven,18490,24000,5510,1,00122,India
210866,2023-12-06,506,monitor,3249,8000,4751,1,00122,India
602483,2023-12-06,501,iphone 15,60000,80000,20000,1,00246,India
602483,2023-12-06,505,oven,18490,24000,5510,1,00246,India
602483,2023-12-06,506,monitor,3249,8000,4751,1,00246,India
141138,2023-12-06,505,oven,18490,24000,5510,1,00258,India
652857,2023-12-06,506,monitor,3249,8000,4751,1,00352,India
652857,2023-12-06,505,oven,18490,24000,5510,1,00352,India
652857,2023-12-06,501,iphone 15,60000,80000,20000,1,00352,India
447765,2023-12-06,501,iphone 15,60000,80000,20000,1,00054,India
447765,2023-12-06,506,monitor,3249,8000,4751,1,00054,India
447765,2023-12-06,504,iron,449,879,430,1,00054,India
447765,2023-12-06,507,washing machine,6990,16490,9500,1,00054,India
819405,2023-12-06,502,iphone 15 pro max,100000,135000,35000,1,00466,India
768383,2023-12-06,505,oven,18490,24000,5510,1,00163,India
768383,2023-12-06,501,iphone 15,60000,80000,20000,1,00163,India
730497,2023-12-06,504,iron,449,879,430,1,00109,India
730497,2023-12-06,502,iphone 15 pro max,100000,135000,35000,1,00109,India
144051,2023-12-06,503,mixer,1349,3249,1900,1,00335,India
144051,2023-12-06,505,oven,18490,24000,5510,1,00335,India
101927,2023-12-06,503,mixer,1349,3249,1900,1,00480,India
101927,2023-12-06,501,iphone 15,60000,80000,20000,1,00480,India
101927,2023-12-06,505,oven,18490,24000,5510,1,00480,India
304872,2023-12-06,504,iron,449,879,430,1,00210,India
304872,2023-12-06,506,monitor,3249,8000,4751,1,00210,India
304872,2023-12-06,501,iphone 15,60000,80000,20000,1,00210,India
629392,2023-12-06,507,washing machine,6990,16490,9500,1,00080,India
629392,2023-12-06,505,oven,18490,24000,5510,1,00080,India
629392,2023-12-06,503,mixer,1349,3249,1900,1,00080,India
375650,2023-12-06,503,mixer,1349,3249,1900,1,00012,India
375650,2023-12-06,507,washing machine,6990,16490,9500,1,00012,India
375650,2023-12-06,505,oven,18490,24000,5510,1,00012,India
375650,2023-12-06,502,iphone 15 pro max,100000,135000,35000,1,00012,India
375650,2023-12-06,506,monitor,3249,8000,4751,1,00012,India
394616,2023-12-06,501,iphone 15,60000,80000,20000,1,00270,India
551117,2023-12-06,504,iron,449,879,430,1,00049,India
551117,2023-12-06,507,washing machine,6990,16490,9500,1,00049,India
551117,2023-12-06,502,iphone 15 pro max,100000,135000,35000,1,00049,India
566695,2023-12-06,502,iphone 15 pro max,100000,135000,35000,1,00311,India
566695,2023-12-06,506,monitor,3249,8000,4751,1,00311,India
260258,2023-12-06,507,washing machine,6990,16490,9500,1,00076,India
260258,2023-12-06,501,iphone 15,60000,80000,20000,1,00076,India
260258,2023-12-06,503,mixer,1349,3249,1900,1,00076,India
564197,2023-12-06,505,oven,18490,24000,5510,1,00491,India
564197,2023-12-06,504,iron,449,879,430,1,00491,India
617550,2023-12-06,506,monitor,3249,8000,4751,1,00168,India
617550,2023-12-06,504,iron,449,879,430,1,00168,India
327883,2023-12-06,506,monitor,3249,8000,4751,1,00325,India
218358,2023-12-06,501,iphone 15,60000,80000,20000,1,00256,India
218358,2023-12-06,503,mixer,1349,3249,1900,1,00256,India
218358,2023-12-06,505,oven,18490,24000,5510,1,00256,India
218358,2023-12-06,507,washing machine,6990,16490,9500,1,00256,India
250023,2023-12-06,504,iron,449,879,430,1,00401,India
250023,2023-12-06,502,iphone 15 pro max,100000,135000,35000,1,00401,India
250023,2023-12-06,505,oven,18490,24000,5510,1,00401,India
324902,2023-12-06,506,monitor,3249,8000,4751,1,00326,India
910623,2023-12-06,506,monitor,3249,8000,4751,1,00296,India
910623,2023-12-06,503,mixer,1349,3249,1900,1,00296,India
737657,2023-12-06,507,washing machine,6990,16490,9500,1,00381,India
737657,2023-12-06,506,monitor,3249,8000,4751,1,00381,India
737657,2023-12-06,504,iron,449,879,430,1,00381,India
798712,2023-12-06,501,iphone 15,60000,80000,20000,1,00301,India
798712,2023-12-06,506,monitor,3249,8000,4751,1,00301,India
798712,2023-12-06,507,washing machine,6990,16490,9500,1,00301,India
967417,2023-12-06,507,washing machine,6990,16490,9500,1,00248,India
967417,2023-12-06,503,mixer,1349,3249,1900,1,00248,India
967417,2023-12-06,505,oven,18490,24000,5510,1,00248,India
967417,2023-12-06,502,iphone 15 pro max,100000,135000,35000,1,00248,India
705632,2023-12-06,501,iphone 15,60000,80000,20000,1,00101,India
944059,2023-12-06,503,mixer,1349,3249,1900,1,00065,India
825538,2023-12-06,501,iphone 15,60000,80000,20000,1,00207,India
825538,2023-12-06,502,iphone 15 pro max,100000,135000,35000,1,00207,India
825538,2023-12-06,503,mixer,1349,3249,1900,1,00207,India
991419,2023-12-06,507,washing machine,6990,16490,9500,1,00377,India
991419,2023-12-06,505,oven,18490,24000,5510,1,00377,India
208695,2023-12-06,504,iron,449,879,430,1,00031,India
208695,2023-12-06,501,iphone 15,60000,80000,20000,1,00031,India
208695,2023-12-06,506,monitor,3249,8000,4751,1,00031,India
777910,2023-12-06,504,iron,449,879,430,1,00272,India
784065,2023-12-06,503,mixer,1349,3249,1900,1,00454,India
784065,2023-12-06,501,iphone 15,60000,80000,20000,1,00454,India
574162,2023-12-06,504,iron,449,879,430,1,00108,India
574162,2023-12-06,506,monitor,3249,8000,4751,1,00108,India
574162,2023-12-06,507,washing machine,6990,16490,9500,1,00108,India
480788,2023-12-06,505,oven,18490,24000,5510,1,00306,India
975063,2023-12-06,501,iphone 15,60000,80000,20000,1,00402,India
724649,2023-12-06,502,iphone 15 pro max,100000,135000,35000,1,00461,India
724649,2023-12-06,505,oven,18490,24000,5510,1,00461,India
645935,2023-12-06,507,washing machine,6990,16490,9500,1,00201,India
645935,2023-12-06,503,mixer,1349,3249,1900,1,00201,India
645935,2023-12-06,506,monitor,3249,8000,4751,1,00201,India
980838,2023-12-06,501,iphone 15,60000,80000,20000,1,00055,India
698135,2023-12-06,506,monitor,3249,8000,4751,1,00224,India
456201,2023-12-06,504,iron,449,879,430,1,00224,India
520141,2023-12-06,504,iron,449,879,430,1,00482,India
520141,2023-12-06,502,iphone 15 pro max,100000,135000,35000,1,00482,India
698050,2023-12-06,504,iron,449,879,430,1,00199,India
698050,2023-12-06,502,iphone 15 pro max,100000,135000,35000,1,00199,India
698050,2023-12-06,505,oven,18490,24000,5510,1,00199,India
698050,2023-12-06,503,mixer,1349,3249,1900,1,00199,India
390463,2023-12-06,502,iphone 15 pro max,100000,135000,35000,1,00313,India
390463,2023-12-06,504,iron,449,879,430,1,00313,India
390463,2023-12-06,501,iphone 15,60000,80000,20000,1,00313,India
442435,2023-12-06,502,iphone 15 pro max,100000,135000,35000,1,00166,India
442435,2023-12-06,506,monitor,3249,8000,4751,1,00166,India
442435,2023-12-06,504,iron,449,879,430,1,00166,India
951114,2023-12-06,503,mixer,1349,3249,1900,1,00024,India
951114,2023-12-06,505,oven,18490,24000,5510,1,00024,India
951114,2023-12-06,501,iphone 15,60000,80000,20000,1,00024,India
620082,2023-12-06,504,iron,449,879,430,1,00300,India
620082,2023-12-06,505,oven,18490,24000,5510,1,00300,India
979955,2023-12-06,504,iron,449,879,430,1,00442,India
979955,2023-12-06,506,monitor,3249,8000,4751,1,00442,India
979955,2023-12-06,503,mixer,1349,3249,1900,1,00442,India
666863,2023-12-06,504,iron,449,879,430,1,00160,India
666863,2023-12-06,505,oven,18490,24000,5510,1,00160,India
666863,2023-12-06,502,iphone 15 pro max,100000,135000,35000,1,00160,India
666863,2023-12-06,506,monitor,3249,8000,4751,1,00160,India
611926,2023-12-06,506,monitor,3249,8000,4751,1,00061,India
611926,2023-12-06,505,oven,18490,24000,5510,1,00061,India
611926,2023-12-06,501,iphone 15,60000,80000,20000,1,00061,India
611926,2023-12-06,507,washing machine,6990,16490,9500,1,00061,India
375474,2023-12-06,501,iphone 15,60000,80000,20000,1,00478,India
375474,2023-12-06,504,iron,449,879,430,1,00478,India
375474,2023-12-06,506,monitor,3249,8000,4751,1,00478,India
375474,2023-12-06,505,oven,18490,24000,5510,1,00478,India
299778,2023-12-06,501,iphone 15,60000,80000,20000,1,00227,India
299778,2023-12-06,506,monitor,3249,8000,4751,1,00227,India
299778,2023-12-06,507,washing machine,6990,16490,9500,1,00227,India
310778,2023-12-06,504,iron,449,879,430,1,00056,India
310778,2023-12-06,503,mixer,1349,3249,1900,1,00056,India
495695,2023-12-06,504,iron,449,879,430,1,00485,India
728332,2023-12-06,501,iphone 15,60000,80000,20000,1,00011,India
728332,2023-12-06,507,washing machine,6990,16490,9500,1,00011,India
728332,2023-12-06,504,iron,449,879,430,1,00011,India
157413,2023-12-06,505,oven,18490,24000,5510,1,00241,India
157413,2023-12-06,502,iphone 15 pro max,100000,135000,35000,1,00241,India
157413,2023-12-06,504,iron,449,879,430,1,00241,India
701116,2023-12-06,503,mixer,1349,3249,1900,1,00318,India
701116,2023-12-06,501,iphone 15,60000,80000,20000,1,00318,India
701116,2023-12-06,504,iron,449,879,430,1,00318,India
176178,2023-12-06,502,iphone 15 pro max,100000,135000,35000,1,00006,India
176178,2023-12-06,503,mixer,1349,3249,1900,1,00006,India
176178,2023-12-06,505,oven,18490,24000,5510,1,00006,India
176178,2023-12-06,504,iron,449,879,430,1,00006,India
122087,2023-12-06,501,iphone 15,60000,80000,20000,1,00425,India
696457,2023-12-06,507,washing machine,6990,16490,9500,1,00175,India
696457,2023-12-06,502,iphone 15 pro max,100000,135000,35000,1,00175,India
696457,2023-12-06,505,oven,18490,24000,5510,1,00175,India
213329,2023-12-06,507,washing machine,6990,16490,9500,1,00063,India
213329,2023-12-06,501,iphone 15,60000,80000,20000,1,00063,India
213329,2023-12-06,506,monitor,3249,8000,4751,1,00063,India
213329,2023-12-06,504,iron,449,879,430,1,00063,India
408416,2023-12-06,501,iphone 15,60000,80000,20000,1,00312,India
496852,2023-12-06,504,iron,449,879,430,1,00408,India
347774,2023-12-06,503,mixer,1349,3249,1900,1,00308,India
172865,2023-12-06,507,washing machine,6990,16490,9500,1,00415,India
172865,2023-12-06,501,iphone 15,60000,80000,20000,1,00415,India
657632,2023-12-06,507,washing machine,6990,16490,9500,1,00165,India
657632,2023-12-06,504,iron,449,879,430,1,00165,India
713806,2023-12-06,502,iphone 15 pro max,100000,135000,35000,1,00500,India
713806,2023-12-06,503,mixer,1349,3249,1900,1,00500,India
759766,2023-12-06,502,iphone 15 pro max,100000,135000,35000,1,00258,India
759766,2023-12-06,507,washing machine,6990,16490,9500,1,00258,India
957769,2023-12-06,501,iphone 15,60000,80000,20000,1,00112,India
957769,2023-12-06,503,mixer,1349,3249,1900,1,00112,India
957769,2023-12-06,504,iron,449,879,430,1,00112,India
957769,2023-12-06,507,washing machine,6990,16490,9500,1,00112,India
849149,2023-12-06,504,iron,449,879,430,1,00163,India
849149,2023-12-06,502,iphone 15 pro max,100000,135000,35000,1,00163,India
849149,2023-12-06,506,monitor,3249,8000,4751,1,00163,India
849149,2023-12-06,507,washing machine,6990,16490,9500,1,00163,India
849149,2023-12-06,503,mixer,1349,3249,1900,1,00163,India
139718,2023-12-06,502,iphone 15 pro max,100000,135000,35000,1,00446,India
647260,2023-12-06,503,mixer,1349,3249,1900,1,00063,India
647260,2023-12-06,507,washing machine,6990,16490,9500,1,00063,India
647260,2023-12-06,506,monitor,3249,8000,4751,1,00063,India
103602,2023-12-06,504,iron,449,879,430,1,00282,India
472296,2023-12-06,501,iphone 15,60000,80000,20000,1,00441,India
472296,2023-12-06,503,mixer,1349,3249,1900,1,00441,India
310487,2023-12-06,503,mixer,1349,3249,1900,1,00226,India
310487,2023-12-06,507,washing machine,6990,16490,9500,1,00226,India
310487,2023-12-06,504,iron,449,879,430,1,00226,India
176572,2023-12-06,504,iron,449,879,430,1,00381,India
914798,2023-12-06,505,oven,18490,24000,5510,1,00180,India
914798,2023-12-06,503,mixer,1349,3249,1900,1,00180,India
378217,2023-12-06,503,mixer,1349,3249,1900,1,00378,India
378217,2023-12-06,502,iphone 15 pro max,100000,135000,35000,1,00378,India
378217,2023-12-06,506,monitor,3249,8000,4751,1,00378,India
294321,2023-12-06,503,mixer,1349,3249,1900,1,00140,India
294321,2023-12-06,501,iphone 15,60000,80000,20000,1,00140,India
155988,2023-12-06,506,monitor,3249,8000,4751,1,00304,India
152731,2023-12-06,505,oven,18490,24000,5510,1,00177,India
152731,2023-12-06,501,iphone 15,60000,80000,20000,1,00177,India
964469,2023-12-07,501,iphone 15,60000,80000,20000,1,00036,India
964469,2023-12-07,502,iphone 15 pro max,100000,135000,35000,1,00036,India
964469,2023-12-07,507,washing machine,6990,16490,9500,1,00036,India
964469,2023-12-07,504,iron,449,879,430,1,00036,India
964469,2023-12-07,505,oven,18490,24000,5510,1,00036,India
991310,2023-12-07,501,iphone 15,60000,80000,20000,1,00360,India
991310,2023-12-07,507,washing machine,6990,16490,9500,1,00360,India
991310,2023-12-07,506,monitor,3249,8000,4751,1,00360,India
356180,2023-12-07,506,monitor,3249,8000,4751,1,00194,India
356180,2023-12-07,504,iron,449,879,430,1,00194,India
356180,2023-12-07,503,mixer,1349,3249,1900,1,00194,India
356180,2023-12-07,501,iphone 15,60000,80000,20000,1,00194,India
373465,2023-12-07,504,iron,449,879,430,1,00201,India
373465,2023-12-07,505,oven,18490,24000,5510,1,00201,India
373465,2023-12-07,502,iphone 15 pro max,100000,135000,35000,1,00201,India
802363,2023-12-07,507,washing machine,6990,16490,9500,1,00346,India
774276,2023-12-07,501,iphone 15,60000,80000,20000,1,00171,India
774276,2023-12-07,503,mixer,1349,3249,1900,1,00171,India
774276,2023-12-07,504,iron,449,879,430,1,00171,India
252144,2023-12-07,502,iphone 15 pro max,100000,135000,35000,1,00105,India
986417,2023-12-07,502,iphone 15 pro max,100000,135000,35000,1,00047,India
647884,2023-12-07,507,washing machine,6990,16490,9500,1,00248,India
647884,2023-12-07,505,oven,18490,24000,5510,1,00248,India
647884,2023-12-07,503,mixer,1349,3249,1900,1,00248,India
647884,2023-12-07,502,iphone 15 pro max,100000,135000,35000,1,00248,India
769032,2023-12-07,506,monitor,3249,8000,4751,1,00471,India
288549,2023-12-07,507,washing machine,6990,16490,9500,1,00147,India
408675,2023-12-07,502,iphone 15 pro max,100000,135000,35000,1,00443,India
408675,2023-12-07,507,washing machine,6990,16490,9500,1,00443,India
408675,2023-12-07,501,iphone 15,60000,80000,20000,1,00443,India
408675,2023-12-07,504,iron,449,879,430,1,00443,India
256046,2023-12-07,507,washing machine,6990,16490,9500,1,00244,India
256046,2023-12-07,501,iphone 15,60000,80000,20000,1,00244,India
256046,2023-12-07,504,iron,449,879,430,1,00244,India
995522,2023-12-07,502,iphone 15 pro max,100000,135000,35000,1,00149,India
995522,2023-12-07,503,mixer,1349,3249,1900,1,00149,India
905493,2023-12-07,503,mixer,1349,3249,1900,1,00451,India
905493,2023-12-07,505,oven,18490,24000,5510,1,00451,India
905493,2023-12-07,502,iphone 15 pro max,100000,135000,35000,1,00451,India
563537,2023-12-07,504,iron,449,879,430,1,00124,India
563537,2023-12-07,506,monitor,3249,8000,4751,1,00124,India
563537,2023-12-07,501,iphone 15,60000,80000,20000,1,00124,India
713119,2023-12-07,506,monitor,3249,8000,4751,1,00112,India
713119,2023-12-07,504,iron,449,879,430,1,00112,India
441495,2023-12-07,503,mixer,1349,3249,1900,1,00497,India
441495,2023-12-07,504,iron,449,879,430,1,00497,India
174410,2023-12-07,501,iphone 15,60000,80000,20000,1,00280,India
174410,2023-12-07,505,oven,18490,24000,5510,1,00280,India
174410,2023-12-07,507,washing machine,6990,16490,9500,1,00280,India
174410,2023-12-07,503,mixer,1349,3249,1900,1,00280,India
455103,2023-12-07,505,oven,18490,24000,5510,1,00441,India
963523,2023-12-07,505,oven,18490,24000,5510,1,00378,India
963523,2023-12-07,503,mixer,1349,3249,1900,1,00378,India
963523,2023-12-07,501,iphone 15,60000,80000,20000,1,00378,India
928877,2023-12-07,501,iphone 15,60000,80000,20000,1,00332,India
928877,2023-12-07,505,oven,18490,24000,5510,1,00332,India
928877,2023-12-07,504,iron,449,879,430,1,00332,India
995116,2023-12-07,501,iphone 15,60000,80000,20000,1,00244,India
995116,2023-12-07,503,mixer,1349,3249,1900,1,00244,India
590728,2023-12-07,504,iron,449,879,430,1,00457,India
590728,2023-12-07,505,oven,18490,24000,5510,1,00457,India
590728,2023-12-07,507,washing machine,6990,16490,9500,1,00457,India
716168,2023-12-07,503,mixer,1349,3249,1900,1,00275,India
767517,2023-12-07,506,monitor,3249,8000,4751,1,00305,India
767517,2023-12-07,502,iphone 15 pro max,100000,135000,35000,1,00305,India
676355,2023-12-07,507,washing machine,6990,16490,9500,1,00376,India
676355,2023-12-07,502,iphone 15 pro max,100000,135000,35000,1,00376,India
676355,2023-12-07,505,oven,18490,24000,5510,1,00376,India
965316,2023-12-07,505,oven,18490,24000,5510,1,00268,India
965316,2023-12-07,507,washing machine,6990,16490,9500,1,00268,India
222270,2023-12-07,507,washing machine,6990,16490,9500,1,00176,India
171051,2023-12-07,505,oven,18490,24000,5510,1,00129,India
171051,2023-12-07,506,monitor,3249,8000,4751,1,00129,India
171051,2023-12-07,502,iphone 15 pro max,100000,135000,35000,1,00129,India
904349,2023-12-07,502,iphone 15 pro max,100000,135000,35000,1,00033,India
904349,2023-12-07,503,mixer,1349,3249,1900,1,00033,India
242549,2023-12-07,505,oven,18490,24000,5510,1,00104,India
576866,2023-12-07,502,iphone 15 pro max,100000,135000,35000,1,00091,India
576866,2023-12-07,504,iron,449,879,430,1,00091,India
576866,2023-12-07,501,iphone 15,60000,80000,20000,1,00091,India
576866,2023-12-07,506,monitor,3249,8000,4751,1,00091,India
576866,2023-12-07,503,mixer,1349,3249,1900,1,00091,India
226935,2023-12-07,507,washing machine,6990,16490,9500,1,00406,India
226935,2023-12-07,504,iron,449,879,430,1,00406,India
226935,2023-12-07,506,monitor,3249,8000,4751,1,00406,India
226935,2023-12-07,501,iphone 15,60000,80000,20000,1,00406,India
226935,2023-12-07,503,mixer,1349,3249,1900,1,00406,India
382209,2023-12-07,501,iphone 15,60000,80000,20000,1,00343,India
382209,2023-12-07,503,mixer,1349,3249,1900,1,00343,India
382209,2023-12-07,506,monitor,3249,8000,4751,1,00343,India
382209,2023-12-07,507,washing machine,6990,16490,9500,1,00343,India
253204,2023-12-07,501,iphone 15,60000,80000,20000,1,00385,India
253204,2023-12-07,502,iphone 15 pro max,100000,135000,35000,1,00385,India
253204,2023-12-07,505,oven,18490,24000,5510,1,00385,India
958191,2023-12-07,502,iphone 15 pro max,100000,135000,35000,1,00110,India
958191,2023-12-07,503,mixer,1349,3249,1900,1,00110,India
958191,2023-12-07,501,iphone 15,60000,80000,20000,1,00110,India
741843,2023-12-07,507,washing machine,6990,16490,9500,1,00228,India
741843,2023-12-07,504,iron,449,879,430,1,00228,India
943521,2023-12-07,505,oven,18490,24000,5510,1,00156,India
943521,2023-12-07,507,washing machine,6990,16490,9500,1,00156,India
943521,2023-12-07,506,monitor,3249,8000,4751,1,00156,India
943521,2023-12-07,502,iphone 15 pro max,100000,135000,35000,1,00156,India
771751,2023-12-07,503,mixer,1349,3249,1900,1,00133,India
853835,2023-12-07,502,iphone 15 pro max,100000,135000,35000,1,00197,India
853835,2023-12-07,505,oven,18490,24000,5510,1,00197,India
853835,2023-12-07,501,iphone 15,60000,80000,20000,1,00197,India
114673,2023-12-07,502,iphone 15 pro max,100000,135000,35000,1,00059,India
114673,2023-12-07,504,iron,449,879,430,1,00059,India
114673,2023-12-07,506,monitor,3249,8000,4751,1,00059,India
114673,2023-12-07,501,iphone 15,60000,80000,20000,1,00059,India
848386,2023-12-07,505,oven,18490,24000,5510,1,00080,India
848386,2023-12-07,501,iphone 15,60000,80000,20000,1,00080,India
848386,2023-12-07,502,iphone 15 pro max,100000,135000,35000,1,00080,India
212104,2023-12-07,505,oven,18490,24000,5510,1,00334,India
212104,2023-12-07,503,mixer,1349,3249,1900,1,00334,India
212104,2023-12-07,501,iphone 15,60000,80000,20000,1,00334,India
711520,2023-12-07,506,monitor,3249,8000,4751,1,00189,India
711520,2023-12-07,503,mixer,1349,3249,1900,1,00189,India
711520,2023-12-07,505,oven,18490,24000,5510,1,00189,India
257202,2023-12-07,505,oven,18490,24000,5510,1,00370,India
257202,2023-12-07,507,washing machine,6990,16490,9500,1,00370,India
257202,2023-12-07,503,mixer,1349,3249,1900,1,00370,India
257202,2023-12-07,502,iphone 15 pro max,100000,135000,35000,1,00370,India
257202,2023-12-07,501,iphone 15,60000,80000,20000,1,00370,India
399846,2023-12-07,502,iphone 15 pro max,100000,135000,35000,1,00123,India
399846,2023-12-07,507,washing machine,6990,16490,9500,1,00123,India
399846,2023-12-07,506,monitor,3249,8000,4751,1,00123,India
764524,2023-12-07,505,oven,18490,24000,5510,1,00142,India
764524,2023-12-07,504,iron,449,879,430,1,00142,India
764524,2023-12-07,503,mixer,1349,3249,1900,1,00142,India
417314,2023-12-07,501,iphone 15,60000,80000,20000,1,00020,India
417314,2023-12-07,505,oven,18490,24000,5510,1,00020,India
417314,2023-12-07,503,mixer,1349,3249,1900,1,00020,India
417314,2023-12-07,507,washing machine,6990,16490,9500,1,00020,India
744701,2023-12-07,506,monitor,3249,8000,4751,1,00376,India
603617,2023-12-07,501,iphone 15,60000,80000,20000,1,00012,India
603617,2023-12-07,506,monitor,3249,8000,4751,1,00012,India
450261,2023-12-07,503,mixer,1349,3249,1900,1,00350,India
760054,2023-12-07,504,iron,449,879,430,1,00311,India
760054,2023-12-07,501,iphone 15,60000,80000,20000,1,00311,India
613489,2023-12-07,504,iron,449,879,430,1,00488,India
200374,2023-12-07,503,mixer,1349,3249,1900,1,00142,India
200374,2023-12-07,506,monitor,3249,8000,4751,1,00142,India
200374,2023-12-07,504,iron,449,879,430,1,00142,India
849708,2023-12-07,506,monitor,3249,8000,4751,1,00064,India
849708,2023-12-07,501,iphone 15,60000,80000,20000,1,00064,India
191900,2023-12-07,503,mixer,1349,3249,1900,1,00388,India
191900,2023-12-07,505,oven,18490,24000,5510,1,00388,India
191900,2023-12-07,506,monitor,3249,8000,4751,1,00388,India
779485,2023-12-07,504,iron,449,879,430,1,00372,India
227591,2023-12-07,504,iron,449,879,430,1,00359,India
227591,2023-12-07,506,monitor,3249,8000,4751,1,00359,India
443673,2023-12-07,507,washing machine,6990,16490,9500,1,00129,India
443673,2023-12-07,506,monitor,3249,8000,4751,1,00129,India
443673,2023-12-07,504,iron,449,879,430,1,00129,India
547511,2023-12-07,503,mixer,1349,3249,1900,1,00279,India
547511,2023-12-07,506,monitor,3249,8000,4751,1,00279,India
547511,2023-12-07,501,iphone 15,60000,80000,20000,1,00279,India
837750,2023-12-07,506,monitor,3249,8000,4751,1,00475,India
837750,2023-12-07,507,washing machine,6990,16490,9500,1,00475,India
837750,2023-12-07,505,oven,18490,24000,5510,1,00475,India
243479,2023-12-07,505,oven,18490,24000,5510,1,00306,India
243479,2023-12-07,501,iphone 15,60000,80000,20000,1,00306,India
243479,2023-12-07,503,mixer,1349,3249,1900,1,00306,India
338120,2023-12-07,505,oven,18490,24000,5510,1,00346,India
930758,2023-12-07,506,monitor,3249,8000,4751,1,00369,India
930758,2023-12-07,501,iphone 15,60000,80000,20000,1,00369,India
889102,2023-12-07,502,iphone 15 pro max,100000,135000,35000,1,00450,India
889102,2023-12-07,501,iphone 15,60000,80000,20000,1,00450,India
889102,2023-12-07,505,oven,18490,24000,5510,1,00450,India
889102,2023-12-07,503,mixer,1349,3249,1900,1,00450,India
241765,2023-12-07,503,mixer,1349,3249,1900,1,00130,India
241765,2023-12-07,507,washing machine,6990,16490,9500,1,00130,India
241765,2023-12-07,501,iphone 15,60000,80000,20000,1,00130,India
903518,2023-12-07,502,iphone 15 pro max,100000,135000,35000,1,00185,India
903518,2023-12-07,501,iphone 15,60000,80000,20000,1,00185,India
450732,2023-12-07,501,iphone 15,60000,80000,20000,1,00040,India
450732,2023-12-07,502,iphone 15 pro max,100000,135000,35000,1,00040,India
450732,2023-12-07,506,monitor,3249,8000,4751,1,00040,India
450732,2023-12-07,504,iron,449,879,430,1,00040,India
901628,2023-12-07,507,washing machine,6990,16490,9500,1,00296,India
910591,2023-12-07,504,iron,449,879,430,1,00155,India
617668,2023-12-07,504,iron,449,879,430,1,00024,India
909646,2023-12-07,501,iphone 15,60000,80000,20000,1,00348,India
909646,2023-12-07,503,mixer,1349,3249,1900,1,00348,India
909646,2023-12-07,507,washing machine,6990,16490,9500,1,00348,India
909646,2023-12-07,505,oven,18490,24000,5510,1,00348,India
815851,2023-12-08,504,iron,449,879,430,1,00061,India
815851,2023-12-08,505,oven,18490,24000,5510,1,00061,India
815851,2023-12-08,503,mixer,1349,3249,1900,1,00061,India
762880,2023-12-08,506,monitor,3249,8000,4751,1,00154,India
762880,2023-12-08,505,oven,18490,24000,5510,1,00154,India
624263,2023-12-08,502,iphone 15 pro max,100000,135000,35000,1,00427,India
624263,2023-12-08,504,iron,449,879,430,1,00427,India
161995,2023-12-08,507,washing machine,6990,16490,9500,1,00493,India
437058,2023-12-08,506,monitor,3249,8000,4751,1,00036,India
437058,2023-12-08,503,mixer,1349,3249,1900,1,00036,India
201229,2023-12-08,501,iphone 15,60000,80000,20000,1,00146,India
201229,2023-12-08,504,iron,449,879,430,1,00146,India
201229,2023-12-08,505,oven,18490,24000,5510,1,00146,India
809306,2023-12-08,507,washing machine,6990,16490,9500,1,00340,India
809306,2023-12-08,501,iphone 15,60000,80000,20000,1,00340,India
332082,2023-12-08,505,oven,18490,24000,5510,1,00139,India
332082,2023-12-08,507,washing machine,6990,16490,9500,1,00139,India
332082,2023-12-08,504,iron,449,879,430,1,00139,India
332082,2023-12-08,501,iphone 15,60000,80000,20000,1,00139,India
599533,2023-12-08,502,iphone 15 pro max,100000,135000,35000,1,00096,India
116110,2023-12-08,503,mixer,1349,3249,1900,1,00176,India
116110,2023-12-08,501,iphone 15,60000,80000,20000,1,00176,India
116110,2023-12-08,502,iphone 15 pro max,100000,135000,35000,1,00176,India
654562,2023-12-08,503,mixer,1349,3249,1900,1,00342,India
654562,2023-12-08,501,iphone 15,60000,80000,20000,1,00342,India
318203,2023-12-08,502,iphone 15 pro max,100000,135000,35000,1,00182,India
318203,2023-12-08,503,mixer,1349,3249,1900,1,00182,India
318203,2023-12-08,501,iphone 15,60000,80000,20000,1,00182,India
135349,2023-12-08,506,monitor,3249,8000,4751,1,00242,India
135349,2023-12-08,505,oven,18490,24000,5510,1,00242,India
135349,2023-12-08,501,iphone 15,60000,80000,20000,1,00242,India
525758,2023-12-08,506,monitor,3249,8000,4751,1,00485,India
525758,2023-12-08,503,mixer,1349,3249,1900,1,00485,India
525758,2023-12-08,505,oven,18490,24000,5510,1,00485,India
512104,2023-12-08,504,iron,449,879,430,1,00325,India
512104,2023-12-08,505,oven,18490,24000,5510,1,00325,India
774333,2023-12-08,506,monitor,3249,8000,4751,1,00427,India
774333,2023-12-08,505,oven,18490,24000,5510,1,00427,India
774333,2023-12-08,501,iphone 15,60000,80000,20000,1,00427,India
603749,2023-12-08,501,iphone 15,60000,80000,20000,1,00073,India
603749,2023-12-08,504,iron,449,879,430,1,00073,India
603749,2023-12-08,506,monitor,3249,8000,4751,1,00073,India
393127,2023-12-08,503,mixer,1349,3249,1900,1,00239,India
393127,2023-12-08,505,oven,18490,24000,5510,1,00239,India
393127,2023-12-08,507,washing machine,6990,16490,9500,1,00239,India
393127,2023-12-08,502,iphone 15 pro max,100000,135000,35000,1,00239,India
150443,2023-12-08,503,mixer,1349,3249,1900,1,00350,India
150443,2023-12-08,506,monitor,3249,8000,4751,1,00350,India
756146,2023-12-08,504,iron,449,879,430,1,00087,India
756146,2023-12-08,505,oven,18490,24000,5510,1,00087,India
756146,2023-12-08,506,monitor,3249,8000,4751,1,00087,India
756146,2023-12-08,507,washing machine,6990,16490,9500,1,00087,India
899811,2023-12-08,504,iron,449,879,430,1,00210,India
899811,2023-12-08,505,oven,18490,24000,5510,1,00210,India
899811,2023-12-08,502,iphone 15 pro max,100000,135000,35000,1,00210,India
858741,2023-12-08,503,mixer,1349,3249,1900,1,00430,India
858741,2023-12-08,504,iron,449,879,430,1,00430,India
858741,2023-12-08,506,monitor,3249,8000,4751,1,00430,India
926963,2023-12-08,506,monitor,3249,8000,4751,1,00432,India
261669,2023-12-08,506,monitor,3249,8000,4751,1,00130,India
261669,2023-12-08,501,iphone 15,60000,80000,20000,1,00130,India
482963,2023-12-08,506,monitor,3249,8000,4751,1,00053,India
482963,2023-12-08,504,iron,449,879,430,1,00053,India
482963,2023-12-08,503,mixer,1349,3249,1900,1,00053,India
251814,2023-12-08,507,washing machine,6990,16490,9500,1,00377,India
251814,2023-12-08,501,iphone 15,60000,80000,20000,1,00377,India
251814,2023-12-08,503,mixer,1349,3249,1900,1,00377,India
835148,2023-12-08,506,monitor,3249,8000,4751,1,00282,India
835148,2023-12-08,507,washing machine,6990,16490,9500,1,00282,India
720858,2023-12-08,502,iphone 15 pro max,100000,135000,35000,1,00072,India
720858,2023-12-08,507,washing machine,6990,16490,9500,1,00072,India
720858,2023-12-08,505,oven,18490,24000,5510,1,00072,India
720858,2023-12-08,501,iphone 15,60000,80000,20000,1,00072,India
524520,2023-12-08,502,iphone 15 pro max,100000,135000,35000,1,00337,India
524520,2023-12-08,506,monitor,3249,8000,4751,1,00337,India
524520,2023-12-08,507,washing machine,6990,16490,9500,1,00337,India
288755,2023-12-08,501,iphone 15,60000,80000,20000,1,00433,India
288755,2023-12-08,507,washing machine,6990,16490,9500,1,00433,India
288755,2023-12-08,502,iphone 15 pro max,100000,135000,35000,1,00433,India
172298,2023-12-08,507,washing machine,6990,16490,9500,1,00450,India
172298,2023-12-08,505,oven,18490,24000,5510,1,00450,India
647917,2023-12-08,505,oven,18490,24000,5510,1,00344,India
647917,2023-12-08,506,monitor,3249,8000,4751,1,00344,India
647917,2023-12-08,503,mixer,1349,3249,1900,1,00344,India
647917,2023-12-08,501,iphone 15,60000,80000,20000,1,00344,India
374199,2023-12-08,501,iphone 15,60000,80000,20000,1,00445,India
374199,2023-12-08,502,iphone 15 pro max,100000,135000,35000,1,00445,India
374199,2023-12-08,504,iron,449,879,430,1,00445,India
671459,2023-12-08,506,monitor,3249,8000,4751,1,00439,India
671459,2023-12-08,504,iron,449,879,430,1,00439,India
671459,2023-12-08,505,oven,18490,24000,5510,1,00439,India
425243,2023-12-08,501,iphone 15,60000,80000,20000,1,00497,India
425243,2023-12-08,507,washing machine,6990,16490,9500,1,00497,India
471151,2023-12-08,503,mixer,1349,3249,1900,1,00216,India
471151,2023-12-08,505,oven,18490,24000,5510,1,00216,India
471151,2023-12-08,507,washing machine,6990,16490,9500,1,00216,India
194863,2023-12-08,502,iphone 15 pro max,100000,135000,35000,1,00260,India
194863,2023-12-08,506,monitor,3249,8000,4751,1,00260,India
194863,2023-12-08,505,oven,18490,24000,5510,1,00260,India
194863,2023-12-08,507,washing machine,6990,16490,9500,1,00260,India
872530,2023-12-08,506,monitor,3249,8000,4751,1,00497,India
872530,2023-12-08,507,washing machine,6990,16490,9500,1,00497,India
872530,2023-12-08,502,iphone 15 pro max,100000,135000,35000,1,00497,India
901629,2023-12-08,505,oven,18490,24000,5510,1,00298,India
901629,2023-12-08,501,iphone 15,60000,80000,20000,1,00298,India
901629,2023-12-08,504,iron,449,879,430,1,00298,India
901629,2023-12-08,506,monitor,3249,8000,4751,1,00298,India
536596,2023-12-08,501,iphone 15,60000,80000,20000,1,00092,India
346423,2023-12-08,504,iron,449,879,430,1,00368,India
346423,2023-12-08,502,iphone 15 pro max,100000,135000,35000,1,00368,India
346423,2023-12-08,505,oven,18490,24000,5510,1,00368,India
402328,2023-12-08,501,iphone 15,60000,80000,20000,1,00331,India
402328,2023-12-08,503,mixer,1349,3249,1900,1,00331,India
402328,2023-12-08,505,oven,18490,24000,5510,1,00331,India
507898,2023-12-08,506,monitor,3249,8000,4751,1,00387,India
507898,2023-12-08,501,iphone 15,60000,80000,20000,1,00387,India
507898,2023-12-08,507,washing machine,6990,16490,9500,1,00387,India
494217,2023-12-08,506,monitor,3249,8000,4751,1,00450,India
494217,2023-12-08,503,mixer,1349,3249,1900,1,00450,India
242567,2023-12-08,506,monitor,3249,8000,4751,1,00475,India
267915,2023-12-08,507,washing machine,6990,16490,9500,1,00276,India
267915,2023-12-08,504,iron,449,879,430,1,00276,India
716457,2023-12-08,504,iron,449,879,430,1,00266,India
716457,2023-12-08,503,mixer,1349,3249,1900,1,00266,India
716457,2023-12-08,507,washing machine,6990,16490,9500,1,00266,India
376411,2023-12-08,505,oven,18490,24000,5510,1,00327,India
926313,2023-12-08,501,iphone 15,60000,80000,20000,1,00382,India
926313,2023-12-08,506,monitor,3249,8000,4751,1,00382,India
926313,2023-12-08,503,mixer,1349,3249,1900,1,00382,India
761192,2023-12-08,503,mixer,1349,3249,1900,1,00458,India
269669,2023-12-08,506,monitor,3249,8000,4751,1,00107,India
269669,2023-12-08,504,iron,449,879,430,1,00107,India
976348,2023-12-08,502,iphone 15 pro max,100000,135000,35000,1,00482,India
976348,2023-12-08,505,oven,18490,24000,5510,1,00482,India
976348,2023-12-08,507,washing machine,6990,16490,9500,1,00482,India
906823,2023-12-08,501,iphone 15,60000,80000,20000,1,00191,India
906823,2023-12-08,507,washing machine,6990,16490,9500,1,00191,India
906823,2023-12-08,502,iphone 15 pro max,100000,135000,35000,1,00191,India
906823,2023-12-08,505,oven,18490,24000,5510,1,00191,India
493775,2023-12-08,504,iron,449,879,430,1,00367,India
173355,2023-12-08,503,mixer,1349,3249,1900,1,00065,India
353126,2023-12-08,507,washing machine,6990,16490,9500,1,00075,India
353126,2023-12-08,502,iphone 15 pro max,100000,135000,35000,1,00075,India
272952,2023-12-08,502,iphone 15 pro max,100000,135000,35000,1,00284,India
272952,2023-12-08,504,iron,449,879,430,1,00284,India
272952,2023-12-08,507,washing machine,6990,16490,9500,1,00284,India
272952,2023-12-08,501,iphone 15,60000,80000,20000,1,00284,India
270647,2023-12-08,505,oven,18490,24000,5510,1,00358,India
627276,2023-12-08,501,iphone 15,60000,80000,20000,1,00005,India
986393,2023-12-08,505,oven,18490,24000,5510,1,00283,India
986393,2023-12-08,506,monitor,3249,8000,4751,1,00283,India
317810,2023-12-08,506,monitor,3249,8000,4751,1,00211,India
455451,2023-12-08,506,monitor,3249,8000,4751,1,00122,India
455451,2023-12-08,502,iphone 15 pro max,100000,135000,35000,1,00122,India
455451,2023-12-08,507,washing machine,6990,16490,9500,1,00122,India
267238,2023-12-08,506,monitor,3249,8000,4751,1,00184,India
267238,2023-12-08,503,mixer,1349,3249,1900,1,00184,India
267238,2023-12-08,504,iron,449,879,430,1,00184,India
652662,2023-12-08,505,oven,18490,24000,5510,1,00202,India
652662,2023-12-08,503,mixer,1349,3249,1900,1,00202,India
652662,2023-12-08,506,monitor,3249,8000,4751,1,00202,India
652662,2023-12-08,501,iphone 15,60000,80000,20000,1,00202,India
652662,2023-12-08,504,iron,449,879,430,1,00202,India
390236,2023-12-08,503,mixer,1349,3249,1900,1,00328,India
361789,2023-12-08,506,monitor,3249,8000,4751,1,00077,India
361789,2023-12-08,504,iron,449,879,430,1,00077,India
361789,2023-12-08,507,washing machine,6990,16490,9500,1,00077,India
661316,2023-12-08,502,iphone 15 pro max,100000,135000,35000,1,00442,India
661316,2023-12-08,504,iron,449,879,430,1,00442,India
271341,2023-12-08,507,washing machine,6990,16490,9500,1,00476,India
271341,2023-12-08,503,mixer,1349,3249,1900,1,00476,India
370701,2023-12-08,506,monitor,3249,8000,4751,1,00048,India
370701,2023-12-08,502,iphone 15 pro max,100000,135000,35000,1,00048,India
744198,2023-12-08,507,washing machine,6990,16490,9500,1,00189,India
744198,2023-12-08,502,iphone 15 pro max,100000,135000,35000,1,00189,India
744198,2023-12-08,505,oven,18490,24000,5510,1,00189,India
178060,2023-12-08,502,iphone 15 pro max,100000,135000,35000,1,00497,India
559191,2023-12-08,506,monitor,3249,8000,4751,1,00253,India
559191,2023-12-08,505,oven,18490,24000,5510,1,00253,India
770278,2023-12-08,506,monitor,3249,8000,4751,1,00203,India
770278,2023-12-08,502,iphone 15 pro max,100000,135000,35000,1,00203,India
770278,2023-12-08,505,oven,18490,24000,5510,1,00203,India
770278,2023-12-08,501,iphone 15,60000,80000,20000,1,00203,India
770278,2023-12-08,507,washing machine,6990,16490,9500,1,00203,India
984477,2023-12-08,503,mixer,1349,3249,1900,1,00134,India
152049,2023-12-08,507,washing machine,6990,16490,9500,1,00023,India
191255,2023-12-08,502,iphone 15 pro max,100000,135000,35000,1,00100,India
191255,2023-12-08,507,washing machine,6990,16490,9500,1,00100,India
581650,2023-12-08,506,monitor,3249,8000,4751,1,00128,India
581650,2023-12-08,504,iron,449,879,430,1,00128,India
362037,2023-12-08,504,iron,449,879,430,1,00318,India
535305,2023-12-08,506,monitor,3249,8000,4751,1,00413,India
226773,2023-12-08,507,washing machine,6990,16490,9500,1,00426,India
226773,2023-12-08,505,oven,18490,24000,5510,1,00426,India
226773,2023-12-08,502,iphone 15 pro max,100000,135000,35000,1,00426,India
505842,2023-12-08,505,oven,18490,24000,5510,1,00134,India
505842,2023-12-08,503,mixer,1349,3249,1900,1,00134,India
505842,2023-12-08,501,iphone 15,60000,80000,20000,1,00134,India
322414,2023-12-08,502,iphone 15 pro max,100000,135000,35000,1,00090,India
322414,2023-12-08,501,iphone 15,60000,80000,20000,1,00090,India
819780,2023-12-08,506,monitor,3249,8000,4751,1,00258,India
446458,2023-12-08,504,iron,449,879,430,1,00099,India
446458,2023-12-08,506,monitor,3249,8000,4751,1,00099,India
446458,2023-12-08,507,washing machine,6990,16490,9500,1,00099,India
446458,2023-12-08,505,oven,18490,24000,5510,1,00099,India
562122,2023-12-09,505,oven,18490,24000,5510,1,00265,India
562122,2023-12-09,504,iron,449,879,430,1,00265,India
562122,2023-12-09,506,monitor,3249,8000,4751,1,00265,India
562122,2023-12-09,501,iphone 15,60000,80000,20000,1,00265,India
767857,2023-12-09,505,oven,18490,24000,5510,1,00175,India
756516,2023-12-09,505,oven,18490,24000,5510,1,00011,India
756516,2023-12-09,503,mixer,1349,3249,1900,1,00011,India
756516,2023-12-09,501,iphone 15,60000,80000,20000,1,00011,India
756516,2023-12-09,504,iron,449,879,430,1,00011,India
756516,2023-12-09,507,washing machine,6990,16490,9500,1,00011,India
308400,2023-12-09,505,oven,18490,24000,5510,1,00374,India
308400,2023-12-09,507,washing machine,6990,16490,9500,1,00374,India
438555,2023-12-09,501,iphone 15,60000,80000,20000,1,00117,India
438555,2023-12-09,507,washing machine,6990,16490,9500,1,00117,India
292937,2023-12-09,507,washing machine,6990,16490,9500,1,00354,India
292937,2023-12-09,503,mixer,1349,3249,1900,1,00354,India
944414,2023-12-09,505,oven,18490,24000,5510,1,00044,India
944414,2023-12-09,502,iphone 15 pro max,100000,135000,35000,1,00044,India
944414,2023-12-09,507,washing machine,6990,16490,9500,1,00044,India
944414,2023-12-09,506,monitor,3249,8000,4751,1,00044,India
944414,2023-12-09,503,mixer,1349,3249,1900,1,00044,India
885841,2023-12-09,507,washing machine,6990,16490,9500,1,00034,India
885841,2023-12-09,504,iron,449,879,430,1,00034,India
209261,2023-12-09,502,iphone 15 pro max,100000,135000,35000,1,00127,India
209261,2023-12-09,504,iron,449,879,430,1,00127,India
432993,2023-12-09,505,oven,18490,24000,5510,1,00340,India
432993,2023-12-09,501,iphone 15,60000,80000,20000,1,00340,India
973807,2023-12-09,506,monitor,3249,8000,4751,1,00172,India
973807,2023-12-09,503,mixer,1349,3249,1900,1,00172,India
973807,2023-12-09,504,iron,449,879,430,1,00172,India
886837,2023-12-09,502,iphone 15 pro max,100000,135000,35000,1,00265,India
886837,2023-12-09,501,iphone 15,60000,80000,20000,1,00265,India
167671,2023-12-09,504,iron,449,879,430,1,00141,India
167671,2023-12-09,501,iphone 15,60000,80000,20000,1,00141,India
167671,2023-12-09,506,monitor,3249,8000,4751,1,00141,India
167671,2023-12-09,507,washing machine,6990,16490,9500,1,00141,India
107393,2023-12-09,503,mixer,1349,3249,1900,1,00354,India
107393,2023-12-09,504,iron,449,879,430,1,00354,India
107393,2023-12-09,507,washing machine,6990,16490,9500,1,00354,India
107393,2023-12-09,505,oven,18490,24000,5510,1,00354,India
797147,2023-12-09,506,monitor,3249,8000,4751,1,00456,India
797147,2023-12-09,504,iron,449,879,430,1,00456,India
797147,2023-12-09,502,iphone 15 pro max,100000,135000,35000,1,00456,India
228597,2023-12-09,505,oven,18490,24000,5510,1,00222,India
228597,2023-12-09,502,iphone 15 pro max,100000,135000,35000,1,00222,India
798683,2023-12-09,504,iron,449,879,430,1,00392,India
798683,2023-12-09,503,mixer,1349,3249,1900,1,00392,India
798683,2023-12-09,501,iphone 15,60000,80000,20000,1,00392,India
798683,2023-12-09,505,oven,18490,24000,5510,1,00392,India
841986,2023-12-09,502,iphone 15 pro max,100000,135000,35000,1,00209,India
841986,2023-12-09,504,iron,449,879,430,1,00209,India
605066,2023-12-09,501,iphone 15,60000,80000,20000,1,00123,India
715303,2023-12-09,502,iphone 15 pro max,100000,135000,35000,1,00196,India
715303,2023-12-09,505,oven,18490,24000,5510,1,00196,India
715303,2023-12-09,507,washing machine,6990,16490,9500,1,00196,India
232807,2023-12-09,507,washing machine,6990,16490,9500,1,00268,India
748022,2023-12-09,501,iphone 15,60000,80000,20000,1,00189,India
612776,2023-12-09,504,iron,449,879,430,1,00268,India
612776,2023-12-09,506,monitor,3249,8000,4751,1,00268,India
612776,2023-12-09,505,oven,18490,24000,5510,1,00268,India
565232,2023-12-09,502,iphone 15 pro max,100000,135000,35000,1,00188,India
565232,2023-12-09,507,washing machine,6990,16490,9500,1,00188,India
565232,2023-12-09,504,iron,449,879,430,1,00188,India
565232,2023-12-09,505,oven,18490,24000,5510,1,00188,India
813825,2023-12-09,503,mixer,1349,3249,1900,1,00398,India
813825,2023-12-09,506,monitor,3249,8000,4751,1,00398,India
813825,2023-12-09,502,iphone 15 pro max,100000,135000,35000,1,00398,India
813825,2023-12-09,507,washing machine,6990,16490,9500,1,00398,India
735313,2023-12-09,502,iphone 15 pro max,100000,135000,35000,1,00406,India
735313,2023-12-09,507,washing machine,6990,16490,9500,1,00406,India
735313,2023-12-09,503,mixer,1349,3249,1900,1,00406,India
735313,2023-12-09,505,oven,18490,24000,5510,1,00406,India
335032,2023-12-09,501,iphone 15,60000,80000,20000,1,00006,India
335032,2023-12-09,505,oven,18490,24000,5510,1,00006,India
883080,2023-12-09,506,monitor,3249,8000,4751,1,00421,India
885746,2023-12-09,507,washing machine,6990,16490,9500,1,00248,India
885746,2023-12-09,502,iphone 15 pro max,100000,135000,35000,1,00248,India
885746,2023-12-09,506,monitor,3249,8000,4751,1,00248,India
885746,2023-12-09,503,mixer,1349,3249,1900,1,00248,India
744874,2023-12-09,502,iphone 15 pro max,100000,135000,35000,1,00330,India
744874,2023-12-09,503,mixer,1349,3249,1900,1,00330,India
464881,2023-12-09,506,monitor,3249,8000,4751,1,00064,India
464881,2023-12-09,501,iphone 15,60000,80000,20000,1,00064,India
501181,2023-12-09,505,oven,18490,24000,5510,1,00204,India
501181,2023-12-09,502,iphone 15 pro max,100000,135000,35000,1,00204,India
501181,2023-12-09,507,washing machine,6990,16490,9500,1,00204,India
116204,2023-12-09,507,washing machine,6990,16490,9500,1,00093,India
116204,2023-12-09,503,mixer,1349,3249,1900,1,00093,India
116204,2023-12-09,506,monitor,3249,8000,4751,1,00093,India
743241,2023-12-09,501,iphone 15,60000,80000,20000,1,00184,India
822869,2023-12-09,501,iphone 15,60000,80000,20000,1,00050,India
822869,2023-12-09,506,monitor,3249,8000,4751,1,00050,India
822869,2023-12-09,502,iphone 15 pro max,100000,135000,35000,1,00050,India
822869,2023-12-09,507,washing machine,6990,16490,9500,1,00050,India
497285,2023-12-09,503,mixer,1349,3249,1900,1,00452,India
497285,2023-12-09,506,monitor,3249,8000,4751,1,00452,India
497285,2023-12-09,505,oven,18490,24000,5510,1,00452,India
497285,2023-12-09,504,iron,449,879,430,1,00452,India
601295,2023-12-09,506,monitor,3249,8000,4751,1,00195,India
601295,2023-12-09,501,iphone 15,60000,80000,20000,1,00195,India
531779,2023-12-09,504,iron,449,879,430,1,00409,India
531779,2023-12-09,506,monitor,3249,8000,4751,1,00409,India
531779,2023-12-09,507,washing machine,6990,16490,9500,1,00409,India
645655,2023-12-09,501,iphone 15,60000,80000,20000,1,00175,India
645655,2023-12-09,504,iron,449,879,430,1,00175,India
645655,2023-12-09,507,washing machine,6990,16490,9500,1,00175,India
442044,2023-12-09,506,monitor,3249,8000,4751,1,00037,India
121586,2023-12-09,507,washing machine,6990,16490,9500,1,00184,India
121586,2023-12-09,501,iphone 15,60000,80000,20000,1,00184,India
121586,2023-12-09,502,iphone 15 pro max,100000,135000,35000,1,00184,India
331649,2023-12-09,501,iphone 15,60000,80000,20000,1,00347,India
247029,2023-12-09,503,mixer,1349,3249,1900,1,00031,India
647907,2023-12-09,507,washing machine,6990,16490,9500,1,00089,India
470630,2023-12-09,503,mixer,1349,3249,1900,1,00265,India
470630,2023-12-09,507,washing machine,6990,16490,9500,1,00265,India
877275,2023-12-09,502,iphone 15 pro max,100000,135000,35000,1,00437,India
877275,2023-12-09,507,washing machine,6990,16490,9500,1,00437,India
877275,2023-12-09,501,iphone 15,60000,80000,20000,1,00437,India
937993,2023-12-09,503,mixer,1349,3249,1900,1,00457,India
937993,2023-12-09,506,monitor,3249,8000,4751,1,00457,India
194563,2023-12-09,507,washing machine,6990,16490,9500,1,00022,India
194563,2023-12-09,503,mixer,1349,3249,1900,1,00022,India
194563,2023-12-09,502,iphone 15 pro max,100000,135000,35000,1,00022,India
194563,2023-12-09,506,monitor,3249,8000,4751,1,00022,India
867130,2023-12-09,502,iphone 15 pro max,100000,135000,35000,1,00257,India
684395,2023-12-09,507,washing machine,6990,16490,9500,1,00083,India
684395,2023-12-09,504,iron,449,879,430,1,00083,India
684395,2023-12-09,503,mixer,1349,3249,1900,1,00083,India
684395,2023-12-09,505,oven,18490,24000,5510,1,00083,India
934950,2023-12-09,501,iphone 15,60000,80000,20000,1,00204,India
318803,2023-12-09,503,mixer,1349,3249,1900,1,00282,India
318803,2023-12-09,504,iron,449,879,430,1,00282,India
902960,2023-12-09,507,washing machine,6990,16490,9500,1,00200,India
902960,2023-12-09,504,iron,449,879,430,1,00200,India
902960,2023-12-09,501,iphone 15,60000,80000,20000,1,00200,India
835413,2023-12-10,506,monitor,3249,8000,4751,1,00174,India
835413,2023-12-10,507,washing machine,6990,16490,9500,1,00174,India
835413,2023-12-10,503,mixer,1349,3249,1900,1,00174,India
536032,2023-12-10,503,mixer,1349,3249,1900,1,00305,India
536032,2023-12-10,501,iphone 15,60000,80000,20000,1,00305,India
536032,2023-12-10,502,iphone 15 pro max,100000,135000,35000,1,00305,India
920022,2023-12-10,507,washing machine,6990,16490,9500,1,00304,India
920022,2023-12-10,501,iphone 15,60000,80000,20000,1,00304,India
920022,2023-12-10,502,iphone 15 pro max,100000,135000,35000,1,00304,India
927883,2023-12-10,501,iphone 15,60000,80000,20000,1,00428,India
927883,2023-12-10,505,oven,18490,24000,5510,1,00428,India
927883,2023-12-10,504,iron,449,879,430,1,00428,India
718715,2023-12-10,506,monitor,3249,8000,4751,1,00247,India
718715,2023-12-10,501,iphone 15,60000,80000,20000,1,00247,India
718715,2023-12-10,505,oven,18490,24000,5510,1,00247,India
718715,2023-12-10,502,iphone 15 pro max,100000,135000,35000,1,00247,India
732729,2023-12-10,501,iphone 15,60000,80000,20000,1,00238,India
732729,2023-12-10,506,monitor,3249,8000,4751,1,00238,India
871787,2023-12-10,505,oven,18490,24000,5510,1,00345,India
871787,2023-12-10,506,monitor,3249,8000,4751,1,00345,India
871787,2023-12-10,501,iphone 15,60000,80000,20000,1,00345,India
421513,2023-12-10,505,oven,18490,24000,5510,1,00247,India
421513,2023-12-10,502,iphone 15 pro max,100000,135000,35000,1,00247,India
421513,2023-12-10,503,mixer,1349,3249,1900,1,00247,India
696256,2023-12-10,502,iphone 15 pro max,100000,135000,35000,1,00484,India
774525,2023-12-10,502,iphone 15 pro max,100000,135000,35000,1,00210,India
774525,2023-12-10,504,iron,449,879,430,1,00210,India
774525,2023-12-10,507,washing machine,6990,16490,9500,1,00210,India
810887,2023-12-10,507,washing machine,6990,16490,9500,1,00408,India
810887,2023-12-10,501,iphone 15,60000,80000,20000,1,00408,India
896611,2023-12-10,502,iphone 15 pro max,100000,135000,35000,1,00003,India
896611,2023-12-10,506,monitor,3249,8000,4751,1,00003,India
896611,2023-12-10,504,iron,449,879,430,1,00003,India
896611,2023-12-10,501,iphone 15,60000,80000,20000,1,00003,India
972445,2023-12-10,507,washing machine,6990,16490,9500,1,00249,India
972445,2023-12-10,501,iphone 15,60000,80000,20000,1,00249,India
972445,2023-12-10,503,mixer,1349,3249,1900,1,00249,India
972445,2023-12-10,502,iphone 15 pro max,100000,135000,35000,1,00249,India
610695,2023-12-10,503,mixer,1349,3249,1900,1,00295,India
785605,2023-12-10,506,monitor,3249,8000,4751,1,00480,India
785605,2023-12-10,505,oven,18490,24000,5510,1,00480,India
457059,2023-12-10,506,monitor,3249,8000,4751,1,00365,India
457059,2023-12-10,507,washing machine,6990,16490,9500,1,00365,India
457059,2023-12-10,503,mixer,1349,3249,1900,1,00365,India
321792,2023-12-10,505,oven,18490,24000,5510,1,00123,India
321792,2023-12-10,502,iphone 15 pro max,100000,135000,35000,1,00123,India
321792,2023-12-10,504,iron,449,879,430,1,00123,India
538682,2023-12-10,505,oven,18490,24000,5510,1,00041,India
538682,2023-12-10,504,iron,449,879,430,1,00041,India
538682,2023-12-10,507,washing machine,6990,16490,9500,1,00041,India
538682,2023-12-10,502,iphone 15 pro max,100000,135000,35000,1,00041,India
831991,2023-12-10,505,oven,18490,24000,5510,1,00143,India
831991,2023-12-10,504,iron,449,879,430,1,00143,India
831991,2023-12-10,507,washing machine,6990,16490,9500,1,00143,India
352128,2023-12-10,501,iphone 15,60000,80000,20000,1,00435,India
352128,2023-12-10,506,monitor,3249,8000,4751,1,00435,India
579830,2023-12-10,505,oven,18490,24000,5510,1,00052,India
579830,2023-12-10,507,washing machine,6990,16490,9500,1,00052,India
579830,2023-12-10,506,monitor,3249,8000,4751,1,00052,India
852360,2023-12-10,502,iphone 15 pro max,100000,135000,35000,1,00199,India
852360,2023-12-10,507,washing machine,6990,16490,9500,1,00199,India
269231,2023-12-10,505,oven,18490,24000,5510,1,00375,India
269231,2023-12-10,506,monitor,3249,8000,4751,1,00375,India
269231,2023-12-10,504,iron,449,879,430,1,00375,India
269231,2023-12-10,507,washing machine,6990,16490,9500,1,00375,India
180508,2023-12-10,503,mixer,1349,3249,1900,1,00027,India
127105,2023-12-10,506,monitor,3249,8000,4751,1,00106,India
127105,2023-12-10,504,iron,449,879,430,1,00106,India
127105,2023-12-10,501,iphone 15,60000,80000,20000,1,00106,India
527409,2023-12-10,502,iphone 15 pro max,100000,135000,35000,1,00005,India
527409,2023-12-10,506,monitor,3249,8000,4751,1,00005,India
527409,2023-12-10,501,iphone 15,60000,80000,20000,1,00005,India
112168,2023-12-10,502,iphone 15 pro max,100000,135000,35000,1,00242,India
112168,2023-12-10,501,iphone 15,60000,80000,20000,1,00242,India
906870,2023-12-10,505,oven,18490,24000,5510,1,00125,India
614855,2023-12-10,507,washing machine,6990,16490,9500,1,00235,India
614855,2023-12-10,502,iphone 15 pro max,100000,135000,35000,1,00235,India
614855,2023-12-10,501,iphone 15,60000,80000,20000,1,00235,India
614855,2023-12-10,504,iron,449,879,430,1,00235,India
392919,2023-12-10,504,iron,449,879,430,1,00390,India
392919,2023-12-10,502,iphone 15 pro max,100000,135000,35000,1,00390,India
392919,2023-12-10,505,oven,18490,24000,5510,1,00390,India
582972,2023-12-10,507,washing machine,6990,16490,9500,1,00350,India
880157,2023-12-10,505,oven,18490,24000,5510,1,00399,India
880157,2023-12-10,504,iron,449,879,430,1,00399,India
581594,2023-12-10,506,monitor,3249,8000,4751,1,00043,India
581594,2023-12-10,501,iphone 15,60000,80000,20000,1,00043,India
581594,2023-12-10,504,iron,449,879,430,1,00043,India
581594,2023-12-10,503,mixer,1349,3249,1900,1,00043,India
494877,2023-12-10,501,iphone 15,60000,80000,20000,1,00117,India
494877,2023-12-10,503,mixer,1349,3249,1900,1,00117,India
117152,2023-12-10,503,mixer,1349,3249,1900,1,00366,India
718077,2023-12-10,504,iron,449,879,430,1,00336,India
976768,2023-12-10,507,washing machine,6990,16490,9500,1,00375,India
976768,2023-12-10,504,iron,449,879,430,1,00375,India
240989,2023-12-10,502,iphone 15 pro max,100000,135000,35000,1,00024,India
240989,2023-12-10,504,iron,449,879,430,1,00024,India
505494,2023-12-10,502,iphone 15 pro max,100000,135000,35000,1,00200,India
384262,2023-12-10,506,monitor,3249,8000,4751,1,00369,India
384262,2023-12-10,501,iphone 15,60000,80000,20000,1,00369,India
384262,2023-12-10,505,oven,18490,24000,5510,1,00369,India
384262,2023-12-10,503,mixer,1349,3249,1900,1,00369,India
439911,2023-12-10,506,monitor,3249,8000,4751,1,00266,India
439911,2023-12-10,501,iphone 15,60000,80000,20000,1,00266,India
439911,2023-12-10,502,iphone 15 pro max,100000,135000,35000,1,00266,India
439911,2023-12-10,505,oven,18490,24000,5510,1,00266,India
439955,2023-12-10,506,monitor,3249,8000,4751,1,00360,India
343103,2023-12-10,506,monitor,3249,8000,4751,1,00136,India
343103,2023-12-10,501,iphone 15,60000,80000,20000,1,00136,India
181673,2023-12-10,504,iron,449,879,430,1,00169,India
181673,2023-12-10,505,oven,18490,24000,5510,1,00169,India
174187,2023-12-10,506,monitor,3249,8000,4751,1,00152,India
174187,2023-12-10,505,oven,18490,24000,5510,1,00152,India
174187,2023-12-10,504,iron,449,879,430,1,00152,India
292733,2023-12-10,502,iphone 15 pro max,100000,135000,35000,1,00207,India
292733,2023-12-10,507,washing machine,6990,16490,9500,1,00207,India
292733,2023-12-10,503,mixer,1349,3249,1900,1,00207,India
437985,2023-12-10,502,iphone 15 pro max,100000,135000,35000,1,00274,India
437985,2023-12-10,501,iphone 15,60000,80000,20000,1,00274,India
501376,2023-12-10,502,iphone 15 pro max,100000,135000,35000,1,00460,India
501376,2023-12-10,507,washing machine,6990,16490,9500,1,00460,India
501376,2023-12-10,503,mixer,1349,3249,1900,1,00460,India
501376,2023-12-10,506,monitor,3249,8000,4751,1,00460,India
550930,2023-12-10,501,iphone 15,60000,80000,20000,1,00132,India
550930,2023-12-10,507,washing machine,6990,16490,9500,1,00132,India
550930,2023-12-10,503,mixer,1349,3249,1900,1,00132,India
550930,2023-12-10,506,monitor,3249,8000,4751,1,00132,India
964080,2023-12-10,507,washing machine,6990,16490,9500,1,00031,India
964080,2023-12-10,503,mixer,1349,3249,1900,1,00031,India
964080,2023-12-10,506,monitor,3249,8000,4751,1,00031,India
964080,2023-12-10,505,oven,18490,24000,5510,1,00031,India
179582,2023-12-10,504,iron,449,879,430,1,00315,India
179582,2023-12-10,501,iphone 15,60000,80000,20000,1,00315,India
179582,2023-12-10,505,oven,18490,24000,5510,1,00315,India
179582,2023-12-10,502,iphone 15 pro max,100000,135000,35000,1,00315,India
550292,2023-12-10,507,washing machine,6990,16490,9500,1,00461,India
713350,2023-12-10,505,oven,18490,24000,5510,1,00485,India
713350,2023-12-10,504,iron,449,879,430,1,00485,India
713350,2023-12-10,503,mixer,1349,3249,1900,1,00485,India
713350,2023-12-10,507,washing machine,6990,16490,9500,1,00485,India
346319,2023-12-10,504,iron,449,879,430,1,00488,India
346319,2023-12-10,505,oven,18490,24000,5510,1,00488,India
144572,2023-12-10,502,iphone 15 pro max,100000,135000,35000,1,00332,India
144572,2023-12-10,507,washing machine,6990,16490,9500,1,00332,India
144572,2023-12-10,501,iphone 15,60000,80000,20000,1,00332,India
144572,2023-12-10,504,iron,449,879,430,1,00332,India
215111,2023-12-10,504,iron,449,879,430,1,00107,India
215111,2023-12-10,503,mixer,1349,3249,1900,1,00107,India
215111,2023-12-10,506,monitor,3249,8000,4751,1,00107,India
215111,2023-12-10,502,iphone 15 pro max,100000,135000,35000,1,00107,India
659141,2023-12-10,502,iphone 15 pro max,100000,135000,35000,1,00054,India
659141,2023-12-10,506,monitor,3249,8000,4751,1,00054,India
659141,2023-12-10,503,mixer,1349,3249,1900,1,00054,India
659141,2023-12-10,505,oven,18490,24000,5510,1,00054,India
678462,2023-12-10,502,iphone 15 pro max,100000,135000,35000,1,00276,India
678462,2023-12-10,506,monitor,3249,8000,4751,1,00276,India
678462,2023-12-10,504,iron,449,879,430,1,00276,India
678462,2023-12-10,505,oven,18490,24000,5510,1,00276,India
999904,2023-12-10,507,washing machine,6990,16490,9500,1,00390,India
999904,2023-12-10,506,monitor,3249,8000,4751,1,00390,India
517396,2023-12-10,504,iron,449,879,430,1,00148,India
517396,2023-12-10,503,mixer,1349,3249,1900,1,00148,India
517396,2023-12-10,505,oven,18490,24000,5510,1,00148,India
517396,2023-12-10,501,iphone 15,60000,80000,20000,1,00148,India
785854,2023-12-10,503,mixer,1349,3249,1900,1,00494,India
725171,2023-12-10,507,washing machine,6990,16490,9500,1,00370,India
725171,2023-12-10,502,iphone 15 pro max,100000,135000,35000,1,00370,India
725171,2023-12-10,506,monitor,3249,8000,4751,1,00370,India
725171,2023-12-10,504,iron,449,879,430,1,00370,India
421235,2023-12-10,503,mixer,1349,3249,1900,1,00489,India
421235,2023-12-10,506,monitor,3249,8000,4751,1,00489,India
421235,2023-12-10,507,washing machine,6990,16490,9500,1,00489,India
229103,2023-12-11,504,iron,449,879,430,1,00277,India
229103,2023-12-11,507,washing machine,6990,16490,9500,1,00277,India
229103,2023-12-11,501,iphone 15,60000,80000,20000,1,00277,India
229103,2023-12-11,506,monitor,3249,8000,4751,1,00277,India
167206,2023-12-11,501,iphone 15,60000,80000,20000,1,00360,India
167206,2023-12-11,507,washing machine,6990,16490,9500,1,00360,India
642743,2023-12-11,502,iphone 15 pro max,100000,135000,35000,1,00392,India
176095,2023-12-11,502,iphone 15 pro max,100000,135000,35000,1,00445,India
176095,2023-12-11,507,washing machine,6990,16490,9500,1,00445,India
176095,2023-12-11,503,mixer,1349,3249,1900,1,00445,India
511237,2023-12-11,503,mixer,1349,3249,1900,1,00029,India
511237,2023-12-11,507,washing machine,6990,16490,9500,1,00029,India
511237,2023-12-11,501,iphone 15,60000,80000,20000,1,00029,India
511237,2023-12-11,506,monitor,3249,8000,4751,1,00029,India
990885,2023-12-11,506,monitor,3249,8000,4751,1,00055,India
996506,2023-12-11,506,monitor,3249,8000,4751,1,00480,India
985558,2023-12-11,502,iphone 15 pro max,100000,135000,35000,1,00374,India
985558,2023-12-11,505,oven,18490,24000,5510,1,00374,India
985558,2023-12-11,507,washing machine,6990,16490,9500,1,00374,India
955581,2023-12-11,505,oven,18490,24000,5510,1,00165,India
955581,2023-12-11,501,iphone 15,60000,80000,20000,1,00165,India
191145,2023-12-11,507,washing machine,6990,16490,9500,1,00350,India
824185,2023-12-11,504,iron,449,879,430,1,00178,India
824185,2023-12-11,505,oven,18490,24000,5510,1,00178,India
824185,2023-12-11,507,washing machine,6990,16490,9500,1,00178,India
824185,2023-12-11,503,mixer,1349,3249,1900,1,00178,India
479954,2023-12-11,505,oven,18490,24000,5510,1,00383,India
790693,2023-12-11,505,oven,18490,24000,5510,1,00464,India
790693,2023-12-11,506,monitor,3249,8000,4751,1,00464,India
860579,2023-12-11,501,iphone 15,60000,80000,20000,1,00060,India
231402,2023-12-11,503,mixer,1349,3249,1900,1,00179,India
231402,2023-12-11,507,washing machine,6990,16490,9500,1,00179,India
231402,2023-12-11,501,iphone 15,60000,80000,20000,1,00179,India
250232,2023-12-11,506,monitor,3249,8000,4751,1,00494,India
250232,2023-12-11,507,washing machine,6990,16490,9500,1,00494,India
250232,2023-12-11,505,oven,18490,24000,5510,1,00494,India
378694,2023-12-11,505,oven,18490,24000,5510,1,00267,India
378694,2023-12-11,506,monitor,3249,8000,4751,1,00267,India
378694,2023-12-11,501,iphone 15,60000,80000,20000,1,00267,India
378694,2023-12-11,502,iphone 15 pro max,100000,135000,35000,1,00267,India
740762,2023-12-11,506,monitor,3249,8000,4751,1,00271,India
740762,2023-12-11,507,washing machine,6990,16490,9500,1,00271,India
740762,2023-12-11,505,oven,18490,24000,5510,1,00271,India
345738,2023-12-11,504,iron,449,879,430,1,00057,India
345738,2023-12-11,505,oven,18490,24000,5510,1,00057,India
345738,2023-12-11,503,mixer,1349,3249,1900,1,00057,India
345738,2023-12-11,501,iphone 15,60000,80000,20000,1,00057,India
345738,2023-12-11,507,washing machine,6990,16490,9500,1,00057,India
868328,2023-12-11,501,iphone 15,60000,80000,20000,1,00481,India
153593,2023-12-11,501,iphone 15,60000,80000,20000,1,00189,India
436526,2023-12-11,504,iron,449,879,430,1,00326,India
818121,2023-12-11,507,washing machine,6990,16490,9500,1,00095,India
905899,2023-12-11,502,iphone 15 pro max,100000,135000,35000,1,00359,India
210598,2023-12-11,501,iphone 15,60000,80000,20000,1,00327,India
210598,2023-12-11,504,iron,449,879,430,1,00327,India
210598,2023-12-11,502,iphone 15 pro max,100000,135000,35000,1,00327,India
839128,2023-12-11,507,washing machine,6990,16490,9500,1,00464,India
197867,2023-12-11,505,oven,18490,24000,5510,1,00189,India
197867,2023-12-11,501,iphone 15,60000,80000,20000,1,00189,India
372218,2023-12-11,501,iphone 15,60000,80000,20000,1,00352,India
586845,2023-12-11,501,iphone 15,60000,80000,20000,1,00186,India
586845,2023-12-11,506,monitor,3249,8000,4751,1,00186,India
586845,2023-12-11,507,washing machine,6990,16490,9500,1,00186,India
539338,2023-12-11,503,mixer,1349,3249,1900,1,00112,India
539338,2023-12-11,507,washing machine,6990,16490,9500,1,00112,India
539338,2023-12-11,506,monitor,3249,8000,4751,1,00112,India
539338,2023-12-11,504,iron,449,879,430,1,00112,India
806065,2023-12-11,506,monitor,3249,8000,4751,1,00439,India
806065,2023-12-11,507,washing machine,6990,16490,9500,1,00439,India
433593,2023-12-11,501,iphone 15,60000,80000,20000,1,00347,India
433593,2023-12-11,504,iron,449,879,430,1,00347,India
433593,2023-12-11,502,iphone 15 pro max,100000,135000,35000,1,00347,India
433593,2023-12-11,505,oven,18490,24000,5510,1,00347,India
873980,2023-12-11,504,iron,449,879,430,1,00220,India
873980,2023-12-11,501,iphone 15,60000,80000,20000,1,00220,India
873980,2023-12-11,502,iphone 15 pro max,100000,135000,35000,1,00220,India
876137,2023-12-11,501,iphone 15,60000,80000,20000,1,00490,India
633325,2023-12-11,506,monitor,3249,8000,4751,1,00104,India
144947,2023-12-11,504,iron,449,879,430,1,00382,India
383154,2023-12-11,504,iron,449,879,430,1,00499,India
383154,2023-12-11,507,washing machine,6990,16490,9500,1,00499,India
383154,2023-12-11,503,mixer,1349,3249,1900,1,00499,India
944503,2023-12-11,505,oven,18490,24000,5510,1,00359,India
304214,2023-12-11,501,iphone 15,60000,80000,20000,1,00219,India
304214,2023-12-11,502,iphone 15 pro max,100000,135000,35000,1,00219,India
304214,2023-12-11,506,monitor,3249,8000,4751,1,00219,India
567806,2023-12-11,506,monitor,3249,8000,4751,1,00383,India
250837,2023-12-11,504,iron,449,879,430,1,00108,India
250837,2023-12-11,502,iphone 15 pro max,100000,135000,35000,1,00108,India
985748,2023-12-11,502,iphone 15 pro max,100000,135000,35000,1,00385,India
985748,2023-12-11,501,iphone 15,60000,80000,20000,1,00385,India
985748,2023-12-11,507,washing machine,6990,16490,9500,1,00385,India
734910,2023-12-11,502,iphone 15 pro max,100000,135000,35000,1,00368,India
734910,2023-12-11,504,iron,449,879,430,1,00368,India
858570,2023-12-11,507,washing machine,6990,16490,9500,1,00133,India
813836,2023-12-11,506,monitor,3249,8000,4751,1,00458,India
813836,2023-12-11,503,mixer,1349,3249,1900,1,00458,India
813836,2023-12-11,502,iphone 15 pro max,100000,135000,35000,1,00458,India
267951,2023-12-11,506,monitor,3249,8000,4751,1,00138,India
267951,2023-12-11,504,iron,449,879,430,1,00138,India
784705,2023-12-11,506,monitor,3249,8000,4751,1,00213,India
784705,2023-12-11,503,mixer,1349,3249,1900,1,00213,India
784705,2023-12-11,504,iron,449,879,430,1,00213,India
784705,2023-12-11,502,iphone 15 pro max,100000,135000,35000,1,00213,India
620830,2023-12-11,502,iphone 15 pro max,100000,135000,35000,1,00110,India
620830,2023-12-11,501,iphone 15,60000,80000,20000,1,00110,India
123902,2023-12-11,505,oven,18490,24000,5510,1,00098,India
123902,2023-12-11,503,mixer,1349,3249,1900,1,00098,India
123902,2023-12-11,501,iphone 15,60000,80000,20000,1,00098,India
123902,2023-12-11,507,washing machine,6990,16490,9500,1,00098,India
646998,2023-12-11,507,washing machine,6990,16490,9500,1,00432,India
646998,2023-12-11,504,iron,449,879,430,1,00432,India
855065,2023-12-11,502,iphone 15 pro max,100000,135000,35000,1,00110,India
855065,2023-12-11,504,iron,449,879,430,1,00110,India
855065,2023-12-11,507,washing machine,6990,16490,9500,1,00110,India
861829,2023-12-11,501,iphone 15,60000,80000,20000,1,00489,India
861829,2023-12-11,505,oven,18490,24000,5510,1,00489,India
861829,2023-12-11,504,iron,449,879,430,1,00489,India
671706,2023-12-11,503,mixer,1349,3249,1900,1,00476,India
671706,2023-12-11,507,washing machine,6990,16490,9500,1,00476,India
747829,2023-12-11,507,washing machine,6990,16490,9500,1,00151,India
747829,2023-12-11,504,iron,449,879,430,1,00151,India
747829,2023-12-11,502,iphone 15 pro max,100000,135000,35000,1,00151,India
548682,2023-12-11,504,iron,449,879,430,1,00352,India
548682,2023-12-11,503,mixer,1349,3249,1900,1,00352,India
548682,2023-12-11,507,washing machine,6990,16490,9500,1,00352,India
548682,2023-12-11,506,monitor,3249,8000,4751,1,00352,India
577326,2023-12-11,504,iron,449,879,430,1,00167,India
309304,2023-12-11,502,iphone 15 pro max,100000,135000,35000,1,00052,India
858570,2023-12-11,506,monitor,3249,8000,4751,1,00133,India
858570,2023-12-11,504,iron,449,879,430,1,00133,India
853397,2023-12-11,503,mixer,1349,3249,1900,1,00329,India
853397,2023-12-11,504,iron,449,879,430,1,00329,India
853397,2023-12-11,505,oven,18490,24000,5510,1,00329,India
853397,2023-12-11,501,iphone 15,60000,80000,20000,1,00329,India
865310,2023-12-11,506,monitor,3249,8000,4751,1,00124,India
865310,2023-12-11,503,mixer,1349,3249,1900,1,00124,India
865310,2023-12-11,501,iphone 15,60000,80000,20000,1,00124,India
934810,2023-12-11,503,mixer,1349,3249,1900,1,00328,India
934810,2023-12-11,504,iron,449,879,430,1,00328,India
934810,2023-12-11,501,iphone 15,60000,80000,20000,1,00328,India
529388,2023-12-11,507,washing machine,6990,16490,9500,1,00448,India
529388,2023-12-11,503,mixer,1349,3249,1900,1,00448,India
529388,2023-12-11,505,oven,18490,24000,5510,1,00448,India
529388,2023-12-11,504,iron,449,879,430,1,00448,India
245704,2023-12-11,501,iphone 15,60000,80000,20000,1,00354,India
245704,2023-12-11,502,iphone 15 pro max,100000,135000,35000,1,00354,India
245704,2023-12-11,504,iron,449,879,430,1,00354,India
866125,2023-12-11,504,iron,449,879,430,1,00468,India
749446,2023-12-11,507,washing machine,6990,16490,9500,1,00073,India
749446,2023-12-11,505,oven,18490,24000,5510,1,00073,India
630029,2023-12-11,504,iron,449,879,430,1,00089,India
630029,2023-12-11,503,mixer,1349,3249,1900,1,00089,India
630029,2023-12-11,506,monitor,3249,8000,4751,1,00089,India
630029,2023-12-11,502,iphone 15 pro max,100000,135000,35000,1,00089,India
205578,2023-12-11,506,monitor,3249,8000,4751,1,00194,India
205578,2023-12-11,501,iphone 15,60000,80000,20000,1,00194,India
205578,2023-12-11,503,mixer,1349,3249,1900,1,00194,India
799872,2023-12-11,503,mixer,1349,3249,1900,1,00289,India
799872,2023-12-11,501,iphone 15,60000,80000,20000,1,00289,India
365282,2023-12-11,506,monitor,3249,8000,4751,1,00112,India
365282,2023-12-11,507,washing machine,6990,16490,9500,1,00112,India
365282,2023-12-11,504,iron,449,879,430,1,00112,India
365282,2023-12-11,502,iphone 15 pro max,100000,135000,35000,1,00112,India
193374,2023-12-11,505,oven,18490,24000,5510,1,00193,India
193374,2023-12-11,502,iphone 15 pro max,100000,135000,35000,1,00193,India
193374,2023-12-11,506,monitor,3249,8000,4751,1,00193,India
256078,2023-12-11,502,iphone 15 pro max,100000,135000,35000,1,00475,India
256078,2023-12-11,506,monitor,3249,8000,4751,1,00475,India
918532,2023-12-11,502,iphone 15 pro max,100000,135000,35000,1,00023,India
918532,2023-12-11,504,iron,449,879,430,1,00023,India
918532,2023-12-11,507,washing machine,6990,16490,9500,1,00023,India
897501,2023-12-11,507,washing machine,6990,16490,9500,1,00463,India
897501,2023-12-11,504,iron,449,879,430,1,00463,India
897501,2023-12-11,505,oven,18490,24000,5510,1,00463,India
140197,2023-12-11,504,iron,449,879,430,1,00209,India
140197,2023-12-11,503,mixer,1349,3249,1900,1,00209,India
140197,2023-12-11,502,iphone 15 pro max,100000,135000,35000,1,00209,India
722475,2023-12-11,503,mixer,1349,3249,1900,1,00423,India
722475,2023-12-11,502,iphone 15 pro max,100000,135000,35000,1,00423,India
722475,2023-12-11,507,washing machine,6990,16490,9500,1,00423,India
253609,2023-12-11,501,iphone 15,60000,80000,20000,1,00054,India
253609,2023-12-11,507,washing machine,6990,16490,9500,1,00054,India
253609,2023-12-11,505,oven,18490,24000,5510,1,00054,India
658860,2023-12-11,503,mixer,1349,3249,1900,1,00009,India
658860,2023-12-11,501,iphone 15,60000,80000,20000,1,00009,India
287262,2023-12-11,507,washing machine,6990,16490,9500,1,00321,India
287262,2023-12-11,501,iphone 15,60000,80000,20000,1,00321,India
773989,2023-12-11,501,iphone 15,60000,80000,20000,1,00214,India
773989,2023-12-11,505,oven,18490,24000,5510,1,00214,India
773989,2023-12-11,504,iron,449,879,430,1,00214,India
752586,2023-12-11,503,mixer,1349,3249,1900,1,00117,India
752586,2023-12-11,507,washing machine,6990,16490,9500,1,00117,India
752586,2023-12-11,502,iphone 15 pro max,100000,135000,35000,1,00117,India
752586,2023-12-11,504,iron,449,879,430,1,00117,India
732912,2023-12-11,506,monitor,3249,8000,4751,1,00367,India
732912,2023-12-11,504,iron,449,879,430,1,00367,India
162666,2023-12-11,503,mixer,1349,3249,1900,1,00082,India
995356,2023-12-11,507,washing machine,6990,16490,9500,1,00068,India
995356,2023-12-11,505,oven,18490,24000,5510,1,00068,India
995356,2023-12-11,504,iron,449,879,430,1,00068,India
995356,2023-12-11,506,monitor,3249,8000,4751,1,00068,India
115800,2023-12-11,504,iron,449,879,430,1,00311,India
115800,2023-12-11,502,iphone 15 pro max,100000,135000,35000,1,00311,India
115800,2023-12-11,503,mixer,1349,3249,1900,1,00311,India
115800,2023-12-11,505,oven,18490,24000,5510,1,00311,India
192956,2023-12-11,502,iphone 15 pro max,100000,135000,35000,1,00092,India
192956,2023-12-11,507,washing machine,6990,16490,9500,1,00092,India
192956,2023-12-11,506,monitor,3249,8000,4751,1,00092,India
883896,2023-12-11,501,iphone 15,60000,80000,20000,1,00065,India
883896,2023-12-11,505,oven,18490,24000,5510,1,00065,India
883896,2023-12-11,506,monitor,3249,8000,4751,1,00065,India
809551,2023-12-11,505,oven,18490,24000,5510,1,00094,India
809551,2023-12-11,507,washing machine,6990,16490,9500,1,00094,India
809551,2023-12-11,503,mixer,1349,3249,1900,1,00094,India
437443,2023-12-11,501,iphone 15,60000,80000,20000,1,00146,India
437443,2023-12-11,507,washing machine,6990,16490,9500,1,00146,India
398569,2023-12-11,505,oven,18490,24000,5510,1,00316,India
959500,2023-12-11,506,monitor,3249,8000,4751,1,00149,India
959500,2023-12-11,503,mixer,1349,3249,1900,1,00149,India
959500,2023-12-11,502,iphone 15 pro max,100000,135000,35000,1,00149,India
959500,2023-12-11,507,washing machine,6990,16490,9500,1,00149,India
352997,2023-12-11,505,oven,18490,24000,5510,1,00344,India
352997,2023-12-11,506,monitor,3249,8000,4751,1,00344,India
352997,2023-12-11,501,iphone 15,60000,80000,20000,1,00344,India
352997,2023-12-11,502,iphone 15 pro max,100000,135000,35000,1,00344,India
287388,2023-12-11,502,iphone 15 pro max,100000,135000,35000,1,00213,India
287388,2023-12-11,501,iphone 15,60000,80000,20000,1,00213,India
287388,2023-12-11,506,monitor,3249,8000,4751,1,00213,India
924724,2023-12-11,506,monitor,3249,8000,4751,1,00213,India
318445,2023-12-11,504,iron,449,879,430,1,00148,India
318445,2023-12-11,506,monitor,3249,8000,4751,1,00148,India
637281,2023-12-11,507,washing machine,6990,16490,9500,1,00296,India
637281,2023-12-11,506,monitor,3249,8000,4751,1,00296,India
637281,2023-12-11,504,iron,449,879,430,1,00296,India
637281,2023-12-11,502,iphone 15 pro max,100000,135000,35000,1,00296,India
525623,2023-12-11,505,oven,18490,24000,5510,1,00177,India
769259,2023-12-11,507,washing machine,6990,16490,9500,1,00228,India
769259,2023-12-11,503,mixer,1349,3249,1900,1,00228,India
769259,2023-12-11,502,iphone 15 pro max,100000,135000,35000,1,00228,India
769259,2023-12-11,506,monitor,3249,8000,4751,1,00228,India
150136,2023-12-11,504,iron,449,879,430,1,00479,India
827416,2023-12-11,501,iphone 15,60000,80000,20000,1,00005,India
827416,2023-12-11,503,mixer,1349,3249,1900,1,00005,India
637067,2023-12-11,504,iron,449,879,430,1,00082,India
679764,2023-12-12,501,iphone 15,60000,80000,20000,1,00343,India
679764,2023-12-12,506,monitor,3249,8000,4751,1,00343,India
679764,2023-12-12,505,oven,18490,24000,5510,1,00343,India
544536,2023-12-12,505,oven,18490,24000,5510,1,00293,India
544536,2023-12-12,502,iphone 15 pro max,100000,135000,35000,1,00293,India
544536,2023-12-12,501,iphone 15,60000,80000,20000,1,00293,India
384013,2023-12-12,507,washing machine,6990,16490,9500,1,00051,India
638147,2023-12-12,502,iphone 15 pro max,100000,135000,35000,1,00342,India
638147,2023-12-12,501,iphone 15,60000,80000,20000,1,00342,India
497435,2023-12-12,506,monitor,3249,8000,4751,1,00145,India
497435,2023-12-12,502,iphone 15 pro max,100000,135000,35000,1,00145,India
497435,2023-12-12,504,iron,449,879,430,1,00145,India
497435,2023-12-12,503,mixer,1349,3249,1900,1,00145,India
497435,2023-12-12,507,washing machine,6990,16490,9500,1,00145,India
756679,2023-12-12,501,iphone 15,60000,80000,20000,1,00493,India
756679,2023-12-12,503,mixer,1349,3249,1900,1,00493,India
756679,2023-12-12,507,washing machine,6990,16490,9500,1,00493,India
719568,2023-12-12,507,washing machine,6990,16490,9500,1,00130,India
719568,2023-12-12,502,iphone 15 pro max,100000,135000,35000,1,00130,India
464037,2023-12-12,502,iphone 15 pro max,100000,135000,35000,1,00396,India
464037,2023-12-12,507,washing machine,6990,16490,9500,1,00396,India
670285,2023-12-12,506,monitor,3249,8000,4751,1,00360,India
719486,2023-12-12,501,iphone 15,60000,80000,20000,1,00113,India
719486,2023-12-12,504,iron,449,879,430,1,00113,India
755530,2023-12-12,504,iron,449,879,430,1,00435,India
755530,2023-12-12,501,iphone 15,60000,80000,20000,1,00435,India
222269,2023-12-12,502,iphone 15 pro max,100000,135000,35000,1,00218,India
332487,2023-12-12,504,iron,449,879,430,1,00124,India
332487,2023-12-12,502,iphone 15 pro max,100000,135000,35000,1,00124,India
989276,2023-12-12,504,iron,449,879,430,1,00459,India
989276,2023-12-12,505,oven,18490,24000,5510,1,00459,India
989276,2023-12-12,507,washing machine,6990,16490,9500,1,00459,India
989276,2023-12-12,506,monitor,3249,8000,4751,1,00459,India
484429,2023-12-12,505,oven,18490,24000,5510,1,00226,India
484429,2023-12-12,506,monitor,3249,8000,4751,1,00226,India
484429,2023-12-12,503,mixer,1349,3249,1900,1,00226,India
845569,2023-12-12,504,iron,449,879,430,1,00358,India
845569,2023-12-12,502,iphone 15 pro max,100000,135000,35000,1,00358,India
845569,2023-12-12,506,monitor,3249,8000,4751,1,00358,India
899455,2023-12-12,501,iphone 15,60000,80000,20000,1,00370,India
899455,2023-12-12,503,mixer,1349,3249,1900,1,00370,India
899455,2023-12-12,506,monitor,3249,8000,4751,1,00370,India
899455,2023-12-12,502,iphone 15 pro max,100000,135000,35000,1,00370,India
341371,2023-12-12,501,iphone 15,60000,80000,20000,1,00025,India
341371,2023-12-12,502,iphone 15 pro max,100000,135000,35000,1,00025,India
439290,2023-12-12,503,mixer,1349,3249,1900,1,00144,India
439290,2023-12-12,505,oven,18490,24000,5510,1,00144,India
439290,2023-12-12,504,iron,449,879,430,1,00144,India
439290,2023-12-12,502,iphone 15 pro max,100000,135000,35000,1,00144,India
918929,2023-12-12,501,iphone 15,60000,80000,20000,1,00329,India
846699,2023-12-12,503,mixer,1349,3249,1900,1,00451,India
846699,2023-12-12,507,washing machine,6990,16490,9500,1,00451,India
387497,2023-12-12,504,iron,449,879,430,1,00408,India
387497,2023-12-12,501,iphone 15,60000,80000,20000,1,00408,India
387497,2023-12-12,507,washing machine,6990,16490,9500,1,00408,India
387497,2023-12-12,503,mixer,1349,3249,1900,1,00408,India
860110,2023-12-12,503,mixer,1349,3249,1900,1,00157,India
486409,2023-12-12,507,washing machine,6990,16490,9500,1,00289,India
161197,2023-12-12,506,monitor,3249,8000,4751,1,00481,India
161197,2023-12-12,504,iron,449,879,430,1,00481,India
161197,2023-12-12,503,mixer,1349,3249,1900,1,00481,India
706191,2023-12-12,502,iphone 15 pro max,100000,135000,35000,1,00433,India
706191,2023-12-12,501,iphone 15,60000,80000,20000,1,00433,India
359050,2023-12-12,503,mixer,1349,3249,1900,1,00421,India
359050,2023-12-12,504,iron,449,879,430,1,00421,India
359050,2023-12-12,501,iphone 15,60000,80000,20000,1,00421,India
359050,2023-12-12,505,oven,18490,24000,5510,1,00421,India
359050,2023-12-12,502,iphone 15 pro max,100000,135000,35000,1,00421,India
292537,2023-12-12,504,iron,449,879,430,1,00308,India
292537,2023-12-12,502,iphone 15 pro max,100000,135000,35000,1,00308,India
292537,2023-12-12,505,oven,18490,24000,5510,1,00308,India
292537,2023-12-12,506,monitor,3249,8000,4751,1,00308,India
210701,2023-12-12,501,iphone 15,60000,80000,20000,1,00182,India
210701,2023-12-12,507,washing machine,6990,16490,9500,1,00182,India
210701,2023-12-12,503,mixer,1349,3249,1900,1,00182,India
648207,2023-12-12,504,iron,449,879,430,1,00081,India
648207,2023-12-12,505,oven,18490,24000,5510,1,00081,India
735468,2023-12-12,506,monitor,3249,8000,4751,1,00088,India
735468,2023-12-12,503,mixer,1349,3249,1900,1,00088,India
712501,2023-12-12,501,iphone 15,60000,80000,20000,1,00301,India
712501,2023-12-12,502,iphone 15 pro max,100000,135000,35000,1,00301,India
712501,2023-12-12,503,mixer,1349,3249,1900,1,00301,India
957485,2023-12-12,503,mixer,1349,3249,1900,1,00141,India
957485,2023-12-12,505,oven,18490,24000,5510,1,00141,India
673969,2023-12-12,504,iron,449,879,430,1,00202,India
601353,2023-12-12,503,mixer,1349,3249,1900,1,00005,India
601353,2023-12-12,507,washing machine,6990,16490,9500,1,00005,India
601353,2023-12-12,504,iron,449,879,430,1,00005,India
601353,2023-12-12,501,iphone 15,60000,80000,20000,1,00005,India
502204,2023-12-12,505,oven,18490,24000,5510,1,00437,India
781386,2023-12-12,505,oven,18490,24000,5510,1,00024,India
781386,2023-12-12,501,iphone 15,60000,80000,20000,1,00024,India
468682,2023-12-12,507,washing machine,6990,16490,9500,1,00340,India
468682,2023-12-12,506,monitor,3249,8000,4751,1,00340,India
468682,2023-12-12,501,iphone 15,60000,80000,20000,1,00340,India
468682,2023-12-12,504,iron,449,879,430,1,00340,India
468682,2023-12-12,502,iphone 15 pro max,100000,135000,35000,1,00340,India
314269,2023-12-12,501,iphone 15,60000,80000,20000,1,00469,India
314269,2023-12-12,503,mixer,1349,3249,1900,1,00469,India
314269,2023-12-12,505,oven,18490,24000,5510,1,00469,India
319458,2023-12-12,503,mixer,1349,3249,1900,1,00391,India
516904,2023-12-12,505,oven,18490,24000,5510,1,00462,India
516904,2023-12-12,501,iphone 15,60000,80000,20000,1,00462,India
235488,2023-12-12,507,washing machine,6990,16490,9500,1,00445,India
235488,2023-12-12,501,iphone 15,60000,80000,20000,1,00445,India
418502,2023-12-12,506,monitor,3249,8000,4751,1,00147,India
702964,2023-12-12,502,iphone 15 pro max,100000,135000,35000,1,00050,India
702964,2023-12-12,503,mixer,1349,3249,1900,1,00050,India
702964,2023-12-12,504,iron,449,879,430,1,00050,India
845923,2023-12-12,506,monitor,3249,8000,4751,1,00116,India
845923,2023-12-12,502,iphone 15 pro max,100000,135000,35000,1,00116,India
845923,2023-12-12,501,iphone 15,60000,80000,20000,1,00116,India
845923,2023-12-12,505,oven,18490,24000,5510,1,00116,India
845923,2023-12-12,507,washing machine,6990,16490,9500,1,00116,India
682813,2023-12-12,501,iphone 15,60000,80000,20000,1,00185,India
682813,2023-12-12,502,iphone 15 pro max,100000,135000,35000,1,00185,India
682813,2023-12-12,506,monitor,3249,8000,4751,1,00185,India
682813,2023-12-12,503,mixer,1349,3249,1900,1,00185,India
108041,2023-12-12,501,iphone 15,60000,80000,20000,1,00086,India
108041,2023-12-12,505,oven,18490,24000,5510,1,00086,India
108041,2023-12-12,506,monitor,3249,8000,4751,1,00086,India
765329,2023-12-12,501,iphone 15,60000,80000,20000,1,00480,India
945704,2023-12-12,504,iron,449,879,430,1,00462,India
945704,2023-12-12,503,mixer,1349,3249,1900,1,00462,India
945704,2023-12-12,507,washing machine,6990,16490,9500,1,00462,India
360328,2023-12-12,501,iphone 15,60000,80000,20000,1,00322,India
360328,2023-12-12,504,iron,449,879,430,1,00322,India
379789,2023-12-12,503,mixer,1349,3249,1900,1,00091,India
379789,2023-12-12,505,oven,18490,24000,5510,1,00091,India
379789,2023-12-12,507,washing machine,6990,16490,9500,1,00091,India
561837,2023-12-12,503,mixer,1349,3249,1900,1,00380,India
561837,2023-12-12,506,monitor,3249,8000,4751,1,00380,India
561837,2023-12-12,501,iphone 15,60000,80000,20000,1,00380,India
484806,2023-12-12,505,oven,18490,24000,5510,1,00423,India
640330,2023-12-12,501,iphone 15,60000,80000,20000,1,00494,India
640330,2023-12-12,502,iphone 15 pro max,100000,135000,35000,1,00494,India
640330,2023-12-12,503,mixer,1349,3249,1900,1,00494,India
640330,2023-12-12,504,iron,449,879,430,1,00494,India
629972,2023-12-12,501,iphone 15,60000,80000,20000,1,00397,India
629972,2023-12-12,504,iron,449,879,430,1,00397,India
629972,2023-12-12,507,washing machine,6990,16490,9500,1,00397,India
629972,2023-12-12,502,iphone 15 pro max,100000,135000,35000,1,00397,India
620418,2023-12-12,502,iphone 15 pro max,100000,135000,35000,1,00250,India
620418,2023-12-12,507,washing machine,6990,16490,9500,1,00250,India
620418,2023-12-12,503,mixer,1349,3249,1900,1,00250,India
620418,2023-12-12,506,monitor,3249,8000,4751,1,00250,India
432098,2023-12-12,502,iphone 15 pro max,100000,135000,35000,1,00346,India
432098,2023-12-12,501,iphone 15,60000,80000,20000,1,00346,India
539522,2023-12-12,505,oven,18490,24000,5510,1,00257,India
539522,2023-12-12,506,monitor,3249,8000,4751,1,00257,India
539522,2023-12-12,504,iron,449,879,430,1,00257,India
539522,2023-12-12,501,iphone 15,60000,80000,20000,1,00257,India
511220,2023-12-12,503,mixer,1349,3249,1900,1,00067,India
511220,2023-12-12,505,oven,18490,24000,5510,1,00067,India
511220,2023-12-12,506,monitor,3249,8000,4751,1,00067,India
511220,2023-12-12,507,washing machine,6990,16490,9500,1,00067,India
549500,2023-12-12,502,iphone 15 pro max,100000,135000,35000,1,00235,India
549500,2023-12-12,501,iphone 15,60000,80000,20000,1,00235,India
549500,2023-12-12,504,iron,449,879,430,1,00235,India
213448,2023-12-12,506,monitor,3249,8000,4751,1,00029,India
437879,2023-12-12,503,mixer,1349,3249,1900,1,00285,India
437879,2023-12-12,502,iphone 15 pro max,100000,135000,35000,1,00285,India
437879,2023-12-12,507,washing machine,6990,16490,9500,1,00285,India
437879,2023-12-12,501,iphone 15,60000,80000,20000,1,00285,India
437879,2023-12-12,504,iron,449,879,430,1,00285,India
472731,2023-12-12,505,oven,18490,24000,5510,1,00221,India
472731,2023-12-12,501,iphone 15,60000,80000,20000,1,00221,India
399385,2023-12-12,502,iphone 15 pro max,100000,135000,35000,1,00437,India
399385,2023-12-12,506,monitor,3249,8000,4751,1,00437,India
409016,2023-12-12,507,washing machine,6990,16490,9500,1,00325,India
409016,2023-12-12,504,iron,449,879,430,1,00325,India
409016,2023-12-12,501,iphone 15,60000,80000,20000,1,00325,India
498111,2023-12-12,502,iphone 15 pro max,100000,135000,35000,1,00462,India
498111,2023-12-12,507,washing machine,6990,16490,9500,1,00462,India
498111,2023-12-12,505,oven,18490,24000,5510,1,00462,India
733283,2023-12-12,503,mixer,1349,3249,1900,1,00264,India
733283,2023-12-12,501,iphone 15,60000,80000,20000,1,00264,India
733283,2023-12-12,504,iron,449,879,430,1,00264,India
733283,2023-12-12,505,oven,18490,24000,5510,1,00264,India
454034,2023-12-12,505,oven,18490,24000,5510,1,00436,India
454034,2023-12-12,506,monitor,3249,8000,4751,1,00436,India
454034,2023-12-12,507,washing machine,6990,16490,9500,1,00436,India
223585,2023-12-12,501,iphone 15,60000,80000,20000,1,00159,India
223585,2023-12-12,502,iphone 15 pro max,100000,135000,35000,1,00159,India
223585,2023-12-12,503,mixer,1349,3249,1900,1,00159,India
841190,2023-12-12,504,iron,449,879,430,1,00352,India
841190,2023-12-12,502,iphone 15 pro max,100000,135000,35000,1,00352,India
854774,2023-12-12,501,iphone 15,60000,80000,20000,1,00285,India
515012,2023-12-12,505,oven,18490,24000,5510,1,00061,India
515012,2023-12-12,501,iphone 15,60000,80000,20000,1,00061,India
515012,2023-12-12,502,iphone 15 pro max,100000,135000,35000,1,00061,India
234124,2023-12-12,501,iphone 15,60000,80000,20000,1,00386,India
234124,2023-12-12,505,oven,18490,24000,5510,1,00386,India
234124,2023-12-12,504,iron,449,879,430,1,00386,India
874755,2023-12-12,503,mixer,1349,3249,1900,1,00325,India
251615,2023-12-12,506,monitor,3249,8000,4751,1,00153,India
251615,2023-12-12,505,oven,18490,24000,5510,1,00153,India
591280,2023-12-13,504,iron,449,879,430,1,00476,India
591280,2023-12-13,502,iphone 15 pro max,100000,135000,35000,1,00476,India
591280,2023-12-13,505,oven,18490,24000,5510,1,00476,India
591280,2023-12-13,503,mixer,1349,3249,1900,1,00476,India
591280,2023-12-13,506,monitor,3249,8000,4751,1,00476,India
443186,2023-12-13,502,iphone 15 pro max,100000,135000,35000,1,00372,India
443186,2023-12-13,501,iphone 15,60000,80000,20000,1,00372,India
443186,2023-12-13,507,washing machine,6990,16490,9500,1,00372,India
265999,2023-12-13,505,oven,18490,24000,5510,1,00034,India
265999,2023-12-13,502,iphone 15 pro max,100000,135000,35000,1,00034,India
961187,2023-12-13,502,iphone 15 pro max,100000,135000,35000,1,00401,India
819381,2023-12-13,503,mixer,1349,3249,1900,1,00035,India
819381,2023-12-13,506,monitor,3249,8000,4751,1,00035,India
819381,2023-12-13,505,oven,18490,24000,5510,1,00035,India
952233,2023-12-13,501,iphone 15,60000,80000,20000,1,00031,India
952233,2023-12-13,504,iron,449,879,430,1,00031,India
952233,2023-12-13,505,oven,18490,24000,5510,1,00031,India
548144,2023-12-13,505,oven,18490,24000,5510,1,00036,India
548144,2023-12-13,504,iron,449,879,430,1,00036,India
548144,2023-12-13,502,iphone 15 pro max,100000,135000,35000,1,00036,India
548144,2023-12-13,503,mixer,1349,3249,1900,1,00036,India
676834,2023-12-13,504,iron,449,879,430,1,00295,India
676834,2023-12-13,506,monitor,3249,8000,4751,1,00295,India
676834,2023-12-13,502,iphone 15 pro max,100000,135000,35000,1,00295,India
999149,2023-12-13,503,mixer,1349,3249,1900,1,00329,India
999149,2023-12-13,504,iron,449,879,430,1,00329,India
999149,2023-12-13,507,washing machine,6990,16490,9500,1,00329,India
999149,2023-12-13,505,oven,18490,24000,5510,1,00329,India
999149,2023-12-13,502,iphone 15 pro max,100000,135000,35000,1,00329,India
646971,2023-12-13,501,iphone 15,60000,80000,20000,1,00031,India
653072,2023-12-13,504,iron,449,879,430,1,00247,India
424761,2023-12-13,506,monitor,3249,8000,4751,1,00353,India
424761,2023-12-13,504,iron,449,879,430,1,00353,India
424761,2023-12-13,507,washing machine,6990,16490,9500,1,00353,India
424761,2023-12-13,501,iphone 15,60000,80000,20000,1,00353,India
442671,2023-12-13,502,iphone 15 pro max,100000,135000,35000,1,00018,India
442671,2023-12-13,507,washing machine,6990,16490,9500,1,00018,India
442671,2023-12-13,501,iphone 15,60000,80000,20000,1,00018,India
442671,2023-12-13,503,mixer,1349,3249,1900,1,00018,India
662889,2023-12-13,505,oven,18490,24000,5510,1,00187,India
554193,2023-12-13,502,iphone 15 pro max,100000,135000,35000,1,00489,India
554193,2023-12-13,507,washing machine,6990,16490,9500,1,00489,India
980504,2023-12-13,503,mixer,1349,3249,1900,1,00339,India
980504,2023-12-13,506,monitor,3249,8000,4751,1,00339,India
980504,2023-12-13,502,iphone 15 pro max,100000,135000,35000,1,00339,India
980504,2023-12-13,501,iphone 15,60000,80000,20000,1,00339,India
980504,2023-12-13,507,washing machine,6990,16490,9500,1,00339,India
463625,2023-12-13,503,mixer,1349,3249,1900,1,00465,India
463625,2023-12-13,502,iphone 15 pro max,100000,135000,35000,1,00465,India
537361,2023-12-13,504,iron,449,879,430,1,00030,India
537361,2023-12-13,502,iphone 15 pro max,100000,135000,35000,1,00030,India
537361,2023-12-13,501,iphone 15,60000,80000,20000,1,00030,India
399379,2023-12-13,501,iphone 15,60000,80000,20000,1,00076,India
399379,2023-12-13,504,iron,449,879,430,1,00076,India
399379,2023-12-13,505,oven,18490,24000,5510,1,00076,India
371800,2023-12-13,506,monitor,3249,8000,4751,1,00335,India
371800,2023-12-13,501,iphone 15,60000,80000,20000,1,00335,India
371800,2023-12-13,502,iphone 15 pro max,100000,135000,35000,1,00335,India
611193,2023-12-13,507,washing machine,6990,16490,9500,1,00305,India
611193,2023-12-13,503,mixer,1349,3249,1900,1,00305,India
611193,2023-12-13,504,iron,449,879,430,1,00305,India
611193,2023-12-13,501,iphone 15,60000,80000,20000,1,00305,India
691241,2023-12-13,501,iphone 15,60000,80000,20000,1,00371,India
691241,2023-12-13,502,iphone 15 pro max,100000,135000,35000,1,00371,India
691241,2023-12-13,505,oven,18490,24000,5510,1,00371,India
691241,2023-12-13,506,monitor,3249,8000,4751,1,00371,India
806990,2023-12-13,503,mixer,1349,3249,1900,1,00128,India
806990,2023-12-13,501,iphone 15,60000,80000,20000,1,00128,India
524586,2023-12-13,503,mixer,1349,3249,1900,1,00472,India
524586,2023-12-13,502,iphone 15 pro max,100000,135000,35000,1,00472,India
560347,2023-12-13,501,iphone 15,60000,80000,20000,1,00250,India
560347,2023-12-13,504,iron,449,879,430,1,00250,India
791606,2023-12-13,501,iphone 15,60000,80000,20000,1,00221,India
791606,2023-12-13,505,oven,18490,24000,5510,1,00221,India
791606,2023-12-13,502,iphone 15 pro max,100000,135000,35000,1,00221,India
791606,2023-12-13,503,mixer,1349,3249,1900,1,00221,India
353183,2023-12-13,502,iphone 15 pro max,100000,135000,35000,1,00038,India
580436,2023-12-13,502,iphone 15 pro max,100000,135000,35000,1,00419,India
126192,2023-12-13,501,iphone 15,60000,80000,20000,1,00120,India
126192,2023-12-13,502,iphone 15 pro max,100000,135000,35000,1,00120,India
126192,2023-12-13,504,iron,449,879,430,1,00120,India
602692,2023-12-13,502,iphone 15 pro max,100000,135000,35000,1,00297,India
602692,2023-12-13,504,iron,449,879,430,1,00297,India
602692,2023-12-13,501,iphone 15,60000,80000,20000,1,00297,India
586814,2023-12-13,502,iphone 15 pro max,100000,135000,35000,1,00486,India
586814,2023-12-13,504,iron,449,879,430,1,00486,India
955762,2023-12-13,503,mixer,1349,3249,1900,1,00094,India
492006,2023-12-13,507,washing machine,6990,16490,9500,1,00061,India
207349,2023-12-13,501,iphone 15,60000,80000,20000,1,00238,India
207349,2023-12-13,503,mixer,1349,3249,1900,1,00238,India
207349,2023-12-13,502,iphone 15 pro max,100000,135000,35000,1,00238,India
207349,2023-12-13,505,oven,18490,24000,5510,1,00238,India
207349,2023-12-13,504,iron,449,879,430,1,00238,India
582135,2023-12-13,502,iphone 15 pro max,100000,135000,35000,1,00500,India
471693,2023-12-13,507,washing machine,6990,16490,9500,1,00288,India
471693,2023-12-13,501,iphone 15,60000,80000,20000,1,00288,India
471693,2023-12-13,505,oven,18490,24000,5510,1,00288,India
471693,2023-12-13,503,mixer,1349,3249,1900,1,00288,India
907310,2023-12-13,503,mixer,1349,3249,1900,1,00304,India
907310,2023-12-13,504,iron,449,879,430,1,00304,India
907310,2023-12-13,501,iphone 15,60000,80000,20000,1,00304,India
923801,2023-12-13,506,monitor,3249,8000,4751,1,00185,India
750082,2023-12-13,502,iphone 15 pro max,100000,135000,35000,1,00421,India
750082,2023-12-13,507,washing machine,6990,16490,9500,1,00421,India
750082,2023-12-13,505,oven,18490,24000,5510,1,00421,India
750082,2023-12-13,501,iphone 15,60000,80000,20000,1,00421,India
750082,2023-12-13,503,mixer,1349,3249,1900,1,00421,India
913897,2023-12-13,506,monitor,3249,8000,4751,1,00155,India
913897,2023-12-13,501,iphone 15,60000,80000,20000,1,00155,India
913897,2023-12-13,504,iron,449,879,430,1,00155,India
402555,2023-12-13,505,oven,18490,24000,5510,1,00049,India
402555,2023-12-13,507,washing machine,6990,16490,9500,1,00049,India
402555,2023-12-13,502,iphone 15 pro max,100000,135000,35000,1,00049,India
203634,2023-12-13,501,iphone 15,60000,80000,20000,1,00039,India
596138,2023-12-13,505,oven,18490,24000,5510,1,00085,India
596138,2023-12-13,506,monitor,3249,8000,4751,1,00085,India
596138,2023-12-13,507,washing machine,6990,16490,9500,1,00085,India
596138,2023-12-13,501,iphone 15,60000,80000,20000,1,00085,India
710242,2023-12-13,501,iphone 15,60000,80000,20000,1,00099,India
710242,2023-12-13,507,washing machine,6990,16490,9500,1,00099,India
404346,2023-12-13,503,mixer,1349,3249,1900,1,00149,India
404346,2023-12-13,506,monitor,3249,8000,4751,1,00149,India
404346,2023-12-13,501,iphone 15,60000,80000,20000,1,00149,India
404346,2023-12-13,507,washing machine,6990,16490,9500,1,00149,India
558436,2023-12-13,505,oven,18490,24000,5510,1,00128,India
558436,2023-12-13,501,iphone 15,60000,80000,20000,1,00128,India
558436,2023-12-13,504,iron,449,879,430,1,00128,India
970375,2023-12-13,502,iphone 15 pro max,100000,135000,35000,1,00314,India
426179,2023-12-13,504,iron,449,879,430,1,00173,India
426179,2023-12-13,503,mixer,1349,3249,1900,1,00173,India
426179,2023-12-13,502,iphone 15 pro max,100000,135000,35000,1,00173,India
562816,2023-12-13,502,iphone 15 pro max,100000,135000,35000,1,00424,India
562816,2023-12-13,504,iron,449,879,430,1,00424,India
562816,2023-12-13,503,mixer,1349,3249,1900,1,00424,India
258414,2023-12-13,506,monitor,3249,8000,4751,1,00112,India
258414,2023-12-13,501,iphone 15,60000,80000,20000,1,00112,India
565594,2023-12-13,501,iphone 15,60000,80000,20000,1,00445,India
565594,2023-12-13,503,mixer,1349,3249,1900,1,00445,India
565594,2023-12-13,507,washing machine,6990,16490,9500,1,00445,India
754878,2023-12-13,501,iphone 15,60000,80000,20000,1,00329,India
754878,2023-12-13,507,washing machine,6990,16490,9500,1,00329,India
754878,2023-12-13,505,oven,18490,24000,5510,1,00329,India
905497,2023-12-13,503,mixer,1349,3249,1900,1,00018,India
349292,2023-12-13,504,iron,449,879,430,1,00120,India
349292,2023-12-13,505,oven,18490,24000,5510,1,00120,India
905378,2023-12-13,507,washing machine,6990,16490,9500,1,00366,India
905378,2023-12-13,502,iphone 15 pro max,100000,135000,35000,1,00366,India
179991,2023-12-13,503,mixer,1349,3249,1900,1,00433,India
249021,2023-12-13,503,mixer,1349,3249,1900,1,00344,India
249021,2023-12-13,504,iron,449,879,430,1,00344,India
249021,2023-12-13,501,iphone 15,60000,80000,20000,1,00344,India
571890,2023-12-13,502,iphone 15 pro max,100000,135000,35000,1,00408,India
571890,2023-12-13,507,washing machine,6990,16490,9500,1,00408,India
571890,2023-12-13,505,oven,18490,24000,5510,1,00408,India
688982,2023-12-13,505,oven,18490,24000,5510,1,00077,India
688982,2023-12-13,503,mixer,1349,3249,1900,1,00077,India
989647,2023-12-13,507,washing machine,6990,16490,9500,1,00182,India
989647,2023-12-13,505,oven,18490,24000,5510,1,00182,India
965746,2023-12-13,506,monitor,3249,8000,4751,1,00333,India
506084,2023-12-13,507,washing machine,6990,16490,9500,1,00054,India
468107,2023-12-13,506,monitor,3249,8000,4751,1,00362,India
397081,2023-12-13,504,iron,449,879,430,1,00210,India
397081,2023-12-13,503,mixer,1349,3249,1900,1,00210,India
397081,2023-12-13,502,iphone 15 pro max,100000,135000,35000,1,00210,India
835665,2023-12-13,503,mixer,1349,3249,1900,1,00380,India
835665,2023-12-13,501,iphone 15,60000,80000,20000,1,00380,India
835665,2023-12-13,507,washing machine,6990,16490,9500,1,00380,India
135789,2023-12-13,506,monitor,3249,8000,4751,1,00462,India
807369,2023-12-13,505,oven,18490,24000,5510,1,00402,India
807369,2023-12-13,507,washing machine,6990,16490,9500,1,00402,India
807369,2023-12-13,506,monitor,3249,8000,4751,1,00402,India
807369,2023-12-13,501,iphone 15,60000,80000,20000,1,00402,India
211094,2023-12-13,504,iron,449,879,430,1,00241,India
890771,2023-12-13,503,mixer,1349,3249,1900,1,00219,India
890771,2023-12-13,502,iphone 15 pro max,100000,135000,35000,1,00219,India
890771,2023-12-13,505,oven,18490,24000,5510,1,00219,India
964546,2023-12-13,504,iron,449,879,430,1,00194,India
964546,2023-12-13,506,monitor,3249,8000,4751,1,00194,India
773502,2023-12-13,506,monitor,3249,8000,4751,1,00007,India
773502,2023-12-13,501,iphone 15,60000,80000,20000,1,00007,India
244033,2023-12-13,506,monitor,3249,8000,4751,1,00197,India
244033,2023-12-13,504,iron,449,879,430,1,00197,India
299542,2023-12-13,503,mixer,1349,3249,1900,1,00126,India
299542,2023-12-13,502,iphone 15 pro max,100000,135000,35000,1,00126,India
299542,2023-12-13,501,iphone 15,60000,80000,20000,1,00126,India
522872,2023-12-13,506,monitor,3249,8000,4751,1,00266,India
256597,2023-12-13,505,oven,18490,24000,5510,1,00212,India
966495,2023-12-13,502,iphone 15 pro max,100000,135000,35000,1,00402,India
966495,2023-12-13,501,iphone 15,60000,80000,20000,1,00402,India
966495,2023-12-13,507,washing machine,6990,16490,9500,1,00402,India
966495,2023-12-13,505,oven,18490,24000,5510,1,00402,India
777389,2023-12-13,501,iphone 15,60000,80000,20000,1,00189,India
777389,2023-12-13,503,mixer,1349,3249,1900,1,00189,India
777389,2023-12-13,502,iphone 15 pro max,100000,135000,35000,1,00189,India
777389,2023-12-13,506,monitor,3249,8000,4751,1,00189,India
777389,2023-12-13,507,washing machine,6990,16490,9500,1,00189,India
401809,2023-12-13,506,monitor,3249,8000,4751,1,00420,India
401809,2023-12-13,507,washing machine,6990,16490,9500,1,00420,India
320054,2023-12-13,506,monitor,3249,8000,4751,1,00004,India
320054,2023-12-13,504,iron,449,879,430,1,00004,India
320054,2023-12-13,501,iphone 15,60000,80000,20000,1,00004,India
660760,2023-12-13,501,iphone 15,60000,80000,20000,1,00323,India
660760,2023-12-13,504,iron,449,879,430,1,00323,India
660760,2023-12-13,507,washing machine,6990,16490,9500,1,00323,India
660760,2023-12-13,502,iphone 15 pro max,100000,135000,35000,1,00323,India
359749,2023-12-13,506,monitor,3249,8000,4751,1,00235,India
359749,2023-12-13,502,iphone 15 pro max,100000,135000,35000,1,00235,India
359749,2023-12-13,504,iron,449,879,430,1,00235,India
942479,2023-12-13,505,oven,18490,24000,5510,1,00408,India
691154,2023-12-13,505,oven,18490,24000,5510,1,00149,India
691154,2023-12-13,504,iron,449,879,430,1,00149,India
691154,2023-12-13,501,iphone 15,60000,80000,20000,1,00149,India
421567,2023-12-13,505,oven,18490,24000,5510,1,00161,India
421567,2023-12-13,502,iphone 15 pro max,100000,135000,35000,1,00161,India
421567,2023-12-13,506,monitor,3249,8000,4751,1,00161,India
992261,2023-12-13,503,mixer,1349,3249,1900,1,00083,India
345383,2023-12-13,503,mixer,1349,3249,1900,1,00065,India
345383,2023-12-13,505,oven,18490,24000,5510,1,00065,India
607718,2023-12-13,502,iphone 15 pro max,100000,135000,35000,1,00012,India
607718,2023-12-13,503,mixer,1349,3249,1900,1,00012,India
864225,2023-12-13,506,monitor,3249,8000,4751,1,00186,India
864225,2023-12-13,504,iron,449,879,430,1,00186,India
864225,2023-12-13,507,washing machine,6990,16490,9500,1,00186,India
864225,2023-12-13,501,iphone 15,60000,80000,20000,1,00186,India
397148,2023-12-14,505,oven,18490,24000,5510,1,00073,India
397148,2023-12-14,501,iphone 15,60000,80000,20000,1,00073,India
397148,2023-12-14,502,iphone 15 pro max,100000,135000,35000,1,00073,India
397148,2023-12-14,507,washing machine,6990,16490,9500,1,00073,India
349765,2023-12-14,504,iron,449,879,430,1,00174,India
349765,2023-12-14,503,mixer,1349,3249,1900,1,00174,India
534519,2023-12-14,506,monitor,3249,8000,4751,1,00168,India
534519,2023-12-14,504,iron,449,879,430,1,00168,India
430677,2023-12-14,506,monitor,3249,8000,4751,1,00325,India
430677,2023-12-14,503,mixer,1349,3249,1900,1,00325,India
265074,2023-12-14,507,washing machine,6990,16490,9500,1,00491,India
265074,2023-12-14,502,iphone 15 pro max,100000,135000,35000,1,00491,India
265074,2023-12-14,503,mixer,1349,3249,1900,1,00491,India
265074,2023-12-14,506,monitor,3249,8000,4751,1,00491,India
266995,2023-12-14,503,mixer,1349,3249,1900,1,00405,India
266995,2023-12-14,501,iphone 15,60000,80000,20000,1,00405,India
652279,2023-12-14,501,iphone 15,60000,80000,20000,1,00003,India
652279,2023-12-14,504,iron,449,879,430,1,00003,India
652279,2023-12-14,503,mixer,1349,3249,1900,1,00003,India
391919,2023-12-14,502,iphone 15 pro max,100000,135000,35000,1,00134,India
391919,2023-12-14,504,iron,449,879,430,1,00134,India
391919,2023-12-14,506,monitor,3249,8000,4751,1,00134,India
752952,2023-12-14,501,iphone 15,60000,80000,20000,1,00386,India
752952,2023-12-14,506,monitor,3249,8000,4751,1,00386,India
752952,2023-12-14,503,mixer,1349,3249,1900,1,00386,India
752952,2023-12-14,505,oven,18490,24000,5510,1,00386,India
916937,2023-12-14,501,iphone 15,60000,80000,20000,1,00449,India
916937,2023-12-14,505,oven,18490,24000,5510,1,00449,India
916937,2023-12-14,503,mixer,1349,3249,1900,1,00449,India
899677,2023-12-14,504,iron,449,879,430,1,00331,India
899677,2023-12-14,502,iphone 15 pro max,100000,135000,35000,1,00331,India
652050,2023-12-14,504,iron,449,879,430,1,00377,India
652050,2023-12-14,501,iphone 15,60000,80000,20000,1,00377,India
604435,2023-12-14,505,oven,18490,24000,5510,1,00003,India
604435,2023-12-14,507,washing machine,6990,16490,9500,1,00003,India
604435,2023-12-14,503,mixer,1349,3249,1900,1,00003,India
168364,2023-12-14,503,mixer,1349,3249,1900,1,00392,India
168364,2023-12-14,502,iphone 15 pro max,100000,135000,35000,1,00392,India
168364,2023-12-14,507,washing machine,6990,16490,9500,1,00392,India
487619,2023-12-14,502,iphone 15 pro max,100000,135000,35000,1,00439,India
487619,2023-12-14,505,oven,18490,24000,5510,1,00439,India
822431,2023-12-14,506,monitor,3249,8000,4751,1,00249,India
982316,2023-12-14,506,monitor,3249,8000,4751,1,00026,India
982316,2023-12-14,502,iphone 15 pro max,100000,135000,35000,1,00026,India
532701,2023-12-14,506,monitor,3249,8000,4751,1,00235,India
194458,2023-12-14,507,washing machine,6990,16490,9500,1,00253,India
194458,2023-12-14,506,monitor,3249,8000,4751,1,00253,India
194458,2023-12-14,502,iphone 15 pro max,100000,135000,35000,1,00253,India
759840,2023-12-14,504,iron,449,879,430,1,00097,India
759840,2023-12-14,505,oven,18490,24000,5510,1,00097,India
437314,2023-12-14,503,mixer,1349,3249,1900,1,00256,India
437314,2023-12-14,504,iron,449,879,430,1,00256,India
437314,2023-12-14,506,monitor,3249,8000,4751,1,00256,India
480112,2023-12-14,503,mixer,1349,3249,1900,1,00124,India
480112,2023-12-14,505,oven,18490,24000,5510,1,00124,India
480112,2023-12-14,502,iphone 15 pro max,100000,135000,35000,1,00124,India
480112,2023-12-14,504,iron,449,879,430,1,00124,India
480112,2023-12-14,507,washing machine,6990,16490,9500,1,00124,India
887683,2023-12-14,501,iphone 15,60000,80000,20000,1,00070,India
887683,2023-12-14,503,mixer,1349,3249,1900,1,00070,India
887683,2023-12-14,502,iphone 15 pro max,100000,135000,35000,1,00070,India
748475,2023-12-14,502,iphone 15 pro max,100000,135000,35000,1,00364,India
748475,2023-12-14,506,monitor,3249,8000,4751,1,00364,India
748475,2023-12-14,507,washing machine,6990,16490,9500,1,00364,India
365087,2023-12-14,506,monitor,3249,8000,4751,1,00291,India
365087,2023-12-14,504,iron,449,879,430,1,00291,India
621138,2023-12-14,501,iphone 15,60000,80000,20000,1,00123,India
100916,2023-12-14,505,oven,18490,24000,5510,1,00246,India
100916,2023-12-14,502,iphone 15 pro max,100000,135000,35000,1,00246,India
100916,2023-12-14,501,iphone 15,60000,80000,20000,1,00246,India
181798,2023-12-14,501,iphone 15,60000,80000,20000,1,00297,India
181798,2023-12-14,505,oven,18490,24000,5510,1,00297,India
181798,2023-12-14,507,washing machine,6990,16490,9500,1,00297,India
227579,2023-12-14,502,iphone 15 pro max,100000,135000,35000,1,00096,India
755462,2023-12-14,501,iphone 15,60000,80000,20000,1,00305,India
755462,2023-12-14,506,monitor,3249,8000,4751,1,00305,India
755462,2023-12-14,503,mixer,1349,3249,1900,1,00305,India
916178,2023-12-14,507,washing machine,6990,16490,9500,1,00019,India
916178,2023-12-14,505,oven,18490,24000,5510,1,00019,India
916178,2023-12-14,503,mixer,1349,3249,1900,1,00019,India
916178,2023-12-14,501,iphone 15,60000,80000,20000,1,00019,India
703865,2023-12-14,504,iron,449,879,430,1,00208,India
703865,2023-12-14,506,monitor,3249,8000,4751,1,00208,India
247275,2023-12-14,505,oven,18490,24000,5510,1,00078,India
247275,2023-12-14,507,washing machine,6990,16490,9500,1,00078,India
247275,2023-12-14,506,monitor,3249,8000,4751,1,00078,India
247275,2023-12-14,501,iphone 15,60000,80000,20000,1,00078,India
428963,2023-12-14,506,monitor,3249,8000,4751,1,00075,India
428963,2023-12-14,501,iphone 15,60000,80000,20000,1,00075,India
808159,2023-12-14,503,mixer,1349,3249,1900,1,00435,India
808159,2023-12-14,506,monitor,3249,8000,4751,1,00435,India
808159,2023-12-14,501,iphone 15,60000,80000,20000,1,00435,India
186692,2023-12-14,503,mixer,1349,3249,1900,1,00379,India
186692,2023-12-14,504,iron,449,879,430,1,00379,India
186692,2023-12-14,507,washing machine,6990,16490,9500,1,00379,India
186692,2023-12-14,502,iphone 15 pro max,100000,135000,35000,1,00379,India
599570,2023-12-14,506,monitor,3249,8000,4751,1,00490,India
599570,2023-12-14,507,washing machine,6990,16490,9500,1,00490,India
514259,2023-12-14,505,oven,18490,24000,5510,1,00314,India
514259,2023-12-14,503,mixer,1349,3249,1900,1,00314,India
514259,2023-12-14,507,washing machine,6990,16490,9500,1,00314,India
826142,2023-12-14,505,oven,18490,24000,5510,1,00010,India
137101,2023-12-14,507,washing machine,6990,16490,9500,1,00346,India
137101,2023-12-14,505,oven,18490,24000,5510,1,00346,India
137101,2023-12-14,501,iphone 15,60000,80000,20000,1,00346,India
137101,2023-12-14,503,mixer,1349,3249,1900,1,00346,India
104969,2023-12-14,506,monitor,3249,8000,4751,1,00417,India
104969,2023-12-14,503,mixer,1349,3249,1900,1,00417,India
104969,2023-12-14,501,iphone 15,60000,80000,20000,1,00417,India
727814,2023-12-14,504,iron,449,879,430,1,00151,India
892915,2023-12-14,501,iphone 15,60000,80000,20000,1,00333,India
892915,2023-12-14,506,monitor,3249,8000,4751,1,00333,India
892915,2023-12-14,504,iron,449,879,430,1,00333,India
277657,2023-12-14,503,mixer,1349,3249,1900,1,00294,India
277657,2023-12-14,502,iphone 15 pro max,100000,135000,35000,1,00294,India
831041,2023-12-14,506,monitor,3249,8000,4751,1,00140,India
831041,2023-12-14,504,iron,449,879,430,1,00140,India
831041,2023-12-14,505,oven,18490,24000,5510,1,00140,India
648347,2023-12-14,505,oven,18490,24000,5510,1,00403,India
648347,2023-12-14,501,iphone 15,60000,80000,20000,1,00403,India
648347,2023-12-14,503,mixer,1349,3249,1900,1,00403,India
664343,2023-12-14,506,monitor,3249,8000,4751,1,00124,India
664343,2023-12-14,505,oven,18490,24000,5510,1,00124,India
664343,2023-12-14,501,iphone 15,60000,80000,20000,1,00124,India
102965,2023-12-14,506,monitor,3249,8000,4751,1,00213,India
102965,2023-12-14,505,oven,18490,24000,5510,1,00213,India
102965,2023-12-14,501,iphone 15,60000,80000,20000,1,00213,India
102965,2023-12-14,507,washing machine,6990,16490,9500,1,00213,India
102965,2023-12-14,504,iron,449,879,430,1,00213,India
352247,2023-12-14,506,monitor,3249,8000,4751,1,00230,India
352247,2023-12-14,505,oven,18490,24000,5510,1,00230,India
352247,2023-12-14,503,mixer,1349,3249,1900,1,00230,India
858650,2023-12-14,507,washing machine,6990,16490,9500,1,00312,India
858650,2023-12-14,503,mixer,1349,3249,1900,1,00312,India
858650,2023-12-14,504,iron,449,879,430,1,00312,India
720205,2023-12-14,507,washing machine,6990,16490,9500,1,00500,India
720205,2023-12-14,502,iphone 15 pro max,100000,135000,35000,1,00500,India
720205,2023-12-14,501,iphone 15,60000,80000,20000,1,00500,India
720205,2023-12-14,504,iron,449,879,430,1,00500,India
517239,2023-12-14,503,mixer,1349,3249,1900,1,00079,India
517239,2023-12-14,506,monitor,3249,8000,4751,1,00079,India
517239,2023-12-14,507,washing machine,6990,16490,9500,1,00079,India
415682,2023-12-14,504,iron,449,879,430,1,00430,India
415682,2023-12-14,505,oven,18490,24000,5510,1,00430,India
415682,2023-12-14,502,iphone 15 pro max,100000,135000,35000,1,00430,India
983570,2023-12-14,503,mixer,1349,3249,1900,1,00127,India
983570,2023-12-14,507,washing machine,6990,16490,9500,1,00127,India
983570,2023-12-14,504,iron,449,879,430,1,00127,India
877839,2023-12-14,504,iron,449,879,430,1,00128,India
877839,2023-12-14,506,monitor,3249,8000,4751,1,00128,India
492976,2023-12-14,503,mixer,1349,3249,1900,1,00392,India
132205,2023-12-14,503,mixer,1349,3249,1900,1,00413,India
132205,2023-12-14,502,iphone 15 pro max,100000,135000,35000,1,00413,India
132205,2023-12-14,501,iphone 15,60000,80000,20000,1,00413,India
348352,2023-12-14,502,iphone 15 pro max,100000,135000,35000,1,00293,India
348352,2023-12-14,505,oven,18490,24000,5510,1,00293,India
348352,2023-12-14,507,washing machine,6990,16490,9500,1,00293,India
348352,2023-12-14,501,iphone 15,60000,80000,20000,1,00293,India
486237,2023-12-14,502,iphone 15 pro max,100000,135000,35000,1,00007,India
486237,2023-12-14,501,iphone 15,60000,80000,20000,1,00007,India
486237,2023-12-14,505,oven,18490,24000,5510,1,00007,India
737887,2023-12-14,502,iphone 15 pro max,100000,135000,35000,1,00139,India
649104,2023-12-14,505,oven,18490,24000,5510,1,00186,India
649104,2023-12-14,502,iphone 15 pro max,100000,135000,35000,1,00186,India
649104,2023-12-14,503,mixer,1349,3249,1900,1,00186,India
975897,2023-12-15,502,iphone 15 pro max,100000,135000,35000,1,00284,India
815801,2023-12-15,507,washing machine,6990,16490,9500,1,00048,India
815801,2023-12-15,505,oven,18490,24000,5510,1,00048,India
815801,2023-12-15,501,iphone 15,60000,80000,20000,1,00048,India
815801,2023-12-15,502,iphone 15 pro max,100000,135000,35000,1,00048,India
450743,2023-12-15,505,oven,18490,24000,5510,1,00391,India
450743,2023-12-15,506,monitor,3249,8000,4751,1,00391,India
450743,2023-12-15,504,iron,449,879,430,1,00391,India
997024,2023-12-15,504,iron,449,879,430,1,00452,India
997024,2023-12-15,502,iphone 15 pro max,100000,135000,35000,1,00452,India
997024,2023-12-15,507,washing machine,6990,16490,9500,1,00452,India
761004,2023-12-15,506,monitor,3249,8000,4751,1,00050,India
761004,2023-12-15,501,iphone 15,60000,80000,20000,1,00050,India
761004,2023-12-15,502,iphone 15 pro max,100000,135000,35000,1,00050,India
998246,2023-12-15,501,iphone 15,60000,80000,20000,1,00444,India
998246,2023-12-15,503,mixer,1349,3249,1900,1,00444,India
403731,2023-12-15,506,monitor,3249,8000,4751,1,00105,India
403731,2023-12-15,507,washing machine,6990,16490,9500,1,00105,India
516992,2023-12-15,504,iron,449,879,430,1,00306,India
516992,2023-12-15,503,mixer,1349,3249,1900,1,00306,India
516992,2023-12-15,502,iphone 15 pro max,100000,135000,35000,1,00306,India
501302,2023-12-15,504,iron,449,879,430,1,00292,India
501302,2023-12-15,502,iphone 15 pro max,100000,135000,35000,1,00292,India
501302,2023-12-15,506,monitor,3249,8000,4751,1,00292,India
501302,2023-12-15,505,oven,18490,24000,5510,1,00292,India
545145,2023-12-15,503,mixer,1349,3249,1900,1,00361,India
330073,2023-12-15,506,monitor,3249,8000,4751,1,00447,India
330073,2023-12-15,507,washing machine,6990,16490,9500,1,00447,India
330073,2023-12-15,505,oven,18490,24000,5510,1,00447,India
330073,2023-12-15,501,iphone 15,60000,80000,20000,1,00447,India
670537,2023-12-15,501,iphone 15,60000,80000,20000,1,00134,India
670537,2023-12-15,502,iphone 15 pro max,100000,135000,35000,1,00134,India
670537,2023-12-15,503,mixer,1349,3249,1900,1,00134,India
749644,2023-12-15,505,oven,18490,24000,5510,1,00252,India
749644,2023-12-15,507,washing machine,6990,16490,9500,1,00252,India
370727,2023-12-15,505,oven,18490,24000,5510,1,00468,India
370727,2023-12-15,501,iphone 15,60000,80000,20000,1,00468,India
744164,2023-12-15,502,iphone 15 pro max,100000,135000,35000,1,00441,India
744164,2023-12-15,507,washing machine,6990,16490,9500,1,00441,India
781792,2023-12-15,501,iphone 15,60000,80000,20000,1,00484,India
781792,2023-12-15,503,mixer,1349,3249,1900,1,00484,India
239472,2023-12-15,507,washing machine,6990,16490,9500,1,00222,India
239472,2023-12-15,501,iphone 15,60000,80000,20000,1,00222,India
239472,2023-12-15,504,iron,449,879,430,1,00222,India
239472,2023-12-15,505,oven,18490,24000,5510,1,00222,India
239472,2023-12-15,506,monitor,3249,8000,4751,1,00222,India
512255,2023-12-15,504,iron,449,879,430,1,00066,India
332514,2023-12-15,504,iron,449,879,430,1,00414,India
332514,2023-12-15,505,oven,18490,24000,5510,1,00414,India
332514,2023-12-15,502,iphone 15 pro max,100000,135000,35000,1,00414,India
576787,2023-12-15,504,iron,449,879,430,1,00173,India
576787,2023-12-15,505,oven,18490,24000,5510,1,00173,India
576787,2023-12-15,502,iphone 15 pro max,100000,135000,35000,1,00173,India
459718,2023-12-15,506,monitor,3249,8000,4751,1,00301,India
459718,2023-12-15,502,iphone 15 pro max,100000,135000,35000,1,00301,India
459718,2023-12-15,504,iron,449,879,430,1,00301,India
229644,2023-12-15,504,iron,449,879,430,1,00049,India
518025,2023-12-15,503,mixer,1349,3249,1900,1,00106,India
518025,2023-12-15,502,iphone 15 pro max,100000,135000,35000,1,00106,India
518025,2023-12-15,501,iphone 15,60000,80000,20000,1,00106,India
548147,2023-12-15,506,monitor,3249,8000,4751,1,00422,India
548147,2023-12-15,504,iron,449,879,430,1,00422,India
548147,2023-12-15,507,washing machine,6990,16490,9500,1,00422,India
285897,2023-12-15,504,iron,449,879,430,1,00305,India
146481,2023-12-15,501,iphone 15,60000,80000,20000,1,00160,India
146481,2023-12-15,506,monitor,3249,8000,4751,1,00160,India
887785,2023-12-15,506,monitor,3249,8000,4751,1,00376,India
887785,2023-12-15,507,washing machine,6990,16490,9500,1,00376,India
887785,2023-12-15,502,iphone 15 pro max,100000,135000,35000,1,00376,India
887785,2023-12-15,505,oven,18490,24000,5510,1,00376,India
291535,2023-12-15,504,iron,449,879,430,1,00447,India
291535,2023-12-15,507,washing machine,6990,16490,9500,1,00447,India
291535,2023-12-15,506,monitor,3249,8000,4751,1,00447,India
291535,2023-12-15,505,oven,18490,24000,5510,1,00447,India
242825,2023-12-15,502,iphone 15 pro max,100000,135000,35000,1,00088,India
242825,2023-12-15,506,monitor,3249,8000,4751,1,00088,India
859792,2023-12-15,504,iron,449,879,430,1,00439,India
859792,2023-12-15,505,oven,18490,24000,5510,1,00439,India
444051,2023-12-15,505,oven,18490,24000,5510,1,00435,India
444051,2023-12-15,501,iphone 15,60000,80000,20000,1,00435,India
444051,2023-12-15,504,iron,449,879,430,1,00435,India
458830,2023-12-15,506,monitor,3249,8000,4751,1,00338,India
458830,2023-12-15,502,iphone 15 pro max,100000,135000,35000,1,00338,India
458830,2023-12-15,501,iphone 15,60000,80000,20000,1,00338,India
458830,2023-12-15,504,iron,449,879,430,1,00338,India
983761,2023-12-15,506,monitor,3249,8000,4751,1,00351,India
983761,2023-12-15,507,washing machine,6990,16490,9500,1,00351,India
983761,2023-12-15,504,iron,449,879,430,1,00351,India
983761,2023-12-15,505,oven,18490,24000,5510,1,00351,India
488796,2023-12-15,505,oven,18490,24000,5510,1,00381,India
488796,2023-12-15,504,iron,449,879,430,1,00381,India
488796,2023-12-15,506,monitor,3249,8000,4751,1,00381,India
720449,2023-12-15,503,mixer,1349,3249,1900,1,00482,India
454957,2023-12-15,507,washing machine,6990,16490,9500,1,00005,India
454957,2023-12-15,504,iron,449,879,430,1,00005,India
653703,2023-12-15,506,monitor,3249,8000,4751,1,00354,India
653703,2023-12-15,501,iphone 15,60000,80000,20000,1,00354,India
653703,2023-12-15,507,washing machine,6990,16490,9500,1,00354,India
112365,2023-12-15,501,iphone 15,60000,80000,20000,1,00044,India
112365,2023-12-15,507,washing machine,6990,16490,9500,1,00044,India
112365,2023-12-15,506,monitor,3249,8000,4751,1,00044,India
112365,2023-12-15,503,mixer,1349,3249,1900,1,00044,India
384184,2023-12-15,504,iron,449,879,430,1,00050,India
284865,2023-12-15,503,mixer,1349,3249,1900,1,00069,India
662926,2023-12-15,501,iphone 15,60000,80000,20000,1,00193,India
662926,2023-12-15,507,washing machine,6990,16490,9500,1,00193,India
662926,2023-12-15,502,iphone 15 pro max,100000,135000,35000,1,00193,India
714118,2023-12-15,507,washing machine,6990,16490,9500,1,00206,India
714118,2023-12-15,501,iphone 15,60000,80000,20000,1,00206,India
714118,2023-12-15,503,mixer,1349,3249,1900,1,00206,India
645405,2023-12-15,507,washing machine,6990,16490,9500,1,00171,India
429552,2023-12-15,507,washing machine,6990,16490,9500,1,00211,India
429552,2023-12-15,501,iphone 15,60000,80000,20000,1,00211,India
875867,2023-12-15,504,iron,449,879,430,1,00176,India
875867,2023-12-15,501,iphone 15,60000,80000,20000,1,00176,India
844337,2023-12-15,505,oven,18490,24000,5510,1,00435,India
844337,2023-12-15,506,monitor,3249,8000,4751,1,00435,India
844337,2023-12-15,504,iron,449,879,430,1,00435,India
366190,2023-12-15,505,oven,18490,24000,5510,1,00142,India
366190,2023-12-15,506,monitor,3249,8000,4751,1,00142,India
708892,2023-12-15,506,monitor,3249,8000,4751,1,00119,India
344717,2023-12-15,504,iron,449,879,430,1,00077,India
344717,2023-12-15,505,oven,18490,24000,5510,1,00077,India
344717,2023-12-15,501,iphone 15,60000,80000,20000,1,00077,India
344717,2023-12-15,507,washing machine,6990,16490,9500,1,00077,India
344717,2023-12-15,506,monitor,3249,8000,4751,1,00077,India
250269,2023-12-15,506,monitor,3249,8000,4751,1,00407,India
805257,2023-12-15,507,washing machine,6990,16490,9500,1,00168,India
805257,2023-12-15,501,iphone 15,60000,80000,20000,1,00168,India
654573,2023-12-15,504,iron,449,879,430,1,00094,India
654573,2023-12-15,506,monitor,3249,8000,4751,1,00094,India
654573,2023-12-15,503,mixer,1349,3249,1900,1,00094,India
284083,2023-12-15,503,mixer,1349,3249,1900,1,00007,India
284083,2023-12-15,504,iron,449,879,430,1,00007,India
284083,2023-12-15,507,washing machine,6990,16490,9500,1,00007,India
777193,2023-12-15,501,iphone 15,60000,80000,20000,1,00122,India
777193,2023-12-15,505,oven,18490,24000,5510,1,00122,India
777193,2023-12-15,504,iron,449,879,430,1,00122,India
911543,2023-12-15,504,iron,449,879,430,1,00491,India
911543,2023-12-15,506,monitor,3249,8000,4751,1,00491,India
940918,2023-12-15,507,washing machine,6990,16490,9500,1,00097,India
940918,2023-12-15,502,iphone 15 pro max,100000,135000,35000,1,00097,India
429717,2023-12-15,503,mixer,1349,3249,1900,1,00412,India
429717,2023-12-15,505,oven,18490,24000,5510,1,00412,India
429717,2023-12-15,502,iphone 15 pro max,100000,135000,35000,1,00412,India
860117,2023-12-15,507,washing machine,6990,16490,9500,1,00466,India
860117,2023-12-15,505,oven,18490,24000,5510,1,00466,India
930017,2023-12-15,505,oven,18490,24000,5510,1,00252,India
930017,2023-12-15,502,iphone 15 pro max,100000,135000,35000,1,00252,India
930017,2023-12-15,503,mixer,1349,3249,1900,1,00252,India
930017,2023-12-15,504,iron,449,879,430,1,00252,India
128291,2023-12-15,503,mixer,1349,3249,1900,1,00299,India
162256,2023-12-15,503,mixer,1349,3249,1900,1,00473,India
162256,2023-12-15,505,oven,18490,24000,5510,1,00473,India
499745,2023-12-15,502,iphone 15 pro max,100000,135000,35000,1,00111,India
499745,2023-12-15,504,iron,449,879,430,1,00111,India
347177,2023-12-15,507,washing machine,6990,16490,9500,1,00191,India
794970,2023-12-15,506,monitor,3249,8000,4751,1,00451,India
794970,2023-12-15,502,iphone 15 pro max,100000,135000,35000,1,00451,India
566339,2023-12-15,501,iphone 15,60000,80000,20000,1,00105,India
566339,2023-12-15,503,mixer,1349,3249,1900,1,00105,India
566339,2023-12-15,506,monitor,3249,8000,4751,1,00105,India
566339,2023-12-15,502,iphone 15 pro max,100000,135000,35000,1,00105,India
272978,2023-12-15,501,iphone 15,60000,80000,20000,1,00391,India
272978,2023-12-15,503,mixer,1349,3249,1900,1,00391,India
272978,2023-12-15,507,washing machine,6990,16490,9500,1,00391,India
272978,2023-12-15,506,monitor,3249,8000,4751,1,00391,India
110326,2023-12-15,501,iphone 15,60000,80000,20000,1,00124,India
110326,2023-12-15,506,monitor,3249,8000,4751,1,00124,India
120928,2023-12-15,502,iphone 15 pro max,100000,135000,35000,1,00490,India
680080,2023-12-15,506,monitor,3249,8000,4751,1,00372,India
680080,2023-12-15,507,washing machine,6990,16490,9500,1,00372,India
680080,2023-12-15,503,mixer,1349,3249,1900,1,00372,India
680080,2023-12-15,505,oven,18490,24000,5510,1,00372,India
680080,2023-12-15,504,iron,449,879,430,1,00372,India
851766,2023-12-15,504,iron,449,879,430,1,00476,India
851766,2023-12-15,503,mixer,1349,3249,1900,1,00476,India
851766,2023-12-15,505,oven,18490,24000,5510,1,00476,India
851766,2023-12-15,501,iphone 15,60000,80000,20000,1,00476,India
188725,2023-12-15,501,iphone 15,60000,80000,20000,1,00082,India
188725,2023-12-15,504,iron,449,879,430,1,00082,India
188725,2023-12-15,507,washing machine,6990,16490,9500,1,00082,India
593958,2023-12-15,506,monitor,3249,8000,4751,1,00323,India
593958,2023-12-15,502,iphone 15 pro max,100000,135000,35000,1,00323,India
593958,2023-12-15,503,mixer,1349,3249,1900,1,00323,India
146898,2023-12-15,504,iron,449,879,430,1,00133,India
146898,2023-12-15,507,washing machine,6990,16490,9500,1,00133,India
146898,2023-12-15,502,iphone 15 pro max,100000,135000,35000,1,00133,India
154674,2023-12-15,503,mixer,1349,3249,1900,1,00133,India
331695,2023-12-15,501,iphone 15,60000,80000,20000,1,00500,India
331695,2023-12-15,506,monitor,3249,8000,4751,1,00500,India
331695,2023-12-15,502,iphone 15 pro max,100000,135000,35000,1,00500,India
331695,2023-12-15,503,mixer,1349,3249,1900,1,00500,India
191659,2023-12-15,503,mixer,1349,3249,1900,1,00385,India
191659,2023-12-15,501,iphone 15,60000,80000,20000,1,00385,India
321442,2023-12-15,506,monitor,3249,8000,4751,1,00293,India
321442,2023-12-15,501,iphone 15,60000,80000,20000,1,00293,India
321442,2023-12-15,502,iphone 15 pro max,100000,135000,35000,1,00293,India
298655,2023-12-15,507,washing machine,6990,16490,9500,1,00382,India
141396,2023-12-15,501,iphone 15,60000,80000,20000,1,00179,India
141396,2023-12-15,507,washing machine,6990,16490,9500,1,00179,India
141396,2023-12-15,503,mixer,1349,3249,1900,1,00179,India
860259,2023-12-15,503,mixer,1349,3249,1900,1,00150,India
216620,2023-12-15,505,oven,18490,24000,5510,1,00165,India
216620,2023-12-15,507,washing machine,6990,16490,9500,1,00165,India
664562,2023-12-15,505,oven,18490,24000,5510,1,00454,India
664562,2023-12-15,506,monitor,3249,8000,4751,1,00454,India
483447,2023-12-15,504,iron,449,879,430,1,00083,India
261626,2023-12-15,502,iphone 15 pro max,100000,135000,35000,1,00311,India
261626,2023-12-15,501,iphone 15,60000,80000,20000,1,00311,India
261626,2023-12-15,503,mixer,1349,3249,1900,1,00311,India
261626,2023-12-15,504,iron,449,879,430,1,00311,India
454986,2023-12-15,505,oven,18490,24000,5510,1,00400,India
454986,2023-12-15,504,iron,449,879,430,1,00400,India
454986,2023-12-15,502,iphone 15 pro max,100000,135000,35000,1,00400,India
572707,2023-12-15,502,iphone 15 pro max,100000,135000,35000,1,00253,India
572707,2023-12-15,505,oven,18490,24000,5510,1,00253,India
572707,2023-12-15,507,washing machine,6990,16490,9500,1,00253,India
572707,2023-12-15,504,iron,449,879,430,1,00253,India
191146,2023-12-15,507,washing machine,6990,16490,9500,1,00365,India
191146,2023-12-15,501,iphone 15,60000,80000,20000,1,00365,India
191146,2023-12-15,505,oven,18490,24000,5510,1,00365,India
572181,2023-12-15,501,iphone 15,60000,80000,20000,1,00025,India
572181,2023-12-15,504,iron,449,879,430,1,00025,India
608826,2023-12-15,502,iphone 15 pro max,100000,135000,35000,1,00460,India
608826,2023-12-15,503,mixer,1349,3249,1900,1,00460,India
608826,2023-12-15,506,monitor,3249,8000,4751,1,00460,India
803365,2023-12-15,506,monitor,3249,8000,4751,1,00316,India
803365,2023-12-15,503,mixer,1349,3249,1900,1,00316,India
721851,2023-12-15,503,mixer,1349,3249,1900,1,00358,India
721851,2023-12-15,507,washing machine,6990,16490,9500,1,00358,India
402140,2023-12-15,503,mixer,1349,3249,1900,1,00005,India
402140,2023-12-15,507,washing machine,6990,16490,9500,1,00005,India
402140,2023-12-15,504,iron,449,879,430,1,00005,India
402140,2023-12-15,505,oven,18490,24000,5510,1,00005,India
862550,2023-12-15,504,iron,449,879,430,1,00426,India
765587,2023-12-15,507,washing machine,6990,16490,9500,1,00105,India
765587,2023-12-15,501,iphone 15,60000,80000,20000,1,00105,India
765587,2023-12-15,506,monitor,3249,8000,4751,1,00105,India
765587,2023-12-15,502,iphone 15 pro max,100000,135000,35000,1,00105,India
572135,2023-12-15,501,iphone 15,60000,80000,20000,1,00188,India
572135,2023-12-15,503,mixer,1349,3249,1900,1,00188,India
687111,2023-12-15,505,oven,18490,24000,5510,1,00073,India
687111,2023-12-15,503,mixer,1349,3249,1900,1,00073,India
687111,2023-12-15,507,washing machine,6990,16490,9500,1,00073,India
687111,2023-12-15,501,iphone 15,60000,80000,20000,1,00073,India
523182,2023-12-15,503,mixer,1349,3249,1900,1,00294,India
523182,2023-12-15,505,oven,18490,24000,5510,1,00294,India
250200,2023-12-16,506,monitor,3249,8000,4751,1,00004,India
250200,2023-12-16,503,mixer,1349,3249,1900,1,00004,India
250200,2023-12-16,507,washing machine,6990,16490,9500,1,00004,India
250200,2023-12-16,505,oven,18490,24000,5510,1,00004,India
868156,2023-12-16,507,washing machine,6990,16490,9500,1,00009,India
868156,2023-12-16,501,iphone 15,60000,80000,20000,1,00009,India
868156,2023-12-16,504,iron,449,879,430,1,00009,India
182573,2023-12-16,505,oven,18490,24000,5510,1,00344,India
182573,2023-12-16,502,iphone 15 pro max,100000,135000,35000,1,00344,India
182573,2023-12-16,506,monitor,3249,8000,4751,1,00344,India
182573,2023-12-16,504,iron,449,879,430,1,00344,India
362999,2023-12-16,502,iphone 15 pro max,100000,135000,35000,1,00107,India
362999,2023-12-16,501,iphone 15,60000,80000,20000,1,00107,India
362999,2023-12-16,504,iron,449,879,430,1,00107,India
362999,2023-12-16,505,oven,18490,24000,5510,1,00107,India
479744,2023-12-16,504,iron,449,879,430,1,00412,India
479744,2023-12-16,502,iphone 15 pro max,100000,135000,35000,1,00412,India
479744,2023-12-16,505,oven,18490,24000,5510,1,00412,India
641956,2023-12-16,502,iphone 15 pro max,100000,135000,35000,1,00301,India
641956,2023-12-16,504,iron,449,879,430,1,00301,India
191781,2023-12-16,504,iron,449,879,430,1,00408,India
191781,2023-12-16,501,iphone 15,60000,80000,20000,1,00408,India
191781,2023-12-16,502,iphone 15 pro max,100000,135000,35000,1,00408,India
191781,2023-12-16,506,monitor,3249,8000,4751,1,00408,India
195888,2023-12-16,503,mixer,1349,3249,1900,1,00347,India
195888,2023-12-16,507,washing machine,6990,16490,9500,1,00347,India
195888,2023-12-16,505,oven,18490,24000,5510,1,00347,India
198326,2023-12-16,501,iphone 15,60000,80000,20000,1,00463,India
198326,2023-12-16,505,oven,18490,24000,5510,1,00463,India
198326,2023-12-16,504,iron,449,879,430,1,00463,India
198326,2023-12-16,503,mixer,1349,3249,1900,1,00463,India
400613,2023-12-16,501,iphone 15,60000,80000,20000,1,00283,India
400613,2023-12-16,504,iron,449,879,430,1,00283,India
400613,2023-12-16,503,mixer,1349,3249,1900,1,00283,India
400613,2023-12-16,507,washing machine,6990,16490,9500,1,00283,India
993121,2023-12-16,506,monitor,3249,8000,4751,1,00051,India
993121,2023-12-16,503,mixer,1349,3249,1900,1,00051,India
623789,2023-12-16,507,washing machine,6990,16490,9500,1,00246,India
623789,2023-12-16,504,iron,449,879,430,1,00246,India
239302,2023-12-16,502,iphone 15 pro max,100000,135000,35000,1,00035,India
381544,2023-12-16,505,oven,18490,24000,5510,1,00458,India
864932,2023-12-16,507,washing machine,6990,16490,9500,1,00167,India
864932,2023-12-16,502,iphone 15 pro max,100000,135000,35000,1,00167,India
864932,2023-12-16,506,monitor,3249,8000,4751,1,00167,India
579339,2023-12-16,507,washing machine,6990,16490,9500,1,00482,India
579339,2023-12-16,504,iron,449,879,430,1,00482,India
532779,2023-12-16,506,monitor,3249,8000,4751,1,00299,India
839425,2023-12-16,504,iron,449,879,430,1,00179,India
839425,2023-12-16,503,mixer,1349,3249,1900,1,00179,India
839425,2023-12-16,505,oven,18490,24000,5510,1,00179,India
839425,2023-12-16,501,iphone 15,60000,80000,20000,1,00179,India
646201,2023-12-16,503,mixer,1349,3249,1900,1,00232,India
994643,2023-12-16,503,mixer,1349,3249,1900,1,00357,India
994643,2023-12-16,506,monitor,3249,8000,4751,1,00357,India
994643,2023-12-16,502,iphone 15 pro max,100000,135000,35000,1,00357,India
310901,2023-12-16,503,mixer,1349,3249,1900,1,00382,India
310901,2023-12-16,506,monitor,3249,8000,4751,1,00382,India
299550,2023-12-16,502,iphone 15 pro max,100000,135000,35000,1,00318,India
299550,2023-12-16,504,iron,449,879,430,1,00318,India
299550,2023-12-16,503,mixer,1349,3249,1900,1,00318,India
299550,2023-12-16,505,oven,18490,24000,5510,1,00318,India
639641,2023-12-16,503,mixer,1349,3249,1900,1,00101,India
414866,2023-12-16,507,washing machine,6990,16490,9500,1,00431,India
414866,2023-12-16,501,iphone 15,60000,80000,20000,1,00431,India
414328,2023-12-16,507,washing machine,6990,16490,9500,1,00160,India
414328,2023-12-16,506,monitor,3249,8000,4751,1,00160,India
604788,2023-12-16,505,oven,18490,24000,5510,1,00221,India
604788,2023-12-16,507,washing machine,6990,16490,9500,1,00221,India
964678,2023-12-16,502,iphone 15 pro max,100000,135000,35000,1,00485,India
964678,2023-12-16,503,mixer,1349,3249,1900,1,00485,India
944993,2023-12-16,506,monitor,3249,8000,4751,1,00372,India
944993,2023-12-16,507,washing machine,6990,16490,9500,1,00372,India
944993,2023-12-16,505,oven,18490,24000,5510,1,00372,India
938530,2023-12-16,505,oven,18490,24000,5510,1,00428,India
938530,2023-12-16,501,iphone 15,60000,80000,20000,1,00428,India
876481,2023-12-16,505,oven,18490,24000,5510,1,00231,India
571449,2023-12-16,502,iphone 15 pro max,100000,135000,35000,1,00028,India
571449,2023-12-16,504,iron,449,879,430,1,00028,India
912772,2023-12-16,507,washing machine,6990,16490,9500,1,00361,India
912772,2023-12-16,505,oven,18490,24000,5510,1,00361,India
313812,2023-12-16,505,oven,18490,24000,5510,1,00439,India
313812,2023-12-16,502,iphone 15 pro max,100000,135000,35000,1,00439,India
298144,2023-12-16,504,iron,449,879,430,1,00447,India
298144,2023-12-16,503,mixer,1349,3249,1900,1,00447,India
298144,2023-12-16,502,iphone 15 pro max,100000,135000,35000,1,00447,India
298144,2023-12-16,505,oven,18490,24000,5510,1,00447,India
345236,2023-12-16,501,iphone 15,60000,80000,20000,1,00136,India
345236,2023-12-16,507,washing machine,6990,16490,9500,1,00136,India
345236,2023-12-16,504,iron,449,879,430,1,00136,India
345236,2023-12-16,502,iphone 15 pro max,100000,135000,35000,1,00136,India
832465,2023-12-16,503,mixer,1349,3249,1900,1,00120,India
832465,2023-12-16,505,oven,18490,24000,5510,1,00120,India
832465,2023-12-16,507,washing machine,6990,16490,9500,1,00120,India
832465,2023-12-16,502,iphone 15 pro max,100000,135000,35000,1,00120,India
215292,2023-12-16,503,mixer,1349,3249,1900,1,00426,India
215292,2023-12-16,501,iphone 15,60000,80000,20000,1,00426,India
215292,2023-12-16,502,iphone 15 pro max,100000,135000,35000,1,00426,India
215292,2023-12-16,504,iron,449,879,430,1,00426,India
215292,2023-12-16,507,washing machine,6990,16490,9500,1,00426,India
965709,2023-12-16,504,iron,449,879,430,1,00390,India
965709,2023-12-16,502,iphone 15 pro max,100000,135000,35000,1,00390,India
965709,2023-12-16,506,monitor,3249,8000,4751,1,00390,India
369048,2023-12-16,501,iphone 15,60000,80000,20000,1,00314,India
369048,2023-12-16,503,mixer,1349,3249,1900,1,00314,India
369048,2023-12-16,504,iron,449,879,430,1,00314,India
469277,2023-12-16,502,iphone 15 pro max,100000,135000,35000,1,00227,India
889282,2023-12-16,505,oven,18490,24000,5510,1,00318,India
889282,2023-12-16,504,iron,449,879,430,1,00318,India
889282,2023-12-16,503,mixer,1349,3249,1900,1,00318,India
889282,2023-12-16,502,iphone 15 pro max,100000,135000,35000,1,00318,India
614708,2023-12-16,504,iron,449,879,430,1,00382,India
881625,2023-12-16,501,iphone 15,60000,80000,20000,1,00492,India
248959,2023-12-16,504,iron,449,879,430,1,00081,India
248959,2023-12-16,505,oven,18490,24000,5510,1,00081,India
248959,2023-12-16,503,mixer,1349,3249,1900,1,00081,India
248959,2023-12-16,502,iphone 15 pro max,100000,135000,35000,1,00081,India
150088,2023-12-16,502,iphone 15 pro max,100000,135000,35000,1,00101,India
909877,2023-12-16,507,washing machine,6990,16490,9500,1,00354,India
909877,2023-12-16,504,iron,449,879,430,1,00354,India
479340,2023-12-16,501,iphone 15,60000,80000,20000,1,00416,India
479340,2023-12-16,503,mixer,1349,3249,1900,1,00416,India
268878,2023-12-16,503,mixer,1349,3249,1900,1,00308,India
268878,2023-12-16,505,oven,18490,24000,5510,1,00308,India
713084,2023-12-16,506,monitor,3249,8000,4751,1,00340,India
713084,2023-12-16,503,mixer,1349,3249,1900,1,00340,India
713084,2023-12-16,504,iron,449,879,430,1,00340,India
888763,2023-12-16,506,monitor,3249,8000,4751,1,00488,India
888763,2023-12-16,504,iron,449,879,430,1,00488,India
888763,2023-12-16,507,washing machine,6990,16490,9500,1,00488,India
379547,2023-12-16,502,iphone 15 pro max,100000,135000,35000,1,00395,India
379547,2023-12-16,505,oven,18490,24000,5510,1,00395,India
379547,2023-12-16,506,monitor,3249,8000,4751,1,00395,India
379547,2023-12-16,503,mixer,1349,3249,1900,1,00395,India
639003,2023-12-16,504,iron,449,879,430,1,00035,India
386580,2023-12-16,504,iron,449,879,430,1,00271,India
531776,2023-12-16,506,monitor,3249,8000,4751,1,00352,India
531776,2023-12-16,505,oven,18490,24000,5510,1,00352,India
531776,2023-12-16,504,iron,449,879,430,1,00352,India
531776,2023-12-16,507,washing machine,6990,16490,9500,1,00352,India
890557,2023-12-16,504,iron,449,879,430,1,00392,India
890557,2023-12-16,507,washing machine,6990,16490,9500,1,00392,India
890557,2023-12-16,505,oven,18490,24000,5510,1,00392,India
754891,2023-12-16,505,oven,18490,24000,5510,1,00307,India
754891,2023-12-16,503,mixer,1349,3249,1900,1,00307,India
754891,2023-12-16,507,washing machine,6990,16490,9500,1,00307,India
503605,2023-12-16,502,iphone 15 pro max,100000,135000,35000,1,00372,India
503605,2023-12-16,504,iron,449,879,430,1,00372,India
503605,2023-12-16,505,oven,18490,24000,5510,1,00372,India
503605,2023-12-16,503,mixer,1349,3249,1900,1,00372,India
866030,2023-12-16,505,oven,18490,24000,5510,1,00045,India
925424,2023-12-16,505,oven,18490,24000,5510,1,00135,India
885959,2023-12-16,504,iron,449,879,430,1,00367,India
885959,2023-12-16,503,mixer,1349,3249,1900,1,00367,India
888633,2023-12-16,503,mixer,1349,3249,1900,1,00230,India
888633,2023-12-16,501,iphone 15,60000,80000,20000,1,00230,India
888633,2023-12-16,504,iron,449,879,430,1,00230,India
888633,2023-12-16,502,iphone 15 pro max,100000,135000,35000,1,00230,India
289641,2023-12-16,506,monitor,3249,8000,4751,1,00448,India
289641,2023-12-16,507,washing machine,6990,16490,9500,1,00448,India
659876,2023-12-16,505,oven,18490,24000,5510,1,00316,India
659876,2023-12-16,501,iphone 15,60000,80000,20000,1,00316,India
659876,2023-12-16,506,monitor,3249,8000,4751,1,00316,India
740855,2023-12-16,504,iron,449,879,430,1,00371,India
346534,2023-12-16,503,mixer,1349,3249,1900,1,00177,India
226908,2023-12-16,504,iron,449,879,430,1,00015,India
226908,2023-12-16,501,iphone 15,60000,80000,20000,1,00015,India
226908,2023-12-16,507,washing machine,6990,16490,9500,1,00015,India
226908,2023-12-16,505,oven,18490,24000,5510,1,00015,India
286514,2023-12-16,506,monitor,3249,8000,4751,1,00054,India
778770,2023-12-16,501,iphone 15,60000,80000,20000,1,00488,India
235404,2023-12-16,502,iphone 15 pro max,100000,135000,35000,1,00448,India
235404,2023-12-16,504,iron,449,879,430,1,00448,India
235404,2023-12-16,503,mixer,1349,3249,1900,1,00448,India
909215,2023-12-16,502,iphone 15 pro max,100000,135000,35000,1,00165,India
909215,2023-12-16,507,washing machine,6990,16490,9500,1,00165,India
909215,2023-12-16,505,oven,18490,24000,5510,1,00165,India
139228,2023-12-16,501,iphone 15,60000,80000,20000,1,00097,India
139228,2023-12-16,503,mixer,1349,3249,1900,1,00097,India
139228,2023-12-16,504,iron,449,879,430,1,00097,India
761238,2023-12-16,504,iron,449,879,430,1,00479,India
761238,2023-12-16,505,oven,18490,24000,5510,1,00479,India
363667,2023-12-16,505,oven,18490,24000,5510,1,00451,India
363667,2023-12-16,501,iphone 15,60000,80000,20000,1,00451,India
363667,2023-12-16,504,iron,449,879,430,1,00451,India
363667,2023-12-16,503,mixer,1349,3249,1900,1,00451,India
646885,2023-12-16,502,iphone 15 pro max,100000,135000,35000,1,00003,India
646885,2023-12-16,505,oven,18490,24000,5510,1,00003,India
646885,2023-12-16,507,washing machine,6990,16490,9500,1,00003,India
824964,2023-12-16,502,iphone 15 pro max,100000,135000,35000,1,00362,India
438538,2023-12-16,506,monitor,3249,8000,4751,1,00059,India
786442,2023-12-16,506,monitor,3249,8000,4751,1,00087,India
786442,2023-12-16,505,oven,18490,24000,5510,1,00087,India
786442,2023-12-16,501,iphone 15,60000,80000,20000,1,00087,India
779288,2023-12-16,507,washing machine,6990,16490,9500,1,00240,India
779288,2023-12-16,504,iron,449,879,430,1,00240,India
806234,2023-12-16,501,iphone 15,60000,80000,20000,1,00328,India
631377,2023-12-16,505,oven,18490,24000,5510,1,00480,India
631377,2023-12-16,504,iron,449,879,430,1,00480,India
631377,2023-12-16,501,iphone 15,60000,80000,20000,1,00480,India
631377,2023-12-16,507,washing machine,6990,16490,9500,1,00480,India
603104,2023-12-16,502,iphone 15 pro max,100000,135000,35000,1,00249,India
603104,2023-12-16,504,iron,449,879,430,1,00249,India
603104,2023-12-16,506,monitor,3249,8000,4751,1,00249,India
603104,2023-12-16,501,iphone 15,60000,80000,20000,1,00249,India
970347,2023-12-17,503,mixer,1349,3249,1900,1,00254,India
970347,2023-12-17,504,iron,449,879,430,1,00254,India
628041,2023-12-17,505,oven,18490,24000,5510,1,00136,India
628041,2023-12-17,504,iron,449,879,430,1,00136,India
735130,2023-12-17,503,mixer,1349,3249,1900,1,00097,India
735130,2023-12-17,501,iphone 15,60000,80000,20000,1,00097,India
597429,2023-12-17,507,washing machine,6990,16490,9500,1,00474,India
597429,2023-12-17,505,oven,18490,24000,5510,1,00474,India
597429,2023-12-17,504,iron,449,879,430,1,00474,India
597429,2023-12-17,501,iphone 15,60000,80000,20000,1,00474,India
857935,2023-12-17,507,washing machine,6990,16490,9500,1,00104,India
857935,2023-12-17,503,mixer,1349,3249,1900,1,00104,India
348744,2023-12-17,503,mixer,1349,3249,1900,1,00304,India
348744,2023-12-17,506,monitor,3249,8000,4751,1,00304,India
348744,2023-12-17,507,washing machine,6990,16490,9500,1,00304,India
318939,2023-12-17,507,washing machine,6990,16490,9500,1,00445,India
318939,2023-12-17,501,iphone 15,60000,80000,20000,1,00445,India
123613,2023-12-17,506,monitor,3249,8000,4751,1,00397,India
123613,2023-12-17,504,iron,449,879,430,1,00397,India
123613,2023-12-17,503,mixer,1349,3249,1900,1,00397,India
633905,2023-12-17,507,washing machine,6990,16490,9500,1,00155,India
633905,2023-12-17,501,iphone 15,60000,80000,20000,1,00155,India
633905,2023-12-17,504,iron,449,879,430,1,00155,India
338353,2023-12-17,503,mixer,1349,3249,1900,1,00264,India
448310,2023-12-17,502,iphone 15 pro max,100000,135000,35000,1,00115,India
448310,2023-12-17,501,iphone 15,60000,80000,20000,1,00115,India
448310,2023-12-17,503,mixer,1349,3249,1900,1,00115,India
628054,2023-12-17,502,iphone 15 pro max,100000,135000,35000,1,00359,India
628054,2023-12-17,507,washing machine,6990,16490,9500,1,00359,India
628054,2023-12-17,501,iphone 15,60000,80000,20000,1,00359,India
628054,2023-12-17,503,mixer,1349,3249,1900,1,00359,India
319468,2023-12-17,505,oven,18490,24000,5510,1,00240,India
319468,2023-12-17,506,monitor,3249,8000,4751,1,00240,India
253653,2023-12-17,503,mixer,1349,3249,1900,1,00108,India
253653,2023-12-17,507,washing machine,6990,16490,9500,1,00108,India
455276,2023-12-17,503,mixer,1349,3249,1900,1,00471,India
294150,2023-12-17,504,iron,449,879,430,1,00214,India
294150,2023-12-17,506,monitor,3249,8000,4751,1,00214,India
294150,2023-12-17,502,iphone 15 pro max,100000,135000,35000,1,00214,India
288134,2023-12-17,505,oven,18490,24000,5510,1,00430,India
288134,2023-12-17,502,iphone 15 pro max,100000,135000,35000,1,00430,India
288134,2023-12-17,503,mixer,1349,3249,1900,1,00430,India
442545,2023-12-17,504,iron,449,879,430,1,00092,India
442545,2023-12-17,506,monitor,3249,8000,4751,1,00092,India
442545,2023-12-17,501,iphone 15,60000,80000,20000,1,00092,India
898324,2023-12-17,506,monitor,3249,8000,4751,1,00369,India
898324,2023-12-17,505,oven,18490,24000,5510,1,00369,India
898324,2023-12-17,501,iphone 15,60000,80000,20000,1,00369,India
898324,2023-12-17,504,iron,449,879,430,1,00369,India
627018,2023-12-17,504,iron,449,879,430,1,00497,India
627018,2023-12-17,506,monitor,3249,8000,4751,1,00497,India
496869,2023-12-17,507,washing machine,6990,16490,9500,1,00321,India
496869,2023-12-17,505,oven,18490,24000,5510,1,00321,India
496869,2023-12-17,502,iphone 15 pro max,100000,135000,35000,1,00321,India
496869,2023-12-17,503,mixer,1349,3249,1900,1,00321,India
265585,2023-12-17,503,mixer,1349,3249,1900,1,00241,India
265585,2023-12-17,506,monitor,3249,8000,4751,1,00241,India
598789,2023-12-17,506,monitor,3249,8000,4751,1,00494,India
598789,2023-12-17,501,iphone 15,60000,80000,20000,1,00494,India
452946,2023-12-17,505,oven,18490,24000,5510,1,00156,India
452946,2023-12-17,507,washing machine,6990,16490,9500,1,00156,India
452946,2023-12-17,502,iphone 15 pro max,100000,135000,35000,1,00156,India
452946,2023-12-17,501,iphone 15,60000,80000,20000,1,00156,India
796957,2023-12-17,507,washing machine,6990,16490,9500,1,00267,India
796957,2023-12-17,506,monitor,3249,8000,4751,1,00267,India
796957,2023-12-17,503,mixer,1349,3249,1900,1,00267,India
796957,2023-12-17,502,iphone 15 pro max,100000,135000,35000,1,00267,India
668931,2023-12-17,507,washing machine,6990,16490,9500,1,00424,India
434545,2023-12-17,503,mixer,1349,3249,1900,1,00206,India
434545,2023-12-17,506,monitor,3249,8000,4751,1,00206,India
665285,2023-12-17,506,monitor,3249,8000,4751,1,00491,India
166089,2023-12-17,506,monitor,3249,8000,4751,1,00291,India
166089,2023-12-17,505,oven,18490,24000,5510,1,00291,India
645552,2023-12-17,502,iphone 15 pro max,100000,135000,35000,1,00024,India
732602,2023-12-17,507,washing machine,6990,16490,9500,1,00015,India
732602,2023-12-17,501,iphone 15,60000,80000,20000,1,00015,India
732602,2023-12-17,503,mixer,1349,3249,1900,1,00015,India
589260,2023-12-17,503,mixer,1349,3249,1900,1,00204,India
589260,2023-12-17,507,washing machine,6990,16490,9500,1,00204,India
365664,2023-12-17,502,iphone 15 pro max,100000,135000,35000,1,00212,India
365664,2023-12-17,507,washing machine,6990,16490,9500,1,00212,India
615932,2023-12-17,505,oven,18490,24000,5510,1,00228,India
146002,2023-12-17,505,oven,18490,24000,5510,1,00078,India
146002,2023-12-17,506,monitor,3249,8000,4751,1,00078,India
146002,2023-12-17,501,iphone 15,60000,80000,20000,1,00078,India
653766,2023-12-17,505,oven,18490,24000,5510,1,00445,India
653766,2023-12-17,503,mixer,1349,3249,1900,1,00445,India
653766,2023-12-17,504,iron,449,879,430,1,00445,India
408880,2023-12-17,501,iphone 15,60000,80000,20000,1,00454,India
408880,2023-12-17,506,monitor,3249,8000,4751,1,00454,India
408880,2023-12-17,503,mixer,1349,3249,1900,1,00454,India
192787,2023-12-17,502,iphone 15 pro max,100000,135000,35000,1,00290,India
192787,2023-12-17,503,mixer,1349,3249,1900,1,00290,India
192787,2023-12-17,506,monitor,3249,8000,4751,1,00290,India
554468,2023-12-17,506,monitor,3249,8000,4751,1,00034,India
365404,2023-12-17,507,washing machine,6990,16490,9500,1,00290,India
809195,2023-12-17,501,iphone 15,60000,80000,20000,1,00154,India
809195,2023-12-17,502,iphone 15 pro max,100000,135000,35000,1,00154,India
362205,2023-12-17,503,mixer,1349,3249,1900,1,00125,India
755418,2023-12-17,505,oven,18490,24000,5510,1,00139,India
755418,2023-12-17,504,iron,449,879,430,1,00139,India
755418,2023-12-17,507,washing machine,6990,16490,9500,1,00139,India
755418,2023-12-17,502,iphone 15 pro max,100000,135000,35000,1,00139,India
656983,2023-12-17,503,mixer,1349,3249,1900,1,00481,India
656983,2023-12-17,505,oven,18490,24000,5510,1,00481,India
246693,2023-12-17,502,iphone 15 pro max,100000,135000,35000,1,00111,India
246693,2023-12-17,501,iphone 15,60000,80000,20000,1,00111,India
246693,2023-12-17,504,iron,449,879,430,1,00111,India
246693,2023-12-17,507,washing machine,6990,16490,9500,1,00111,India
825755,2023-12-17,503,mixer,1349,3249,1900,1,00353,India
825755,2023-12-17,505,oven,18490,24000,5510,1,00353,India
825755,2023-12-17,504,iron,449,879,430,1,00353,India
415489,2023-12-17,502,iphone 15 pro max,100000,135000,35000,1,00067,India
415489,2023-12-17,503,mixer,1349,3249,1900,1,00067,India
425371,2023-12-17,502,iphone 15 pro max,100000,135000,35000,1,00339,India
425371,2023-12-17,506,monitor,3249,8000,4751,1,00339,India
173685,2023-12-17,506,monitor,3249,8000,4751,1,00351,India
173685,2023-12-17,507,washing machine,6990,16490,9500,1,00351,India
925957,2023-12-17,501,iphone 15,60000,80000,20000,1,00259,India
925957,2023-12-17,504,iron,449,879,430,1,00259,India
925957,2023-12-17,502,iphone 15 pro max,100000,135000,35000,1,00259,India
925957,2023-12-17,507,washing machine,6990,16490,9500,1,00259,India
324280,2023-12-17,506,monitor,3249,8000,4751,1,00127,India
324280,2023-12-17,505,oven,18490,24000,5510,1,00127,India
324280,2023-12-17,502,iphone 15 pro max,100000,135000,35000,1,00127,India
788550,2023-12-17,504,iron,449,879,430,1,00144,India
788550,2023-12-17,505,oven,18490,24000,5510,1,00144,India
788550,2023-12-17,501,iphone 15,60000,80000,20000,1,00144,India
788550,2023-12-17,502,iphone 15 pro max,100000,135000,35000,1,00144,India
899485,2023-12-17,501,iphone 15,60000,80000,20000,1,00101,India
899485,2023-12-17,506,monitor,3249,8000,4751,1,00101,India
692823,2023-12-17,506,monitor,3249,8000,4751,1,00153,India
692823,2023-12-17,503,mixer,1349,3249,1900,1,00153,India
692823,2023-12-17,504,iron,449,879,430,1,00153,India
835532,2023-12-17,504,iron,449,879,430,1,00128,India
835532,2023-12-17,501,iphone 15,60000,80000,20000,1,00128,India
835532,2023-12-17,505,oven,18490,24000,5510,1,00128,India
835532,2023-12-17,507,washing machine,6990,16490,9500,1,00128,India
922897,2023-12-17,506,monitor,3249,8000,4751,1,00256,India
922897,2023-12-17,504,iron,449,879,430,1,00256,India
922897,2023-12-17,503,mixer,1349,3249,1900,1,00256,India
408290,2023-12-17,505,oven,18490,24000,5510,1,00449,India
488359,2023-12-17,505,oven,18490,24000,5510,1,00488,India
148017,2023-12-17,503,mixer,1349,3249,1900,1,00450,India
372032,2023-12-17,506,monitor,3249,8000,4751,1,00389,India
372032,2023-12-17,505,oven,18490,24000,5510,1,00389,India
121696,2023-12-17,506,monitor,3249,8000,4751,1,00437,India
941383,2023-12-17,504,iron,449,879,430,1,00240,India
956205,2023-12-17,507,washing machine,6990,16490,9500,1,00384,India
956205,2023-12-17,502,iphone 15 pro max,100000,135000,35000,1,00384,India
956205,2023-12-17,504,iron,449,879,430,1,00384,India
723523,2023-12-17,501,iphone 15,60000,80000,20000,1,00433,India
187681,2023-12-17,507,washing machine,6990,16490,9500,1,00402,India
187681,2023-12-17,506,monitor,3249,8000,4751,1,00402,India
389944,2023-12-17,507,washing machine,6990,16490,9500,1,00319,India
185307,2023-12-17,505,oven,18490,24000,5510,1,00042,India
380812,2023-12-17,501,iphone 15,60000,80000,20000,1,00054,India
721689,2023-12-17,505,oven,18490,24000,5510,1,00231,India
721689,2023-12-17,507,washing machine,6990,16490,9500,1,00231,India
117825,2023-12-17,502,iphone 15 pro max,100000,135000,35000,1,00053,India
117825,2023-12-17,505,oven,18490,24000,5510,1,00053,India
117825,2023-12-17,507,washing machine,6990,16490,9500,1,00053,India
653560,2023-12-17,501,iphone 15,60000,80000,20000,1,00092,India
653560,2023-12-17,506,monitor,3249,8000,4751,1,00092,India
653560,2023-12-17,502,iphone 15 pro max,100000,135000,35000,1,00092,India
653560,2023-12-17,507,washing machine,6990,16490,9500,1,00092,India
641734,2023-12-17,506,monitor,3249,8000,4751,1,00081,India
641734,2023-12-17,502,iphone 15 pro max,100000,135000,35000,1,00081,India
641734,2023-12-17,501,iphone 15,60000,80000,20000,1,00081,India
553521,2023-12-17,502,iphone 15 pro max,100000,135000,35000,1,00083,India
553521,2023-12-17,503,mixer,1349,3249,1900,1,00083,India
553521,2023-12-17,505,oven,18490,24000,5510,1,00083,India
113017,2023-12-17,507,washing machine,6990,16490,9500,1,00221,India
113017,2023-12-17,502,iphone 15 pro max,100000,135000,35000,1,00221,India
113017,2023-12-17,503,mixer,1349,3249,1900,1,00221,India
113017,2023-12-17,506,monitor,3249,8000,4751,1,00221,India
302683,2023-12-17,504,iron,449,879,430,1,00043,India
302683,2023-12-17,507,washing machine,6990,16490,9500,1,00043,India
302683,2023-12-17,506,monitor,3249,8000,4751,1,00043,India
383737,2023-12-17,504,iron,449,879,430,1,00445,India
383737,2023-12-17,507,washing machine,6990,16490,9500,1,00445,India
788383,2023-12-17,502,iphone 15 pro max,100000,135000,35000,1,00343,India
990834,2023-12-17,502,iphone 15 pro max,100000,135000,35000,1,00482,India
990834,2023-12-17,505,oven,18490,24000,5510,1,00482,India
990834,2023-12-17,504,iron,449,879,430,1,00482,India
626868,2023-12-17,503,mixer,1349,3249,1900,1,00262,India
626868,2023-12-17,504,iron,449,879,430,1,00262,India
626868,2023-12-17,502,iphone 15 pro max,100000,135000,35000,1,00262,India
834077,2023-12-17,507,washing machine,6990,16490,9500,1,00331,India
834077,2023-12-17,505,oven,18490,24000,5510,1,00331,India
834077,2023-12-17,504,iron,449,879,430,1,00331,India
834077,2023-12-17,501,iphone 15,60000,80000,20000,1,00331,India
666915,2023-12-17,503,mixer,1349,3249,1900,1,00300,India
666915,2023-12-17,502,iphone 15 pro max,100000,135000,35000,1,00300,India
666915,2023-12-17,507,washing machine,6990,16490,9500,1,00300,India
805803,2023-12-17,503,mixer,1349,3249,1900,1,00242,India
805803,2023-12-17,507,washing machine,6990,16490,9500,1,00242,India
805803,2023-12-17,502,iphone 15 pro max,100000,135000,35000,1,00242,India
713917,2023-12-17,506,monitor,3249,8000,4751,1,00262,India
750427,2023-12-17,505,oven,18490,24000,5510,1,00382,India
750427,2023-12-17,502,iphone 15 pro max,100000,135000,35000,1,00382,India
173015,2023-12-17,506,monitor,3249,8000,4751,1,00211,India
173015,2023-12-17,503,mixer,1349,3249,1900,1,00211,India
370007,2023-12-17,503,mixer,1349,3249,1900,1,00122,India
495818,2023-12-17,507,washing machine,6990,16490,9500,1,00261,India
780600,2023-12-17,504,iron,449,879,430,1,00016,India
780600,2023-12-17,503,mixer,1349,3249,1900,1,00016,India
107120,2023-12-17,502,iphone 15 pro max,100000,135000,35000,1,00296,India
107120,2023-12-17,501,iphone 15,60000,80000,20000,1,00296,India
774550,2023-12-17,505,oven,18490,24000,5510,1,00373,India
339714,2023-12-17,507,washing machine,6990,16490,9500,1,00228,India
339714,2023-12-17,503,mixer,1349,3249,1900,1,00228,India
724236,2023-12-17,504,iron,449,879,430,1,00091,India
724236,2023-12-17,502,iphone 15 pro max,100000,135000,35000,1,00091,India
724236,2023-12-17,506,monitor,3249,8000,4751,1,00091,India
724236,2023-12-17,505,oven,18490,24000,5510,1,00091,India
334056,2023-12-17,503,mixer,1349,3249,1900,1,00009,India
334056,2023-12-17,502,iphone 15 pro max,100000,135000,35000,1,00009,India
334056,2023-12-17,501,iphone 15,60000,80000,20000,1,00009,India
290544,2023-12-17,504,iron,449,879,430,1,00168,India
290544,2023-12-17,506,monitor,3249,8000,4751,1,00168,India
574816,2023-12-17,503,mixer,1349,3249,1900,1,00192,India
574816,2023-12-17,506,monitor,3249,8000,4751,1,00192,India
678231,2023-12-17,504,iron,449,879,430,1,00240,India
631930,2023-12-17,506,monitor,3249,8000,4751,1,00360,India
756296,2023-12-18,506,monitor,3249,8000,4751,1,00097,India
756296,2023-12-18,505,oven,18490,24000,5510,1,00097,India
756296,2023-12-18,503,mixer,1349,3249,1900,1,00097,India
914224,2023-12-18,502,iphone 15 pro max,100000,135000,35000,1,00319,India
914224,2023-12-18,507,washing machine,6990,16490,9500,1,00319,India
914224,2023-12-18,506,monitor,3249,8000,4751,1,00319,India
567814,2023-12-18,507,washing machine,6990,16490,9500,1,00078,India
567814,2023-12-18,502,iphone 15 pro max,100000,135000,35000,1,00078,India
567814,2023-12-18,505,oven,18490,24000,5510,1,00078,India
985886,2023-12-18,502,iphone 15 pro max,100000,135000,35000,1,00082,India
562788,2023-12-18,502,iphone 15 pro max,100000,135000,35000,1,00343,India
562788,2023-12-18,503,mixer,1349,3249,1900,1,00343,India
562788,2023-12-18,507,washing machine,6990,16490,9500,1,00343,India
562788,2023-12-18,501,iphone 15,60000,80000,20000,1,00343,India
608269,2023-12-18,502,iphone 15 pro max,100000,135000,35000,1,00283,India
552506,2023-12-18,506,monitor,3249,8000,4751,1,00081,India
552506,2023-12-18,503,mixer,1349,3249,1900,1,00081,India
552506,2023-12-18,502,iphone 15 pro max,100000,135000,35000,1,00081,India
552506,2023-12-18,507,washing machine,6990,16490,9500,1,00081,India
407827,2023-12-18,507,washing machine,6990,16490,9500,1,00229,India
922379,2023-12-18,502,iphone 15 pro max,100000,135000,35000,1,00456,India
922379,2023-12-18,506,monitor,3249,8000,4751,1,00456,India
922379,2023-12-18,501,iphone 15,60000,80000,20000,1,00456,India
922379,2023-12-18,503,mixer,1349,3249,1900,1,00456,India
922379,2023-12-18,507,washing machine,6990,16490,9500,1,00456,India
548371,2023-12-18,507,washing machine,6990,16490,9500,1,00219,India
548371,2023-12-18,505,oven,18490,24000,5510,1,00219,India
548371,2023-12-18,504,iron,449,879,430,1,00219,India
548371,2023-12-18,501,iphone 15,60000,80000,20000,1,00219,India
763870,2023-12-18,506,monitor,3249,8000,4751,1,00422,India
374841,2023-12-18,503,mixer,1349,3249,1900,1,00294,India
374841,2023-12-18,504,iron,449,879,430,1,00294,India
374841,2023-12-18,505,oven,18490,24000,5510,1,00294,India
209432,2023-12-18,507,washing machine,6990,16490,9500,1,00077,India
209432,2023-12-18,504,iron,449,879,430,1,00077,India
209432,2023-12-18,505,oven,18490,24000,5510,1,00077,India
183215,2023-12-18,507,washing machine,6990,16490,9500,1,00479,India
183215,2023-12-18,504,iron,449,879,430,1,00479,India
701157,2023-12-18,504,iron,449,879,430,1,00433,India
701157,2023-12-18,502,iphone 15 pro max,100000,135000,35000,1,00433,India
197912,2023-12-18,501,iphone 15,60000,80000,20000,1,00180,India
197912,2023-12-18,506,monitor,3249,8000,4751,1,00180,India
197912,2023-12-18,502,iphone 15 pro max,100000,135000,35000,1,00180,India
197912,2023-12-18,507,washing machine,6990,16490,9500,1,00180,India
824357,2023-12-18,503,mixer,1349,3249,1900,1,00416,India
536019,2023-12-18,502,iphone 15 pro max,100000,135000,35000,1,00437,India
536019,2023-12-18,507,washing machine,6990,16490,9500,1,00437,India
536019,2023-12-18,506,monitor,3249,8000,4751,1,00437,India
425279,2023-12-18,506,monitor,3249,8000,4751,1,00419,India
425279,2023-12-18,504,iron,449,879,430,1,00419,India
838411,2023-12-18,501,iphone 15,60000,80000,20000,1,00307,India
838411,2023-12-18,505,oven,18490,24000,5510,1,00307,India
838411,2023-12-18,504,iron,449,879,430,1,00307,India
784807,2023-12-18,505,oven,18490,24000,5510,1,00159,India
424458,2023-12-18,503,mixer,1349,3249,1900,1,00154,India
268149,2023-12-18,504,iron,449,879,430,1,00130,India
268149,2023-12-18,505,oven,18490,24000,5510,1,00130,India
268149,2023-12-18,507,washing machine,6990,16490,9500,1,00130,India
940935,2023-12-18,507,washing machine,6990,16490,9500,1,00198,India
940935,2023-12-18,506,monitor,3249,8000,4751,1,00198,India
940935,2023-12-18,505,oven,18490,24000,5510,1,00198,India
854774,2023-12-18,502,iphone 15 pro max,100000,135000,35000,1,00285,India
854774,2023-12-18,503,mixer,1349,3249,1900,1,00285,India
854774,2023-12-18,507,washing machine,6990,16490,9500,1,00285,India
691834,2023-12-18,503,mixer,1349,3249,1900,1,00275,India
838341,2023-12-18,502,iphone 15 pro max,100000,135000,35000,1,00490,India
838341,2023-12-18,505,oven,18490,24000,5510,1,00490,India
838341,2023-12-18,506,monitor,3249,8000,4751,1,00490,India
819602,2023-12-18,505,oven,18490,24000,5510,1,00188,India
819602,2023-12-18,501,iphone 15,60000,80000,20000,1,00188,India
819602,2023-12-18,502,iphone 15 pro max,100000,135000,35000,1,00188,India
397044,2023-12-18,503,mixer,1349,3249,1900,1,00202,India
397044,2023-12-18,504,iron,449,879,430,1,00202,India
397044,2023-12-18,502,iphone 15 pro max,100000,135000,35000,1,00202,India
448598,2023-12-18,504,iron,449,879,430,1,00260,India
448598,2023-12-18,505,oven,18490,24000,5510,1,00260,India
448598,2023-12-18,502,iphone 15 pro max,100000,135000,35000,1,00260,India
448598,2023-12-18,501,iphone 15,60000,80000,20000,1,00260,India
295877,2023-12-18,504,iron,449,879,430,1,00399,India
295877,2023-12-18,506,monitor,3249,8000,4751,1,00399,India
295877,2023-12-18,502,iphone 15 pro max,100000,135000,35000,1,00399,India
295877,2023-12-18,507,washing machine,6990,16490,9500,1,00399,India
658834,2023-12-18,503,mixer,1349,3249,1900,1,00424,India
658834,2023-12-18,502,iphone 15 pro max,100000,135000,35000,1,00424,India
658834,2023-12-18,501,iphone 15,60000,80000,20000,1,00424,India
103703,2023-12-18,502,iphone 15 pro max,100000,135000,35000,1,00477,India
103703,2023-12-18,505,oven,18490,24000,5510,1,00477,India
103703,2023-12-18,506,monitor,3249,8000,4751,1,00477,India
886952,2023-12-18,505,oven,18490,24000,5510,1,00494,India
821122,2023-12-18,505,oven,18490,24000,5510,1,00408,India
669989,2023-12-18,501,iphone 15,60000,80000,20000,1,00035,India
669989,2023-12-18,505,oven,18490,24000,5510,1,00035,India
669989,2023-12-18,502,iphone 15 pro max,100000,135000,35000,1,00035,India
904732,2023-12-18,501,iphone 15,60000,80000,20000,1,00207,India
904732,2023-12-18,502,iphone 15 pro max,100000,135000,35000,1,00207,India
904732,2023-12-18,507,washing machine,6990,16490,9500,1,00207,India
708942,2023-12-18,504,iron,449,879,430,1,00411,India
708942,2023-12-18,506,monitor,3249,8000,4751,1,00411,India
937973,2023-12-18,507,washing machine,6990,16490,9500,1,00234,India
937973,2023-12-18,505,oven,18490,24000,5510,1,00234,India
937973,2023-12-18,503,mixer,1349,3249,1900,1,00234,India
937973,2023-12-18,504,iron,449,879,430,1,00234,India
679584,2023-12-18,506,monitor,3249,8000,4751,1,00276,India
679584,2023-12-18,502,iphone 15 pro max,100000,135000,35000,1,00276,India
679584,2023-12-18,505,oven,18490,24000,5510,1,00276,India
838172,2023-12-18,502,iphone 15 pro max,100000,135000,35000,1,00286,India
826818,2023-12-18,507,washing machine,6990,16490,9500,1,00378,India
893027,2023-12-18,506,monitor,3249,8000,4751,1,00232,India
893027,2023-12-18,503,mixer,1349,3249,1900,1,00232,India
893027,2023-12-18,501,iphone 15,60000,80000,20000,1,00232,India
893027,2023-12-18,504,iron,449,879,430,1,00232,India
409967,2023-12-18,501,iphone 15,60000,80000,20000,1,00375,India
409967,2023-12-18,505,oven,18490,24000,5510,1,00375,India
409967,2023-12-18,502,iphone 15 pro max,100000,135000,35000,1,00375,India
665145,2023-12-18,506,monitor,3249,8000,4751,1,00360,India
665145,2023-12-18,501,iphone 15,60000,80000,20000,1,00360,India
665145,2023-12-18,505,oven,18490,24000,5510,1,00360,India
665145,2023-12-18,503,mixer,1349,3249,1900,1,00360,India
650968,2023-12-18,504,iron,449,879,430,1,00209,India
650968,2023-12-18,505,oven,18490,24000,5510,1,00209,India
650968,2023-12-18,501,iphone 15,60000,80000,20000,1,00209,India
163831,2023-12-18,506,monitor,3249,8000,4751,1,00487,India
163831,2023-12-18,504,iron,449,879,430,1,00487,India
874235,2023-12-18,506,monitor,3249,8000,4751,1,00465,India
874235,2023-12-18,502,iphone 15 pro max,100000,135000,35000,1,00465,India
874235,2023-12-18,507,washing machine,6990,16490,9500,1,00465,India
889604,2023-12-18,506,monitor,3249,8000,4751,1,00026,India
666458,2023-12-18,507,washing machine,6990,16490,9500,1,00132,India
666458,2023-12-18,504,iron,449,879,430,1,00132,India
666458,2023-12-18,501,iphone 15,60000,80000,20000,1,00132,India
315158,2023-12-18,504,iron,449,879,430,1,00159,India
315158,2023-12-18,506,monitor,3249,8000,4751,1,00159,India
315158,2023-12-18,505,oven,18490,24000,5510,1,00159,India
799838,2023-12-18,504,iron,449,879,430,1,00155,India
633813,2023-12-18,506,monitor,3249,8000,4751,1,00116,India
633813,2023-12-18,501,iphone 15,60000,80000,20000,1,00116,India
633813,2023-12-18,503,mixer,1349,3249,1900,1,00116,India
633813,2023-12-18,504,iron,449,879,430,1,00116,India
480388,2023-12-18,505,oven,18490,24000,5510,1,00152,India
562543,2023-12-18,504,iron,449,879,430,1,00248,India
803841,2023-12-18,501,iphone 15,60000,80000,20000,1,00251,India
675418,2023-12-18,503,mixer,1349,3249,1900,1,00073,India
675418,2023-12-18,502,iphone 15 pro max,100000,135000,35000,1,00073,India
675418,2023-12-18,507,washing machine,6990,16490,9500,1,00073,India
948483,2023-12-18,501,iphone 15,60000,80000,20000,1,00315,India
948483,2023-12-18,506,monitor,3249,8000,4751,1,00315,India
948483,2023-12-18,507,washing machine,6990,16490,9500,1,00315,India
948483,2023-12-18,504,iron,449,879,430,1,00315,India
994874,2023-12-18,505,oven,18490,24000,5510,1,00305,India
994874,2023-12-18,502,iphone 15 pro max,100000,135000,35000,1,00305,India
391052,2023-12-18,507,washing machine,6990,16490,9500,1,00254,India
391052,2023-12-18,503,mixer,1349,3249,1900,1,00254,India
784131,2023-12-18,503,mixer,1349,3249,1900,1,00179,India
784131,2023-12-18,504,iron,449,879,430,1,00179,India
605799,2023-12-18,503,mixer,1349,3249,1900,1,00032,India
605799,2023-12-18,507,washing machine,6990,16490,9500,1,00032,India
605799,2023-12-18,505,oven,18490,24000,5510,1,00032,India
557786,2023-12-18,504,iron,449,879,430,1,00127,India
557786,2023-12-18,501,iphone 15,60000,80000,20000,1,00127,India
307105,2023-12-18,504,iron,449,879,430,1,00040,India
307064,2023-12-18,507,washing machine,6990,16490,9500,1,00018,India
307064,2023-12-18,502,iphone 15 pro max,100000,135000,35000,1,00018,India
175592,2023-12-18,505,oven,18490,24000,5510,1,00429,India
175592,2023-12-18,503,mixer,1349,3249,1900,1,00429,India
425007,2023-12-18,506,monitor,3249,8000,4751,1,00178,India
833133,2023-12-18,506,monitor,3249,8000,4751,1,00197,India
833133,2023-12-18,507,washing machine,6990,16490,9500,1,00197,India
833133,2023-12-18,505,oven,18490,24000,5510,1,00197,India
258308,2023-12-18,504,iron,449,879,430,1,00031,India
258308,2023-12-18,506,monitor,3249,8000,4751,1,00031,India
258308,2023-12-18,502,iphone 15 pro max,100000,135000,35000,1,00031,India
258308,2023-12-18,507,washing machine,6990,16490,9500,1,00031,India
258308,2023-12-18,503,mixer,1349,3249,1900,1,00031,India
382640,2023-12-18,502,iphone 15 pro max,100000,135000,35000,1,00018,India
382640,2023-12-18,506,monitor,3249,8000,4751,1,00018,India
755297,2023-12-18,506,monitor,3249,8000,4751,1,00295,India
755297,2023-12-18,502,iphone 15 pro max,100000,135000,35000,1,00295,India
755297,2023-12-18,501,iphone 15,60000,80000,20000,1,00295,India
540994,2023-12-18,503,mixer,1349,3249,1900,1,00235,India
540994,2023-12-18,504,iron,449,879,430,1,00235,India
619067,2023-12-18,507,washing machine,6990,16490,9500,1,00025,India
619067,2023-12-18,504,iron,449,879,430,1,00025,India
128996,2023-12-18,501,iphone 15,60000,80000,20000,1,00379,India
754072,2023-12-18,506,monitor,3249,8000,4751,1,00327,India
754072,2023-12-18,504,iron,449,879,430,1,00327,India
754072,2023-12-18,505,oven,18490,24000,5510,1,00327,India
776751,2023-12-18,504,iron,449,879,430,1,00262,India
776751,2023-12-18,507,washing machine,6990,16490,9500,1,00262,India
627343,2023-12-18,504,iron,449,879,430,1,00429,India
627343,2023-12-18,505,oven,18490,24000,5510,1,00429,India
627343,2023-12-18,503,mixer,1349,3249,1900,1,00429,India
110425,2023-12-18,501,iphone 15,60000,80000,20000,1,00142,India
110425,2023-12-18,506,monitor,3249,8000,4751,1,00142,India
110425,2023-12-18,503,mixer,1349,3249,1900,1,00142,India
110425,2023-12-18,502,iphone 15 pro max,100000,135000,35000,1,00142,India
611268,2023-12-18,503,mixer,1349,3249,1900,1,00186,India
865945,2023-12-18,505,oven,18490,24000,5510,1,00094,India
865945,2023-12-18,507,washing machine,6990,16490,9500,1,00094,India
865945,2023-12-18,504,iron,449,879,430,1,00094,India
865945,2023-12-18,506,monitor,3249,8000,4751,1,00094,India
865945,2023-12-18,503,mixer,1349,3249,1900,1,00094,India
271824,2023-12-18,505,oven,18490,24000,5510,1,00393,India
992978,2023-12-18,502,iphone 15 pro max,100000,135000,35000,1,00169,India
992978,2023-12-18,501,iphone 15,60000,80000,20000,1,00169,India
992978,2023-12-18,504,iron,449,879,430,1,00169,India
992978,2023-12-18,505,oven,18490,24000,5510,1,00169,India
980060,2023-12-18,506,monitor,3249,8000,4751,1,00201,India
980060,2023-12-18,503,mixer,1349,3249,1900,1,00201,India
235891,2023-12-18,507,washing machine,6990,16490,9500,1,00448,India
235891,2023-12-18,506,monitor,3249,8000,4751,1,00448,India
235891,2023-12-18,503,mixer,1349,3249,1900,1,00448,India
997301,2023-12-18,505,oven,18490,24000,5510,1,00155,India
997301,2023-12-18,504,iron,449,879,430,1,00155,India
997301,2023-12-18,502,iphone 15 pro max,100000,135000,35000,1,00155,India
997301,2023-12-18,501,iphone 15,60000,80000,20000,1,00155,India
568407,2023-12-18,503,mixer,1349,3249,1900,1,00208,India
568407,2023-12-18,504,iron,449,879,430,1,00208,India
568407,2023-12-18,507,washing machine,6990,16490,9500,1,00208,India
135043,2023-12-18,507,washing machine,6990,16490,9500,1,00433,India
135043,2023-12-18,502,iphone 15 pro max,100000,135000,35000,1,00433,India
648538,2023-12-18,503,mixer,1349,3249,1900,1,00093,India
648538,2023-12-18,506,monitor,3249,8000,4751,1,00093,India
648538,2023-12-18,505,oven,18490,24000,5510,1,00093,India
648538,2023-12-18,502,iphone 15 pro max,100000,135000,35000,1,00093,India
758811,2023-12-18,505,oven,18490,24000,5510,1,00204,India
561091,2023-12-18,503,mixer,1349,3249,1900,1,00164,India
561091,2023-12-18,507,washing machine,6990,16490,9500,1,00164,India
561091,2023-12-18,502,iphone 15 pro max,100000,135000,35000,1,00164,India
561091,2023-12-18,505,oven,18490,24000,5510,1,00164,India
429364,2023-12-18,501,iphone 15,60000,80000,20000,1,00332,India
380185,2023-12-18,506,monitor,3249,8000,4751,1,00228,India
490426,2023-12-18,503,mixer,1349,3249,1900,1,00313,India
490426,2023-12-18,507,washing machine,6990,16490,9500,1,00313,India
914392,2023-12-18,501,iphone 15,60000,80000,20000,1,00105,India
269208,2023-12-18,507,washing machine,6990,16490,9500,1,00178,India
269208,2023-12-18,506,monitor,3249,8000,4751,1,00178,India
269208,2023-12-18,503,mixer,1349,3249,1900,1,00178,India
252103,2023-12-18,501,iphone 15,60000,80000,20000,1,00010,India
252103,2023-12-18,506,monitor,3249,8000,4751,1,00010,India
829374,2023-12-18,503,mixer,1349,3249,1900,1,00200,India
829374,2023-12-18,505,oven,18490,24000,5510,1,00200,India
829374,2023-12-18,504,iron,449,879,430,1,00200,India
395488,2023-12-18,503,mixer,1349,3249,1900,1,00122,India
395488,2023-12-18,506,monitor,3249,8000,4751,1,00122,India
395488,2023-12-18,501,iphone 15,60000,80000,20000,1,00122,India
445169,2023-12-18,503,mixer,1349,3249,1900,1,00367,India
445169,2023-12-18,505,oven,18490,24000,5510,1,00367,India
715184,2023-12-18,501,iphone 15,60000,80000,20000,1,00272,India
715184,2023-12-18,504,iron,449,879,430,1,00272,India
715184,2023-12-18,506,monitor,3249,8000,4751,1,00272,India
715184,2023-12-18,505,oven,18490,24000,5510,1,00272,India
715184,2023-12-18,503,mixer,1349,3249,1900,1,00272,India
378290,2023-12-19,503,mixer,1349,3249,1900,1,00018,India
378290,2023-12-19,505,oven,18490,24000,5510,1,00018,India
378290,2023-12-19,504,iron,449,879,430,1,00018,India
378290,2023-12-19,506,monitor,3249,8000,4751,1,00018,India
115583,2023-12-19,504,iron,449,879,430,1,00305,India
696050,2023-12-19,502,iphone 15 pro max,100000,135000,35000,1,00260,India
696050,2023-12-19,507,washing machine,6990,16490,9500,1,00260,India
696050,2023-12-19,504,iron,449,879,430,1,00260,India
525253,2023-12-19,501,iphone 15,60000,80000,20000,1,00097,India
525253,2023-12-19,502,iphone 15 pro max,100000,135000,35000,1,00097,India
525253,2023-12-19,506,monitor,3249,8000,4751,1,00097,India
182960,2023-12-19,502,iphone 15 pro max,100000,135000,35000,1,00466,India
182960,2023-12-19,501,iphone 15,60000,80000,20000,1,00466,India
742730,2023-12-19,503,mixer,1349,3249,1900,1,00455,India
742730,2023-12-19,504,iron,449,879,430,1,00455,India
742730,2023-12-19,507,washing machine,6990,16490,9500,1,00455,India
742730,2023-12-19,502,iphone 15 pro max,100000,135000,35000,1,00455,India
505794,2023-12-19,504,iron,449,879,430,1,00056,India
505794,2023-12-19,502,iphone 15 pro max,100000,135000,35000,1,00056,India
137779,2023-12-19,501,iphone 15,60000,80000,20000,1,00488,India
137779,2023-12-19,503,mixer,1349,3249,1900,1,00488,India
137779,2023-12-19,506,monitor,3249,8000,4751,1,00488,India
137779,2023-12-19,504,iron,449,879,430,1,00488,India
180087,2023-12-19,501,iphone 15,60000,80000,20000,1,00007,India
180087,2023-12-19,502,iphone 15 pro max,100000,135000,35000,1,00007,India
299419,2023-12-19,503,mixer,1349,3249,1900,1,00436,India
299419,2023-12-19,504,iron,449,879,430,1,00436,India
527526,2023-12-19,501,iphone 15,60000,80000,20000,1,00334,India
527526,2023-12-19,506,monitor,3249,8000,4751,1,00334,India
561865,2023-12-19,505,oven,18490,24000,5510,1,00148,India
561865,2023-12-19,504,iron,449,879,430,1,00148,India
820012,2023-12-19,506,monitor,3249,8000,4751,1,00380,India
820012,2023-12-19,503,mixer,1349,3249,1900,1,00380,India
820012,2023-12-19,505,oven,18490,24000,5510,1,00380,India
197576,2023-12-19,506,monitor,3249,8000,4751,1,00239,India
197576,2023-12-19,501,iphone 15,60000,80000,20000,1,00239,India
197576,2023-12-19,503,mixer,1349,3249,1900,1,00239,India
197576,2023-12-19,507,washing machine,6990,16490,9500,1,00239,India
587800,2023-12-19,502,iphone 15 pro max,100000,135000,35000,1,00140,India
587800,2023-12-19,503,mixer,1349,3249,1900,1,00140,India
733670,2023-12-19,507,washing machine,6990,16490,9500,1,00175,India
733670,2023-12-19,505,oven,18490,24000,5510,1,00175,India
733670,2023-12-19,502,iphone 15 pro max,100000,135000,35000,1,00175,India
797828,2023-12-19,503,mixer,1349,3249,1900,1,00039,India
797828,2023-12-19,507,washing machine,6990,16490,9500,1,00039,India
797828,2023-12-19,501,iphone 15,60000,80000,20000,1,00039,India
566418,2023-12-19,501,iphone 15,60000,80000,20000,1,00027,India
566418,2023-12-19,506,monitor,3249,8000,4751,1,00027,India
767258,2023-12-19,503,mixer,1349,3249,1900,1,00158,India
767258,2023-12-19,501,iphone 15,60000,80000,20000,1,00158,India
767258,2023-12-19,505,oven,18490,24000,5510,1,00158,India
806517,2023-12-19,506,monitor,3249,8000,4751,1,00240,India
806517,2023-12-19,503,mixer,1349,3249,1900,1,00240,India
806517,2023-12-19,505,oven,18490,24000,5510,1,00240,India
806517,2023-12-19,507,washing machine,6990,16490,9500,1,00240,India
809425,2023-12-19,502,iphone 15 pro max,100000,135000,35000,1,00164,India
809425,2023-12-19,505,oven,18490,24000,5510,1,00164,India
809425,2023-12-19,501,iphone 15,60000,80000,20000,1,00164,India
141156,2023-12-19,502,iphone 15 pro max,100000,135000,35000,1,00321,India
141156,2023-12-19,507,washing machine,6990,16490,9500,1,00321,India
141156,2023-12-19,501,iphone 15,60000,80000,20000,1,00321,India
413377,2023-12-19,503,mixer,1349,3249,1900,1,00207,India
267132,2023-12-19,501,iphone 15,60000,80000,20000,1,00093,India
267132,2023-12-19,504,iron,449,879,430,1,00093,India
267132,2023-12-19,502,iphone 15 pro max,100000,135000,35000,1,00093,India
628255,2023-12-19,506,monitor,3249,8000,4751,1,00410,India
628255,2023-12-19,504,iron,449,879,430,1,00410,India
578327,2023-12-19,505,oven,18490,24000,5510,1,00377,India
578327,2023-12-19,507,washing machine,6990,16490,9500,1,00377,India
578327,2023-12-19,504,iron,449,879,430,1,00377,India
578327,2023-12-19,501,iphone 15,60000,80000,20000,1,00377,India
554011,2023-12-19,501,iphone 15,60000,80000,20000,1,00177,India
554011,2023-12-19,502,iphone 15 pro max,100000,135000,35000,1,00177,India
554011,2023-12-19,505,oven,18490,24000,5510,1,00177,India
166634,2023-12-19,504,iron,449,879,430,1,00196,India
151514,2023-12-19,507,washing machine,6990,16490,9500,1,00320,India
151514,2023-12-19,505,oven,18490,24000,5510,1,00320,India
151514,2023-12-19,501,iphone 15,60000,80000,20000,1,00320,India
151514,2023-12-19,504,iron,449,879,430,1,00320,India
452955,2023-12-19,507,washing machine,6990,16490,9500,1,00279,India
452955,2023-12-19,505,oven,18490,24000,5510,1,00279,India
452955,2023-12-19,506,monitor,3249,8000,4751,1,00279,India
873681,2023-12-19,503,mixer,1349,3249,1900,1,00302,India
873681,2023-12-19,502,iphone 15 pro max,100000,135000,35000,1,00302,India
593225,2023-12-19,501,iphone 15,60000,80000,20000,1,00453,India
593225,2023-12-19,506,monitor,3249,8000,4751,1,00453,India
593225,2023-12-19,505,oven,18490,24000,5510,1,00453,India
593225,2023-12-19,502,iphone 15 pro max,100000,135000,35000,1,00453,India
869225,2023-12-19,504,iron,449,879,430,1,00151,India
869225,2023-12-19,506,monitor,3249,8000,4751,1,00151,India
869225,2023-12-19,502,iphone 15 pro max,100000,135000,35000,1,00151,India
931941,2023-12-19,504,iron,449,879,430,1,00382,India
605398,2023-12-19,502,iphone 15 pro max,100000,135000,35000,1,00055,India
605398,2023-12-19,507,washing machine,6990,16490,9500,1,00055,India
145796,2023-12-19,505,oven,18490,24000,5510,1,00440,India
145796,2023-12-19,506,monitor,3249,8000,4751,1,00440,India
145796,2023-12-19,501,iphone 15,60000,80000,20000,1,00440,India
507850,2023-12-19,502,iphone 15 pro max,100000,135000,35000,1,00394,India
944070,2023-12-19,504,iron,449,879,430,1,00208,India
945242,2023-12-19,503,mixer,1349,3249,1900,1,00313,India
695196,2023-12-19,502,iphone 15 pro max,100000,135000,35000,1,00499,India
695196,2023-12-19,507,washing machine,6990,16490,9500,1,00499,India
695196,2023-12-19,505,oven,18490,24000,5510,1,00499,India
695196,2023-12-19,501,iphone 15,60000,80000,20000,1,00499,India
473886,2023-12-19,505,oven,18490,24000,5510,1,00104,India
915359,2023-12-19,501,iphone 15,60000,80000,20000,1,00455,India
915359,2023-12-19,505,oven,18490,24000,5510,1,00455,India
915359,2023-12-19,502,iphone 15 pro max,100000,135000,35000,1,00455,India
915359,2023-12-19,506,monitor,3249,8000,4751,1,00455,India
915359,2023-12-19,503,mixer,1349,3249,1900,1,00455,India
728201,2023-12-19,502,iphone 15 pro max,100000,135000,35000,1,00411,India
547363,2023-12-19,502,iphone 15 pro max,100000,135000,35000,1,00071,India
547363,2023-12-19,507,washing machine,6990,16490,9500,1,00071,India
547363,2023-12-19,504,iron,449,879,430,1,00071,India
547363,2023-12-19,506,monitor,3249,8000,4751,1,00071,India
146379,2023-12-19,505,oven,18490,24000,5510,1,00156,India
146379,2023-12-19,506,monitor,3249,8000,4751,1,00156,India
146379,2023-12-19,501,iphone 15,60000,80000,20000,1,00156,India
146379,2023-12-19,507,washing machine,6990,16490,9500,1,00156,India
852692,2023-12-19,507,washing machine,6990,16490,9500,1,00480,India
688106,2023-12-19,506,monitor,3249,8000,4751,1,00374,India
688106,2023-12-19,501,iphone 15,60000,80000,20000,1,00374,India
448806,2023-12-19,502,iphone 15 pro max,100000,135000,35000,1,00183,India
793688,2023-12-19,501,iphone 15,60000,80000,20000,1,00293,India
223427,2023-12-19,502,iphone 15 pro max,100000,135000,35000,1,00287,India
223427,2023-12-19,507,washing machine,6990,16490,9500,1,00287,India
223427,2023-12-19,501,iphone 15,60000,80000,20000,1,00287,India
223427,2023-12-19,506,monitor,3249,8000,4751,1,00287,India
555787,2023-12-19,505,oven,18490,24000,5510,1,00249,India
555787,2023-12-19,507,washing machine,6990,16490,9500,1,00249,India
493594,2023-12-19,507,washing machine,6990,16490,9500,1,00326,India
493594,2023-12-19,502,iphone 15 pro max,100000,135000,35000,1,00326,India
493594,2023-12-19,501,iphone 15,60000,80000,20000,1,00326,India
796713,2023-12-19,505,oven,18490,24000,5510,1,00313,India
439341,2023-12-19,501,iphone 15,60000,80000,20000,1,00491,India
439341,2023-12-19,506,monitor,3249,8000,4751,1,00491,India
439341,2023-12-19,502,iphone 15 pro max,100000,135000,35000,1,00491,India
439341,2023-12-19,503,mixer,1349,3249,1900,1,00491,India
680830,2023-12-19,503,mixer,1349,3249,1900,1,00225,India
680830,2023-12-19,505,oven,18490,24000,5510,1,00225,India
725541,2023-12-19,504,iron,449,879,430,1,00072,India
725541,2023-12-19,505,oven,18490,24000,5510,1,00072,India
725541,2023-12-19,503,mixer,1349,3249,1900,1,00072,India
725541,2023-12-19,506,monitor,3249,8000,4751,1,00072,India
367853,2023-12-19,504,iron,449,879,430,1,00168,India
367853,2023-12-19,507,washing machine,6990,16490,9500,1,00168,India
661525,2023-12-19,504,iron,449,879,430,1,00243,India
759921,2023-12-19,501,iphone 15,60000,80000,20000,1,00002,India
409275,2023-12-19,504,iron,449,879,430,1,00111,India
409275,2023-12-19,506,monitor,3249,8000,4751,1,00111,India
409275,2023-12-19,507,washing machine,6990,16490,9500,1,00111,India
606014,2023-12-19,504,iron,449,879,430,1,00175,India
290933,2023-12-19,502,iphone 15 pro max,100000,135000,35000,1,00085,India
290933,2023-12-19,507,washing machine,6990,16490,9500,1,00085,India
290933,2023-12-19,503,mixer,1349,3249,1900,1,00085,India
353893,2023-12-19,506,monitor,3249,8000,4751,1,00321,India
772520,2023-12-19,506,monitor,3249,8000,4751,1,00050,India
772520,2023-12-19,503,mixer,1349,3249,1900,1,00050,India
772520,2023-12-19,502,iphone 15 pro max,100000,135000,35000,1,00050,India
254100,2023-12-19,505,oven,18490,24000,5510,1,00218,India
254100,2023-12-19,507,washing machine,6990,16490,9500,1,00218,India
254100,2023-12-19,503,mixer,1349,3249,1900,1,00218,India
320749,2023-12-19,507,washing machine,6990,16490,9500,1,00404,India
320749,2023-12-19,501,iphone 15,60000,80000,20000,1,00404,India
320749,2023-12-19,505,oven,18490,24000,5510,1,00404,India
320749,2023-12-19,506,monitor,3249,8000,4751,1,00404,India
128914,2023-12-19,501,iphone 15,60000,80000,20000,1,00444,India
213084,2023-12-19,507,washing machine,6990,16490,9500,1,00279,India
213084,2023-12-19,501,iphone 15,60000,80000,20000,1,00279,India
643160,2023-12-19,501,iphone 15,60000,80000,20000,1,00098,India
643160,2023-12-19,507,washing machine,6990,16490,9500,1,00098,India
643160,2023-12-19,503,mixer,1349,3249,1900,1,00098,India
643160,2023-12-19,506,monitor,3249,8000,4751,1,00098,India
819675,2023-12-19,507,washing machine,6990,16490,9500,1,00278,India
695503,2023-12-19,501,iphone 15,60000,80000,20000,1,00267,India
695503,2023-12-19,506,monitor,3249,8000,4751,1,00267,India
695503,2023-12-19,504,iron,449,879,430,1,00267,India
184216,2023-12-19,502,iphone 15 pro max,100000,135000,35000,1,00113,India
184216,2023-12-19,501,iphone 15,60000,80000,20000,1,00113,India
138065,2023-12-19,506,monitor,3249,8000,4751,1,00421,India
138065,2023-12-19,503,mixer,1349,3249,1900,1,00421,India
724923,2023-12-19,502,iphone 15 pro max,100000,135000,35000,1,00340,India
724923,2023-12-19,503,mixer,1349,3249,1900,1,00340,India
724923,2023-12-19,505,oven,18490,24000,5510,1,00340,India
202223,2023-12-19,505,oven,18490,24000,5510,1,00457,India
202223,2023-12-19,507,washing machine,6990,16490,9500,1,00457,India
202223,2023-12-19,501,iphone 15,60000,80000,20000,1,00457,India
817182,2023-12-19,504,iron,449,879,430,1,00430,India
532147,2023-12-19,507,washing machine,6990,16490,9500,1,00411,India
532147,2023-12-19,505,oven,18490,24000,5510,1,00411,India
532147,2023-12-19,503,mixer,1349,3249,1900,1,00411,India
220095,2023-12-20,504,iron,449,879,430,1,00414,India
220095,2023-12-20,502,iphone 15 pro max,100000,135000,35000,1,00414,India
220095,2023-12-20,507,washing machine,6990,16490,9500,1,00414,India
273880,2023-12-20,502,iphone 15 pro max,100000,135000,35000,1,00250,India
273880,2023-12-20,504,iron,449,879,430,1,00250,India
983189,2023-12-20,505,oven,18490,24000,5510,1,00313,India
554488,2023-12-20,503,mixer,1349,3249,1900,1,00032,India
554488,2023-12-20,507,washing machine,6990,16490,9500,1,00032,India
554488,2023-12-20,505,oven,18490,24000,5510,1,00032,India
319084,2023-12-20,503,mixer,1349,3249,1900,1,00139,India
319084,2023-12-20,505,oven,18490,24000,5510,1,00139,India
319084,2023-12-20,507,washing machine,6990,16490,9500,1,00139,India
319084,2023-12-20,501,iphone 15,60000,80000,20000,1,00139,India
319084,2023-12-20,504,iron,449,879,430,1,00139,India
279990,2023-12-20,507,washing machine,6990,16490,9500,1,00318,India
279990,2023-12-20,501,iphone 15,60000,80000,20000,1,00318,India
279990,2023-12-20,506,monitor,3249,8000,4751,1,00318,India
817460,2023-12-20,504,iron,449,879,430,1,00016,India
817460,2023-12-20,502,iphone 15 pro max,100000,135000,35000,1,00016,India
817460,2023-12-20,505,oven,18490,24000,5510,1,00016,India
817460,2023-12-20,503,mixer,1349,3249,1900,1,00016,India
926316,2023-12-20,501,iphone 15,60000,80000,20000,1,00483,India
239590,2023-12-20,503,mixer,1349,3249,1900,1,00425,India
239590,2023-12-20,504,iron,449,879,430,1,00425,India
960128,2023-12-20,503,mixer,1349,3249,1900,1,00464,India
157256,2023-12-20,503,mixer,1349,3249,1900,1,00168,India
157256,2023-12-20,506,monitor,3249,8000,4751,1,00168,India
379139,2023-12-20,504,iron,449,879,430,1,00257,India
379139,2023-12-20,501,iphone 15,60000,80000,20000,1,00257,India
556869,2023-12-20,501,iphone 15,60000,80000,20000,1,00394,India
556869,2023-12-20,505,oven,18490,24000,5510,1,00394,India
639645,2023-12-20,504,iron,449,879,430,1,00101,India
114349,2023-12-20,501,iphone 15,60000,80000,20000,1,00061,India
114349,2023-12-20,503,mixer,1349,3249,1900,1,00061,India
114349,2023-12-20,507,washing machine,6990,16490,9500,1,00061,India
798807,2023-12-20,505,oven,18490,24000,5510,1,00247,India
798807,2023-12-20,507,washing machine,6990,16490,9500,1,00247,India
798807,2023-12-20,504,iron,449,879,430,1,00247,India
179947,2023-12-20,506,monitor,3249,8000,4751,1,00085,India
179947,2023-12-20,504,iron,449,879,430,1,00085,India
179947,2023-12-20,505,oven,18490,24000,5510,1,00085,India
179947,2023-12-20,502,iphone 15 pro max,100000,135000,35000,1,00085,India
363780,2023-12-20,506,monitor,3249,8000,4751,1,00291,India
363780,2023-12-20,503,mixer,1349,3249,1900,1,00291,India
519330,2023-12-20,504,iron,449,879,430,1,00222,India
523647,2023-12-20,502,iphone 15 pro max,100000,135000,35000,1,00305,India
523647,2023-12-20,507,washing machine,6990,16490,9500,1,00305,India
523647,2023-12-20,505,oven,18490,24000,5510,1,00305,India
523647,2023-12-20,503,mixer,1349,3249,1900,1,00305,India
117736,2023-12-20,501,iphone 15,60000,80000,20000,1,00236,India
117736,2023-12-20,502,iphone 15 pro max,100000,135000,35000,1,00236,India
117736,2023-12-20,507,washing machine,6990,16490,9500,1,00236,India
712473,2023-12-20,505,oven,18490,24000,5510,1,00081,India
712473,2023-12-20,506,monitor,3249,8000,4751,1,00081,India
712473,2023-12-20,507,washing machine,6990,16490,9500,1,00081,India
772562,2023-12-20,506,monitor,3249,8000,4751,1,00250,India
772562,2023-12-20,505,oven,18490,24000,5510,1,00250,India
772562,2023-12-20,504,iron,449,879,430,1,00250,India
118278,2023-12-20,507,washing machine,6990,16490,9500,1,00018,India
118278,2023-12-20,504,iron,449,879,430,1,00018,India
211056,2023-12-20,505,oven,18490,24000,5510,1,00038,India
276554,2023-12-20,506,monitor,3249,8000,4751,1,00192,India
276554,2023-12-20,501,iphone 15,60000,80000,20000,1,00192,India
346503,2023-12-20,505,oven,18490,24000,5510,1,00194,India
346503,2023-12-20,506,monitor,3249,8000,4751,1,00194,India
783733,2023-12-20,505,oven,18490,24000,5510,1,00271,India
783733,2023-12-20,501,iphone 15,60000,80000,20000,1,00271,India
783733,2023-12-20,507,washing machine,6990,16490,9500,1,00271,India
783733,2023-12-20,502,iphone 15 pro max,100000,135000,35000,1,00271,India
839731,2023-12-20,506,monitor,3249,8000,4751,1,00326,India
839731,2023-12-20,501,iphone 15,60000,80000,20000,1,00326,India
839731,2023-12-20,507,washing machine,6990,16490,9500,1,00326,India
581480,2023-12-20,506,monitor,3249,8000,4751,1,00420,India
795997,2023-12-20,505,oven,18490,24000,5510,1,00074,India
795997,2023-12-20,502,iphone 15 pro max,100000,135000,35000,1,00074,India
795997,2023-12-20,501,iphone 15,60000,80000,20000,1,00074,India
795997,2023-12-20,506,monitor,3249,8000,4751,1,00074,India
268872,2023-12-20,505,oven,18490,24000,5510,1,00255,India
268872,2023-12-20,501,iphone 15,60000,80000,20000,1,00255,India
268872,2023-12-20,506,monitor,3249,8000,4751,1,00255,India
268872,2023-12-20,503,mixer,1349,3249,1900,1,00255,India
398414,2023-12-20,504,iron,449,879,430,1,00241,India
866063,2023-12-20,507,washing machine,6990,16490,9500,1,00474,India
866063,2023-12-20,505,oven,18490,24000,5510,1,00474,India
866063,2023-12-20,503,mixer,1349,3249,1900,1,00474,India
804393,2023-12-20,506,monitor,3249,8000,4751,1,00440,India
804393,2023-12-20,507,washing machine,6990,16490,9500,1,00440,India
804393,2023-12-20,505,oven,18490,24000,5510,1,00440,India
804393,2023-12-20,504,iron,449,879,430,1,00440,India
816797,2023-12-20,505,oven,18490,24000,5510,1,00308,India
200232,2023-12-20,506,monitor,3249,8000,4751,1,00481,India
200232,2023-12-20,505,oven,18490,24000,5510,1,00481,India
200232,2023-12-20,503,mixer,1349,3249,1900,1,00481,India
736827,2023-12-20,502,iphone 15 pro max,100000,135000,35000,1,00487,India
736827,2023-12-20,501,iphone 15,60000,80000,20000,1,00487,India
736827,2023-12-20,503,mixer,1349,3249,1900,1,00487,India
524007,2023-12-20,504,iron,449,879,430,1,00189,India
524007,2023-12-20,507,washing machine,6990,16490,9500,1,00189,India
524007,2023-12-20,503,mixer,1349,3249,1900,1,00189,India
407805,2023-12-20,504,iron,449,879,430,1,00356,India
407805,2023-12-20,502,iphone 15 pro max,100000,135000,35000,1,00356,India
456157,2023-12-20,505,oven,18490,24000,5510,1,00092,India
523375,2023-12-20,505,oven,18490,24000,5510,1,00261,India
523375,2023-12-20,507,washing machine,6990,16490,9500,1,00261,India
523375,2023-12-20,503,mixer,1349,3249,1900,1,00261,India
523375,2023-12-20,506,monitor,3249,8000,4751,1,00261,India
301339,2023-12-20,504,iron,449,879,430,1,00068,India
301339,2023-12-20,502,iphone 15 pro max,100000,135000,35000,1,00068,India
301339,2023-12-20,501,iphone 15,60000,80000,20000,1,00068,India
996639,2023-12-20,503,mixer,1349,3249,1900,1,00182,India
996639,2023-12-20,502,iphone 15 pro max,100000,135000,35000,1,00182,India
996639,2023-12-20,507,washing machine,6990,16490,9500,1,00182,India
719328,2023-12-20,502,iphone 15 pro max,100000,135000,35000,1,00367,India
719328,2023-12-20,507,washing machine,6990,16490,9500,1,00367,India
719328,2023-12-20,501,iphone 15,60000,80000,20000,1,00367,India
719328,2023-12-20,503,mixer,1349,3249,1900,1,00367,India
761621,2023-12-20,504,iron,449,879,430,1,00010,India
761621,2023-12-20,502,iphone 15 pro max,100000,135000,35000,1,00010,India
761621,2023-12-20,507,washing machine,6990,16490,9500,1,00010,India
366602,2023-12-20,502,iphone 15 pro max,100000,135000,35000,1,00442,India
366602,2023-12-20,503,mixer,1349,3249,1900,1,00442,India
366602,2023-12-20,507,washing machine,6990,16490,9500,1,00442,India
653945,2023-12-20,504,iron,449,879,430,1,00408,India
653945,2023-12-20,507,washing machine,6990,16490,9500,1,00408,India
653945,2023-12-20,501,iphone 15,60000,80000,20000,1,00408,India
469669,2023-12-20,501,iphone 15,60000,80000,20000,1,00163,India
469669,2023-12-20,505,oven,18490,24000,5510,1,00163,India
469669,2023-12-20,507,washing machine,6990,16490,9500,1,00163,India
867649,2023-12-20,505,oven,18490,24000,5510,1,00186,India
867649,2023-12-20,503,mixer,1349,3249,1900,1,00186,India
671045,2023-12-20,507,washing machine,6990,16490,9500,1,00126,India
671045,2023-12-20,503,mixer,1349,3249,1900,1,00126,India
671045,2023-12-20,501,iphone 15,60000,80000,20000,1,00126,India
671045,2023-12-20,502,iphone 15 pro max,100000,135000,35000,1,00126,India
388500,2023-12-20,504,iron,449,879,430,1,00066,India
538558,2023-12-20,504,iron,449,879,430,1,00304,India
538558,2023-12-20,507,washing machine,6990,16490,9500,1,00304,India
538558,2023-12-20,506,monitor,3249,8000,4751,1,00304,India
792312,2023-12-20,506,monitor,3249,8000,4751,1,00433,India
792312,2023-12-20,501,iphone 15,60000,80000,20000,1,00433,India
792312,2023-12-20,505,oven,18490,24000,5510,1,00433,India
792312,2023-12-20,503,mixer,1349,3249,1900,1,00433,India
586329,2023-12-20,504,iron,449,879,430,1,00309,India
586329,2023-12-20,505,oven,18490,24000,5510,1,00309,India
586329,2023-12-20,501,iphone 15,60000,80000,20000,1,00309,India
586329,2023-12-20,507,washing machine,6990,16490,9500,1,00309,India
100872,2023-12-20,502,iphone 15 pro max,100000,135000,35000,1,00500,India
233256,2023-12-20,501,iphone 15,60000,80000,20000,1,00204,India
233256,2023-12-20,507,washing machine,6990,16490,9500,1,00204,India
233256,2023-12-20,506,monitor,3249,8000,4751,1,00204,India
276164,2023-12-20,501,iphone 15,60000,80000,20000,1,00410,India
420893,2023-12-20,504,iron,449,879,430,1,00400,India
420893,2023-12-20,502,iphone 15 pro max,100000,135000,35000,1,00400,India
680309,2023-12-20,504,iron,449,879,430,1,00434,India
680309,2023-12-20,506,monitor,3249,8000,4751,1,00434,India
657949,2023-12-20,505,oven,18490,24000,5510,1,00334,India
657949,2023-12-20,504,iron,449,879,430,1,00334,India
657949,2023-12-20,506,monitor,3249,8000,4751,1,00334,India
577713,2023-12-20,503,mixer,1349,3249,1900,1,00342,India
577713,2023-12-20,504,iron,449,879,430,1,00342,India
723224,2023-12-20,505,oven,18490,24000,5510,1,00075,India
604487,2023-12-20,505,oven,18490,24000,5510,1,00320,India
604487,2023-12-20,503,mixer,1349,3249,1900,1,00320,India
746672,2023-12-20,503,mixer,1349,3249,1900,1,00011,India
746672,2023-12-20,505,oven,18490,24000,5510,1,00011,India
746672,2023-12-20,507,washing machine,6990,16490,9500,1,00011,India
746672,2023-12-20,501,iphone 15,60000,80000,20000,1,00011,India
962086,2023-12-20,502,iphone 15 pro max,100000,135000,35000,1,00293,India
881298,2023-12-20,501,iphone 15,60000,80000,20000,1,00121,India
881298,2023-12-20,506,monitor,3249,8000,4751,1,00121,India
660396,2023-12-20,501,iphone 15,60000,80000,20000,1,00109,India
660396,2023-12-20,504,iron,449,879,430,1,00109,India
660396,2023-12-20,505,oven,18490,24000,5510,1,00109,India
140730,2023-12-20,501,iphone 15,60000,80000,20000,1,00288,India
219743,2023-12-20,505,oven,18490,24000,5510,1,00058,India
219743,2023-12-20,502,iphone 15 pro max,100000,135000,35000,1,00058,India
219743,2023-12-20,506,monitor,3249,8000,4751,1,00058,India
895199,2023-12-20,501,iphone 15,60000,80000,20000,1,00225,India
895199,2023-12-20,505,oven,18490,24000,5510,1,00225,India
895199,2023-12-20,503,mixer,1349,3249,1900,1,00225,India
895199,2023-12-20,506,monitor,3249,8000,4751,1,00225,India
432516,2023-12-20,503,mixer,1349,3249,1900,1,00418,India
432516,2023-12-20,507,washing machine,6990,16490,9500,1,00418,India
875132,2023-12-20,502,iphone 15 pro max,100000,135000,35000,1,00112,India
875132,2023-12-20,506,monitor,3249,8000,4751,1,00112,India
403231,2023-12-20,503,mixer,1349,3249,1900,1,00063,India
403231,2023-12-20,507,washing machine,6990,16490,9500,1,00063,India
403231,2023-12-20,504,iron,449,879,430,1,00063,India
403231,2023-12-20,502,iphone 15 pro max,100000,135000,35000,1,00063,India
909497,2023-12-20,507,washing machine,6990,16490,9500,1,00043,India
301390,2023-12-20,503,mixer,1349,3249,1900,1,00087,India
495769,2023-12-20,501,iphone 15,60000,80000,20000,1,00149,India
495769,2023-12-20,506,monitor,3249,8000,4751,1,00149,India
495769,2023-12-20,505,oven,18490,24000,5510,1,00149,India
495769,2023-12-20,503,mixer,1349,3249,1900,1,00149,India
214253,2023-12-20,502,iphone 15 pro max,100000,135000,35000,1,00262,India
214253,2023-12-20,505,oven,18490,24000,5510,1,00262,India
214253,2023-12-20,501,iphone 15,60000,80000,20000,1,00262,India
950173,2023-12-20,502,iphone 15 pro max,100000,135000,35000,1,00371,India
950173,2023-12-20,504,iron,449,879,430,1,00371,India
950173,2023-12-20,507,washing machine,6990,16490,9500,1,00371,India
950173,2023-12-20,506,monitor,3249,8000,4751,1,00371,India
423097,2023-12-20,507,washing machine,6990,16490,9500,1,00213,India
423097,2023-12-20,506,monitor,3249,8000,4751,1,00213,India
123940,2023-12-20,503,mixer,1349,3249,1900,1,00113,India
238548,2023-12-20,505,oven,18490,24000,5510,1,00361,India
238548,2023-12-20,502,iphone 15 pro max,100000,135000,35000,1,00361,India
982566,2023-12-20,505,oven,18490,24000,5510,1,00304,India
982566,2023-12-20,502,iphone 15 pro max,100000,135000,35000,1,00304,India
982566,2023-12-20,503,mixer,1349,3249,1900,1,00304,India
373704,2023-12-20,503,mixer,1349,3249,1900,1,00468,India
373704,2023-12-20,504,iron,449,879,430,1,00468,India
373704,2023-12-20,507,washing machine,6990,16490,9500,1,00468,India
240174,2023-12-20,504,iron,449,879,430,1,00298,India
240174,2023-12-20,501,iphone 15,60000,80000,20000,1,00298,India
240174,2023-12-20,502,iphone 15 pro max,100000,135000,35000,1,00298,India
822675,2023-12-20,502,iphone 15 pro max,100000,135000,35000,1,00047,India
822675,2023-12-20,506,monitor,3249,8000,4751,1,00047,India
908684,2023-12-20,506,monitor,3249,8000,4751,1,00041,India
908684,2023-12-20,501,iphone 15,60000,80000,20000,1,00041,India
908684,2023-12-20,503,mixer,1349,3249,1900,1,00041,India
916025,2023-12-20,501,iphone 15,60000,80000,20000,1,00079,India
468098,2023-12-21,507,washing machine,6990,16490,9500,1,00293,India
468098,2023-12-21,506,monitor,3249,8000,4751,1,00293,India
468098,2023-12-21,501,iphone 15,60000,80000,20000,1,00293,India
446513,2023-12-21,501,iphone 15,60000,80000,20000,1,00460,India
446513,2023-12-21,503,mixer,1349,3249,1900,1,00460,India
572940,2023-12-21,503,mixer,1349,3249,1900,1,00265,India
119152,2023-12-21,506,monitor,3249,8000,4751,1,00470,India
119152,2023-12-21,507,washing machine,6990,16490,9500,1,00470,India
119152,2023-12-21,502,iphone 15 pro max,100000,135000,35000,1,00470,India
119152,2023-12-21,501,iphone 15,60000,80000,20000,1,00470,India
119152,2023-12-21,503,mixer,1349,3249,1900,1,00470,India
221858,2023-12-21,502,iphone 15 pro max,100000,135000,35000,1,00293,India
221858,2023-12-21,506,monitor,3249,8000,4751,1,00293,India
682736,2023-12-21,503,mixer,1349,3249,1900,1,00173,India
682736,2023-12-21,505,oven,18490,24000,5510,1,00173,India
414970,2023-12-21,502,iphone 15 pro max,100000,135000,35000,1,00067,India
414970,2023-12-21,505,oven,18490,24000,5510,1,00067,India
414970,2023-12-21,503,mixer,1349,3249,1900,1,00067,India
479087,2023-12-21,502,iphone 15 pro max,100000,135000,35000,1,00031,India
422179,2023-12-21,502,iphone 15 pro max,100000,135000,35000,1,00021,India
346421,2023-12-21,503,mixer,1349,3249,1900,1,00102,India
346421,2023-12-21,501,iphone 15,60000,80000,20000,1,00102,India
327300,2023-12-21,506,monitor,3249,8000,4751,1,00395,India
327300,2023-12-21,505,oven,18490,24000,5510,1,00395,India
263156,2023-12-21,505,oven,18490,24000,5510,1,00419,India
263156,2023-12-21,501,iphone 15,60000,80000,20000,1,00419,India
263156,2023-12-21,503,mixer,1349,3249,1900,1,00419,India
751964,2023-12-21,501,iphone 15,60000,80000,20000,1,00032,India
751964,2023-12-21,507,washing machine,6990,16490,9500,1,00032,India
751964,2023-12-21,504,iron,449,879,430,1,00032,India
751964,2023-12-21,502,iphone 15 pro max,100000,135000,35000,1,00032,India
751964,2023-12-21,506,monitor,3249,8000,4751,1,00032,India
266093,2023-12-21,507,washing machine,6990,16490,9500,1,00286,India
266093,2023-12-21,503,mixer,1349,3249,1900,1,00286,India
266093,2023-12-21,506,monitor,3249,8000,4751,1,00286,India
266093,2023-12-21,501,iphone 15,60000,80000,20000,1,00286,India
222657,2023-12-21,503,mixer,1349,3249,1900,1,00115,India
222657,2023-12-21,502,iphone 15 pro max,100000,135000,35000,1,00115,India
222657,2023-12-21,504,iron,449,879,430,1,00115,India
946065,2023-12-21,501,iphone 15,60000,80000,20000,1,00047,India
946065,2023-12-21,502,iphone 15 pro max,100000,135000,35000,1,00047,India
946065,2023-12-21,506,monitor,3249,8000,4751,1,00047,India
432136,2023-12-21,501,iphone 15,60000,80000,20000,1,00261,India
432136,2023-12-21,502,iphone 15 pro max,100000,135000,35000,1,00261,India
211479,2023-12-21,504,iron,449,879,430,1,00026,India
211479,2023-12-21,505,oven,18490,24000,5510,1,00026,India
211479,2023-12-21,502,iphone 15 pro max,100000,135000,35000,1,00026,India
408765,2023-12-21,502,iphone 15 pro max,100000,135000,35000,1,00097,India
408765,2023-12-21,506,monitor,3249,8000,4751,1,00097,India
202758,2023-12-21,502,iphone 15 pro max,100000,135000,35000,1,00103,India
125871,2023-12-21,503,mixer,1349,3249,1900,1,00304,India
125871,2023-12-21,507,washing machine,6990,16490,9500,1,00304,India
125871,2023-12-21,505,oven,18490,24000,5510,1,00304,India
888770,2023-12-21,501,iphone 15,60000,80000,20000,1,00035,India
888770,2023-12-21,504,iron,449,879,430,1,00035,India
888770,2023-12-21,503,mixer,1349,3249,1900,1,00035,India
224628,2023-12-21,505,oven,18490,24000,5510,1,00322,India
335505,2023-12-21,502,iphone 15 pro max,100000,135000,35000,1,00044,India
335505,2023-12-21,501,iphone 15,60000,80000,20000,1,00044,India
525026,2023-12-21,504,iron,449,879,430,1,00068,India
526496,2023-12-21,504,iron,449,879,430,1,00469,India
526496,2023-12-21,506,monitor,3249,8000,4751,1,00469,India
890205,2023-12-21,506,monitor,3249,8000,4751,1,00154,India
890205,2023-12-21,502,iphone 15 pro max,100000,135000,35000,1,00154,India
890205,2023-12-21,503,mixer,1349,3249,1900,1,00154,India
890205,2023-12-21,505,oven,18490,24000,5510,1,00154,India
890205,2023-12-21,501,iphone 15,60000,80000,20000,1,00154,India
482081,2023-12-21,505,oven,18490,24000,5510,1,00205,India
482081,2023-12-21,501,iphone 15,60000,80000,20000,1,00205,India
482081,2023-12-21,503,mixer,1349,3249,1900,1,00205,India
608059,2023-12-21,501,iphone 15,60000,80000,20000,1,00203,India
608059,2023-12-21,503,mixer,1349,3249,1900,1,00203,India
608059,2023-12-21,504,iron,449,879,430,1,00203,India
608059,2023-12-21,506,monitor,3249,8000,4751,1,00203,India
335897,2023-12-21,504,iron,449,879,430,1,00080,India
335897,2023-12-21,503,mixer,1349,3249,1900,1,00080,India
551879,2023-12-21,501,iphone 15,60000,80000,20000,1,00314,India
551879,2023-12-21,503,mixer,1349,3249,1900,1,00314,India
603195,2023-12-21,504,iron,449,879,430,1,00459,India
603195,2023-12-21,502,iphone 15 pro max,100000,135000,35000,1,00459,India
286273,2023-12-21,506,monitor,3249,8000,4751,1,00485,India
286273,2023-12-21,504,iron,449,879,430,1,00485,India
286273,2023-12-21,505,oven,18490,24000,5510,1,00485,India
286273,2023-12-21,507,washing machine,6990,16490,9500,1,00485,India
157780,2023-12-21,504,iron,449,879,430,1,00279,India
157780,2023-12-21,502,iphone 15 pro max,100000,135000,35000,1,00279,India
157780,2023-12-21,501,iphone 15,60000,80000,20000,1,00279,India
157780,2023-12-21,505,oven,18490,24000,5510,1,00279,India
332943,2023-12-21,502,iphone 15 pro max,100000,135000,35000,1,00380,India
332943,2023-12-21,506,monitor,3249,8000,4751,1,00380,India
332943,2023-12-21,505,oven,18490,24000,5510,1,00380,India
332943,2023-12-21,507,washing machine,6990,16490,9500,1,00380,India
869562,2023-12-21,507,washing machine,6990,16490,9500,1,00374,India
869562,2023-12-21,502,iphone 15 pro max,100000,135000,35000,1,00374,India
426791,2023-12-21,504,iron,449,879,430,1,00217,India
401462,2023-12-21,502,iphone 15 pro max,100000,135000,35000,1,00159,India
303765,2023-12-21,502,iphone 15 pro max,100000,135000,35000,1,00199,India
303765,2023-12-21,507,washing machine,6990,16490,9500,1,00199,India
303765,2023-12-21,503,mixer,1349,3249,1900,1,00199,India
151728,2023-12-21,501,iphone 15,60000,80000,20000,1,00012,India
151728,2023-12-21,503,mixer,1349,3249,1900,1,00012,India
151728,2023-12-21,506,monitor,3249,8000,4751,1,00012,India
388309,2023-12-21,503,mixer,1349,3249,1900,1,00322,India
388309,2023-12-21,505,oven,18490,24000,5510,1,00322,India
388309,2023-12-21,501,iphone 15,60000,80000,20000,1,00322,India
553228,2023-12-21,506,monitor,3249,8000,4751,1,00168,India
553228,2023-12-21,503,mixer,1349,3249,1900,1,00168,India
452798,2023-12-21,507,washing machine,6990,16490,9500,1,00458,India
282118,2023-12-21,505,oven,18490,24000,5510,1,00323,India
752466,2023-12-21,506,monitor,3249,8000,4751,1,00289,India
752466,2023-12-21,502,iphone 15 pro max,100000,135000,35000,1,00289,India
847820,2023-12-21,505,oven,18490,24000,5510,1,00259,India
847820,2023-12-21,504,iron,449,879,430,1,00259,India
847820,2023-12-21,506,monitor,3249,8000,4751,1,00259,India
634475,2023-12-21,502,iphone 15 pro max,100000,135000,35000,1,00387,India
634475,2023-12-21,506,monitor,3249,8000,4751,1,00387,India
426640,2023-12-21,504,iron,449,879,430,1,00143,India
426640,2023-12-21,501,iphone 15,60000,80000,20000,1,00143,India
426640,2023-12-21,507,washing machine,6990,16490,9500,1,00143,India
957459,2023-12-21,503,mixer,1349,3249,1900,1,00333,India
259270,2023-12-21,507,washing machine,6990,16490,9500,1,00411,India
259270,2023-12-21,503,mixer,1349,3249,1900,1,00411,India
428980,2023-12-21,506,monitor,3249,8000,4751,1,00332,India
428980,2023-12-21,501,iphone 15,60000,80000,20000,1,00332,India
428980,2023-12-21,505,oven,18490,24000,5510,1,00332,India
497845,2023-12-21,502,iphone 15 pro max,100000,135000,35000,1,00296,India
703153,2023-12-21,502,iphone 15 pro max,100000,135000,35000,1,00375,India
242469,2023-12-21,505,oven,18490,24000,5510,1,00251,India
242469,2023-12-21,506,monitor,3249,8000,4751,1,00251,India
242469,2023-12-21,504,iron,449,879,430,1,00251,India
101380,2023-12-21,502,iphone 15 pro max,100000,135000,35000,1,00163,India
363438,2023-12-21,506,monitor,3249,8000,4751,1,00409,India
363438,2023-12-21,501,iphone 15,60000,80000,20000,1,00409,India
363438,2023-12-21,502,iphone 15 pro max,100000,135000,35000,1,00409,India
435060,2023-12-21,501,iphone 15,60000,80000,20000,1,00437,India
435060,2023-12-21,506,monitor,3249,8000,4751,1,00437,India
435060,2023-12-21,503,mixer,1349,3249,1900,1,00437,India
435060,2023-12-21,502,iphone 15 pro max,100000,135000,35000,1,00437,India
108583,2023-12-21,505,oven,18490,24000,5510,1,00440,India
108583,2023-12-21,503,mixer,1349,3249,1900,1,00440,India
108583,2023-12-21,506,monitor,3249,8000,4751,1,00440,India
794277,2023-12-21,504,iron,449,879,430,1,00070,India
794277,2023-12-21,505,oven,18490,24000,5510,1,00070,India
699123,2023-12-21,507,washing machine,6990,16490,9500,1,00254,India
699123,2023-12-21,501,iphone 15,60000,80000,20000,1,00254,India
699123,2023-12-21,504,iron,449,879,430,1,00254,India
699123,2023-12-21,505,oven,18490,24000,5510,1,00254,India
852910,2023-12-21,501,iphone 15,60000,80000,20000,1,00257,India
852910,2023-12-21,504,iron,449,879,430,1,00257,India
852910,2023-12-21,507,washing machine,6990,16490,9500,1,00257,India
314197,2023-12-21,502,iphone 15 pro max,100000,135000,35000,1,00437,India
314197,2023-12-21,501,iphone 15,60000,80000,20000,1,00437,India
314197,2023-12-21,505,oven,18490,24000,5510,1,00437,India
935736,2023-12-21,505,oven,18490,24000,5510,1,00248,India
935736,2023-12-21,506,monitor,3249,8000,4751,1,00248,India
935736,2023-12-21,502,iphone 15 pro max,100000,135000,35000,1,00248,India
935736,2023-12-21,507,washing machine,6990,16490,9500,1,00248,India
826396,2023-12-21,507,washing machine,6990,16490,9500,1,00015,India
826396,2023-12-21,503,mixer,1349,3249,1900,1,00015,India
337686,2023-12-21,504,iron,449,879,430,1,00137,India
337686,2023-12-21,505,oven,18490,24000,5510,1,00137,India
337686,2023-12-21,507,washing machine,6990,16490,9500,1,00137,India
337686,2023-12-21,503,mixer,1349,3249,1900,1,00137,India
354492,2023-12-21,507,washing machine,6990,16490,9500,1,00152,India
354492,2023-12-21,506,monitor,3249,8000,4751,1,00152,India
520766,2023-12-21,507,washing machine,6990,16490,9500,1,00138,India
520766,2023-12-21,501,iphone 15,60000,80000,20000,1,00138,India
520766,2023-12-21,502,iphone 15 pro max,100000,135000,35000,1,00138,India
520766,2023-12-21,503,mixer,1349,3249,1900,1,00138,India
490814,2023-12-21,504,iron,449,879,430,1,00263,India
408948,2023-12-21,505,oven,18490,24000,5510,1,00026,India
408948,2023-12-21,503,mixer,1349,3249,1900,1,00026,India
320019,2023-12-21,505,oven,18490,24000,5510,1,00012,India
320019,2023-12-21,502,iphone 15 pro max,100000,135000,35000,1,00012,India
347736,2023-12-22,503,mixer,1349,3249,1900,1,00408,India
347736,2023-12-22,507,washing machine,6990,16490,9500,1,00408,India
347736,2023-12-22,502,iphone 15 pro max,100000,135000,35000,1,00408,India
962754,2023-12-22,506,monitor,3249,8000,4751,1,00218,India
962754,2023-12-22,502,iphone 15 pro max,100000,135000,35000,1,00218,India
962754,2023-12-22,505,oven,18490,24000,5510,1,00218,India
926615,2023-12-22,507,washing machine,6990,16490,9500,1,00223,India
926615,2023-12-22,505,oven,18490,24000,5510,1,00223,India
926615,2023-12-22,504,iron,449,879,430,1,00223,India
472668,2023-12-22,506,monitor,3249,8000,4751,1,00483,India
472668,2023-12-22,501,iphone 15,60000,80000,20000,1,00483,India
472668,2023-12-22,504,iron,449,879,430,1,00483,India
903527,2023-12-22,505,oven,18490,24000,5510,1,00117,India
903527,2023-12-22,506,monitor,3249,8000,4751,1,00117,India
903527,2023-12-22,501,iphone 15,60000,80000,20000,1,00117,India
377642,2023-12-22,504,iron,449,879,430,1,00261,India
377642,2023-12-22,502,iphone 15 pro max,100000,135000,35000,1,00261,India
377642,2023-12-22,506,monitor,3249,8000,4751,1,00261,India
377642,2023-12-22,505,oven,18490,24000,5510,1,00261,India
377642,2023-12-22,507,washing machine,6990,16490,9500,1,00261,India
165196,2023-12-22,501,iphone 15,60000,80000,20000,1,00151,India
165196,2023-12-22,505,oven,18490,24000,5510,1,00151,India
683026,2023-12-22,501,iphone 15,60000,80000,20000,1,00356,India
683026,2023-12-22,502,iphone 15 pro max,100000,135000,35000,1,00356,India
683026,2023-12-22,505,oven,18490,24000,5510,1,00356,India
683026,2023-12-22,507,washing machine,6990,16490,9500,1,00356,India
104780,2023-12-22,501,iphone 15,60000,80000,20000,1,00284,India
104780,2023-12-22,504,iron,449,879,430,1,00284,India
104780,2023-12-22,507,washing machine,6990,16490,9500,1,00284,India
120953,2023-12-22,505,oven,18490,24000,5510,1,00328,India
120953,2023-12-22,504,iron,449,879,430,1,00328,India
120953,2023-12-22,507,washing machine,6990,16490,9500,1,00328,India
435727,2023-12-22,507,washing machine,6990,16490,9500,1,00212,India
435727,2023-12-22,505,oven,18490,24000,5510,1,00212,India
297883,2023-12-22,502,iphone 15 pro max,100000,135000,35000,1,00166,India
297883,2023-12-22,501,iphone 15,60000,80000,20000,1,00166,India
297883,2023-12-22,504,iron,449,879,430,1,00166,India
297883,2023-12-22,503,mixer,1349,3249,1900,1,00166,India
434629,2023-12-22,503,mixer,1349,3249,1900,1,00065,India
434629,2023-12-22,502,iphone 15 pro max,100000,135000,35000,1,00065,India
434629,2023-12-22,501,iphone 15,60000,80000,20000,1,00065,India
569151,2023-12-22,502,iphone 15 pro max,100000,135000,35000,1,00454,India
569151,2023-12-22,503,mixer,1349,3249,1900,1,00454,India
569151,2023-12-22,507,washing machine,6990,16490,9500,1,00454,India
569151,2023-12-22,505,oven,18490,24000,5510,1,00454,India
665763,2023-12-22,506,monitor,3249,8000,4751,1,00274,India
805209,2023-12-22,507,washing machine,6990,16490,9500,1,00058,India
805209,2023-12-22,505,oven,18490,24000,5510,1,00058,India
805209,2023-12-22,506,monitor,3249,8000,4751,1,00058,India
805209,2023-12-22,501,iphone 15,60000,80000,20000,1,00058,India
781881,2023-12-22,507,washing machine,6990,16490,9500,1,00460,India
327059,2023-12-22,502,iphone 15 pro max,100000,135000,35000,1,00033,India
327059,2023-12-22,507,washing machine,6990,16490,9500,1,00033,India
327059,2023-12-22,501,iphone 15,60000,80000,20000,1,00033,India
428805,2023-12-22,506,monitor,3249,8000,4751,1,00392,India
428805,2023-12-22,504,iron,449,879,430,1,00392,India
428805,2023-12-22,502,iphone 15 pro max,100000,135000,35000,1,00392,India
392695,2023-12-22,503,mixer,1349,3249,1900,1,00439,India
392695,2023-12-22,506,monitor,3249,8000,4751,1,00439,India
264020,2023-12-22,502,iphone 15 pro max,100000,135000,35000,1,00401,India
264020,2023-12-22,507,washing machine,6990,16490,9500,1,00401,India
177448,2023-12-22,506,monitor,3249,8000,4751,1,00376,India
177448,2023-12-22,503,mixer,1349,3249,1900,1,00376,India
177448,2023-12-22,502,iphone 15 pro max,100000,135000,35000,1,00376,India
177448,2023-12-22,505,oven,18490,24000,5510,1,00376,India
245748,2023-12-22,505,oven,18490,24000,5510,1,00396,India
245748,2023-12-22,504,iron,449,879,430,1,00396,India
885506,2023-12-22,505,oven,18490,24000,5510,1,00468,India
562040,2023-12-22,507,washing machine,6990,16490,9500,1,00009,India
562040,2023-12-22,503,mixer,1349,3249,1900,1,00009,India
715692,2023-12-22,502,iphone 15 pro max,100000,135000,35000,1,00318,India
715692,2023-12-22,504,iron,449,879,430,1,00318,India
715692,2023-12-22,505,oven,18490,24000,5510,1,00318,India
715692,2023-12-22,501,iphone 15,60000,80000,20000,1,00318,India
974883,2023-12-22,504,iron,449,879,430,1,00030,India
302189,2023-12-22,502,iphone 15 pro max,100000,135000,35000,1,00159,India
302189,2023-12-22,503,mixer,1349,3249,1900,1,00159,India
302189,2023-12-22,506,monitor,3249,8000,4751,1,00159,India
302189,2023-12-22,501,iphone 15,60000,80000,20000,1,00159,India
302189,2023-12-22,507,washing machine,6990,16490,9500,1,00159,India
675495,2023-12-22,506,monitor,3249,8000,4751,1,00248,India
675495,2023-12-22,505,oven,18490,24000,5510,1,00248,India
675495,2023-12-22,507,washing machine,6990,16490,9500,1,00248,India
675495,2023-12-22,503,mixer,1349,3249,1900,1,00248,India
513422,2023-12-22,506,monitor,3249,8000,4751,1,00165,India
513422,2023-12-22,507,washing machine,6990,16490,9500,1,00165,India
513422,2023-12-22,505,oven,18490,24000,5510,1,00165,India
513422,2023-12-22,501,iphone 15,60000,80000,20000,1,00165,India
513422,2023-12-22,502,iphone 15 pro max,100000,135000,35000,1,00165,India
179111,2023-12-22,502,iphone 15 pro max,100000,135000,35000,1,00047,India
535746,2023-12-22,504,iron,449,879,430,1,00415,India
535746,2023-12-22,502,iphone 15 pro max,100000,135000,35000,1,00415,India
239883,2023-12-22,502,iphone 15 pro max,100000,135000,35000,1,00239,India
239883,2023-12-22,507,washing machine,6990,16490,9500,1,00239,India
239883,2023-12-22,504,iron,449,879,430,1,00239,India
239883,2023-12-22,505,oven,18490,24000,5510,1,00239,India
633776,2023-12-22,507,washing machine,6990,16490,9500,1,00422,India
633776,2023-12-22,503,mixer,1349,3249,1900,1,00422,India
633776,2023-12-22,504,iron,449,879,430,1,00422,India
633776,2023-12-22,505,oven,18490,24000,5510,1,00422,India
508782,2023-12-22,501,iphone 15,60000,80000,20000,1,00267,India
797877,2023-12-22,503,mixer,1349,3249,1900,1,00481,India
797877,2023-12-22,506,monitor,3249,8000,4751,1,00481,India
742934,2023-12-22,505,oven,18490,24000,5510,1,00294,India
742934,2023-12-22,506,monitor,3249,8000,4751,1,00294,India
742934,2023-12-22,507,washing machine,6990,16490,9500,1,00294,India
742934,2023-12-22,501,iphone 15,60000,80000,20000,1,00294,India
792937,2023-12-22,503,mixer,1349,3249,1900,1,00029,India
110785,2023-12-22,503,mixer,1349,3249,1900,1,00476,India
110785,2023-12-22,506,monitor,3249,8000,4751,1,00476,India
110785,2023-12-22,501,iphone 15,60000,80000,20000,1,00476,India
303687,2023-12-22,507,washing machine,6990,16490,9500,1,00423,India
303687,2023-12-22,506,monitor,3249,8000,4751,1,00423,India
942539,2023-12-22,504,iron,449,879,430,1,00495,India
942539,2023-12-22,507,washing machine,6990,16490,9500,1,00495,India
942539,2023-12-22,501,iphone 15,60000,80000,20000,1,00495,India
942539,2023-12-22,503,mixer,1349,3249,1900,1,00495,India
439583,2023-12-22,502,iphone 15 pro max,100000,135000,35000,1,00268,India
122916,2023-12-22,501,iphone 15,60000,80000,20000,1,00139,India
921872,2023-12-22,502,iphone 15 pro max,100000,135000,35000,1,00191,India
921872,2023-12-22,505,oven,18490,24000,5510,1,00191,India
921872,2023-12-22,504,iron,449,879,430,1,00191,India
133939,2023-12-22,506,monitor,3249,8000,4751,1,00063,India
133939,2023-12-22,504,iron,449,879,430,1,00063,India
133939,2023-12-22,501,iphone 15,60000,80000,20000,1,00063,India
133939,2023-12-22,503,mixer,1349,3249,1900,1,00063,India
235927,2023-12-22,502,iphone 15 pro max,100000,135000,35000,1,00076,India
235927,2023-12-22,506,monitor,3249,8000,4751,1,00076,India
235927,2023-12-22,507,washing machine,6990,16490,9500,1,00076,India
235927,2023-12-22,503,mixer,1349,3249,1900,1,00076,India
110202,2023-12-22,504,iron,449,879,430,1,00425,India
110202,2023-12-22,505,oven,18490,24000,5510,1,00425,India
870625,2023-12-22,506,monitor,3249,8000,4751,1,00296,India
870625,2023-12-22,502,iphone 15 pro max,100000,135000,35000,1,00296,India
114092,2023-12-22,505,oven,18490,24000,5510,1,00455,India
114092,2023-12-22,503,mixer,1349,3249,1900,1,00455,India
114092,2023-12-22,504,iron,449,879,430,1,00455,India
418208,2023-12-22,501,iphone 15,60000,80000,20000,1,00189,India
512126,2023-12-23,506,monitor,3249,8000,4751,1,00233,India
542229,2023-12-23,506,monitor,3249,8000,4751,1,00261,India
913962,2023-12-23,505,oven,18490,24000,5510,1,00207,India
913962,2023-12-23,502,iphone 15 pro max,100000,135000,35000,1,00207,India
913962,2023-12-23,501,iphone 15,60000,80000,20000,1,00207,India
913962,2023-12-23,503,mixer,1349,3249,1900,1,00207,India
913962,2023-12-23,507,washing machine,6990,16490,9500,1,00207,India
431199,2023-12-23,502,iphone 15 pro max,100000,135000,35000,1,00221,India
407530,2023-12-23,503,mixer,1349,3249,1900,1,00157,India
407530,2023-12-23,501,iphone 15,60000,80000,20000,1,00157,India
407530,2023-12-23,506,monitor,3249,8000,4751,1,00157,India
196003,2023-12-23,501,iphone 15,60000,80000,20000,1,00323,India
162748,2023-12-23,501,iphone 15,60000,80000,20000,1,00079,India
162748,2023-12-23,504,iron,449,879,430,1,00079,India
856293,2023-12-23,503,mixer,1349,3249,1900,1,00188,India
856293,2023-12-23,507,washing machine,6990,16490,9500,1,00188,India
856293,2023-12-23,502,iphone 15 pro max,100000,135000,35000,1,00188,India
241056,2023-12-23,507,washing machine,6990,16490,9500,1,00272,India
241056,2023-12-23,504,iron,449,879,430,1,00272,India
241056,2023-12-23,502,iphone 15 pro max,100000,135000,35000,1,00272,India
850962,2023-12-23,507,washing machine,6990,16490,9500,1,00153,India
121245,2023-12-23,502,iphone 15 pro max,100000,135000,35000,1,00094,India
121245,2023-12-23,507,washing machine,6990,16490,9500,1,00094,India
159600,2023-12-23,504,iron,449,879,430,1,00203,India
159600,2023-12-23,501,iphone 15,60000,80000,20000,1,00203,India
159600,2023-12-23,505,oven,18490,24000,5510,1,00203,India
608848,2023-12-23,501,iphone 15,60000,80000,20000,1,00123,India
608848,2023-12-23,503,mixer,1349,3249,1900,1,00123,India
608848,2023-12-23,504,iron,449,879,430,1,00123,India
608848,2023-12-23,505,oven,18490,24000,5510,1,00123,India
846010,2023-12-23,507,washing machine,6990,16490,9500,1,00484,India
846010,2023-12-23,506,monitor,3249,8000,4751,1,00484,India
914554,2023-12-23,501,iphone 15,60000,80000,20000,1,00457,India
916471,2023-12-23,503,mixer,1349,3249,1900,1,00219,India
131993,2023-12-23,505,oven,18490,24000,5510,1,00016,India
131993,2023-12-23,507,washing machine,6990,16490,9500,1,00016,India
131993,2023-12-23,502,iphone 15 pro max,100000,135000,35000,1,00016,India
131993,2023-12-23,506,monitor,3249,8000,4751,1,00016,India
922062,2023-12-23,501,iphone 15,60000,80000,20000,1,00386,India
922062,2023-12-23,506,monitor,3249,8000,4751,1,00386,India
922062,2023-12-23,507,washing machine,6990,16490,9500,1,00386,India
922062,2023-12-23,503,mixer,1349,3249,1900,1,00386,India
922062,2023-12-23,502,iphone 15 pro max,100000,135000,35000,1,00386,India
449767,2023-12-23,503,mixer,1349,3249,1900,1,00421,India
449767,2023-12-23,502,iphone 15 pro max,100000,135000,35000,1,00421,India
656863,2023-12-23,506,monitor,3249,8000,4751,1,00322,India
656863,2023-12-23,504,iron,449,879,430,1,00322,India
656863,2023-12-23,502,iphone 15 pro max,100000,135000,35000,1,00322,India
675160,2023-12-23,507,washing machine,6990,16490,9500,1,00272,India
675160,2023-12-23,503,mixer,1349,3249,1900,1,00272,India
675160,2023-12-23,505,oven,18490,24000,5510,1,00272,India
358054,2023-12-23,507,washing machine,6990,16490,9500,1,00231,India
982239,2023-12-23,502,iphone 15 pro max,100000,135000,35000,1,00475,India
567576,2023-12-23,502,iphone 15 pro max,100000,135000,35000,1,00327,India
567576,2023-12-23,504,iron,449,879,430,1,00327,India
567576,2023-12-23,501,iphone 15,60000,80000,20000,1,00327,India
120035,2023-12-23,504,iron,449,879,430,1,00093,India
120035,2023-12-23,507,washing machine,6990,16490,9500,1,00093,India
212388,2023-12-23,504,iron,449,879,430,1,00184,India
212388,2023-12-23,505,oven,18490,24000,5510,1,00184,India
212388,2023-12-23,506,monitor,3249,8000,4751,1,00184,India
789411,2023-12-23,502,iphone 15 pro max,100000,135000,35000,1,00447,India
789411,2023-12-23,506,monitor,3249,8000,4751,1,00447,India
789411,2023-12-23,507,washing machine,6990,16490,9500,1,00447,India
889943,2023-12-23,504,iron,449,879,430,1,00164,India
889943,2023-12-23,506,monitor,3249,8000,4751,1,00164,India
889943,2023-12-23,505,oven,18490,24000,5510,1,00164,India
889943,2023-12-23,502,iphone 15 pro max,100000,135000,35000,1,00164,India
509269,2023-12-23,506,monitor,3249,8000,4751,1,00067,India
509269,2023-12-23,502,iphone 15 pro max,100000,135000,35000,1,00067,India
509269,2023-12-23,501,iphone 15,60000,80000,20000,1,00067,India
933811,2023-12-23,505,oven,18490,24000,5510,1,00463,India
933811,2023-12-23,504,iron,449,879,430,1,00463,India
933811,2023-12-23,502,iphone 15 pro max,100000,135000,35000,1,00463,India
933811,2023-12-23,507,washing machine,6990,16490,9500,1,00463,India
933811,2023-12-23,501,iphone 15,60000,80000,20000,1,00463,India
429573,2023-12-23,503,mixer,1349,3249,1900,1,00031,India
429573,2023-12-23,507,washing machine,6990,16490,9500,1,00031,India
429573,2023-12-23,504,iron,449,879,430,1,00031,India
857218,2023-12-23,503,mixer,1349,3249,1900,1,00002,India
857218,2023-12-23,507,washing machine,6990,16490,9500,1,00002,India
857218,2023-12-23,502,iphone 15 pro max,100000,135000,35000,1,00002,India
857218,2023-12-23,504,iron,449,879,430,1,00002,India
996592,2023-12-23,504,iron,449,879,430,1,00342,India
908766,2023-12-23,505,oven,18490,24000,5510,1,00042,India
908766,2023-12-23,504,iron,449,879,430,1,00042,India
634681,2023-12-23,501,iphone 15,60000,80000,20000,1,00270,India
958635,2023-12-23,501,iphone 15,60000,80000,20000,1,00310,India
180771,2023-12-23,502,iphone 15 pro max,100000,135000,35000,1,00104,India
180771,2023-12-23,503,mixer,1349,3249,1900,1,00104,India
180771,2023-12-23,506,monitor,3249,8000,4751,1,00104,India
960842,2023-12-23,502,iphone 15 pro max,100000,135000,35000,1,00500,India
984156,2023-12-23,504,iron,449,879,430,1,00114,India
984156,2023-12-23,501,iphone 15,60000,80000,20000,1,00114,India
757134,2023-12-23,504,iron,449,879,430,1,00387,India
757134,2023-12-23,501,iphone 15,60000,80000,20000,1,00387,India
757134,2023-12-23,506,monitor,3249,8000,4751,1,00387,India
795052,2023-12-23,502,iphone 15 pro max,100000,135000,35000,1,00041,India
795052,2023-12-23,507,washing machine,6990,16490,9500,1,00041,India
805684,2023-12-23,502,iphone 15 pro max,100000,135000,35000,1,00267,India
341236,2023-12-23,505,oven,18490,24000,5510,1,00378,India
341236,2023-12-23,504,iron,449,879,430,1,00378,India
923808,2023-12-23,507,washing machine,6990,16490,9500,1,00387,India
612957,2023-12-23,504,iron,449,879,430,1,00319,India
612957,2023-12-23,501,iphone 15,60000,80000,20000,1,00319,India
612957,2023-12-23,506,monitor,3249,8000,4751,1,00319,India
612957,2023-12-23,502,iphone 15 pro max,100000,135000,35000,1,00319,India
576581,2023-12-23,501,iphone 15,60000,80000,20000,1,00477,India
576581,2023-12-23,505,oven,18490,24000,5510,1,00477,India
576581,2023-12-23,507,washing machine,6990,16490,9500,1,00477,India
952448,2023-12-23,502,iphone 15 pro max,100000,135000,35000,1,00098,India
305113,2023-12-23,507,washing machine,6990,16490,9500,1,00493,India
367328,2023-12-23,503,mixer,1349,3249,1900,1,00207,India
367328,2023-12-23,505,oven,18490,24000,5510,1,00207,India
367328,2023-12-23,501,iphone 15,60000,80000,20000,1,00207,India
367328,2023-12-23,507,washing machine,6990,16490,9500,1,00207,India
367328,2023-12-23,502,iphone 15 pro max,100000,135000,35000,1,00207,India
334822,2023-12-23,502,iphone 15 pro max,100000,135000,35000,1,00168,India
560756,2023-12-23,506,monitor,3249,8000,4751,1,00254,India
560756,2023-12-23,505,oven,18490,24000,5510,1,00254,India
560756,2023-12-23,502,iphone 15 pro max,100000,135000,35000,1,00254,India
560756,2023-12-23,503,mixer,1349,3249,1900,1,00254,India
531909,2023-12-23,504,iron,449,879,430,1,00495,India
531909,2023-12-23,503,mixer,1349,3249,1900,1,00495,India
531909,2023-12-23,502,iphone 15 pro max,100000,135000,35000,1,00495,India
531909,2023-12-23,507,washing machine,6990,16490,9500,1,00495,India
956793,2023-12-23,506,monitor,3249,8000,4751,1,00222,India
237891,2023-12-23,505,oven,18490,24000,5510,1,00085,India
237891,2023-12-23,503,mixer,1349,3249,1900,1,00085,India
878644,2023-12-23,506,monitor,3249,8000,4751,1,00159,India
878644,2023-12-23,501,iphone 15,60000,80000,20000,1,00159,India
172259,2023-12-23,506,monitor,3249,8000,4751,1,00351,India
172259,2023-12-23,507,washing machine,6990,16490,9500,1,00351,India
172259,2023-12-23,502,iphone 15 pro max,100000,135000,35000,1,00351,India
172259,2023-12-23,504,iron,449,879,430,1,00351,India
678547,2023-12-23,503,mixer,1349,3249,1900,1,00007,India
678547,2023-12-23,507,washing machine,6990,16490,9500,1,00007,India
678547,2023-12-23,506,monitor,3249,8000,4751,1,00007,India
596711,2023-12-23,505,oven,18490,24000,5510,1,00437,India
596711,2023-12-23,506,monitor,3249,8000,4751,1,00437,India
167854,2023-12-23,507,washing machine,6990,16490,9500,1,00310,India
167854,2023-12-23,501,iphone 15,60000,80000,20000,1,00310,India
167854,2023-12-23,502,iphone 15 pro max,100000,135000,35000,1,00310,India
735377,2023-12-23,504,iron,449,879,430,1,00101,India
735377,2023-12-23,501,iphone 15,60000,80000,20000,1,00101,India
735377,2023-12-23,507,washing machine,6990,16490,9500,1,00101,India
735377,2023-12-23,502,iphone 15 pro max,100000,135000,35000,1,00101,India
880003,2023-12-23,504,iron,449,879,430,1,00335,India
880003,2023-12-23,505,oven,18490,24000,5510,1,00335,India
880003,2023-12-23,501,iphone 15,60000,80000,20000,1,00335,India
763122,2023-12-23,506,monitor,3249,8000,4751,1,00119,India
763122,2023-12-23,507,washing machine,6990,16490,9500,1,00119,India
763122,2023-12-23,504,iron,449,879,430,1,00119,India
692703,2023-12-23,504,iron,449,879,430,1,00101,India
692703,2023-12-23,502,iphone 15 pro max,100000,135000,35000,1,00101,India
692703,2023-12-23,506,monitor,3249,8000,4751,1,00101,India
264892,2023-12-23,501,iphone 15,60000,80000,20000,1,00214,India
264892,2023-12-23,503,mixer,1349,3249,1900,1,00214,India
264892,2023-12-23,505,oven,18490,24000,5510,1,00214,India
698648,2023-12-23,505,oven,18490,24000,5510,1,00384,India
698648,2023-12-23,501,iphone 15,60000,80000,20000,1,00384,India
698648,2023-12-23,507,washing machine,6990,16490,9500,1,00384,India
423618,2023-12-23,506,monitor,3249,8000,4751,1,00038,India
976167,2023-12-23,502,iphone 15 pro max,100000,135000,35000,1,00281,India
976167,2023-12-23,506,monitor,3249,8000,4751,1,00281,India
699899,2023-12-23,505,oven,18490,24000,5510,1,00251,India
605479,2023-12-23,502,iphone 15 pro max,100000,135000,35000,1,00372,India
605479,2023-12-23,506,monitor,3249,8000,4751,1,00372,India
605479,2023-12-23,501,iphone 15,60000,80000,20000,1,00372,India
461842,2023-12-23,506,monitor,3249,8000,4751,1,00443,India
461842,2023-12-23,502,iphone 15 pro max,100000,135000,35000,1,00443,India
461842,2023-12-23,501,iphone 15,60000,80000,20000,1,00443,India
461842,2023-12-23,503,mixer,1349,3249,1900,1,00443,India
461842,2023-12-23,504,iron,449,879,430,1,00443,India
822334,2023-12-23,506,monitor,3249,8000,4751,1,00468,India
822334,2023-12-23,501,iphone 15,60000,80000,20000,1,00468,India
542833,2023-12-23,506,monitor,3249,8000,4751,1,00320,India
542833,2023-12-23,501,iphone 15,60000,80000,20000,1,00320,India
542833,2023-12-23,502,iphone 15 pro max,100000,135000,35000,1,00320,India
350782,2023-12-23,507,washing machine,6990,16490,9500,1,00222,India
667276,2023-12-23,507,washing machine,6990,16490,9500,1,00012,India
667276,2023-12-23,502,iphone 15 pro max,100000,135000,35000,1,00012,India
548280,2023-12-23,504,iron,449,879,430,1,00268,India
548280,2023-12-23,505,oven,18490,24000,5510,1,00268,India
333620,2023-12-23,507,washing machine,6990,16490,9500,1,00185,India
537783,2023-12-23,504,iron,449,879,430,1,00033,India
537783,2023-12-23,502,iphone 15 pro max,100000,135000,35000,1,00033,India
350220,2023-12-23,503,mixer,1349,3249,1900,1,00331,India
350220,2023-12-23,501,iphone 15,60000,80000,20000,1,00331,India
183730,2023-12-23,507,washing machine,6990,16490,9500,1,00098,India
962053,2023-12-23,507,washing machine,6990,16490,9500,1,00287,India
962053,2023-12-23,503,mixer,1349,3249,1900,1,00287,India
667092,2023-12-23,506,monitor,3249,8000,4751,1,00308,India
667092,2023-12-23,503,mixer,1349,3249,1900,1,00308,India
667092,2023-12-23,504,iron,449,879,430,1,00308,India
118429,2023-12-23,504,iron,449,879,430,1,00224,India
782132,2023-12-23,504,iron,449,879,430,1,00362,India
611948,2023-12-23,505,oven,18490,24000,5510,1,00494,India
611948,2023-12-23,503,mixer,1349,3249,1900,1,00494,India
611948,2023-12-23,504,iron,449,879,430,1,00494,India
611948,2023-12-23,507,washing machine,6990,16490,9500,1,00494,India
677389,2023-12-24,506,monitor,3249,8000,4751,1,00418,India
677389,2023-12-24,502,iphone 15 pro max,100000,135000,35000,1,00418,India
677389,2023-12-24,505,oven,18490,24000,5510,1,00418,India
751925,2023-12-24,507,washing machine,6990,16490,9500,1,00428,India
751925,2023-12-24,506,monitor,3249,8000,4751,1,00428,India
751925,2023-12-24,501,iphone 15,60000,80000,20000,1,00428,India
873478,2023-12-24,501,iphone 15,60000,80000,20000,1,00279,India
771248,2023-12-24,505,oven,18490,24000,5510,1,00354,India
771248,2023-12-24,507,washing machine,6990,16490,9500,1,00354,India
779128,2023-12-24,503,mixer,1349,3249,1900,1,00483,India
487635,2023-12-24,507,washing machine,6990,16490,9500,1,00225,India
487635,2023-12-24,502,iphone 15 pro max,100000,135000,35000,1,00225,India
487635,2023-12-24,505,oven,18490,24000,5510,1,00225,India
498094,2023-12-24,503,mixer,1349,3249,1900,1,00288,India
498094,2023-12-24,501,iphone 15,60000,80000,20000,1,00288,India
498094,2023-12-24,507,washing machine,6990,16490,9500,1,00288,India
498094,2023-12-24,505,oven,18490,24000,5510,1,00288,India
978553,2023-12-24,505,oven,18490,24000,5510,1,00109,India
978553,2023-12-24,503,mixer,1349,3249,1900,1,00109,India
978553,2023-12-24,507,washing machine,6990,16490,9500,1,00109,India
978553,2023-12-24,504,iron,449,879,430,1,00109,India
508438,2023-12-24,504,iron,449,879,430,1,00165,India
508438,2023-12-24,502,iphone 15 pro max,100000,135000,35000,1,00165,India
508438,2023-12-24,501,iphone 15,60000,80000,20000,1,00165,India
264542,2023-12-24,505,oven,18490,24000,5510,1,00412,India
264542,2023-12-24,501,iphone 15,60000,80000,20000,1,00412,India
392826,2023-12-24,507,washing machine,6990,16490,9500,1,00169,India
392826,2023-12-24,503,mixer,1349,3249,1900,1,00169,India
612989,2023-12-24,505,oven,18490,24000,5510,1,00107,India
612989,2023-12-24,504,iron,449,879,430,1,00107,India
612989,2023-12-24,503,mixer,1349,3249,1900,1,00107,India
753092,2023-12-24,501,iphone 15,60000,80000,20000,1,00359,India
753092,2023-12-24,502,iphone 15 pro max,100000,135000,35000,1,00359,India
753092,2023-12-24,503,mixer,1349,3249,1900,1,00359,India
753092,2023-12-24,505,oven,18490,24000,5510,1,00359,India
842001,2023-12-24,503,mixer,1349,3249,1900,1,00054,India
842001,2023-12-24,502,iphone 15 pro max,100000,135000,35000,1,00054,India
559673,2023-12-24,503,mixer,1349,3249,1900,1,00481,India
559673,2023-12-24,507,washing machine,6990,16490,9500,1,00481,India
924141,2023-12-24,505,oven,18490,24000,5510,1,00016,India
924141,2023-12-24,507,washing machine,6990,16490,9500,1,00016,India
924141,2023-12-24,504,iron,449,879,430,1,00016,India
589090,2023-12-24,505,oven,18490,24000,5510,1,00144,India
423506,2023-12-24,504,iron,449,879,430,1,00201,India
423506,2023-12-24,506,monitor,3249,8000,4751,1,00201,India
282183,2023-12-24,501,iphone 15,60000,80000,20000,1,00005,India
274346,2023-12-24,503,mixer,1349,3249,1900,1,00025,India
274346,2023-12-24,504,iron,449,879,430,1,00025,India
274346,2023-12-24,507,washing machine,6990,16490,9500,1,00025,India
285627,2023-12-24,507,washing machine,6990,16490,9500,1,00001,India
285627,2023-12-24,506,monitor,3249,8000,4751,1,00001,India
379875,2023-12-24,505,oven,18490,24000,5510,1,00203,India
379875,2023-12-24,502,iphone 15 pro max,100000,135000,35000,1,00203,India
791582,2023-12-24,507,washing machine,6990,16490,9500,1,00067,India
134627,2023-12-24,501,iphone 15,60000,80000,20000,1,00014,India
134627,2023-12-24,506,monitor,3249,8000,4751,1,00014,India
518816,2023-12-24,501,iphone 15,60000,80000,20000,1,00001,India
518816,2023-12-24,505,oven,18490,24000,5510,1,00001,India
518816,2023-12-24,507,washing machine,6990,16490,9500,1,00001,India
518816,2023-12-24,504,iron,449,879,430,1,00001,India
320160,2023-12-24,501,iphone 15,60000,80000,20000,1,00010,India
320160,2023-12-24,505,oven,18490,24000,5510,1,00010,India
320160,2023-12-24,504,iron,449,879,430,1,00010,India
320160,2023-12-24,506,monitor,3249,8000,4751,1,00010,India
852275,2023-12-24,506,monitor,3249,8000,4751,1,00360,India
568838,2023-12-24,507,washing machine,6990,16490,9500,1,00290,India
568838,2023-12-24,502,iphone 15 pro max,100000,135000,35000,1,00290,India
299424,2023-12-24,506,monitor,3249,8000,4751,1,00232,India
299424,2023-12-24,505,oven,18490,24000,5510,1,00232,India
299424,2023-12-24,504,iron,449,879,430,1,00232,India
299424,2023-12-24,502,iphone 15 pro max,100000,135000,35000,1,00232,India
299424,2023-12-24,507,washing machine,6990,16490,9500,1,00232,India
506941,2023-12-24,507,washing machine,6990,16490,9500,1,00103,India
506941,2023-12-24,502,iphone 15 pro max,100000,135000,35000,1,00103,India
506941,2023-12-24,501,iphone 15,60000,80000,20000,1,00103,India
596990,2023-12-24,505,oven,18490,24000,5510,1,00223,India
596990,2023-12-24,507,washing machine,6990,16490,9500,1,00223,India
596990,2023-12-24,506,monitor,3249,8000,4751,1,00223,India
596990,2023-12-24,501,iphone 15,60000,80000,20000,1,00223,India
707542,2023-12-24,501,iphone 15,60000,80000,20000,1,00467,India
707542,2023-12-24,502,iphone 15 pro max,100000,135000,35000,1,00467,India
861149,2023-12-24,507,washing machine,6990,16490,9500,1,00222,India
159514,2023-12-24,503,mixer,1349,3249,1900,1,00112,India
119594,2023-12-24,501,iphone 15,60000,80000,20000,1,00243,India
560349,2023-12-24,504,iron,449,879,430,1,00047,India
560349,2023-12-24,501,iphone 15,60000,80000,20000,1,00047,India
560349,2023-12-24,507,washing machine,6990,16490,9500,1,00047,India
357710,2023-12-24,504,iron,449,879,430,1,00469,India
357710,2023-12-24,501,iphone 15,60000,80000,20000,1,00469,India
357710,2023-12-24,503,mixer,1349,3249,1900,1,00469,India
197008,2023-12-24,503,mixer,1349,3249,1900,1,00112,India
197008,2023-12-24,505,oven,18490,24000,5510,1,00112,India
197008,2023-12-24,502,iphone 15 pro max,100000,135000,35000,1,00112,India
830312,2023-12-24,503,mixer,1349,3249,1900,1,00073,India
830312,2023-12-24,504,iron,449,879,430,1,00073,India
830312,2023-12-24,505,oven,18490,24000,5510,1,00073,India
990018,2023-12-24,504,iron,449,879,430,1,00392,India
990018,2023-12-24,506,monitor,3249,8000,4751,1,00392,India
990018,2023-12-24,505,oven,18490,24000,5510,1,00392,India
970495,2023-12-24,506,monitor,3249,8000,4751,1,00097,India
970495,2023-12-24,501,iphone 15,60000,80000,20000,1,00097,India
970495,2023-12-24,507,washing machine,6990,16490,9500,1,00097,India
901783,2023-12-24,503,mixer,1349,3249,1900,1,00018,India
901783,2023-12-24,506,monitor,3249,8000,4751,1,00018,India
901783,2023-12-24,501,iphone 15,60000,80000,20000,1,00018,India
901783,2023-12-24,502,iphone 15 pro max,100000,135000,35000,1,00018,India
595134,2023-12-24,507,washing machine,6990,16490,9500,1,00445,India
595134,2023-12-24,505,oven,18490,24000,5510,1,00445,India
595134,2023-12-24,502,iphone 15 pro max,100000,135000,35000,1,00445,India
753094,2023-12-24,504,iron,449,879,430,1,00418,India
753094,2023-12-24,505,oven,18490,24000,5510,1,00418,India
753094,2023-12-24,502,iphone 15 pro max,100000,135000,35000,1,00418,India
753094,2023-12-24,501,iphone 15,60000,80000,20000,1,00418,India
753094,2023-12-24,503,mixer,1349,3249,1900,1,00418,India
544913,2023-12-24,506,monitor,3249,8000,4751,1,00354,India
544913,2023-12-24,507,washing machine,6990,16490,9500,1,00354,India
544913,2023-12-24,501,iphone 15,60000,80000,20000,1,00354,India
544913,2023-12-24,505,oven,18490,24000,5510,1,00354,India
440084,2023-12-24,504,iron,449,879,430,1,00240,India
440084,2023-12-24,503,mixer,1349,3249,1900,1,00240,India
440084,2023-12-24,501,iphone 15,60000,80000,20000,1,00240,India
257388,2023-12-24,506,monitor,3249,8000,4751,1,00001,India
257388,2023-12-24,501,iphone 15,60000,80000,20000,1,00001,India
257388,2023-12-24,505,oven,18490,24000,5510,1,00001,India
563650,2023-12-24,505,oven,18490,24000,5510,1,00487,India
563650,2023-12-24,502,iphone 15 pro max,100000,135000,35000,1,00487,India
259631,2023-12-24,502,iphone 15 pro max,100000,135000,35000,1,00029,India
259631,2023-12-24,506,monitor,3249,8000,4751,1,00029,India
259631,2023-12-24,501,iphone 15,60000,80000,20000,1,00029,India
259631,2023-12-24,504,iron,449,879,430,1,00029,India
721389,2023-12-24,503,mixer,1349,3249,1900,1,00295,India
960924,2023-12-24,503,mixer,1349,3249,1900,1,00052,India
391891,2023-12-24,504,iron,449,879,430,1,00133,India
391891,2023-12-24,502,iphone 15 pro max,100000,135000,35000,1,00133,India
732050,2023-12-24,505,oven,18490,24000,5510,1,00257,India
732050,2023-12-24,504,iron,449,879,430,1,00257,India
507918,2023-12-24,502,iphone 15 pro max,100000,135000,35000,1,00409,India
507918,2023-12-24,506,monitor,3249,8000,4751,1,00409,India
865453,2023-12-24,505,oven,18490,24000,5510,1,00197,India
865453,2023-12-24,501,iphone 15,60000,80000,20000,1,00197,India
865453,2023-12-24,504,iron,449,879,430,1,00197,India
865453,2023-12-24,506,monitor,3249,8000,4751,1,00197,India
178657,2023-12-24,505,oven,18490,24000,5510,1,00447,India
178657,2023-12-24,502,iphone 15 pro max,100000,135000,35000,1,00447,India
485458,2023-12-24,505,oven,18490,24000,5510,1,00426,India
485458,2023-12-24,507,washing machine,6990,16490,9500,1,00426,India
624770,2023-12-24,505,oven,18490,24000,5510,1,00399,India
624770,2023-12-24,504,iron,449,879,430,1,00399,India
624770,2023-12-24,503,mixer,1349,3249,1900,1,00399,India
624770,2023-12-24,507,washing machine,6990,16490,9500,1,00399,India
624770,2023-12-24,501,iphone 15,60000,80000,20000,1,00399,India
141077,2023-12-24,501,iphone 15,60000,80000,20000,1,00201,India
141077,2023-12-24,504,iron,449,879,430,1,00201,India
141077,2023-12-24,507,washing machine,6990,16490,9500,1,00201,India
740956,2023-12-24,502,iphone 15 pro max,100000,135000,35000,1,00029,India
663559,2023-12-24,501,iphone 15,60000,80000,20000,1,00462,India
663559,2023-12-24,506,monitor,3249,8000,4751,1,00462,India
412808,2023-12-24,503,mixer,1349,3249,1900,1,00382,India
563729,2023-12-24,505,oven,18490,24000,5510,1,00462,India
843534,2023-12-24,503,mixer,1349,3249,1900,1,00117,India
843534,2023-12-24,506,monitor,3249,8000,4751,1,00117,India
843534,2023-12-24,507,washing machine,6990,16490,9500,1,00117,India
843534,2023-12-24,502,iphone 15 pro max,100000,135000,35000,1,00117,India
704527,2023-12-24,506,monitor,3249,8000,4751,1,00178,India
704527,2023-12-24,507,washing machine,6990,16490,9500,1,00178,India
298421,2023-12-24,507,washing machine,6990,16490,9500,1,00476,India
298421,2023-12-24,503,mixer,1349,3249,1900,1,00476,India
298421,2023-12-24,502,iphone 15 pro max,100000,135000,35000,1,00476,India
298421,2023-12-24,505,oven,18490,24000,5510,1,00476,India
419839,2023-12-24,505,oven,18490,24000,5510,1,00412,India
419839,2023-12-24,507,washing machine,6990,16490,9500,1,00412,India
419839,2023-12-24,506,monitor,3249,8000,4751,1,00412,India
555290,2023-12-24,504,iron,449,879,430,1,00473,India
555290,2023-12-24,506,monitor,3249,8000,4751,1,00473,India
555290,2023-12-24,502,iphone 15 pro max,100000,135000,35000,1,00473,India
555290,2023-12-24,501,iphone 15,60000,80000,20000,1,00473,India
743684,2023-12-24,503,mixer,1349,3249,1900,1,00217,India
743684,2023-12-24,504,iron,449,879,430,1,00217,India
743684,2023-12-24,506,monitor,3249,8000,4751,1,00217,India
136673,2023-12-24,505,oven,18490,24000,5510,1,00073,India
136673,2023-12-24,502,iphone 15 pro max,100000,135000,35000,1,00073,India
136673,2023-12-24,503,mixer,1349,3249,1900,1,00073,India
136673,2023-12-24,501,iphone 15,60000,80000,20000,1,00073,India
202382,2023-12-24,501,iphone 15,60000,80000,20000,1,00004,India
202382,2023-12-24,502,iphone 15 pro max,100000,135000,35000,1,00004,India
202382,2023-12-24,505,oven,18490,24000,5510,1,00004,India
155630,2023-12-24,506,monitor,3249,8000,4751,1,00245,India
155630,2023-12-24,503,mixer,1349,3249,1900,1,00245,India
155630,2023-12-24,502,iphone 15 pro max,100000,135000,35000,1,00245,India
143986,2023-12-24,505,oven,18490,24000,5510,1,00485,India
392867,2023-12-24,504,iron,449,879,430,1,00268,India
392867,2023-12-24,506,monitor,3249,8000,4751,1,00268,India
392867,2023-12-24,502,iphone 15 pro max,100000,135000,35000,1,00268,India
753032,2023-12-24,504,iron,449,879,430,1,00407,India
753032,2023-12-24,502,iphone 15 pro max,100000,135000,35000,1,00407,India
753032,2023-12-24,506,monitor,3249,8000,4751,1,00407,India
753032,2023-12-24,507,washing machine,6990,16490,9500,1,00407,India
845337,2023-12-24,501,iphone 15,60000,80000,20000,1,00479,India
845337,2023-12-24,504,iron,449,879,430,1,00479,India
223274,2023-12-25,507,washing machine,6990,16490,9500,1,00046,India
223274,2023-12-25,505,oven,18490,24000,5510,1,00046,India
450637,2023-12-25,503,mixer,1349,3249,1900,1,00337,India
450637,2023-12-25,504,iron,449,879,430,1,00337,India
450637,2023-12-25,506,monitor,3249,8000,4751,1,00337,India
318660,2023-12-25,506,monitor,3249,8000,4751,1,00128,India
318660,2023-12-25,505,oven,18490,24000,5510,1,00128,India
318660,2023-12-25,507,washing machine,6990,16490,9500,1,00128,India
337950,2023-12-25,504,iron,449,879,430,1,00190,India
337950,2023-12-25,506,monitor,3249,8000,4751,1,00190,India
505841,2023-12-25,505,oven,18490,24000,5510,1,00333,India
505841,2023-12-25,506,monitor,3249,8000,4751,1,00333,India
505841,2023-12-25,503,mixer,1349,3249,1900,1,00333,India
859520,2023-12-25,501,iphone 15,60000,80000,20000,1,00491,India
859520,2023-12-25,506,monitor,3249,8000,4751,1,00491,India
859520,2023-12-25,507,washing machine,6990,16490,9500,1,00491,India
227459,2023-12-25,503,mixer,1349,3249,1900,1,00152,India
854120,2023-12-25,501,iphone 15,60000,80000,20000,1,00348,India
854120,2023-12-25,502,iphone 15 pro max,100000,135000,35000,1,00348,India
354324,2023-12-25,507,washing machine,6990,16490,9500,1,00362,India
354324,2023-12-25,504,iron,449,879,430,1,00362,India
354324,2023-12-25,502,iphone 15 pro max,100000,135000,35000,1,00362,India
354324,2023-12-25,506,monitor,3249,8000,4751,1,00362,India
548161,2023-12-25,506,monitor,3249,8000,4751,1,00489,India
957171,2023-12-25,502,iphone 15 pro max,100000,135000,35000,1,00303,India
957171,2023-12-25,507,washing machine,6990,16490,9500,1,00303,India
957171,2023-12-25,506,monitor,3249,8000,4751,1,00303,India
957171,2023-12-25,504,iron,449,879,430,1,00303,India
957171,2023-12-25,501,iphone 15,60000,80000,20000,1,00303,India
110174,2023-12-25,503,mixer,1349,3249,1900,1,00239,India
110174,2023-12-25,501,iphone 15,60000,80000,20000,1,00239,India
110174,2023-12-25,506,monitor,3249,8000,4751,1,00239,India
110174,2023-12-25,507,washing machine,6990,16490,9500,1,00239,India
799888,2023-12-25,505,oven,18490,24000,5510,1,00237,India
799888,2023-12-25,502,iphone 15 pro max,100000,135000,35000,1,00237,India
799888,2023-12-25,501,iphone 15,60000,80000,20000,1,00237,India
525979,2023-12-25,505,oven,18490,24000,5510,1,00277,India
525979,2023-12-25,502,iphone 15 pro max,100000,135000,35000,1,00277,India
505175,2023-12-25,506,monitor,3249,8000,4751,1,00354,India
505175,2023-12-25,505,oven,18490,24000,5510,1,00354,India
505175,2023-12-25,502,iphone 15 pro max,100000,135000,35000,1,00354,India
431025,2023-12-25,506,monitor,3249,8000,4751,1,00243,India
431025,2023-12-25,502,iphone 15 pro max,100000,135000,35000,1,00243,India
431025,2023-12-25,504,iron,449,879,430,1,00243,India
397508,2023-12-25,504,iron,449,879,430,1,00292,India
397508,2023-12-25,505,oven,18490,24000,5510,1,00292,India
632266,2023-12-25,501,iphone 15,60000,80000,20000,1,00059,India
781398,2023-12-25,502,iphone 15 pro max,100000,135000,35000,1,00279,India
781398,2023-12-25,503,mixer,1349,3249,1900,1,00279,India
781398,2023-12-25,506,monitor,3249,8000,4751,1,00279,India
637059,2023-12-25,504,iron,449,879,430,1,00121,India
637059,2023-12-25,507,washing machine,6990,16490,9500,1,00121,India
179190,2023-12-25,507,washing machine,6990,16490,9500,1,00299,India
179190,2023-12-25,506,monitor,3249,8000,4751,1,00299,India
179190,2023-12-25,502,iphone 15 pro max,100000,135000,35000,1,00299,India
802769,2023-12-25,506,monitor,3249,8000,4751,1,00037,India
547124,2023-12-25,501,iphone 15,60000,80000,20000,1,00315,India
211295,2023-12-25,507,washing machine,6990,16490,9500,1,00038,India
211295,2023-12-25,506,monitor,3249,8000,4751,1,00038,India
445688,2023-12-25,504,iron,449,879,430,1,00253,India
445688,2023-12-25,503,mixer,1349,3249,1900,1,00253,India
326084,2023-12-25,507,washing machine,6990,16490,9500,1,00284,India
326084,2023-12-25,505,oven,18490,24000,5510,1,00284,India
326084,2023-12-25,504,iron,449,879,430,1,00284,India
428281,2023-12-25,501,iphone 15,60000,80000,20000,1,00155,India
428281,2023-12-25,505,oven,18490,24000,5510,1,00155,India
298373,2023-12-25,505,oven,18490,24000,5510,1,00110,India
298373,2023-12-25,501,iphone 15,60000,80000,20000,1,00110,India
298373,2023-12-25,503,mixer,1349,3249,1900,1,00110,India
698016,2023-12-25,505,oven,18490,24000,5510,1,00313,India
487516,2023-12-25,506,monitor,3249,8000,4751,1,00202,India
487516,2023-12-25,502,iphone 15 pro max,100000,135000,35000,1,00202,India
487516,2023-12-25,507,washing machine,6990,16490,9500,1,00202,India
177905,2023-12-25,502,iphone 15 pro max,100000,135000,35000,1,00301,India
177905,2023-12-25,504,iron,449,879,430,1,00301,India
177905,2023-12-25,503,mixer,1349,3249,1900,1,00301,India
811921,2023-12-25,503,mixer,1349,3249,1900,1,00174,India
811921,2023-12-25,506,monitor,3249,8000,4751,1,00174,India
811921,2023-12-25,504,iron,449,879,430,1,00174,India
981167,2023-12-25,505,oven,18490,24000,5510,1,00337,India
981167,2023-12-25,506,monitor,3249,8000,4751,1,00337,India
981167,2023-12-25,501,iphone 15,60000,80000,20000,1,00337,India
100484,2023-12-25,501,iphone 15,60000,80000,20000,1,00253,India
100484,2023-12-25,507,washing machine,6990,16490,9500,1,00253,India
442368,2023-12-25,504,iron,449,879,430,1,00396,India
442368,2023-12-25,507,washing machine,6990,16490,9500,1,00396,India
568452,2023-12-25,503,mixer,1349,3249,1900,1,00081,India
568452,2023-12-25,504,iron,449,879,430,1,00081,India
283631,2023-12-25,501,iphone 15,60000,80000,20000,1,00134,India
283631,2023-12-25,502,iphone 15 pro max,100000,135000,35000,1,00134,India
283631,2023-12-25,507,washing machine,6990,16490,9500,1,00134,India
283631,2023-12-25,505,oven,18490,24000,5510,1,00134,India
884847,2023-12-25,503,mixer,1349,3249,1900,1,00154,India
884847,2023-12-25,506,monitor,3249,8000,4751,1,00154,India
884847,2023-12-25,502,iphone 15 pro max,100000,135000,35000,1,00154,India
574755,2023-12-25,503,mixer,1349,3249,1900,1,00405,India
574755,2023-12-25,507,washing machine,6990,16490,9500,1,00405,India
574755,2023-12-25,506,monitor,3249,8000,4751,1,00405,India
389826,2023-12-25,501,iphone 15,60000,80000,20000,1,00008,India
389826,2023-12-25,502,iphone 15 pro max,100000,135000,35000,1,00008,India
389826,2023-12-25,504,iron,449,879,430,1,00008,India
389826,2023-12-25,503,mixer,1349,3249,1900,1,00008,India
191626,2023-12-25,501,iphone 15,60000,80000,20000,1,00328,India
328954,2023-12-25,504,iron,449,879,430,1,00346,India
328954,2023-12-25,505,oven,18490,24000,5510,1,00346,India
328954,2023-12-25,501,iphone 15,60000,80000,20000,1,00346,India
328954,2023-12-25,507,washing machine,6990,16490,9500,1,00346,India
335781,2023-12-25,507,washing machine,6990,16490,9500,1,00320,India
335781,2023-12-25,506,monitor,3249,8000,4751,1,00320,India
335781,2023-12-25,504,iron,449,879,430,1,00320,India
335781,2023-12-25,505,oven,18490,24000,5510,1,00320,India
335781,2023-12-25,501,iphone 15,60000,80000,20000,1,00320,India
704435,2023-12-25,504,iron,449,879,430,1,00150,India
704435,2023-12-25,505,oven,18490,24000,5510,1,00150,India
704435,2023-12-25,507,washing machine,6990,16490,9500,1,00150,India
704435,2023-12-25,503,mixer,1349,3249,1900,1,00150,India
401340,2023-12-25,505,oven,18490,24000,5510,1,00265,India
401340,2023-12-25,503,mixer,1349,3249,1900,1,00265,India
202969,2023-12-25,503,mixer,1349,3249,1900,1,00308,India
918907,2023-12-25,502,iphone 15 pro max,100000,135000,35000,1,00226,India
694047,2023-12-25,501,iphone 15,60000,80000,20000,1,00296,India
744877,2023-12-25,504,iron,449,879,430,1,00180,India
744877,2023-12-25,502,iphone 15 pro max,100000,135000,35000,1,00180,India
691624,2023-12-25,507,washing machine,6990,16490,9500,1,00390,India
691624,2023-12-25,502,iphone 15 pro max,100000,135000,35000,1,00390,India
691624,2023-12-25,501,iphone 15,60000,80000,20000,1,00390,India
501261,2023-12-25,501,iphone 15,60000,80000,20000,1,00349,India
501261,2023-12-25,507,washing machine,6990,16490,9500,1,00349,India
591827,2023-12-25,506,monitor,3249,8000,4751,1,00401,India
591827,2023-12-25,502,iphone 15 pro max,100000,135000,35000,1,00401,India
591827,2023-12-25,504,iron,449,879,430,1,00401,India
373346,2023-12-25,503,mixer,1349,3249,1900,1,00247,India
160458,2023-12-26,506,monitor,3249,8000,4751,1,00091,India
160458,2023-12-26,507,washing machine,6990,16490,9500,1,00091,India
160458,2023-12-26,503,mixer,1349,3249,1900,1,00091,India
160458,2023-12-26,502,iphone 15 pro max,100000,135000,35000,1,00091,India
762450,2023-12-26,504,iron,449,879,430,1,00485,India
762450,2023-12-26,501,iphone 15,60000,80000,20000,1,00485,India
762450,2023-12-26,506,monitor,3249,8000,4751,1,00485,India
123002,2023-12-26,505,oven,18490,24000,5510,1,00364,India
123002,2023-12-26,506,monitor,3249,8000,4751,1,00364,India
123002,2023-12-26,503,mixer,1349,3249,1900,1,00364,India
704561,2023-12-26,507,washing machine,6990,16490,9500,1,00024,India
120152,2023-12-26,503,mixer,1349,3249,1900,1,00428,India
120152,2023-12-26,507,washing machine,6990,16490,9500,1,00428,India
120152,2023-12-26,501,iphone 15,60000,80000,20000,1,00428,India
907145,2023-12-26,503,mixer,1349,3249,1900,1,00343,India
883667,2023-12-26,501,iphone 15,60000,80000,20000,1,00401,India
883667,2023-12-26,507,washing machine,6990,16490,9500,1,00401,India
883667,2023-12-26,506,monitor,3249,8000,4751,1,00401,India
239062,2023-12-26,504,iron,449,879,430,1,00178,India
239062,2023-12-26,502,iphone 15 pro max,100000,135000,35000,1,00178,India
239062,2023-12-26,503,mixer,1349,3249,1900,1,00178,India
223272,2023-12-26,506,monitor,3249,8000,4751,1,00433,India
223272,2023-12-26,507,washing machine,6990,16490,9500,1,00433,India
223272,2023-12-26,502,iphone 15 pro max,100000,135000,35000,1,00433,India
215440,2023-12-26,504,iron,449,879,430,1,00241,India
875955,2023-12-26,507,washing machine,6990,16490,9500,1,00030,India
875955,2023-12-26,505,oven,18490,24000,5510,1,00030,India
149840,2023-12-26,503,mixer,1349,3249,1900,1,00118,India
149840,2023-12-26,504,iron,449,879,430,1,00118,India
149840,2023-12-26,501,iphone 15,60000,80000,20000,1,00118,India
149840,2023-12-26,502,iphone 15 pro max,100000,135000,35000,1,00118,India
149840,2023-12-26,507,washing machine,6990,16490,9500,1,00118,India
229115,2023-12-26,501,iphone 15,60000,80000,20000,1,00222,India
229115,2023-12-26,505,oven,18490,24000,5510,1,00222,India
229115,2023-12-26,504,iron,449,879,430,1,00222,India
229115,2023-12-26,506,monitor,3249,8000,4751,1,00222,India
936119,2023-12-26,501,iphone 15,60000,80000,20000,1,00115,India
936119,2023-12-26,506,monitor,3249,8000,4751,1,00115,India
761821,2023-12-26,502,iphone 15 pro max,100000,135000,35000,1,00176,India
761821,2023-12-26,503,mixer,1349,3249,1900,1,00176,India
176707,2023-12-26,502,iphone 15 pro max,100000,135000,35000,1,00165,India
176707,2023-12-26,504,iron,449,879,430,1,00165,India
176707,2023-12-26,501,iphone 15,60000,80000,20000,1,00165,India
219528,2023-12-26,504,iron,449,879,430,1,00384,India
219528,2023-12-26,506,monitor,3249,8000,4751,1,00384,India
787888,2023-12-26,505,oven,18490,24000,5510,1,00378,India
593780,2023-12-26,501,iphone 15,60000,80000,20000,1,00232,India
529707,2023-12-26,504,iron,449,879,430,1,00079,India
529707,2023-12-26,502,iphone 15 pro max,100000,135000,35000,1,00079,India
125596,2023-12-26,504,iron,449,879,430,1,00207,India
125596,2023-12-26,506,monitor,3249,8000,4751,1,00207,India
125596,2023-12-26,502,iphone 15 pro max,100000,135000,35000,1,00207,India
387159,2023-12-26,502,iphone 15 pro max,100000,135000,35000,1,00305,India
387159,2023-12-26,506,monitor,3249,8000,4751,1,00305,India
458791,2023-12-26,504,iron,449,879,430,1,00354,India
458791,2023-12-26,506,monitor,3249,8000,4751,1,00354,India
458791,2023-12-26,505,oven,18490,24000,5510,1,00354,India
458791,2023-12-26,507,washing machine,6990,16490,9500,1,00354,India
972598,2023-12-26,502,iphone 15 pro max,100000,135000,35000,1,00022,India
972598,2023-12-26,507,washing machine,6990,16490,9500,1,00022,India
972598,2023-12-26,504,iron,449,879,430,1,00022,India
772966,2023-12-26,504,iron,449,879,430,1,00446,India
772966,2023-12-26,505,oven,18490,24000,5510,1,00446,India
772966,2023-12-26,507,washing machine,6990,16490,9500,1,00446,India
522577,2023-12-26,503,mixer,1349,3249,1900,1,00221,India
522577,2023-12-26,501,iphone 15,60000,80000,20000,1,00221,India
522577,2023-12-26,502,iphone 15 pro max,100000,135000,35000,1,00221,India
531032,2023-12-26,503,mixer,1349,3249,1900,1,00159,India
306447,2023-12-26,507,washing machine,6990,16490,9500,1,00324,India
107000,2023-12-26,504,iron,449,879,430,1,00081,India
172837,2023-12-26,505,oven,18490,24000,5510,1,00039,India
414907,2023-12-26,506,monitor,3249,8000,4751,1,00479,India
605278,2023-12-26,507,washing machine,6990,16490,9500,1,00042,India
605278,2023-12-26,503,mixer,1349,3249,1900,1,00042,India
605278,2023-12-26,502,iphone 15 pro max,100000,135000,35000,1,00042,India
840463,2023-12-26,502,iphone 15 pro max,100000,135000,35000,1,00213,India
840463,2023-12-26,506,monitor,3249,8000,4751,1,00213,India
817728,2023-12-26,504,iron,449,879,430,1,00482,India
530237,2023-12-26,507,washing machine,6990,16490,9500,1,00473,India
530237,2023-12-26,504,iron,449,879,430,1,00473,India
479953,2023-12-26,501,iphone 15,60000,80000,20000,1,00121,India
718862,2023-12-26,507,washing machine,6990,16490,9500,1,00091,India
718862,2023-12-26,503,mixer,1349,3249,1900,1,00091,India
484671,2023-12-26,505,oven,18490,24000,5510,1,00326,India
484671,2023-12-26,504,iron,449,879,430,1,00326,India
760053,2023-12-26,507,washing machine,6990,16490,9500,1,00144,India
760053,2023-12-26,501,iphone 15,60000,80000,20000,1,00144,India
760053,2023-12-26,506,monitor,3249,8000,4751,1,00144,India
760053,2023-12-26,505,oven,18490,24000,5510,1,00144,India
760053,2023-12-26,503,mixer,1349,3249,1900,1,00144,India
704210,2023-12-26,502,iphone 15 pro max,100000,135000,35000,1,00356,India
704210,2023-12-26,507,washing machine,6990,16490,9500,1,00356,India
704210,2023-12-26,506,monitor,3249,8000,4751,1,00356,India
833391,2023-12-26,507,washing machine,6990,16490,9500,1,00287,India
833391,2023-12-26,505,oven,18490,24000,5510,1,00287,India
833391,2023-12-26,503,mixer,1349,3249,1900,1,00287,India
264925,2023-12-26,506,monitor,3249,8000,4751,1,00488,India
264925,2023-12-26,507,washing machine,6990,16490,9500,1,00488,India
264925,2023-12-26,505,oven,18490,24000,5510,1,00488,India
264925,2023-12-26,503,mixer,1349,3249,1900,1,00488,India
264925,2023-12-26,502,iphone 15 pro max,100000,135000,35000,1,00488,India
261051,2023-12-26,506,monitor,3249,8000,4751,1,00278,India
261051,2023-12-26,502,iphone 15 pro max,100000,135000,35000,1,00278,India
261051,2023-12-26,503,mixer,1349,3249,1900,1,00278,India
886753,2023-12-26,506,monitor,3249,8000,4751,1,00380,India
886753,2023-12-26,501,iphone 15,60000,80000,20000,1,00380,India
790151,2023-12-26,502,iphone 15 pro max,100000,135000,35000,1,00019,India
790151,2023-12-26,506,monitor,3249,8000,4751,1,00019,India
790151,2023-12-26,507,washing machine,6990,16490,9500,1,00019,India
844144,2023-12-26,501,iphone 15,60000,80000,20000,1,00244,India
844144,2023-12-26,505,oven,18490,24000,5510,1,00244,India
844144,2023-12-26,504,iron,449,879,430,1,00244,India
844144,2023-12-26,502,iphone 15 pro max,100000,135000,35000,1,00244,India
668139,2023-12-26,505,oven,18490,24000,5510,1,00176,India
668139,2023-12-26,507,washing machine,6990,16490,9500,1,00176,India
668139,2023-12-26,504,iron,449,879,430,1,00176,India
867948,2023-12-26,506,monitor,3249,8000,4751,1,00119,India
867948,2023-12-26,507,washing machine,6990,16490,9500,1,00119,India
892829,2023-12-26,503,mixer,1349,3249,1900,1,00223,India
104885,2023-12-26,502,iphone 15 pro max,100000,135000,35000,1,00013,India
181804,2023-12-26,502,iphone 15 pro max,100000,135000,35000,1,00387,India
181804,2023-12-26,506,monitor,3249,8000,4751,1,00387,India
480840,2023-12-26,503,mixer,1349,3249,1900,1,00164,India
480840,2023-12-26,501,iphone 15,60000,80000,20000,1,00164,India
480840,2023-12-26,507,washing machine,6990,16490,9500,1,00164,India
480840,2023-12-26,502,iphone 15 pro max,100000,135000,35000,1,00164,India
209960,2023-12-26,501,iphone 15,60000,80000,20000,1,00466,India
173061,2023-12-26,507,washing machine,6990,16490,9500,1,00288,India
173061,2023-12-26,502,iphone 15 pro max,100000,135000,35000,1,00288,India
644756,2023-12-26,505,oven,18490,24000,5510,1,00295,India
644756,2023-12-26,503,mixer,1349,3249,1900,1,00295,India
590845,2023-12-26,503,mixer,1349,3249,1900,1,00058,India
590845,2023-12-26,507,washing machine,6990,16490,9500,1,00058,India
590845,2023-12-26,505,oven,18490,24000,5510,1,00058,India
590845,2023-12-26,501,iphone 15,60000,80000,20000,1,00058,India
565641,2023-12-26,504,iron,449,879,430,1,00286,India
565641,2023-12-26,505,oven,18490,24000,5510,1,00286,India
565641,2023-12-26,506,monitor,3249,8000,4751,1,00286,India
565641,2023-12-26,503,mixer,1349,3249,1900,1,00286,India
681884,2023-12-26,501,iphone 15,60000,80000,20000,1,00263,India
681884,2023-12-26,504,iron,449,879,430,1,00263,India
681884,2023-12-26,505,oven,18490,24000,5510,1,00263,India
948152,2023-12-26,501,iphone 15,60000,80000,20000,1,00463,India
948152,2023-12-26,505,oven,18490,24000,5510,1,00463,India
948152,2023-12-26,503,mixer,1349,3249,1900,1,00463,India
948152,2023-12-26,507,washing machine,6990,16490,9500,1,00463,India
569958,2023-12-26,501,iphone 15,60000,80000,20000,1,00449,India
569958,2023-12-26,504,iron,449,879,430,1,00449,India
569958,2023-12-26,507,washing machine,6990,16490,9500,1,00449,India
812723,2023-12-26,506,monitor,3249,8000,4751,1,00078,India
884209,2023-12-26,502,iphone 15 pro max,100000,135000,35000,1,00271,India
884209,2023-12-26,505,oven,18490,24000,5510,1,00271,India
211033,2023-12-26,506,monitor,3249,8000,4751,1,00353,India
211033,2023-12-26,504,iron,449,879,430,1,00353,India
211033,2023-12-26,502,iphone 15 pro max,100000,135000,35000,1,00353,India
209991,2023-12-26,501,iphone 15,60000,80000,20000,1,00170,India
209991,2023-12-26,506,monitor,3249,8000,4751,1,00170,India
209991,2023-12-26,502,iphone 15 pro max,100000,135000,35000,1,00170,India
209991,2023-12-26,507,washing machine,6990,16490,9500,1,00170,India
397272,2023-12-26,506,monitor,3249,8000,4751,1,00344,India
397272,2023-12-26,502,iphone 15 pro max,100000,135000,35000,1,00344,India
397272,2023-12-26,503,mixer,1349,3249,1900,1,00344,India
397272,2023-12-26,501,iphone 15,60000,80000,20000,1,00344,India
131568,2023-12-26,506,monitor,3249,8000,4751,1,00151,India
907734,2023-12-26,505,oven,18490,24000,5510,1,00259,India
907734,2023-12-26,506,monitor,3249,8000,4751,1,00259,India
907734,2023-12-26,507,washing machine,6990,16490,9500,1,00259,India
907734,2023-12-26,501,iphone 15,60000,80000,20000,1,00259,India
702481,2023-12-26,507,washing machine,6990,16490,9500,1,00303,India
702481,2023-12-26,502,iphone 15 pro max,100000,135000,35000,1,00303,India
702481,2023-12-26,503,mixer,1349,3249,1900,1,00303,India
643811,2023-12-26,502,iphone 15 pro max,100000,135000,35000,1,00161,India
643811,2023-12-26,503,mixer,1349,3249,1900,1,00161,India
937733,2023-12-26,502,iphone 15 pro max,100000,135000,35000,1,00234,India
937733,2023-12-26,503,mixer,1349,3249,1900,1,00234,India
590508,2023-12-26,505,oven,18490,24000,5510,1,00325,India
975356,2023-12-26,503,mixer,1349,3249,1900,1,00398,India
643947,2023-12-26,501,iphone 15,60000,80000,20000,1,00262,India
643947,2023-12-26,502,iphone 15 pro max,100000,135000,35000,1,00262,India
127336,2023-12-26,505,oven,18490,24000,5510,1,00128,India
127336,2023-12-26,506,monitor,3249,8000,4751,1,00128,India
127336,2023-12-26,501,iphone 15,60000,80000,20000,1,00128,India
127336,2023-12-26,503,mixer,1349,3249,1900,1,00128,India
654122,2023-12-26,503,mixer,1349,3249,1900,1,00100,India
451766,2023-12-26,504,iron,449,879,430,1,00083,India
451766,2023-12-26,505,oven,18490,24000,5510,1,00083,India
451766,2023-12-26,502,iphone 15 pro max,100000,135000,35000,1,00083,India
319054,2023-12-26,501,iphone 15,60000,80000,20000,1,00099,India
319054,2023-12-26,507,washing machine,6990,16490,9500,1,00099,India
319054,2023-12-26,504,iron,449,879,430,1,00099,India
454773,2023-12-26,506,monitor,3249,8000,4751,1,00395,India
454773,2023-12-26,501,iphone 15,60000,80000,20000,1,00395,India
454773,2023-12-26,507,washing machine,6990,16490,9500,1,00395,India
454773,2023-12-26,502,iphone 15 pro max,100000,135000,35000,1,00395,India
552244,2023-12-26,501,iphone 15,60000,80000,20000,1,00010,India
226425,2023-12-26,503,mixer,1349,3249,1900,1,00124,India
620344,2023-12-26,503,mixer,1349,3249,1900,1,00167,India
540481,2023-12-26,504,iron,449,879,430,1,00007,India
540481,2023-12-26,501,iphone 15,60000,80000,20000,1,00007,India
540481,2023-12-26,506,monitor,3249,8000,4751,1,00007,India
103569,2023-12-26,507,washing machine,6990,16490,9500,1,00446,India
103569,2023-12-26,503,mixer,1349,3249,1900,1,00446,India
849262,2023-12-26,503,mixer,1349,3249,1900,1,00257,India
849262,2023-12-26,504,iron,449,879,430,1,00257,India
849262,2023-12-26,506,monitor,3249,8000,4751,1,00257,India
248092,2023-12-27,504,iron,449,879,430,1,00097,India
248092,2023-12-27,507,washing machine,6990,16490,9500,1,00097,India
248092,2023-12-27,506,monitor,3249,8000,4751,1,00097,India
822891,2023-12-27,501,iphone 15,60000,80000,20000,1,00276,India
822891,2023-12-27,507,washing machine,6990,16490,9500,1,00276,India
796744,2023-12-27,504,iron,449,879,430,1,00458,India
490668,2023-12-27,504,iron,449,879,430,1,00104,India
490668,2023-12-27,507,washing machine,6990,16490,9500,1,00104,India
490668,2023-12-27,506,monitor,3249,8000,4751,1,00104,India
490668,2023-12-27,502,iphone 15 pro max,100000,135000,35000,1,00104,India
527576,2023-12-27,504,iron,449,879,430,1,00410,India
357110,2023-12-27,506,monitor,3249,8000,4751,1,00245,India
357110,2023-12-27,501,iphone 15,60000,80000,20000,1,00245,India
357110,2023-12-27,503,mixer,1349,3249,1900,1,00245,India
322762,2023-12-27,505,oven,18490,24000,5510,1,00211,India
322762,2023-12-27,504,iron,449,879,430,1,00211,India
322762,2023-12-27,503,mixer,1349,3249,1900,1,00211,India
161968,2023-12-27,506,monitor,3249,8000,4751,1,00427,India
161968,2023-12-27,504,iron,449,879,430,1,00427,India
161968,2023-12-27,507,washing machine,6990,16490,9500,1,00427,India
161968,2023-12-27,501,iphone 15,60000,80000,20000,1,00427,India
161968,2023-12-27,502,iphone 15 pro max,100000,135000,35000,1,00427,India
206457,2023-12-27,503,mixer,1349,3249,1900,1,00352,India
328867,2023-12-27,504,iron,449,879,430,1,00202,India
328867,2023-12-27,503,mixer,1349,3249,1900,1,00202,India
296978,2023-12-27,502,iphone 15 pro max,100000,135000,35000,1,00313,India
296978,2023-12-27,503,mixer,1349,3249,1900,1,00313,India
296978,2023-12-27,505,oven,18490,24000,5510,1,00313,India
296978,2023-12-27,501,iphone 15,60000,80000,20000,1,00313,India
592717,2023-12-27,502,iphone 15 pro max,100000,135000,35000,1,00436,India
592717,2023-12-27,507,washing machine,6990,16490,9500,1,00436,India
592717,2023-12-27,504,iron,449,879,430,1,00436,India
544638,2023-12-27,504,iron,449,879,430,1,00399,India
704975,2023-12-27,501,iphone 15,60000,80000,20000,1,00334,India
704975,2023-12-27,507,washing machine,6990,16490,9500,1,00334,India
704975,2023-12-27,503,mixer,1349,3249,1900,1,00334,India
704975,2023-12-27,505,oven,18490,24000,5510,1,00334,India
797804,2023-12-27,504,iron,449,879,430,1,00098,India
797804,2023-12-27,502,iphone 15 pro max,100000,135000,35000,1,00098,India
797804,2023-12-27,505,oven,18490,24000,5510,1,00098,India
613686,2023-12-27,507,washing machine,6990,16490,9500,1,00321,India
613686,2023-12-27,501,iphone 15,60000,80000,20000,1,00321,India
152418,2023-12-27,503,mixer,1349,3249,1900,1,00088,India
152418,2023-12-27,501,iphone 15,60000,80000,20000,1,00088,India
842328,2023-12-27,507,washing machine,6990,16490,9500,1,00370,India
842328,2023-12-27,504,iron,449,879,430,1,00370,India
842328,2023-12-27,502,iphone 15 pro max,100000,135000,35000,1,00370,India
792550,2023-12-27,505,oven,18490,24000,5510,1,00287,India
792550,2023-12-27,502,iphone 15 pro max,100000,135000,35000,1,00287,India
128807,2023-12-27,507,washing machine,6990,16490,9500,1,00296,India
128807,2023-12-27,502,iphone 15 pro max,100000,135000,35000,1,00296,India
700521,2023-12-27,503,mixer,1349,3249,1900,1,00243,India
700521,2023-12-27,507,washing machine,6990,16490,9500,1,00243,India
700521,2023-12-27,505,oven,18490,24000,5510,1,00243,India
698113,2023-12-27,501,iphone 15,60000,80000,20000,1,00112,India
698113,2023-12-27,502,iphone 15 pro max,100000,135000,35000,1,00112,India
698113,2023-12-27,506,monitor,3249,8000,4751,1,00112,India
698113,2023-12-27,507,washing machine,6990,16490,9500,1,00112,India
261851,2023-12-27,507,washing machine,6990,16490,9500,1,00283,India
261851,2023-12-27,501,iphone 15,60000,80000,20000,1,00283,India
261851,2023-12-27,505,oven,18490,24000,5510,1,00283,India
611024,2023-12-27,506,monitor,3249,8000,4751,1,00274,India
611024,2023-12-27,504,iron,449,879,430,1,00274,India
410683,2023-12-27,504,iron,449,879,430,1,00203,India
410683,2023-12-27,502,iphone 15 pro max,100000,135000,35000,1,00203,India
646352,2023-12-27,501,iphone 15,60000,80000,20000,1,00452,India
646352,2023-12-27,505,oven,18490,24000,5510,1,00452,India
646352,2023-12-27,503,mixer,1349,3249,1900,1,00452,India
646352,2023-12-27,502,iphone 15 pro max,100000,135000,35000,1,00452,India
774178,2023-12-27,503,mixer,1349,3249,1900,1,00253,India
836129,2023-12-27,507,washing machine,6990,16490,9500,1,00438,India
836129,2023-12-27,504,iron,449,879,430,1,00438,India
836129,2023-12-27,502,iphone 15 pro max,100000,135000,35000,1,00438,India
466216,2023-12-27,506,monitor,3249,8000,4751,1,00280,India
686955,2023-12-27,505,oven,18490,24000,5510,1,00321,India
686955,2023-12-27,503,mixer,1349,3249,1900,1,00321,India
771946,2023-12-27,502,iphone 15 pro max,100000,135000,35000,1,00224,India
771946,2023-12-27,505,oven,18490,24000,5510,1,00224,India
771946,2023-12-27,506,monitor,3249,8000,4751,1,00224,India
771946,2023-12-27,504,iron,449,879,430,1,00224,India
409214,2023-12-27,505,oven,18490,24000,5510,1,00474,India
474271,2023-12-27,506,monitor,3249,8000,4751,1,00011,India
329480,2023-12-27,504,iron,449,879,430,1,00466,India
329480,2023-12-27,505,oven,18490,24000,5510,1,00466,India
346580,2023-12-27,501,iphone 15,60000,80000,20000,1,00216,India
346580,2023-12-27,503,mixer,1349,3249,1900,1,00216,India
202374,2023-12-27,507,washing machine,6990,16490,9500,1,00104,India
588474,2023-12-27,506,monitor,3249,8000,4751,1,00357,India
588474,2023-12-27,501,iphone 15,60000,80000,20000,1,00357,India
588474,2023-12-27,502,iphone 15 pro max,100000,135000,35000,1,00357,India
588474,2023-12-27,503,mixer,1349,3249,1900,1,00357,India
818960,2023-12-27,506,monitor,3249,8000,4751,1,00364,India
818960,2023-12-27,501,iphone 15,60000,80000,20000,1,00364,India
818960,2023-12-27,504,iron,449,879,430,1,00364,India
443408,2023-12-27,504,iron,449,879,430,1,00166,India
443408,2023-12-27,507,washing machine,6990,16490,9500,1,00166,India
443408,2023-12-27,501,iphone 15,60000,80000,20000,1,00166,India
419562,2023-12-27,506,monitor,3249,8000,4751,1,00193,India
105565,2023-12-27,501,iphone 15,60000,80000,20000,1,00372,India
238523,2023-12-27,507,washing machine,6990,16490,9500,1,00319,India
192259,2023-12-27,507,washing machine,6990,16490,9500,1,00266,India
469824,2023-12-27,501,iphone 15,60000,80000,20000,1,00456,India
469824,2023-12-27,507,washing machine,6990,16490,9500,1,00456,India
469824,2023-12-27,506,monitor,3249,8000,4751,1,00456,India
469824,2023-12-27,503,mixer,1349,3249,1900,1,00456,India
748977,2023-12-27,505,oven,18490,24000,5510,1,00393,India
748977,2023-12-27,504,iron,449,879,430,1,00393,India
748977,2023-12-27,503,mixer,1349,3249,1900,1,00393,India
318800,2023-12-27,503,mixer,1349,3249,1900,1,00485,India
318800,2023-12-27,502,iphone 15 pro max,100000,135000,35000,1,00485,India
318800,2023-12-27,506,monitor,3249,8000,4751,1,00485,India
989863,2023-12-27,506,monitor,3249,8000,4751,1,00122,India
989863,2023-12-27,504,iron,449,879,430,1,00122,India
360796,2023-12-27,507,washing machine,6990,16490,9500,1,00011,India
360796,2023-12-27,506,monitor,3249,8000,4751,1,00011,India
360796,2023-12-27,501,iphone 15,60000,80000,20000,1,00011,India
993549,2023-12-27,503,mixer,1349,3249,1900,1,00086,India
993549,2023-12-27,504,iron,449,879,430,1,00086,India
105083,2023-12-27,503,mixer,1349,3249,1900,1,00103,India
105083,2023-12-27,506,monitor,3249,8000,4751,1,00103,India
378031,2023-12-27,504,iron,449,879,430,1,00452,India
378031,2023-12-27,501,iphone 15,60000,80000,20000,1,00452,India
378031,2023-12-27,507,washing machine,6990,16490,9500,1,00452,India
607757,2023-12-27,507,washing machine,6990,16490,9500,1,00001,India
607757,2023-12-27,502,iphone 15 pro max,100000,135000,35000,1,00001,India
607757,2023-12-27,506,monitor,3249,8000,4751,1,00001,India
607757,2023-12-27,501,iphone 15,60000,80000,20000,1,00001,India
754149,2023-12-27,506,monitor,3249,8000,4751,1,00459,India
605874,2023-12-27,501,iphone 15,60000,80000,20000,1,00206,India
605874,2023-12-27,506,monitor,3249,8000,4751,1,00206,India
605874,2023-12-27,502,iphone 15 pro max,100000,135000,35000,1,00206,India
856458,2023-12-27,506,monitor,3249,8000,4751,1,00433,India
856458,2023-12-27,507,washing machine,6990,16490,9500,1,00433,India
856458,2023-12-27,504,iron,449,879,430,1,00433,India
508349,2023-12-27,503,mixer,1349,3249,1900,1,00407,India
508349,2023-12-27,506,monitor,3249,8000,4751,1,00407,India
508349,2023-12-27,507,washing machine,6990,16490,9500,1,00407,India
508349,2023-12-27,502,iphone 15 pro max,100000,135000,35000,1,00407,India
731201,2023-12-27,506,monitor,3249,8000,4751,1,00007,India
731201,2023-12-27,507,washing machine,6990,16490,9500,1,00007,India
731201,2023-12-27,503,mixer,1349,3249,1900,1,00007,India
731201,2023-12-27,502,iphone 15 pro max,100000,135000,35000,1,00007,India
731201,2023-12-27,501,iphone 15,60000,80000,20000,1,00007,India
394500,2023-12-27,504,iron,449,879,430,1,00389,India
394500,2023-12-27,505,oven,18490,24000,5510,1,00389,India
580864,2023-12-27,505,oven,18490,24000,5510,1,00142,India
580864,2023-12-27,507,washing machine,6990,16490,9500,1,00142,India
489600,2023-12-27,507,washing machine,6990,16490,9500,1,00245,India
489600,2023-12-27,505,oven,18490,24000,5510,1,00245,India
489600,2023-12-27,504,iron,449,879,430,1,00245,India
489600,2023-12-27,503,mixer,1349,3249,1900,1,00245,India
881750,2023-12-27,505,oven,18490,24000,5510,1,00219,India
881750,2023-12-27,503,mixer,1349,3249,1900,1,00219,India
304283,2023-12-27,506,monitor,3249,8000,4751,1,00021,India
304283,2023-12-27,504,iron,449,879,430,1,00021,India
530932,2023-12-27,504,iron,449,879,430,1,00196,India
530932,2023-12-27,502,iphone 15 pro max,100000,135000,35000,1,00196,India
530932,2023-12-27,501,iphone 15,60000,80000,20000,1,00196,India
662470,2023-12-27,507,washing machine,6990,16490,9500,1,00215,India
746296,2023-12-27,502,iphone 15 pro max,100000,135000,35000,1,00057,India
274588,2023-12-27,502,iphone 15 pro max,100000,135000,35000,1,00272,India
274588,2023-12-27,503,mixer,1349,3249,1900,1,00272,India
274588,2023-12-27,506,monitor,3249,8000,4751,1,00272,India
203163,2023-12-27,503,mixer,1349,3249,1900,1,00475,India
203163,2023-12-27,504,iron,449,879,430,1,00475,India
203163,2023-12-27,506,monitor,3249,8000,4751,1,00475,India
760545,2023-12-27,505,oven,18490,24000,5510,1,00389,India
760545,2023-12-27,502,iphone 15 pro max,100000,135000,35000,1,00389,India
760545,2023-12-27,507,washing machine,6990,16490,9500,1,00389,India
760545,2023-12-27,501,iphone 15,60000,80000,20000,1,00389,India
947153,2023-12-27,502,iphone 15 pro max,100000,135000,35000,1,00429,India
947153,2023-12-27,507,washing machine,6990,16490,9500,1,00429,India
314588,2023-12-27,504,iron,449,879,430,1,00001,India
593675,2023-12-27,501,iphone 15,60000,80000,20000,1,00449,India
593675,2023-12-27,505,oven,18490,24000,5510,1,00449,India
593675,2023-12-27,506,monitor,3249,8000,4751,1,00449,India
297179,2023-12-27,506,monitor,3249,8000,4751,1,00217,India
223644,2023-12-27,506,monitor,3249,8000,4751,1,00100,India
650931,2023-12-27,504,iron,449,879,430,1,00208,India
650931,2023-12-27,506,monitor,3249,8000,4751,1,00208,India
650931,2023-12-27,507,washing machine,6990,16490,9500,1,00208,India
650931,2023-12-27,501,iphone 15,60000,80000,20000,1,00208,India
352293,2023-12-27,506,monitor,3249,8000,4751,1,00051,India
487205,2023-12-27,505,oven,18490,24000,5510,1,00499,India
152733,2023-12-27,507,washing machine,6990,16490,9500,1,00483,India
152733,2023-12-27,505,oven,18490,24000,5510,1,00483,India
152733,2023-12-27,502,iphone 15 pro max,100000,135000,35000,1,00483,India
152733,2023-12-27,503,mixer,1349,3249,1900,1,00483,India
765587,2023-12-27,504,iron,449,879,430,1,00105,India
765587,2023-12-27,503,mixer,1349,3249,1900,1,00105,India
765587,2023-12-27,502,iphone 15 pro max,100000,135000,35000,1,00105,India
543961,2023-12-27,506,monitor,3249,8000,4751,1,00453,India
543961,2023-12-27,507,washing machine,6990,16490,9500,1,00453,India
583625,2023-12-27,501,iphone 15,60000,80000,20000,1,00251,India
583625,2023-12-27,506,monitor,3249,8000,4751,1,00251,India
583625,2023-12-27,502,iphone 15 pro max,100000,135000,35000,1,00251,India
583625,2023-12-27,504,iron,449,879,430,1,00251,India
269106,2023-12-27,505,oven,18490,24000,5510,1,00434,India
269106,2023-12-27,504,iron,449,879,430,1,00434,India
203555,2023-12-28,506,monitor,3249,8000,4751,1,00138,India
537476,2023-12-28,507,washing machine,6990,16490,9500,1,00030,India
537476,2023-12-28,504,iron,449,879,430,1,00030,India
537476,2023-12-28,503,mixer,1349,3249,1900,1,00030,India
259340,2023-12-28,504,iron,449,879,430,1,00170,India
259340,2023-12-28,507,washing machine,6990,16490,9500,1,00170,India
259340,2023-12-28,503,mixer,1349,3249,1900,1,00170,India
406213,2023-12-28,507,washing machine,6990,16490,9500,1,00349,India
406213,2023-12-28,506,monitor,3249,8000,4751,1,00349,India
406213,2023-12-28,503,mixer,1349,3249,1900,1,00349,India
406213,2023-12-28,502,iphone 15 pro max,100000,135000,35000,1,00349,India
475715,2023-12-28,503,mixer,1349,3249,1900,1,00461,India
475715,2023-12-28,507,washing machine,6990,16490,9500,1,00461,India
475715,2023-12-28,505,oven,18490,24000,5510,1,00461,India
475715,2023-12-28,504,iron,449,879,430,1,00461,India
475715,2023-12-28,501,iphone 15,60000,80000,20000,1,00461,India
714318,2023-12-28,507,washing machine,6990,16490,9500,1,00226,India
714318,2023-12-28,506,monitor,3249,8000,4751,1,00226,India
714318,2023-12-28,505,oven,18490,24000,5510,1,00226,India
933415,2023-12-28,507,washing machine,6990,16490,9500,1,00400,India
933415,2023-12-28,505,oven,18490,24000,5510,1,00400,India
419071,2023-12-28,502,iphone 15 pro max,100000,135000,35000,1,00053,India
157498,2023-12-28,503,mixer,1349,3249,1900,1,00358,India
376778,2023-12-28,501,iphone 15,60000,80000,20000,1,00078,India
376778,2023-12-28,502,iphone 15 pro max,100000,135000,35000,1,00078,India
376778,2023-12-28,506,monitor,3249,8000,4751,1,00078,India
479266,2023-12-28,507,washing machine,6990,16490,9500,1,00473,India
479266,2023-12-28,504,iron,449,879,430,1,00473,India
479266,2023-12-28,502,iphone 15 pro max,100000,135000,35000,1,00473,India
479266,2023-12-28,503,mixer,1349,3249,1900,1,00473,India
454809,2023-12-28,507,washing machine,6990,16490,9500,1,00057,India
454809,2023-12-28,501,iphone 15,60000,80000,20000,1,00057,India
497262,2023-12-28,501,iphone 15,60000,80000,20000,1,00117,India
497262,2023-12-28,504,iron,449,879,430,1,00117,India
875659,2023-12-28,504,iron,449,879,430,1,00234,India
332470,2023-12-28,507,washing machine,6990,16490,9500,1,00119,India
332470,2023-12-28,501,iphone 15,60000,80000,20000,1,00119,India
332470,2023-12-28,506,monitor,3249,8000,4751,1,00119,India
332470,2023-12-28,504,iron,449,879,430,1,00119,India
805334,2023-12-28,506,monitor,3249,8000,4751,1,00065,India
805334,2023-12-28,502,iphone 15 pro max,100000,135000,35000,1,00065,India
805334,2023-12-28,505,oven,18490,24000,5510,1,00065,India
607095,2023-12-28,507,washing machine,6990,16490,9500,1,00434,India
607095,2023-12-28,505,oven,18490,24000,5510,1,00434,India
983171,2023-12-28,503,mixer,1349,3249,1900,1,00187,India
983171,2023-12-28,506,monitor,3249,8000,4751,1,00187,India
191299,2023-12-28,504,iron,449,879,430,1,00088,India
191299,2023-12-28,502,iphone 15 pro max,100000,135000,35000,1,00088,India
191299,2023-12-28,501,iphone 15,60000,80000,20000,1,00088,India
449071,2023-12-28,506,monitor,3249,8000,4751,1,00362,India
449071,2023-12-28,507,washing machine,6990,16490,9500,1,00362,India
449071,2023-12-28,502,iphone 15 pro max,100000,135000,35000,1,00362,India
449071,2023-12-28,505,oven,18490,24000,5510,1,00362,India
449071,2023-12-28,501,iphone 15,60000,80000,20000,1,00362,India
535697,2023-12-28,501,iphone 15,60000,80000,20000,1,00025,India
535697,2023-12-28,506,monitor,3249,8000,4751,1,00025,India
408955,2023-12-28,504,iron,449,879,430,1,00130,India
869636,2023-12-28,504,iron,449,879,430,1,00191,India
869636,2023-12-28,505,oven,18490,24000,5510,1,00191,India
766096,2023-12-28,506,monitor,3249,8000,4751,1,00146,India
766096,2023-12-28,502,iphone 15 pro max,100000,135000,35000,1,00146,India
766096,2023-12-28,507,washing machine,6990,16490,9500,1,00146,India
861228,2023-12-28,506,monitor,3249,8000,4751,1,00097,India
861228,2023-12-28,505,oven,18490,24000,5510,1,00097,India
861228,2023-12-28,502,iphone 15 pro max,100000,135000,35000,1,00097,India
710595,2023-12-28,504,iron,449,879,430,1,00045,India
710595,2023-12-28,505,oven,18490,24000,5510,1,00045,India
710595,2023-12-28,502,iphone 15 pro max,100000,135000,35000,1,00045,India
710595,2023-12-28,501,iphone 15,60000,80000,20000,1,00045,India
446476,2023-12-28,504,iron,449,879,430,1,00193,India
446476,2023-12-28,506,monitor,3249,8000,4751,1,00193,India
446476,2023-12-28,503,mixer,1349,3249,1900,1,00193,India
196088,2023-12-28,503,mixer,1349,3249,1900,1,00109,India
196088,2023-12-28,506,monitor,3249,8000,4751,1,00109,India
196088,2023-12-28,507,washing machine,6990,16490,9500,1,00109,India
304582,2023-12-28,501,iphone 15,60000,80000,20000,1,00332,India
703361,2023-12-28,501,iphone 15,60000,80000,20000,1,00401,India
703361,2023-12-28,503,mixer,1349,3249,1900,1,00401,India
338342,2023-12-28,502,iphone 15 pro max,100000,135000,35000,1,00226,India
338342,2023-12-28,505,oven,18490,24000,5510,1,00226,India
338342,2023-12-28,506,monitor,3249,8000,4751,1,00226,India
338342,2023-12-28,503,mixer,1349,3249,1900,1,00226,India
163100,2023-12-28,504,iron,449,879,430,1,00246,India
200622,2023-12-28,505,oven,18490,24000,5510,1,00119,India
200622,2023-12-28,502,iphone 15 pro max,100000,135000,35000,1,00119,India
200622,2023-12-28,507,washing machine,6990,16490,9500,1,00119,India
632763,2023-12-28,501,iphone 15,60000,80000,20000,1,00086,India
632763,2023-12-28,502,iphone 15 pro max,100000,135000,35000,1,00086,India
632763,2023-12-28,505,oven,18490,24000,5510,1,00086,India
632763,2023-12-28,507,washing machine,6990,16490,9500,1,00086,India
814945,2023-12-28,503,mixer,1349,3249,1900,1,00075,India
683624,2023-12-28,504,iron,449,879,430,1,00298,India
683624,2023-12-28,507,washing machine,6990,16490,9500,1,00298,India
683624,2023-12-28,502,iphone 15 pro max,100000,135000,35000,1,00298,India
683624,2023-12-28,505,oven,18490,24000,5510,1,00298,India
437322,2023-12-28,502,iphone 15 pro max,100000,135000,35000,1,00390,India
504019,2023-12-28,507,washing machine,6990,16490,9500,1,00184,India
504019,2023-12-28,504,iron,449,879,430,1,00184,India
504019,2023-12-28,503,mixer,1349,3249,1900,1,00184,India
666733,2023-12-28,505,oven,18490,24000,5510,1,00004,India
666733,2023-12-28,501,iphone 15,60000,80000,20000,1,00004,India
666733,2023-12-28,502,iphone 15 pro max,100000,135000,35000,1,00004,India
766562,2023-12-28,504,iron,449,879,430,1,00414,India
766562,2023-12-28,501,iphone 15,60000,80000,20000,1,00414,India
766562,2023-12-28,503,mixer,1349,3249,1900,1,00414,India
766562,2023-12-28,502,iphone 15 pro max,100000,135000,35000,1,00414,India
183744,2023-12-28,502,iphone 15 pro max,100000,135000,35000,1,00369,India
183744,2023-12-28,503,mixer,1349,3249,1900,1,00369,India
183744,2023-12-28,505,oven,18490,24000,5510,1,00369,India
183744,2023-12-28,501,iphone 15,60000,80000,20000,1,00369,India
183744,2023-12-28,504,iron,449,879,430,1,00369,India
276006,2023-12-28,504,iron,449,879,430,1,00076,India
276006,2023-12-28,502,iphone 15 pro max,100000,135000,35000,1,00076,India
276006,2023-12-28,507,washing machine,6990,16490,9500,1,00076,India
691566,2023-12-28,501,iphone 15,60000,80000,20000,1,00018,India
297726,2023-12-28,505,oven,18490,24000,5510,1,00300,India
121468,2023-12-28,506,monitor,3249,8000,4751,1,00413,India
342820,2023-12-28,506,monitor,3249,8000,4751,1,00120,India
342820,2023-12-28,502,iphone 15 pro max,100000,135000,35000,1,00120,India
342820,2023-12-28,504,iron,449,879,430,1,00120,India
307994,2023-12-28,505,oven,18490,24000,5510,1,00278,India
307994,2023-12-28,502,iphone 15 pro max,100000,135000,35000,1,00278,India
307994,2023-12-28,506,monitor,3249,8000,4751,1,00278,India
757644,2023-12-28,503,mixer,1349,3249,1900,1,00454,India
953255,2023-12-28,504,iron,449,879,430,1,00156,India
102485,2023-12-28,502,iphone 15 pro max,100000,135000,35000,1,00045,India
102485,2023-12-28,504,iron,449,879,430,1,00045,India
913377,2023-12-28,501,iphone 15,60000,80000,20000,1,00455,India
913377,2023-12-28,507,washing machine,6990,16490,9500,1,00455,India
913377,2023-12-28,503,mixer,1349,3249,1900,1,00455,India
913377,2023-12-28,506,monitor,3249,8000,4751,1,00455,India
209122,2023-12-28,506,monitor,3249,8000,4751,1,00150,India
209122,2023-12-28,501,iphone 15,60000,80000,20000,1,00150,India
209122,2023-12-28,507,washing machine,6990,16490,9500,1,00150,India
589998,2023-12-28,507,washing machine,6990,16490,9500,1,00429,India
589998,2023-12-28,501,iphone 15,60000,80000,20000,1,00429,India
589998,2023-12-28,503,mixer,1349,3249,1900,1,00429,India
710920,2023-12-28,504,iron,449,879,430,1,00362,India
924336,2023-12-28,503,mixer,1349,3249,1900,1,00207,India
924336,2023-12-28,501,iphone 15,60000,80000,20000,1,00207,India
924336,2023-12-28,504,iron,449,879,430,1,00207,India
338177,2023-12-28,503,mixer,1349,3249,1900,1,00249,India
338177,2023-12-28,505,oven,18490,24000,5510,1,00249,India
137804,2023-12-28,502,iphone 15 pro max,100000,135000,35000,1,00217,India
137804,2023-12-28,503,mixer,1349,3249,1900,1,00217,India
137804,2023-12-28,501,iphone 15,60000,80000,20000,1,00217,India
722993,2023-12-28,504,iron,449,879,430,1,00238,India
722993,2023-12-28,505,oven,18490,24000,5510,1,00238,India
722993,2023-12-28,506,monitor,3249,8000,4751,1,00238,India
236171,2023-12-28,503,mixer,1349,3249,1900,1,00247,India
236171,2023-12-28,505,oven,18490,24000,5510,1,00247,India
236171,2023-12-28,502,iphone 15 pro max,100000,135000,35000,1,00247,India
855085,2023-12-28,506,monitor,3249,8000,4751,1,00403,India
925803,2023-12-28,502,iphone 15 pro max,100000,135000,35000,1,00204,India
925803,2023-12-28,501,iphone 15,60000,80000,20000,1,00204,India
165551,2023-12-28,506,monitor,3249,8000,4751,1,00351,India
437154,2023-12-28,505,oven,18490,24000,5510,1,00337,India
437154,2023-12-28,506,monitor,3249,8000,4751,1,00337,India
437154,2023-12-28,507,washing machine,6990,16490,9500,1,00337,India
437154,2023-12-28,501,iphone 15,60000,80000,20000,1,00337,India
437154,2023-12-28,503,mixer,1349,3249,1900,1,00337,India
674177,2023-12-28,504,iron,449,879,430,1,00253,India
674177,2023-12-28,506,monitor,3249,8000,4751,1,00253,India
674177,2023-12-28,502,iphone 15 pro max,100000,135000,35000,1,00253,India
674177,2023-12-28,503,mixer,1349,3249,1900,1,00253,India
674177,2023-12-28,501,iphone 15,60000,80000,20000,1,00253,India
414227,2023-12-28,503,mixer,1349,3249,1900,1,00131,India
763039,2023-12-28,505,oven,18490,24000,5510,1,00309,India
763039,2023-12-28,503,mixer,1349,3249,1900,1,00309,India
763039,2023-12-28,501,iphone 15,60000,80000,20000,1,00309,India
763039,2023-12-28,502,iphone 15 pro max,100000,135000,35000,1,00309,India
763039,2023-12-28,507,washing machine,6990,16490,9500,1,00309,India
962788,2023-12-28,503,mixer,1349,3249,1900,1,00204,India
962788,2023-12-28,505,oven,18490,24000,5510,1,00204,India
482591,2023-12-28,502,iphone 15 pro max,100000,135000,35000,1,00206,India
482591,2023-12-28,501,iphone 15,60000,80000,20000,1,00206,India
596645,2023-12-28,501,iphone 15,60000,80000,20000,1,00452,India
827643,2023-12-28,505,oven,18490,24000,5510,1,00295,India
827643,2023-12-28,501,iphone 15,60000,80000,20000,1,00295,India
827643,2023-12-28,502,iphone 15 pro max,100000,135000,35000,1,00295,India
827643,2023-12-28,504,iron,449,879,430,1,00295,India
855646,2023-12-28,501,iphone 15,60000,80000,20000,1,00268,India
855646,2023-12-28,505,oven,18490,24000,5510,1,00268,India
855804,2023-12-28,507,washing machine,6990,16490,9500,1,00469,India
855804,2023-12-28,505,oven,18490,24000,5510,1,00469,India
855804,2023-12-28,506,monitor,3249,8000,4751,1,00469,India
855804,2023-12-28,503,mixer,1349,3249,1900,1,00469,India
604350,2023-12-29,501,iphone 15,60000,80000,20000,1,00139,India
604350,2023-12-29,502,iphone 15 pro max,100000,135000,35000,1,00139,India
368678,2023-12-29,502,iphone 15 pro max,100000,135000,35000,1,00244,India
368678,2023-12-29,506,monitor,3249,8000,4751,1,00244,India
817779,2023-12-29,503,mixer,1349,3249,1900,1,00301,India
817779,2023-12-29,502,iphone 15 pro max,100000,135000,35000,1,00301,India
532545,2023-12-29,501,iphone 15,60000,80000,20000,1,00389,India
532545,2023-12-29,503,mixer,1349,3249,1900,1,00389,India
663680,2023-12-29,501,iphone 15,60000,80000,20000,1,00017,India
663680,2023-12-29,503,mixer,1349,3249,1900,1,00017,India
931832,2023-12-29,501,iphone 15,60000,80000,20000,1,00144,India
931832,2023-12-29,502,iphone 15 pro max,100000,135000,35000,1,00144,India
143623,2023-12-29,506,monitor,3249,8000,4751,1,00248,India
583032,2023-12-29,504,iron,449,879,430,1,00446,India
583032,2023-12-29,505,oven,18490,24000,5510,1,00446,India
556863,2023-12-29,504,iron,449,879,430,1,00127,India
556863,2023-12-29,501,iphone 15,60000,80000,20000,1,00127,India
865584,2023-12-29,502,iphone 15 pro max,100000,135000,35000,1,00369,India
740298,2023-12-29,504,iron,449,879,430,1,00471,India
740298,2023-12-29,502,iphone 15 pro max,100000,135000,35000,1,00471,India
878612,2023-12-29,504,iron,449,879,430,1,00480,India
910530,2023-12-29,504,iron,449,879,430,1,00173,India
910530,2023-12-29,506,monitor,3249,8000,4751,1,00173,India
910530,2023-12-29,505,oven,18490,24000,5510,1,00173,India
910530,2023-12-29,507,washing machine,6990,16490,9500,1,00173,India
771719,2023-12-29,505,oven,18490,24000,5510,1,00343,India
771719,2023-12-29,504,iron,449,879,430,1,00343,India
731924,2023-12-29,503,mixer,1349,3249,1900,1,00491,India
731924,2023-12-29,501,iphone 15,60000,80000,20000,1,00491,India
731924,2023-12-29,506,monitor,3249,8000,4751,1,00491,India
257661,2023-12-29,504,iron,449,879,430,1,00123,India
881921,2023-12-29,506,monitor,3249,8000,4751,1,00183,India
881921,2023-12-29,503,mixer,1349,3249,1900,1,00183,India
881921,2023-12-29,507,washing machine,6990,16490,9500,1,00183,India
376532,2023-12-29,501,iphone 15,60000,80000,20000,1,00007,India
376532,2023-12-29,504,iron,449,879,430,1,00007,India
376532,2023-12-29,505,oven,18490,24000,5510,1,00007,India
393584,2023-12-29,501,iphone 15,60000,80000,20000,1,00290,India
428113,2023-12-29,502,iphone 15 pro max,100000,135000,35000,1,00476,India
428113,2023-12-29,504,iron,449,879,430,1,00476,India
428113,2023-12-29,506,monitor,3249,8000,4751,1,00476,India
428113,2023-12-29,507,washing machine,6990,16490,9500,1,00476,India
428113,2023-12-29,501,iphone 15,60000,80000,20000,1,00476,India
589141,2023-12-29,506,monitor,3249,8000,4751,1,00455,India
589141,2023-12-29,502,iphone 15 pro max,100000,135000,35000,1,00455,India
589141,2023-12-29,507,washing machine,6990,16490,9500,1,00455,India
604674,2023-12-29,506,monitor,3249,8000,4751,1,00234,India
604674,2023-12-29,502,iphone 15 pro max,100000,135000,35000,1,00234,India
487443,2023-12-29,505,oven,18490,24000,5510,1,00140,India
836221,2023-12-29,501,iphone 15,60000,80000,20000,1,00404,India
836221,2023-12-29,504,iron,449,879,430,1,00404,India
320283,2023-12-29,506,monitor,3249,8000,4751,1,00482,India
320283,2023-12-29,503,mixer,1349,3249,1900,1,00482,India
320283,2023-12-29,504,iron,449,879,430,1,00482,India
205537,2023-12-29,506,monitor,3249,8000,4751,1,00415,India
205537,2023-12-29,502,iphone 15 pro max,100000,135000,35000,1,00415,India
205537,2023-12-29,503,mixer,1349,3249,1900,1,00415,India
205537,2023-12-29,504,iron,449,879,430,1,00415,India
303798,2023-12-29,506,monitor,3249,8000,4751,1,00129,India
880928,2023-12-29,501,iphone 15,60000,80000,20000,1,00361,India
880928,2023-12-29,504,iron,449,879,430,1,00361,India
880928,2023-12-29,503,mixer,1349,3249,1900,1,00361,India
659165,2023-12-29,504,iron,449,879,430,1,00396,India
659165,2023-12-29,507,washing machine,6990,16490,9500,1,00396,India
465615,2023-12-29,505,oven,18490,24000,5510,1,00114,India
465615,2023-12-29,506,monitor,3249,8000,4751,1,00114,India
465615,2023-12-29,507,washing machine,6990,16490,9500,1,00114,India
465615,2023-12-29,503,mixer,1349,3249,1900,1,00114,India
769395,2023-12-29,505,oven,18490,24000,5510,1,00009,India
769395,2023-12-29,502,iphone 15 pro max,100000,135000,35000,1,00009,India
769395,2023-12-29,506,monitor,3249,8000,4751,1,00009,India
403776,2023-12-29,502,iphone 15 pro max,100000,135000,35000,1,00047,India
403776,2023-12-29,507,washing machine,6990,16490,9500,1,00047,India
403776,2023-12-29,505,oven,18490,24000,5510,1,00047,India
791676,2023-12-29,506,monitor,3249,8000,4751,1,00077,India
565452,2023-12-29,502,iphone 15 pro max,100000,135000,35000,1,00347,India
565452,2023-12-29,503,mixer,1349,3249,1900,1,00347,India
565452,2023-12-29,504,iron,449,879,430,1,00347,India
565452,2023-12-29,501,iphone 15,60000,80000,20000,1,00347,India
455469,2023-12-29,506,monitor,3249,8000,4751,1,00240,India
712056,2023-12-29,501,iphone 15,60000,80000,20000,1,00469,India
712056,2023-12-29,505,oven,18490,24000,5510,1,00469,India
712056,2023-12-29,503,mixer,1349,3249,1900,1,00469,India
205863,2023-12-29,505,oven,18490,24000,5510,1,00031,India
205863,2023-12-29,501,iphone 15,60000,80000,20000,1,00031,India
205863,2023-12-29,502,iphone 15 pro max,100000,135000,35000,1,00031,India
221813,2023-12-29,502,iphone 15 pro max,100000,135000,35000,1,00432,India
221813,2023-12-29,501,iphone 15,60000,80000,20000,1,00432,India
237494,2023-12-29,502,iphone 15 pro max,100000,135000,35000,1,00080,India
148954,2023-12-29,502,iphone 15 pro max,100000,135000,35000,1,00069,India
148954,2023-12-29,504,iron,449,879,430,1,00069,India
516841,2023-12-29,502,iphone 15 pro max,100000,135000,35000,1,00029,India
516841,2023-12-29,501,iphone 15,60000,80000,20000,1,00029,India
516841,2023-12-29,505,oven,18490,24000,5510,1,00029,India
535808,2023-12-29,501,iphone 15,60000,80000,20000,1,00063,India
535808,2023-12-29,507,washing machine,6990,16490,9500,1,00063,India
535808,2023-12-29,505,oven,18490,24000,5510,1,00063,India
251009,2023-12-29,504,iron,449,879,430,1,00296,India
251009,2023-12-29,506,monitor,3249,8000,4751,1,00296,India
251009,2023-12-29,502,iphone 15 pro max,100000,135000,35000,1,00296,India
408139,2023-12-29,503,mixer,1349,3249,1900,1,00470,India
408139,2023-12-29,507,washing machine,6990,16490,9500,1,00470,India
138828,2023-12-29,503,mixer,1349,3249,1900,1,00254,India
138828,2023-12-29,505,oven,18490,24000,5510,1,00254,India
138828,2023-12-29,506,monitor,3249,8000,4751,1,00254,India
526087,2023-12-29,504,iron,449,879,430,1,00461,India
526087,2023-12-29,506,monitor,3249,8000,4751,1,00461,India
732354,2023-12-29,505,oven,18490,24000,5510,1,00103,India
732354,2023-12-29,503,mixer,1349,3249,1900,1,00103,India
382360,2023-12-29,504,iron,449,879,430,1,00226,India
382360,2023-12-29,505,oven,18490,24000,5510,1,00226,India
602688,2023-12-29,503,mixer,1349,3249,1900,1,00051,India
400361,2023-12-29,507,washing machine,6990,16490,9500,1,00374,India
400361,2023-12-29,501,iphone 15,60000,80000,20000,1,00374,India
400361,2023-12-29,506,monitor,3249,8000,4751,1,00374,India
400361,2023-12-29,505,oven,18490,24000,5510,1,00374,India
578611,2023-12-29,507,washing machine,6990,16490,9500,1,00136,India
578611,2023-12-29,505,oven,18490,24000,5510,1,00136,India
578611,2023-12-29,504,iron,449,879,430,1,00136,India
578611,2023-12-29,506,monitor,3249,8000,4751,1,00136,India
299352,2023-12-29,504,iron,449,879,430,1,00219,India
299352,2023-12-29,502,iphone 15 pro max,100000,135000,35000,1,00219,India
299352,2023-12-29,506,monitor,3249,8000,4751,1,00219,India
299352,2023-12-29,505,oven,18490,24000,5510,1,00219,India
711637,2023-12-29,507,washing machine,6990,16490,9500,1,00272,India
457552,2023-12-29,504,iron,449,879,430,1,00188,India
457552,2023-12-29,505,oven,18490,24000,5510,1,00188,India
457552,2023-12-29,507,washing machine,6990,16490,9500,1,00188,India
457552,2023-12-29,503,mixer,1349,3249,1900,1,00188,India
920669,2023-12-29,506,monitor,3249,8000,4751,1,00368,India
920669,2023-12-29,503,mixer,1349,3249,1900,1,00368,India
771666,2023-12-29,502,iphone 15 pro max,100000,135000,35000,1,00409,India
856553,2023-12-29,504,iron,449,879,430,1,00451,India
856553,2023-12-29,507,washing machine,6990,16490,9500,1,00451,India
856553,2023-12-29,502,iphone 15 pro max,100000,135000,35000,1,00451,India
856553,2023-12-29,501,iphone 15,60000,80000,20000,1,00451,India
681638,2023-12-29,501,iphone 15,60000,80000,20000,1,00273,India
681638,2023-12-29,507,washing machine,6990,16490,9500,1,00273,India
645366,2023-12-29,503,mixer,1349,3249,1900,1,00376,India
645366,2023-12-29,504,iron,449,879,430,1,00376,India
348459,2023-12-29,501,iphone 15,60000,80000,20000,1,00368,India
348459,2023-12-29,502,iphone 15 pro max,100000,135000,35000,1,00368,India
594106,2023-12-29,505,oven,18490,24000,5510,1,00470,India
594106,2023-12-29,504,iron,449,879,430,1,00470,India
594106,2023-12-29,507,washing machine,6990,16490,9500,1,00470,India
594106,2023-12-29,502,iphone 15 pro max,100000,135000,35000,1,00470,India
545170,2023-12-29,503,mixer,1349,3249,1900,1,00345,India
545170,2023-12-29,505,oven,18490,24000,5510,1,00345,India
545170,2023-12-29,501,iphone 15,60000,80000,20000,1,00345,India
966680,2023-12-29,504,iron,449,879,430,1,00159,India
969773,2023-12-29,505,oven,18490,24000,5510,1,00335,India
364110,2023-12-29,504,iron,449,879,430,1,00453,India
364110,2023-12-29,507,washing machine,6990,16490,9500,1,00453,India
364110,2023-12-29,503,mixer,1349,3249,1900,1,00453,India
272513,2023-12-29,503,mixer,1349,3249,1900,1,00221,India
272513,2023-12-29,504,iron,449,879,430,1,00221,India
973552,2023-12-29,505,oven,18490,24000,5510,1,00442,India
973552,2023-12-29,502,iphone 15 pro max,100000,135000,35000,1,00442,India
973552,2023-12-29,504,iron,449,879,430,1,00442,India
117365,2023-12-29,501,iphone 15,60000,80000,20000,1,00193,India
119060,2023-12-29,506,monitor,3249,8000,4751,1,00361,India
119060,2023-12-29,501,iphone 15,60000,80000,20000,1,00361,India
119060,2023-12-29,505,oven,18490,24000,5510,1,00361,India
900270,2023-12-29,507,washing machine,6990,16490,9500,1,00237,India
900270,2023-12-29,502,iphone 15 pro max,100000,135000,35000,1,00237,India
356463,2023-12-29,503,mixer,1349,3249,1900,1,00356,India
356463,2023-12-29,507,washing machine,6990,16490,9500,1,00356,India
356463,2023-12-29,505,oven,18490,24000,5510,1,00356,India
266917,2023-12-29,504,iron,449,879,430,1,00106,India
266917,2023-12-29,507,washing machine,6990,16490,9500,1,00106,India
152469,2023-12-30,506,monitor,3249,8000,4751,1,00211,India
152469,2023-12-30,507,washing machine,6990,16490,9500,1,00211,India
152469,2023-12-30,501,iphone 15,60000,80000,20000,1,00211,India
430508,2023-12-30,506,monitor,3249,8000,4751,1,00333,India
976617,2023-12-30,506,monitor,3249,8000,4751,1,00352,India
976617,2023-12-30,502,iphone 15 pro max,100000,135000,35000,1,00352,India
976617,2023-12-30,503,mixer,1349,3249,1900,1,00352,India
740080,2023-12-30,502,iphone 15 pro max,100000,135000,35000,1,00080,India
658323,2023-12-30,505,oven,18490,24000,5510,1,00480,India
227079,2023-12-30,503,mixer,1349,3249,1900,1,00266,India
227079,2023-12-30,504,iron,449,879,430,1,00266,India
355780,2023-12-30,502,iphone 15 pro max,100000,135000,35000,1,00155,India
373841,2023-12-30,504,iron,449,879,430,1,00183,India
373841,2023-12-30,505,oven,18490,24000,5510,1,00183,India
949479,2023-12-30,506,monitor,3249,8000,4751,1,00184,India
169548,2023-12-30,505,oven,18490,24000,5510,1,00416,India
169548,2023-12-30,507,washing machine,6990,16490,9500,1,00416,India
398415,2023-12-30,501,iphone 15,60000,80000,20000,1,00363,India
398415,2023-12-30,507,washing machine,6990,16490,9500,1,00363,India
398415,2023-12-30,506,monitor,3249,8000,4751,1,00363,India
258351,2023-12-30,506,monitor,3249,8000,4751,1,00015,India
258351,2023-12-30,503,mixer,1349,3249,1900,1,00015,India
258351,2023-12-30,501,iphone 15,60000,80000,20000,1,00015,India
258351,2023-12-30,507,washing machine,6990,16490,9500,1,00015,India
516481,2023-12-30,504,iron,449,879,430,1,00392,India
516481,2023-12-30,506,monitor,3249,8000,4751,1,00392,India
516481,2023-12-30,502,iphone 15 pro max,100000,135000,35000,1,00392,India
979724,2023-12-30,506,monitor,3249,8000,4751,1,00029,India
260277,2023-12-30,503,mixer,1349,3249,1900,1,00485,India
209586,2023-12-30,507,washing machine,6990,16490,9500,1,00292,India
209586,2023-12-30,504,iron,449,879,430,1,00292,India
390441,2023-12-30,502,iphone 15 pro max,100000,135000,35000,1,00045,India
390441,2023-12-30,507,washing machine,6990,16490,9500,1,00045,India
390441,2023-12-30,503,mixer,1349,3249,1900,1,00045,India
390441,2023-12-30,501,iphone 15,60000,80000,20000,1,00045,India
291032,2023-12-30,505,oven,18490,24000,5510,1,00491,India
291032,2023-12-30,503,mixer,1349,3249,1900,1,00491,India
291032,2023-12-30,502,iphone 15 pro max,100000,135000,35000,1,00491,India
343443,2023-12-30,501,iphone 15,60000,80000,20000,1,00136,India
343443,2023-12-30,504,iron,449,879,430,1,00136,India
343443,2023-12-30,505,oven,18490,24000,5510,1,00136,India
343443,2023-12-30,507,washing machine,6990,16490,9500,1,00136,India
701684,2023-12-30,504,iron,449,879,430,1,00243,India
701684,2023-12-30,505,oven,18490,24000,5510,1,00243,India
701684,2023-12-30,501,iphone 15,60000,80000,20000,1,00243,India
701684,2023-12-30,506,monitor,3249,8000,4751,1,00243,India
188934,2023-12-30,501,iphone 15,60000,80000,20000,1,00404,India
188934,2023-12-30,506,monitor,3249,8000,4751,1,00404,India
481339,2023-12-30,506,monitor,3249,8000,4751,1,00171,India
481339,2023-12-30,502,iphone 15 pro max,100000,135000,35000,1,00171,India
605471,2023-12-30,506,monitor,3249,8000,4751,1,00388,India
605471,2023-12-30,502,iphone 15 pro max,100000,135000,35000,1,00388,India
605471,2023-12-30,503,mixer,1349,3249,1900,1,00388,India
605471,2023-12-30,505,oven,18490,24000,5510,1,00388,India
394918,2023-12-30,507,washing machine,6990,16490,9500,1,00338,India
394918,2023-12-30,506,monitor,3249,8000,4751,1,00338,India
394918,2023-12-30,504,iron,449,879,430,1,00338,India
394918,2023-12-30,502,iphone 15 pro max,100000,135000,35000,1,00338,India
194119,2023-12-30,501,iphone 15,60000,80000,20000,1,00448,India
194119,2023-12-30,504,iron,449,879,430,1,00448,India
194119,2023-12-30,506,monitor,3249,8000,4751,1,00448,India
194119,2023-12-30,502,iphone 15 pro max,100000,135000,35000,1,00448,India
306706,2023-12-30,502,iphone 15 pro max,100000,135000,35000,1,00348,India
306706,2023-12-30,501,iphone 15,60000,80000,20000,1,00348,India
306706,2023-12-30,507,washing machine,6990,16490,9500,1,00348,India
306706,2023-12-30,504,iron,449,879,430,1,00348,India
306706,2023-12-30,503,mixer,1349,3249,1900,1,00348,India
749491,2023-12-30,505,oven,18490,24000,5510,1,00303,India
553585,2023-12-30,503,mixer,1349,3249,1900,1,00167,India
647765,2023-12-30,501,iphone 15,60000,80000,20000,1,00268,India
647765,2023-12-30,506,monitor,3249,8000,4751,1,00268,India
604369,2023-12-30,506,monitor,3249,8000,4751,1,00279,India
821628,2023-12-30,506,monitor,3249,8000,4751,1,00317,India
821628,2023-12-30,505,oven,18490,24000,5510,1,00317,India
821628,2023-12-30,503,mixer,1349,3249,1900,1,00317,India
821628,2023-12-30,507,washing machine,6990,16490,9500,1,00317,India
565590,2023-12-30,503,mixer,1349,3249,1900,1,00091,India
565590,2023-12-30,507,washing machine,6990,16490,9500,1,00091,India
360896,2023-12-30,503,mixer,1349,3249,1900,1,00151,India
360896,2023-12-30,504,iron,449,879,430,1,00151,India
360896,2023-12-30,505,oven,18490,24000,5510,1,00151,India
360896,2023-12-30,501,iphone 15,60000,80000,20000,1,00151,India
951968,2023-12-30,503,mixer,1349,3249,1900,1,00223,India
951968,2023-12-30,507,washing machine,6990,16490,9500,1,00223,India
951968,2023-12-30,501,iphone 15,60000,80000,20000,1,00223,India
951968,2023-12-30,502,iphone 15 pro max,100000,135000,35000,1,00223,India
899505,2023-12-30,503,mixer,1349,3249,1900,1,00471,India
899505,2023-12-30,506,monitor,3249,8000,4751,1,00471,India
899505,2023-12-30,501,iphone 15,60000,80000,20000,1,00471,India
899505,2023-12-30,504,iron,449,879,430,1,00471,India
494596,2023-12-30,507,washing machine,6990,16490,9500,1,00049,India
494596,2023-12-30,505,oven,18490,24000,5510,1,00049,India
246759,2023-12-30,503,mixer,1349,3249,1900,1,00211,India
246759,2023-12-30,505,oven,18490,24000,5510,1,00211,India
246759,2023-12-30,501,iphone 15,60000,80000,20000,1,00211,India
930749,2023-12-30,503,mixer,1349,3249,1900,1,00023,India
930749,2023-12-30,507,washing machine,6990,16490,9500,1,00023,India
930749,2023-12-30,505,oven,18490,24000,5510,1,00023,India
930749,2023-12-30,501,iphone 15,60000,80000,20000,1,00023,India
930749,2023-12-30,504,iron,449,879,430,1,00023,India
914867,2023-12-30,502,iphone 15 pro max,100000,135000,35000,1,00414,India
914867,2023-12-30,506,monitor,3249,8000,4751,1,00414,India
580766,2023-12-30,506,monitor,3249,8000,4751,1,00135,India
580766,2023-12-30,501,iphone 15,60000,80000,20000,1,00135,India
580766,2023-12-30,504,iron,449,879,430,1,00135,India
580766,2023-12-30,503,mixer,1349,3249,1900,1,00135,India
580766,2023-12-30,505,oven,18490,24000,5510,1,00135,India
189087,2023-12-30,503,mixer,1349,3249,1900,1,00394,India
527213,2023-12-30,503,mixer,1349,3249,1900,1,00475,India
527213,2023-12-30,507,washing machine,6990,16490,9500,1,00475,India
527213,2023-12-30,506,monitor,3249,8000,4751,1,00475,India
820857,2023-12-30,503,mixer,1349,3249,1900,1,00038,India
820857,2023-12-30,504,iron,449,879,430,1,00038,India
825580,2023-12-30,501,iphone 15,60000,80000,20000,1,00006,India
825580,2023-12-30,505,oven,18490,24000,5510,1,00006,India
825580,2023-12-30,507,washing machine,6990,16490,9500,1,00006,India
825580,2023-12-30,506,monitor,3249,8000,4751,1,00006,India
730402,2023-12-30,506,monitor,3249,8000,4751,1,00164,India
407271,2023-12-30,503,mixer,1349,3249,1900,1,00378,India
887243,2023-12-30,503,mixer,1349,3249,1900,1,00091,India
887243,2023-12-30,504,iron,449,879,430,1,00091,India
887243,2023-12-30,501,iphone 15,60000,80000,20000,1,00091,India
389845,2023-12-30,507,washing machine,6990,16490,9500,1,00207,India
389845,2023-12-30,504,iron,449,879,430,1,00207,India
923504,2023-12-30,507,washing machine,6990,16490,9500,1,00216,India
923504,2023-12-30,501,iphone 15,60000,80000,20000,1,00216,India
298654,2023-12-30,506,monitor,3249,8000,4751,1,00018,India
298654,2023-12-30,507,washing machine,6990,16490,9500,1,00018,India
298654,2023-12-30,501,iphone 15,60000,80000,20000,1,00018,India
123282,2023-12-30,502,iphone 15 pro max,100000,135000,35000,1,00222,India
123282,2023-12-30,503,mixer,1349,3249,1900,1,00222,India
123282,2023-12-30,501,iphone 15,60000,80000,20000,1,00222,India
331732,2023-12-30,502,iphone 15 pro max,100000,135000,35000,1,00272,India
331732,2023-12-30,503,mixer,1349,3249,1900,1,00272,India
331732,2023-12-30,501,iphone 15,60000,80000,20000,1,00272,India
606258,2023-12-30,506,monitor,3249,8000,4751,1,00125,India
606258,2023-12-30,507,washing machine,6990,16490,9500,1,00125,India
606258,2023-12-30,501,iphone 15,60000,80000,20000,1,00125,India
186151,2023-12-30,504,iron,449,879,430,1,00483,India
186151,2023-12-30,506,monitor,3249,8000,4751,1,00483,India
186151,2023-12-30,503,mixer,1349,3249,1900,1,00483,India
618247,2023-12-30,506,monitor,3249,8000,4751,1,00006,India
618247,2023-12-30,503,mixer,1349,3249,1900,1,00006,India
618247,2023-12-30,504,iron,449,879,430,1,00006,India
578658,2023-12-30,502,iphone 15 pro max,100000,135000,35000,1,00159,India
578658,2023-12-30,507,washing machine,6990,16490,9500,1,00159,India
578658,2023-12-30,503,mixer,1349,3249,1900,1,00159,India
578658,2023-12-30,501,iphone 15,60000,80000,20000,1,00159,India
301595,2023-12-30,505,oven,18490,24000,5510,1,00478,India
301595,2023-12-30,504,iron,449,879,430,1,00478,India
301595,2023-12-30,502,iphone 15 pro max,100000,135000,35000,1,00478,India
583357,2023-12-30,504,iron,449,879,430,1,00494,India
725355,2023-12-30,507,washing machine,6990,16490,9500,1,00335,India
725355,2023-12-30,506,monitor,3249,8000,4751,1,00335,India
725355,2023-12-30,502,iphone 15 pro max,100000,135000,35000,1,00335,India
725355,2023-12-30,503,mixer,1349,3249,1900,1,00335,India
963397,2023-12-30,507,washing machine,6990,16490,9500,1,00340,India
963397,2023-12-30,506,monitor,3249,8000,4751,1,00340,India
963397,2023-12-30,505,oven,18490,24000,5510,1,00340,India
773508,2023-12-30,506,monitor,3249,8000,4751,1,00233,India
773508,2023-12-30,502,iphone 15 pro max,100000,135000,35000,1,00233,India
773508,2023-12-30,503,mixer,1349,3249,1900,1,00233,India
398493,2023-12-30,504,iron,449,879,430,1,00034,India
398493,2023-12-30,501,iphone 15,60000,80000,20000,1,00034,India
398493,2023-12-30,505,oven,18490,24000,5510,1,00034,India
593571,2023-12-30,505,oven,18490,24000,5510,1,00429,India
593571,2023-12-30,501,iphone 15,60000,80000,20000,1,00429,India
593571,2023-12-30,504,iron,449,879,430,1,00429,India
165330,2023-12-30,504,iron,449,879,430,1,00480,India
165330,2023-12-30,501,iphone 15,60000,80000,20000,1,00480,India
165330,2023-12-30,505,oven,18490,24000,5510,1,00480,India
621189,2023-12-30,507,washing machine,6990,16490,9500,1,00453,India
205023,2023-12-30,505,oven,18490,24000,5510,1,00261,India
205023,2023-12-30,501,iphone 15,60000,80000,20000,1,00261,India
205023,2023-12-30,502,iphone 15 pro max,100000,135000,35000,1,00261,India
205023,2023-12-30,503,mixer,1349,3249,1900,1,00261,India
341128,2023-12-30,503,mixer,1349,3249,1900,1,00180,India
103724,2023-12-30,506,monitor,3249,8000,4751,1,00360,India
299859,2023-12-31,505,oven,18490,24000,5510,1,00185,India
299859,2023-12-31,502,iphone 15 pro max,100000,135000,35000,1,00185,India
740833,2023-12-31,507,washing machine,6990,16490,9500,1,00331,India
740833,2023-12-31,501,iphone 15,60000,80000,20000,1,00331,India
719055,2023-12-31,502,iphone 15 pro max,100000,135000,35000,1,00180,India
719055,2023-12-31,506,monitor,3249,8000,4751,1,00180,India
719055,2023-12-31,503,mixer,1349,3249,1900,1,00180,India
173028,2023-12-31,507,washing machine,6990,16490,9500,1,00232,India
173028,2023-12-31,502,iphone 15 pro max,100000,135000,35000,1,00232,India
714845,2023-12-31,503,mixer,1349,3249,1900,1,00454,India
714845,2023-12-31,501,iphone 15,60000,80000,20000,1,00454,India
968612,2023-12-31,503,mixer,1349,3249,1900,1,00157,India
968612,2023-12-31,502,iphone 15 pro max,100000,135000,35000,1,00157,India
968612,2023-12-31,504,iron,449,879,430,1,00157,India
968612,2023-12-31,506,monitor,3249,8000,4751,1,00157,India
775069,2023-12-31,501,iphone 15,60000,80000,20000,1,00359,India
775069,2023-12-31,505,oven,18490,24000,5510,1,00359,India
775069,2023-12-31,507,washing machine,6990,16490,9500,1,00359,India
775069,2023-12-31,503,mixer,1349,3249,1900,1,00359,India
925654,2023-12-31,502,iphone 15 pro max,100000,135000,35000,1,00204,India
974934,2023-12-31,504,iron,449,879,430,1,00343,India
974934,2023-12-31,503,mixer,1349,3249,1900,1,00343,India
974934,2023-12-31,501,iphone 15,60000,80000,20000,1,00343,India
432561,2023-12-31,503,mixer,1349,3249,1900,1,00253,India
385598,2023-12-31,506,monitor,3249,8000,4751,1,00315,India
385598,2023-12-31,507,washing machine,6990,16490,9500,1,00315,India
572105,2023-12-31,504,iron,449,879,430,1,00027,India
572105,2023-12-31,505,oven,18490,24000,5510,1,00027,India
572105,2023-12-31,506,monitor,3249,8000,4751,1,00027,India
572105,2023-12-31,507,washing machine,6990,16490,9500,1,00027,India
188221,2023-12-31,502,iphone 15 pro max,100000,135000,35000,1,00050,India
188221,2023-12-31,501,iphone 15,60000,80000,20000,1,00050,India
188221,2023-12-31,503,mixer,1349,3249,1900,1,00050,India
188221,2023-12-31,505,oven,18490,24000,5510,1,00050,India
588325,2023-12-31,507,washing machine,6990,16490,9500,1,00056,India
588325,2023-12-31,506,monitor,3249,8000,4751,1,00056,India
588325,2023-12-31,501,iphone 15,60000,80000,20000,1,00056,India
588325,2023-12-31,504,iron,449,879,430,1,00056,India
952435,2023-12-31,504,iron,449,879,430,1,00208,India
952435,2023-12-31,506,monitor,3249,8000,4751,1,00208,India
952435,2023-12-31,502,iphone 15 pro max,100000,135000,35000,1,00208,India
850527,2023-12-31,502,iphone 15 pro max,100000,135000,35000,1,00288,India
850527,2023-12-31,505,oven,18490,24000,5510,1,00288,India
850527,2023-12-31,503,mixer,1349,3249,1900,1,00288,India
850527,2023-12-31,507,washing machine,6990,16490,9500,1,00288,India
994368,2023-12-31,505,oven,18490,24000,5510,1,00463,India
994368,2023-12-31,501,iphone 15,60000,80000,20000,1,00463,India
994368,2023-12-31,502,iphone 15 pro max,100000,135000,35000,1,00463,India
994368,2023-12-31,506,monitor,3249,8000,4751,1,00463,India
112534,2023-12-31,506,monitor,3249,8000,4751,1,00465,India
250489,2023-12-31,505,oven,18490,24000,5510,1,00480,India
250489,2023-12-31,507,washing machine,6990,16490,9500,1,00480,India
489692,2023-12-31,507,washing machine,6990,16490,9500,1,00032,India
733682,2023-12-31,503,mixer,1349,3249,1900,1,00478,India
733682,2023-12-31,506,monitor,3249,8000,4751,1,00478,India
733682,2023-12-31,501,iphone 15,60000,80000,20000,1,00478,India
733682,2023-12-31,504,iron,449,879,430,1,00478,India
364947,2023-12-31,501,iphone 15,60000,80000,20000,1,00293,India
364947,2023-12-31,504,iron,449,879,430,1,00293,India
364947,2023-12-31,506,monitor,3249,8000,4751,1,00293,India
826401,2023-12-31,506,monitor,3249,8000,4751,1,00072,India
826401,2023-12-31,505,oven,18490,24000,5510,1,00072,India
826401,2023-12-31,507,washing machine,6990,16490,9500,1,00072,India
155470,2023-12-31,505,oven,18490,24000,5510,1,00082,India
155470,2023-12-31,504,iron,449,879,430,1,00082,India
626790,2023-12-31,507,washing machine,6990,16490,9500,1,00119,India
626790,2023-12-31,504,iron,449,879,430,1,00119,India
626790,2023-12-31,501,iphone 15,60000,80000,20000,1,00119,India
626790,2023-12-31,502,iphone 15 pro max,100000,135000,35000,1,00119,India
932853,2023-12-31,505,oven,18490,24000,5510,1,00416,India
932853,2023-12-31,504,iron,449,879,430,1,00416,India
932853,2023-12-31,507,washing machine,6990,16490,9500,1,00416,India
108751,2023-12-31,505,oven,18490,24000,5510,1,00141,India
440700,2023-12-31,501,iphone 15,60000,80000,20000,1,00482,India
440700,2023-12-31,502,iphone 15 pro max,100000,135000,35000,1,00482,India
440700,2023-12-31,507,washing machine,6990,16490,9500,1,00482,India
952516,2023-12-31,504,iron,449,879,430,1,00436,India
952516,2023-12-31,505,oven,18490,24000,5510,1,00436,India
554482,2023-12-31,502,iphone 15 pro max,100000,135000,35000,1,00195,India
554482,2023-12-31,505,oven,18490,24000,5510,1,00195,India
554482,2023-12-31,504,iron,449,879,430,1,00195,India
331063,2023-12-31,505,oven,18490,24000,5510,1,00490,India
331063,2023-12-31,504,iron,449,879,430,1,00490,India
331063,2023-12-31,501,iphone 15,60000,80000,20000,1,00490,India
521854,2023-12-31,502,iphone 15 pro max,100000,135000,35000,1,00191,India
521854,2023-12-31,505,oven,18490,24000,5510,1,00191,India
935385,2023-12-31,504,iron,449,879,430,1,00289,India
935385,2023-12-31,505,oven,18490,24000,5510,1,00289,India
935385,2023-12-31,507,washing machine,6990,16490,9500,1,00289,India
935385,2023-12-31,501,iphone 15,60000,80000,20000,1,00289,India
924714,2023-12-31,503,mixer,1349,3249,1900,1,00049,India
924714,2023-12-31,501,iphone 15,60000,80000,20000,1,00049,India
924714,2023-12-31,504,iron,449,879,430,1,00049,India
689661,2023-12-31,504,iron,449,879,430,1,00148,India
689661,2023-12-31,507,washing machine,6990,16490,9500,1,00148,India
873832,2023-12-31,503,mixer,1349,3249,1900,1,00083,India
873832,2023-12-31,501,iphone 15,60000,80000,20000,1,00083,India
873832,2023-12-31,502,iphone 15 pro max,100000,135000,35000,1,00083,India
873832,2023-12-31,507,washing machine,6990,16490,9500,1,00083,India
155070,2023-12-31,505,oven,18490,24000,5510,1,00446,India
155070,2023-12-31,503,mixer,1349,3249,1900,1,00446,India
250178,2023-12-31,502,iphone 15 pro max,100000,135000,35000,1,00123,India
250178,2023-12-31,501,iphone 15,60000,80000,20000,1,00123,India
250178,2023-12-31,504,iron,449,879,430,1,00123,India
250178,2023-12-31,507,washing machine,6990,16490,9500,1,00123,India
375194,2023-12-31,503,mixer,1349,3249,1900,1,00423,India
375194,2023-12-31,505,oven,18490,24000,5510,1,00423,India
375194,2023-12-31,502,iphone 15 pro max,100000,135000,35000,1,00423,India
850477,2023-12-31,501,iphone 15,60000,80000,20000,1,00152,India
850477,2023-12-31,506,monitor,3249,8000,4751,1,00152,India
850477,2023-12-31,503,mixer,1349,3249,1900,1,00152,India
781004,2023-12-31,503,mixer,1349,3249,1900,1,00458,India
781004,2023-12-31,501,iphone 15,60000,80000,20000,1,00458,India
781004,2023-12-31,506,monitor,3249,8000,4751,1,00458,India
181846,2023-12-31,501,iphone 15,60000,80000,20000,1,00070,India
181846,2023-12-31,507,washing machine,6990,16490,9500,1,00070,India
181846,2023-12-31,504,iron,449,879,430,1,00070,India
181846,2023-12-31,506,monitor,3249,8000,4751,1,00070,India
412141,2023-12-31,506,monitor,3249,8000,4751,1,00038,India
412141,2023-12-31,501,iphone 15,60000,80000,20000,1,00038,India
185389,2023-12-31,501,iphone 15,60000,80000,20000,1,00240,India
185389,2023-12-31,505,oven,18490,24000,5510,1,00240,India
185389,2023-12-31,504,iron,449,879,430,1,00240,India
440843,2023-12-31,506,monitor,3249,8000,4751,1,00439,India
440843,2023-12-31,507,washing machine,6990,16490,9500,1,00439,India
327476,2023-12-31,505,oven,18490,24000,5510,1,00229,India
257796,2023-12-31,504,iron,449,879,430,1,00015,India
257796,2023-12-31,502,iphone 15 pro max,100000,135000,35000,1,00015,India
358212,2023-12-31,505,oven,18490,24000,5510,1,00209,India
358212,2023-12-31,501,iphone 15,60000,80000,20000,1,00209,India
226332,2023-12-31,504,iron,449,879,430,1,00160,India
226332,2023-12-31,501,iphone 15,60000,80000,20000,1,00160,India
226332,2023-12-31,502,iphone 15 pro max,100000,135000,35000,1,00160,India
226332,2023-12-31,505,oven,18490,24000,5510,1,00160,India
558045,2023-12-31,504,iron,449,879,430,1,00251,India
558045,2023-12-31,505,oven,18490,24000,5510,1,00251,India
558045,2023-12-31,502,iphone 15 pro max,100000,135000,35000,1,00251,India
570905,2023-12-31,507,washing machine,6990,16490,9500,1,00312,India
570905,2023-12-31,503,mixer,1349,3249,1900,1,00312,India
619826,2023-12-31,502,iphone 15 pro max,100000,135000,35000,1,00211,India
619826,2023-12-31,506,monitor,3249,8000,4751,1,00211,India
619826,2023-12-31,507,washing machine,6990,16490,9500,1,00211,India
619826,2023-12-31,505,oven,18490,24000,5510,1,00211,India
258434,2023-12-31,503,mixer,1349,3249,1900,1,00009,India
258434,2023-12-31,507,washing machine,6990,16490,9500,1,00009,India
258434,2023-12-31,501,iphone 15,60000,80000,20000,1,00009,India
541536,2023-12-31,501,iphone 15,60000,80000,20000,1,00125,India
541536,2023-12-31,506,monitor,3249,8000,4751,1,00125,India
541536,2023-12-31,507,washing machine,6990,16490,9500,1,00125,India
541536,2023-12-31,503,mixer,1349,3249,1900,1,00125,India
541536,2023-12-31,505,oven,18490,24000,5510,1,00125,India
205892,2023-12-31,504,iron,449,879,430,1,00487,India
540554,2023-12-31,507,washing machine,6990,16490,9500,1,00228,India
540554,2023-12-31,503,mixer,1349,3249,1900,1,00228,India
540554,2023-12-31,506,monitor,3249,8000,4751,1,00228,India
996069,2023-12-31,501,iphone 15,60000,80000,20000,1,00090,India
544125,2023-12-31,503,mixer,1349,3249,1900,1,00423,India
544125,2023-12-31,501,iphone 15,60000,80000,20000,1,00423,India
544125,2023-12-31,504,iron,449,879,430,1,00423,India
689271,2023-12-31,504,iron,449,879,430,1,00029,India
548388,2023-12-31,504,iron,449,879,430,1,00046,India
548388,2023-12-31,502,iphone 15 pro max,100000,135000,35000,1,00046,India
548388,2023-12-31,505,oven,18490,24000,5510,1,00046,India
548388,2023-12-31,503,mixer,1349,3249,1900,1,00046,India
468604,2023-12-31,501,iphone 15,60000,80000,20000,1,00081,India
468604,2023-12-31,502,iphone 15 pro max,100000,135000,35000,1,00081,India
103674,2023-12-31,506,monitor,3249,8000,4751,1,00248,India
103674,2023-12-31,503,mixer,1349,3249,1900,1,00248,India
103674,2023-12-31,505,oven,18490,24000,5510,1,00248,India
103674,2023-12-31,501,iphone 15,60000,80000,20000,1,00248,India
393007,2023-12-31,507,washing machine,6990,16490,9500,1,00067,India
393007,2023-12-31,501,iphone 15,60000,80000,20000,1,00067,India
393007,2023-12-31,505,oven,18490,24000,5510,1,00067,India
963163,2023-12-31,502,iphone 15 pro max,100000,135000,35000,1,00356,India
963163,2023-12-31,503,mixer,1349,3249,1900,1,00356,India
963163,2023-12-31,507,washing machine,6990,16490,9500,1,00356,India
963163,2023-12-31,504,iron,449,879,430,1,00356,India
547315,2023-12-31,502,iphone 15 pro max,100000,135000,35000,1,00229,India
731187,2023-12-31,501,iphone 15,60000,80000,20000,1,00229,India
731187,2023-12-31,502,iphone 15 pro max,100000,135000,35000,1,00229,India
731187,2023-12-31,503,mixer,1349,3249,1900,1,00229,India
750812,2023-12-31,507,washing machine,6990,16490,9500,1,00086,India
750812,2023-12-31,504,iron,449,879,430,1,00086,India
750812,2023-12-31,506,monitor,3249,8000,4751,1,00086,India
794480,2023-12-31,501,iphone 15,60000,80000,20000,1,00339,India
794480,2023-12-31,502,iphone 15 pro max,100000,135000,35000,1,00339,India
794480,2023-12-31,506,monitor,3249,8000,4751,1,00339,India
518420,2023-12-31,504,iron,449,879,430,1,00392,India
518420,2023-12-31,502,iphone 15 pro max,100000,135000,35000,1,00392,India
497626,2023-12-31,507,washing machine,6990,16490,9500,1,00065,India
497626,2023-12-31,502,iphone 15 pro max,100000,135000,35000,1,00065,India
225024,2023-12-31,504,iron,449,879,430,1,00067,India
225024,2023-12-31,507,washing machine,6990,16490,9500,1,00067,India
826577,2023-12-31,501,iphone 15,60000,80000,20000,1,00060,India
826577,2023-12-31,507,washing machine,6990,16490,9500,1,00060,India
826577,2023-12-31,504,iron,449,879,430,1,00060,India
317482,2023-12-31,505,oven,18490,24000,5510,1,00436,India
317482,2023-12-31,506,monitor,3249,8000,4751,1,00436,India
317482,2023-12-31,503,mixer,1349,3249,1900,1,00436,India
336648,2023-12-31,503,mixer,1349,3249,1900,1,00469,India
336648,2023-12-31,502,iphone 15 pro max,100000,135000,35000,1,00469,India
336648,2023-12-31,505,oven,18490,24000,5510,1,00469,India
808772,2023-12-31,507,washing machine,6990,16490,9500,1,00126,India
808772,2023-12-31,503,mixer,1349,3249,1900,1,00126,India
774273,2023-12-31,507,washing machine,6990,16490,9500,1,00002,India
557914,2023-12-31,501,iphone 15,60000,80000,20000,1,00249,India
557914,2023-12-31,504,iron,449,879,430,1,00249,India
774047,2023-12-31,505,oven,18490,24000,5510,1,00352,India
774047,2023-12-31,507,washing machine,6990,16490,9500,1,00352,India
774047,2023-12-31,502,iphone 15 pro max,100000,135000,35000,1,00352,India
808046,2023-12-31,506,monitor,3249,8000,4751,1,00460,India
808046,2023-12-31,504,iron,449,879,430,1,00460,India
402255,2023-12-31,505,oven,18490,24000,5510,1,00088,India
402255,2023-12-31,503,mixer,1349,3249,1900,1,00088,India
402255,2023-12-31,506,monitor,3249,8000,4751,1,00088,India
402255,2023-12-31,504,iron,449,879,430,1,00088,India
351507,2023-12-31,506,monitor,3249,8000,4751,1,00365,India
351507,2023-12-31,505,oven,18490,24000,5510,1,00365,India
351507,2023-12-31,501,iphone 15,60000,80000,20000,1,00365,India
351507,2023-12-31,504,iron,449,879,430,1,00365,India
174112,2023-12-31,502,iphone 15 pro max,100000,135000,35000,1,00295,India
174112,2023-12-31,504,iron,449,879,430,1,00295,India
415834,2023-12-31,503,mixer,1349,3249,1900,1,00124,India
258396,2024-01-01,504,iron,449,879,430,1,00414,India
258396,2024-01-01,507,washing machine,6990,16490,9500,1,00414,India
258396,2024-01-01,506,monitor,3249,8000,4751,1,00414,India
892903,2024-01-01,503,mixer,1349,3249,1900,1,00473,India
892903,2024-01-01,501,iphone 15,60000,80000,20000,1,00473,India
892903,2024-01-01,505,oven,18490,24000,5510,1,00473,India
892903,2024-01-01,502,iphone 15 pro max,100000,135000,35000,1,00473,India
629986,2024-01-01,503,mixer,1349,3249,1900,1,00187,India
629986,2024-01-01,502,iphone 15 pro max,100000,135000,35000,1,00187,India
629986,2024-01-01,501,iphone 15,60000,80000,20000,1,00187,India
103206,2024-01-01,506,monitor,3249,8000,4751,1,00127,India
103206,2024-01-01,505,oven,18490,24000,5510,1,00127,India
103206,2024-01-01,503,mixer,1349,3249,1900,1,00127,India
103206,2024-01-01,502,iphone 15 pro max,100000,135000,35000,1,00127,India
434060,2024-01-01,501,iphone 15,60000,80000,20000,1,00258,India
434060,2024-01-01,506,monitor,3249,8000,4751,1,00258,India
434060,2024-01-01,502,iphone 15 pro max,100000,135000,35000,1,00258,India
982297,2024-01-01,507,washing machine,6990,16490,9500,1,00177,India
982297,2024-01-01,503,mixer,1349,3249,1900,1,00177,India
982297,2024-01-01,502,iphone 15 pro max,100000,135000,35000,1,00177,India
982297,2024-01-01,506,monitor,3249,8000,4751,1,00177,India
982297,2024-01-01,501,iphone 15,60000,80000,20000,1,00177,India
827101,2024-01-01,501,iphone 15,60000,80000,20000,1,00049,India
827101,2024-01-01,502,iphone 15 pro max,100000,135000,35000,1,00049,India
440280,2024-01-01,507,washing machine,6990,16490,9500,1,00052,India
440280,2024-01-01,506,monitor,3249,8000,4751,1,00052,India
440280,2024-01-01,503,mixer,1349,3249,1900,1,00052,India
716863,2024-01-01,502,iphone 15 pro max,100000,135000,35000,1,00367,India
716863,2024-01-01,503,mixer,1349,3249,1900,1,00367,India
716863,2024-01-01,506,monitor,3249,8000,4751,1,00367,India
716863,2024-01-01,504,iron,449,879,430,1,00367,India
819354,2024-01-01,503,mixer,1349,3249,1900,1,00485,India
819354,2024-01-01,504,iron,449,879,430,1,00485,India
819354,2024-01-01,505,oven,18490,24000,5510,1,00485,India
819354,2024-01-01,507,washing machine,6990,16490,9500,1,00485,India
146737,2024-01-01,507,washing machine,6990,16490,9500,1,00179,India
146737,2024-01-01,504,iron,449,879,430,1,00179,India
146737,2024-01-01,506,monitor,3249,8000,4751,1,00179,India
146737,2024-01-01,502,iphone 15 pro max,100000,135000,35000,1,00179,India
580791,2024-01-01,506,monitor,3249,8000,4751,1,00145,India
580791,2024-01-01,503,mixer,1349,3249,1900,1,00145,India
580791,2024-01-01,505,oven,18490,24000,5510,1,00145,India
865934,2024-01-01,506,monitor,3249,8000,4751,1,00433,India
865934,2024-01-01,502,iphone 15 pro max,100000,135000,35000,1,00433,India
865934,2024-01-01,505,oven,18490,24000,5510,1,00433,India
844814,2024-01-01,506,monitor,3249,8000,4751,1,00295,India
917862,2024-01-01,503,mixer,1349,3249,1900,1,00300,India
927884,2024-01-01,502,iphone 15 pro max,100000,135000,35000,1,00353,India
850084,2024-01-01,502,iphone 15 pro max,100000,135000,35000,1,00446,India
850084,2024-01-01,504,iron,449,879,430,1,00446,India
616778,2024-01-01,503,mixer,1349,3249,1900,1,00200,India
616778,2024-01-01,501,iphone 15,60000,80000,20000,1,00200,India
616778,2024-01-01,506,monitor,3249,8000,4751,1,00200,India
616778,2024-01-01,504,iron,449,879,430,1,00200,India
803913,2024-01-01,503,mixer,1349,3249,1900,1,00402,India
803913,2024-01-01,506,monitor,3249,8000,4751,1,00402,India
803913,2024-01-01,501,iphone 15,60000,80000,20000,1,00402,India
803913,2024-01-01,507,washing machine,6990,16490,9500,1,00402,India
803913,2024-01-01,502,iphone 15 pro max,100000,135000,35000,1,00402,India
413778,2024-01-01,506,monitor,3249,8000,4751,1,00087,India
413778,2024-01-01,505,oven,18490,24000,5510,1,00087,India
413778,2024-01-01,503,mixer,1349,3249,1900,1,00087,India
715548,2024-01-01,503,mixer,1349,3249,1900,1,00011,India
715548,2024-01-01,504,iron,449,879,430,1,00011,India
715548,2024-01-01,502,iphone 15 pro max,100000,135000,35000,1,00011,India
189332,2024-01-01,504,iron,449,879,430,1,00262,India
189332,2024-01-01,501,iphone 15,60000,80000,20000,1,00262,India
189332,2024-01-01,502,iphone 15 pro max,100000,135000,35000,1,00262,India
825674,2024-01-01,504,iron,449,879,430,1,00100,India
825674,2024-01-01,502,iphone 15 pro max,100000,135000,35000,1,00100,India
472694,2024-01-01,507,washing machine,6990,16490,9500,1,00164,India
472694,2024-01-01,501,iphone 15,60000,80000,20000,1,00164,India
868743,2024-01-01,506,monitor,3249,8000,4751,1,00497,India
868743,2024-01-01,503,mixer,1349,3249,1900,1,00497,India
868743,2024-01-01,507,washing machine,6990,16490,9500,1,00497,India
868743,2024-01-01,501,iphone 15,60000,80000,20000,1,00497,India
604460,2024-01-01,504,iron,449,879,430,1,00320,India
604460,2024-01-01,503,mixer,1349,3249,1900,1,00320,India
604460,2024-01-01,502,iphone 15 pro max,100000,135000,35000,1,00320,India
319839,2024-01-01,504,iron,449,879,430,1,00340,India
319839,2024-01-01,503,mixer,1349,3249,1900,1,00340,India
340969,2024-01-01,505,oven,18490,24000,5510,1,00197,India
340969,2024-01-01,503,mixer,1349,3249,1900,1,00197,India
340969,2024-01-01,501,iphone 15,60000,80000,20000,1,00197,India
340969,2024-01-01,507,washing machine,6990,16490,9500,1,00197,India
974345,2024-01-01,505,oven,18490,24000,5510,1,00485,India
974345,2024-01-01,501,iphone 15,60000,80000,20000,1,00485,India
424781,2024-01-01,506,monitor,3249,8000,4751,1,00068,India
424781,2024-01-01,503,mixer,1349,3249,1900,1,00068,India
610048,2024-01-01,504,iron,449,879,430,1,00164,India
610048,2024-01-01,506,monitor,3249,8000,4751,1,00164,India
610048,2024-01-01,505,oven,18490,24000,5510,1,00164,India
610048,2024-01-01,503,mixer,1349,3249,1900,1,00164,India
729910,2024-01-01,503,mixer,1349,3249,1900,1,00466,India
818018,2024-01-01,507,washing machine,6990,16490,9500,1,00427,India
818018,2024-01-01,501,iphone 15,60000,80000,20000,1,00427,India
818018,2024-01-01,502,iphone 15 pro max,100000,135000,35000,1,00427,India
818018,2024-01-01,504,iron,449,879,430,1,00427,India
156402,2024-01-01,505,oven,18490,24000,5510,1,00329,India
991405,2024-01-01,502,iphone 15 pro max,100000,135000,35000,1,00427,India
651148,2024-01-01,506,monitor,3249,8000,4751,1,00009,India
651148,2024-01-01,507,washing machine,6990,16490,9500,1,00009,India
651148,2024-01-01,504,iron,449,879,430,1,00009,India
651148,2024-01-01,502,iphone 15 pro max,100000,135000,35000,1,00009,India
512441,2024-01-01,506,monitor,3249,8000,4751,1,00490,India
145459,2024-01-01,501,iphone 15,60000,80000,20000,1,00171,India
145459,2024-01-01,506,monitor,3249,8000,4751,1,00171,India
145459,2024-01-01,507,washing machine,6990,16490,9500,1,00171,India
336714,2024-01-01,501,iphone 15,60000,80000,20000,1,00072,India
336714,2024-01-01,502,iphone 15 pro max,100000,135000,35000,1,00072,India
336714,2024-01-01,506,monitor,3249,8000,4751,1,00072,India
336714,2024-01-01,507,washing machine,6990,16490,9500,1,00072,India
146750,2024-01-01,503,mixer,1349,3249,1900,1,00183,India
509082,2024-01-01,503,mixer,1349,3249,1900,1,00317,India
769657,2024-01-01,503,mixer,1349,3249,1900,1,00446,India
866810,2024-01-01,502,iphone 15 pro max,100000,135000,35000,1,00046,India
866810,2024-01-01,503,mixer,1349,3249,1900,1,00046,India
302669,2024-01-01,503,mixer,1349,3249,1900,1,00195,India
302669,2024-01-01,506,monitor,3249,8000,4751,1,00195,India
302669,2024-01-01,502,iphone 15 pro max,100000,135000,35000,1,00195,India
741325,2024-01-01,501,iphone 15,60000,80000,20000,1,00159,India
741325,2024-01-01,502,iphone 15 pro max,100000,135000,35000,1,00159,India
741325,2024-01-01,507,washing machine,6990,16490,9500,1,00159,India
741325,2024-01-01,506,monitor,3249,8000,4751,1,00159,India
639158,2024-01-01,502,iphone 15 pro max,100000,135000,35000,1,00259,India
639158,2024-01-01,507,washing machine,6990,16490,9500,1,00259,India
639158,2024-01-01,505,oven,18490,24000,5510,1,00259,India
639158,2024-01-01,506,monitor,3249,8000,4751,1,00259,India
324985,2024-01-01,503,mixer,1349,3249,1900,1,00065,India
324985,2024-01-01,505,oven,18490,24000,5510,1,00065,India
994068,2024-01-01,503,mixer,1349,3249,1900,1,00240,India
994068,2024-01-01,506,monitor,3249,8000,4751,1,00240,India
994068,2024-01-01,502,iphone 15 pro max,100000,135000,35000,1,00240,India
128460,2024-01-01,505,oven,18490,24000,5510,1,00202,India
736766,2024-01-01,504,iron,449,879,430,1,00335,India
736766,2024-01-01,501,iphone 15,60000,80000,20000,1,00335,India
736766,2024-01-01,505,oven,18490,24000,5510,1,00335,India
736766,2024-01-01,506,monitor,3249,8000,4751,1,00335,India
138230,2024-01-01,501,iphone 15,60000,80000,20000,1,00084,India
138230,2024-01-01,505,oven,18490,24000,5510,1,00084,India
143949,2024-01-01,503,mixer,1349,3249,1900,1,00205,India
652790,2024-01-01,506,monitor,3249,8000,4751,1,00459,India
652790,2024-01-01,501,iphone 15,60000,80000,20000,1,00459,India
652790,2024-01-01,504,iron,449,879,430,1,00459,India
728733,2024-01-01,507,washing machine,6990,16490,9500,1,00124,India
728733,2024-01-01,502,iphone 15 pro max,100000,135000,35000,1,00124,India
728733,2024-01-01,506,monitor,3249,8000,4751,1,00124,India
197172,2024-01-01,501,iphone 15,60000,80000,20000,1,00325,India
197172,2024-01-01,503,mixer,1349,3249,1900,1,00325,India
197172,2024-01-01,504,iron,449,879,430,1,00325,India
353193,2024-01-01,502,iphone 15 pro max,100000,135000,35000,1,00023,India
353193,2024-01-01,503,mixer,1349,3249,1900,1,00023,India
353193,2024-01-01,506,monitor,3249,8000,4751,1,00023,India
516111,2024-01-01,507,washing machine,6990,16490,9500,1,00346,India
516111,2024-01-01,506,monitor,3249,8000,4751,1,00346,India
516111,2024-01-01,504,iron,449,879,430,1,00346,India
382777,2024-01-01,504,iron,449,879,430,1,00093,India
224104,2024-01-01,506,monitor,3249,8000,4751,1,00409,India
224104,2024-01-01,507,washing machine,6990,16490,9500,1,00409,India
224104,2024-01-01,501,iphone 15,60000,80000,20000,1,00409,India
224104,2024-01-01,504,iron,449,879,430,1,00409,India
224104,2024-01-01,503,mixer,1349,3249,1900,1,00409,India
711931,2024-01-01,507,washing machine,6990,16490,9500,1,00487,India
711931,2024-01-01,503,mixer,1349,3249,1900,1,00487,India
911235,2024-01-01,502,iphone 15 pro max,100000,135000,35000,1,00192,India
911235,2024-01-01,505,oven,18490,24000,5510,1,00192,India
873915,2024-01-01,501,iphone 15,60000,80000,20000,1,00475,India
873915,2024-01-01,506,monitor,3249,8000,4751,1,00475,India
873915,2024-01-01,505,oven,18490,24000,5510,1,00475,India
873915,2024-01-01,507,washing machine,6990,16490,9500,1,00475,India
632721,2024-01-01,501,iphone 15,60000,80000,20000,1,00436,India
632721,2024-01-01,505,oven,18490,24000,5510,1,00436,India
550682,2024-01-01,502,iphone 15 pro max,100000,135000,35000,1,00344,India
550682,2024-01-01,505,oven,18490,24000,5510,1,00344,India
803877,2024-01-01,507,washing machine,6990,16490,9500,1,00218,India
803877,2024-01-01,506,monitor,3249,8000,4751,1,00218,India
934278,2024-01-01,506,monitor,3249,8000,4751,1,00241,India
934278,2024-01-01,505,oven,18490,24000,5510,1,00241,India
890700,2024-01-01,504,iron,449,879,430,1,00487,India
890700,2024-01-01,502,iphone 15 pro max,100000,135000,35000,1,00487,India
225907,2024-01-01,504,iron,449,879,430,1,00046,India
225907,2024-01-01,505,oven,18490,24000,5510,1,00046,India
225907,2024-01-01,506,monitor,3249,8000,4751,1,00046,India
225907,2024-01-01,502,iphone 15 pro max,100000,135000,35000,1,00046,India
862918,2024-01-01,504,iron,449,879,430,1,00125,India
862918,2024-01-01,501,iphone 15,60000,80000,20000,1,00125,India
279007,2024-01-01,501,iphone 15,60000,80000,20000,1,00220,India
286428,2024-01-01,506,monitor,3249,8000,4751,1,00321,India
286428,2024-01-01,501,iphone 15,60000,80000,20000,1,00321,India
286428,2024-01-01,507,washing machine,6990,16490,9500,1,00321,India
299687,2024-01-01,503,mixer,1349,3249,1900,1,00147,India
299687,2024-01-01,505,oven,18490,24000,5510,1,00147,India
299687,2024-01-01,507,washing machine,6990,16490,9500,1,00147,India
668073,2024-01-01,505,oven,18490,24000,5510,1,00222,India
668073,2024-01-01,503,mixer,1349,3249,1900,1,00222,India
668073,2024-01-01,501,iphone 15,60000,80000,20000,1,00222,India
473795,2024-01-01,507,washing machine,6990,16490,9500,1,00232,India
473795,2024-01-01,501,iphone 15,60000,80000,20000,1,00232,India
473795,2024-01-01,506,monitor,3249,8000,4751,1,00232,India
873003,2024-01-01,506,monitor,3249,8000,4751,1,00092,India
873003,2024-01-01,507,washing machine,6990,16490,9500,1,00092,India
873003,2024-01-01,502,iphone 15 pro max,100000,135000,35000,1,00092,India
873003,2024-01-01,503,mixer,1349,3249,1900,1,00092,India
776599,2024-01-02,505,oven,18490,24000,5510,1,00208,India
776599,2024-01-02,501,iphone 15,60000,80000,20000,1,00208,India
145307,2024-01-02,504,iron,449,879,430,1,00493,India
145307,2024-01-02,506,monitor,3249,8000,4751,1,00493,India
286771,2024-01-02,501,iphone 15,60000,80000,20000,1,00236,India
413056,2024-01-02,504,iron,449,879,430,1,00372,India
413056,2024-01-02,502,iphone 15 pro max,100000,135000,35000,1,00372,India
413056,2024-01-02,506,monitor,3249,8000,4751,1,00372,India
413056,2024-01-02,505,oven,18490,24000,5510,1,00372,India
587349,2024-01-02,507,washing machine,6990,16490,9500,1,00472,India
587349,2024-01-02,506,monitor,3249,8000,4751,1,00472,India
879226,2024-01-02,505,oven,18490,24000,5510,1,00350,India
879226,2024-01-02,507,washing machine,6990,16490,9500,1,00350,India
465220,2024-01-02,504,iron,449,879,430,1,00469,India
809583,2024-01-02,501,iphone 15,60000,80000,20000,1,00243,India
809583,2024-01-02,505,oven,18490,24000,5510,1,00243,India
809583,2024-01-02,507,washing machine,6990,16490,9500,1,00243,India
538930,2024-01-02,501,iphone 15,60000,80000,20000,1,00190,India
185454,2024-01-02,504,iron,449,879,430,1,00180,India
185454,2024-01-02,502,iphone 15 pro max,100000,135000,35000,1,00180,India
934338,2024-01-02,505,oven,18490,24000,5510,1,00464,India
577988,2024-01-02,504,iron,449,879,430,1,00061,India
628391,2024-01-02,507,washing machine,6990,16490,9500,1,00228,India
628391,2024-01-02,504,iron,449,879,430,1,00228,India
628391,2024-01-02,506,monitor,3249,8000,4751,1,00228,India
328479,2024-01-02,507,washing machine,6990,16490,9500,1,00106,India
328479,2024-01-02,506,monitor,3249,8000,4751,1,00106,India
699568,2024-01-02,506,monitor,3249,8000,4751,1,00230,India
722920,2024-01-02,501,iphone 15,60000,80000,20000,1,00134,India
722920,2024-01-02,502,iphone 15 pro max,100000,135000,35000,1,00134,India
722920,2024-01-02,503,mixer,1349,3249,1900,1,00134,India
139375,2024-01-02,506,monitor,3249,8000,4751,1,00413,India
139375,2024-01-02,502,iphone 15 pro max,100000,135000,35000,1,00413,India
139375,2024-01-02,505,oven,18490,24000,5510,1,00413,India
139375,2024-01-02,501,iphone 15,60000,80000,20000,1,00413,India
139375,2024-01-02,504,iron,449,879,430,1,00413,India
927645,2024-01-02,504,iron,449,879,430,1,00418,India
922077,2024-01-02,507,washing machine,6990,16490,9500,1,00339,India
922077,2024-01-02,502,iphone 15 pro max,100000,135000,35000,1,00339,India
922077,2024-01-02,505,oven,18490,24000,5510,1,00339,India
719568,2024-01-02,503,mixer,1349,3249,1900,1,00130,India
719568,2024-01-02,504,iron,449,879,430,1,00130,India
719568,2024-01-02,506,monitor,3249,8000,4751,1,00130,India
719568,2024-01-02,505,oven,18490,24000,5510,1,00130,India
472850,2024-01-02,502,iphone 15 pro max,100000,135000,35000,1,00150,India
472850,2024-01-02,507,washing machine,6990,16490,9500,1,00150,India
472850,2024-01-02,501,iphone 15,60000,80000,20000,1,00150,India
472850,2024-01-02,505,oven,18490,24000,5510,1,00150,India
472850,2024-01-02,503,mixer,1349,3249,1900,1,00150,India
463216,2024-01-02,503,mixer,1349,3249,1900,1,00307,India
463216,2024-01-02,502,iphone 15 pro max,100000,135000,35000,1,00307,India
624604,2024-01-02,507,washing machine,6990,16490,9500,1,00143,India
416093,2024-01-02,502,iphone 15 pro max,100000,135000,35000,1,00059,India
416093,2024-01-02,501,iphone 15,60000,80000,20000,1,00059,India
416093,2024-01-02,507,washing machine,6990,16490,9500,1,00059,India
159949,2024-01-02,507,washing machine,6990,16490,9500,1,00094,India
159949,2024-01-02,503,mixer,1349,3249,1900,1,00094,India
558100,2024-01-02,503,mixer,1349,3249,1900,1,00049,India
558100,2024-01-02,506,monitor,3249,8000,4751,1,00049,India
558100,2024-01-02,504,iron,449,879,430,1,00049,India
693486,2024-01-02,506,monitor,3249,8000,4751,1,00363,India
693486,2024-01-02,502,iphone 15 pro max,100000,135000,35000,1,00363,India
824141,2024-01-02,503,mixer,1349,3249,1900,1,00087,India
824141,2024-01-02,504,iron,449,879,430,1,00087,India
486092,2024-01-02,503,mixer,1349,3249,1900,1,00190,India
486092,2024-01-02,507,washing machine,6990,16490,9500,1,00190,India
360990,2024-01-02,505,oven,18490,24000,5510,1,00144,India
360990,2024-01-02,506,monitor,3249,8000,4751,1,00144,India
454062,2024-01-02,507,washing machine,6990,16490,9500,1,00448,India
454062,2024-01-02,502,iphone 15 pro max,100000,135000,35000,1,00448,India
454062,2024-01-02,506,monitor,3249,8000,4751,1,00448,India
546734,2024-01-02,504,iron,449,879,430,1,00276,India
546734,2024-01-02,507,washing machine,6990,16490,9500,1,00276,India
546734,2024-01-02,501,iphone 15,60000,80000,20000,1,00276,India
462194,2024-01-02,502,iphone 15 pro max,100000,135000,35000,1,00333,India
462194,2024-01-02,503,mixer,1349,3249,1900,1,00333,India
462194,2024-01-02,506,monitor,3249,8000,4751,1,00333,India
462194,2024-01-02,501,iphone 15,60000,80000,20000,1,00333,India
861154,2024-01-02,505,oven,18490,24000,5510,1,00217,India
861154,2024-01-02,506,monitor,3249,8000,4751,1,00217,India
896194,2024-01-02,505,oven,18490,24000,5510,1,00195,India
896194,2024-01-02,506,monitor,3249,8000,4751,1,00195,India
896194,2024-01-02,507,washing machine,6990,16490,9500,1,00195,India
820669,2024-01-02,504,iron,449,879,430,1,00060,India
221741,2024-01-02,503,mixer,1349,3249,1900,1,00284,India
221741,2024-01-02,501,iphone 15,60000,80000,20000,1,00284,India
221741,2024-01-02,505,oven,18490,24000,5510,1,00284,India
221741,2024-01-02,506,monitor,3249,8000,4751,1,00284,India
185467,2024-01-02,507,washing machine,6990,16490,9500,1,00223,India
185467,2024-01-02,501,iphone 15,60000,80000,20000,1,00223,India
291867,2024-01-02,507,washing machine,6990,16490,9500,1,00178,India
707718,2024-01-02,502,iphone 15 pro max,100000,135000,35000,1,00289,India
707718,2024-01-02,505,oven,18490,24000,5510,1,00289,India
707718,2024-01-02,504,iron,449,879,430,1,00289,India
707718,2024-01-02,501,iphone 15,60000,80000,20000,1,00289,India
729300,2024-01-02,504,iron,449,879,430,1,00156,India
729300,2024-01-02,503,mixer,1349,3249,1900,1,00156,India
729300,2024-01-02,502,iphone 15 pro max,100000,135000,35000,1,00156,India
106065,2024-01-02,503,mixer,1349,3249,1900,1,00023,India
106065,2024-01-02,506,monitor,3249,8000,4751,1,00023,India
430728,2024-01-02,502,iphone 15 pro max,100000,135000,35000,1,00115,India
984645,2024-01-02,502,iphone 15 pro max,100000,135000,35000,1,00450,India
984645,2024-01-02,501,iphone 15,60000,80000,20000,1,00450,India
984645,2024-01-02,504,iron,449,879,430,1,00450,India
399152,2024-01-02,502,iphone 15 pro max,100000,135000,35000,1,00434,India
399152,2024-01-02,505,oven,18490,24000,5510,1,00434,India
399152,2024-01-02,503,mixer,1349,3249,1900,1,00434,India
260813,2024-01-02,504,iron,449,879,430,1,00029,India
260813,2024-01-02,505,oven,18490,24000,5510,1,00029,India
260813,2024-01-02,503,mixer,1349,3249,1900,1,00029,India
984841,2024-01-02,502,iphone 15 pro max,100000,135000,35000,1,00305,India
984841,2024-01-02,506,monitor,3249,8000,4751,1,00305,India
984841,2024-01-02,501,iphone 15,60000,80000,20000,1,00305,India
984841,2024-01-02,504,iron,449,879,430,1,00305,India
778737,2024-01-02,504,iron,449,879,430,1,00216,India
778737,2024-01-02,506,monitor,3249,8000,4751,1,00216,India
778737,2024-01-02,502,iphone 15 pro max,100000,135000,35000,1,00216,India
551073,2024-01-02,502,iphone 15 pro max,100000,135000,35000,1,00179,India
551073,2024-01-02,504,iron,449,879,430,1,00179,India
925460,2024-01-02,506,monitor,3249,8000,4751,1,00121,India
269628,2024-01-02,503,mixer,1349,3249,1900,1,00138,India
108083,2024-01-02,507,washing machine,6990,16490,9500,1,00378,India
108083,2024-01-02,501,iphone 15,60000,80000,20000,1,00378,India
108083,2024-01-02,506,monitor,3249,8000,4751,1,00378,India
108083,2024-01-02,502,iphone 15 pro max,100000,135000,35000,1,00378,India
998223,2024-01-02,502,iphone 15 pro max,100000,135000,35000,1,00218,India
998223,2024-01-02,501,iphone 15,60000,80000,20000,1,00218,India
954773,2024-01-02,502,iphone 15 pro max,100000,135000,35000,1,00362,India
618591,2024-01-02,505,oven,18490,24000,5510,1,00344,India
618591,2024-01-02,503,mixer,1349,3249,1900,1,00344,India
898107,2024-01-02,506,monitor,3249,8000,4751,1,00205,India
898107,2024-01-02,505,oven,18490,24000,5510,1,00205,India
898107,2024-01-02,507,washing machine,6990,16490,9500,1,00205,India
898107,2024-01-02,504,iron,449,879,430,1,00205,India
764775,2024-01-02,502,iphone 15 pro max,100000,135000,35000,1,00283,India
764775,2024-01-02,505,oven,18490,24000,5510,1,00283,India
628343,2024-01-02,507,washing machine,6990,16490,9500,1,00006,India
628343,2024-01-02,506,monitor,3249,8000,4751,1,00006,India
995013,2024-01-02,505,oven,18490,24000,5510,1,00161,India
995013,2024-01-02,504,iron,449,879,430,1,00161,India
995013,2024-01-02,503,mixer,1349,3249,1900,1,00161,India
995013,2024-01-02,502,iphone 15 pro max,100000,135000,35000,1,00161,India
726477,2024-01-02,501,iphone 15,60000,80000,20000,1,00356,India
726477,2024-01-02,502,iphone 15 pro max,100000,135000,35000,1,00356,India
366679,2024-01-02,506,monitor,3249,8000,4751,1,00470,India
366679,2024-01-02,502,iphone 15 pro max,100000,135000,35000,1,00470,India
366679,2024-01-02,507,washing machine,6990,16490,9500,1,00470,India
366679,2024-01-02,505,oven,18490,24000,5510,1,00470,India
877984,2024-01-02,501,iphone 15,60000,80000,20000,1,00243,India
877984,2024-01-02,507,washing machine,6990,16490,9500,1,00243,India
877984,2024-01-02,502,iphone 15 pro max,100000,135000,35000,1,00243,India
195977,2024-01-02,503,mixer,1349,3249,1900,1,00344,India
195977,2024-01-02,505,oven,18490,24000,5510,1,00344,India
353517,2024-01-02,503,mixer,1349,3249,1900,1,00366,India
353517,2024-01-02,507,washing machine,6990,16490,9500,1,00366,India
751251,2024-01-02,502,iphone 15 pro max,100000,135000,35000,1,00371,India
751251,2024-01-02,503,mixer,1349,3249,1900,1,00371,India
821629,2024-01-02,506,monitor,3249,8000,4751,1,00311,India
821629,2024-01-02,504,iron,449,879,430,1,00311,India
625289,2024-01-02,506,monitor,3249,8000,4751,1,00109,India
424621,2024-01-02,507,washing machine,6990,16490,9500,1,00446,India
701371,2024-01-02,504,iron,449,879,430,1,00200,India
701371,2024-01-02,503,mixer,1349,3249,1900,1,00200,India
701371,2024-01-02,506,monitor,3249,8000,4751,1,00200,India
701371,2024-01-02,507,washing machine,6990,16490,9500,1,00200,India
701371,2024-01-02,501,iphone 15,60000,80000,20000,1,00200,India
657367,2024-01-02,505,oven,18490,24000,5510,1,00223,India
657367,2024-01-02,501,iphone 15,60000,80000,20000,1,00223,India
458191,2024-01-02,507,washing machine,6990,16490,9500,1,00208,India
458191,2024-01-02,503,mixer,1349,3249,1900,1,00208,India
745824,2024-01-02,503,mixer,1349,3249,1900,1,00424,India
745824,2024-01-02,504,iron,449,879,430,1,00424,India
745824,2024-01-02,501,iphone 15,60000,80000,20000,1,00424,India
745824,2024-01-02,505,oven,18490,24000,5510,1,00424,India
232997,2024-01-02,507,washing machine,6990,16490,9500,1,00430,India
232997,2024-01-02,503,mixer,1349,3249,1900,1,00430,India
555278,2024-01-02,501,iphone 15,60000,80000,20000,1,00163,India
103405,2024-01-02,505,oven,18490,24000,5510,1,00262,India
103405,2024-01-02,501,iphone 15,60000,80000,20000,1,00262,India
103405,2024-01-02,504,iron,449,879,430,1,00262,India
103405,2024-01-02,507,washing machine,6990,16490,9500,1,00262,India
362811,2024-01-02,503,mixer,1349,3249,1900,1,00034,India
362811,2024-01-02,502,iphone 15 pro max,100000,135000,35000,1,00034,India
362811,2024-01-02,507,washing machine,6990,16490,9500,1,00034,India
362811,2024-01-02,506,monitor,3249,8000,4751,1,00034,India
910456,2024-01-02,503,mixer,1349,3249,1900,1,00472,India
606016,2024-01-02,504,iron,449,879,430,1,00181,India
606016,2024-01-02,501,iphone 15,60000,80000,20000,1,00181,India
606016,2024-01-02,507,washing machine,6990,16490,9500,1,00181,India
692941,2024-01-02,504,iron,449,879,430,1,00248,India
692941,2024-01-02,507,washing machine,6990,16490,9500,1,00248,India
692941,2024-01-02,502,iphone 15 pro max,100000,135000,35000,1,00248,India
379990,2024-01-02,507,washing machine,6990,16490,9500,1,00243,India
379990,2024-01-02,503,mixer,1349,3249,1900,1,00243,India
379990,2024-01-02,502,iphone 15 pro max,100000,135000,35000,1,00243,India
379990,2024-01-02,504,iron,449,879,430,1,00243,India
379990,2024-01-02,506,monitor,3249,8000,4751,1,00243,India
697563,2024-01-02,502,iphone 15 pro max,100000,135000,35000,1,00370,India
407622,2024-01-02,502,iphone 15 pro max,100000,135000,35000,1,00220,India
407622,2024-01-02,504,iron,449,879,430,1,00220,India
407622,2024-01-02,507,washing machine,6990,16490,9500,1,00220,India
407622,2024-01-02,506,monitor,3249,8000,4751,1,00220,India
384844,2024-01-02,502,iphone 15 pro max,100000,135000,35000,1,00273,India
384844,2024-01-02,507,washing machine,6990,16490,9500,1,00273,India
384844,2024-01-02,504,iron,449,879,430,1,00273,India
384844,2024-01-02,505,oven,18490,24000,5510,1,00273,India
384844,2024-01-02,506,monitor,3249,8000,4751,1,00273,India
534014,2024-01-03,506,monitor,3249,8000,4751,1,00055,India
534014,2024-01-03,501,iphone 15,60000,80000,20000,1,00055,India
149932,2024-01-03,505,oven,18490,24000,5510,1,00091,India
473228,2024-01-03,502,iphone 15 pro max,100000,135000,35000,1,00455,India
473228,2024-01-03,504,iron,449,879,430,1,00455,India
365413,2024-01-03,506,monitor,3249,8000,4751,1,00120,India
365413,2024-01-03,501,iphone 15,60000,80000,20000,1,00120,India
365413,2024-01-03,503,mixer,1349,3249,1900,1,00120,India
365413,2024-01-03,502,iphone 15 pro max,100000,135000,35000,1,00120,India
283546,2024-01-03,507,washing machine,6990,16490,9500,1,00188,India
283546,2024-01-03,505,oven,18490,24000,5510,1,00188,India
133715,2024-01-03,502,iphone 15 pro max,100000,135000,35000,1,00464,India
133715,2024-01-03,501,iphone 15,60000,80000,20000,1,00464,India
133715,2024-01-03,505,oven,18490,24000,5510,1,00464,India
963424,2024-01-03,503,mixer,1349,3249,1900,1,00062,India
963424,2024-01-03,507,washing machine,6990,16490,9500,1,00062,India
963424,2024-01-03,505,oven,18490,24000,5510,1,00062,India
963424,2024-01-03,506,monitor,3249,8000,4751,1,00062,India
199479,2024-01-03,504,iron,449,879,430,1,00204,India
199479,2024-01-03,503,mixer,1349,3249,1900,1,00204,India
185279,2024-01-03,502,iphone 15 pro max,100000,135000,35000,1,00191,India
576435,2024-01-03,507,washing machine,6990,16490,9500,1,00020,India
576435,2024-01-03,502,iphone 15 pro max,100000,135000,35000,1,00020,India
576435,2024-01-03,501,iphone 15,60000,80000,20000,1,00020,India
576435,2024-01-03,506,monitor,3249,8000,4751,1,00020,India
757327,2024-01-03,507,washing machine,6990,16490,9500,1,00417,India
757327,2024-01-03,506,monitor,3249,8000,4751,1,00417,India
757327,2024-01-03,505,oven,18490,24000,5510,1,00417,India
586343,2024-01-03,507,washing machine,6990,16490,9500,1,00415,India
586343,2024-01-03,503,mixer,1349,3249,1900,1,00415,India
586343,2024-01-03,506,monitor,3249,8000,4751,1,00415,India
586343,2024-01-03,502,iphone 15 pro max,100000,135000,35000,1,00415,India
802483,2024-01-03,505,oven,18490,24000,5510,1,00283,India
802483,2024-01-03,503,mixer,1349,3249,1900,1,00283,India
979246,2024-01-03,503,mixer,1349,3249,1900,1,00333,India
979246,2024-01-03,504,iron,449,879,430,1,00333,India
575188,2024-01-03,503,mixer,1349,3249,1900,1,00236,India
836855,2024-01-03,507,washing machine,6990,16490,9500,1,00210,India
836855,2024-01-03,505,oven,18490,24000,5510,1,00210,India
836855,2024-01-03,506,monitor,3249,8000,4751,1,00210,India
443287,2024-01-03,505,oven,18490,24000,5510,1,00019,India
443287,2024-01-03,506,monitor,3249,8000,4751,1,00019,India
443287,2024-01-03,503,mixer,1349,3249,1900,1,00019,India
971070,2024-01-03,507,washing machine,6990,16490,9500,1,00404,India
971070,2024-01-03,505,oven,18490,24000,5510,1,00404,India
538459,2024-01-03,502,iphone 15 pro max,100000,135000,35000,1,00017,India
538459,2024-01-03,506,monitor,3249,8000,4751,1,00017,India
312558,2024-01-03,503,mixer,1349,3249,1900,1,00367,India
312558,2024-01-03,507,washing machine,6990,16490,9500,1,00367,India
312558,2024-01-03,505,oven,18490,24000,5510,1,00367,India
119628,2024-01-03,506,monitor,3249,8000,4751,1,00198,India
119628,2024-01-03,502,iphone 15 pro max,100000,135000,35000,1,00198,India
119628,2024-01-03,505,oven,18490,24000,5510,1,00198,India
474121,2024-01-03,506,monitor,3249,8000,4751,1,00198,India
474121,2024-01-03,505,oven,18490,24000,5510,1,00198,India
474121,2024-01-03,504,iron,449,879,430,1,00198,India
474121,2024-01-03,502,iphone 15 pro max,100000,135000,35000,1,00198,India
151259,2024-01-03,505,oven,18490,24000,5510,1,00166,India
963783,2024-01-03,507,washing machine,6990,16490,9500,1,00169,India
963783,2024-01-03,503,mixer,1349,3249,1900,1,00169,India
963783,2024-01-03,502,iphone 15 pro max,100000,135000,35000,1,00169,India
291693,2024-01-03,501,iphone 15,60000,80000,20000,1,00494,India
291693,2024-01-03,507,washing machine,6990,16490,9500,1,00494,India
282973,2024-01-03,504,iron,449,879,430,1,00367,India
300733,2024-01-03,502,iphone 15 pro max,100000,135000,35000,1,00216,India
300733,2024-01-03,503,mixer,1349,3249,1900,1,00216,India
518778,2024-01-03,503,mixer,1349,3249,1900,1,00462,India
518778,2024-01-03,505,oven,18490,24000,5510,1,00462,India
518778,2024-01-03,506,monitor,3249,8000,4751,1,00462,India
518778,2024-01-03,507,washing machine,6990,16490,9500,1,00462,India
518778,2024-01-03,504,iron,449,879,430,1,00462,India
209368,2024-01-03,503,mixer,1349,3249,1900,1,00230,India
209368,2024-01-03,506,monitor,3249,8000,4751,1,00230,India
209368,2024-01-03,504,iron,449,879,430,1,00230,India
521492,2024-01-03,501,iphone 15,60000,80000,20000,1,00500,India
521492,2024-01-03,503,mixer,1349,3249,1900,1,00500,India
521492,2024-01-03,506,monitor,3249,8000,4751,1,00500,India
213536,2024-01-03,505,oven,18490,24000,5510,1,00428,India
213536,2024-01-03,504,iron,449,879,430,1,00428,India
211570,2024-01-03,506,monitor,3249,8000,4751,1,00216,India
552600,2024-01-03,502,iphone 15 pro max,100000,135000,35000,1,00288,India
552600,2024-01-03,501,iphone 15,60000,80000,20000,1,00288,India
552600,2024-01-03,507,washing machine,6990,16490,9500,1,00288,India
650835,2024-01-03,503,mixer,1349,3249,1900,1,00491,India
650835,2024-01-03,507,washing machine,6990,16490,9500,1,00491,India
306266,2024-01-03,502,iphone 15 pro max,100000,135000,35000,1,00249,India
306266,2024-01-03,505,oven,18490,24000,5510,1,00249,India
306266,2024-01-03,506,monitor,3249,8000,4751,1,00249,India
469606,2024-01-03,507,washing machine,6990,16490,9500,1,00405,India
828795,2024-01-03,507,washing machine,6990,16490,9500,1,00387,India
828795,2024-01-03,505,oven,18490,24000,5510,1,00387,India
828795,2024-01-03,503,mixer,1349,3249,1900,1,00387,India
902545,2024-01-03,506,monitor,3249,8000,4751,1,00136,India
902545,2024-01-03,507,washing machine,6990,16490,9500,1,00136,India
902545,2024-01-03,502,iphone 15 pro max,100000,135000,35000,1,00136,India
902545,2024-01-03,503,mixer,1349,3249,1900,1,00136,India
733452,2024-01-03,507,washing machine,6990,16490,9500,1,00200,India
733452,2024-01-03,503,mixer,1349,3249,1900,1,00200,India
733452,2024-01-03,505,oven,18490,24000,5510,1,00200,India
239598,2024-01-03,502,iphone 15 pro max,100000,135000,35000,1,00118,India
239598,2024-01-03,504,iron,449,879,430,1,00118,India
283919,2024-01-03,503,mixer,1349,3249,1900,1,00198,India
283919,2024-01-03,502,iphone 15 pro max,100000,135000,35000,1,00198,India
283919,2024-01-03,501,iphone 15,60000,80000,20000,1,00198,India
283919,2024-01-03,506,monitor,3249,8000,4751,1,00198,India
552222,2024-01-03,504,iron,449,879,430,1,00403,India
552222,2024-01-03,502,iphone 15 pro max,100000,135000,35000,1,00403,India
552222,2024-01-03,503,mixer,1349,3249,1900,1,00403,India
552222,2024-01-03,505,oven,18490,24000,5510,1,00403,India
337825,2024-01-03,501,iphone 15,60000,80000,20000,1,00369,India
337825,2024-01-03,502,iphone 15 pro max,100000,135000,35000,1,00369,India
337825,2024-01-03,505,oven,18490,24000,5510,1,00369,India
727343,2024-01-03,501,iphone 15,60000,80000,20000,1,00168,India
727343,2024-01-03,506,monitor,3249,8000,4751,1,00168,India
727343,2024-01-03,505,oven,18490,24000,5510,1,00168,India
727343,2024-01-03,502,iphone 15 pro max,100000,135000,35000,1,00168,India
463268,2024-01-03,507,washing machine,6990,16490,9500,1,00090,India
463268,2024-01-03,504,iron,449,879,430,1,00090,India
463268,2024-01-03,506,monitor,3249,8000,4751,1,00090,India
463268,2024-01-03,502,iphone 15 pro max,100000,135000,35000,1,00090,India
255473,2024-01-03,505,oven,18490,24000,5510,1,00105,India
255473,2024-01-03,503,mixer,1349,3249,1900,1,00105,India
103438,2024-01-03,504,iron,449,879,430,1,00317,India
103438,2024-01-03,507,washing machine,6990,16490,9500,1,00317,India
103438,2024-01-03,501,iphone 15,60000,80000,20000,1,00317,India
945994,2024-01-03,501,iphone 15,60000,80000,20000,1,00244,India
945994,2024-01-03,503,mixer,1349,3249,1900,1,00244,India
678250,2024-01-03,503,mixer,1349,3249,1900,1,00105,India
678250,2024-01-03,505,oven,18490,24000,5510,1,00105,India
870740,2024-01-03,502,iphone 15 pro max,100000,135000,35000,1,00184,India
870740,2024-01-03,505,oven,18490,24000,5510,1,00184,India
230865,2024-01-03,507,washing machine,6990,16490,9500,1,00197,India
230865,2024-01-03,505,oven,18490,24000,5510,1,00197,India
230865,2024-01-03,506,monitor,3249,8000,4751,1,00197,India
854503,2024-01-03,501,iphone 15,60000,80000,20000,1,00423,India
854503,2024-01-03,504,iron,449,879,430,1,00423,India
790339,2024-01-03,507,washing machine,6990,16490,9500,1,00007,India
790339,2024-01-03,503,mixer,1349,3249,1900,1,00007,India
226541,2024-01-03,502,iphone 15 pro max,100000,135000,35000,1,00178,India
226541,2024-01-03,507,washing machine,6990,16490,9500,1,00178,India
226541,2024-01-03,506,monitor,3249,8000,4751,1,00178,India
226541,2024-01-03,505,oven,18490,24000,5510,1,00178,India
840859,2024-01-03,501,iphone 15,60000,80000,20000,1,00468,India
467921,2024-01-03,507,washing machine,6990,16490,9500,1,00490,India
467921,2024-01-03,501,iphone 15,60000,80000,20000,1,00490,India
780992,2024-01-03,506,monitor,3249,8000,4751,1,00226,India
780992,2024-01-03,505,oven,18490,24000,5510,1,00226,India
780992,2024-01-03,507,washing machine,6990,16490,9500,1,00226,India
438584,2024-01-03,504,iron,449,879,430,1,00057,India
438584,2024-01-03,503,mixer,1349,3249,1900,1,00057,India
438584,2024-01-03,501,iphone 15,60000,80000,20000,1,00057,India
438584,2024-01-03,507,washing machine,6990,16490,9500,1,00057,India
483639,2024-01-03,504,iron,449,879,430,1,00225,India
483639,2024-01-03,505,oven,18490,24000,5510,1,00225,India
965961,2024-01-03,505,oven,18490,24000,5510,1,00424,India
965961,2024-01-03,504,iron,449,879,430,1,00424,India
965961,2024-01-03,502,iphone 15 pro max,100000,135000,35000,1,00424,India
601819,2024-01-03,502,iphone 15 pro max,100000,135000,35000,1,00143,India
601819,2024-01-03,505,oven,18490,24000,5510,1,00143,India
446976,2024-01-03,505,oven,18490,24000,5510,1,00422,India
446976,2024-01-03,504,iron,449,879,430,1,00422,India
360188,2024-01-03,503,mixer,1349,3249,1900,1,00252,India
825514,2024-01-03,502,iphone 15 pro max,100000,135000,35000,1,00460,India
825514,2024-01-03,504,iron,449,879,430,1,00460,India
825514,2024-01-03,503,mixer,1349,3249,1900,1,00460,India
396701,2024-01-03,503,mixer,1349,3249,1900,1,00221,India
396701,2024-01-03,502,iphone 15 pro max,100000,135000,35000,1,00221,India
396701,2024-01-03,506,monitor,3249,8000,4751,1,00221,India
396701,2024-01-03,507,washing machine,6990,16490,9500,1,00221,India
165962,2024-01-03,501,iphone 15,60000,80000,20000,1,00253,India
165962,2024-01-03,504,iron,449,879,430,1,00253,India
165962,2024-01-03,502,iphone 15 pro max,100000,135000,35000,1,00253,India
165962,2024-01-03,506,monitor,3249,8000,4751,1,00253,India
345899,2024-01-03,505,oven,18490,24000,5510,1,00032,India
345899,2024-01-03,502,iphone 15 pro max,100000,135000,35000,1,00032,India
345899,2024-01-03,504,iron,449,879,430,1,00032,India
717476,2024-01-03,503,mixer,1349,3249,1900,1,00312,India
717476,2024-01-03,507,washing machine,6990,16490,9500,1,00312,India
717476,2024-01-03,505,oven,18490,24000,5510,1,00312,India
717476,2024-01-03,504,iron,449,879,430,1,00312,India
977448,2024-01-03,506,monitor,3249,8000,4751,1,00388,India
977448,2024-01-03,504,iron,449,879,430,1,00388,India
977448,2024-01-03,502,iphone 15 pro max,100000,135000,35000,1,00388,India
269534,2024-01-03,506,monitor,3249,8000,4751,1,00285,India
793969,2024-01-03,506,monitor,3249,8000,4751,1,00029,India
793969,2024-01-03,502,iphone 15 pro max,100000,135000,35000,1,00029,India
728011,2024-01-03,502,iphone 15 pro max,100000,135000,35000,1,00063,India
728011,2024-01-03,503,mixer,1349,3249,1900,1,00063,India
728011,2024-01-03,504,iron,449,879,430,1,00063,India
243106,2024-01-03,501,iphone 15,60000,80000,20000,1,00162,India
243106,2024-01-03,503,mixer,1349,3249,1900,1,00162,India
243106,2024-01-03,506,monitor,3249,8000,4751,1,00162,India
145357,2024-01-03,507,washing machine,6990,16490,9500,1,00025,India
145357,2024-01-03,502,iphone 15 pro max,100000,135000,35000,1,00025,India
807330,2024-01-03,503,mixer,1349,3249,1900,1,00459,India
807330,2024-01-03,501,iphone 15,60000,80000,20000,1,00459,India
662935,2024-01-03,505,oven,18490,24000,5510,1,00495,India
662935,2024-01-03,504,iron,449,879,430,1,00495,India
662935,2024-01-03,501,iphone 15,60000,80000,20000,1,00495,India
488330,2024-01-03,504,iron,449,879,430,1,00318,India
986484,2024-01-03,502,iphone 15 pro max,100000,135000,35000,1,00309,India
986484,2024-01-03,501,iphone 15,60000,80000,20000,1,00309,India
986484,2024-01-03,505,oven,18490,24000,5510,1,00309,India
309856,2024-01-03,502,iphone 15 pro max,100000,135000,35000,1,00105,India
953504,2024-01-03,503,mixer,1349,3249,1900,1,00022,India
409665,2024-01-03,503,mixer,1349,3249,1900,1,00483,India
409665,2024-01-03,502,iphone 15 pro max,100000,135000,35000,1,00483,India
409665,2024-01-03,504,iron,449,879,430,1,00483,India
409665,2024-01-03,505,oven,18490,24000,5510,1,00483,India
758949,2024-01-03,501,iphone 15,60000,80000,20000,1,00343,India
758949,2024-01-03,503,mixer,1349,3249,1900,1,00343,India
758949,2024-01-03,506,monitor,3249,8000,4751,1,00343,India
758949,2024-01-03,502,iphone 15 pro max,100000,135000,35000,1,00343,India
614408,2024-01-03,502,iphone 15 pro max,100000,135000,35000,1,00430,India
614408,2024-01-03,506,monitor,3249,8000,4751,1,00430,India
486409,2024-01-03,503,mixer,1349,3249,1900,1,00289,India
507764,2024-01-03,502,iphone 15 pro max,100000,135000,35000,1,00404,India
507764,2024-01-03,503,mixer,1349,3249,1900,1,00404,India
507764,2024-01-03,504,iron,449,879,430,1,00404,India
507764,2024-01-03,507,washing machine,6990,16490,9500,1,00404,India
700433,2024-01-03,506,monitor,3249,8000,4751,1,00384,India
284321,2024-01-03,504,iron,449,879,430,1,00372,India
170431,2024-01-03,506,monitor,3249,8000,4751,1,00311,India
170431,2024-01-03,505,oven,18490,24000,5510,1,00311,India
170431,2024-01-03,501,iphone 15,60000,80000,20000,1,00311,India
837047,2024-01-03,503,mixer,1349,3249,1900,1,00035,India
837047,2024-01-03,501,iphone 15,60000,80000,20000,1,00035,India
283770,2024-01-03,503,mixer,1349,3249,1900,1,00246,India
931740,2024-01-03,503,mixer,1349,3249,1900,1,00054,India
931740,2024-01-03,507,washing machine,6990,16490,9500,1,00054,India
933437,2024-01-03,503,mixer,1349,3249,1900,1,00233,India
933437,2024-01-03,506,monitor,3249,8000,4751,1,00233,India
515703,2024-01-03,501,iphone 15,60000,80000,20000,1,00049,India
515703,2024-01-03,503,mixer,1349,3249,1900,1,00049,India
883854,2024-01-03,505,oven,18490,24000,5510,1,00173,India
883854,2024-01-03,501,iphone 15,60000,80000,20000,1,00173,India
982292,2024-01-03,506,monitor,3249,8000,4751,1,00315,India
370850,2024-01-03,504,iron,449,879,430,1,00220,India
370850,2024-01-03,501,iphone 15,60000,80000,20000,1,00220,India
370850,2024-01-03,505,oven,18490,24000,5510,1,00220,India
520878,2024-01-03,503,mixer,1349,3249,1900,1,00210,India
520878,2024-01-03,506,monitor,3249,8000,4751,1,00210,India
520878,2024-01-03,504,iron,449,879,430,1,00210,India
837370,2024-01-04,507,washing machine,6990,16490,9500,1,00260,India
843358,2024-01-04,504,iron,449,879,430,1,00081,India
843358,2024-01-04,506,monitor,3249,8000,4751,1,00081,India
843358,2024-01-04,505,oven,18490,24000,5510,1,00081,India
924851,2024-01-04,502,iphone 15 pro max,100000,135000,35000,1,00330,India
924851,2024-01-04,505,oven,18490,24000,5510,1,00330,India
924851,2024-01-04,503,mixer,1349,3249,1900,1,00330,India
924851,2024-01-04,501,iphone 15,60000,80000,20000,1,00330,India
924851,2024-01-04,504,iron,449,879,430,1,00330,India
821371,2024-01-04,507,washing machine,6990,16490,9500,1,00067,India
821371,2024-01-04,503,mixer,1349,3249,1900,1,00067,India
821371,2024-01-04,502,iphone 15 pro max,100000,135000,35000,1,00067,India
437305,2024-01-04,503,mixer,1349,3249,1900,1,00217,India
437305,2024-01-04,502,iphone 15 pro max,100000,135000,35000,1,00217,India
437305,2024-01-04,504,iron,449,879,430,1,00217,India
437305,2024-01-04,505,oven,18490,24000,5510,1,00217,India
437305,2024-01-04,506,monitor,3249,8000,4751,1,00217,India
338728,2024-01-04,506,monitor,3249,8000,4751,1,00026,India
338728,2024-01-04,507,washing machine,6990,16490,9500,1,00026,India
553956,2024-01-04,505,oven,18490,24000,5510,1,00099,India
553956,2024-01-04,507,washing machine,6990,16490,9500,1,00099,India
856249,2024-01-04,506,monitor,3249,8000,4751,1,00470,India
541913,2024-01-04,506,monitor,3249,8000,4751,1,00459,India
541913,2024-01-04,502,iphone 15 pro max,100000,135000,35000,1,00459,India
473871,2024-01-04,505,oven,18490,24000,5510,1,00329,India
473871,2024-01-04,504,iron,449,879,430,1,00329,India
473871,2024-01-04,502,iphone 15 pro max,100000,135000,35000,1,00329,India
473871,2024-01-04,503,mixer,1349,3249,1900,1,00329,India
545256,2024-01-04,507,washing machine,6990,16490,9500,1,00110,India
321139,2024-01-04,503,mixer,1349,3249,1900,1,00462,India
321139,2024-01-04,504,iron,449,879,430,1,00462,India
210534,2024-01-04,505,oven,18490,24000,5510,1,00063,India
210534,2024-01-04,507,washing machine,6990,16490,9500,1,00063,India
210534,2024-01-04,506,monitor,3249,8000,4751,1,00063,India
476547,2024-01-04,504,iron,449,879,430,1,00292,India
476547,2024-01-04,501,iphone 15,60000,80000,20000,1,00292,India
476547,2024-01-04,502,iphone 15 pro max,100000,135000,35000,1,00292,India
476547,2024-01-04,505,oven,18490,24000,5510,1,00292,India
462888,2024-01-04,507,washing machine,6990,16490,9500,1,00058,India
462888,2024-01-04,502,iphone 15 pro max,100000,135000,35000,1,00058,India
987765,2024-01-04,507,washing machine,6990,16490,9500,1,00218,India
987765,2024-01-04,505,oven,18490,24000,5510,1,00218,India
987765,2024-01-04,503,mixer,1349,3249,1900,1,00218,India
351547,2024-01-04,504,iron,449,879,430,1,00285,India
351547,2024-01-04,502,iphone 15 pro max,100000,135000,35000,1,00285,India
351547,2024-01-04,507,washing machine,6990,16490,9500,1,00285,India
351547,2024-01-04,503,mixer,1349,3249,1900,1,00285,India
548052,2024-01-04,507,washing machine,6990,16490,9500,1,00328,India
284043,2024-01-04,507,washing machine,6990,16490,9500,1,00016,India
284043,2024-01-04,505,oven,18490,24000,5510,1,00016,India
284043,2024-01-04,506,monitor,3249,8000,4751,1,00016,India
828401,2024-01-04,505,oven,18490,24000,5510,1,00486,India
130114,2024-01-04,502,iphone 15 pro max,100000,135000,35000,1,00295,India
130114,2024-01-04,504,iron,449,879,430,1,00295,India
130114,2024-01-04,505,oven,18490,24000,5510,1,00295,India
130114,2024-01-04,506,monitor,3249,8000,4751,1,00295,India
315943,2024-01-04,503,mixer,1349,3249,1900,1,00150,India
315943,2024-01-04,507,washing machine,6990,16490,9500,1,00150,India
132530,2024-01-04,506,monitor,3249,8000,4751,1,00374,India
132530,2024-01-04,503,mixer,1349,3249,1900,1,00374,India
132530,2024-01-04,504,iron,449,879,430,1,00374,India
901558,2024-01-04,507,washing machine,6990,16490,9500,1,00372,India
901558,2024-01-04,502,iphone 15 pro max,100000,135000,35000,1,00372,India
901558,2024-01-04,506,monitor,3249,8000,4751,1,00372,India
901558,2024-01-04,501,iphone 15,60000,80000,20000,1,00372,India
797986,2024-01-04,506,monitor,3249,8000,4751,1,00205,India
797986,2024-01-04,503,mixer,1349,3249,1900,1,00205,India
797986,2024-01-04,501,iphone 15,60000,80000,20000,1,00205,India
195307,2024-01-04,503,mixer,1349,3249,1900,1,00433,India
565194,2024-01-04,504,iron,449,879,430,1,00339,India
565194,2024-01-04,503,mixer,1349,3249,1900,1,00339,India
788079,2024-01-04,502,iphone 15 pro max,100000,135000,35000,1,00191,India
710404,2024-01-04,502,iphone 15 pro max,100000,135000,35000,1,00273,India
591266,2024-01-04,505,oven,18490,24000,5510,1,00129,India
591266,2024-01-04,507,washing machine,6990,16490,9500,1,00129,India
591266,2024-01-04,501,iphone 15,60000,80000,20000,1,00129,India
596632,2024-01-04,502,iphone 15 pro max,100000,135000,35000,1,00127,India
596632,2024-01-04,507,washing machine,6990,16490,9500,1,00127,India
596632,2024-01-04,506,monitor,3249,8000,4751,1,00127,India
291513,2024-01-04,506,monitor,3249,8000,4751,1,00137,India
983216,2024-01-04,507,washing machine,6990,16490,9500,1,00472,India
983216,2024-01-04,505,oven,18490,24000,5510,1,00472,India
983216,2024-01-04,501,iphone 15,60000,80000,20000,1,00472,India
983216,2024-01-04,503,mixer,1349,3249,1900,1,00472,India
983216,2024-01-04,504,iron,449,879,430,1,00472,India
699320,2024-01-04,501,iphone 15,60000,80000,20000,1,00198,India
699320,2024-01-04,504,iron,449,879,430,1,00198,India
851432,2024-01-04,507,washing machine,6990,16490,9500,1,00384,India
851432,2024-01-04,502,iphone 15 pro max,100000,135000,35000,1,00384,India
851432,2024-01-04,503,mixer,1349,3249,1900,1,00384,India
851432,2024-01-04,505,oven,18490,24000,5510,1,00384,India
368108,2024-01-04,502,iphone 15 pro max,100000,135000,35000,1,00137,India
542497,2024-01-04,506,monitor,3249,8000,4751,1,00005,India
542497,2024-01-04,501,iphone 15,60000,80000,20000,1,00005,India
542497,2024-01-04,507,washing machine,6990,16490,9500,1,00005,India
970182,2024-01-04,504,iron,449,879,430,1,00379,India
970182,2024-01-04,505,oven,18490,24000,5510,1,00379,India
269052,2024-01-04,503,mixer,1349,3249,1900,1,00168,India
269052,2024-01-04,504,iron,449,879,430,1,00168,India
269052,2024-01-04,505,oven,18490,24000,5510,1,00168,India
269052,2024-01-04,502,iphone 15 pro max,100000,135000,35000,1,00168,India
175317,2024-01-04,503,mixer,1349,3249,1900,1,00027,India
175317,2024-01-04,502,iphone 15 pro max,100000,135000,35000,1,00027,India
553805,2024-01-04,503,mixer,1349,3249,1900,1,00253,India
553805,2024-01-04,505,oven,18490,24000,5510,1,00253,India
553805,2024-01-04,501,iphone 15,60000,80000,20000,1,00253,India
553805,2024-01-04,502,iphone 15 pro max,100000,135000,35000,1,00253,India
754127,2024-01-04,504,iron,449,879,430,1,00178,India
754127,2024-01-04,506,monitor,3249,8000,4751,1,00178,India
754127,2024-01-04,503,mixer,1349,3249,1900,1,00178,India
754953,2024-01-04,501,iphone 15,60000,80000,20000,1,00048,India
754953,2024-01-04,504,iron,449,879,430,1,00048,India
754953,2024-01-04,506,monitor,3249,8000,4751,1,00048,India
619383,2024-01-04,504,iron,449,879,430,1,00346,India
619383,2024-01-04,506,monitor,3249,8000,4751,1,00346,India
619383,2024-01-04,501,iphone 15,60000,80000,20000,1,00346,India
619383,2024-01-04,502,iphone 15 pro max,100000,135000,35000,1,00346,India
619383,2024-01-04,507,washing machine,6990,16490,9500,1,00346,India
299185,2024-01-04,502,iphone 15 pro max,100000,135000,35000,1,00215,India
568567,2024-01-04,505,oven,18490,24000,5510,1,00366,India
568567,2024-01-04,504,iron,449,879,430,1,00366,India
568567,2024-01-04,506,monitor,3249,8000,4751,1,00366,India
568567,2024-01-04,502,iphone 15 pro max,100000,135000,35000,1,00366,India
313219,2024-01-04,503,mixer,1349,3249,1900,1,00247,India
313219,2024-01-04,505,oven,18490,24000,5510,1,00247,India
317520,2024-01-04,506,monitor,3249,8000,4751,1,00267,India
317520,2024-01-04,504,iron,449,879,430,1,00267,India
780047,2024-01-04,503,mixer,1349,3249,1900,1,00016,India
780047,2024-01-04,501,iphone 15,60000,80000,20000,1,00016,India
780047,2024-01-04,507,washing machine,6990,16490,9500,1,00016,India
432714,2024-01-04,502,iphone 15 pro max,100000,135000,35000,1,00150,India
432714,2024-01-04,505,oven,18490,24000,5510,1,00150,India
432714,2024-01-04,504,iron,449,879,430,1,00150,India
432714,2024-01-04,503,mixer,1349,3249,1900,1,00150,India
799184,2024-01-04,502,iphone 15 pro max,100000,135000,35000,1,00270,India
799184,2024-01-04,506,monitor,3249,8000,4751,1,00270,India
799184,2024-01-04,503,mixer,1349,3249,1900,1,00270,India
701691,2024-01-04,504,iron,449,879,430,1,00071,India
701691,2024-01-04,503,mixer,1349,3249,1900,1,00071,India
701691,2024-01-04,507,washing machine,6990,16490,9500,1,00071,India
605102,2024-01-04,506,monitor,3249,8000,4751,1,00389,India
605102,2024-01-04,502,iphone 15 pro max,100000,135000,35000,1,00389,India
605102,2024-01-04,505,oven,18490,24000,5510,1,00389,India
605102,2024-01-04,503,mixer,1349,3249,1900,1,00389,India
605102,2024-01-04,501,iphone 15,60000,80000,20000,1,00389,India
561281,2024-01-04,506,monitor,3249,8000,4751,1,00276,India
461886,2024-01-04,507,washing machine,6990,16490,9500,1,00295,India
461886,2024-01-04,506,monitor,3249,8000,4751,1,00295,India
461886,2024-01-04,502,iphone 15 pro max,100000,135000,35000,1,00295,India
694984,2024-01-04,503,mixer,1349,3249,1900,1,00250,India
694984,2024-01-04,506,monitor,3249,8000,4751,1,00250,India
694984,2024-01-04,501,iphone 15,60000,80000,20000,1,00250,India
694984,2024-01-04,507,washing machine,6990,16490,9500,1,00250,India
694984,2024-01-04,502,iphone 15 pro max,100000,135000,35000,1,00250,India
827831,2024-01-04,501,iphone 15,60000,80000,20000,1,00480,India
827831,2024-01-04,503,mixer,1349,3249,1900,1,00480,India
827831,2024-01-04,506,monitor,3249,8000,4751,1,00480,India
808296,2024-01-04,502,iphone 15 pro max,100000,135000,35000,1,00124,India
808296,2024-01-04,501,iphone 15,60000,80000,20000,1,00124,India
808296,2024-01-04,505,oven,18490,24000,5510,1,00124,India
808296,2024-01-04,504,iron,449,879,430,1,00124,India
803777,2024-01-04,507,washing machine,6990,16490,9500,1,00380,India
803777,2024-01-04,504,iron,449,879,430,1,00380,India
344489,2024-01-04,505,oven,18490,24000,5510,1,00248,India
791157,2024-01-04,507,washing machine,6990,16490,9500,1,00422,India
791157,2024-01-04,501,iphone 15,60000,80000,20000,1,00422,India
791157,2024-01-04,506,monitor,3249,8000,4751,1,00422,India
791157,2024-01-04,502,iphone 15 pro max,100000,135000,35000,1,00422,India
509522,2024-01-04,505,oven,18490,24000,5510,1,00030,India
509522,2024-01-04,507,washing machine,6990,16490,9500,1,00030,India
572926,2024-01-04,504,iron,449,879,430,1,00300,India
572926,2024-01-04,503,mixer,1349,3249,1900,1,00300,India
692035,2024-01-04,505,oven,18490,24000,5510,1,00363,India
692035,2024-01-04,506,monitor,3249,8000,4751,1,00363,India
692035,2024-01-04,503,mixer,1349,3249,1900,1,00363,India
615021,2024-01-04,506,monitor,3249,8000,4751,1,00428,India
615021,2024-01-04,504,iron,449,879,430,1,00428,India
615021,2024-01-04,503,mixer,1349,3249,1900,1,00428,India
276071,2024-01-04,501,iphone 15,60000,80000,20000,1,00053,India
276071,2024-01-04,503,mixer,1349,3249,1900,1,00053,India
718535,2024-01-04,505,oven,18490,24000,5510,1,00427,India
718535,2024-01-04,507,washing machine,6990,16490,9500,1,00427,India
718535,2024-01-04,501,iphone 15,60000,80000,20000,1,00427,India
353316,2024-01-04,506,monitor,3249,8000,4751,1,00188,India
353316,2024-01-04,505,oven,18490,24000,5510,1,00188,India
353316,2024-01-04,503,mixer,1349,3249,1900,1,00188,India
843638,2024-01-04,507,washing machine,6990,16490,9500,1,00399,India
725168,2024-01-04,505,oven,18490,24000,5510,1,00075,India
725168,2024-01-04,506,monitor,3249,8000,4751,1,00075,India
725168,2024-01-04,507,washing machine,6990,16490,9500,1,00075,India
725168,2024-01-04,501,iphone 15,60000,80000,20000,1,00075,India
725168,2024-01-04,504,iron,449,879,430,1,00075,India
853114,2024-01-04,501,iphone 15,60000,80000,20000,1,00185,India
335561,2024-01-04,506,monitor,3249,8000,4751,1,00443,India
335561,2024-01-04,503,mixer,1349,3249,1900,1,00443,India
310048,2024-01-04,502,iphone 15 pro max,100000,135000,35000,1,00353,India
310048,2024-01-04,504,iron,449,879,430,1,00353,India
163757,2024-01-04,504,iron,449,879,430,1,00042,India
163757,2024-01-04,505,oven,18490,24000,5510,1,00042,India
163757,2024-01-04,502,iphone 15 pro max,100000,135000,35000,1,00042,India
877705,2024-01-04,504,iron,449,879,430,1,00168,India
877705,2024-01-04,505,oven,18490,24000,5510,1,00168,India
120389,2024-01-04,504,iron,449,879,430,1,00399,India
120389,2024-01-04,502,iphone 15 pro max,100000,135000,35000,1,00399,India
120389,2024-01-04,503,mixer,1349,3249,1900,1,00399,India
326296,2024-01-04,501,iphone 15,60000,80000,20000,1,00090,India
326296,2024-01-04,506,monitor,3249,8000,4751,1,00090,India
326296,2024-01-04,505,oven,18490,24000,5510,1,00090,India
326296,2024-01-04,502,iphone 15 pro max,100000,135000,35000,1,00090,India
361084,2024-01-04,501,iphone 15,60000,80000,20000,1,00386,India
403114,2024-01-04,504,iron,449,879,430,1,00177,India
403114,2024-01-04,505,oven,18490,24000,5510,1,00177,India
403114,2024-01-04,506,monitor,3249,8000,4751,1,00177,India
520125,2024-01-04,507,washing machine,6990,16490,9500,1,00231,India
917222,2024-01-04,505,oven,18490,24000,5510,1,00309,India
969158,2024-01-04,503,mixer,1349,3249,1900,1,00028,India
969158,2024-01-04,504,iron,449,879,430,1,00028,India
969158,2024-01-04,507,washing machine,6990,16490,9500,1,00028,India
969158,2024-01-04,506,monitor,3249,8000,4751,1,00028,India
441967,2024-01-04,503,mixer,1349,3249,1900,1,00484,India
441967,2024-01-04,506,monitor,3249,8000,4751,1,00484,India
441967,2024-01-04,501,iphone 15,60000,80000,20000,1,00484,India
134650,2024-01-04,502,iphone 15 pro max,100000,135000,35000,1,00257,India
134650,2024-01-04,501,iphone 15,60000,80000,20000,1,00257,India
134650,2024-01-04,505,oven,18490,24000,5510,1,00257,India
817025,2024-01-04,501,iphone 15,60000,80000,20000,1,00130,India
817025,2024-01-04,504,iron,449,879,430,1,00130,India
817025,2024-01-04,502,iphone 15 pro max,100000,135000,35000,1,00130,India
817025,2024-01-04,507,washing machine,6990,16490,9500,1,00130,India
309253,2024-01-05,505,oven,18490,24000,5510,1,00100,India
309253,2024-01-05,502,iphone 15 pro max,100000,135000,35000,1,00100,India
309253,2024-01-05,503,mixer,1349,3249,1900,1,00100,India
309253,2024-01-05,504,iron,449,879,430,1,00100,India
869180,2024-01-05,503,mixer,1349,3249,1900,1,00477,India
192747,2024-01-05,501,iphone 15,60000,80000,20000,1,00111,India
192747,2024-01-05,502,iphone 15 pro max,100000,135000,35000,1,00111,India
192747,2024-01-05,507,washing machine,6990,16490,9500,1,00111,India
192747,2024-01-05,505,oven,18490,24000,5510,1,00111,India
778618,2024-01-05,507,washing machine,6990,16490,9500,1,00431,India
778618,2024-01-05,506,monitor,3249,8000,4751,1,00431,India
778618,2024-01-05,502,iphone 15 pro max,100000,135000,35000,1,00431,India
610631,2024-01-05,503,mixer,1349,3249,1900,1,00339,India
610631,2024-01-05,504,iron,449,879,430,1,00339,India
449111,2024-01-05,505,oven,18490,24000,5510,1,00070,India
449111,2024-01-05,502,iphone 15 pro max,100000,135000,35000,1,00070,India
449111,2024-01-05,507,washing machine,6990,16490,9500,1,00070,India
238207,2024-01-05,507,washing machine,6990,16490,9500,1,00392,India
238207,2024-01-05,506,monitor,3249,8000,4751,1,00392,India
298163,2024-01-05,505,oven,18490,24000,5510,1,00178,India
298163,2024-01-05,503,mixer,1349,3249,1900,1,00178,India
298163,2024-01-05,501,iphone 15,60000,80000,20000,1,00178,India
958049,2024-01-05,504,iron,449,879,430,1,00437,India
958049,2024-01-05,502,iphone 15 pro max,100000,135000,35000,1,00437,India
958049,2024-01-05,505,oven,18490,24000,5510,1,00437,India
554404,2024-01-05,507,washing machine,6990,16490,9500,1,00464,India
554404,2024-01-05,504,iron,449,879,430,1,00464,India
554404,2024-01-05,505,oven,18490,24000,5510,1,00464,India
378108,2024-01-05,507,washing machine,6990,16490,9500,1,00434,India
378108,2024-01-05,503,mixer,1349,3249,1900,1,00434,India
378108,2024-01-05,505,oven,18490,24000,5510,1,00434,India
417993,2024-01-05,504,iron,449,879,430,1,00429,India
417993,2024-01-05,505,oven,18490,24000,5510,1,00429,India
531729,2024-01-05,507,washing machine,6990,16490,9500,1,00434,India
145350,2024-01-05,506,monitor,3249,8000,4751,1,00442,India
145350,2024-01-05,502,iphone 15 pro max,100000,135000,35000,1,00442,India
145350,2024-01-05,503,mixer,1349,3249,1900,1,00442,India
268005,2024-01-05,501,iphone 15,60000,80000,20000,1,00458,India
813689,2024-01-05,502,iphone 15 pro max,100000,135000,35000,1,00493,India
547143,2024-01-05,501,iphone 15,60000,80000,20000,1,00345,India
547143,2024-01-05,505,oven,18490,24000,5510,1,00345,India
547143,2024-01-05,503,mixer,1349,3249,1900,1,00345,India
547143,2024-01-05,506,monitor,3249,8000,4751,1,00345,India
723214,2024-01-05,507,washing machine,6990,16490,9500,1,00464,India
925513,2024-01-05,503,mixer,1349,3249,1900,1,00046,India
925513,2024-01-05,501,iphone 15,60000,80000,20000,1,00046,India
925513,2024-01-05,506,monitor,3249,8000,4751,1,00046,India
925513,2024-01-05,504,iron,449,879,430,1,00046,India
529103,2024-01-05,501,iphone 15,60000,80000,20000,1,00187,India
529103,2024-01-05,505,oven,18490,24000,5510,1,00187,India
529103,2024-01-05,506,monitor,3249,8000,4751,1,00187,India
119766,2024-01-05,506,monitor,3249,8000,4751,1,00418,India
615441,2024-01-05,505,oven,18490,24000,5510,1,00456,India
615441,2024-01-05,502,iphone 15 pro max,100000,135000,35000,1,00456,India
615441,2024-01-05,506,monitor,3249,8000,4751,1,00456,India
615441,2024-01-05,503,mixer,1349,3249,1900,1,00456,India
255587,2024-01-05,502,iphone 15 pro max,100000,135000,35000,1,00195,India
986439,2024-01-05,503,mixer,1349,3249,1900,1,00332,India
986439,2024-01-05,501,iphone 15,60000,80000,20000,1,00332,India
986439,2024-01-05,507,washing machine,6990,16490,9500,1,00332,India
986439,2024-01-05,504,iron,449,879,430,1,00332,India
339914,2024-01-05,505,oven,18490,24000,5510,1,00481,India
339914,2024-01-05,507,washing machine,6990,16490,9500,1,00481,India
339914,2024-01-05,502,iphone 15 pro max,100000,135000,35000,1,00481,India
738084,2024-01-05,502,iphone 15 pro max,100000,135000,35000,1,00390,India
738084,2024-01-05,505,oven,18490,24000,5510,1,00390,India
738084,2024-01-05,506,monitor,3249,8000,4751,1,00390,India
751457,2024-01-05,505,oven,18490,24000,5510,1,00282,India
751457,2024-01-05,504,iron,449,879,430,1,00282,India
751457,2024-01-05,502,iphone 15 pro max,100000,135000,35000,1,00282,India
527809,2024-01-05,507,washing machine,6990,16490,9500,1,00385,India
527809,2024-01-05,504,iron,449,879,430,1,00385,India
875269,2024-01-05,502,iphone 15 pro max,100000,135000,35000,1,00342,India
875269,2024-01-05,501,iphone 15,60000,80000,20000,1,00342,India
645505,2024-01-05,501,iphone 15,60000,80000,20000,1,00482,India
645505,2024-01-05,504,iron,449,879,430,1,00482,India
458817,2024-01-05,505,oven,18490,24000,5510,1,00423,India
458817,2024-01-05,506,monitor,3249,8000,4751,1,00423,India
458817,2024-01-05,501,iphone 15,60000,80000,20000,1,00423,India
458817,2024-01-05,504,iron,449,879,430,1,00423,India
458817,2024-01-05,503,mixer,1349,3249,1900,1,00423,India
347653,2024-01-05,501,iphone 15,60000,80000,20000,1,00025,India
330180,2024-01-05,502,iphone 15 pro max,100000,135000,35000,1,00451,India
330180,2024-01-05,507,washing machine,6990,16490,9500,1,00451,India
330180,2024-01-05,506,monitor,3249,8000,4751,1,00451,India
590033,2024-01-05,501,iphone 15,60000,80000,20000,1,00368,India
590033,2024-01-05,503,mixer,1349,3249,1900,1,00368,India
590033,2024-01-05,505,oven,18490,24000,5510,1,00368,India
710889,2024-01-05,503,mixer,1349,3249,1900,1,00181,India
710889,2024-01-05,505,oven,18490,24000,5510,1,00181,India
710889,2024-01-05,502,iphone 15 pro max,100000,135000,35000,1,00181,India
248070,2024-01-05,507,washing machine,6990,16490,9500,1,00397,India
723314,2024-01-05,506,monitor,3249,8000,4751,1,00215,India
723314,2024-01-05,503,mixer,1349,3249,1900,1,00215,India
753971,2024-01-05,505,oven,18490,24000,5510,1,00075,India
753971,2024-01-05,504,iron,449,879,430,1,00075,India
446954,2024-01-05,503,mixer,1349,3249,1900,1,00437,India
446954,2024-01-05,505,oven,18490,24000,5510,1,00437,India
952476,2024-01-05,501,iphone 15,60000,80000,20000,1,00049,India
952476,2024-01-05,504,iron,449,879,430,1,00049,India
952476,2024-01-05,503,mixer,1349,3249,1900,1,00049,India
952476,2024-01-05,507,washing machine,6990,16490,9500,1,00049,India
784315,2024-01-05,506,monitor,3249,8000,4751,1,00163,India
784315,2024-01-05,502,iphone 15 pro max,100000,135000,35000,1,00163,India
784315,2024-01-05,501,iphone 15,60000,80000,20000,1,00163,India
784315,2024-01-05,505,oven,18490,24000,5510,1,00163,India
434478,2024-01-05,507,washing machine,6990,16490,9500,1,00217,India
434478,2024-01-05,505,oven,18490,24000,5510,1,00217,India
434478,2024-01-05,504,iron,449,879,430,1,00217,India
280829,2024-01-05,503,mixer,1349,3249,1900,1,00340,India
255440,2024-01-05,502,iphone 15 pro max,100000,135000,35000,1,00448,India
211655,2024-01-05,505,oven,18490,24000,5510,1,00281,India
945111,2024-01-05,504,iron,449,879,430,1,00256,India
945111,2024-01-05,502,iphone 15 pro max,100000,135000,35000,1,00256,India
141593,2024-01-05,504,iron,449,879,430,1,00309,India
141593,2024-01-05,506,monitor,3249,8000,4751,1,00309,India
141593,2024-01-05,507,washing machine,6990,16490,9500,1,00309,India
141593,2024-01-05,505,oven,18490,24000,5510,1,00309,India
138840,2024-01-05,502,iphone 15 pro max,100000,135000,35000,1,00340,India
138840,2024-01-05,501,iphone 15,60000,80000,20000,1,00340,India
138840,2024-01-05,505,oven,18490,24000,5510,1,00340,India
232923,2024-01-05,503,mixer,1349,3249,1900,1,00432,India
232923,2024-01-05,501,iphone 15,60000,80000,20000,1,00432,India
232923,2024-01-05,506,monitor,3249,8000,4751,1,00432,India
606950,2024-01-05,504,iron,449,879,430,1,00473,India
606950,2024-01-05,506,monitor,3249,8000,4751,1,00473,India
759857,2024-01-05,502,iphone 15 pro max,100000,135000,35000,1,00218,India
759857,2024-01-05,503,mixer,1349,3249,1900,1,00218,India
759857,2024-01-05,507,washing machine,6990,16490,9500,1,00218,India
853606,2024-01-05,503,mixer,1349,3249,1900,1,00329,India
622742,2024-01-05,507,washing machine,6990,16490,9500,1,00177,India
622742,2024-01-05,504,iron,449,879,430,1,00177,India
622742,2024-01-05,503,mixer,1349,3249,1900,1,00177,India
917990,2024-01-05,507,washing machine,6990,16490,9500,1,00016,India
917990,2024-01-05,504,iron,449,879,430,1,00016,India
917990,2024-01-05,502,iphone 15 pro max,100000,135000,35000,1,00016,India
939112,2024-01-05,504,iron,449,879,430,1,00498,India
939112,2024-01-05,502,iphone 15 pro max,100000,135000,35000,1,00498,India
325850,2024-01-05,504,iron,449,879,430,1,00382,India
325850,2024-01-05,507,washing machine,6990,16490,9500,1,00382,India
961232,2024-01-05,507,washing machine,6990,16490,9500,1,00412,India
961232,2024-01-05,504,iron,449,879,430,1,00412,India
961232,2024-01-05,505,oven,18490,24000,5510,1,00412,India
493436,2024-01-05,501,iphone 15,60000,80000,20000,1,00201,India
493436,2024-01-05,507,washing machine,6990,16490,9500,1,00201,India
493436,2024-01-05,505,oven,18490,24000,5510,1,00201,India
233326,2024-01-05,503,mixer,1349,3249,1900,1,00127,India
233326,2024-01-05,502,iphone 15 pro max,100000,135000,35000,1,00127,India
233326,2024-01-05,506,monitor,3249,8000,4751,1,00127,India
233326,2024-01-05,507,washing machine,6990,16490,9500,1,00127,India
538281,2024-01-05,507,washing machine,6990,16490,9500,1,00440,India
538281,2024-01-05,503,mixer,1349,3249,1900,1,00440,India
542739,2024-01-05,505,oven,18490,24000,5510,1,00184,India
542739,2024-01-05,506,monitor,3249,8000,4751,1,00184,India
542739,2024-01-05,504,iron,449,879,430,1,00184,India
542739,2024-01-05,507,washing machine,6990,16490,9500,1,00184,India
368043,2024-01-05,505,oven,18490,24000,5510,1,00422,India
368043,2024-01-05,503,mixer,1349,3249,1900,1,00422,India
137063,2024-01-05,502,iphone 15 pro max,100000,135000,35000,1,00094,India
137063,2024-01-05,507,washing machine,6990,16490,9500,1,00094,India
137063,2024-01-05,505,oven,18490,24000,5510,1,00094,India
137063,2024-01-05,501,iphone 15,60000,80000,20000,1,00094,India
338695,2024-01-05,504,iron,449,879,430,1,00187,India
338695,2024-01-05,505,oven,18490,24000,5510,1,00187,India
792815,2024-01-05,503,mixer,1349,3249,1900,1,00107,India
854484,2024-01-05,502,iphone 15 pro max,100000,135000,35000,1,00229,India
854484,2024-01-05,505,oven,18490,24000,5510,1,00229,India
854484,2024-01-05,501,iphone 15,60000,80000,20000,1,00229,India
920515,2024-01-05,503,mixer,1349,3249,1900,1,00013,India
920515,2024-01-05,505,oven,18490,24000,5510,1,00013,India
920515,2024-01-05,506,monitor,3249,8000,4751,1,00013,India
920515,2024-01-05,502,iphone 15 pro max,100000,135000,35000,1,00013,India
920515,2024-01-05,501,iphone 15,60000,80000,20000,1,00013,India
712511,2024-01-05,502,iphone 15 pro max,100000,135000,35000,1,00304,India
712511,2024-01-05,504,iron,449,879,430,1,00304,India
712511,2024-01-05,503,mixer,1349,3249,1900,1,00304,India
797963,2024-01-05,501,iphone 15,60000,80000,20000,1,00015,India
760175,2024-01-05,502,iphone 15 pro max,100000,135000,35000,1,00230,India
760175,2024-01-05,507,washing machine,6990,16490,9500,1,00230,India
760175,2024-01-05,503,mixer,1349,3249,1900,1,00230,India
629267,2024-01-05,502,iphone 15 pro max,100000,135000,35000,1,00398,India
629267,2024-01-05,501,iphone 15,60000,80000,20000,1,00398,India
629267,2024-01-05,503,mixer,1349,3249,1900,1,00398,India
784664,2024-01-05,506,monitor,3249,8000,4751,1,00357,India
784664,2024-01-05,503,mixer,1349,3249,1900,1,00357,India
784664,2024-01-05,502,iphone 15 pro max,100000,135000,35000,1,00357,India
471967,2024-01-05,504,iron,449,879,430,1,00256,India
471967,2024-01-05,505,oven,18490,24000,5510,1,00256,India
471967,2024-01-05,506,monitor,3249,8000,4751,1,00256,India
748129,2024-01-05,504,iron,449,879,430,1,00028,India
748129,2024-01-05,501,iphone 15,60000,80000,20000,1,00028,India
748129,2024-01-05,505,oven,18490,24000,5510,1,00028,India
146000,2024-01-05,502,iphone 15 pro max,100000,135000,35000,1,00089,India
146000,2024-01-05,505,oven,18490,24000,5510,1,00089,India
821324,2024-01-05,504,iron,449,879,430,1,00492,India
821324,2024-01-05,502,iphone 15 pro max,100000,135000,35000,1,00492,India
821324,2024-01-05,503,mixer,1349,3249,1900,1,00492,India
860336,2024-01-05,504,iron,449,879,430,1,00479,India
860336,2024-01-05,503,mixer,1349,3249,1900,1,00479,India
860336,2024-01-05,507,washing machine,6990,16490,9500,1,00479,India
143564,2024-01-05,502,iphone 15 pro max,100000,135000,35000,1,00154,India
143564,2024-01-05,501,iphone 15,60000,80000,20000,1,00154,India
143564,2024-01-05,505,oven,18490,24000,5510,1,00154,India
143564,2024-01-05,504,iron,449,879,430,1,00154,India
771399,2024-01-05,504,iron,449,879,430,1,00254,India
771399,2024-01-05,506,monitor,3249,8000,4751,1,00254,India
771399,2024-01-05,502,iphone 15 pro max,100000,135000,35000,1,00254,India
771399,2024-01-05,507,washing machine,6990,16490,9500,1,00254,India
157529,2024-01-05,507,washing machine,6990,16490,9500,1,00463,India
157529,2024-01-05,502,iphone 15 pro max,100000,135000,35000,1,00463,India
157529,2024-01-05,504,iron,449,879,430,1,00463,India
157529,2024-01-05,503,mixer,1349,3249,1900,1,00463,India
795869,2024-01-05,507,washing machine,6990,16490,9500,1,00155,India
795869,2024-01-05,503,mixer,1349,3249,1900,1,00155,India
795869,2024-01-05,501,iphone 15,60000,80000,20000,1,00155,India
795869,2024-01-05,505,oven,18490,24000,5510,1,00155,India
873267,2024-01-06,503,mixer,1349,3249,1900,1,00220,India
873267,2024-01-06,506,monitor,3249,8000,4751,1,00220,India
873267,2024-01-06,504,iron,449,879,430,1,00220,India
840270,2024-01-06,506,monitor,3249,8000,4751,1,00094,India
840270,2024-01-06,504,iron,449,879,430,1,00094,India
707540,2024-01-06,505,oven,18490,24000,5510,1,00365,India
707540,2024-01-06,504,iron,449,879,430,1,00365,India
707540,2024-01-06,501,iphone 15,60000,80000,20000,1,00365,India
784854,2024-01-06,501,iphone 15,60000,80000,20000,1,00081,India
784854,2024-01-06,506,monitor,3249,8000,4751,1,00081,India
736389,2024-01-06,504,iron,449,879,430,1,00002,India
140974,2024-01-06,501,iphone 15,60000,80000,20000,1,00493,India
140974,2024-01-06,505,oven,18490,24000,5510,1,00493,India
140974,2024-01-06,506,monitor,3249,8000,4751,1,00493,India
140974,2024-01-06,503,mixer,1349,3249,1900,1,00493,India
410692,2024-01-06,506,monitor,3249,8000,4751,1,00108,India
410692,2024-01-06,505,oven,18490,24000,5510,1,00108,India
410692,2024-01-06,502,iphone 15 pro max,100000,135000,35000,1,00108,India
578748,2024-01-06,504,iron,449,879,430,1,00379,India
578748,2024-01-06,501,iphone 15,60000,80000,20000,1,00379,India
578748,2024-01-06,503,mixer,1349,3249,1900,1,00379,India
872754,2024-01-06,502,iphone 15 pro max,100000,135000,35000,1,00122,India
872754,2024-01-06,504,iron,449,879,430,1,00122,India
872754,2024-01-06,503,mixer,1349,3249,1900,1,00122,India
872754,2024-01-06,507,washing machine,6990,16490,9500,1,00122,India
243087,2024-01-06,502,iphone 15 pro max,100000,135000,35000,1,00042,India
243087,2024-01-06,504,iron,449,879,430,1,00042,India
775592,2024-01-06,502,iphone 15 pro max,100000,135000,35000,1,00127,India
775592,2024-01-06,501,iphone 15,60000,80000,20000,1,00127,India
471075,2024-01-06,504,iron,449,879,430,1,00067,India
471075,2024-01-06,502,iphone 15 pro max,100000,135000,35000,1,00067,India
471075,2024-01-06,506,monitor,3249,8000,4751,1,00067,India
603585,2024-01-06,501,iphone 15,60000,80000,20000,1,00270,India
603585,2024-01-06,506,monitor,3249,8000,4751,1,00270,India
603585,2024-01-06,504,iron,449,879,430,1,00270,India
603585,2024-01-06,507,washing machine,6990,16490,9500,1,00270,India
603585,2024-01-06,505,oven,18490,24000,5510,1,00270,India
607442,2024-01-06,507,washing machine,6990,16490,9500,1,00197,India
672407,2024-01-06,504,iron,449,879,430,1,00305,India
672407,2024-01-06,506,monitor,3249,8000,4751,1,00305,India
799584,2024-01-06,501,iphone 15,60000,80000,20000,1,00412,India
799584,2024-01-06,505,oven,18490,24000,5510,1,00412,India
644416,2024-01-06,507,washing machine,6990,16490,9500,1,00411,India
964356,2024-01-06,501,iphone 15,60000,80000,20000,1,00288,India
964356,2024-01-06,505,oven,18490,24000,5510,1,00288,India
964356,2024-01-06,506,monitor,3249,8000,4751,1,00288,India
964356,2024-01-06,502,iphone 15 pro max,100000,135000,35000,1,00288,India
917049,2024-01-06,507,washing machine,6990,16490,9500,1,00306,India
917049,2024-01-06,501,iphone 15,60000,80000,20000,1,00306,India
976958,2024-01-06,502,iphone 15 pro max,100000,135000,35000,1,00092,India
976958,2024-01-06,503,mixer,1349,3249,1900,1,00092,India
976958,2024-01-06,501,iphone 15,60000,80000,20000,1,00092,India
976958,2024-01-06,506,monitor,3249,8000,4751,1,00092,India
507399,2024-01-06,505,oven,18490,24000,5510,1,00248,India
507399,2024-01-06,506,monitor,3249,8000,4751,1,00248,India
507399,2024-01-06,507,washing machine,6990,16490,9500,1,00248,India
518039,2024-01-06,506,monitor,3249,8000,4751,1,00179,India
518039,2024-01-06,507,washing machine,6990,16490,9500,1,00179,India
251971,2024-01-06,504,iron,449,879,430,1,00237,India
251971,2024-01-06,505,oven,18490,24000,5510,1,00237,India
251971,2024-01-06,502,iphone 15 pro max,100000,135000,35000,1,00237,India
415601,2024-01-06,505,oven,18490,24000,5510,1,00239,India
415601,2024-01-06,501,iphone 15,60000,80000,20000,1,00239,India
415601,2024-01-06,503,mixer,1349,3249,1900,1,00239,India
969881,2024-01-06,503,mixer,1349,3249,1900,1,00280,India
969881,2024-01-06,507,washing machine,6990,16490,9500,1,00280,India
969881,2024-01-06,502,iphone 15 pro max,100000,135000,35000,1,00280,India
969881,2024-01-06,505,oven,18490,24000,5510,1,00280,India
912239,2024-01-06,501,iphone 15,60000,80000,20000,1,00274,India
697417,2024-01-06,504,iron,449,879,430,1,00377,India
697417,2024-01-06,502,iphone 15 pro max,100000,135000,35000,1,00377,India
697417,2024-01-06,503,mixer,1349,3249,1900,1,00377,India
675618,2024-01-06,506,monitor,3249,8000,4751,1,00379,India
675618,2024-01-06,503,mixer,1349,3249,1900,1,00379,India
675618,2024-01-06,507,washing machine,6990,16490,9500,1,00379,India
497199,2024-01-06,501,iphone 15,60000,80000,20000,1,00051,India
142610,2024-01-06,507,washing machine,6990,16490,9500,1,00116,India
138017,2024-01-06,505,oven,18490,24000,5510,1,00130,India
138017,2024-01-06,507,washing machine,6990,16490,9500,1,00130,India
138017,2024-01-06,506,monitor,3249,8000,4751,1,00130,India
138017,2024-01-06,503,mixer,1349,3249,1900,1,00130,India
432132,2024-01-06,504,iron,449,879,430,1,00130,India
432132,2024-01-06,506,monitor,3249,8000,4751,1,00130,India
849105,2024-01-06,505,oven,18490,24000,5510,1,00175,India
849105,2024-01-06,502,iphone 15 pro max,100000,135000,35000,1,00175,India
849105,2024-01-06,506,monitor,3249,8000,4751,1,00175,India
529751,2024-01-06,501,iphone 15,60000,80000,20000,1,00403,India
529751,2024-01-06,506,monitor,3249,8000,4751,1,00403,India
183417,2024-01-06,502,iphone 15 pro max,100000,135000,35000,1,00054,India
585306,2024-01-06,501,iphone 15,60000,80000,20000,1,00261,India
585306,2024-01-06,504,iron,449,879,430,1,00261,India
585306,2024-01-06,507,washing machine,6990,16490,9500,1,00261,India
566675,2024-01-06,503,mixer,1349,3249,1900,1,00439,India
365849,2024-01-06,506,monitor,3249,8000,4751,1,00362,India
365849,2024-01-06,503,mixer,1349,3249,1900,1,00362,India
365849,2024-01-06,505,oven,18490,24000,5510,1,00362,India
393802,2024-01-06,504,iron,449,879,430,1,00205,India
393802,2024-01-06,501,iphone 15,60000,80000,20000,1,00205,India
393802,2024-01-06,502,iphone 15 pro max,100000,135000,35000,1,00205,India
191027,2024-01-06,506,monitor,3249,8000,4751,1,00302,India
719807,2024-01-06,504,iron,449,879,430,1,00409,India
719807,2024-01-06,502,iphone 15 pro max,100000,135000,35000,1,00409,India
836470,2024-01-06,503,mixer,1349,3249,1900,1,00085,India
836470,2024-01-06,501,iphone 15,60000,80000,20000,1,00085,India
836470,2024-01-06,505,oven,18490,24000,5510,1,00085,India
836470,2024-01-06,504,iron,449,879,430,1,00085,India
578882,2024-01-06,505,oven,18490,24000,5510,1,00089,India
578882,2024-01-06,502,iphone 15 pro max,100000,135000,35000,1,00089,India
578882,2024-01-06,503,mixer,1349,3249,1900,1,00089,India
578882,2024-01-06,507,washing machine,6990,16490,9500,1,00089,India
858568,2024-01-06,506,monitor,3249,8000,4751,1,00107,India
858568,2024-01-06,504,iron,449,879,430,1,00107,India
858568,2024-01-06,501,iphone 15,60000,80000,20000,1,00107,India
238831,2024-01-06,505,oven,18490,24000,5510,1,00204,India
238831,2024-01-06,507,washing machine,6990,16490,9500,1,00204,India
238831,2024-01-06,506,monitor,3249,8000,4751,1,00204,India
238831,2024-01-06,503,mixer,1349,3249,1900,1,00204,India
338965,2024-01-06,506,monitor,3249,8000,4751,1,00008,India
338965,2024-01-06,505,oven,18490,24000,5510,1,00008,India
338965,2024-01-06,503,mixer,1349,3249,1900,1,00008,India
338965,2024-01-06,502,iphone 15 pro max,100000,135000,35000,1,00008,India
338965,2024-01-06,501,iphone 15,60000,80000,20000,1,00008,India
715779,2024-01-06,505,oven,18490,24000,5510,1,00297,India
166547,2024-01-06,506,monitor,3249,8000,4751,1,00190,India
166547,2024-01-06,504,iron,449,879,430,1,00190,India
166547,2024-01-06,507,washing machine,6990,16490,9500,1,00190,India
630201,2024-01-06,506,monitor,3249,8000,4751,1,00194,India
630201,2024-01-06,502,iphone 15 pro max,100000,135000,35000,1,00194,India
630201,2024-01-06,507,washing machine,6990,16490,9500,1,00194,India
144325,2024-01-06,507,washing machine,6990,16490,9500,1,00200,India
144325,2024-01-06,502,iphone 15 pro max,100000,135000,35000,1,00200,India
144325,2024-01-06,506,monitor,3249,8000,4751,1,00200,India
144325,2024-01-06,503,mixer,1349,3249,1900,1,00200,India
455192,2024-01-06,507,washing machine,6990,16490,9500,1,00336,India
455192,2024-01-06,505,oven,18490,24000,5510,1,00336,India
567295,2024-01-06,505,oven,18490,24000,5510,1,00247,India
567295,2024-01-06,506,monitor,3249,8000,4751,1,00247,India
567295,2024-01-06,501,iphone 15,60000,80000,20000,1,00247,India
271706,2024-01-06,501,iphone 15,60000,80000,20000,1,00249,India
271706,2024-01-06,504,iron,449,879,430,1,00249,India
271706,2024-01-06,507,washing machine,6990,16490,9500,1,00249,India
876195,2024-01-06,503,mixer,1349,3249,1900,1,00344,India
876195,2024-01-06,504,iron,449,879,430,1,00344,India
876195,2024-01-06,501,iphone 15,60000,80000,20000,1,00344,India
876195,2024-01-06,502,iphone 15 pro max,100000,135000,35000,1,00344,India
432175,2024-01-06,506,monitor,3249,8000,4751,1,00122,India
432175,2024-01-06,504,iron,449,879,430,1,00122,India
432175,2024-01-06,503,mixer,1349,3249,1900,1,00122,India
406105,2024-01-06,505,oven,18490,24000,5510,1,00172,India
406105,2024-01-06,506,monitor,3249,8000,4751,1,00172,India
949426,2024-01-06,502,iphone 15 pro max,100000,135000,35000,1,00056,India
949426,2024-01-06,507,washing machine,6990,16490,9500,1,00056,India
949426,2024-01-06,504,iron,449,879,430,1,00056,India
896708,2024-01-06,506,monitor,3249,8000,4751,1,00141,India
896708,2024-01-06,502,iphone 15 pro max,100000,135000,35000,1,00141,India
896708,2024-01-06,504,iron,449,879,430,1,00141,India
930611,2024-01-06,506,monitor,3249,8000,4751,1,00153,India
930611,2024-01-06,504,iron,449,879,430,1,00153,India
930611,2024-01-06,507,washing machine,6990,16490,9500,1,00153,India
614237,2024-01-06,503,mixer,1349,3249,1900,1,00203,India
614237,2024-01-06,506,monitor,3249,8000,4751,1,00203,India
614237,2024-01-06,502,iphone 15 pro max,100000,135000,35000,1,00203,India
875746,2024-01-06,501,iphone 15,60000,80000,20000,1,00275,India
875746,2024-01-06,503,mixer,1349,3249,1900,1,00275,India
875746,2024-01-06,502,iphone 15 pro max,100000,135000,35000,1,00275,India
293947,2024-01-06,501,iphone 15,60000,80000,20000,1,00313,India
293947,2024-01-06,505,oven,18490,24000,5510,1,00313,India
293947,2024-01-06,507,washing machine,6990,16490,9500,1,00313,India
421275,2024-01-06,502,iphone 15 pro max,100000,135000,35000,1,00142,India
687772,2024-01-06,507,washing machine,6990,16490,9500,1,00345,India
646097,2024-01-06,506,monitor,3249,8000,4751,1,00399,India
646097,2024-01-06,507,washing machine,6990,16490,9500,1,00399,India
646097,2024-01-06,501,iphone 15,60000,80000,20000,1,00399,India
408743,2024-01-06,506,monitor,3249,8000,4751,1,00183,India
774703,2024-01-06,504,iron,449,879,430,1,00120,India
774703,2024-01-06,506,monitor,3249,8000,4751,1,00120,India
704144,2024-01-06,507,washing machine,6990,16490,9500,1,00403,India
704144,2024-01-06,504,iron,449,879,430,1,00403,India
704144,2024-01-06,506,monitor,3249,8000,4751,1,00403,India
704144,2024-01-06,502,iphone 15 pro max,100000,135000,35000,1,00403,India
704144,2024-01-06,505,oven,18490,24000,5510,1,00403,India
566587,2024-01-06,502,iphone 15 pro max,100000,135000,35000,1,00106,India
566587,2024-01-06,505,oven,18490,24000,5510,1,00106,India
566587,2024-01-06,507,washing machine,6990,16490,9500,1,00106,India
403283,2024-01-06,504,iron,449,879,430,1,00337,India
403283,2024-01-06,503,mixer,1349,3249,1900,1,00337,India
403283,2024-01-06,502,iphone 15 pro max,100000,135000,35000,1,00337,India
403283,2024-01-06,506,monitor,3249,8000,4751,1,00337,India
137206,2024-01-06,506,monitor,3249,8000,4751,1,00228,India
137206,2024-01-06,504,iron,449,879,430,1,00228,India
137206,2024-01-06,503,mixer,1349,3249,1900,1,00228,India
137206,2024-01-06,507,washing machine,6990,16490,9500,1,00228,India
759067,2024-01-06,503,mixer,1349,3249,1900,1,00281,India
542890,2024-01-06,504,iron,449,879,430,1,00492,India
542890,2024-01-06,503,mixer,1349,3249,1900,1,00492,India
542890,2024-01-06,507,washing machine,6990,16490,9500,1,00492,India
542890,2024-01-06,505,oven,18490,24000,5510,1,00492,India
292471,2024-01-06,507,washing machine,6990,16490,9500,1,00461,India
292471,2024-01-06,505,oven,18490,24000,5510,1,00461,India
756273,2024-01-06,506,monitor,3249,8000,4751,1,00216,India
756273,2024-01-06,503,mixer,1349,3249,1900,1,00216,India
756273,2024-01-06,502,iphone 15 pro max,100000,135000,35000,1,00216,India
612392,2024-01-06,506,monitor,3249,8000,4751,1,00290,India
948350,2024-01-06,507,washing machine,6990,16490,9500,1,00428,India
948350,2024-01-06,503,mixer,1349,3249,1900,1,00428,India
982865,2024-01-06,504,iron,449,879,430,1,00011,India
982865,2024-01-06,502,iphone 15 pro max,100000,135000,35000,1,00011,India
982865,2024-01-06,507,washing machine,6990,16490,9500,1,00011,India
982865,2024-01-06,506,monitor,3249,8000,4751,1,00011,India
999990,2024-01-06,505,oven,18490,24000,5510,1,00254,India
195206,2024-01-07,501,iphone 15,60000,80000,20000,1,00156,India
195206,2024-01-07,506,monitor,3249,8000,4751,1,00156,India
683768,2024-01-07,501,iphone 15,60000,80000,20000,1,00256,India
522813,2024-01-07,502,iphone 15 pro max,100000,135000,35000,1,00404,India
522813,2024-01-07,503,mixer,1349,3249,1900,1,00404,India
522813,2024-01-07,506,monitor,3249,8000,4751,1,00404,India
598100,2024-01-07,505,oven,18490,24000,5510,1,00131,India
598100,2024-01-07,504,iron,449,879,430,1,00131,India
598100,2024-01-07,501,iphone 15,60000,80000,20000,1,00131,India
598100,2024-01-07,506,monitor,3249,8000,4751,1,00131,India
535023,2024-01-07,506,monitor,3249,8000,4751,1,00189,India
535023,2024-01-07,507,washing machine,6990,16490,9500,1,00189,India
535023,2024-01-07,502,iphone 15 pro max,100000,135000,35000,1,00189,India
535023,2024-01-07,504,iron,449,879,430,1,00189,India
437423,2024-01-07,503,mixer,1349,3249,1900,1,00282,India
939287,2024-01-07,504,iron,449,879,430,1,00271,India
210583,2024-01-07,502,iphone 15 pro max,100000,135000,35000,1,00149,India
210583,2024-01-07,507,washing machine,6990,16490,9500,1,00149,India
210583,2024-01-07,504,iron,449,879,430,1,00149,India
210583,2024-01-07,503,mixer,1349,3249,1900,1,00149,India
481250,2024-01-07,504,iron,449,879,430,1,00296,India
481250,2024-01-07,505,oven,18490,24000,5510,1,00296,India
212603,2024-01-07,501,iphone 15,60000,80000,20000,1,00153,India
212603,2024-01-07,507,washing machine,6990,16490,9500,1,00153,India
212603,2024-01-07,506,monitor,3249,8000,4751,1,00153,India
212603,2024-01-07,505,oven,18490,24000,5510,1,00153,India
356598,2024-01-07,507,washing machine,6990,16490,9500,1,00394,India
356598,2024-01-07,501,iphone 15,60000,80000,20000,1,00394,India
356598,2024-01-07,505,oven,18490,24000,5510,1,00394,India
171521,2024-01-07,501,iphone 15,60000,80000,20000,1,00289,India
171521,2024-01-07,503,mixer,1349,3249,1900,1,00289,India
171521,2024-01-07,506,monitor,3249,8000,4751,1,00289,India
174613,2024-01-07,503,mixer,1349,3249,1900,1,00317,India
174613,2024-01-07,506,monitor,3249,8000,4751,1,00317,India
420093,2024-01-07,507,washing machine,6990,16490,9500,1,00104,India
420093,2024-01-07,502,iphone 15 pro max,100000,135000,35000,1,00104,India
420093,2024-01-07,503,mixer,1349,3249,1900,1,00104,India
420093,2024-01-07,505,oven,18490,24000,5510,1,00104,India
157623,2024-01-07,504,iron,449,879,430,1,00194,India
775550,2024-01-07,504,iron,449,879,430,1,00097,India
775550,2024-01-07,506,monitor,3249,8000,4751,1,00097,India
775550,2024-01-07,503,mixer,1349,3249,1900,1,00097,India
388171,2024-01-07,503,mixer,1349,3249,1900,1,00305,India
773746,2024-01-07,506,monitor,3249,8000,4751,1,00065,India
773746,2024-01-07,503,mixer,1349,3249,1900,1,00065,India
821417,2024-01-07,505,oven,18490,24000,5510,1,00103,India
821417,2024-01-07,504,iron,449,879,430,1,00103,India
821417,2024-01-07,507,washing machine,6990,16490,9500,1,00103,India
821417,2024-01-07,506,monitor,3249,8000,4751,1,00103,India
647249,2024-01-07,503,mixer,1349,3249,1900,1,00481,India
305327,2024-01-07,506,monitor,3249,8000,4751,1,00131,India
305327,2024-01-07,507,washing machine,6990,16490,9500,1,00131,India
305327,2024-01-07,501,iphone 15,60000,80000,20000,1,00131,India
305327,2024-01-07,504,iron,449,879,430,1,00131,India
859510,2024-01-07,504,iron,449,879,430,1,00477,India
859510,2024-01-07,507,washing machine,6990,16490,9500,1,00477,India
859510,2024-01-07,503,mixer,1349,3249,1900,1,00477,India
859510,2024-01-07,506,monitor,3249,8000,4751,1,00477,India
351985,2024-01-07,504,iron,449,879,430,1,00028,India
351985,2024-01-07,505,oven,18490,24000,5510,1,00028,India
351985,2024-01-07,507,washing machine,6990,16490,9500,1,00028,India
382990,2024-01-07,501,iphone 15,60000,80000,20000,1,00082,India
382990,2024-01-07,503,mixer,1349,3249,1900,1,00082,India
843190,2024-01-07,502,iphone 15 pro max,100000,135000,35000,1,00206,India
843190,2024-01-07,505,oven,18490,24000,5510,1,00206,India
727853,2024-01-07,507,washing machine,6990,16490,9500,1,00179,India
727853,2024-01-07,501,iphone 15,60000,80000,20000,1,00179,India
510902,2024-01-07,506,monitor,3249,8000,4751,1,00296,India
510902,2024-01-07,503,mixer,1349,3249,1900,1,00296,India
510902,2024-01-07,505,oven,18490,24000,5510,1,00296,India
510902,2024-01-07,502,iphone 15 pro max,100000,135000,35000,1,00296,India
790460,2024-01-07,501,iphone 15,60000,80000,20000,1,00125,India
544474,2024-01-07,506,monitor,3249,8000,4751,1,00030,India
544474,2024-01-07,501,iphone 15,60000,80000,20000,1,00030,India
306083,2024-01-07,501,iphone 15,60000,80000,20000,1,00366,India
724215,2024-01-07,504,iron,449,879,430,1,00184,India
873568,2024-01-07,503,mixer,1349,3249,1900,1,00365,India
873568,2024-01-07,502,iphone 15 pro max,100000,135000,35000,1,00365,India
873568,2024-01-07,507,washing machine,6990,16490,9500,1,00365,India
873568,2024-01-07,506,monitor,3249,8000,4751,1,00365,India
512445,2024-01-07,503,mixer,1349,3249,1900,1,00111,India
512445,2024-01-07,502,iphone 15 pro max,100000,135000,35000,1,00111,India
512445,2024-01-07,504,iron,449,879,430,1,00111,India
512445,2024-01-07,506,monitor,3249,8000,4751,1,00111,India
544692,2024-01-07,502,iphone 15 pro max,100000,135000,35000,1,00355,India
544692,2024-01-07,505,oven,18490,24000,5510,1,00355,India
544692,2024-01-07,507,washing machine,6990,16490,9500,1,00355,India
656260,2024-01-07,503,mixer,1349,3249,1900,1,00364,India
669736,2024-01-07,504,iron,449,879,430,1,00204,India
669736,2024-01-07,506,monitor,3249,8000,4751,1,00204,India
669736,2024-01-07,503,mixer,1349,3249,1900,1,00204,India
382401,2024-01-07,505,oven,18490,24000,5510,1,00126,India
286856,2024-01-07,503,mixer,1349,3249,1900,1,00288,India
286856,2024-01-07,502,iphone 15 pro max,100000,135000,35000,1,00288,India
286856,2024-01-07,506,monitor,3249,8000,4751,1,00288,India
286856,2024-01-07,501,iphone 15,60000,80000,20000,1,00288,India
656293,2024-01-07,507,washing machine,6990,16490,9500,1,00155,India
603147,2024-01-07,507,washing machine,6990,16490,9500,1,00310,India
603147,2024-01-07,504,iron,449,879,430,1,00310,India
603147,2024-01-07,501,iphone 15,60000,80000,20000,1,00310,India
603147,2024-01-07,505,oven,18490,24000,5510,1,00310,India
603147,2024-01-07,503,mixer,1349,3249,1900,1,00310,India
652327,2024-01-07,507,washing machine,6990,16490,9500,1,00248,India
652327,2024-01-07,506,monitor,3249,8000,4751,1,00248,India
652327,2024-01-07,501,iphone 15,60000,80000,20000,1,00248,India
652327,2024-01-07,505,oven,18490,24000,5510,1,00248,India
652327,2024-01-07,502,iphone 15 pro max,100000,135000,35000,1,00248,India
282845,2024-01-07,505,oven,18490,24000,5510,1,00366,India
282845,2024-01-07,507,washing machine,6990,16490,9500,1,00366,India
421326,2024-01-07,504,iron,449,879,430,1,00296,India
421326,2024-01-07,507,washing machine,6990,16490,9500,1,00296,India
421326,2024-01-07,501,iphone 15,60000,80000,20000,1,00296,India
310561,2024-01-07,504,iron,449,879,430,1,00273,India
310561,2024-01-07,502,iphone 15 pro max,100000,135000,35000,1,00273,India
157575,2024-01-07,503,mixer,1349,3249,1900,1,00362,India
157575,2024-01-07,507,washing machine,6990,16490,9500,1,00362,India
157575,2024-01-07,506,monitor,3249,8000,4751,1,00362,India
749764,2024-01-07,503,mixer,1349,3249,1900,1,00454,India
749764,2024-01-07,505,oven,18490,24000,5510,1,00454,India
946113,2024-01-07,506,monitor,3249,8000,4751,1,00204,India
946113,2024-01-07,507,washing machine,6990,16490,9500,1,00204,India
398444,2024-01-07,507,washing machine,6990,16490,9500,1,00344,India
398444,2024-01-07,504,iron,449,879,430,1,00344,India
444085,2024-01-07,505,oven,18490,24000,5510,1,00454,India
444085,2024-01-07,503,mixer,1349,3249,1900,1,00454,India
444085,2024-01-07,507,washing machine,6990,16490,9500,1,00454,India
889243,2024-01-07,504,iron,449,879,430,1,00269,India
889243,2024-01-07,501,iphone 15,60000,80000,20000,1,00269,India
889243,2024-01-07,507,washing machine,6990,16490,9500,1,00269,India
821114,2024-01-07,506,monitor,3249,8000,4751,1,00420,India
821114,2024-01-07,505,oven,18490,24000,5510,1,00420,India
434390,2024-01-07,502,iphone 15 pro max,100000,135000,35000,1,00259,India
434390,2024-01-07,507,washing machine,6990,16490,9500,1,00259,India
470336,2024-01-07,502,iphone 15 pro max,100000,135000,35000,1,00170,India
470336,2024-01-07,505,oven,18490,24000,5510,1,00170,India
470336,2024-01-07,501,iphone 15,60000,80000,20000,1,00170,India
209405,2024-01-07,505,oven,18490,24000,5510,1,00126,India
209405,2024-01-07,506,monitor,3249,8000,4751,1,00126,India
209405,2024-01-07,507,washing machine,6990,16490,9500,1,00126,India
874213,2024-01-07,502,iphone 15 pro max,100000,135000,35000,1,00159,India
874213,2024-01-07,504,iron,449,879,430,1,00159,India
874213,2024-01-07,503,mixer,1349,3249,1900,1,00159,India
874213,2024-01-07,505,oven,18490,24000,5510,1,00159,India
215287,2024-01-07,502,iphone 15 pro max,100000,135000,35000,1,00054,India
215287,2024-01-07,504,iron,449,879,430,1,00054,India
215287,2024-01-07,507,washing machine,6990,16490,9500,1,00054,India
350948,2024-01-07,501,iphone 15,60000,80000,20000,1,00339,India
350948,2024-01-07,503,mixer,1349,3249,1900,1,00339,India
350948,2024-01-07,505,oven,18490,24000,5510,1,00339,India
350948,2024-01-07,502,iphone 15 pro max,100000,135000,35000,1,00339,India
122304,2024-01-07,501,iphone 15,60000,80000,20000,1,00207,India
122304,2024-01-07,506,monitor,3249,8000,4751,1,00207,India
122304,2024-01-07,502,iphone 15 pro max,100000,135000,35000,1,00207,India
165110,2024-01-07,503,mixer,1349,3249,1900,1,00265,India
165110,2024-01-07,506,monitor,3249,8000,4751,1,00265,India
165110,2024-01-07,507,washing machine,6990,16490,9500,1,00265,India
165110,2024-01-07,501,iphone 15,60000,80000,20000,1,00265,India
718826,2024-01-07,501,iphone 15,60000,80000,20000,1,00308,India
718826,2024-01-07,507,washing machine,6990,16490,9500,1,00308,India
752777,2024-01-07,501,iphone 15,60000,80000,20000,1,00270,India
752777,2024-01-07,503,mixer,1349,3249,1900,1,00270,India
290528,2024-01-07,505,oven,18490,24000,5510,1,00495,India
290528,2024-01-07,506,monitor,3249,8000,4751,1,00495,India
290528,2024-01-07,504,iron,449,879,430,1,00495,India
679609,2024-01-07,505,oven,18490,24000,5510,1,00177,India
679609,2024-01-07,504,iron,449,879,430,1,00177,India
679609,2024-01-07,502,iphone 15 pro max,100000,135000,35000,1,00177,India
960396,2024-01-07,507,washing machine,6990,16490,9500,1,00034,India
960396,2024-01-07,501,iphone 15,60000,80000,20000,1,00034,India
960396,2024-01-07,503,mixer,1349,3249,1900,1,00034,India
793650,2024-01-07,502,iphone 15 pro max,100000,135000,35000,1,00363,India
793650,2024-01-07,503,mixer,1349,3249,1900,1,00363,India
793650,2024-01-07,506,monitor,3249,8000,4751,1,00363,India
793650,2024-01-07,505,oven,18490,24000,5510,1,00363,India
793650,2024-01-07,507,washing machine,6990,16490,9500,1,00363,India
452097,2024-01-07,502,iphone 15 pro max,100000,135000,35000,1,00193,India
452097,2024-01-07,501,iphone 15,60000,80000,20000,1,00193,India
452097,2024-01-07,503,mixer,1349,3249,1900,1,00193,India
775522,2024-01-07,502,iphone 15 pro max,100000,135000,35000,1,00280,India
775522,2024-01-07,503,mixer,1349,3249,1900,1,00280,India
775522,2024-01-07,505,oven,18490,24000,5510,1,00280,India
210724,2024-01-07,506,monitor,3249,8000,4751,1,00016,India
210724,2024-01-07,501,iphone 15,60000,80000,20000,1,00016,India
766703,2024-01-07,504,iron,449,879,430,1,00166,India
766703,2024-01-07,503,mixer,1349,3249,1900,1,00166,India
801025,2024-01-07,507,washing machine,6990,16490,9500,1,00409,India
801025,2024-01-07,506,monitor,3249,8000,4751,1,00409,India
801025,2024-01-07,501,iphone 15,60000,80000,20000,1,00409,India
186675,2024-01-07,502,iphone 15 pro max,100000,135000,35000,1,00226,India
662535,2024-01-07,503,mixer,1349,3249,1900,1,00215,India
369738,2024-01-07,506,monitor,3249,8000,4751,1,00109,India
369738,2024-01-07,501,iphone 15,60000,80000,20000,1,00109,India
823164,2024-01-07,506,monitor,3249,8000,4751,1,00302,India
823164,2024-01-07,505,oven,18490,24000,5510,1,00302,India
823164,2024-01-07,507,washing machine,6990,16490,9500,1,00302,India
701379,2024-01-07,503,mixer,1349,3249,1900,1,00043,India
701379,2024-01-07,501,iphone 15,60000,80000,20000,1,00043,India
950178,2024-01-07,505,oven,18490,24000,5510,1,00133,India
138851,2024-01-08,507,washing machine,6990,16490,9500,1,00103,India
791436,2024-01-08,501,iphone 15,60000,80000,20000,1,00293,India
791436,2024-01-08,507,washing machine,6990,16490,9500,1,00293,India
791436,2024-01-08,503,mixer,1349,3249,1900,1,00293,India
791436,2024-01-08,505,oven,18490,24000,5510,1,00293,India
281468,2024-01-08,507,washing machine,6990,16490,9500,1,00143,India
281468,2024-01-08,503,mixer,1349,3249,1900,1,00143,India
281468,2024-01-08,504,iron,449,879,430,1,00143,India
281468,2024-01-08,505,oven,18490,24000,5510,1,00143,India
225836,2024-01-08,507,washing machine,6990,16490,9500,1,00029,India
211183,2024-01-08,502,iphone 15 pro max,100000,135000,35000,1,00421,India
211183,2024-01-08,504,iron,449,879,430,1,00421,India
211183,2024-01-08,506,monitor,3249,8000,4751,1,00421,India
860056,2024-01-08,501,iphone 15,60000,80000,20000,1,00318,India
860056,2024-01-08,503,mixer,1349,3249,1900,1,00318,India
860056,2024-01-08,502,iphone 15 pro max,100000,135000,35000,1,00318,India
117558,2024-01-08,501,iphone 15,60000,80000,20000,1,00423,India
896425,2024-01-08,503,mixer,1349,3249,1900,1,00081,India
936502,2024-01-08,505,oven,18490,24000,5510,1,00436,India
936502,2024-01-08,502,iphone 15 pro max,100000,135000,35000,1,00436,India
936502,2024-01-08,501,iphone 15,60000,80000,20000,1,00436,India
936502,2024-01-08,504,iron,449,879,430,1,00436,India
985257,2024-01-08,502,iphone 15 pro max,100000,135000,35000,1,00319,India
985257,2024-01-08,505,oven,18490,24000,5510,1,00319,India
985257,2024-01-08,503,mixer,1349,3249,1900,1,00319,India
484200,2024-01-08,502,iphone 15 pro max,100000,135000,35000,1,00356,India
484200,2024-01-08,501,iphone 15,60000,80000,20000,1,00356,India
826384,2024-01-08,506,monitor,3249,8000,4751,1,00244,India
826384,2024-01-08,507,washing machine,6990,16490,9500,1,00244,India
826384,2024-01-08,503,mixer,1349,3249,1900,1,00244,India
826384,2024-01-08,502,iphone 15 pro max,100000,135000,35000,1,00244,India
439163,2024-01-08,505,oven,18490,24000,5510,1,00183,India
439163,2024-01-08,507,washing machine,6990,16490,9500,1,00183,India
439163,2024-01-08,504,iron,449,879,430,1,00183,India
996131,2024-01-08,504,iron,449,879,430,1,00395,India
996131,2024-01-08,507,washing machine,6990,16490,9500,1,00395,India
996131,2024-01-08,501,iphone 15,60000,80000,20000,1,00395,India
201769,2024-01-08,502,iphone 15 pro max,100000,135000,35000,1,00159,India
524623,2024-01-08,501,iphone 15,60000,80000,20000,1,00500,India
524623,2024-01-08,503,mixer,1349,3249,1900,1,00500,India
684541,2024-01-08,506,monitor,3249,8000,4751,1,00095,India
684541,2024-01-08,501,iphone 15,60000,80000,20000,1,00095,India
426744,2024-01-08,502,iphone 15 pro max,100000,135000,35000,1,00308,India
426744,2024-01-08,501,iphone 15,60000,80000,20000,1,00308,India
133049,2024-01-08,501,iphone 15,60000,80000,20000,1,00157,India
133049,2024-01-08,503,mixer,1349,3249,1900,1,00157,India
759110,2024-01-08,504,iron,449,879,430,1,00376,India
713981,2024-01-08,504,iron,449,879,430,1,00121,India
713981,2024-01-08,503,mixer,1349,3249,1900,1,00121,India
713981,2024-01-08,505,oven,18490,24000,5510,1,00121,India
274913,2024-01-08,502,iphone 15 pro max,100000,135000,35000,1,00334,India
274913,2024-01-08,507,washing machine,6990,16490,9500,1,00334,India
109894,2024-01-08,507,washing machine,6990,16490,9500,1,00489,India
347769,2024-01-08,503,mixer,1349,3249,1900,1,00383,India
904383,2024-01-08,502,iphone 15 pro max,100000,135000,35000,1,00407,India
904383,2024-01-08,505,oven,18490,24000,5510,1,00407,India
618923,2024-01-08,505,oven,18490,24000,5510,1,00018,India
379760,2024-01-08,503,mixer,1349,3249,1900,1,00148,India
379760,2024-01-08,507,washing machine,6990,16490,9500,1,00148,India
379760,2024-01-08,502,iphone 15 pro max,100000,135000,35000,1,00148,India
269512,2024-01-08,507,washing machine,6990,16490,9500,1,00101,India
269512,2024-01-08,505,oven,18490,24000,5510,1,00101,India
321526,2024-01-08,501,iphone 15,60000,80000,20000,1,00097,India
321526,2024-01-08,502,iphone 15 pro max,100000,135000,35000,1,00097,India
690205,2024-01-08,504,iron,449,879,430,1,00416,India
690205,2024-01-08,501,iphone 15,60000,80000,20000,1,00416,India
690205,2024-01-08,503,mixer,1349,3249,1900,1,00416,India
690205,2024-01-08,507,washing machine,6990,16490,9500,1,00416,India
577059,2024-01-08,502,iphone 15 pro max,100000,135000,35000,1,00134,India
577059,2024-01-08,504,iron,449,879,430,1,00134,India
577059,2024-01-08,506,monitor,3249,8000,4751,1,00134,India
903878,2024-01-08,503,mixer,1349,3249,1900,1,00013,India
903878,2024-01-08,506,monitor,3249,8000,4751,1,00013,India
630283,2024-01-08,501,iphone 15,60000,80000,20000,1,00292,India
630283,2024-01-08,503,mixer,1349,3249,1900,1,00292,India
799623,2024-01-08,501,iphone 15,60000,80000,20000,1,00046,India
799623,2024-01-08,503,mixer,1349,3249,1900,1,00046,India
799623,2024-01-08,502,iphone 15 pro max,100000,135000,35000,1,00046,India
799623,2024-01-08,506,monitor,3249,8000,4751,1,00046,India
799623,2024-01-08,505,oven,18490,24000,5510,1,00046,India
620665,2024-01-08,505,oven,18490,24000,5510,1,00143,India
620665,2024-01-08,506,monitor,3249,8000,4751,1,00143,India
620665,2024-01-08,507,washing machine,6990,16490,9500,1,00143,India
620665,2024-01-08,502,iphone 15 pro max,100000,135000,35000,1,00143,India
461229,2024-01-08,507,washing machine,6990,16490,9500,1,00495,India
461229,2024-01-08,501,iphone 15,60000,80000,20000,1,00495,India
710034,2024-01-08,505,oven,18490,24000,5510,1,00277,India
710034,2024-01-08,502,iphone 15 pro max,100000,135000,35000,1,00277,India
960509,2024-01-08,502,iphone 15 pro max,100000,135000,35000,1,00295,India
960509,2024-01-08,504,iron,449,879,430,1,00295,India
805240,2024-01-08,501,iphone 15,60000,80000,20000,1,00099,India
805240,2024-01-08,502,iphone 15 pro max,100000,135000,35000,1,00099,India
805240,2024-01-08,505,oven,18490,24000,5510,1,00099,India
805240,2024-01-08,503,mixer,1349,3249,1900,1,00099,India
702556,2024-01-08,502,iphone 15 pro max,100000,135000,35000,1,00393,India
702556,2024-01-08,505,oven,18490,24000,5510,1,00393,India
702556,2024-01-08,506,monitor,3249,8000,4751,1,00393,India
702556,2024-01-08,504,iron,449,879,430,1,00393,India
702556,2024-01-08,503,mixer,1349,3249,1900,1,00393,India
263384,2024-01-08,507,washing machine,6990,16490,9500,1,00026,India
263384,2024-01-08,504,iron,449,879,430,1,00026,India
263384,2024-01-08,502,iphone 15 pro max,100000,135000,35000,1,00026,India
998720,2024-01-08,507,washing machine,6990,16490,9500,1,00180,India
998720,2024-01-08,501,iphone 15,60000,80000,20000,1,00180,India
998720,2024-01-08,502,iphone 15 pro max,100000,135000,35000,1,00180,India
666590,2024-01-08,507,washing machine,6990,16490,9500,1,00109,India
666590,2024-01-08,504,iron,449,879,430,1,00109,India
666590,2024-01-08,506,monitor,3249,8000,4751,1,00109,India
666590,2024-01-08,503,mixer,1349,3249,1900,1,00109,India
781398,2024-01-08,506,monitor,3249,8000,4751,1,00279,India
781398,2024-01-08,507,washing machine,6990,16490,9500,1,00279,India
149883,2024-01-08,501,iphone 15,60000,80000,20000,1,00024,India
822998,2024-01-08,503,mixer,1349,3249,1900,1,00054,India
822998,2024-01-08,501,iphone 15,60000,80000,20000,1,00054,India
965906,2024-01-08,503,mixer,1349,3249,1900,1,00325,India
965906,2024-01-08,501,iphone 15,60000,80000,20000,1,00325,India
574112,2024-01-08,505,oven,18490,24000,5510,1,00014,India
574112,2024-01-08,506,monitor,3249,8000,4751,1,00014,India
313349,2024-01-08,506,monitor,3249,8000,4751,1,00297,India
313349,2024-01-08,504,iron,449,879,430,1,00297,India
379177,2024-01-08,505,oven,18490,24000,5510,1,00394,India
379177,2024-01-08,507,washing machine,6990,16490,9500,1,00394,India
379177,2024-01-08,506,monitor,3249,8000,4751,1,00394,India
379177,2024-01-08,503,mixer,1349,3249,1900,1,00394,India
762251,2024-01-08,502,iphone 15 pro max,100000,135000,35000,1,00003,India
762251,2024-01-08,505,oven,18490,24000,5510,1,00003,India
337891,2024-01-08,506,monitor,3249,8000,4751,1,00161,India
337891,2024-01-08,501,iphone 15,60000,80000,20000,1,00161,India
337891,2024-01-08,505,oven,18490,24000,5510,1,00161,India
732798,2024-01-08,501,iphone 15,60000,80000,20000,1,00309,India
732798,2024-01-08,502,iphone 15 pro max,100000,135000,35000,1,00309,India
240066,2024-01-08,501,iphone 15,60000,80000,20000,1,00172,India
240066,2024-01-08,504,iron,449,879,430,1,00172,India
240066,2024-01-08,502,iphone 15 pro max,100000,135000,35000,1,00172,India
570550,2024-01-08,506,monitor,3249,8000,4751,1,00376,India
570550,2024-01-08,505,oven,18490,24000,5510,1,00376,India
570550,2024-01-08,502,iphone 15 pro max,100000,135000,35000,1,00376,India
570550,2024-01-08,503,mixer,1349,3249,1900,1,00376,India
163450,2024-01-08,501,iphone 15,60000,80000,20000,1,00348,India
163450,2024-01-08,507,washing machine,6990,16490,9500,1,00348,India
163450,2024-01-08,506,monitor,3249,8000,4751,1,00348,India
163450,2024-01-08,502,iphone 15 pro max,100000,135000,35000,1,00348,India
667997,2024-01-08,507,washing machine,6990,16490,9500,1,00379,India
667997,2024-01-08,501,iphone 15,60000,80000,20000,1,00379,India
667997,2024-01-08,504,iron,449,879,430,1,00379,India
926502,2024-01-08,505,oven,18490,24000,5510,1,00053,India
926502,2024-01-08,503,mixer,1349,3249,1900,1,00053,India
926502,2024-01-08,502,iphone 15 pro max,100000,135000,35000,1,00053,India
926502,2024-01-08,504,iron,449,879,430,1,00053,India
511279,2024-01-08,504,iron,449,879,430,1,00343,India
511279,2024-01-08,506,monitor,3249,8000,4751,1,00343,India
554797,2024-01-08,507,washing machine,6990,16490,9500,1,00365,India
554797,2024-01-08,502,iphone 15 pro max,100000,135000,35000,1,00365,India
565708,2024-01-08,504,iron,449,879,430,1,00218,India
400427,2024-01-08,502,iphone 15 pro max,100000,135000,35000,1,00144,India
400427,2024-01-08,501,iphone 15,60000,80000,20000,1,00144,India
910243,2024-01-08,501,iphone 15,60000,80000,20000,1,00161,India
910243,2024-01-08,502,iphone 15 pro max,100000,135000,35000,1,00161,India
910243,2024-01-08,506,monitor,3249,8000,4751,1,00161,India
910243,2024-01-08,507,washing machine,6990,16490,9500,1,00161,India
671024,2024-01-08,505,oven,18490,24000,5510,1,00046,India
671024,2024-01-08,503,mixer,1349,3249,1900,1,00046,India
407536,2024-01-08,504,iron,449,879,430,1,00244,India
407536,2024-01-08,503,mixer,1349,3249,1900,1,00244,India
472858,2024-01-08,501,iphone 15,60000,80000,20000,1,00441,India
472858,2024-01-08,507,washing machine,6990,16490,9500,1,00441,India
472858,2024-01-08,503,mixer,1349,3249,1900,1,00441,India
472858,2024-01-08,502,iphone 15 pro max,100000,135000,35000,1,00441,India
472300,2024-01-08,502,iphone 15 pro max,100000,135000,35000,1,00307,India
472300,2024-01-08,505,oven,18490,24000,5510,1,00307,India
472300,2024-01-08,503,mixer,1349,3249,1900,1,00307,India
144793,2024-01-08,507,washing machine,6990,16490,9500,1,00372,India
144793,2024-01-08,502,iphone 15 pro max,100000,135000,35000,1,00372,India
144793,2024-01-08,503,mixer,1349,3249,1900,1,00372,India
144793,2024-01-08,501,iphone 15,60000,80000,20000,1,00372,India
758312,2024-01-08,502,iphone 15 pro max,100000,135000,35000,1,00457,India
685699,2024-01-08,505,oven,18490,24000,5510,1,00497,India
994185,2024-01-08,504,iron,449,879,430,1,00477,India
994185,2024-01-08,501,iphone 15,60000,80000,20000,1,00477,India
994185,2024-01-08,503,mixer,1349,3249,1900,1,00477,India
994185,2024-01-08,506,monitor,3249,8000,4751,1,00477,India
732639,2024-01-09,504,iron,449,879,430,1,00115,India
732639,2024-01-09,501,iphone 15,60000,80000,20000,1,00115,India
732639,2024-01-09,502,iphone 15 pro max,100000,135000,35000,1,00115,India
274989,2024-01-09,503,mixer,1349,3249,1900,1,00260,India
274989,2024-01-09,504,iron,449,879,430,1,00260,India
274989,2024-01-09,502,iphone 15 pro max,100000,135000,35000,1,00260,India
753873,2024-01-09,505,oven,18490,24000,5510,1,00435,India
753873,2024-01-09,507,washing machine,6990,16490,9500,1,00435,India
753873,2024-01-09,502,iphone 15 pro max,100000,135000,35000,1,00435,India
753873,2024-01-09,506,monitor,3249,8000,4751,1,00435,India
173346,2024-01-09,501,iphone 15,60000,80000,20000,1,00049,India
173346,2024-01-09,506,monitor,3249,8000,4751,1,00049,India
173346,2024-01-09,507,washing machine,6990,16490,9500,1,00049,India
530594,2024-01-09,507,washing machine,6990,16490,9500,1,00055,India
530594,2024-01-09,506,monitor,3249,8000,4751,1,00055,India
530594,2024-01-09,501,iphone 15,60000,80000,20000,1,00055,India
530594,2024-01-09,504,iron,449,879,430,1,00055,India
530594,2024-01-09,505,oven,18490,24000,5510,1,00055,India
611864,2024-01-09,505,oven,18490,24000,5510,1,00106,India
611864,2024-01-09,501,iphone 15,60000,80000,20000,1,00106,India
611864,2024-01-09,503,mixer,1349,3249,1900,1,00106,India
692458,2024-01-09,506,monitor,3249,8000,4751,1,00186,India
692458,2024-01-09,503,mixer,1349,3249,1900,1,00186,India
440516,2024-01-09,506,monitor,3249,8000,4751,1,00268,India
440516,2024-01-09,504,iron,449,879,430,1,00268,India
804737,2024-01-09,503,mixer,1349,3249,1900,1,00062,India
769889,2024-01-09,505,oven,18490,24000,5510,1,00450,India
769889,2024-01-09,501,iphone 15,60000,80000,20000,1,00450,India
769889,2024-01-09,502,iphone 15 pro max,100000,135000,35000,1,00450,India
769889,2024-01-09,507,washing machine,6990,16490,9500,1,00450,India
242676,2024-01-09,505,oven,18490,24000,5510,1,00170,India
242676,2024-01-09,503,mixer,1349,3249,1900,1,00170,India
242676,2024-01-09,507,washing machine,6990,16490,9500,1,00170,India
242676,2024-01-09,502,iphone 15 pro max,100000,135000,35000,1,00170,India
767969,2024-01-09,506,monitor,3249,8000,4751,1,00377,India
767969,2024-01-09,502,iphone 15 pro max,100000,135000,35000,1,00377,India
767969,2024-01-09,503,mixer,1349,3249,1900,1,00377,India
516962,2024-01-09,504,iron,449,879,430,1,00228,India
516962,2024-01-09,506,monitor,3249,8000,4751,1,00228,India
516962,2024-01-09,505,oven,18490,24000,5510,1,00228,India
516962,2024-01-09,502,iphone 15 pro max,100000,135000,35000,1,00228,India
516962,2024-01-09,503,mixer,1349,3249,1900,1,00228,India
296071,2024-01-09,505,oven,18490,24000,5510,1,00405,India
867996,2024-01-09,501,iphone 15,60000,80000,20000,1,00190,India
867996,2024-01-09,506,monitor,3249,8000,4751,1,00190,India
867996,2024-01-09,503,mixer,1349,3249,1900,1,00190,India
867996,2024-01-09,502,iphone 15 pro max,100000,135000,35000,1,00190,India
326056,2024-01-09,503,mixer,1349,3249,1900,1,00086,India
326056,2024-01-09,502,iphone 15 pro max,100000,135000,35000,1,00086,India
326056,2024-01-09,504,iron,449,879,430,1,00086,India
326056,2024-01-09,506,monitor,3249,8000,4751,1,00086,India
873530,2024-01-09,505,oven,18490,24000,5510,1,00190,India
319620,2024-01-09,501,iphone 15,60000,80000,20000,1,00325,India
319620,2024-01-09,502,iphone 15 pro max,100000,135000,35000,1,00325,India
319620,2024-01-09,503,mixer,1349,3249,1900,1,00325,India
640794,2024-01-09,504,iron,449,879,430,1,00320,India
640794,2024-01-09,502,iphone 15 pro max,100000,135000,35000,1,00320,India
640794,2024-01-09,506,monitor,3249,8000,4751,1,00320,India
640794,2024-01-09,505,oven,18490,24000,5510,1,00320,India
418175,2024-01-09,505,oven,18490,24000,5510,1,00032,India
418175,2024-01-09,501,iphone 15,60000,80000,20000,1,00032,India
653897,2024-01-09,505,oven,18490,24000,5510,1,00015,India
653897,2024-01-09,507,washing machine,6990,16490,9500,1,00015,India
653897,2024-01-09,501,iphone 15,60000,80000,20000,1,00015,India
872719,2024-01-09,504,iron,449,879,430,1,00455,India
872719,2024-01-09,506,monitor,3249,8000,4751,1,00455,India
872719,2024-01-09,502,iphone 15 pro max,100000,135000,35000,1,00455,India
401756,2024-01-09,503,mixer,1349,3249,1900,1,00211,India
401756,2024-01-09,506,monitor,3249,8000,4751,1,00211,India
296751,2024-01-09,505,oven,18490,24000,5510,1,00438,India
415352,2024-01-09,504,iron,449,879,430,1,00002,India
415352,2024-01-09,506,monitor,3249,8000,4751,1,00002,India
384825,2024-01-09,507,washing machine,6990,16490,9500,1,00129,India
920957,2024-01-09,504,iron,449,879,430,1,00371,India
920957,2024-01-09,502,iphone 15 pro max,100000,135000,35000,1,00371,India
224697,2024-01-09,502,iphone 15 pro max,100000,135000,35000,1,00344,India
224697,2024-01-09,506,monitor,3249,8000,4751,1,00344,India
224697,2024-01-09,503,mixer,1349,3249,1900,1,00344,India
233419,2024-01-09,503,mixer,1349,3249,1900,1,00117,India
723634,2024-01-09,501,iphone 15,60000,80000,20000,1,00254,India
723634,2024-01-09,507,washing machine,6990,16490,9500,1,00254,India
144710,2024-01-09,506,monitor,3249,8000,4751,1,00452,India
144710,2024-01-09,503,mixer,1349,3249,1900,1,00452,India
144710,2024-01-09,504,iron,449,879,430,1,00452,India
144710,2024-01-09,501,iphone 15,60000,80000,20000,1,00452,India
275154,2024-01-09,502,iphone 15 pro max,100000,135000,35000,1,00317,India
933373,2024-01-09,507,washing machine,6990,16490,9500,1,00351,India
933373,2024-01-09,501,iphone 15,60000,80000,20000,1,00351,India
933373,2024-01-09,502,iphone 15 pro max,100000,135000,35000,1,00351,India
381293,2024-01-09,505,oven,18490,24000,5510,1,00395,India
381293,2024-01-09,502,iphone 15 pro max,100000,135000,35000,1,00395,India
398817,2024-01-09,503,mixer,1349,3249,1900,1,00448,India
398817,2024-01-09,504,iron,449,879,430,1,00448,India
398817,2024-01-09,502,iphone 15 pro max,100000,135000,35000,1,00448,India
701805,2024-01-09,505,oven,18490,24000,5510,1,00291,India
701805,2024-01-09,502,iphone 15 pro max,100000,135000,35000,1,00291,India
701805,2024-01-09,504,iron,449,879,430,1,00291,India
125525,2024-01-09,505,oven,18490,24000,5510,1,00110,India
200005,2024-01-09,502,iphone 15 pro max,100000,135000,35000,1,00418,India
200005,2024-01-09,504,iron,449,879,430,1,00418,India
200005,2024-01-09,503,mixer,1349,3249,1900,1,00418,India
468199,2024-01-09,505,oven,18490,24000,5510,1,00389,India
468199,2024-01-09,503,mixer,1349,3249,1900,1,00389,India
468199,2024-01-09,506,monitor,3249,8000,4751,1,00389,India
468199,2024-01-09,507,washing machine,6990,16490,9500,1,00389,India
812688,2024-01-09,504,iron,449,879,430,1,00381,India
219573,2024-01-09,507,washing machine,6990,16490,9500,1,00271,India
219573,2024-01-09,503,mixer,1349,3249,1900,1,00271,India
219573,2024-01-09,501,iphone 15,60000,80000,20000,1,00271,India
219573,2024-01-09,504,iron,449,879,430,1,00271,India
121052,2024-01-09,506,monitor,3249,8000,4751,1,00141,India
121052,2024-01-09,507,washing machine,6990,16490,9500,1,00141,India
121052,2024-01-09,502,iphone 15 pro max,100000,135000,35000,1,00141,India
895427,2024-01-09,507,washing machine,6990,16490,9500,1,00420,India
686683,2024-01-09,502,iphone 15 pro max,100000,135000,35000,1,00147,India
686683,2024-01-09,507,washing machine,6990,16490,9500,1,00147,India
668215,2024-01-09,504,iron,449,879,430,1,00039,India
668215,2024-01-09,502,iphone 15 pro max,100000,135000,35000,1,00039,India
158655,2024-01-09,503,mixer,1349,3249,1900,1,00372,India
158655,2024-01-09,505,oven,18490,24000,5510,1,00372,India
158655,2024-01-09,507,washing machine,6990,16490,9500,1,00372,India
158655,2024-01-09,501,iphone 15,60000,80000,20000,1,00372,India
957848,2024-01-09,506,monitor,3249,8000,4751,1,00105,India
957848,2024-01-09,507,washing machine,6990,16490,9500,1,00105,India
942916,2024-01-09,507,washing machine,6990,16490,9500,1,00476,India
942916,2024-01-09,503,mixer,1349,3249,1900,1,00476,India
942916,2024-01-09,502,iphone 15 pro max,100000,135000,35000,1,00476,India
801075,2024-01-09,506,monitor,3249,8000,4751,1,00232,India
801075,2024-01-09,504,iron,449,879,430,1,00232,India
801075,2024-01-09,501,iphone 15,60000,80000,20000,1,00232,India
801075,2024-01-09,503,mixer,1349,3249,1900,1,00232,India
602917,2024-01-09,504,iron,449,879,430,1,00378,India
824460,2024-01-09,502,iphone 15 pro max,100000,135000,35000,1,00423,India
824460,2024-01-09,505,oven,18490,24000,5510,1,00423,India
337629,2024-01-09,507,washing machine,6990,16490,9500,1,00245,India
689761,2024-01-09,505,oven,18490,24000,5510,1,00232,India
689761,2024-01-09,501,iphone 15,60000,80000,20000,1,00232,India
722672,2024-01-09,505,oven,18490,24000,5510,1,00145,India
722672,2024-01-09,501,iphone 15,60000,80000,20000,1,00145,India
247244,2024-01-09,501,iphone 15,60000,80000,20000,1,00081,India
247244,2024-01-09,503,mixer,1349,3249,1900,1,00081,India
247244,2024-01-09,507,washing machine,6990,16490,9500,1,00081,India
247244,2024-01-09,505,oven,18490,24000,5510,1,00081,India
247244,2024-01-09,506,monitor,3249,8000,4751,1,00081,India
841060,2024-01-09,506,monitor,3249,8000,4751,1,00076,India
841060,2024-01-09,505,oven,18490,24000,5510,1,00076,India
752637,2024-01-09,501,iphone 15,60000,80000,20000,1,00043,India
528865,2024-01-09,501,iphone 15,60000,80000,20000,1,00254,India
528865,2024-01-09,506,monitor,3249,8000,4751,1,00254,India
362834,2024-01-09,506,monitor,3249,8000,4751,1,00427,India
362834,2024-01-09,505,oven,18490,24000,5510,1,00427,India
607128,2024-01-09,502,iphone 15 pro max,100000,135000,35000,1,00240,India
558576,2024-01-09,502,iphone 15 pro max,100000,135000,35000,1,00303,India
167657,2024-01-09,507,washing machine,6990,16490,9500,1,00116,India
210110,2024-01-09,505,oven,18490,24000,5510,1,00260,India
210110,2024-01-09,507,washing machine,6990,16490,9500,1,00260,India
945018,2024-01-09,502,iphone 15 pro max,100000,135000,35000,1,00257,India
945018,2024-01-09,506,monitor,3249,8000,4751,1,00257,India
323625,2024-01-09,505,oven,18490,24000,5510,1,00207,India
552421,2024-01-09,502,iphone 15 pro max,100000,135000,35000,1,00046,India
552421,2024-01-09,507,washing machine,6990,16490,9500,1,00046,India
552421,2024-01-09,506,monitor,3249,8000,4751,1,00046,India
830113,2024-01-09,502,iphone 15 pro max,100000,135000,35000,1,00016,India
830113,2024-01-09,504,iron,449,879,430,1,00016,India
830113,2024-01-09,503,mixer,1349,3249,1900,1,00016,India
532583,2024-01-09,501,iphone 15,60000,80000,20000,1,00039,India
231327,2024-01-09,504,iron,449,879,430,1,00063,India
478442,2024-01-09,504,iron,449,879,430,1,00449,India
478442,2024-01-09,507,washing machine,6990,16490,9500,1,00449,India
737266,2024-01-09,507,washing machine,6990,16490,9500,1,00200,India
737266,2024-01-09,503,mixer,1349,3249,1900,1,00200,India
130098,2024-01-09,504,iron,449,879,430,1,00155,India
130098,2024-01-09,501,iphone 15,60000,80000,20000,1,00155,India
130098,2024-01-09,506,monitor,3249,8000,4751,1,00155,India
116578,2024-01-09,504,iron,449,879,430,1,00054,India
116578,2024-01-09,503,mixer,1349,3249,1900,1,00054,India
116578,2024-01-09,501,iphone 15,60000,80000,20000,1,00054,India
116578,2024-01-09,506,monitor,3249,8000,4751,1,00054,India
718971,2024-01-09,506,monitor,3249,8000,4751,1,00438,India
718971,2024-01-09,504,iron,449,879,430,1,00438,India
491928,2024-01-09,506,monitor,3249,8000,4751,1,00423,India
491928,2024-01-09,503,mixer,1349,3249,1900,1,00423,India
491928,2024-01-09,501,iphone 15,60000,80000,20000,1,00423,India
745706,2024-01-09,501,iphone 15,60000,80000,20000,1,00395,India
745706,2024-01-09,504,iron,449,879,430,1,00395,India
414481,2024-01-09,504,iron,449,879,430,1,00139,India
491212,2024-01-09,504,iron,449,879,430,1,00381,India
491212,2024-01-09,503,mixer,1349,3249,1900,1,00381,India
555092,2024-01-09,507,washing machine,6990,16490,9500,1,00171,India
555092,2024-01-09,504,iron,449,879,430,1,00171,India
779642,2024-01-09,506,monitor,3249,8000,4751,1,00353,India
779642,2024-01-09,502,iphone 15 pro max,100000,135000,35000,1,00353,India
779642,2024-01-09,501,iphone 15,60000,80000,20000,1,00353,India
618937,2024-01-09,507,washing machine,6990,16490,9500,1,00165,India
618937,2024-01-09,505,oven,18490,24000,5510,1,00165,India
618937,2024-01-09,506,monitor,3249,8000,4751,1,00165,India
335127,2024-01-09,505,oven,18490,24000,5510,1,00261,India
335127,2024-01-09,507,washing machine,6990,16490,9500,1,00261,India
335127,2024-01-09,501,iphone 15,60000,80000,20000,1,00261,India
335127,2024-01-09,502,iphone 15 pro max,100000,135000,35000,1,00261,India
335127,2024-01-09,503,mixer,1349,3249,1900,1,00261,India
121451,2024-01-09,504,iron,449,879,430,1,00170,India
121451,2024-01-09,507,washing machine,6990,16490,9500,1,00170,India
121451,2024-01-09,506,monitor,3249,8000,4751,1,00170,India
145482,2024-01-09,506,monitor,3249,8000,4751,1,00254,India
145482,2024-01-09,503,mixer,1349,3249,1900,1,00254,India
552131,2024-01-09,506,monitor,3249,8000,4751,1,00292,India
552131,2024-01-09,507,washing machine,6990,16490,9500,1,00292,India
552131,2024-01-09,504,iron,449,879,430,1,00292,India
552131,2024-01-09,501,iphone 15,60000,80000,20000,1,00292,India
844861,2024-01-09,505,oven,18490,24000,5510,1,00317,India
844861,2024-01-09,504,iron,449,879,430,1,00317,India
844861,2024-01-09,506,monitor,3249,8000,4751,1,00317,India
742959,2024-01-09,507,washing machine,6990,16490,9500,1,00256,India
367099,2024-01-09,506,monitor,3249,8000,4751,1,00423,India
367099,2024-01-09,504,iron,449,879,430,1,00423,India
367099,2024-01-09,501,iphone 15,60000,80000,20000,1,00423,India
888199,2024-01-09,505,oven,18490,24000,5510,1,00495,India
888199,2024-01-09,504,iron,449,879,430,1,00495,India
209249,2024-01-09,506,monitor,3249,8000,4751,1,00460,India
209249,2024-01-09,507,washing machine,6990,16490,9500,1,00460,India
209249,2024-01-09,503,mixer,1349,3249,1900,1,00460,India
209249,2024-01-09,501,iphone 15,60000,80000,20000,1,00460,India
799519,2024-01-09,501,iphone 15,60000,80000,20000,1,00396,India
139869,2024-01-09,505,oven,18490,24000,5510,1,00404,India
586443,2024-01-09,506,monitor,3249,8000,4751,1,00130,India
309357,2024-01-09,506,monitor,3249,8000,4751,1,00350,India
309357,2024-01-09,504,iron,449,879,430,1,00350,India
843993,2024-01-09,503,mixer,1349,3249,1900,1,00170,India
843993,2024-01-09,504,iron,449,879,430,1,00170,India
843993,2024-01-09,501,iphone 15,60000,80000,20000,1,00170,India
168902,2024-01-09,506,monitor,3249,8000,4751,1,00293,India
340418,2024-01-09,502,iphone 15 pro max,100000,135000,35000,1,00121,India
819379,2024-01-09,502,iphone 15 pro max,100000,135000,35000,1,00018,India
819379,2024-01-09,507,washing machine,6990,16490,9500,1,00018,India
272181,2024-01-09,507,washing machine,6990,16490,9500,1,00032,India
272181,2024-01-09,506,monitor,3249,8000,4751,1,00032,India
272181,2024-01-09,501,iphone 15,60000,80000,20000,1,00032,India
273229,2024-01-09,501,iphone 15,60000,80000,20000,1,00272,India
269511,2024-01-10,505,oven,18490,24000,5510,1,00335,India
269511,2024-01-10,507,washing machine,6990,16490,9500,1,00335,India
347742,2024-01-10,506,monitor,3249,8000,4751,1,00285,India
609020,2024-01-10,502,iphone 15 pro max,100000,135000,35000,1,00340,India
609020,2024-01-10,503,mixer,1349,3249,1900,1,00340,India
609020,2024-01-10,505,oven,18490,24000,5510,1,00340,India
359435,2024-01-10,505,oven,18490,24000,5510,1,00495,India
359435,2024-01-10,501,iphone 15,60000,80000,20000,1,00495,India
359435,2024-01-10,506,monitor,3249,8000,4751,1,00495,India
359435,2024-01-10,504,iron,449,879,430,1,00495,India
140166,2024-01-10,503,mixer,1349,3249,1900,1,00393,India
140166,2024-01-10,504,iron,449,879,430,1,00393,India
140166,2024-01-10,501,iphone 15,60000,80000,20000,1,00393,India
140166,2024-01-10,505,oven,18490,24000,5510,1,00393,India
720377,2024-01-10,501,iphone 15,60000,80000,20000,1,00120,India
720377,2024-01-10,502,iphone 15 pro max,100000,135000,35000,1,00120,India
741423,2024-01-10,506,monitor,3249,8000,4751,1,00425,India
741423,2024-01-10,503,mixer,1349,3249,1900,1,00425,India
741423,2024-01-10,507,washing machine,6990,16490,9500,1,00425,India
785681,2024-01-10,504,iron,449,879,430,1,00103,India
785681,2024-01-10,503,mixer,1349,3249,1900,1,00103,India
785681,2024-01-10,505,oven,18490,24000,5510,1,00103,India
785681,2024-01-10,506,monitor,3249,8000,4751,1,00103,India
282345,2024-01-10,502,iphone 15 pro max,100000,135000,35000,1,00258,India
282345,2024-01-10,507,washing machine,6990,16490,9500,1,00258,India
282345,2024-01-10,505,oven,18490,24000,5510,1,00258,India
470347,2024-01-10,501,iphone 15,60000,80000,20000,1,00319,India
883828,2024-01-10,506,monitor,3249,8000,4751,1,00069,India
990299,2024-01-10,503,mixer,1349,3249,1900,1,00018,India
990299,2024-01-10,502,iphone 15 pro max,100000,135000,35000,1,00018,India
780728,2024-01-10,504,iron,449,879,430,1,00471,India
780728,2024-01-10,505,oven,18490,24000,5510,1,00471,India
780728,2024-01-10,501,iphone 15,60000,80000,20000,1,00471,India
780728,2024-01-10,507,washing machine,6990,16490,9500,1,00471,India
324569,2024-01-10,503,mixer,1349,3249,1900,1,00415,India
324569,2024-01-10,505,oven,18490,24000,5510,1,00415,India
319262,2024-01-10,505,oven,18490,24000,5510,1,00235,India
672707,2024-01-10,504,iron,449,879,430,1,00485,India
672707,2024-01-10,507,washing machine,6990,16490,9500,1,00485,India
126099,2024-01-10,507,washing machine,6990,16490,9500,1,00208,India
456675,2024-01-10,504,iron,449,879,430,1,00176,India
290421,2024-01-10,502,iphone 15 pro max,100000,135000,35000,1,00459,India
290421,2024-01-10,501,iphone 15,60000,80000,20000,1,00459,India
290421,2024-01-10,503,mixer,1349,3249,1900,1,00459,India
290421,2024-01-10,504,iron,449,879,430,1,00459,India
309116,2024-01-10,504,iron,449,879,430,1,00491,India
309116,2024-01-10,505,oven,18490,24000,5510,1,00491,India
223631,2024-01-10,506,monitor,3249,8000,4751,1,00177,India
223631,2024-01-10,504,iron,449,879,430,1,00177,India
223631,2024-01-10,503,mixer,1349,3249,1900,1,00177,India
993091,2024-01-10,505,oven,18490,24000,5510,1,00074,India
993091,2024-01-10,506,monitor,3249,8000,4751,1,00074,India
993091,2024-01-10,504,iron,449,879,430,1,00074,India
503186,2024-01-10,506,monitor,3249,8000,4751,1,00124,India
503186,2024-01-10,505,oven,18490,24000,5510,1,00124,India
503186,2024-01-10,503,mixer,1349,3249,1900,1,00124,India
956077,2024-01-10,505,oven,18490,24000,5510,1,00236,India
956077,2024-01-10,503,mixer,1349,3249,1900,1,00236,India
956077,2024-01-10,502,iphone 15 pro max,100000,135000,35000,1,00236,India
956077,2024-01-10,506,monitor,3249,8000,4751,1,00236,India
871831,2024-01-10,505,oven,18490,24000,5510,1,00165,India
871831,2024-01-10,503,mixer,1349,3249,1900,1,00165,India
871831,2024-01-10,504,iron,449,879,430,1,00165,India
871831,2024-01-10,502,iphone 15 pro max,100000,135000,35000,1,00165,India
147916,2024-01-10,502,iphone 15 pro max,100000,135000,35000,1,00075,India
147916,2024-01-10,504,iron,449,879,430,1,00075,India
147916,2024-01-10,505,oven,18490,24000,5510,1,00075,India
542621,2024-01-10,507,washing machine,6990,16490,9500,1,00287,India
542621,2024-01-10,504,iron,449,879,430,1,00287,India
542621,2024-01-10,502,iphone 15 pro max,100000,135000,35000,1,00287,India
336778,2024-01-10,506,monitor,3249,8000,4751,1,00118,India
336778,2024-01-10,501,iphone 15,60000,80000,20000,1,00118,India
336778,2024-01-10,507,washing machine,6990,16490,9500,1,00118,India
702257,2024-01-10,506,monitor,3249,8000,4751,1,00092,India
702257,2024-01-10,503,mixer,1349,3249,1900,1,00092,India
702257,2024-01-10,502,iphone 15 pro max,100000,135000,35000,1,00092,India
421756,2024-01-10,505,oven,18490,24000,5510,1,00463,India
421756,2024-01-10,506,monitor,3249,8000,4751,1,00463,India
151200,2024-01-10,501,iphone 15,60000,80000,20000,1,00187,India
151200,2024-01-10,504,iron,449,879,430,1,00187,India
330254,2024-01-10,502,iphone 15 pro max,100000,135000,35000,1,00435,India
330254,2024-01-10,501,iphone 15,60000,80000,20000,1,00435,India
330254,2024-01-10,504,iron,449,879,430,1,00435,India
725816,2024-01-10,501,iphone 15,60000,80000,20000,1,00402,India
999557,2024-01-10,503,mixer,1349,3249,1900,1,00113,India
999557,2024-01-10,504,iron,449,879,430,1,00113,India
999557,2024-01-10,506,monitor,3249,8000,4751,1,00113,India
770669,2024-01-10,502,iphone 15 pro max,100000,135000,35000,1,00197,India
249589,2024-01-10,505,oven,18490,24000,5510,1,00326,India
249589,2024-01-10,501,iphone 15,60000,80000,20000,1,00326,India
831929,2024-01-10,504,iron,449,879,430,1,00433,India
831929,2024-01-10,507,washing machine,6990,16490,9500,1,00433,India
831929,2024-01-10,502,iphone 15 pro max,100000,135000,35000,1,00433,India
831929,2024-01-10,506,monitor,3249,8000,4751,1,00433,India
194462,2024-01-10,505,oven,18490,24000,5510,1,00271,India
194462,2024-01-10,503,mixer,1349,3249,1900,1,00271,India
194462,2024-01-10,502,iphone 15 pro max,100000,135000,35000,1,00271,India
457966,2024-01-10,504,iron,449,879,430,1,00428,India
147075,2024-01-10,506,monitor,3249,8000,4751,1,00395,India
147075,2024-01-10,501,iphone 15,60000,80000,20000,1,00395,India
202736,2024-01-10,506,monitor,3249,8000,4751,1,00116,India
202736,2024-01-10,504,iron,449,879,430,1,00116,India
202736,2024-01-10,502,iphone 15 pro max,100000,135000,35000,1,00116,India
708851,2024-01-10,503,mixer,1349,3249,1900,1,00261,India
708851,2024-01-10,502,iphone 15 pro max,100000,135000,35000,1,00261,India
708851,2024-01-10,501,iphone 15,60000,80000,20000,1,00261,India
139719,2024-01-10,506,monitor,3249,8000,4751,1,00308,India
763811,2024-01-10,507,washing machine,6990,16490,9500,1,00088,India
333269,2024-01-10,501,iphone 15,60000,80000,20000,1,00387,India
333269,2024-01-10,504,iron,449,879,430,1,00387,India
333269,2024-01-10,506,monitor,3249,8000,4751,1,00387,India
969400,2024-01-10,505,oven,18490,24000,5510,1,00377,India
969400,2024-01-10,507,washing machine,6990,16490,9500,1,00377,India
969400,2024-01-10,506,monitor,3249,8000,4751,1,00377,India
969400,2024-01-10,503,mixer,1349,3249,1900,1,00377,India
969400,2024-01-10,501,iphone 15,60000,80000,20000,1,00377,India
384329,2024-01-10,505,oven,18490,24000,5510,1,00340,India
384329,2024-01-10,501,iphone 15,60000,80000,20000,1,00340,India
384329,2024-01-10,504,iron,449,879,430,1,00340,India
384329,2024-01-10,507,washing machine,6990,16490,9500,1,00340,India
547116,2024-01-10,503,mixer,1349,3249,1900,1,00161,India
547116,2024-01-10,502,iphone 15 pro max,100000,135000,35000,1,00161,India
547116,2024-01-10,501,iphone 15,60000,80000,20000,1,00161,India
499840,2024-01-10,504,iron,449,879,430,1,00290,India
499840,2024-01-10,505,oven,18490,24000,5510,1,00290,India
499840,2024-01-10,507,washing machine,6990,16490,9500,1,00290,India
499840,2024-01-10,506,monitor,3249,8000,4751,1,00290,India
499840,2024-01-10,503,mixer,1349,3249,1900,1,00290,India
662575,2024-01-10,503,mixer,1349,3249,1900,1,00361,India
374304,2024-01-10,501,iphone 15,60000,80000,20000,1,00389,India
832944,2024-01-10,507,washing machine,6990,16490,9500,1,00131,India
847943,2024-01-10,505,oven,18490,24000,5510,1,00110,India
847943,2024-01-10,501,iphone 15,60000,80000,20000,1,00110,India
847943,2024-01-10,503,mixer,1349,3249,1900,1,00110,India
621130,2024-01-10,507,washing machine,6990,16490,9500,1,00106,India
621130,2024-01-10,504,iron,449,879,430,1,00106,India
621130,2024-01-10,502,iphone 15 pro max,100000,135000,35000,1,00106,India
197290,2024-01-10,505,oven,18490,24000,5510,1,00254,India
954354,2024-01-10,503,mixer,1349,3249,1900,1,00426,India
954354,2024-01-10,501,iphone 15,60000,80000,20000,1,00426,India
954354,2024-01-10,504,iron,449,879,430,1,00426,India
803386,2024-01-10,503,mixer,1349,3249,1900,1,00029,India
513853,2024-01-10,502,iphone 15 pro max,100000,135000,35000,1,00243,India
130491,2024-01-11,506,monitor,3249,8000,4751,1,00231,India
340757,2024-01-11,504,iron,449,879,430,1,00070,India
340757,2024-01-11,507,washing machine,6990,16490,9500,1,00070,India
750824,2024-01-11,505,oven,18490,24000,5510,1,00332,India
750824,2024-01-11,502,iphone 15 pro max,100000,135000,35000,1,00332,India
842608,2024-01-11,506,monitor,3249,8000,4751,1,00122,India
842608,2024-01-11,504,iron,449,879,430,1,00122,India
842608,2024-01-11,507,washing machine,6990,16490,9500,1,00122,India
842608,2024-01-11,503,mixer,1349,3249,1900,1,00122,India
822459,2024-01-11,507,washing machine,6990,16490,9500,1,00019,India
424947,2024-01-11,504,iron,449,879,430,1,00142,India
424947,2024-01-11,505,oven,18490,24000,5510,1,00142,India
424947,2024-01-11,507,washing machine,6990,16490,9500,1,00142,India
719868,2024-01-11,507,washing machine,6990,16490,9500,1,00312,India
719868,2024-01-11,504,iron,449,879,430,1,00312,India
700968,2024-01-11,502,iphone 15 pro max,100000,135000,35000,1,00192,India
700968,2024-01-11,503,mixer,1349,3249,1900,1,00192,India
712257,2024-01-11,501,iphone 15,60000,80000,20000,1,00199,India
168067,2024-01-11,504,iron,449,879,430,1,00062,India
168067,2024-01-11,505,oven,18490,24000,5510,1,00062,India
168067,2024-01-11,507,washing machine,6990,16490,9500,1,00062,India
168067,2024-01-11,502,iphone 15 pro max,100000,135000,35000,1,00062,India
492537,2024-01-11,507,washing machine,6990,16490,9500,1,00049,India
492537,2024-01-11,502,iphone 15 pro max,100000,135000,35000,1,00049,India
492537,2024-01-11,504,iron,449,879,430,1,00049,India
492537,2024-01-11,505,oven,18490,24000,5510,1,00049,India
492537,2024-01-11,506,monitor,3249,8000,4751,1,00049,India
391169,2024-01-11,502,iphone 15 pro max,100000,135000,35000,1,00349,India
391169,2024-01-11,506,monitor,3249,8000,4751,1,00349,India
391169,2024-01-11,504,iron,449,879,430,1,00349,India
391169,2024-01-11,503,mixer,1349,3249,1900,1,00349,India
531904,2024-01-11,507,washing machine,6990,16490,9500,1,00204,India
157559,2024-01-11,503,mixer,1349,3249,1900,1,00464,India
157559,2024-01-11,506,monitor,3249,8000,4751,1,00464,India
157559,2024-01-11,504,iron,449,879,430,1,00464,India
695318,2024-01-11,505,oven,18490,24000,5510,1,00428,India
695318,2024-01-11,501,iphone 15,60000,80000,20000,1,00428,India
695318,2024-01-11,506,monitor,3249,8000,4751,1,00428,India
695318,2024-01-11,503,mixer,1349,3249,1900,1,00428,India
650306,2024-01-11,501,iphone 15,60000,80000,20000,1,00399,India
650306,2024-01-11,506,monitor,3249,8000,4751,1,00399,India
716966,2024-01-11,505,oven,18490,24000,5510,1,00315,India
716966,2024-01-11,502,iphone 15 pro max,100000,135000,35000,1,00315,India
716966,2024-01-11,507,washing machine,6990,16490,9500,1,00315,India
485992,2024-01-11,502,iphone 15 pro max,100000,135000,35000,1,00397,India
409418,2024-01-11,502,iphone 15 pro max,100000,135000,35000,1,00311,India
409418,2024-01-11,503,mixer,1349,3249,1900,1,00311,India
409418,2024-01-11,505,oven,18490,24000,5510,1,00311,India
764510,2024-01-11,502,iphone 15 pro max,100000,135000,35000,1,00366,India
764510,2024-01-11,503,mixer,1349,3249,1900,1,00366,India
764510,2024-01-11,507,washing machine,6990,16490,9500,1,00366,India
700195,2024-01-11,503,mixer,1349,3249,1900,1,00390,India
700195,2024-01-11,504,iron,449,879,430,1,00390,India
700195,2024-01-11,505,oven,18490,24000,5510,1,00390,India
404365,2024-01-11,502,iphone 15 pro max,100000,135000,35000,1,00198,India
546680,2024-01-11,502,iphone 15 pro max,100000,135000,35000,1,00471,India
546680,2024-01-11,504,iron,449,879,430,1,00471,India
566556,2024-01-11,503,mixer,1349,3249,1900,1,00229,India
566556,2024-01-11,505,oven,18490,24000,5510,1,00229,India
528953,2024-01-11,504,iron,449,879,430,1,00355,India
528953,2024-01-11,502,iphone 15 pro max,100000,135000,35000,1,00355,India
528953,2024-01-11,503,mixer,1349,3249,1900,1,00355,India
800462,2024-01-11,505,oven,18490,24000,5510,1,00024,India
800462,2024-01-11,507,washing machine,6990,16490,9500,1,00024,India
464432,2024-01-11,507,washing machine,6990,16490,9500,1,00336,India
464432,2024-01-11,504,iron,449,879,430,1,00336,India
464432,2024-01-11,503,mixer,1349,3249,1900,1,00336,India
464432,2024-01-11,501,iphone 15,60000,80000,20000,1,00336,India
506191,2024-01-11,505,oven,18490,24000,5510,1,00166,India
305197,2024-01-11,505,oven,18490,24000,5510,1,00179,India
305197,2024-01-11,504,iron,449,879,430,1,00179,India
305197,2024-01-11,503,mixer,1349,3249,1900,1,00179,India
305197,2024-01-11,506,monitor,3249,8000,4751,1,00179,India
612230,2024-01-11,505,oven,18490,24000,5510,1,00273,India
483396,2024-01-11,504,iron,449,879,430,1,00096,India
313317,2024-01-11,506,monitor,3249,8000,4751,1,00097,India
339603,2024-01-11,506,monitor,3249,8000,4751,1,00069,India
586197,2024-01-11,501,iphone 15,60000,80000,20000,1,00407,India
586197,2024-01-11,507,washing machine,6990,16490,9500,1,00407,India
162284,2024-01-11,503,mixer,1349,3249,1900,1,00021,India
162284,2024-01-11,507,washing machine,6990,16490,9500,1,00021,India
162284,2024-01-11,504,iron,449,879,430,1,00021,India
722086,2024-01-11,505,oven,18490,24000,5510,1,00424,India
215722,2024-01-11,501,iphone 15,60000,80000,20000,1,00308,India
215722,2024-01-11,502,iphone 15 pro max,100000,135000,35000,1,00308,India
215722,2024-01-11,507,washing machine,6990,16490,9500,1,00308,India
215722,2024-01-11,503,mixer,1349,3249,1900,1,00308,India
215722,2024-01-11,505,oven,18490,24000,5510,1,00308,India
444006,2024-01-11,506,monitor,3249,8000,4751,1,00089,India
444006,2024-01-11,504,iron,449,879,430,1,00089,India
491270,2024-01-11,501,iphone 15,60000,80000,20000,1,00498,India
672198,2024-01-11,505,oven,18490,24000,5510,1,00085,India
672198,2024-01-11,502,iphone 15 pro max,100000,135000,35000,1,00085,India
672198,2024-01-11,507,washing machine,6990,16490,9500,1,00085,India
486798,2024-01-11,506,monitor,3249,8000,4751,1,00257,India
563780,2024-01-11,503,mixer,1349,3249,1900,1,00178,India
563780,2024-01-11,501,iphone 15,60000,80000,20000,1,00178,India
526081,2024-01-11,505,oven,18490,24000,5510,1,00402,India
526081,2024-01-11,501,iphone 15,60000,80000,20000,1,00402,India
219485,2024-01-11,506,monitor,3249,8000,4751,1,00427,India
219485,2024-01-11,502,iphone 15 pro max,100000,135000,35000,1,00427,India
219485,2024-01-11,505,oven,18490,24000,5510,1,00427,India
219485,2024-01-11,507,washing machine,6990,16490,9500,1,00427,India
965782,2024-01-11,505,oven,18490,24000,5510,1,00053,India
965782,2024-01-11,506,monitor,3249,8000,4751,1,00053,India
965782,2024-01-11,504,iron,449,879,430,1,00053,India
965782,2024-01-11,503,mixer,1349,3249,1900,1,00053,India
965782,2024-01-11,501,iphone 15,60000,80000,20000,1,00053,India
189033,2024-01-11,506,monitor,3249,8000,4751,1,00487,India
189033,2024-01-11,503,mixer,1349,3249,1900,1,00487,India
189033,2024-01-11,504,iron,449,879,430,1,00487,India
189033,2024-01-11,507,washing machine,6990,16490,9500,1,00487,India
571573,2024-01-11,502,iphone 15 pro max,100000,135000,35000,1,00163,India
431558,2024-01-11,502,iphone 15 pro max,100000,135000,35000,1,00095,India
422883,2024-01-11,507,washing machine,6990,16490,9500,1,00259,India
422883,2024-01-11,503,mixer,1349,3249,1900,1,00259,India
422883,2024-01-11,506,monitor,3249,8000,4751,1,00259,India
846339,2024-01-11,504,iron,449,879,430,1,00257,India
846339,2024-01-11,503,mixer,1349,3249,1900,1,00257,India
846339,2024-01-11,507,washing machine,6990,16490,9500,1,00257,India
846339,2024-01-11,502,iphone 15 pro max,100000,135000,35000,1,00257,India
374939,2024-01-11,503,mixer,1349,3249,1900,1,00437,India
374939,2024-01-11,506,monitor,3249,8000,4751,1,00437,India
374939,2024-01-11,504,iron,449,879,430,1,00437,India
412046,2024-01-11,506,monitor,3249,8000,4751,1,00312,India
430458,2024-01-11,506,monitor,3249,8000,4751,1,00231,India
430458,2024-01-11,502,iphone 15 pro max,100000,135000,35000,1,00231,India
332994,2024-01-11,505,oven,18490,24000,5510,1,00492,India
332994,2024-01-11,507,washing machine,6990,16490,9500,1,00492,India
332994,2024-01-11,506,monitor,3249,8000,4751,1,00492,India
332994,2024-01-11,501,iphone 15,60000,80000,20000,1,00492,India
332994,2024-01-11,502,iphone 15 pro max,100000,135000,35000,1,00492,India
855685,2024-01-11,507,washing machine,6990,16490,9500,1,00263,India
855685,2024-01-11,505,oven,18490,24000,5510,1,00263,India
855685,2024-01-11,503,mixer,1349,3249,1900,1,00263,India
349565,2024-01-11,503,mixer,1349,3249,1900,1,00353,India
349565,2024-01-11,501,iphone 15,60000,80000,20000,1,00353,India
349565,2024-01-11,505,oven,18490,24000,5510,1,00353,India
349565,2024-01-11,506,monitor,3249,8000,4751,1,00353,India
329696,2024-01-11,507,washing machine,6990,16490,9500,1,00245,India
329696,2024-01-11,502,iphone 15 pro max,100000,135000,35000,1,00245,India
329696,2024-01-11,506,monitor,3249,8000,4751,1,00245,India
329696,2024-01-11,503,mixer,1349,3249,1900,1,00245,India
329696,2024-01-11,501,iphone 15,60000,80000,20000,1,00245,India
650365,2024-01-11,504,iron,449,879,430,1,00229,India
650365,2024-01-11,505,oven,18490,24000,5510,1,00229,India
349975,2024-01-11,501,iphone 15,60000,80000,20000,1,00379,India
332967,2024-01-11,503,mixer,1349,3249,1900,1,00293,India
332967,2024-01-11,501,iphone 15,60000,80000,20000,1,00293,India
349252,2024-01-11,506,monitor,3249,8000,4751,1,00125,India
349252,2024-01-11,507,washing machine,6990,16490,9500,1,00125,India
349252,2024-01-11,503,mixer,1349,3249,1900,1,00125,India
349252,2024-01-11,502,iphone 15 pro max,100000,135000,35000,1,00125,India
717349,2024-01-11,501,iphone 15,60000,80000,20000,1,00433,India
717349,2024-01-11,502,iphone 15 pro max,100000,135000,35000,1,00433,India
717349,2024-01-11,503,mixer,1349,3249,1900,1,00433,India
566211,2024-01-11,505,oven,18490,24000,5510,1,00486,India
566211,2024-01-11,503,mixer,1349,3249,1900,1,00486,India
351455,2024-01-11,505,oven,18490,24000,5510,1,00084,India
351455,2024-01-11,506,monitor,3249,8000,4751,1,00084,India
351455,2024-01-11,503,mixer,1349,3249,1900,1,00084,India
620194,2024-01-11,503,mixer,1349,3249,1900,1,00403,India
620194,2024-01-11,504,iron,449,879,430,1,00403,India
620194,2024-01-11,505,oven,18490,24000,5510,1,00403,India
839456,2024-01-11,507,washing machine,6990,16490,9500,1,00345,India
839456,2024-01-11,504,iron,449,879,430,1,00345,India
839456,2024-01-11,502,iphone 15 pro max,100000,135000,35000,1,00345,India
839456,2024-01-11,505,oven,18490,24000,5510,1,00345,India
425055,2024-01-11,506,monitor,3249,8000,4751,1,00033,India
425055,2024-01-11,502,iphone 15 pro max,100000,135000,35000,1,00033,India
425055,2024-01-11,504,iron,449,879,430,1,00033,India
425055,2024-01-11,505,oven,18490,24000,5510,1,00033,India
226178,2024-01-11,505,oven,18490,24000,5510,1,00066,India
226178,2024-01-11,502,iphone 15 pro max,100000,135000,35000,1,00066,India
574820,2024-01-11,507,washing machine,6990,16490,9500,1,00211,India
574820,2024-01-11,502,iphone 15 pro max,100000,135000,35000,1,00211,India
574820,2024-01-11,501,iphone 15,60000,80000,20000,1,00211,India
322874,2024-01-11,503,mixer,1349,3249,1900,1,00044,India
322874,2024-01-11,507,washing machine,6990,16490,9500,1,00044,India
322874,2024-01-11,506,monitor,3249,8000,4751,1,00044,India
670404,2024-01-11,502,iphone 15 pro max,100000,135000,35000,1,00295,India
670404,2024-01-11,504,iron,449,879,430,1,00295,India
670404,2024-01-11,507,washing machine,6990,16490,9500,1,00295,India
699554,2024-01-11,506,monitor,3249,8000,4751,1,00231,India
699554,2024-01-11,504,iron,449,879,430,1,00231,India
330305,2024-01-11,503,mixer,1349,3249,1900,1,00496,India
518881,2024-01-11,504,iron,449,879,430,1,00002,India
518881,2024-01-11,502,iphone 15 pro max,100000,135000,35000,1,00002,India
518881,2024-01-11,501,iphone 15,60000,80000,20000,1,00002,India
492729,2024-01-12,506,monitor,3249,8000,4751,1,00407,India
492729,2024-01-12,505,oven,18490,24000,5510,1,00407,India
492729,2024-01-12,501,iphone 15,60000,80000,20000,1,00407,India
180243,2024-01-12,506,monitor,3249,8000,4751,1,00153,India
246262,2024-01-12,501,iphone 15,60000,80000,20000,1,00186,India
246262,2024-01-12,505,oven,18490,24000,5510,1,00186,India
246262,2024-01-12,504,iron,449,879,430,1,00186,India
816691,2024-01-12,504,iron,449,879,430,1,00122,India
816691,2024-01-12,505,oven,18490,24000,5510,1,00122,India
507015,2024-01-12,503,mixer,1349,3249,1900,1,00070,India
507015,2024-01-12,501,iphone 15,60000,80000,20000,1,00070,India
507015,2024-01-12,505,oven,18490,24000,5510,1,00070,India
591611,2024-01-12,503,mixer,1349,3249,1900,1,00157,India
591611,2024-01-12,504,iron,449,879,430,1,00157,India
450707,2024-01-12,506,monitor,3249,8000,4751,1,00456,India
450707,2024-01-12,503,mixer,1349,3249,1900,1,00456,India
450707,2024-01-12,502,iphone 15 pro max,100000,135000,35000,1,00456,India
191251,2024-01-12,501,iphone 15,60000,80000,20000,1,00240,India
191251,2024-01-12,503,mixer,1349,3249,1900,1,00240,India
191251,2024-01-12,507,washing machine,6990,16490,9500,1,00240,India
191251,2024-01-12,506,monitor,3249,8000,4751,1,00240,India
903636,2024-01-12,505,oven,18490,24000,5510,1,00244,India
221273,2024-01-12,506,monitor,3249,8000,4751,1,00234,India
549759,2024-01-12,503,mixer,1349,3249,1900,1,00099,India
549759,2024-01-12,507,washing machine,6990,16490,9500,1,00099,India
826226,2024-01-12,506,monitor,3249,8000,4751,1,00478,India
399541,2024-01-12,503,mixer,1349,3249,1900,1,00226,India
399541,2024-01-12,502,iphone 15 pro max,100000,135000,35000,1,00226,India
729717,2024-01-12,506,monitor,3249,8000,4751,1,00486,India
729717,2024-01-12,503,mixer,1349,3249,1900,1,00486,India
729717,2024-01-12,504,iron,449,879,430,1,00486,India
729717,2024-01-12,501,iphone 15,60000,80000,20000,1,00486,India
352858,2024-01-12,501,iphone 15,60000,80000,20000,1,00417,India
352858,2024-01-12,503,mixer,1349,3249,1900,1,00417,India
352858,2024-01-12,504,iron,449,879,430,1,00417,India
903813,2024-01-12,507,washing machine,6990,16490,9500,1,00090,India
921722,2024-01-12,505,oven,18490,24000,5510,1,00024,India
921722,2024-01-12,506,monitor,3249,8000,4751,1,00024,India
921722,2024-01-12,502,iphone 15 pro max,100000,135000,35000,1,00024,India
609000,2024-01-12,505,oven,18490,24000,5510,1,00224,India
609000,2024-01-12,506,monitor,3249,8000,4751,1,00224,India
561271,2024-01-12,507,washing machine,6990,16490,9500,1,00448,India
561271,2024-01-12,502,iphone 15 pro max,100000,135000,35000,1,00448,India
513800,2024-01-12,504,iron,449,879,430,1,00184,India
513800,2024-01-12,502,iphone 15 pro max,100000,135000,35000,1,00184,India
513800,2024-01-12,507,washing machine,6990,16490,9500,1,00184,India
365647,2024-01-12,502,iphone 15 pro max,100000,135000,35000,1,00037,India
365647,2024-01-12,505,oven,18490,24000,5510,1,00037,India
654827,2024-01-12,503,mixer,1349,3249,1900,1,00009,India
654827,2024-01-12,502,iphone 15 pro max,100000,135000,35000,1,00009,India
510168,2024-01-12,506,monitor,3249,8000,4751,1,00086,India
510168,2024-01-12,502,iphone 15 pro max,100000,135000,35000,1,00086,India
510168,2024-01-12,507,washing machine,6990,16490,9500,1,00086,India
510168,2024-01-12,505,oven,18490,24000,5510,1,00086,India
335536,2024-01-12,503,mixer,1349,3249,1900,1,00232,India
335536,2024-01-12,506,monitor,3249,8000,4751,1,00232,India
335536,2024-01-12,507,washing machine,6990,16490,9500,1,00232,India
837139,2024-01-12,507,washing machine,6990,16490,9500,1,00288,India
837139,2024-01-12,506,monitor,3249,8000,4751,1,00288,India
837139,2024-01-12,503,mixer,1349,3249,1900,1,00288,India
837139,2024-01-12,505,oven,18490,24000,5510,1,00288,India
473437,2024-01-12,506,monitor,3249,8000,4751,1,00113,India
473437,2024-01-12,502,iphone 15 pro max,100000,135000,35000,1,00113,India
463921,2024-01-12,505,oven,18490,24000,5510,1,00231,India
358215,2024-01-12,503,mixer,1349,3249,1900,1,00086,India
161169,2024-01-12,501,iphone 15,60000,80000,20000,1,00099,India
161169,2024-01-12,507,washing machine,6990,16490,9500,1,00099,India
161169,2024-01-12,504,iron,449,879,430,1,00099,India
287185,2024-01-12,503,mixer,1349,3249,1900,1,00438,India
335225,2024-01-12,505,oven,18490,24000,5510,1,00209,India
335225,2024-01-12,503,mixer,1349,3249,1900,1,00209,India
335225,2024-01-12,506,monitor,3249,8000,4751,1,00209,India
335225,2024-01-12,501,iphone 15,60000,80000,20000,1,00209,India
341892,2024-01-12,507,washing machine,6990,16490,9500,1,00481,India
341892,2024-01-12,502,iphone 15 pro max,100000,135000,35000,1,00481,India
341892,2024-01-12,504,iron,449,879,430,1,00481,India
501309,2024-01-12,501,iphone 15,60000,80000,20000,1,00364,India
501309,2024-01-12,505,oven,18490,24000,5510,1,00364,India
501309,2024-01-12,502,iphone 15 pro max,100000,135000,35000,1,00364,India
473576,2024-01-12,502,iphone 15 pro max,100000,135000,35000,1,00438,India
473576,2024-01-12,506,monitor,3249,8000,4751,1,00438,India
473576,2024-01-12,501,iphone 15,60000,80000,20000,1,00438,India
757390,2024-01-12,505,oven,18490,24000,5510,1,00124,India
757390,2024-01-12,502,iphone 15 pro max,100000,135000,35000,1,00124,India
381057,2024-01-12,502,iphone 15 pro max,100000,135000,35000,1,00411,India
381057,2024-01-12,506,monitor,3249,8000,4751,1,00411,India
381057,2024-01-12,504,iron,449,879,430,1,00411,India
536106,2024-01-12,505,oven,18490,24000,5510,1,00446,India
536106,2024-01-12,501,iphone 15,60000,80000,20000,1,00446,India
536106,2024-01-12,507,washing machine,6990,16490,9500,1,00446,India
536106,2024-01-12,506,monitor,3249,8000,4751,1,00446,India
536106,2024-01-12,503,mixer,1349,3249,1900,1,00446,India
514941,2024-01-12,504,iron,449,879,430,1,00384,India
514941,2024-01-12,502,iphone 15 pro max,100000,135000,35000,1,00384,India
514941,2024-01-12,505,oven,18490,24000,5510,1,00384,India
999284,2024-01-12,501,iphone 15,60000,80000,20000,1,00351,India
117935,2024-01-12,501,iphone 15,60000,80000,20000,1,00333,India
117935,2024-01-12,506,monitor,3249,8000,4751,1,00333,India
117935,2024-01-12,503,mixer,1349,3249,1900,1,00333,India
425970,2024-01-12,506,monitor,3249,8000,4751,1,00013,India
425970,2024-01-12,507,washing machine,6990,16490,9500,1,00013,India
201286,2024-01-12,507,washing machine,6990,16490,9500,1,00244,India
768420,2024-01-12,501,iphone 15,60000,80000,20000,1,00111,India
768420,2024-01-12,504,iron,449,879,430,1,00111,India
647954,2024-01-12,501,iphone 15,60000,80000,20000,1,00087,India
647954,2024-01-12,507,washing machine,6990,16490,9500,1,00087,India
647954,2024-01-12,502,iphone 15 pro max,100000,135000,35000,1,00087,India
647954,2024-01-12,506,monitor,3249,8000,4751,1,00087,India
647954,2024-01-12,505,oven,18490,24000,5510,1,00087,India
408008,2024-01-12,507,washing machine,6990,16490,9500,1,00044,India
408008,2024-01-12,502,iphone 15 pro max,100000,135000,35000,1,00044,India
408008,2024-01-12,505,oven,18490,24000,5510,1,00044,India
408008,2024-01-12,504,iron,449,879,430,1,00044,India
199548,2024-01-12,502,iphone 15 pro max,100000,135000,35000,1,00021,India
199548,2024-01-12,507,washing machine,6990,16490,9500,1,00021,India
199548,2024-01-12,506,monitor,3249,8000,4751,1,00021,India
129545,2024-01-12,501,iphone 15,60000,80000,20000,1,00443,India
129545,2024-01-12,506,monitor,3249,8000,4751,1,00443,India
123045,2024-01-12,501,iphone 15,60000,80000,20000,1,00408,India
123045,2024-01-12,505,oven,18490,24000,5510,1,00408,India
123045,2024-01-12,507,washing machine,6990,16490,9500,1,00408,India
300462,2024-01-12,505,oven,18490,24000,5510,1,00172,India
300462,2024-01-12,507,washing machine,6990,16490,9500,1,00172,India
300462,2024-01-12,503,mixer,1349,3249,1900,1,00172,India
428034,2024-01-12,503,mixer,1349,3249,1900,1,00078,India
428034,2024-01-12,502,iphone 15 pro max,100000,135000,35000,1,00078,India
834847,2024-01-12,506,monitor,3249,8000,4751,1,00483,India
834847,2024-01-12,507,washing machine,6990,16490,9500,1,00483,India
834847,2024-01-12,504,iron,449,879,430,1,00483,India
777218,2024-01-12,502,iphone 15 pro max,100000,135000,35000,1,00136,India
777218,2024-01-12,504,iron,449,879,430,1,00136,India
335206,2024-01-12,505,oven,18490,24000,5510,1,00322,India
335206,2024-01-12,502,iphone 15 pro max,100000,135000,35000,1,00322,India
721465,2024-01-12,506,monitor,3249,8000,4751,1,00061,India
721465,2024-01-12,501,iphone 15,60000,80000,20000,1,00061,India
721465,2024-01-12,505,oven,18490,24000,5510,1,00061,India
721465,2024-01-12,507,washing machine,6990,16490,9500,1,00061,India
866167,2024-01-12,503,mixer,1349,3249,1900,1,00169,India
866167,2024-01-12,501,iphone 15,60000,80000,20000,1,00169,India
866167,2024-01-12,505,oven,18490,24000,5510,1,00169,India
536840,2024-01-12,502,iphone 15 pro max,100000,135000,35000,1,00470,India
536840,2024-01-12,503,mixer,1349,3249,1900,1,00470,India
536840,2024-01-12,506,monitor,3249,8000,4751,1,00470,India
467356,2024-01-12,506,monitor,3249,8000,4751,1,00182,India
413710,2024-01-12,501,iphone 15,60000,80000,20000,1,00426,India
413710,2024-01-12,502,iphone 15 pro max,100000,135000,35000,1,00426,India
741415,2024-01-12,501,iphone 15,60000,80000,20000,1,00209,India
741415,2024-01-12,507,washing machine,6990,16490,9500,1,00209,India
266410,2024-01-12,502,iphone 15 pro max,100000,135000,35000,1,00106,India
311231,2024-01-12,502,iphone 15 pro max,100000,135000,35000,1,00229,India
311231,2024-01-12,507,washing machine,6990,16490,9500,1,00229,India
311231,2024-01-12,501,iphone 15,60000,80000,20000,1,00229,India
311231,2024-01-12,504,iron,449,879,430,1,00229,India
655277,2024-01-12,505,oven,18490,24000,5510,1,00101,India
655277,2024-01-12,502,iphone 15 pro max,100000,135000,35000,1,00101,India
655277,2024-01-12,507,washing machine,6990,16490,9500,1,00101,India
655277,2024-01-12,501,iphone 15,60000,80000,20000,1,00101,India
503473,2024-01-12,501,iphone 15,60000,80000,20000,1,00208,India
347350,2024-01-12,507,washing machine,6990,16490,9500,1,00358,India
347350,2024-01-12,504,iron,449,879,430,1,00358,India
347350,2024-01-12,501,iphone 15,60000,80000,20000,1,00358,India
544879,2024-01-12,504,iron,449,879,430,1,00362,India
544879,2024-01-12,502,iphone 15 pro max,100000,135000,35000,1,00362,India
544879,2024-01-12,501,iphone 15,60000,80000,20000,1,00362,India
544879,2024-01-12,506,monitor,3249,8000,4751,1,00362,India
420076,2024-01-12,501,iphone 15,60000,80000,20000,1,00191,India
420076,2024-01-12,507,washing machine,6990,16490,9500,1,00191,India
420076,2024-01-12,505,oven,18490,24000,5510,1,00191,India
812015,2024-01-12,504,iron,449,879,430,1,00013,India
812015,2024-01-12,505,oven,18490,24000,5510,1,00013,India
812015,2024-01-12,507,washing machine,6990,16490,9500,1,00013,India
241202,2024-01-12,507,washing machine,6990,16490,9500,1,00355,India
241202,2024-01-12,501,iphone 15,60000,80000,20000,1,00355,India
458147,2024-01-12,504,iron,449,879,430,1,00089,India
458147,2024-01-12,502,iphone 15 pro max,100000,135000,35000,1,00089,India
458147,2024-01-12,506,monitor,3249,8000,4751,1,00089,India
841815,2024-01-13,503,mixer,1349,3249,1900,1,00181,India
361480,2024-01-13,504,iron,449,879,430,1,00180,India
249577,2024-01-13,505,oven,18490,24000,5510,1,00474,India
249577,2024-01-13,503,mixer,1349,3249,1900,1,00474,India
249577,2024-01-13,506,monitor,3249,8000,4751,1,00474,India
104686,2024-01-13,506,monitor,3249,8000,4751,1,00189,India
104686,2024-01-13,502,iphone 15 pro max,100000,135000,35000,1,00189,India
104686,2024-01-13,505,oven,18490,24000,5510,1,00189,India
517478,2024-01-13,505,oven,18490,24000,5510,1,00481,India
517478,2024-01-13,501,iphone 15,60000,80000,20000,1,00481,India
517478,2024-01-13,507,washing machine,6990,16490,9500,1,00481,India
274610,2024-01-13,506,monitor,3249,8000,4751,1,00158,India
274610,2024-01-13,501,iphone 15,60000,80000,20000,1,00158,India
274610,2024-01-13,504,iron,449,879,430,1,00158,India
274610,2024-01-13,505,oven,18490,24000,5510,1,00158,India
580950,2024-01-13,507,washing machine,6990,16490,9500,1,00278,India
793735,2024-01-13,507,washing machine,6990,16490,9500,1,00097,India
653294,2024-01-13,502,iphone 15 pro max,100000,135000,35000,1,00234,India
653294,2024-01-13,506,monitor,3249,8000,4751,1,00234,India
653294,2024-01-13,504,iron,449,879,430,1,00234,India
542511,2024-01-13,504,iron,449,879,430,1,00351,India
542511,2024-01-13,503,mixer,1349,3249,1900,1,00351,India
216211,2024-01-13,502,iphone 15 pro max,100000,135000,35000,1,00042,India
216211,2024-01-13,507,washing machine,6990,16490,9500,1,00042,India
278672,2024-01-13,505,oven,18490,24000,5510,1,00096,India
115363,2024-01-13,501,iphone 15,60000,80000,20000,1,00218,India
115363,2024-01-13,507,washing machine,6990,16490,9500,1,00218,India
913969,2024-01-13,507,washing machine,6990,16490,9500,1,00108,India
913969,2024-01-13,504,iron,449,879,430,1,00108,India
744578,2024-01-13,506,monitor,3249,8000,4751,1,00434,India
744578,2024-01-13,502,iphone 15 pro max,100000,135000,35000,1,00434,India
542243,2024-01-13,503,mixer,1349,3249,1900,1,00039,India
542243,2024-01-13,501,iphone 15,60000,80000,20000,1,00039,India
542243,2024-01-13,502,iphone 15 pro max,100000,135000,35000,1,00039,India
223088,2024-01-13,504,iron,449,879,430,1,00098,India
223088,2024-01-13,506,monitor,3249,8000,4751,1,00098,India
345347,2024-01-13,501,iphone 15,60000,80000,20000,1,00488,India
345347,2024-01-13,503,mixer,1349,3249,1900,1,00488,India
488879,2024-01-13,505,oven,18490,24000,5510,1,00133,India
488879,2024-01-13,507,washing machine,6990,16490,9500,1,00133,India
488879,2024-01-13,502,iphone 15 pro max,100000,135000,35000,1,00133,India
899797,2024-01-13,503,mixer,1349,3249,1900,1,00177,India
899797,2024-01-13,504,iron,449,879,430,1,00177,India
899797,2024-01-13,507,washing machine,6990,16490,9500,1,00177,India
899797,2024-01-13,501,iphone 15,60000,80000,20000,1,00177,India
339843,2024-01-13,505,oven,18490,24000,5510,1,00450,India
522544,2024-01-13,501,iphone 15,60000,80000,20000,1,00403,India
409351,2024-01-13,505,oven,18490,24000,5510,1,00087,India
409351,2024-01-13,502,iphone 15 pro max,100000,135000,35000,1,00087,India
349565,2024-01-13,506,monitor,3249,8000,4751,1,00353,India
349565,2024-01-13,505,oven,18490,24000,5510,1,00353,India
349565,2024-01-13,502,iphone 15 pro max,100000,135000,35000,1,00353,India
274748,2024-01-13,507,washing machine,6990,16490,9500,1,00341,India
274748,2024-01-13,505,oven,18490,24000,5510,1,00341,India
274748,2024-01-13,501,iphone 15,60000,80000,20000,1,00341,India
274748,2024-01-13,506,monitor,3249,8000,4751,1,00341,India
836810,2024-01-13,503,mixer,1349,3249,1900,1,00123,India
836810,2024-01-13,504,iron,449,879,430,1,00123,India
836967,2024-01-13,503,mixer,1349,3249,1900,1,00444,India
836967,2024-01-13,506,monitor,3249,8000,4751,1,00444,India
836967,2024-01-13,507,washing machine,6990,16490,9500,1,00444,India
836967,2024-01-13,501,iphone 15,60000,80000,20000,1,00444,India
908807,2024-01-13,503,mixer,1349,3249,1900,1,00448,India
908807,2024-01-13,506,monitor,3249,8000,4751,1,00448,India
917730,2024-01-13,505,oven,18490,24000,5510,1,00459,India
765371,2024-01-13,504,iron,449,879,430,1,00366,India
256277,2024-01-13,503,mixer,1349,3249,1900,1,00369,India
256277,2024-01-13,505,oven,18490,24000,5510,1,00369,India
256277,2024-01-13,502,iphone 15 pro max,100000,135000,35000,1,00369,India
256277,2024-01-13,504,iron,449,879,430,1,00369,India
388794,2024-01-13,504,iron,449,879,430,1,00153,India
388794,2024-01-13,507,washing machine,6990,16490,9500,1,00153,India
388794,2024-01-13,503,mixer,1349,3249,1900,1,00153,India
579419,2024-01-13,501,iphone 15,60000,80000,20000,1,00379,India
579419,2024-01-13,503,mixer,1349,3249,1900,1,00379,India
579419,2024-01-13,505,oven,18490,24000,5510,1,00379,India
504644,2024-01-13,501,iphone 15,60000,80000,20000,1,00369,India
504644,2024-01-13,505,oven,18490,24000,5510,1,00369,India
881067,2024-01-13,506,monitor,3249,8000,4751,1,00128,India
881067,2024-01-13,501,iphone 15,60000,80000,20000,1,00128,India
881067,2024-01-13,503,mixer,1349,3249,1900,1,00128,India
722502,2024-01-13,504,iron,449,879,430,1,00006,India
722502,2024-01-13,507,washing machine,6990,16490,9500,1,00006,India
722502,2024-01-13,506,monitor,3249,8000,4751,1,00006,India
911730,2024-01-13,507,washing machine,6990,16490,9500,1,00027,India
911730,2024-01-13,506,monitor,3249,8000,4751,1,00027,India
911730,2024-01-13,502,iphone 15 pro max,100000,135000,35000,1,00027,India
376920,2024-01-13,503,mixer,1349,3249,1900,1,00388,India
376920,2024-01-13,502,iphone 15 pro max,100000,135000,35000,1,00388,India
376920,2024-01-13,506,monitor,3249,8000,4751,1,00388,India
376920,2024-01-13,505,oven,18490,24000,5510,1,00388,India
991452,2024-01-13,504,iron,449,879,430,1,00318,India
991452,2024-01-13,503,mixer,1349,3249,1900,1,00318,India
991452,2024-01-13,501,iphone 15,60000,80000,20000,1,00318,India
985571,2024-01-13,505,oven,18490,24000,5510,1,00333,India
985571,2024-01-13,506,monitor,3249,8000,4751,1,00333,India
985571,2024-01-13,502,iphone 15 pro max,100000,135000,35000,1,00333,India
805009,2024-01-13,507,washing machine,6990,16490,9500,1,00015,India
805009,2024-01-13,505,oven,18490,24000,5510,1,00015,India
805009,2024-01-13,504,iron,449,879,430,1,00015,India
805009,2024-01-13,502,iphone 15 pro max,100000,135000,35000,1,00015,India
834594,2024-01-13,502,iphone 15 pro max,100000,135000,35000,1,00215,India
834594,2024-01-13,505,oven,18490,24000,5510,1,00215,India
834594,2024-01-13,507,washing machine,6990,16490,9500,1,00215,India
834594,2024-01-13,503,mixer,1349,3249,1900,1,00215,India
812337,2024-01-13,504,iron,449,879,430,1,00353,India
812337,2024-01-13,502,iphone 15 pro max,100000,135000,35000,1,00353,India
830489,2024-01-13,501,iphone 15,60000,80000,20000,1,00361,India
830489,2024-01-13,503,mixer,1349,3249,1900,1,00361,India
989054,2024-01-13,505,oven,18490,24000,5510,1,00313,India
989054,2024-01-13,506,monitor,3249,8000,4751,1,00313,India
989054,2024-01-13,502,iphone 15 pro max,100000,135000,35000,1,00313,India
872935,2024-01-13,506,monitor,3249,8000,4751,1,00106,India
872935,2024-01-13,501,iphone 15,60000,80000,20000,1,00106,India
872935,2024-01-13,504,iron,449,879,430,1,00106,India
729150,2024-01-13,507,washing machine,6990,16490,9500,1,00076,India
729150,2024-01-13,506,monitor,3249,8000,4751,1,00076,India
108847,2024-01-13,505,oven,18490,24000,5510,1,00155,India
108847,2024-01-13,504,iron,449,879,430,1,00155,India
108847,2024-01-13,507,washing machine,6990,16490,9500,1,00155,India
784946,2024-01-13,503,mixer,1349,3249,1900,1,00227,India
784946,2024-01-13,505,oven,18490,24000,5510,1,00227,India
716820,2024-01-13,502,iphone 15 pro max,100000,135000,35000,1,00317,India
716820,2024-01-13,501,iphone 15,60000,80000,20000,1,00317,India
716820,2024-01-13,503,mixer,1349,3249,1900,1,00317,India
716820,2024-01-13,506,monitor,3249,8000,4751,1,00317,India
119920,2024-01-13,507,washing machine,6990,16490,9500,1,00073,India
119920,2024-01-13,505,oven,18490,24000,5510,1,00073,India
119920,2024-01-13,502,iphone 15 pro max,100000,135000,35000,1,00073,India
633286,2024-01-13,503,mixer,1349,3249,1900,1,00302,India
633286,2024-01-13,502,iphone 15 pro max,100000,135000,35000,1,00302,India
469170,2024-01-13,507,washing machine,6990,16490,9500,1,00207,India
469170,2024-01-13,502,iphone 15 pro max,100000,135000,35000,1,00207,India
469170,2024-01-13,501,iphone 15,60000,80000,20000,1,00207,India
469170,2024-01-13,504,iron,449,879,430,1,00207,India
420742,2024-01-13,503,mixer,1349,3249,1900,1,00457,India
420742,2024-01-13,504,iron,449,879,430,1,00457,India
420742,2024-01-13,502,iphone 15 pro max,100000,135000,35000,1,00457,India
420742,2024-01-13,507,washing machine,6990,16490,9500,1,00457,India
420742,2024-01-13,505,oven,18490,24000,5510,1,00457,India
102439,2024-01-13,504,iron,449,879,430,1,00302,India
102439,2024-01-13,501,iphone 15,60000,80000,20000,1,00302,India
102439,2024-01-13,503,mixer,1349,3249,1900,1,00302,India
998532,2024-01-13,505,oven,18490,24000,5510,1,00116,India
998532,2024-01-13,502,iphone 15 pro max,100000,135000,35000,1,00116,India
998532,2024-01-13,504,iron,449,879,430,1,00116,India
829814,2024-01-13,502,iphone 15 pro max,100000,135000,35000,1,00492,India
139257,2024-01-13,507,washing machine,6990,16490,9500,1,00369,India
299814,2024-01-13,505,oven,18490,24000,5510,1,00384,India
299814,2024-01-13,501,iphone 15,60000,80000,20000,1,00384,India
299814,2024-01-13,503,mixer,1349,3249,1900,1,00384,India
308921,2024-01-13,506,monitor,3249,8000,4751,1,00381,India
308921,2024-01-13,507,washing machine,6990,16490,9500,1,00381,India
148708,2024-01-13,503,mixer,1349,3249,1900,1,00104,India
345577,2024-01-13,506,monitor,3249,8000,4751,1,00489,India
345577,2024-01-13,503,mixer,1349,3249,1900,1,00489,India
345577,2024-01-13,505,oven,18490,24000,5510,1,00489,India
281383,2024-01-13,502,iphone 15 pro max,100000,135000,35000,1,00389,India
254690,2024-01-13,501,iphone 15,60000,80000,20000,1,00324,India
103645,2024-01-13,504,iron,449,879,430,1,00199,India
103645,2024-01-13,507,washing machine,6990,16490,9500,1,00199,India
866454,2024-01-13,507,washing machine,6990,16490,9500,1,00480,India
866454,2024-01-13,505,oven,18490,24000,5510,1,00480,India
866454,2024-01-13,502,iphone 15 pro max,100000,135000,35000,1,00480,India
315648,2024-01-13,507,washing machine,6990,16490,9500,1,00028,India
315648,2024-01-13,505,oven,18490,24000,5510,1,00028,India
747516,2024-01-13,507,washing machine,6990,16490,9500,1,00297,India
787410,2024-01-13,505,oven,18490,24000,5510,1,00363,India
787410,2024-01-13,504,iron,449,879,430,1,00363,India
935041,2024-01-13,507,washing machine,6990,16490,9500,1,00135,India
935041,2024-01-13,505,oven,18490,24000,5510,1,00135,India
749551,2024-01-13,506,monitor,3249,8000,4751,1,00120,India
457342,2024-01-13,504,iron,449,879,430,1,00270,India
457342,2024-01-13,505,oven,18490,24000,5510,1,00270,India
766313,2024-01-13,501,iphone 15,60000,80000,20000,1,00196,India
667598,2024-01-13,507,washing machine,6990,16490,9500,1,00468,India
672783,2024-01-13,504,iron,449,879,430,1,00131,India
885864,2024-01-13,505,oven,18490,24000,5510,1,00049,India
885864,2024-01-13,503,mixer,1349,3249,1900,1,00049,India
197285,2024-01-13,507,washing machine,6990,16490,9500,1,00331,India
197285,2024-01-13,504,iron,449,879,430,1,00331,India
197285,2024-01-13,501,iphone 15,60000,80000,20000,1,00331,India
197285,2024-01-13,506,monitor,3249,8000,4751,1,00331,India
197285,2024-01-13,505,oven,18490,24000,5510,1,00331,India
984588,2024-01-13,506,monitor,3249,8000,4751,1,00125,India
984588,2024-01-13,507,washing machine,6990,16490,9500,1,00125,India
984588,2024-01-13,504,iron,449,879,430,1,00125,India
150128,2024-01-13,505,oven,18490,24000,5510,1,00037,India
150128,2024-01-13,502,iphone 15 pro max,100000,135000,35000,1,00037,India
531485,2024-01-13,504,iron,449,879,430,1,00367,India
101251,2024-01-13,501,iphone 15,60000,80000,20000,1,00323,India
101251,2024-01-13,502,iphone 15 pro max,100000,135000,35000,1,00323,India
101251,2024-01-13,505,oven,18490,24000,5510,1,00323,India
873191,2024-01-13,502,iphone 15 pro max,100000,135000,35000,1,00478,India
873191,2024-01-13,504,iron,449,879,430,1,00478,India
786090,2024-01-13,501,iphone 15,60000,80000,20000,1,00220,India
711166,2024-01-14,506,monitor,3249,8000,4751,1,00360,India
711166,2024-01-14,503,mixer,1349,3249,1900,1,00360,India
552501,2024-01-14,504,iron,449,879,430,1,00139,India
589649,2024-01-14,505,oven,18490,24000,5510,1,00074,India
589649,2024-01-14,503,mixer,1349,3249,1900,1,00074,India
589649,2024-01-14,506,monitor,3249,8000,4751,1,00074,India
589649,2024-01-14,501,iphone 15,60000,80000,20000,1,00074,India
589649,2024-01-14,504,iron,449,879,430,1,00074,India
498746,2024-01-14,503,mixer,1349,3249,1900,1,00236,India
381067,2024-01-14,507,washing machine,6990,16490,9500,1,00408,India
381067,2024-01-14,504,iron,449,879,430,1,00408,India
236177,2024-01-14,505,oven,18490,24000,5510,1,00305,India
236177,2024-01-14,502,iphone 15 pro max,100000,135000,35000,1,00305,India
236177,2024-01-14,506,monitor,3249,8000,4751,1,00305,India
236177,2024-01-14,504,iron,449,879,430,1,00305,India
412241,2024-01-14,505,oven,18490,24000,5510,1,00090,India
412241,2024-01-14,501,iphone 15,60000,80000,20000,1,00090,India
412241,2024-01-14,502,iphone 15 pro max,100000,135000,35000,1,00090,India
778351,2024-01-14,502,iphone 15 pro max,100000,135000,35000,1,00400,India
778351,2024-01-14,505,oven,18490,24000,5510,1,00400,India
452258,2024-01-14,506,monitor,3249,8000,4751,1,00246,India
452258,2024-01-14,503,mixer,1349,3249,1900,1,00246,India
114385,2024-01-14,501,iphone 15,60000,80000,20000,1,00028,India
114385,2024-01-14,507,washing machine,6990,16490,9500,1,00028,India
114385,2024-01-14,505,oven,18490,24000,5510,1,00028,India
532292,2024-01-14,506,monitor,3249,8000,4751,1,00324,India
532292,2024-01-14,505,oven,18490,24000,5510,1,00324,India
627468,2024-01-14,503,mixer,1349,3249,1900,1,00021,India
983679,2024-01-14,503,mixer,1349,3249,1900,1,00347,India
983679,2024-01-14,502,iphone 15 pro max,100000,135000,35000,1,00347,India
631633,2024-01-14,507,washing machine,6990,16490,9500,1,00242,India
631633,2024-01-14,505,oven,18490,24000,5510,1,00242,India
631633,2024-01-14,504,iron,449,879,430,1,00242,India
118121,2024-01-14,502,iphone 15 pro max,100000,135000,35000,1,00292,India
118121,2024-01-14,505,oven,18490,24000,5510,1,00292,India
118121,2024-01-14,503,mixer,1349,3249,1900,1,00292,India
118121,2024-01-14,504,iron,449,879,430,1,00292,India
118121,2024-01-14,501,iphone 15,60000,80000,20000,1,00292,India
731407,2024-01-14,501,iphone 15,60000,80000,20000,1,00189,India
810747,2024-01-14,504,iron,449,879,430,1,00284,India
810747,2024-01-14,503,mixer,1349,3249,1900,1,00284,India
556942,2024-01-14,505,oven,18490,24000,5510,1,00263,India
874604,2024-01-14,504,iron,449,879,430,1,00435,India
874604,2024-01-14,503,mixer,1349,3249,1900,1,00435,India
115722,2024-01-14,503,mixer,1349,3249,1900,1,00012,India
115722,2024-01-14,507,washing machine,6990,16490,9500,1,00012,India
115722,2024-01-14,502,iphone 15 pro max,100000,135000,35000,1,00012,India
935890,2024-01-14,507,washing machine,6990,16490,9500,1,00039,India
935890,2024-01-14,502,iphone 15 pro max,100000,135000,35000,1,00039,India
935890,2024-01-14,506,monitor,3249,8000,4751,1,00039,India
983985,2024-01-14,502,iphone 15 pro max,100000,135000,35000,1,00449,India
983985,2024-01-14,504,iron,449,879,430,1,00449,India
650012,2024-01-14,501,iphone 15,60000,80000,20000,1,00032,India
650012,2024-01-14,504,iron,449,879,430,1,00032,India
289651,2024-01-14,507,washing machine,6990,16490,9500,1,00077,India
210637,2024-01-14,501,iphone 15,60000,80000,20000,1,00282,India
210637,2024-01-14,506,monitor,3249,8000,4751,1,00282,India
210637,2024-01-14,505,oven,18490,24000,5510,1,00282,India
210637,2024-01-14,507,washing machine,6990,16490,9500,1,00282,India
628118,2024-01-14,506,monitor,3249,8000,4751,1,00431,India
628118,2024-01-14,503,mixer,1349,3249,1900,1,00431,India
465756,2024-01-14,507,washing machine,6990,16490,9500,1,00473,India
465756,2024-01-14,501,iphone 15,60000,80000,20000,1,00473,India
465756,2024-01-14,503,mixer,1349,3249,1900,1,00473,India
465756,2024-01-14,502,iphone 15 pro max,100000,135000,35000,1,00473,India
465756,2024-01-14,504,iron,449,879,430,1,00473,India
730260,2024-01-14,504,iron,449,879,430,1,00331,India
730260,2024-01-14,502,iphone 15 pro max,100000,135000,35000,1,00331,India
730260,2024-01-14,506,monitor,3249,8000,4751,1,00331,India
730260,2024-01-14,501,iphone 15,60000,80000,20000,1,00331,India
882726,2024-01-14,503,mixer,1349,3249,1900,1,00036,India
882726,2024-01-14,506,monitor,3249,8000,4751,1,00036,India
754976,2024-01-14,503,mixer,1349,3249,1900,1,00186,India
754976,2024-01-14,505,oven,18490,24000,5510,1,00186,India
754976,2024-01-14,502,iphone 15 pro max,100000,135000,35000,1,00186,India
470398,2024-01-14,505,oven,18490,24000,5510,1,00216,India
470398,2024-01-14,507,washing machine,6990,16490,9500,1,00216,India
470398,2024-01-14,502,iphone 15 pro max,100000,135000,35000,1,00216,India
470398,2024-01-14,501,iphone 15,60000,80000,20000,1,00216,India
979473,2024-01-14,505,oven,18490,24000,5510,1,00180,India
979473,2024-01-14,507,washing machine,6990,16490,9500,1,00180,India
217051,2024-01-14,501,iphone 15,60000,80000,20000,1,00297,India
217051,2024-01-14,507,washing machine,6990,16490,9500,1,00297,India
375439,2024-01-14,506,monitor,3249,8000,4751,1,00226,India
375439,2024-01-14,502,iphone 15 pro max,100000,135000,35000,1,00226,India
713638,2024-01-14,501,iphone 15,60000,80000,20000,1,00447,India
713638,2024-01-14,506,monitor,3249,8000,4751,1,00447,India
180961,2024-01-14,506,monitor,3249,8000,4751,1,00459,India
180961,2024-01-14,501,iphone 15,60000,80000,20000,1,00459,India
180961,2024-01-14,504,iron,449,879,430,1,00459,India
931063,2024-01-14,504,iron,449,879,430,1,00334,India
930735,2024-01-14,501,iphone 15,60000,80000,20000,1,00374,India
930735,2024-01-14,506,monitor,3249,8000,4751,1,00374,India
916047,2024-01-14,503,mixer,1349,3249,1900,1,00080,India
916047,2024-01-14,505,oven,18490,24000,5510,1,00080,India
916047,2024-01-14,502,iphone 15 pro max,100000,135000,35000,1,00080,India
916047,2024-01-14,501,iphone 15,60000,80000,20000,1,00080,India
669153,2024-01-14,503,mixer,1349,3249,1900,1,00109,India
669153,2024-01-14,502,iphone 15 pro max,100000,135000,35000,1,00109,India
669153,2024-01-14,504,iron,449,879,430,1,00109,India
669153,2024-01-14,507,washing machine,6990,16490,9500,1,00109,India
394913,2024-01-14,501,iphone 15,60000,80000,20000,1,00484,India
394913,2024-01-14,503,mixer,1349,3249,1900,1,00484,India
394913,2024-01-14,502,iphone 15 pro max,100000,135000,35000,1,00484,India
693349,2024-01-14,503,mixer,1349,3249,1900,1,00271,India
693349,2024-01-14,506,monitor,3249,8000,4751,1,00271,India
693349,2024-01-14,505,oven,18490,24000,5510,1,00271,India
739988,2024-01-14,501,iphone 15,60000,80000,20000,1,00320,India
739988,2024-01-14,504,iron,449,879,430,1,00320,India
739988,2024-01-14,502,iphone 15 pro max,100000,135000,35000,1,00320,India
739988,2024-01-14,506,monitor,3249,8000,4751,1,00320,India
739988,2024-01-14,507,washing machine,6990,16490,9500,1,00320,India
613900,2024-01-14,501,iphone 15,60000,80000,20000,1,00478,India
613900,2024-01-14,502,iphone 15 pro max,100000,135000,35000,1,00478,India
399727,2024-01-14,505,oven,18490,24000,5510,1,00406,India
399727,2024-01-14,501,iphone 15,60000,80000,20000,1,00406,India
399727,2024-01-14,502,iphone 15 pro max,100000,135000,35000,1,00406,India
292916,2024-01-14,505,oven,18490,24000,5510,1,00239,India
292916,2024-01-14,501,iphone 15,60000,80000,20000,1,00239,India
292916,2024-01-14,507,washing machine,6990,16490,9500,1,00239,India
536195,2024-01-14,505,oven,18490,24000,5510,1,00457,India
898582,2024-01-14,505,oven,18490,24000,5510,1,00094,India
898582,2024-01-14,504,iron,449,879,430,1,00094,India
898582,2024-01-14,501,iphone 15,60000,80000,20000,1,00094,India
788495,2024-01-14,504,iron,449,879,430,1,00317,India
788495,2024-01-14,506,monitor,3249,8000,4751,1,00317,India
788495,2024-01-14,501,iphone 15,60000,80000,20000,1,00317,India
184832,2024-01-14,507,washing machine,6990,16490,9500,1,00142,India
163626,2024-01-14,505,oven,18490,24000,5510,1,00136,India
163626,2024-01-14,507,washing machine,6990,16490,9500,1,00136,India
163626,2024-01-14,501,iphone 15,60000,80000,20000,1,00136,India
632353,2024-01-14,507,washing machine,6990,16490,9500,1,00315,India
632353,2024-01-14,506,monitor,3249,8000,4751,1,00315,India
632353,2024-01-14,503,mixer,1349,3249,1900,1,00315,India
632353,2024-01-14,502,iphone 15 pro max,100000,135000,35000,1,00315,India
632353,2024-01-14,505,oven,18490,24000,5510,1,00315,India
959269,2024-01-14,504,iron,449,879,430,1,00100,India
812670,2024-01-14,503,mixer,1349,3249,1900,1,00176,India
689478,2024-01-14,505,oven,18490,24000,5510,1,00243,India
207271,2024-01-15,506,monitor,3249,8000,4751,1,00045,India
207271,2024-01-15,505,oven,18490,24000,5510,1,00045,India
207271,2024-01-15,503,mixer,1349,3249,1900,1,00045,India
848930,2024-01-15,503,mixer,1349,3249,1900,1,00316,India
654723,2024-01-15,504,iron,449,879,430,1,00120,India
654723,2024-01-15,507,washing machine,6990,16490,9500,1,00120,India
654723,2024-01-15,503,mixer,1349,3249,1900,1,00120,India
654723,2024-01-15,502,iphone 15 pro max,100000,135000,35000,1,00120,India
274010,2024-01-15,503,mixer,1349,3249,1900,1,00148,India
989785,2024-01-15,507,washing machine,6990,16490,9500,1,00140,India
661895,2024-01-15,506,monitor,3249,8000,4751,1,00243,India
661895,2024-01-15,503,mixer,1349,3249,1900,1,00243,India
661895,2024-01-15,502,iphone 15 pro max,100000,135000,35000,1,00243,India
807832,2024-01-15,505,oven,18490,24000,5510,1,00396,India
807832,2024-01-15,501,iphone 15,60000,80000,20000,1,00396,India
407323,2024-01-15,506,monitor,3249,8000,4751,1,00481,India
407323,2024-01-15,507,washing machine,6990,16490,9500,1,00481,India
407323,2024-01-15,503,mixer,1349,3249,1900,1,00481,India
115806,2024-01-15,504,iron,449,879,430,1,00216,India
115806,2024-01-15,503,mixer,1349,3249,1900,1,00216,India
115806,2024-01-15,502,iphone 15 pro max,100000,135000,35000,1,00216,India
115806,2024-01-15,506,monitor,3249,8000,4751,1,00216,India
226789,2024-01-15,505,oven,18490,24000,5510,1,00399,India
226789,2024-01-15,502,iphone 15 pro max,100000,135000,35000,1,00399,India
226789,2024-01-15,504,iron,449,879,430,1,00399,India
370479,2024-01-15,503,mixer,1349,3249,1900,1,00346,India
370479,2024-01-15,505,oven,18490,24000,5510,1,00346,India
370479,2024-01-15,507,washing machine,6990,16490,9500,1,00346,India
910284,2024-01-15,506,monitor,3249,8000,4751,1,00299,India
910284,2024-01-15,501,iphone 15,60000,80000,20000,1,00299,India
910284,2024-01-15,504,iron,449,879,430,1,00299,India
773179,2024-01-15,504,iron,449,879,430,1,00297,India
773179,2024-01-15,506,monitor,3249,8000,4751,1,00297,India
546179,2024-01-15,507,washing machine,6990,16490,9500,1,00086,India
321581,2024-01-15,501,iphone 15,60000,80000,20000,1,00380,India
321581,2024-01-15,505,oven,18490,24000,5510,1,00380,India
249453,2024-01-15,505,oven,18490,24000,5510,1,00486,India
249453,2024-01-15,506,monitor,3249,8000,4751,1,00486,India
249453,2024-01-15,503,mixer,1349,3249,1900,1,00486,India
249453,2024-01-15,501,iphone 15,60000,80000,20000,1,00486,India
480407,2024-01-15,507,washing machine,6990,16490,9500,1,00109,India
480407,2024-01-15,501,iphone 15,60000,80000,20000,1,00109,India
351005,2024-01-15,504,iron,449,879,430,1,00360,India
641397,2024-01-15,505,oven,18490,24000,5510,1,00042,India
934257,2024-01-15,502,iphone 15 pro max,100000,135000,35000,1,00158,India
934257,2024-01-15,507,washing machine,6990,16490,9500,1,00158,India
934257,2024-01-15,501,iphone 15,60000,80000,20000,1,00158,India
858941,2024-01-15,506,monitor,3249,8000,4751,1,00316,India
858941,2024-01-15,502,iphone 15 pro max,100000,135000,35000,1,00316,India
199614,2024-01-15,501,iphone 15,60000,80000,20000,1,00463,India
199614,2024-01-15,505,oven,18490,24000,5510,1,00463,India
199614,2024-01-15,504,iron,449,879,430,1,00463,India
199614,2024-01-15,503,mixer,1349,3249,1900,1,00463,India
701663,2024-01-15,502,iphone 15 pro max,100000,135000,35000,1,00270,India
701663,2024-01-15,507,washing machine,6990,16490,9500,1,00270,India
773265,2024-01-15,501,iphone 15,60000,80000,20000,1,00428,India
773265,2024-01-15,507,washing machine,6990,16490,9500,1,00428,India
773265,2024-01-15,502,iphone 15 pro max,100000,135000,35000,1,00428,India
773265,2024-01-15,506,monitor,3249,8000,4751,1,00428,India
376692,2024-01-15,505,oven,18490,24000,5510,1,00332,India
406827,2024-01-15,507,washing machine,6990,16490,9500,1,00443,India
406827,2024-01-15,506,monitor,3249,8000,4751,1,00443,India
406827,2024-01-15,504,iron,449,879,430,1,00443,India
600140,2024-01-15,501,iphone 15,60000,80000,20000,1,00317,India
600140,2024-01-15,504,iron,449,879,430,1,00317,India
600140,2024-01-15,502,iphone 15 pro max,100000,135000,35000,1,00317,India
600140,2024-01-15,505,oven,18490,24000,5510,1,00317,India
581238,2024-01-15,502,iphone 15 pro max,100000,135000,35000,1,00223,India
581238,2024-01-15,507,washing machine,6990,16490,9500,1,00223,India
581238,2024-01-15,506,monitor,3249,8000,4751,1,00223,India
782170,2024-01-15,503,mixer,1349,3249,1900,1,00292,India
782170,2024-01-15,506,monitor,3249,8000,4751,1,00292,India
782170,2024-01-15,501,iphone 15,60000,80000,20000,1,00292,India
782170,2024-01-15,507,washing machine,6990,16490,9500,1,00292,India
782170,2024-01-15,505,oven,18490,24000,5510,1,00292,India
308165,2024-01-15,505,oven,18490,24000,5510,1,00087,India
308165,2024-01-15,501,iphone 15,60000,80000,20000,1,00087,India
308165,2024-01-15,504,iron,449,879,430,1,00087,India
158257,2024-01-15,505,oven,18490,24000,5510,1,00270,India
158257,2024-01-15,502,iphone 15 pro max,100000,135000,35000,1,00270,India
520294,2024-01-15,502,iphone 15 pro max,100000,135000,35000,1,00079,India
644445,2024-01-15,504,iron,449,879,430,1,00003,India
644445,2024-01-15,501,iphone 15,60000,80000,20000,1,00003,India
644445,2024-01-15,505,oven,18490,24000,5510,1,00003,India
367744,2024-01-15,501,iphone 15,60000,80000,20000,1,00036,India
330201,2024-01-15,506,monitor,3249,8000,4751,1,00489,India
330201,2024-01-15,501,iphone 15,60000,80000,20000,1,00489,India
330201,2024-01-15,502,iphone 15 pro max,100000,135000,35000,1,00489,India
242754,2024-01-15,501,iphone 15,60000,80000,20000,1,00031,India
242754,2024-01-15,504,iron,449,879,430,1,00031,India
242754,2024-01-15,506,monitor,3249,8000,4751,1,00031,India
242754,2024-01-15,505,oven,18490,24000,5510,1,00031,India
413251,2024-01-15,502,iphone 15 pro max,100000,135000,35000,1,00090,India
413251,2024-01-15,507,washing machine,6990,16490,9500,1,00090,India
989874,2024-01-15,502,iphone 15 pro max,100000,135000,35000,1,00426,India
989874,2024-01-15,505,oven,18490,24000,5510,1,00426,India
989874,2024-01-15,507,washing machine,6990,16490,9500,1,00426,India
722628,2024-01-15,504,iron,449,879,430,1,00452,India
722628,2024-01-15,501,iphone 15,60000,80000,20000,1,00452,India
722628,2024-01-15,503,mixer,1349,3249,1900,1,00452,India
722628,2024-01-15,502,iphone 15 pro max,100000,135000,35000,1,00452,India
436354,2024-01-15,503,mixer,1349,3249,1900,1,00499,India
436354,2024-01-15,504,iron,449,879,430,1,00499,India
992040,2024-01-15,501,iphone 15,60000,80000,20000,1,00391,India
764675,2024-01-15,506,monitor,3249,8000,4751,1,00202,India
764675,2024-01-15,505,oven,18490,24000,5510,1,00202,India
889812,2024-01-15,506,monitor,3249,8000,4751,1,00359,India
889812,2024-01-15,507,washing machine,6990,16490,9500,1,00359,India
930219,2024-01-15,506,monitor,3249,8000,4751,1,00139,India
930219,2024-01-15,507,washing machine,6990,16490,9500,1,00139,India
533773,2024-01-15,502,iphone 15 pro max,100000,135000,35000,1,00005,India
533773,2024-01-15,505,oven,18490,24000,5510,1,00005,India
945633,2024-01-15,506,monitor,3249,8000,4751,1,00352,India
945633,2024-01-15,505,oven,18490,24000,5510,1,00352,India
945633,2024-01-15,507,washing machine,6990,16490,9500,1,00352,India
945633,2024-01-15,503,mixer,1349,3249,1900,1,00352,India
451453,2024-01-15,507,washing machine,6990,16490,9500,1,00365,India
451453,2024-01-15,505,oven,18490,24000,5510,1,00365,India
451453,2024-01-15,504,iron,449,879,430,1,00365,India
314124,2024-01-15,504,iron,449,879,430,1,00213,India
314124,2024-01-15,507,washing machine,6990,16490,9500,1,00213,India
235954,2024-01-15,503,mixer,1349,3249,1900,1,00455,India
235954,2024-01-15,504,iron,449,879,430,1,00455,India
235954,2024-01-15,501,iphone 15,60000,80000,20000,1,00455,India
645952,2024-01-15,505,oven,18490,24000,5510,1,00255,India
645952,2024-01-15,502,iphone 15 pro max,100000,135000,35000,1,00255,India
761545,2024-01-15,501,iphone 15,60000,80000,20000,1,00363,India
761545,2024-01-15,505,oven,18490,24000,5510,1,00363,India
903678,2024-01-15,503,mixer,1349,3249,1900,1,00498,India
903678,2024-01-15,504,iron,449,879,430,1,00498,India
979067,2024-01-15,505,oven,18490,24000,5510,1,00195,India
280743,2024-01-15,501,iphone 15,60000,80000,20000,1,00436,India
947213,2024-01-15,506,monitor,3249,8000,4751,1,00368,India
947213,2024-01-15,501,iphone 15,60000,80000,20000,1,00368,India
947213,2024-01-15,507,washing machine,6990,16490,9500,1,00368,India
461182,2024-01-15,507,washing machine,6990,16490,9500,1,00264,India
461182,2024-01-15,503,mixer,1349,3249,1900,1,00264,India
461182,2024-01-15,506,monitor,3249,8000,4751,1,00264,India
517041,2024-01-15,504,iron,449,879,430,1,00296,India
517041,2024-01-15,501,iphone 15,60000,80000,20000,1,00296,India
517041,2024-01-15,506,monitor,3249,8000,4751,1,00296,India
517041,2024-01-15,507,washing machine,6990,16490,9500,1,00296,India
874325,2024-01-15,507,washing machine,6990,16490,9500,1,00441,India
874325,2024-01-15,502,iphone 15 pro max,100000,135000,35000,1,00441,India
191963,2024-01-15,502,iphone 15 pro max,100000,135000,35000,1,00038,India
191963,2024-01-15,505,oven,18490,24000,5510,1,00038,India
191963,2024-01-15,507,washing machine,6990,16490,9500,1,00038,India
922071,2024-01-15,504,iron,449,879,430,1,00209,India
922071,2024-01-15,506,monitor,3249,8000,4751,1,00209,India
922071,2024-01-15,501,iphone 15,60000,80000,20000,1,00209,India
999454,2024-01-15,507,washing machine,6990,16490,9500,1,00348,India
999454,2024-01-15,506,monitor,3249,8000,4751,1,00348,India
999454,2024-01-15,505,oven,18490,24000,5510,1,00348,India
775130,2024-01-15,503,mixer,1349,3249,1900,1,00375,India
775130,2024-01-15,506,monitor,3249,8000,4751,1,00375,India
775130,2024-01-15,507,washing machine,6990,16490,9500,1,00375,India
615173,2024-01-15,501,iphone 15,60000,80000,20000,1,00177,India
309185,2024-01-15,505,oven,18490,24000,5510,1,00263,India
309185,2024-01-15,501,iphone 15,60000,80000,20000,1,00263,India
309185,2024-01-15,503,mixer,1349,3249,1900,1,00263,India
309185,2024-01-15,502,iphone 15 pro max,100000,135000,35000,1,00263,India
785673,2024-01-15,505,oven,18490,24000,5510,1,00015,India
785673,2024-01-15,502,iphone 15 pro max,100000,135000,35000,1,00015,India
785673,2024-01-15,507,washing machine,6990,16490,9500,1,00015,India
861021,2024-01-15,502,iphone 15 pro max,100000,135000,35000,1,00478,India
861021,2024-01-15,501,iphone 15,60000,80000,20000,1,00478,India
861021,2024-01-15,506,monitor,3249,8000,4751,1,00478,India
861021,2024-01-15,503,mixer,1349,3249,1900,1,00478,India
287226,2024-01-15,506,monitor,3249,8000,4751,1,00278,India
287226,2024-01-15,501,iphone 15,60000,80000,20000,1,00278,India
287226,2024-01-15,505,oven,18490,24000,5510,1,00278,India
864272,2024-01-15,503,mixer,1349,3249,1900,1,00407,India
552279,2024-01-15,505,oven,18490,24000,5510,1,00013,India
280111,2024-01-15,504,iron,449,879,430,1,00405,India
280111,2024-01-15,507,washing machine,6990,16490,9500,1,00405,India
280111,2024-01-15,501,iphone 15,60000,80000,20000,1,00405,India
896978,2024-01-15,502,iphone 15 pro max,100000,135000,35000,1,00240,India
896978,2024-01-15,507,washing machine,6990,16490,9500,1,00240,India
896978,2024-01-15,506,monitor,3249,8000,4751,1,00240,India
800148,2024-01-15,503,mixer,1349,3249,1900,1,00234,India
800148,2024-01-15,501,iphone 15,60000,80000,20000,1,00234,India
760763,2024-01-15,502,iphone 15 pro max,100000,135000,35000,1,00315,India
760763,2024-01-15,507,washing machine,6990,16490,9500,1,00315,India
760763,2024-01-15,501,iphone 15,60000,80000,20000,1,00315,India
656441,2024-01-15,502,iphone 15 pro max,100000,135000,35000,1,00225,India
656441,2024-01-15,501,iphone 15,60000,80000,20000,1,00225,India
656441,2024-01-15,505,oven,18490,24000,5510,1,00225,India
882264,2024-01-15,503,mixer,1349,3249,1900,1,00106,India
882264,2024-01-15,505,oven,18490,24000,5510,1,00106,India
686798,2024-01-15,506,monitor,3249,8000,4751,1,00196,India
585934,2024-01-15,501,iphone 15,60000,80000,20000,1,00200,India
585934,2024-01-15,505,oven,18490,24000,5510,1,00200,India
585934,2024-01-15,503,mixer,1349,3249,1900,1,00200,India
186184,2024-01-15,507,washing machine,6990,16490,9500,1,00495,India
186184,2024-01-15,501,iphone 15,60000,80000,20000,1,00495,India
675317,2024-01-15,505,oven,18490,24000,5510,1,00204,India
103890,2024-01-15,504,iron,449,879,430,1,00234,India
103890,2024-01-15,501,iphone 15,60000,80000,20000,1,00234,India
103890,2024-01-15,502,iphone 15 pro max,100000,135000,35000,1,00234,India
147578,2024-01-15,507,washing machine,6990,16490,9500,1,00006,India
298508,2024-01-15,501,iphone 15,60000,80000,20000,1,00169,India
298508,2024-01-15,507,washing machine,6990,16490,9500,1,00169,India
708261,2024-01-15,503,mixer,1349,3249,1900,1,00404,India
708261,2024-01-15,506,monitor,3249,8000,4751,1,00404,India
708261,2024-01-15,505,oven,18490,24000,5510,1,00404,India
708261,2024-01-15,501,iphone 15,60000,80000,20000,1,00404,India
407383,2024-01-15,506,monitor,3249,8000,4751,1,00120,India
407383,2024-01-15,501,iphone 15,60000,80000,20000,1,00120,India
407383,2024-01-15,507,washing machine,6990,16490,9500,1,00120,India
407383,2024-01-15,503,mixer,1349,3249,1900,1,00120,India
407383,2024-01-15,504,iron,449,879,430,1,00120,India
988390,2024-01-15,502,iphone 15 pro max,100000,135000,35000,1,00337,India
988390,2024-01-15,506,monitor,3249,8000,4751,1,00337,India
707554,2024-01-15,502,iphone 15 pro max,100000,135000,35000,1,00070,India
707554,2024-01-15,501,iphone 15,60000,80000,20000,1,00070,India
707554,2024-01-15,506,monitor,3249,8000,4751,1,00070,India
648518,2024-01-15,505,oven,18490,24000,5510,1,00479,India
648518,2024-01-15,503,mixer,1349,3249,1900,1,00479,India
648518,2024-01-15,501,iphone 15,60000,80000,20000,1,00479,India
710955,2024-01-15,504,iron,449,879,430,1,00404,India
688036,2024-01-15,504,iron,449,879,430,1,00277,India
688036,2024-01-15,507,washing machine,6990,16490,9500,1,00277,India
688036,2024-01-15,502,iphone 15 pro max,100000,135000,35000,1,00277,India
383343,2024-01-15,501,iphone 15,60000,80000,20000,1,00368,India
261063,2024-01-15,506,monitor,3249,8000,4751,1,00499,India
261063,2024-01-15,507,washing machine,6990,16490,9500,1,00499,India
261063,2024-01-15,501,iphone 15,60000,80000,20000,1,00499,India
120386,2024-01-15,506,monitor,3249,8000,4751,1,00391,India
485110,2024-01-15,503,mixer,1349,3249,1900,1,00464,India
485110,2024-01-15,506,monitor,3249,8000,4751,1,00464,India
485110,2024-01-15,502,iphone 15 pro max,100000,135000,35000,1,00464,India
920622,2024-01-15,504,iron,449,879,430,1,00409,India
920622,2024-01-15,502,iphone 15 pro max,100000,135000,35000,1,00409,India
920622,2024-01-15,505,oven,18490,24000,5510,1,00409,India
920622,2024-01-15,506,monitor,3249,8000,4751,1,00409,India
345489,2024-01-15,507,washing machine,6990,16490,9500,1,00150,India
345489,2024-01-15,506,monitor,3249,8000,4751,1,00150,India
599255,2024-01-15,502,iphone 15 pro max,100000,135000,35000,1,00045,India
599255,2024-01-15,505,oven,18490,24000,5510,1,00045,India
326597,2024-01-15,502,iphone 15 pro max,100000,135000,35000,1,00500,India
335180,2024-01-15,505,oven,18490,24000,5510,1,00368,India
335180,2024-01-15,503,mixer,1349,3249,1900,1,00368,India
335180,2024-01-15,501,iphone 15,60000,80000,20000,1,00368,India
639434,2024-01-15,503,mixer,1349,3249,1900,1,00022,India
639434,2024-01-15,501,iphone 15,60000,80000,20000,1,00022,India
914896,2024-01-16,503,mixer,1349,3249,1900,1,00024,India
914896,2024-01-16,507,washing machine,6990,16490,9500,1,00024,India
914896,2024-01-16,501,iphone 15,60000,80000,20000,1,00024,India
914896,2024-01-16,504,iron,449,879,430,1,00024,India
303905,2024-01-16,504,iron,449,879,430,1,00075,India
443816,2024-01-16,503,mixer,1349,3249,1900,1,00013,India
443816,2024-01-16,501,iphone 15,60000,80000,20000,1,00013,India
443816,2024-01-16,507,washing machine,6990,16490,9500,1,00013,India
301763,2024-01-16,506,monitor,3249,8000,4751,1,00429,India
301763,2024-01-16,507,washing machine,6990,16490,9500,1,00429,India
301763,2024-01-16,504,iron,449,879,430,1,00429,India
356687,2024-01-16,506,monitor,3249,8000,4751,1,00345,India
356687,2024-01-16,504,iron,449,879,430,1,00345,India
356687,2024-01-16,505,oven,18490,24000,5510,1,00345,India
861403,2024-01-16,504,iron,449,879,430,1,00327,India
861403,2024-01-16,507,washing machine,6990,16490,9500,1,00327,India
984438,2024-01-16,502,iphone 15 pro max,100000,135000,35000,1,00493,India
393563,2024-01-16,507,washing machine,6990,16490,9500,1,00109,India
847221,2024-01-16,502,iphone 15 pro max,100000,135000,35000,1,00316,India
847221,2024-01-16,503,mixer,1349,3249,1900,1,00316,India
847221,2024-01-16,507,washing machine,6990,16490,9500,1,00316,India
863239,2024-01-16,504,iron,449,879,430,1,00114,India
238511,2024-01-16,506,monitor,3249,8000,4751,1,00363,India
238511,2024-01-16,505,oven,18490,24000,5510,1,00363,India
238511,2024-01-16,507,washing machine,6990,16490,9500,1,00363,India
990192,2024-01-16,501,iphone 15,60000,80000,20000,1,00055,India
990192,2024-01-16,502,iphone 15 pro max,100000,135000,35000,1,00055,India
990192,2024-01-16,503,mixer,1349,3249,1900,1,00055,India
781365,2024-01-16,506,monitor,3249,8000,4751,1,00110,India
781365,2024-01-16,507,washing machine,6990,16490,9500,1,00110,India
781365,2024-01-16,503,mixer,1349,3249,1900,1,00110,India
882406,2024-01-16,507,washing machine,6990,16490,9500,1,00396,India
696151,2024-01-16,502,iphone 15 pro max,100000,135000,35000,1,00041,India
696151,2024-01-16,504,iron,449,879,430,1,00041,India
197082,2024-01-16,501,iphone 15,60000,80000,20000,1,00139,India
197082,2024-01-16,506,monitor,3249,8000,4751,1,00139,India
197082,2024-01-16,503,mixer,1349,3249,1900,1,00139,India
122356,2024-01-16,504,iron,449,879,430,1,00479,India
122356,2024-01-16,506,monitor,3249,8000,4751,1,00479,India
122356,2024-01-16,501,iphone 15,60000,80000,20000,1,00479,India
170600,2024-01-16,502,iphone 15 pro max,100000,135000,35000,1,00445,India
379271,2024-01-16,504,iron,449,879,430,1,00122,India
458268,2024-01-16,502,iphone 15 pro max,100000,135000,35000,1,00207,India
458268,2024-01-16,501,iphone 15,60000,80000,20000,1,00207,India
513012,2024-01-16,502,iphone 15 pro max,100000,135000,35000,1,00288,India
653842,2024-01-16,505,oven,18490,24000,5510,1,00006,India
653842,2024-01-16,507,washing machine,6990,16490,9500,1,00006,India
154468,2024-01-16,503,mixer,1349,3249,1900,1,00245,India
154468,2024-01-16,504,iron,449,879,430,1,00245,India
419210,2024-01-16,501,iphone 15,60000,80000,20000,1,00402,India
419210,2024-01-16,502,iphone 15 pro max,100000,135000,35000,1,00402,India
419210,2024-01-16,505,oven,18490,24000,5510,1,00402,India
419210,2024-01-16,506,monitor,3249,8000,4751,1,00402,India
295864,2024-01-16,504,iron,449,879,430,1,00301,India
357737,2024-01-16,505,oven,18490,24000,5510,1,00358,India
357737,2024-01-16,502,iphone 15 pro max,100000,135000,35000,1,00358,India
357737,2024-01-16,506,monitor,3249,8000,4751,1,00358,India
119969,2024-01-16,502,iphone 15 pro max,100000,135000,35000,1,00181,India
119969,2024-01-16,503,mixer,1349,3249,1900,1,00181,India
119969,2024-01-16,505,oven,18490,24000,5510,1,00181,India
321856,2024-01-16,501,iphone 15,60000,80000,20000,1,00068,India
980371,2024-01-16,505,oven,18490,24000,5510,1,00231,India
980371,2024-01-16,504,iron,449,879,430,1,00231,India
980371,2024-01-16,507,washing machine,6990,16490,9500,1,00231,India
980371,2024-01-16,501,iphone 15,60000,80000,20000,1,00231,India
867427,2024-01-16,502,iphone 15 pro max,100000,135000,35000,1,00363,India
867427,2024-01-16,507,washing machine,6990,16490,9500,1,00363,India
867427,2024-01-16,501,iphone 15,60000,80000,20000,1,00363,India
344070,2024-01-16,501,iphone 15,60000,80000,20000,1,00185,India
344070,2024-01-16,507,washing machine,6990,16490,9500,1,00185,India
135220,2024-01-16,505,oven,18490,24000,5510,1,00197,India
135220,2024-01-16,504,iron,449,879,430,1,00197,India
135220,2024-01-16,506,monitor,3249,8000,4751,1,00197,India
135220,2024-01-16,503,mixer,1349,3249,1900,1,00197,India
696526,2024-01-16,502,iphone 15 pro max,100000,135000,35000,1,00318,India
696526,2024-01-16,504,iron,449,879,430,1,00318,India
696526,2024-01-16,505,oven,18490,24000,5510,1,00318,India
696526,2024-01-16,501,iphone 15,60000,80000,20000,1,00318,India
850905,2024-01-16,506,monitor,3249,8000,4751,1,00413,India
850905,2024-01-16,502,iphone 15 pro max,100000,135000,35000,1,00413,India
850905,2024-01-16,504,iron,449,879,430,1,00413,India
825612,2024-01-16,504,iron,449,879,430,1,00097,India
825612,2024-01-16,502,iphone 15 pro max,100000,135000,35000,1,00097,India
273042,2024-01-16,503,mixer,1349,3249,1900,1,00396,India
273042,2024-01-16,501,iphone 15,60000,80000,20000,1,00396,India
273042,2024-01-16,506,monitor,3249,8000,4751,1,00396,India
224048,2024-01-16,502,iphone 15 pro max,100000,135000,35000,1,00060,India
224048,2024-01-16,507,washing machine,6990,16490,9500,1,00060,India
224048,2024-01-16,504,iron,449,879,430,1,00060,India
224048,2024-01-16,505,oven,18490,24000,5510,1,00060,India
910168,2024-01-16,503,mixer,1349,3249,1900,1,00068,India
910168,2024-01-16,504,iron,449,879,430,1,00068,India
910168,2024-01-16,501,iphone 15,60000,80000,20000,1,00068,India
825532,2024-01-16,504,iron,449,879,430,1,00326,India
825532,2024-01-16,505,oven,18490,24000,5510,1,00326,India
825532,2024-01-16,503,mixer,1349,3249,1900,1,00326,India
825532,2024-01-16,502,iphone 15 pro max,100000,135000,35000,1,00326,India
964989,2024-01-16,501,iphone 15,60000,80000,20000,1,00280,India
992981,2024-01-16,502,iphone 15 pro max,100000,135000,35000,1,00456,India
992981,2024-01-16,506,monitor,3249,8000,4751,1,00456,India
992981,2024-01-16,503,mixer,1349,3249,1900,1,00456,India
233460,2024-01-16,505,oven,18490,24000,5510,1,00410,India
810548,2024-01-16,507,washing machine,6990,16490,9500,1,00172,India
810548,2024-01-16,504,iron,449,879,430,1,00172,India
810548,2024-01-16,503,mixer,1349,3249,1900,1,00172,India
329251,2024-01-16,502,iphone 15 pro max,100000,135000,35000,1,00359,India
931545,2024-01-16,502,iphone 15 pro max,100000,135000,35000,1,00114,India
931545,2024-01-16,503,mixer,1349,3249,1900,1,00114,India
931545,2024-01-16,507,washing machine,6990,16490,9500,1,00114,India
931545,2024-01-16,506,monitor,3249,8000,4751,1,00114,India
286186,2024-01-16,505,oven,18490,24000,5510,1,00096,India
286186,2024-01-16,501,iphone 15,60000,80000,20000,1,00096,India
286186,2024-01-16,502,iphone 15 pro max,100000,135000,35000,1,00096,India
594850,2024-01-16,503,mixer,1349,3249,1900,1,00145,India
594850,2024-01-16,507,washing machine,6990,16490,9500,1,00145,India
580888,2024-01-16,505,oven,18490,24000,5510,1,00370,India
580888,2024-01-16,502,iphone 15 pro max,100000,135000,35000,1,00370,India
580888,2024-01-16,501,iphone 15,60000,80000,20000,1,00370,India
136584,2024-01-16,503,mixer,1349,3249,1900,1,00008,India
136584,2024-01-16,502,iphone 15 pro max,100000,135000,35000,1,00008,India
136584,2024-01-16,505,oven,18490,24000,5510,1,00008,India
136584,2024-01-16,507,washing machine,6990,16490,9500,1,00008,India
988084,2024-01-16,503,mixer,1349,3249,1900,1,00034,India
988084,2024-01-16,505,oven,18490,24000,5510,1,00034,India
988084,2024-01-16,504,iron,449,879,430,1,00034,India
406058,2024-01-16,503,mixer,1349,3249,1900,1,00288,India
406058,2024-01-16,507,washing machine,6990,16490,9500,1,00288,India
376775,2024-01-16,503,mixer,1349,3249,1900,1,00131,India
376775,2024-01-16,501,iphone 15,60000,80000,20000,1,00131,India
376775,2024-01-16,507,washing machine,6990,16490,9500,1,00131,India
376775,2024-01-16,502,iphone 15 pro max,100000,135000,35000,1,00131,India
376775,2024-01-16,504,iron,449,879,430,1,00131,India
328583,2024-01-16,503,mixer,1349,3249,1900,1,00419,India
785862,2024-01-16,503,mixer,1349,3249,1900,1,00450,India
785862,2024-01-16,502,iphone 15 pro max,100000,135000,35000,1,00450,India
785862,2024-01-16,506,monitor,3249,8000,4751,1,00450,India
381345,2024-01-16,503,mixer,1349,3249,1900,1,00320,India
430764,2024-01-16,507,washing machine,6990,16490,9500,1,00377,India
430764,2024-01-16,506,monitor,3249,8000,4751,1,00377,India
430764,2024-01-16,503,mixer,1349,3249,1900,1,00377,India
545213,2024-01-16,502,iphone 15 pro max,100000,135000,35000,1,00171,India
545213,2024-01-16,507,washing machine,6990,16490,9500,1,00171,India
545213,2024-01-16,501,iphone 15,60000,80000,20000,1,00171,India
545213,2024-01-16,504,iron,449,879,430,1,00171,India
339658,2024-01-16,502,iphone 15 pro max,100000,135000,35000,1,00329,India
339658,2024-01-16,504,iron,449,879,430,1,00329,India
231938,2024-01-16,502,iphone 15 pro max,100000,135000,35000,1,00393,India
369339,2024-01-16,501,iphone 15,60000,80000,20000,1,00052,India
369339,2024-01-16,502,iphone 15 pro max,100000,135000,35000,1,00052,India
391742,2024-01-16,506,monitor,3249,8000,4751,1,00199,India
391742,2024-01-16,501,iphone 15,60000,80000,20000,1,00199,India
391742,2024-01-16,507,washing machine,6990,16490,9500,1,00199,India
100476,2024-01-16,503,mixer,1349,3249,1900,1,00147,India
100476,2024-01-16,502,iphone 15 pro max,100000,135000,35000,1,00147,India
178433,2024-01-16,506,monitor,3249,8000,4751,1,00013,India
178433,2024-01-16,504,iron,449,879,430,1,00013,India
218748,2024-01-16,501,iphone 15,60000,80000,20000,1,00127,India
218748,2024-01-16,506,monitor,3249,8000,4751,1,00127,India
218748,2024-01-16,502,iphone 15 pro max,100000,135000,35000,1,00127,India
930830,2024-01-16,506,monitor,3249,8000,4751,1,00344,India
930830,2024-01-16,507,washing machine,6990,16490,9500,1,00344,India
992289,2024-01-16,503,mixer,1349,3249,1900,1,00012,India
992289,2024-01-16,507,washing machine,6990,16490,9500,1,00012,India
992289,2024-01-16,506,monitor,3249,8000,4751,1,00012,India
992289,2024-01-16,505,oven,18490,24000,5510,1,00012,India
971344,2024-01-16,503,mixer,1349,3249,1900,1,00377,India
553317,2024-01-16,502,iphone 15 pro max,100000,135000,35000,1,00177,India
553317,2024-01-16,505,oven,18490,24000,5510,1,00177,India
469873,2024-01-16,507,washing machine,6990,16490,9500,1,00402,India
651725,2024-01-16,502,iphone 15 pro max,100000,135000,35000,1,00261,India
651725,2024-01-16,504,iron,449,879,430,1,00261,India
651725,2024-01-16,501,iphone 15,60000,80000,20000,1,00261,India
651725,2024-01-16,503,mixer,1349,3249,1900,1,00261,India
651725,2024-01-16,506,monitor,3249,8000,4751,1,00261,India
411637,2024-01-16,505,oven,18490,24000,5510,1,00074,India
411637,2024-01-16,503,mixer,1349,3249,1900,1,00074,India
411637,2024-01-16,501,iphone 15,60000,80000,20000,1,00074,India
411637,2024-01-16,507,washing machine,6990,16490,9500,1,00074,India
690574,2024-01-16,505,oven,18490,24000,5510,1,00443,India
690574,2024-01-16,503,mixer,1349,3249,1900,1,00443,India
690574,2024-01-16,504,iron,449,879,430,1,00443,India
939275,2024-01-16,505,oven,18490,24000,5510,1,00186,India
939275,2024-01-16,506,monitor,3249,8000,4751,1,00186,India
939275,2024-01-16,501,iphone 15,60000,80000,20000,1,00186,India
939275,2024-01-16,502,iphone 15 pro max,100000,135000,35000,1,00186,India
702541,2024-01-16,506,monitor,3249,8000,4751,1,00132,India
702541,2024-01-16,502,iphone 15 pro max,100000,135000,35000,1,00132,India
702541,2024-01-16,505,oven,18490,24000,5510,1,00132,India
702541,2024-01-16,503,mixer,1349,3249,1900,1,00132,India
333378,2024-01-16,502,iphone 15 pro max,100000,135000,35000,1,00453,India
701062,2024-01-16,505,oven,18490,24000,5510,1,00257,India
701062,2024-01-16,506,monitor,3249,8000,4751,1,00257,India
701062,2024-01-16,507,washing machine,6990,16490,9500,1,00257,India
907884,2024-01-16,501,iphone 15,60000,80000,20000,1,00078,India
527669,2024-01-16,507,washing machine,6990,16490,9500,1,00273,India
527669,2024-01-16,502,iphone 15 pro max,100000,135000,35000,1,00273,India
527669,2024-01-16,503,mixer,1349,3249,1900,1,00273,India
118241,2024-01-16,502,iphone 15 pro max,100000,135000,35000,1,00416,India
118241,2024-01-16,505,oven,18490,24000,5510,1,00416,India
118241,2024-01-16,504,iron,449,879,430,1,00416,India
555024,2024-01-16,503,mixer,1349,3249,1900,1,00432,India
127919,2024-01-16,507,washing machine,6990,16490,9500,1,00012,India
127919,2024-01-16,506,monitor,3249,8000,4751,1,00012,India
127919,2024-01-16,505,oven,18490,24000,5510,1,00012,India
329949,2024-01-16,505,oven,18490,24000,5510,1,00210,India
329949,2024-01-16,507,washing machine,6990,16490,9500,1,00210,India
451493,2024-01-16,503,mixer,1349,3249,1900,1,00055,India
451493,2024-01-16,501,iphone 15,60000,80000,20000,1,00055,India
451493,2024-01-16,505,oven,18490,24000,5510,1,00055,India
931839,2024-01-16,501,iphone 15,60000,80000,20000,1,00308,India
931839,2024-01-16,504,iron,449,879,430,1,00308,India
931839,2024-01-16,503,mixer,1349,3249,1900,1,00308,India
931839,2024-01-16,507,washing machine,6990,16490,9500,1,00308,India
931839,2024-01-16,502,iphone 15 pro max,100000,135000,35000,1,00308,India
700983,2024-01-16,503,mixer,1349,3249,1900,1,00337,India
700983,2024-01-16,501,iphone 15,60000,80000,20000,1,00337,India
700983,2024-01-16,505,oven,18490,24000,5510,1,00337,India
700983,2024-01-16,502,iphone 15 pro max,100000,135000,35000,1,00337,India
550792,2024-01-16,504,iron,449,879,430,1,00479,India
550792,2024-01-16,502,iphone 15 pro max,100000,135000,35000,1,00479,India
550792,2024-01-16,506,monitor,3249,8000,4751,1,00479,India
294539,2024-01-16,501,iphone 15,60000,80000,20000,1,00402,India
294539,2024-01-16,502,iphone 15 pro max,100000,135000,35000,1,00402,India
294539,2024-01-16,505,oven,18490,24000,5510,1,00402,India
938688,2024-01-16,506,monitor,3249,8000,4751,1,00325,India
938688,2024-01-16,501,iphone 15,60000,80000,20000,1,00325,India
700926,2024-01-16,501,iphone 15,60000,80000,20000,1,00315,India
391249,2024-01-16,506,monitor,3249,8000,4751,1,00271,India
391249,2024-01-16,504,iron,449,879,430,1,00271,India
645641,2024-01-16,503,mixer,1349,3249,1900,1,00115,India
645641,2024-01-16,505,oven,18490,24000,5510,1,00115,India
976156,2024-01-16,505,oven,18490,24000,5510,1,00158,India
976156,2024-01-16,502,iphone 15 pro max,100000,135000,35000,1,00158,India
976156,2024-01-16,501,iphone 15,60000,80000,20000,1,00158,India
976156,2024-01-16,504,iron,449,879,430,1,00158,India
976156,2024-01-16,506,monitor,3249,8000,4751,1,00158,India
625806,2024-01-16,504,iron,449,879,430,1,00372,India
625806,2024-01-16,505,oven,18490,24000,5510,1,00372,India
625806,2024-01-16,501,iphone 15,60000,80000,20000,1,00372,India
625806,2024-01-16,507,washing machine,6990,16490,9500,1,00372,India
215475,2024-01-16,503,mixer,1349,3249,1900,1,00484,India
215475,2024-01-16,505,oven,18490,24000,5510,1,00484,India
401947,2024-01-16,502,iphone 15 pro max,100000,135000,35000,1,00135,India
310968,2024-01-17,504,iron,449,879,430,1,00129,India
328049,2024-01-17,503,mixer,1349,3249,1900,1,00297,India
328049,2024-01-17,507,washing machine,6990,16490,9500,1,00297,India
328049,2024-01-17,502,iphone 15 pro max,100000,135000,35000,1,00297,India
108723,2024-01-17,503,mixer,1349,3249,1900,1,00289,India
108723,2024-01-17,504,iron,449,879,430,1,00289,India
911778,2024-01-17,505,oven,18490,24000,5510,1,00096,India
911778,2024-01-17,507,washing machine,6990,16490,9500,1,00096,India
671954,2024-01-17,503,mixer,1349,3249,1900,1,00469,India
671954,2024-01-17,502,iphone 15 pro max,100000,135000,35000,1,00469,India
671954,2024-01-17,505,oven,18490,24000,5510,1,00469,India
491199,2024-01-17,504,iron,449,879,430,1,00497,India
491199,2024-01-17,506,monitor,3249,8000,4751,1,00497,India
209166,2024-01-17,503,mixer,1349,3249,1900,1,00499,India
209166,2024-01-17,507,washing machine,6990,16490,9500,1,00499,India
764654,2024-01-17,504,iron,449,879,430,1,00357,India
764654,2024-01-17,505,oven,18490,24000,5510,1,00357,India
341383,2024-01-17,505,oven,18490,24000,5510,1,00445,India
341383,2024-01-17,503,mixer,1349,3249,1900,1,00445,India
341383,2024-01-17,506,monitor,3249,8000,4751,1,00445,India
430442,2024-01-17,506,monitor,3249,8000,4751,1,00044,India
430442,2024-01-17,505,oven,18490,24000,5510,1,00044,India
430442,2024-01-17,507,washing machine,6990,16490,9500,1,00044,India
430442,2024-01-17,503,mixer,1349,3249,1900,1,00044,India
380745,2024-01-17,507,washing machine,6990,16490,9500,1,00379,India
380745,2024-01-17,503,mixer,1349,3249,1900,1,00379,India
380745,2024-01-17,501,iphone 15,60000,80000,20000,1,00379,India
380745,2024-01-17,505,oven,18490,24000,5510,1,00379,India
262805,2024-01-17,504,iron,449,879,430,1,00354,India
897734,2024-01-17,502,iphone 15 pro max,100000,135000,35000,1,00487,India
815131,2024-01-17,507,washing machine,6990,16490,9500,1,00421,India
815131,2024-01-17,506,monitor,3249,8000,4751,1,00421,India
815131,2024-01-17,505,oven,18490,24000,5510,1,00421,India
815131,2024-01-17,504,iron,449,879,430,1,00421,India
720300,2024-01-17,503,mixer,1349,3249,1900,1,00398,India
720300,2024-01-17,506,monitor,3249,8000,4751,1,00398,India
720300,2024-01-17,507,washing machine,6990,16490,9500,1,00398,India
720300,2024-01-17,504,iron,449,879,430,1,00398,India
406921,2024-01-17,507,washing machine,6990,16490,9500,1,00263,India
406921,2024-01-17,503,mixer,1349,3249,1900,1,00263,India
636599,2024-01-17,505,oven,18490,24000,5510,1,00067,India
144584,2024-01-17,505,oven,18490,24000,5510,1,00466,India
144584,2024-01-17,501,iphone 15,60000,80000,20000,1,00466,India
144584,2024-01-17,507,washing machine,6990,16490,9500,1,00466,India
123731,2024-01-17,507,washing machine,6990,16490,9500,1,00032,India
346090,2024-01-17,505,oven,18490,24000,5510,1,00264,India
346090,2024-01-17,503,mixer,1349,3249,1900,1,00264,India
346090,2024-01-17,501,iphone 15,60000,80000,20000,1,00264,India
242996,2024-01-17,507,washing machine,6990,16490,9500,1,00216,India
242996,2024-01-17,504,iron,449,879,430,1,00216,India
242996,2024-01-17,503,mixer,1349,3249,1900,1,00216,India
242996,2024-01-17,501,iphone 15,60000,80000,20000,1,00216,India
242996,2024-01-17,506,monitor,3249,8000,4751,1,00216,India
885186,2024-01-17,503,mixer,1349,3249,1900,1,00374,India
885186,2024-01-17,505,oven,18490,24000,5510,1,00374,India
200294,2024-01-17,505,oven,18490,24000,5510,1,00013,India
200294,2024-01-17,503,mixer,1349,3249,1900,1,00013,India
200294,2024-01-17,501,iphone 15,60000,80000,20000,1,00013,India
200294,2024-01-17,507,washing machine,6990,16490,9500,1,00013,India
324276,2024-01-17,502,iphone 15 pro max,100000,135000,35000,1,00401,India
324276,2024-01-17,507,washing machine,6990,16490,9500,1,00401,India
324276,2024-01-17,504,iron,449,879,430,1,00401,India
200293,2024-01-17,505,oven,18490,24000,5510,1,00176,India
200293,2024-01-17,502,iphone 15 pro max,100000,135000,35000,1,00176,India
385429,2024-01-17,502,iphone 15 pro max,100000,135000,35000,1,00258,India
144723,2024-01-17,504,iron,449,879,430,1,00371,India
144723,2024-01-17,505,oven,18490,24000,5510,1,00371,India
144723,2024-01-17,501,iphone 15,60000,80000,20000,1,00371,India
144723,2024-01-17,502,iphone 15 pro max,100000,135000,35000,1,00371,India
751399,2024-01-17,503,mixer,1349,3249,1900,1,00498,India
751399,2024-01-17,504,iron,449,879,430,1,00498,India
949698,2024-01-17,503,mixer,1349,3249,1900,1,00217,India
900431,2024-01-17,502,iphone 15 pro max,100000,135000,35000,1,00053,India
900431,2024-01-17,506,monitor,3249,8000,4751,1,00053,India
418898,2024-01-17,501,iphone 15,60000,80000,20000,1,00113,India
418898,2024-01-17,506,monitor,3249,8000,4751,1,00113,India
524295,2024-01-17,506,monitor,3249,8000,4751,1,00022,India
524295,2024-01-17,502,iphone 15 pro max,100000,135000,35000,1,00022,India
524295,2024-01-17,503,mixer,1349,3249,1900,1,00022,India
524295,2024-01-17,505,oven,18490,24000,5510,1,00022,India
983241,2024-01-17,502,iphone 15 pro max,100000,135000,35000,1,00129,India
678189,2024-01-17,506,monitor,3249,8000,4751,1,00214,India
678189,2024-01-17,507,washing machine,6990,16490,9500,1,00214,India
678189,2024-01-17,502,iphone 15 pro max,100000,135000,35000,1,00214,India
183914,2024-01-17,504,iron,449,879,430,1,00459,India
671451,2024-01-17,501,iphone 15,60000,80000,20000,1,00353,India
671451,2024-01-17,507,washing machine,6990,16490,9500,1,00353,India
786461,2024-01-17,502,iphone 15 pro max,100000,135000,35000,1,00088,India
786461,2024-01-17,506,monitor,3249,8000,4751,1,00088,India
136830,2024-01-17,502,iphone 15 pro max,100000,135000,35000,1,00020,India
136830,2024-01-17,504,iron,449,879,430,1,00020,India
136830,2024-01-17,505,oven,18490,24000,5510,1,00020,India
136830,2024-01-17,507,washing machine,6990,16490,9500,1,00020,India
796272,2024-01-17,506,monitor,3249,8000,4751,1,00105,India
404408,2024-01-17,501,iphone 15,60000,80000,20000,1,00165,India
159603,2024-01-17,506,monitor,3249,8000,4751,1,00364,India
579337,2024-01-17,506,monitor,3249,8000,4751,1,00154,India
141491,2024-01-17,505,oven,18490,24000,5510,1,00437,India
141491,2024-01-17,503,mixer,1349,3249,1900,1,00437,India
370205,2024-01-17,504,iron,449,879,430,1,00041,India
370205,2024-01-17,506,monitor,3249,8000,4751,1,00041,India
370205,2024-01-17,502,iphone 15 pro max,100000,135000,35000,1,00041,India
304652,2024-01-17,504,iron,449,879,430,1,00339,India
304652,2024-01-17,505,oven,18490,24000,5510,1,00339,India
304652,2024-01-17,502,iphone 15 pro max,100000,135000,35000,1,00339,India
304652,2024-01-17,506,monitor,3249,8000,4751,1,00339,India
200262,2024-01-17,507,washing machine,6990,16490,9500,1,00222,India
200262,2024-01-17,502,iphone 15 pro max,100000,135000,35000,1,00222,India
422864,2024-01-17,505,oven,18490,24000,5510,1,00456,India
422864,2024-01-17,506,monitor,3249,8000,4751,1,00456,India
696792,2024-01-17,505,oven,18490,24000,5510,1,00115,India
696792,2024-01-17,507,washing machine,6990,16490,9500,1,00115,India
304822,2024-01-17,503,mixer,1349,3249,1900,1,00300,India
304822,2024-01-17,504,iron,449,879,430,1,00300,India
304822,2024-01-17,502,iphone 15 pro max,100000,135000,35000,1,00300,India
545499,2024-01-17,502,iphone 15 pro max,100000,135000,35000,1,00500,India
545499,2024-01-17,507,washing machine,6990,16490,9500,1,00500,India
545499,2024-01-17,506,monitor,3249,8000,4751,1,00500,India
673379,2024-01-17,506,monitor,3249,8000,4751,1,00415,India
673379,2024-01-17,502,iphone 15 pro max,100000,135000,35000,1,00415,India
432928,2024-01-17,503,mixer,1349,3249,1900,1,00023,India
847784,2024-01-17,503,mixer,1349,3249,1900,1,00026,India
847784,2024-01-17,505,oven,18490,24000,5510,1,00026,India
847784,2024-01-17,501,iphone 15,60000,80000,20000,1,00026,India
847784,2024-01-17,507,washing machine,6990,16490,9500,1,00026,India
652002,2024-01-18,507,washing machine,6990,16490,9500,1,00466,India
652002,2024-01-18,502,iphone 15 pro max,100000,135000,35000,1,00466,India
652002,2024-01-18,501,iphone 15,60000,80000,20000,1,00466,India
581991,2024-01-18,501,iphone 15,60000,80000,20000,1,00455,India
581991,2024-01-18,503,mixer,1349,3249,1900,1,00455,India
581991,2024-01-18,507,washing machine,6990,16490,9500,1,00455,India
581991,2024-01-18,505,oven,18490,24000,5510,1,00455,India
901352,2024-01-18,501,iphone 15,60000,80000,20000,1,00317,India
901352,2024-01-18,503,mixer,1349,3249,1900,1,00317,India
901352,2024-01-18,506,monitor,3249,8000,4751,1,00317,India
195315,2024-01-18,503,mixer,1349,3249,1900,1,00087,India
672519,2024-01-18,503,mixer,1349,3249,1900,1,00268,India
672519,2024-01-18,501,iphone 15,60000,80000,20000,1,00268,India
672519,2024-01-18,505,oven,18490,24000,5510,1,00268,India
717901,2024-01-18,503,mixer,1349,3249,1900,1,00375,India
717901,2024-01-18,504,iron,449,879,430,1,00375,India
717901,2024-01-18,501,iphone 15,60000,80000,20000,1,00375,India
279122,2024-01-18,502,iphone 15 pro max,100000,135000,35000,1,00178,India
369313,2024-01-18,504,iron,449,879,430,1,00272,India
504185,2024-01-18,502,iphone 15 pro max,100000,135000,35000,1,00126,India
504185,2024-01-18,503,mixer,1349,3249,1900,1,00126,India
504185,2024-01-18,501,iphone 15,60000,80000,20000,1,00126,India
504185,2024-01-18,507,washing machine,6990,16490,9500,1,00126,India
959973,2024-01-18,505,oven,18490,24000,5510,1,00391,India
616707,2024-01-18,506,monitor,3249,8000,4751,1,00476,India
616707,2024-01-18,507,washing machine,6990,16490,9500,1,00476,India
616707,2024-01-18,505,oven,18490,24000,5510,1,00476,India
616707,2024-01-18,503,mixer,1349,3249,1900,1,00476,India
570420,2024-01-18,507,washing machine,6990,16490,9500,1,00069,India
570420,2024-01-18,504,iron,449,879,430,1,00069,India
476027,2024-01-18,507,washing machine,6990,16490,9500,1,00385,India
476027,2024-01-18,503,mixer,1349,3249,1900,1,00385,India
476027,2024-01-18,506,monitor,3249,8000,4751,1,00385,India
476027,2024-01-18,502,iphone 15 pro max,100000,135000,35000,1,00385,India
476027,2024-01-18,501,iphone 15,60000,80000,20000,1,00385,India
349179,2024-01-18,506,monitor,3249,8000,4751,1,00405,India
349179,2024-01-18,501,iphone 15,60000,80000,20000,1,00405,India
349179,2024-01-18,504,iron,449,879,430,1,00405,India
126754,2024-01-18,505,oven,18490,24000,5510,1,00339,India
126754,2024-01-18,507,washing machine,6990,16490,9500,1,00339,India
126754,2024-01-18,504,iron,449,879,430,1,00339,India
691652,2024-01-18,504,iron,449,879,430,1,00340,India
691652,2024-01-18,502,iphone 15 pro max,100000,135000,35000,1,00340,India
691652,2024-01-18,501,iphone 15,60000,80000,20000,1,00340,India
534297,2024-01-18,506,monitor,3249,8000,4751,1,00109,India
534297,2024-01-18,507,washing machine,6990,16490,9500,1,00109,India
801779,2024-01-18,504,iron,449,879,430,1,00392,India
342492,2024-01-18,502,iphone 15 pro max,100000,135000,35000,1,00483,India
342492,2024-01-18,505,oven,18490,24000,5510,1,00483,India
645082,2024-01-18,505,oven,18490,24000,5510,1,00137,India
645082,2024-01-18,504,iron,449,879,430,1,00137,India
645082,2024-01-18,507,washing machine,6990,16490,9500,1,00137,India
601235,2024-01-18,505,oven,18490,24000,5510,1,00176,India
601235,2024-01-18,506,monitor,3249,8000,4751,1,00176,India
225209,2024-01-18,502,iphone 15 pro max,100000,135000,35000,1,00491,India
225209,2024-01-18,501,iphone 15,60000,80000,20000,1,00491,India
656547,2024-01-18,504,iron,449,879,430,1,00431,India
656547,2024-01-18,501,iphone 15,60000,80000,20000,1,00431,India
332824,2024-01-18,505,oven,18490,24000,5510,1,00126,India
332824,2024-01-18,502,iphone 15 pro max,100000,135000,35000,1,00126,India
332824,2024-01-18,506,monitor,3249,8000,4751,1,00126,India
824484,2024-01-18,506,monitor,3249,8000,4751,1,00457,India
553915,2024-01-18,507,washing machine,6990,16490,9500,1,00453,India
553915,2024-01-18,502,iphone 15 pro max,100000,135000,35000,1,00453,India
553915,2024-01-18,504,iron,449,879,430,1,00453,India
255916,2024-01-18,501,iphone 15,60000,80000,20000,1,00234,India
896542,2024-01-18,501,iphone 15,60000,80000,20000,1,00401,India
211564,2024-01-18,506,monitor,3249,8000,4751,1,00433,India
211564,2024-01-18,507,washing machine,6990,16490,9500,1,00433,India
211564,2024-01-18,504,iron,449,879,430,1,00433,India
401644,2024-01-18,502,iphone 15 pro max,100000,135000,35000,1,00452,India
401644,2024-01-18,506,monitor,3249,8000,4751,1,00452,India
401644,2024-01-18,503,mixer,1349,3249,1900,1,00452,India
401644,2024-01-18,505,oven,18490,24000,5510,1,00452,India
626001,2024-01-18,507,washing machine,6990,16490,9500,1,00310,India
929061,2024-01-18,506,monitor,3249,8000,4751,1,00023,India
929061,2024-01-18,504,iron,449,879,430,1,00023,India
929061,2024-01-18,502,iphone 15 pro max,100000,135000,35000,1,00023,India
929061,2024-01-18,503,mixer,1349,3249,1900,1,00023,India
929061,2024-01-18,507,washing machine,6990,16490,9500,1,00023,India
936500,2024-01-18,504,iron,449,879,430,1,00088,India
936500,2024-01-18,501,iphone 15,60000,80000,20000,1,00088,India
936500,2024-01-18,503,mixer,1349,3249,1900,1,00088,India
726942,2024-01-18,503,mixer,1349,3249,1900,1,00342,India
972410,2024-01-18,503,mixer,1349,3249,1900,1,00361,India
972410,2024-01-18,501,iphone 15,60000,80000,20000,1,00361,India
944777,2024-01-18,505,oven,18490,24000,5510,1,00258,India
351713,2024-01-18,505,oven,18490,24000,5510,1,00423,India
351713,2024-01-18,501,iphone 15,60000,80000,20000,1,00423,India
755410,2024-01-18,502,iphone 15 pro max,100000,135000,35000,1,00168,India
755410,2024-01-18,507,washing machine,6990,16490,9500,1,00168,India
755410,2024-01-18,503,mixer,1349,3249,1900,1,00168,India
755410,2024-01-18,501,iphone 15,60000,80000,20000,1,00168,India
796853,2024-01-18,503,mixer,1349,3249,1900,1,00284,India
654554,2024-01-18,501,iphone 15,60000,80000,20000,1,00355,India
654554,2024-01-18,504,iron,449,879,430,1,00355,India
942631,2024-01-18,507,washing machine,6990,16490,9500,1,00458,India
634947,2024-01-18,504,iron,449,879,430,1,00253,India
451593,2024-01-18,502,iphone 15 pro max,100000,135000,35000,1,00371,India
451593,2024-01-18,503,mixer,1349,3249,1900,1,00371,India
899155,2024-01-18,506,monitor,3249,8000,4751,1,00273,India
899155,2024-01-18,503,mixer,1349,3249,1900,1,00273,India
571913,2024-01-18,504,iron,449,879,430,1,00004,India
571913,2024-01-18,507,washing machine,6990,16490,9500,1,00004,India
571913,2024-01-18,502,iphone 15 pro max,100000,135000,35000,1,00004,India
576822,2024-01-18,502,iphone 15 pro max,100000,135000,35000,1,00408,India
576822,2024-01-18,501,iphone 15,60000,80000,20000,1,00408,India
576822,2024-01-18,505,oven,18490,24000,5510,1,00408,India
576822,2024-01-18,503,mixer,1349,3249,1900,1,00408,India
974945,2024-01-18,501,iphone 15,60000,80000,20000,1,00294,India
974945,2024-01-18,502,iphone 15 pro max,100000,135000,35000,1,00294,India
974945,2024-01-18,504,iron,449,879,430,1,00294,India
109524,2024-01-18,506,monitor,3249,8000,4751,1,00144,India
415145,2024-01-18,506,monitor,3249,8000,4751,1,00104,India
415145,2024-01-18,507,washing machine,6990,16490,9500,1,00104,India
415145,2024-01-18,501,iphone 15,60000,80000,20000,1,00104,India
221592,2024-01-18,504,iron,449,879,430,1,00275,India
221592,2024-01-18,501,iphone 15,60000,80000,20000,1,00275,India
221592,2024-01-18,507,washing machine,6990,16490,9500,1,00275,India
255674,2024-01-18,502,iphone 15 pro max,100000,135000,35000,1,00323,India
255674,2024-01-18,501,iphone 15,60000,80000,20000,1,00323,India
255674,2024-01-18,505,oven,18490,24000,5510,1,00323,India
736244,2024-01-18,506,monitor,3249,8000,4751,1,00065,India
736244,2024-01-18,505,oven,18490,24000,5510,1,00065,India
736244,2024-01-18,502,iphone 15 pro max,100000,135000,35000,1,00065,India
736244,2024-01-18,504,iron,449,879,430,1,00065,India
481236,2024-01-18,506,monitor,3249,8000,4751,1,00110,India
185198,2024-01-18,504,iron,449,879,430,1,00035,India
185198,2024-01-18,506,monitor,3249,8000,4751,1,00035,India
185198,2024-01-18,505,oven,18490,24000,5510,1,00035,India
303645,2024-01-18,501,iphone 15,60000,80000,20000,1,00336,India
303645,2024-01-18,503,mixer,1349,3249,1900,1,00336,India
466146,2024-01-18,503,mixer,1349,3249,1900,1,00161,India
466146,2024-01-18,507,washing machine,6990,16490,9500,1,00161,India
792178,2024-01-18,504,iron,449,879,430,1,00322,India
792178,2024-01-18,505,oven,18490,24000,5510,1,00322,India
792178,2024-01-18,501,iphone 15,60000,80000,20000,1,00322,India
792178,2024-01-18,506,monitor,3249,8000,4751,1,00322,India
253011,2024-01-18,504,iron,449,879,430,1,00106,India
253011,2024-01-18,503,mixer,1349,3249,1900,1,00106,India
706303,2024-01-18,503,mixer,1349,3249,1900,1,00049,India
286944,2024-01-18,507,washing machine,6990,16490,9500,1,00045,India
355230,2024-01-18,507,washing machine,6990,16490,9500,1,00386,India
929377,2024-01-18,503,mixer,1349,3249,1900,1,00135,India
929377,2024-01-18,501,iphone 15,60000,80000,20000,1,00135,India
603104,2024-01-18,504,iron,449,879,430,1,00249,India
603104,2024-01-18,506,monitor,3249,8000,4751,1,00249,India
603104,2024-01-18,505,oven,18490,24000,5510,1,00249,India
783302,2024-01-18,503,mixer,1349,3249,1900,1,00381,India
783302,2024-01-18,507,washing machine,6990,16490,9500,1,00381,India
783302,2024-01-18,502,iphone 15 pro max,100000,135000,35000,1,00381,India
287870,2024-01-18,503,mixer,1349,3249,1900,1,00130,India
287870,2024-01-18,501,iphone 15,60000,80000,20000,1,00130,India
287870,2024-01-18,507,washing machine,6990,16490,9500,1,00130,India
115987,2024-01-18,502,iphone 15 pro max,100000,135000,35000,1,00049,India
115987,2024-01-18,501,iphone 15,60000,80000,20000,1,00049,India
115987,2024-01-18,505,oven,18490,24000,5510,1,00049,India
551093,2024-01-18,507,washing machine,6990,16490,9500,1,00038,India
551093,2024-01-18,504,iron,449,879,430,1,00038,India
212557,2024-01-19,504,iron,449,879,430,1,00098,India
270697,2024-01-19,507,washing machine,6990,16490,9500,1,00277,India
844987,2024-01-19,505,oven,18490,24000,5510,1,00223,India
844987,2024-01-19,503,mixer,1349,3249,1900,1,00223,India
844987,2024-01-19,504,iron,449,879,430,1,00223,India
844987,2024-01-19,506,monitor,3249,8000,4751,1,00223,India
732879,2024-01-19,507,washing machine,6990,16490,9500,1,00277,India
554156,2024-01-19,505,oven,18490,24000,5510,1,00491,India
263870,2024-01-19,506,monitor,3249,8000,4751,1,00388,India
553129,2024-01-19,506,monitor,3249,8000,4751,1,00319,India
740146,2024-01-19,503,mixer,1349,3249,1900,1,00135,India
740146,2024-01-19,504,iron,449,879,430,1,00135,India
143186,2024-01-19,507,washing machine,6990,16490,9500,1,00117,India
143186,2024-01-19,501,iphone 15,60000,80000,20000,1,00117,India
214991,2024-01-19,505,oven,18490,24000,5510,1,00026,India
214991,2024-01-19,506,monitor,3249,8000,4751,1,00026,India
727442,2024-01-19,506,monitor,3249,8000,4751,1,00295,India
727442,2024-01-19,504,iron,449,879,430,1,00295,India
322939,2024-01-19,507,washing machine,6990,16490,9500,1,00025,India
689160,2024-01-19,502,iphone 15 pro max,100000,135000,35000,1,00239,India
689160,2024-01-19,503,mixer,1349,3249,1900,1,00239,India
689160,2024-01-19,501,iphone 15,60000,80000,20000,1,00239,India
689160,2024-01-19,505,oven,18490,24000,5510,1,00239,India
796541,2024-01-19,507,washing machine,6990,16490,9500,1,00164,India
796541,2024-01-19,504,iron,449,879,430,1,00164,India
778378,2024-01-19,501,iphone 15,60000,80000,20000,1,00385,India
403839,2024-01-19,505,oven,18490,24000,5510,1,00386,India
403839,2024-01-19,506,monitor,3249,8000,4751,1,00386,India
155304,2024-01-19,506,monitor,3249,8000,4751,1,00302,India
155304,2024-01-19,504,iron,449,879,430,1,00302,India
996244,2024-01-19,501,iphone 15,60000,80000,20000,1,00295,India
996244,2024-01-19,502,iphone 15 pro max,100000,135000,35000,1,00295,India
996244,2024-01-19,504,iron,449,879,430,1,00295,India
996244,2024-01-19,505,oven,18490,24000,5510,1,00295,India
684995,2024-01-19,505,oven,18490,24000,5510,1,00291,India
684995,2024-01-19,503,mixer,1349,3249,1900,1,00291,India
684995,2024-01-19,506,monitor,3249,8000,4751,1,00291,India
730555,2024-01-19,506,monitor,3249,8000,4751,1,00120,India
759901,2024-01-19,501,iphone 15,60000,80000,20000,1,00320,India
759901,2024-01-19,506,monitor,3249,8000,4751,1,00320,India
185952,2024-01-19,501,iphone 15,60000,80000,20000,1,00259,India
185952,2024-01-19,504,iron,449,879,430,1,00259,India
185952,2024-01-19,507,washing machine,6990,16490,9500,1,00259,India
185952,2024-01-19,503,mixer,1349,3249,1900,1,00259,India
185952,2024-01-19,506,monitor,3249,8000,4751,1,00259,India
774813,2024-01-19,503,mixer,1349,3249,1900,1,00366,India
537622,2024-01-19,502,iphone 15 pro max,100000,135000,35000,1,00487,India
537622,2024-01-19,501,iphone 15,60000,80000,20000,1,00487,India
537622,2024-01-19,506,monitor,3249,8000,4751,1,00487,India
537622,2024-01-19,504,iron,449,879,430,1,00487,India
537622,2024-01-19,507,washing machine,6990,16490,9500,1,00487,India
815764,2024-01-19,501,iphone 15,60000,80000,20000,1,00181,India
815764,2024-01-19,504,iron,449,879,430,1,00181,India
713007,2024-01-19,501,iphone 15,60000,80000,20000,1,00045,India
713007,2024-01-19,502,iphone 15 pro max,100000,135000,35000,1,00045,India
563845,2024-01-19,506,monitor,3249,8000,4751,1,00140,India
563845,2024-01-19,503,mixer,1349,3249,1900,1,00140,India
563845,2024-01-19,501,iphone 15,60000,80000,20000,1,00140,India
563845,2024-01-19,502,iphone 15 pro max,100000,135000,35000,1,00140,India
566132,2024-01-19,506,monitor,3249,8000,4751,1,00073,India
566132,2024-01-19,503,mixer,1349,3249,1900,1,00073,India
566132,2024-01-19,501,iphone 15,60000,80000,20000,1,00073,India
730149,2024-01-19,501,iphone 15,60000,80000,20000,1,00499,India
730149,2024-01-19,504,iron,449,879,430,1,00499,India
730149,2024-01-19,503,mixer,1349,3249,1900,1,00499,India
296311,2024-01-19,501,iphone 15,60000,80000,20000,1,00461,India
296311,2024-01-19,503,mixer,1349,3249,1900,1,00461,India
150062,2024-01-19,501,iphone 15,60000,80000,20000,1,00304,India
150062,2024-01-19,505,oven,18490,24000,5510,1,00304,India
150062,2024-01-19,504,iron,449,879,430,1,00304,India
596021,2024-01-19,503,mixer,1349,3249,1900,1,00225,India
596021,2024-01-19,502,iphone 15 pro max,100000,135000,35000,1,00225,India
596021,2024-01-19,504,iron,449,879,430,1,00225,India
483752,2024-01-19,503,mixer,1349,3249,1900,1,00485,India
483752,2024-01-19,504,iron,449,879,430,1,00485,India
483752,2024-01-19,507,washing machine,6990,16490,9500,1,00485,India
483752,2024-01-19,502,iphone 15 pro max,100000,135000,35000,1,00485,India
179097,2024-01-19,505,oven,18490,24000,5510,1,00113,India
179097,2024-01-19,504,iron,449,879,430,1,00113,India
346519,2024-01-19,506,monitor,3249,8000,4751,1,00365,India
346519,2024-01-19,503,mixer,1349,3249,1900,1,00365,India
346519,2024-01-19,507,washing machine,6990,16490,9500,1,00365,India
346519,2024-01-19,505,oven,18490,24000,5510,1,00365,India
563849,2024-01-19,503,mixer,1349,3249,1900,1,00218,India
633744,2024-01-19,503,mixer,1349,3249,1900,1,00464,India
633744,2024-01-19,501,iphone 15,60000,80000,20000,1,00464,India
883234,2024-01-19,501,iphone 15,60000,80000,20000,1,00293,India
883234,2024-01-19,502,iphone 15 pro max,100000,135000,35000,1,00293,India
883234,2024-01-19,503,mixer,1349,3249,1900,1,00293,India
902963,2024-01-19,505,oven,18490,24000,5510,1,00120,India
902963,2024-01-19,504,iron,449,879,430,1,00120,India
902963,2024-01-19,506,monitor,3249,8000,4751,1,00120,India
763963,2024-01-19,504,iron,449,879,430,1,00133,India
763963,2024-01-19,506,monitor,3249,8000,4751,1,00133,India
731882,2024-01-19,502,iphone 15 pro max,100000,135000,35000,1,00203,India
731882,2024-01-19,504,iron,449,879,430,1,00203,India
731882,2024-01-19,501,iphone 15,60000,80000,20000,1,00203,India
950943,2024-01-19,501,iphone 15,60000,80000,20000,1,00312,India
950943,2024-01-19,506,monitor,3249,8000,4751,1,00312,India
950943,2024-01-19,507,washing machine,6990,16490,9500,1,00312,India
231800,2024-01-19,501,iphone 15,60000,80000,20000,1,00160,India
231800,2024-01-19,503,mixer,1349,3249,1900,1,00160,India
443523,2024-01-19,507,washing machine,6990,16490,9500,1,00195,India
443523,2024-01-19,506,monitor,3249,8000,4751,1,00195,India
924271,2024-01-19,506,monitor,3249,8000,4751,1,00383,India
497833,2024-01-19,502,iphone 15 pro max,100000,135000,35000,1,00355,India
497833,2024-01-19,506,monitor,3249,8000,4751,1,00355,India
116288,2024-01-19,505,oven,18490,24000,5510,1,00271,India
116288,2024-01-19,503,mixer,1349,3249,1900,1,00271,India
116288,2024-01-19,502,iphone 15 pro max,100000,135000,35000,1,00271,India
788984,2024-01-19,502,iphone 15 pro max,100000,135000,35000,1,00293,India
857651,2024-01-19,502,iphone 15 pro max,100000,135000,35000,1,00450,India
857651,2024-01-19,504,iron,449,879,430,1,00450,India
857651,2024-01-19,505,oven,18490,24000,5510,1,00450,India
301817,2024-01-19,504,iron,449,879,430,1,00348,India
301817,2024-01-19,506,monitor,3249,8000,4751,1,00348,India
301817,2024-01-19,502,iphone 15 pro max,100000,135000,35000,1,00348,India
301817,2024-01-19,505,oven,18490,24000,5510,1,00348,India
308102,2024-01-19,501,iphone 15,60000,80000,20000,1,00299,India
308102,2024-01-19,503,mixer,1349,3249,1900,1,00299,India
239607,2024-01-19,501,iphone 15,60000,80000,20000,1,00074,India
239607,2024-01-19,507,washing machine,6990,16490,9500,1,00074,India
239607,2024-01-19,502,iphone 15 pro max,100000,135000,35000,1,00074,India
415538,2024-01-19,505,oven,18490,24000,5510,1,00217,India
415538,2024-01-19,501,iphone 15,60000,80000,20000,1,00217,India
460357,2024-01-19,507,washing machine,6990,16490,9500,1,00500,India
460357,2024-01-19,505,oven,18490,24000,5510,1,00500,India
325940,2024-01-19,504,iron,449,879,430,1,00497,India
325940,2024-01-19,507,washing machine,6990,16490,9500,1,00497,India
835716,2024-01-19,506,monitor,3249,8000,4751,1,00061,India
932803,2024-01-19,501,iphone 15,60000,80000,20000,1,00344,India
932803,2024-01-19,502,iphone 15 pro max,100000,135000,35000,1,00344,India
932803,2024-01-19,503,mixer,1349,3249,1900,1,00344,India
579212,2024-01-19,505,oven,18490,24000,5510,1,00054,India
491409,2024-01-19,504,iron,449,879,430,1,00442,India
491409,2024-01-19,501,iphone 15,60000,80000,20000,1,00442,India
491409,2024-01-19,503,mixer,1349,3249,1900,1,00442,India
491409,2024-01-19,502,iphone 15 pro max,100000,135000,35000,1,00442,India
818991,2024-01-19,502,iphone 15 pro max,100000,135000,35000,1,00171,India
818991,2024-01-19,506,monitor,3249,8000,4751,1,00171,India
818991,2024-01-19,505,oven,18490,24000,5510,1,00171,India
818991,2024-01-19,504,iron,449,879,430,1,00171,India
161213,2024-01-19,503,mixer,1349,3249,1900,1,00144,India
300707,2024-01-20,506,monitor,3249,8000,4751,1,00162,India
731290,2024-01-20,504,iron,449,879,430,1,00230,India
731290,2024-01-20,507,washing machine,6990,16490,9500,1,00230,India
131342,2024-01-20,506,monitor,3249,8000,4751,1,00289,India
131342,2024-01-20,507,washing machine,6990,16490,9500,1,00289,India
131342,2024-01-20,505,oven,18490,24000,5510,1,00289,India
131342,2024-01-20,504,iron,449,879,430,1,00289,India
122785,2024-01-20,506,monitor,3249,8000,4751,1,00329,India
122785,2024-01-20,502,iphone 15 pro max,100000,135000,35000,1,00329,India
122785,2024-01-20,503,mixer,1349,3249,1900,1,00329,India
122785,2024-01-20,504,iron,449,879,430,1,00329,India
354922,2024-01-20,506,monitor,3249,8000,4751,1,00358,India
354922,2024-01-20,503,mixer,1349,3249,1900,1,00358,India
160730,2024-01-20,502,iphone 15 pro max,100000,135000,35000,1,00486,India
122200,2024-01-20,505,oven,18490,24000,5510,1,00286,India
122200,2024-01-20,503,mixer,1349,3249,1900,1,00286,India
874696,2024-01-20,504,iron,449,879,430,1,00044,India
874696,2024-01-20,503,mixer,1349,3249,1900,1,00044,India
800399,2024-01-20,501,iphone 15,60000,80000,20000,1,00228,India
800399,2024-01-20,507,washing machine,6990,16490,9500,1,00228,India
598727,2024-01-20,504,iron,449,879,430,1,00116,India
598727,2024-01-20,502,iphone 15 pro max,100000,135000,35000,1,00116,India
598727,2024-01-20,501,iphone 15,60000,80000,20000,1,00116,India
598727,2024-01-20,506,monitor,3249,8000,4751,1,00116,India
598727,2024-01-20,505,oven,18490,24000,5510,1,00116,India
885906,2024-01-20,504,iron,449,879,430,1,00265,India
885906,2024-01-20,505,oven,18490,24000,5510,1,00265,India
885906,2024-01-20,507,washing machine,6990,16490,9500,1,00265,India
819101,2024-01-20,505,oven,18490,24000,5510,1,00427,India
819101,2024-01-20,501,iphone 15,60000,80000,20000,1,00427,India
819101,2024-01-20,506,monitor,3249,8000,4751,1,00427,India
819101,2024-01-20,502,iphone 15 pro max,100000,135000,35000,1,00427,India
792241,2024-01-20,506,monitor,3249,8000,4751,1,00320,India
792241,2024-01-20,503,mixer,1349,3249,1900,1,00320,India
792241,2024-01-20,501,iphone 15,60000,80000,20000,1,00320,India
792241,2024-01-20,502,iphone 15 pro max,100000,135000,35000,1,00320,India
602518,2024-01-20,507,washing machine,6990,16490,9500,1,00495,India
577938,2024-01-20,504,iron,449,879,430,1,00026,India
577938,2024-01-20,505,oven,18490,24000,5510,1,00026,India
505808,2024-01-20,503,mixer,1349,3249,1900,1,00007,India
505808,2024-01-20,502,iphone 15 pro max,100000,135000,35000,1,00007,India
696989,2024-01-20,505,oven,18490,24000,5510,1,00394,India
205550,2024-01-20,506,monitor,3249,8000,4751,1,00073,India
205550,2024-01-20,501,iphone 15,60000,80000,20000,1,00073,India
649035,2024-01-20,506,monitor,3249,8000,4751,1,00426,India
649035,2024-01-20,505,oven,18490,24000,5510,1,00426,India
897568,2024-01-20,507,washing machine,6990,16490,9500,1,00286,India
897568,2024-01-20,503,mixer,1349,3249,1900,1,00286,India
987026,2024-01-20,501,iphone 15,60000,80000,20000,1,00458,India
987026,2024-01-20,502,iphone 15 pro max,100000,135000,35000,1,00458,India
330034,2024-01-20,505,oven,18490,24000,5510,1,00404,India
330034,2024-01-20,506,monitor,3249,8000,4751,1,00404,India
330034,2024-01-20,503,mixer,1349,3249,1900,1,00404,India
884494,2024-01-20,504,iron,449,879,430,1,00230,India
884494,2024-01-20,502,iphone 15 pro max,100000,135000,35000,1,00230,India
398676,2024-01-20,503,mixer,1349,3249,1900,1,00074,India
398676,2024-01-20,501,iphone 15,60000,80000,20000,1,00074,India
398676,2024-01-20,505,oven,18490,24000,5510,1,00074,India
398676,2024-01-20,502,iphone 15 pro max,100000,135000,35000,1,00074,India
847641,2024-01-20,507,washing machine,6990,16490,9500,1,00485,India
847641,2024-01-20,504,iron,449,879,430,1,00485,India
399616,2024-01-20,501,iphone 15,60000,80000,20000,1,00270,India
399616,2024-01-20,502,iphone 15 pro max,100000,135000,35000,1,00270,India
399616,2024-01-20,506,monitor,3249,8000,4751,1,00270,India
620076,2024-01-20,503,mixer,1349,3249,1900,1,00330,India
189625,2024-01-20,502,iphone 15 pro max,100000,135000,35000,1,00259,India
746525,2024-01-20,503,mixer,1349,3249,1900,1,00197,India
746525,2024-01-20,507,washing machine,6990,16490,9500,1,00197,India
746525,2024-01-20,505,oven,18490,24000,5510,1,00197,India
619270,2024-01-20,503,mixer,1349,3249,1900,1,00062,India
619270,2024-01-20,501,iphone 15,60000,80000,20000,1,00062,India
619270,2024-01-20,506,monitor,3249,8000,4751,1,00062,India
619270,2024-01-20,505,oven,18490,24000,5510,1,00062,India
362993,2024-01-20,507,washing machine,6990,16490,9500,1,00111,India
362993,2024-01-20,504,iron,449,879,430,1,00111,India
362993,2024-01-20,505,oven,18490,24000,5510,1,00111,India
617689,2024-01-20,501,iphone 15,60000,80000,20000,1,00254,India
617689,2024-01-20,503,mixer,1349,3249,1900,1,00254,India
617689,2024-01-20,507,washing machine,6990,16490,9500,1,00254,India
652200,2024-01-20,504,iron,449,879,430,1,00487,India
652200,2024-01-20,502,iphone 15 pro max,100000,135000,35000,1,00487,India
652200,2024-01-20,505,oven,18490,24000,5510,1,00487,India
652200,2024-01-20,501,iphone 15,60000,80000,20000,1,00487,India
164443,2024-01-20,506,monitor,3249,8000,4751,1,00411,India
164443,2024-01-20,502,iphone 15 pro max,100000,135000,35000,1,00411,India
271116,2024-01-20,505,oven,18490,24000,5510,1,00438,India
271116,2024-01-20,504,iron,449,879,430,1,00438,India
271116,2024-01-20,506,monitor,3249,8000,4751,1,00438,India
533999,2024-01-20,501,iphone 15,60000,80000,20000,1,00326,India
869457,2024-01-20,503,mixer,1349,3249,1900,1,00227,India
869457,2024-01-20,507,washing machine,6990,16490,9500,1,00227,India
645709,2024-01-20,507,washing machine,6990,16490,9500,1,00449,India
645709,2024-01-20,504,iron,449,879,430,1,00449,India
776595,2024-01-20,503,mixer,1349,3249,1900,1,00418,India
776595,2024-01-20,501,iphone 15,60000,80000,20000,1,00418,India
146751,2024-01-20,507,washing machine,6990,16490,9500,1,00140,India
146751,2024-01-20,506,monitor,3249,8000,4751,1,00140,India
793372,2024-01-20,506,monitor,3249,8000,4751,1,00007,India
793372,2024-01-20,502,iphone 15 pro max,100000,135000,35000,1,00007,India
793372,2024-01-20,504,iron,449,879,430,1,00007,India
788621,2024-01-20,501,iphone 15,60000,80000,20000,1,00325,India
173772,2024-01-20,507,washing machine,6990,16490,9500,1,00320,India
173772,2024-01-20,501,iphone 15,60000,80000,20000,1,00320,India
441521,2024-01-20,505,oven,18490,24000,5510,1,00418,India
441521,2024-01-20,503,mixer,1349,3249,1900,1,00418,India
441521,2024-01-20,504,iron,449,879,430,1,00418,India
222398,2024-01-20,507,washing machine,6990,16490,9500,1,00332,India
222398,2024-01-20,502,iphone 15 pro max,100000,135000,35000,1,00332,India
222398,2024-01-20,506,monitor,3249,8000,4751,1,00332,India
222398,2024-01-20,505,oven,18490,24000,5510,1,00332,India
190853,2024-01-20,502,iphone 15 pro max,100000,135000,35000,1,00383,India
190853,2024-01-20,505,oven,18490,24000,5510,1,00383,India
526645,2024-01-20,502,iphone 15 pro max,100000,135000,35000,1,00163,India
526645,2024-01-20,504,iron,449,879,430,1,00163,India
992710,2024-01-20,506,monitor,3249,8000,4751,1,00242,India
992710,2024-01-20,504,iron,449,879,430,1,00242,India
323259,2024-01-20,504,iron,449,879,430,1,00243,India
323259,2024-01-20,506,monitor,3249,8000,4751,1,00243,India
323259,2024-01-20,502,iphone 15 pro max,100000,135000,35000,1,00243,India
553722,2024-01-20,507,washing machine,6990,16490,9500,1,00333,India
553722,2024-01-20,503,mixer,1349,3249,1900,1,00333,India
553722,2024-01-20,505,oven,18490,24000,5510,1,00333,India
521847,2024-01-20,507,washing machine,6990,16490,9500,1,00241,India
521847,2024-01-20,506,monitor,3249,8000,4751,1,00241,India
521847,2024-01-20,501,iphone 15,60000,80000,20000,1,00241,India
642972,2024-01-20,506,monitor,3249,8000,4751,1,00349,India
642972,2024-01-20,502,iphone 15 pro max,100000,135000,35000,1,00349,India
811249,2024-01-20,503,mixer,1349,3249,1900,1,00236,India
811249,2024-01-20,501,iphone 15,60000,80000,20000,1,00236,India
907589,2024-01-20,502,iphone 15 pro max,100000,135000,35000,1,00098,India
907589,2024-01-20,503,mixer,1349,3249,1900,1,00098,India
907589,2024-01-20,506,monitor,3249,8000,4751,1,00098,India
907589,2024-01-20,501,iphone 15,60000,80000,20000,1,00098,India
483589,2024-01-20,505,oven,18490,24000,5510,1,00373,India
741028,2024-01-20,507,washing machine,6990,16490,9500,1,00225,India
116707,2024-01-20,504,iron,449,879,430,1,00399,India
116707,2024-01-20,505,oven,18490,24000,5510,1,00399,India
967369,2024-01-20,503,mixer,1349,3249,1900,1,00459,India
967369,2024-01-20,502,iphone 15 pro max,100000,135000,35000,1,00459,India
877851,2024-01-20,506,monitor,3249,8000,4751,1,00389,India
877851,2024-01-20,503,mixer,1349,3249,1900,1,00389,India
559680,2024-01-20,504,iron,449,879,430,1,00057,India
327589,2024-01-20,507,washing machine,6990,16490,9500,1,00044,India
953687,2024-01-20,507,washing machine,6990,16490,9500,1,00390,India
953687,2024-01-20,501,iphone 15,60000,80000,20000,1,00390,India
953687,2024-01-20,502,iphone 15 pro max,100000,135000,35000,1,00390,India
842146,2024-01-20,507,washing machine,6990,16490,9500,1,00496,India
676739,2024-01-21,507,washing machine,6990,16490,9500,1,00175,India
676739,2024-01-21,506,monitor,3249,8000,4751,1,00175,India
326832,2024-01-21,505,oven,18490,24000,5510,1,00019,India
326832,2024-01-21,502,iphone 15 pro max,100000,135000,35000,1,00019,India
243511,2024-01-21,506,monitor,3249,8000,4751,1,00068,India
171526,2024-01-21,504,iron,449,879,430,1,00152,India
171526,2024-01-21,503,mixer,1349,3249,1900,1,00152,India
171526,2024-01-21,505,oven,18490,24000,5510,1,00152,India
171526,2024-01-21,507,washing machine,6990,16490,9500,1,00152,India
371123,2024-01-21,507,washing machine,6990,16490,9500,1,00126,India
371123,2024-01-21,506,monitor,3249,8000,4751,1,00126,India
762668,2024-01-21,506,monitor,3249,8000,4751,1,00307,India
762668,2024-01-21,502,iphone 15 pro max,100000,135000,35000,1,00307,India
762668,2024-01-21,505,oven,18490,24000,5510,1,00307,India
557300,2024-01-21,502,iphone 15 pro max,100000,135000,35000,1,00368,India
557300,2024-01-21,501,iphone 15,60000,80000,20000,1,00368,India
557300,2024-01-21,504,iron,449,879,430,1,00368,India
444236,2024-01-21,501,iphone 15,60000,80000,20000,1,00323,India
444236,2024-01-21,507,washing machine,6990,16490,9500,1,00323,India
315759,2024-01-21,506,monitor,3249,8000,4751,1,00081,India
315759,2024-01-21,505,oven,18490,24000,5510,1,00081,India
168265,2024-01-21,506,monitor,3249,8000,4751,1,00039,India
168265,2024-01-21,501,iphone 15,60000,80000,20000,1,00039,India
165761,2024-01-21,505,oven,18490,24000,5510,1,00497,India
263075,2024-01-21,506,monitor,3249,8000,4751,1,00454,India
263075,2024-01-21,504,iron,449,879,430,1,00454,India
381760,2024-01-21,507,washing machine,6990,16490,9500,1,00168,India
381760,2024-01-21,501,iphone 15,60000,80000,20000,1,00168,India
381760,2024-01-21,502,iphone 15 pro max,100000,135000,35000,1,00168,India
381760,2024-01-21,505,oven,18490,24000,5510,1,00168,India
808773,2024-01-21,503,mixer,1349,3249,1900,1,00248,India
808773,2024-01-21,504,iron,449,879,430,1,00248,India
808773,2024-01-21,506,monitor,3249,8000,4751,1,00248,India
353668,2024-01-21,501,iphone 15,60000,80000,20000,1,00310,India
353668,2024-01-21,504,iron,449,879,430,1,00310,India
353668,2024-01-21,503,mixer,1349,3249,1900,1,00310,India
353668,2024-01-21,507,washing machine,6990,16490,9500,1,00310,India
943185,2024-01-21,507,washing machine,6990,16490,9500,1,00233,India
943185,2024-01-21,503,mixer,1349,3249,1900,1,00233,India
943185,2024-01-21,502,iphone 15 pro max,100000,135000,35000,1,00233,India
943185,2024-01-21,506,monitor,3249,8000,4751,1,00233,India
415991,2024-01-21,501,iphone 15,60000,80000,20000,1,00133,India
397442,2024-01-21,503,mixer,1349,3249,1900,1,00493,India
397442,2024-01-21,506,monitor,3249,8000,4751,1,00493,India
397442,2024-01-21,505,oven,18490,24000,5510,1,00493,India
508225,2024-01-21,506,monitor,3249,8000,4751,1,00050,India
508225,2024-01-21,503,mixer,1349,3249,1900,1,00050,India
955505,2024-01-21,502,iphone 15 pro max,100000,135000,35000,1,00030,India
955505,2024-01-21,503,mixer,1349,3249,1900,1,00030,India
598666,2024-01-21,504,iron,449,879,430,1,00284,India
598666,2024-01-21,505,oven,18490,24000,5510,1,00284,India
276902,2024-01-21,505,oven,18490,24000,5510,1,00297,India
276902,2024-01-21,504,iron,449,879,430,1,00297,India
630967,2024-01-21,503,mixer,1349,3249,1900,1,00049,India
630967,2024-01-21,502,iphone 15 pro max,100000,135000,35000,1,00049,India
418530,2024-01-21,505,oven,18490,24000,5510,1,00333,India
418530,2024-01-21,502,iphone 15 pro max,100000,135000,35000,1,00333,India
957528,2024-01-21,501,iphone 15,60000,80000,20000,1,00373,India
203478,2024-01-21,503,mixer,1349,3249,1900,1,00211,India
203478,2024-01-21,507,washing machine,6990,16490,9500,1,00211,India
203478,2024-01-21,505,oven,18490,24000,5510,1,00211,India
630387,2024-01-21,506,monitor,3249,8000,4751,1,00475,India
622012,2024-01-21,507,washing machine,6990,16490,9500,1,00016,India
811980,2024-01-21,506,monitor,3249,8000,4751,1,00456,India
947369,2024-01-21,501,iphone 15,60000,80000,20000,1,00303,India
947369,2024-01-21,507,washing machine,6990,16490,9500,1,00303,India
947369,2024-01-21,506,monitor,3249,8000,4751,1,00303,India
538800,2024-01-21,506,monitor,3249,8000,4751,1,00049,India
538800,2024-01-21,504,iron,449,879,430,1,00049,India
538800,2024-01-21,502,iphone 15 pro max,100000,135000,35000,1,00049,India
124082,2024-01-21,507,washing machine,6990,16490,9500,1,00227,India
124082,2024-01-21,504,iron,449,879,430,1,00227,India
368861,2024-01-21,505,oven,18490,24000,5510,1,00191,India
368861,2024-01-21,501,iphone 15,60000,80000,20000,1,00191,India
533596,2024-01-21,504,iron,449,879,430,1,00447,India
533596,2024-01-21,507,washing machine,6990,16490,9500,1,00447,India
533596,2024-01-21,505,oven,18490,24000,5510,1,00447,India
603892,2024-01-21,507,washing machine,6990,16490,9500,1,00263,India
547033,2024-01-21,507,washing machine,6990,16490,9500,1,00412,India
547033,2024-01-21,505,oven,18490,24000,5510,1,00412,India
243588,2024-01-21,505,oven,18490,24000,5510,1,00164,India
243588,2024-01-21,506,monitor,3249,8000,4751,1,00164,India
243588,2024-01-21,502,iphone 15 pro max,100000,135000,35000,1,00164,India
708831,2024-01-21,504,iron,449,879,430,1,00308,India
708831,2024-01-21,507,washing machine,6990,16490,9500,1,00308,India
708831,2024-01-21,506,monitor,3249,8000,4751,1,00308,India
633162,2024-01-21,504,iron,449,879,430,1,00126,India
921068,2024-01-21,503,mixer,1349,3249,1900,1,00273,India
921068,2024-01-21,502,iphone 15 pro max,100000,135000,35000,1,00273,India
921068,2024-01-21,504,iron,449,879,430,1,00273,India
921068,2024-01-21,501,iphone 15,60000,80000,20000,1,00273,India
662409,2024-01-21,503,mixer,1349,3249,1900,1,00308,India
662409,2024-01-21,507,washing machine,6990,16490,9500,1,00308,India
170726,2024-01-21,501,iphone 15,60000,80000,20000,1,00483,India
170726,2024-01-21,504,iron,449,879,430,1,00483,India
170726,2024-01-21,505,oven,18490,24000,5510,1,00483,India
109304,2024-01-21,505,oven,18490,24000,5510,1,00132,India
109304,2024-01-21,501,iphone 15,60000,80000,20000,1,00132,India
109304,2024-01-21,502,iphone 15 pro max,100000,135000,35000,1,00132,India
109304,2024-01-21,507,washing machine,6990,16490,9500,1,00132,India
463404,2024-01-21,505,oven,18490,24000,5510,1,00018,India
463404,2024-01-21,502,iphone 15 pro max,100000,135000,35000,1,00018,India
463404,2024-01-21,507,washing machine,6990,16490,9500,1,00018,India
144260,2024-01-21,501,iphone 15,60000,80000,20000,1,00187,India
144260,2024-01-21,504,iron,449,879,430,1,00187,India
144260,2024-01-21,507,washing machine,6990,16490,9500,1,00187,India
457554,2024-01-21,501,iphone 15,60000,80000,20000,1,00367,India
371921,2024-01-21,507,washing machine,6990,16490,9500,1,00405,India
371921,2024-01-21,503,mixer,1349,3249,1900,1,00405,India
371921,2024-01-21,502,iphone 15 pro max,100000,135000,35000,1,00405,India
221708,2024-01-21,504,iron,449,879,430,1,00332,India
221708,2024-01-21,505,oven,18490,24000,5510,1,00332,India
221708,2024-01-21,501,iphone 15,60000,80000,20000,1,00332,India
221708,2024-01-21,507,washing machine,6990,16490,9500,1,00332,India
487947,2024-01-21,503,mixer,1349,3249,1900,1,00425,India
487947,2024-01-21,507,washing machine,6990,16490,9500,1,00425,India
770519,2024-01-21,504,iron,449,879,430,1,00397,India
770519,2024-01-21,503,mixer,1349,3249,1900,1,00397,India
770519,2024-01-21,506,monitor,3249,8000,4751,1,00397,India
846622,2024-01-21,502,iphone 15 pro max,100000,135000,35000,1,00371,India
846622,2024-01-21,505,oven,18490,24000,5510,1,00371,India
846622,2024-01-21,504,iron,449,879,430,1,00371,India
281876,2024-01-21,506,monitor,3249,8000,4751,1,00148,India
281876,2024-01-21,501,iphone 15,60000,80000,20000,1,00148,India
281876,2024-01-21,505,oven,18490,24000,5510,1,00148,India
385312,2024-01-21,502,iphone 15 pro max,100000,135000,35000,1,00480,India
260930,2024-01-21,502,iphone 15 pro max,100000,135000,35000,1,00177,India
260930,2024-01-21,507,washing machine,6990,16490,9500,1,00177,India
260930,2024-01-21,506,monitor,3249,8000,4751,1,00177,India
260930,2024-01-21,501,iphone 15,60000,80000,20000,1,00177,India
601190,2024-01-21,503,mixer,1349,3249,1900,1,00292,India
601190,2024-01-21,504,iron,449,879,430,1,00292,India
601190,2024-01-21,505,oven,18490,24000,5510,1,00292,India
601190,2024-01-21,507,washing machine,6990,16490,9500,1,00292,India
601190,2024-01-21,506,monitor,3249,8000,4751,1,00292,India
570728,2024-01-21,505,oven,18490,24000,5510,1,00027,India
706602,2024-01-21,504,iron,449,879,430,1,00240,India
706602,2024-01-21,501,iphone 15,60000,80000,20000,1,00240,India
915204,2024-01-21,501,iphone 15,60000,80000,20000,1,00396,India
882681,2024-01-21,505,oven,18490,24000,5510,1,00157,India
882681,2024-01-21,504,iron,449,879,430,1,00157,India
882681,2024-01-21,503,mixer,1349,3249,1900,1,00157,India
882681,2024-01-21,506,monitor,3249,8000,4751,1,00157,India
882681,2024-01-21,502,iphone 15 pro max,100000,135000,35000,1,00157,India
860211,2024-01-21,507,washing machine,6990,16490,9500,1,00490,India
291303,2024-01-21,503,mixer,1349,3249,1900,1,00271,India
291303,2024-01-21,505,oven,18490,24000,5510,1,00271,India
220155,2024-01-21,501,iphone 15,60000,80000,20000,1,00354,India
220155,2024-01-21,503,mixer,1349,3249,1900,1,00354,India
925153,2024-01-21,504,iron,449,879,430,1,00398,India
925153,2024-01-21,502,iphone 15 pro max,100000,135000,35000,1,00398,India
925153,2024-01-21,503,mixer,1349,3249,1900,1,00398,India
925153,2024-01-21,507,washing machine,6990,16490,9500,1,00398,India
602017,2024-01-21,503,mixer,1349,3249,1900,1,00329,India
602017,2024-01-21,507,washing machine,6990,16490,9500,1,00329,India
602017,2024-01-21,506,monitor,3249,8000,4751,1,00329,India
631500,2024-01-21,504,iron,449,879,430,1,00064,India
631500,2024-01-21,505,oven,18490,24000,5510,1,00064,India
631500,2024-01-21,506,monitor,3249,8000,4751,1,00064,India
323670,2024-01-21,502,iphone 15 pro max,100000,135000,35000,1,00444,India
323670,2024-01-21,507,washing machine,6990,16490,9500,1,00444,India
323670,2024-01-21,501,iphone 15,60000,80000,20000,1,00444,India
626621,2024-01-21,503,mixer,1349,3249,1900,1,00334,India
626621,2024-01-21,502,iphone 15 pro max,100000,135000,35000,1,00334,India
626621,2024-01-21,506,monitor,3249,8000,4751,1,00334,India
626621,2024-01-21,507,washing machine,6990,16490,9500,1,00334,India
756915,2024-01-21,503,mixer,1349,3249,1900,1,00176,India
756915,2024-01-21,504,iron,449,879,430,1,00176,India
196360,2024-01-21,502,iphone 15 pro max,100000,135000,35000,1,00471,India
629270,2024-01-21,503,mixer,1349,3249,1900,1,00135,India
238174,2024-01-21,501,iphone 15,60000,80000,20000,1,00163,India
238174,2024-01-21,505,oven,18490,24000,5510,1,00163,India
238174,2024-01-21,507,washing machine,6990,16490,9500,1,00163,India
767695,2024-01-21,501,iphone 15,60000,80000,20000,1,00143,India
767695,2024-01-21,505,oven,18490,24000,5510,1,00143,India
767695,2024-01-21,506,monitor,3249,8000,4751,1,00143,India
928552,2024-01-21,505,oven,18490,24000,5510,1,00286,India
928552,2024-01-21,501,iphone 15,60000,80000,20000,1,00286,India
928552,2024-01-21,504,iron,449,879,430,1,00286,India
928552,2024-01-21,502,iphone 15 pro max,100000,135000,35000,1,00286,India
799426,2024-01-22,501,iphone 15,60000,80000,20000,1,00301,India
799426,2024-01-22,502,iphone 15 pro max,100000,135000,35000,1,00301,India
799426,2024-01-22,503,mixer,1349,3249,1900,1,00301,India
644819,2024-01-22,501,iphone 15,60000,80000,20000,1,00449,India
644819,2024-01-22,502,iphone 15 pro max,100000,135000,35000,1,00449,India
644819,2024-01-22,506,monitor,3249,8000,4751,1,00449,India
644819,2024-01-22,504,iron,449,879,430,1,00449,India
269943,2024-01-22,505,oven,18490,24000,5510,1,00290,India
269943,2024-01-22,506,monitor,3249,8000,4751,1,00290,India
269943,2024-01-22,501,iphone 15,60000,80000,20000,1,00290,India
974688,2024-01-22,501,iphone 15,60000,80000,20000,1,00295,India
974688,2024-01-22,503,mixer,1349,3249,1900,1,00295,India
974688,2024-01-22,504,iron,449,879,430,1,00295,India
974688,2024-01-22,502,iphone 15 pro max,100000,135000,35000,1,00295,India
845279,2024-01-22,502,iphone 15 pro max,100000,135000,35000,1,00114,India
845279,2024-01-22,506,monitor,3249,8000,4751,1,00114,India
845279,2024-01-22,503,mixer,1349,3249,1900,1,00114,India
874883,2024-01-22,501,iphone 15,60000,80000,20000,1,00482,India
211646,2024-01-22,505,oven,18490,24000,5510,1,00314,India
211646,2024-01-22,504,iron,449,879,430,1,00314,India
645227,2024-01-22,506,monitor,3249,8000,4751,1,00235,India
867140,2024-01-22,504,iron,449,879,430,1,00076,India
867140,2024-01-22,501,iphone 15,60000,80000,20000,1,00076,India
867140,2024-01-22,506,monitor,3249,8000,4751,1,00076,India
867140,2024-01-22,507,washing machine,6990,16490,9500,1,00076,India
505479,2024-01-22,503,mixer,1349,3249,1900,1,00011,India
885266,2024-01-22,502,iphone 15 pro max,100000,135000,35000,1,00315,India
885266,2024-01-22,501,iphone 15,60000,80000,20000,1,00315,India
960251,2024-01-22,506,monitor,3249,8000,4751,1,00189,India
909747,2024-01-22,506,monitor,3249,8000,4751,1,00268,India
909747,2024-01-22,502,iphone 15 pro max,100000,135000,35000,1,00268,India
909747,2024-01-22,504,iron,449,879,430,1,00268,India
335352,2024-01-22,505,oven,18490,24000,5510,1,00418,India
335352,2024-01-22,502,iphone 15 pro max,100000,135000,35000,1,00418,India
335352,2024-01-22,501,iphone 15,60000,80000,20000,1,00418,India
335352,2024-01-22,506,monitor,3249,8000,4751,1,00418,India
880039,2024-01-22,501,iphone 15,60000,80000,20000,1,00389,India
880039,2024-01-22,506,monitor,3249,8000,4751,1,00389,India
880039,2024-01-22,507,washing machine,6990,16490,9500,1,00389,India
762249,2024-01-22,505,oven,18490,24000,5510,1,00296,India
762249,2024-01-22,507,washing machine,6990,16490,9500,1,00296,India
762249,2024-01-22,503,mixer,1349,3249,1900,1,00296,India
303238,2024-01-22,504,iron,449,879,430,1,00268,India
303238,2024-01-22,506,monitor,3249,8000,4751,1,00268,India
303238,2024-01-22,507,washing machine,6990,16490,9500,1,00268,India
594221,2024-01-22,507,washing machine,6990,16490,9500,1,00142,India
594221,2024-01-22,503,mixer,1349,3249,1900,1,00142,India
110885,2024-01-22,503,mixer,1349,3249,1900,1,00366,India
110885,2024-01-22,506,monitor,3249,8000,4751,1,00366,India
110885,2024-01-22,505,oven,18490,24000,5510,1,00366,India
936745,2024-01-22,502,iphone 15 pro max,100000,135000,35000,1,00271,India
936745,2024-01-22,503,mixer,1349,3249,1900,1,00271,India
936745,2024-01-22,501,iphone 15,60000,80000,20000,1,00271,India
638467,2024-01-22,502,iphone 15 pro max,100000,135000,35000,1,00191,India
638467,2024-01-22,504,iron,449,879,430,1,00191,India
259635,2024-01-22,504,iron,449,879,430,1,00081,India
259635,2024-01-22,506,monitor,3249,8000,4751,1,00081,India
259635,2024-01-22,503,mixer,1349,3249,1900,1,00081,India
259635,2024-01-22,502,iphone 15 pro max,100000,135000,35000,1,00081,India
494234,2024-01-22,503,mixer,1349,3249,1900,1,00329,India
494234,2024-01-22,507,washing machine,6990,16490,9500,1,00329,India
667533,2024-01-22,501,iphone 15,60000,80000,20000,1,00051,India
770912,2024-01-22,502,iphone 15 pro max,100000,135000,35000,1,00116,India
115494,2024-01-22,502,iphone 15 pro max,100000,135000,35000,1,00495,India
115494,2024-01-22,506,monitor,3249,8000,4751,1,00495,India
155437,2024-01-22,503,mixer,1349,3249,1900,1,00039,India
155437,2024-01-22,504,iron,449,879,430,1,00039,India
959235,2024-01-22,502,iphone 15 pro max,100000,135000,35000,1,00302,India
959235,2024-01-22,505,oven,18490,24000,5510,1,00302,India
959235,2024-01-22,506,monitor,3249,8000,4751,1,00302,India
648883,2024-01-22,502,iphone 15 pro max,100000,135000,35000,1,00357,India
844464,2024-01-22,503,mixer,1349,3249,1900,1,00313,India
844464,2024-01-22,501,iphone 15,60000,80000,20000,1,00313,India
924976,2024-01-22,502,iphone 15 pro max,100000,135000,35000,1,00377,India
657055,2024-01-22,503,mixer,1349,3249,1900,1,00048,India
657055,2024-01-22,501,iphone 15,60000,80000,20000,1,00048,India
576971,2024-01-22,505,oven,18490,24000,5510,1,00453,India
576971,2024-01-22,507,washing machine,6990,16490,9500,1,00453,India
241889,2024-01-22,504,iron,449,879,430,1,00342,India
241889,2024-01-22,503,mixer,1349,3249,1900,1,00342,India
909664,2024-01-22,502,iphone 15 pro max,100000,135000,35000,1,00099,India
909664,2024-01-22,506,monitor,3249,8000,4751,1,00099,India
909664,2024-01-22,504,iron,449,879,430,1,00099,India
627464,2024-01-22,507,washing machine,6990,16490,9500,1,00202,India
627464,2024-01-22,505,oven,18490,24000,5510,1,00202,India
627464,2024-01-22,503,mixer,1349,3249,1900,1,00202,India
452949,2024-01-22,506,monitor,3249,8000,4751,1,00426,India
974836,2024-01-22,502,iphone 15 pro max,100000,135000,35000,1,00071,India
974836,2024-01-22,503,mixer,1349,3249,1900,1,00071,India
974836,2024-01-22,504,iron,449,879,430,1,00071,India
276873,2024-01-22,502,iphone 15 pro max,100000,135000,35000,1,00284,India
276873,2024-01-22,504,iron,449,879,430,1,00284,India
887946,2024-01-22,503,mixer,1349,3249,1900,1,00467,India
887946,2024-01-22,506,monitor,3249,8000,4751,1,00467,India
887946,2024-01-22,504,iron,449,879,430,1,00467,India
409772,2024-01-22,501,iphone 15,60000,80000,20000,1,00087,India
409772,2024-01-22,506,monitor,3249,8000,4751,1,00087,India
612711,2024-01-22,502,iphone 15 pro max,100000,135000,35000,1,00356,India
904436,2024-01-22,505,oven,18490,24000,5510,1,00346,India
904436,2024-01-22,502,iphone 15 pro max,100000,135000,35000,1,00346,India
904436,2024-01-22,506,monitor,3249,8000,4751,1,00346,India
788860,2024-01-22,506,monitor,3249,8000,4751,1,00173,India
751044,2024-01-22,507,washing machine,6990,16490,9500,1,00309,India
751044,2024-01-22,501,iphone 15,60000,80000,20000,1,00309,India
751044,2024-01-22,504,iron,449,879,430,1,00309,India
751044,2024-01-22,506,monitor,3249,8000,4751,1,00309,India
502104,2024-01-22,501,iphone 15,60000,80000,20000,1,00134,India
422108,2024-01-22,507,washing machine,6990,16490,9500,1,00185,India
422108,2024-01-22,501,iphone 15,60000,80000,20000,1,00185,India
853861,2024-01-22,501,iphone 15,60000,80000,20000,1,00052,India
853861,2024-01-22,502,iphone 15 pro max,100000,135000,35000,1,00052,India
853861,2024-01-22,506,monitor,3249,8000,4751,1,00052,India
853861,2024-01-22,504,iron,449,879,430,1,00052,India
614124,2024-01-22,503,mixer,1349,3249,1900,1,00407,India
614124,2024-01-22,507,washing machine,6990,16490,9500,1,00407,India
727090,2024-01-22,502,iphone 15 pro max,100000,135000,35000,1,00004,India
727090,2024-01-22,501,iphone 15,60000,80000,20000,1,00004,India
135749,2024-01-22,504,iron,449,879,430,1,00083,India
135749,2024-01-22,507,washing machine,6990,16490,9500,1,00083,India
896041,2024-01-22,502,iphone 15 pro max,100000,135000,35000,1,00293,India
896041,2024-01-22,506,monitor,3249,8000,4751,1,00293,India
890794,2024-01-22,502,iphone 15 pro max,100000,135000,35000,1,00448,India
890794,2024-01-22,507,washing machine,6990,16490,9500,1,00448,India
890794,2024-01-22,503,mixer,1349,3249,1900,1,00448,India
890794,2024-01-22,501,iphone 15,60000,80000,20000,1,00448,India
220712,2024-01-22,505,oven,18490,24000,5510,1,00115,India
220712,2024-01-22,503,mixer,1349,3249,1900,1,00115,India
220712,2024-01-22,502,iphone 15 pro max,100000,135000,35000,1,00115,India
220712,2024-01-22,501,iphone 15,60000,80000,20000,1,00115,India
220712,2024-01-22,506,monitor,3249,8000,4751,1,00115,India
256050,2024-01-22,507,washing machine,6990,16490,9500,1,00020,India
256050,2024-01-22,504,iron,449,879,430,1,00020,India
256050,2024-01-22,505,oven,18490,24000,5510,1,00020,India
429007,2024-01-22,504,iron,449,879,430,1,00067,India
429007,2024-01-22,501,iphone 15,60000,80000,20000,1,00067,India
429007,2024-01-22,502,iphone 15 pro max,100000,135000,35000,1,00067,India
562947,2024-01-22,505,oven,18490,24000,5510,1,00255,India
562947,2024-01-22,501,iphone 15,60000,80000,20000,1,00255,India
434275,2024-01-22,501,iphone 15,60000,80000,20000,1,00072,India
434275,2024-01-22,506,monitor,3249,8000,4751,1,00072,India
434275,2024-01-22,504,iron,449,879,430,1,00072,India
231337,2024-01-22,504,iron,449,879,430,1,00396,India
231337,2024-01-22,503,mixer,1349,3249,1900,1,00396,India
231337,2024-01-22,502,iphone 15 pro max,100000,135000,35000,1,00396,India
466205,2024-01-22,504,iron,449,879,430,1,00052,India
801856,2024-01-22,506,monitor,3249,8000,4751,1,00064,India
801856,2024-01-22,504,iron,449,879,430,1,00064,India
801856,2024-01-22,505,oven,18490,24000,5510,1,00064,India
801856,2024-01-22,502,iphone 15 pro max,100000,135000,35000,1,00064,India
779203,2024-01-22,503,mixer,1349,3249,1900,1,00482,India
999292,2024-01-22,503,mixer,1349,3249,1900,1,00483,India
999292,2024-01-22,502,iphone 15 pro max,100000,135000,35000,1,00483,India
999292,2024-01-22,507,washing machine,6990,16490,9500,1,00483,India
999292,2024-01-22,505,oven,18490,24000,5510,1,00483,India
455362,2024-01-22,505,oven,18490,24000,5510,1,00446,India
652392,2024-01-22,506,monitor,3249,8000,4751,1,00473,India
652392,2024-01-22,507,washing machine,6990,16490,9500,1,00473,India
652392,2024-01-22,502,iphone 15 pro max,100000,135000,35000,1,00473,India
190228,2024-01-22,502,iphone 15 pro max,100000,135000,35000,1,00185,India
533217,2024-01-22,506,monitor,3249,8000,4751,1,00024,India
533217,2024-01-22,501,iphone 15,60000,80000,20000,1,00024,India
533217,2024-01-22,503,mixer,1349,3249,1900,1,00024,India
533217,2024-01-22,507,washing machine,6990,16490,9500,1,00024,India
533217,2024-01-22,504,iron,449,879,430,1,00024,India
611236,2024-01-22,506,monitor,3249,8000,4751,1,00048,India
611236,2024-01-22,505,oven,18490,24000,5510,1,00048,India
164719,2024-01-22,502,iphone 15 pro max,100000,135000,35000,1,00350,India
431335,2024-01-22,506,monitor,3249,8000,4751,1,00324,India
431335,2024-01-22,501,iphone 15,60000,80000,20000,1,00324,India
431335,2024-01-22,503,mixer,1349,3249,1900,1,00324,India
907050,2024-01-22,503,mixer,1349,3249,1900,1,00088,India
907050,2024-01-22,502,iphone 15 pro max,100000,135000,35000,1,00088,India
907050,2024-01-22,507,washing machine,6990,16490,9500,1,00088,India
480704,2024-01-22,506,monitor,3249,8000,4751,1,00009,India
480704,2024-01-22,507,washing machine,6990,16490,9500,1,00009,India
480704,2024-01-22,502,iphone 15 pro max,100000,135000,35000,1,00009,India
394470,2024-01-22,507,washing machine,6990,16490,9500,1,00159,India
394470,2024-01-22,503,mixer,1349,3249,1900,1,00159,India
459859,2024-01-22,506,monitor,3249,8000,4751,1,00191,India
459859,2024-01-22,505,oven,18490,24000,5510,1,00191,India
498322,2024-01-22,507,washing machine,6990,16490,9500,1,00141,India
604862,2024-01-22,504,iron,449,879,430,1,00351,India
604862,2024-01-22,501,iphone 15,60000,80000,20000,1,00351,India
604862,2024-01-22,507,washing machine,6990,16490,9500,1,00351,India
349196,2024-01-22,507,washing machine,6990,16490,9500,1,00166,India
349196,2024-01-22,501,iphone 15,60000,80000,20000,1,00166,India
349196,2024-01-22,506,monitor,3249,8000,4751,1,00166,India
497682,2024-01-22,506,monitor,3249,8000,4751,1,00499,India
497682,2024-01-22,505,oven,18490,24000,5510,1,00499,India
497682,2024-01-22,502,iphone 15 pro max,100000,135000,35000,1,00499,India
497682,2024-01-22,503,mixer,1349,3249,1900,1,00499,India
846043,2024-01-22,502,iphone 15 pro max,100000,135000,35000,1,00259,India
846043,2024-01-22,501,iphone 15,60000,80000,20000,1,00259,India
846043,2024-01-22,505,oven,18490,24000,5510,1,00259,India
846043,2024-01-22,506,monitor,3249,8000,4751,1,00259,India
659155,2024-01-22,504,iron,449,879,430,1,00106,India
659155,2024-01-22,503,mixer,1349,3249,1900,1,00106,India
522583,2024-01-22,504,iron,449,879,430,1,00305,India
773819,2024-01-22,506,monitor,3249,8000,4751,1,00112,India
773819,2024-01-22,503,mixer,1349,3249,1900,1,00112,India
739346,2024-01-22,502,iphone 15 pro max,100000,135000,35000,1,00167,India
739346,2024-01-22,503,mixer,1349,3249,1900,1,00167,India
867561,2024-01-22,505,oven,18490,24000,5510,1,00021,India
867561,2024-01-22,507,washing machine,6990,16490,9500,1,00021,India
867561,2024-01-22,504,iron,449,879,430,1,00021,India
867561,2024-01-22,502,iphone 15 pro max,100000,135000,35000,1,00021,India
856152,2024-01-22,505,oven,18490,24000,5510,1,00454,India
856152,2024-01-22,502,iphone 15 pro max,100000,135000,35000,1,00454,India
856152,2024-01-22,503,mixer,1349,3249,1900,1,00454,India
856152,2024-01-22,507,washing machine,6990,16490,9500,1,00454,India
856152,2024-01-22,504,iron,449,879,430,1,00454,India
850554,2024-01-22,506,monitor,3249,8000,4751,1,00083,India
850554,2024-01-22,504,iron,449,879,430,1,00083,India
850554,2024-01-22,507,washing machine,6990,16490,9500,1,00083,India
815446,2024-01-23,503,mixer,1349,3249,1900,1,00022,India
815446,2024-01-23,505,oven,18490,24000,5510,1,00022,India
815446,2024-01-23,507,washing machine,6990,16490,9500,1,00022,India
844887,2024-01-23,506,monitor,3249,8000,4751,1,00031,India
844887,2024-01-23,504,iron,449,879,430,1,00031,India
955832,2024-01-23,506,monitor,3249,8000,4751,1,00069,India
212987,2024-01-23,506,monitor,3249,8000,4751,1,00151,India
610873,2024-01-23,505,oven,18490,24000,5510,1,00282,India
610873,2024-01-23,502,iphone 15 pro max,100000,135000,35000,1,00282,India
610873,2024-01-23,506,monitor,3249,8000,4751,1,00282,India
770948,2024-01-23,502,iphone 15 pro max,100000,135000,35000,1,00170,India
770948,2024-01-23,506,monitor,3249,8000,4751,1,00170,India
224722,2024-01-23,503,mixer,1349,3249,1900,1,00066,India
224722,2024-01-23,506,monitor,3249,8000,4751,1,00066,India
750236,2024-01-23,505,oven,18490,24000,5510,1,00439,India
461777,2024-01-23,501,iphone 15,60000,80000,20000,1,00405,India
461777,2024-01-23,506,monitor,3249,8000,4751,1,00405,India
461777,2024-01-23,507,washing machine,6990,16490,9500,1,00405,India
461777,2024-01-23,502,iphone 15 pro max,100000,135000,35000,1,00405,India
562092,2024-01-23,502,iphone 15 pro max,100000,135000,35000,1,00380,India
528805,2024-01-23,501,iphone 15,60000,80000,20000,1,00469,India
528805,2024-01-23,502,iphone 15 pro max,100000,135000,35000,1,00469,India
528805,2024-01-23,503,mixer,1349,3249,1900,1,00469,India
528805,2024-01-23,506,monitor,3249,8000,4751,1,00469,India
787547,2024-01-23,501,iphone 15,60000,80000,20000,1,00411,India
787547,2024-01-23,506,monitor,3249,8000,4751,1,00411,India
101469,2024-01-23,506,monitor,3249,8000,4751,1,00101,India
101469,2024-01-23,503,mixer,1349,3249,1900,1,00101,India
101469,2024-01-23,504,iron,449,879,430,1,00101,India
268880,2024-01-23,506,monitor,3249,8000,4751,1,00308,India
268880,2024-01-23,501,iphone 15,60000,80000,20000,1,00308,India
169524,2024-01-23,501,iphone 15,60000,80000,20000,1,00076,India
169524,2024-01-23,504,iron,449,879,430,1,00076,India
519537,2024-01-23,501,iphone 15,60000,80000,20000,1,00022,India
519537,2024-01-23,502,iphone 15 pro max,100000,135000,35000,1,00022,India
519537,2024-01-23,504,iron,449,879,430,1,00022,India
155368,2024-01-23,502,iphone 15 pro max,100000,135000,35000,1,00459,India
155368,2024-01-23,504,iron,449,879,430,1,00459,India
155368,2024-01-23,501,iphone 15,60000,80000,20000,1,00459,India
996057,2024-01-23,501,iphone 15,60000,80000,20000,1,00140,India
648090,2024-01-23,506,monitor,3249,8000,4751,1,00115,India
648090,2024-01-23,503,mixer,1349,3249,1900,1,00115,India
336474,2024-01-23,505,oven,18490,24000,5510,1,00102,India
336474,2024-01-23,506,monitor,3249,8000,4751,1,00102,India
828284,2024-01-23,506,monitor,3249,8000,4751,1,00463,India
963989,2024-01-23,501,iphone 15,60000,80000,20000,1,00114,India
963989,2024-01-23,506,monitor,3249,8000,4751,1,00114,India
428148,2024-01-23,502,iphone 15 pro max,100000,135000,35000,1,00364,India
428148,2024-01-23,503,mixer,1349,3249,1900,1,00364,India
428148,2024-01-23,501,iphone 15,60000,80000,20000,1,00364,India
915065,2024-01-23,502,iphone 15 pro max,100000,135000,35000,1,00178,India
915065,2024-01-23,504,iron,449,879,430,1,00178,India
311145,2024-01-23,506,monitor,3249,8000,4751,1,00420,India
311145,2024-01-23,505,oven,18490,24000,5510,1,00420,India
311145,2024-01-23,502,iphone 15 pro max,100000,135000,35000,1,00420,India
311145,2024-01-23,504,iron,449,879,430,1,00420,India
678269,2024-01-23,506,monitor,3249,8000,4751,1,00227,India
973361,2024-01-23,502,iphone 15 pro max,100000,135000,35000,1,00465,India
973361,2024-01-23,505,oven,18490,24000,5510,1,00465,India
973361,2024-01-23,503,mixer,1349,3249,1900,1,00465,India
714489,2024-01-23,507,washing machine,6990,16490,9500,1,00396,India
714489,2024-01-23,501,iphone 15,60000,80000,20000,1,00396,India
714489,2024-01-23,505,oven,18490,24000,5510,1,00396,India
714489,2024-01-23,506,monitor,3249,8000,4751,1,00396,India
382759,2024-01-23,503,mixer,1349,3249,1900,1,00100,India
697140,2024-01-23,506,monitor,3249,8000,4751,1,00068,India
697140,2024-01-23,503,mixer,1349,3249,1900,1,00068,India
697140,2024-01-23,502,iphone 15 pro max,100000,135000,35000,1,00068,India
697140,2024-01-23,505,oven,18490,24000,5510,1,00068,India
457113,2024-01-23,506,monitor,3249,8000,4751,1,00212,India
457113,2024-01-23,504,iron,449,879,430,1,00212,India
457113,2024-01-23,501,iphone 15,60000,80000,20000,1,00212,India
232720,2024-01-23,501,iphone 15,60000,80000,20000,1,00083,India
903890,2024-01-23,502,iphone 15 pro max,100000,135000,35000,1,00047,India
903890,2024-01-23,505,oven,18490,24000,5510,1,00047,India
903890,2024-01-23,507,washing machine,6990,16490,9500,1,00047,India
903890,2024-01-23,501,iphone 15,60000,80000,20000,1,00047,India
934802,2024-01-23,501,iphone 15,60000,80000,20000,1,00361,India
339773,2024-01-23,503,mixer,1349,3249,1900,1,00111,India
962130,2024-01-23,507,washing machine,6990,16490,9500,1,00111,India
962130,2024-01-23,503,mixer,1349,3249,1900,1,00111,India
166495,2024-01-23,501,iphone 15,60000,80000,20000,1,00396,India
998083,2024-01-23,502,iphone 15 pro max,100000,135000,35000,1,00282,India
998083,2024-01-23,503,mixer,1349,3249,1900,1,00282,India
998083,2024-01-23,507,washing machine,6990,16490,9500,1,00282,India
546579,2024-01-23,504,iron,449,879,430,1,00444,India
546579,2024-01-23,503,mixer,1349,3249,1900,1,00444,India
633433,2024-01-23,507,washing machine,6990,16490,9500,1,00060,India
633433,2024-01-23,504,iron,449,879,430,1,00060,India
633433,2024-01-23,502,iphone 15 pro max,100000,135000,35000,1,00060,India
342243,2024-01-23,501,iphone 15,60000,80000,20000,1,00224,India
342243,2024-01-23,506,monitor,3249,8000,4751,1,00224,India
342243,2024-01-23,503,mixer,1349,3249,1900,1,00224,India
668450,2024-01-23,504,iron,449,879,430,1,00370,India
668450,2024-01-23,502,iphone 15 pro max,100000,135000,35000,1,00370,India
515569,2024-01-23,504,iron,449,879,430,1,00486,India
515569,2024-01-23,506,monitor,3249,8000,4751,1,00486,India
478518,2024-01-23,506,monitor,3249,8000,4751,1,00069,India
478518,2024-01-23,501,iphone 15,60000,80000,20000,1,00069,India
244736,2024-01-23,507,washing machine,6990,16490,9500,1,00054,India
244736,2024-01-23,502,iphone 15 pro max,100000,135000,35000,1,00054,India
244736,2024-01-23,503,mixer,1349,3249,1900,1,00054,India
901673,2024-01-23,506,monitor,3249,8000,4751,1,00337,India
901673,2024-01-23,505,oven,18490,24000,5510,1,00337,India
999176,2024-01-23,505,oven,18490,24000,5510,1,00045,India
999176,2024-01-23,503,mixer,1349,3249,1900,1,00045,India
999176,2024-01-23,504,iron,449,879,430,1,00045,India
999176,2024-01-23,502,iphone 15 pro max,100000,135000,35000,1,00045,India
994743,2024-01-23,504,iron,449,879,430,1,00475,India
994743,2024-01-23,505,oven,18490,24000,5510,1,00475,India
994743,2024-01-23,502,iphone 15 pro max,100000,135000,35000,1,00475,India
923602,2024-01-23,506,monitor,3249,8000,4751,1,00175,India
923602,2024-01-23,501,iphone 15,60000,80000,20000,1,00175,India
923602,2024-01-23,502,iphone 15 pro max,100000,135000,35000,1,00175,India
432614,2024-01-23,503,mixer,1349,3249,1900,1,00115,India
432614,2024-01-23,505,oven,18490,24000,5510,1,00115,India
432614,2024-01-23,504,iron,449,879,430,1,00115,India
432614,2024-01-23,507,washing machine,6990,16490,9500,1,00115,India
432614,2024-01-23,506,monitor,3249,8000,4751,1,00115,India
343637,2024-01-23,507,washing machine,6990,16490,9500,1,00174,India
935208,2024-01-23,504,iron,449,879,430,1,00296,India
563409,2024-01-23,506,monitor,3249,8000,4751,1,00118,India
563409,2024-01-23,501,iphone 15,60000,80000,20000,1,00118,India
950519,2024-01-23,503,mixer,1349,3249,1900,1,00285,India
950519,2024-01-23,505,oven,18490,24000,5510,1,00285,India
950519,2024-01-23,501,iphone 15,60000,80000,20000,1,00285,India
950519,2024-01-23,506,monitor,3249,8000,4751,1,00285,India
735001,2024-01-23,503,mixer,1349,3249,1900,1,00206,India
778863,2024-01-23,501,iphone 15,60000,80000,20000,1,00116,India
250144,2024-01-23,502,iphone 15 pro max,100000,135000,35000,1,00288,India
210517,2024-01-24,504,iron,449,879,430,1,00429,India
210517,2024-01-24,505,oven,18490,24000,5510,1,00429,India
736547,2024-01-24,506,monitor,3249,8000,4751,1,00133,India
736547,2024-01-24,504,iron,449,879,430,1,00133,India
736547,2024-01-24,505,oven,18490,24000,5510,1,00133,India
274158,2024-01-24,504,iron,449,879,430,1,00080,India
830677,2024-01-24,503,mixer,1349,3249,1900,1,00126,India
830677,2024-01-24,505,oven,18490,24000,5510,1,00126,India
830677,2024-01-24,504,iron,449,879,430,1,00126,India
830677,2024-01-24,507,washing machine,6990,16490,9500,1,00126,India
217987,2024-01-24,506,monitor,3249,8000,4751,1,00009,India
217987,2024-01-24,501,iphone 15,60000,80000,20000,1,00009,India
217987,2024-01-24,503,mixer,1349,3249,1900,1,00009,India
974673,2024-01-24,503,mixer,1349,3249,1900,1,00147,India
974673,2024-01-24,501,iphone 15,60000,80000,20000,1,00147,India
304751,2024-01-24,503,mixer,1349,3249,1900,1,00497,India
304751,2024-01-24,505,oven,18490,24000,5510,1,00497,India
215967,2024-01-24,503,mixer,1349,3249,1900,1,00312,India
253742,2024-01-24,502,iphone 15 pro max,100000,135000,35000,1,00079,India
253742,2024-01-24,507,washing machine,6990,16490,9500,1,00079,India
253742,2024-01-24,506,monitor,3249,8000,4751,1,00079,India
154760,2024-01-24,504,iron,449,879,430,1,00317,India
154760,2024-01-24,503,mixer,1349,3249,1900,1,00317,India
154760,2024-01-24,507,washing machine,6990,16490,9500,1,00317,India
735418,2024-01-24,502,iphone 15 pro max,100000,135000,35000,1,00304,India
735418,2024-01-24,506,monitor,3249,8000,4751,1,00304,India
344868,2024-01-24,507,washing machine,6990,16490,9500,1,00305,India
881638,2024-01-24,501,iphone 15,60000,80000,20000,1,00459,India
881638,2024-01-24,504,iron,449,879,430,1,00459,India
881638,2024-01-24,505,oven,18490,24000,5510,1,00459,India
881638,2024-01-24,502,iphone 15 pro max,100000,135000,35000,1,00459,India
875148,2024-01-24,503,mixer,1349,3249,1900,1,00412,India
875148,2024-01-24,502,iphone 15 pro max,100000,135000,35000,1,00412,India
875148,2024-01-24,507,washing machine,6990,16490,9500,1,00412,India
713929,2024-01-24,502,iphone 15 pro max,100000,135000,35000,1,00141,India
713929,2024-01-24,501,iphone 15,60000,80000,20000,1,00141,India
713929,2024-01-24,506,monitor,3249,8000,4751,1,00141,India
414361,2024-01-24,503,mixer,1349,3249,1900,1,00381,India
414361,2024-01-24,505,oven,18490,24000,5510,1,00381,India
414361,2024-01-24,501,iphone 15,60000,80000,20000,1,00381,India
414361,2024-01-24,506,monitor,3249,8000,4751,1,00381,India
313129,2024-01-24,507,washing machine,6990,16490,9500,1,00220,India
606243,2024-01-24,506,monitor,3249,8000,4751,1,00424,India
606243,2024-01-24,507,washing machine,6990,16490,9500,1,00424,India
793060,2024-01-24,501,iphone 15,60000,80000,20000,1,00014,India
793060,2024-01-24,507,washing machine,6990,16490,9500,1,00014,India
796795,2024-01-24,502,iphone 15 pro max,100000,135000,35000,1,00345,India
796795,2024-01-24,503,mixer,1349,3249,1900,1,00345,India
796795,2024-01-24,507,washing machine,6990,16490,9500,1,00345,India
796795,2024-01-24,505,oven,18490,24000,5510,1,00345,India
456708,2024-01-24,505,oven,18490,24000,5510,1,00017,India
456708,2024-01-24,504,iron,449,879,430,1,00017,India
205248,2024-01-24,502,iphone 15 pro max,100000,135000,35000,1,00474,India
205248,2024-01-24,506,monitor,3249,8000,4751,1,00474,India
205248,2024-01-24,503,mixer,1349,3249,1900,1,00474,India
654634,2024-01-24,503,mixer,1349,3249,1900,1,00411,India
654634,2024-01-24,506,monitor,3249,8000,4751,1,00411,India
654634,2024-01-24,501,iphone 15,60000,80000,20000,1,00411,India
654634,2024-01-24,505,oven,18490,24000,5510,1,00411,India
785163,2024-01-24,503,mixer,1349,3249,1900,1,00147,India
785163,2024-01-24,507,washing machine,6990,16490,9500,1,00147,India
785163,2024-01-24,506,monitor,3249,8000,4751,1,00147,India
432845,2024-01-24,502,iphone 15 pro max,100000,135000,35000,1,00213,India
432845,2024-01-24,503,mixer,1349,3249,1900,1,00213,India
432845,2024-01-24,505,oven,18490,24000,5510,1,00213,India
476060,2024-01-24,501,iphone 15,60000,80000,20000,1,00120,India
476060,2024-01-24,505,oven,18490,24000,5510,1,00120,India
476060,2024-01-24,504,iron,449,879,430,1,00120,India
471710,2024-01-24,505,oven,18490,24000,5510,1,00207,India
471710,2024-01-24,506,monitor,3249,8000,4751,1,00207,India
471710,2024-01-24,507,washing machine,6990,16490,9500,1,00207,India
795702,2024-01-24,507,washing machine,6990,16490,9500,1,00457,India
795702,2024-01-24,505,oven,18490,24000,5510,1,00457,India
795702,2024-01-24,506,monitor,3249,8000,4751,1,00457,India
457422,2024-01-24,507,washing machine,6990,16490,9500,1,00119,India
457422,2024-01-24,501,iphone 15,60000,80000,20000,1,00119,India
705417,2024-01-24,503,mixer,1349,3249,1900,1,00403,India
705417,2024-01-24,506,monitor,3249,8000,4751,1,00403,India
705417,2024-01-24,505,oven,18490,24000,5510,1,00403,India
211198,2024-01-24,503,mixer,1349,3249,1900,1,00482,India
211198,2024-01-24,504,iron,449,879,430,1,00482,India
211198,2024-01-24,502,iphone 15 pro max,100000,135000,35000,1,00482,India
211198,2024-01-24,505,oven,18490,24000,5510,1,00482,India
211198,2024-01-24,501,iphone 15,60000,80000,20000,1,00482,India
631292,2024-01-24,507,washing machine,6990,16490,9500,1,00499,India
631292,2024-01-24,501,iphone 15,60000,80000,20000,1,00499,India
631292,2024-01-24,503,mixer,1349,3249,1900,1,00499,India
967511,2024-01-24,501,iphone 15,60000,80000,20000,1,00290,India
967511,2024-01-24,504,iron,449,879,430,1,00290,India
967511,2024-01-24,502,iphone 15 pro max,100000,135000,35000,1,00290,India
967511,2024-01-24,505,oven,18490,24000,5510,1,00290,India
431117,2024-01-24,507,washing machine,6990,16490,9500,1,00263,India
534258,2024-01-24,506,monitor,3249,8000,4751,1,00481,India
121276,2024-01-24,503,mixer,1349,3249,1900,1,00072,India
121276,2024-01-24,506,monitor,3249,8000,4751,1,00072,India
121276,2024-01-24,507,washing machine,6990,16490,9500,1,00072,India
121276,2024-01-24,501,iphone 15,60000,80000,20000,1,00072,India
391783,2024-01-24,505,oven,18490,24000,5510,1,00320,India
391783,2024-01-24,507,washing machine,6990,16490,9500,1,00320,India
612919,2024-01-24,502,iphone 15 pro max,100000,135000,35000,1,00078,India
766577,2024-01-24,502,iphone 15 pro max,100000,135000,35000,1,00423,India
766577,2024-01-24,506,monitor,3249,8000,4751,1,00423,India
854071,2024-01-24,503,mixer,1349,3249,1900,1,00437,India
854071,2024-01-24,505,oven,18490,24000,5510,1,00437,India
284619,2024-01-24,507,washing machine,6990,16490,9500,1,00012,India
284619,2024-01-24,504,iron,449,879,430,1,00012,India
284619,2024-01-24,506,monitor,3249,8000,4751,1,00012,India
846145,2024-01-24,505,oven,18490,24000,5510,1,00201,India
846145,2024-01-24,504,iron,449,879,430,1,00201,India
233809,2024-01-24,504,iron,449,879,430,1,00479,India
233809,2024-01-24,503,mixer,1349,3249,1900,1,00479,India
233809,2024-01-24,502,iphone 15 pro max,100000,135000,35000,1,00479,India
167073,2024-01-24,501,iphone 15,60000,80000,20000,1,00193,India
167073,2024-01-24,505,oven,18490,24000,5510,1,00193,India
167073,2024-01-24,503,mixer,1349,3249,1900,1,00193,India
270009,2024-01-24,502,iphone 15 pro max,100000,135000,35000,1,00310,India
702791,2024-01-24,503,mixer,1349,3249,1900,1,00064,India
702791,2024-01-24,507,washing machine,6990,16490,9500,1,00064,India
702791,2024-01-24,505,oven,18490,24000,5510,1,00064,India
400860,2024-01-24,503,mixer,1349,3249,1900,1,00083,India
400860,2024-01-24,505,oven,18490,24000,5510,1,00083,India
630730,2024-01-24,504,iron,449,879,430,1,00004,India
368232,2024-01-24,507,washing machine,6990,16490,9500,1,00318,India
368232,2024-01-24,506,monitor,3249,8000,4751,1,00318,India
368232,2024-01-24,502,iphone 15 pro max,100000,135000,35000,1,00318,India
368232,2024-01-24,503,mixer,1349,3249,1900,1,00318,India
368232,2024-01-24,505,oven,18490,24000,5510,1,00318,India
803921,2024-01-24,505,oven,18490,24000,5510,1,00258,India
803921,2024-01-24,502,iphone 15 pro max,100000,135000,35000,1,00258,India
303364,2024-01-24,506,monitor,3249,8000,4751,1,00054,India
303364,2024-01-24,507,washing machine,6990,16490,9500,1,00054,India
303364,2024-01-24,504,iron,449,879,430,1,00054,India
946032,2024-01-24,505,oven,18490,24000,5510,1,00412,India
946032,2024-01-24,506,monitor,3249,8000,4751,1,00412,India
520776,2024-01-25,505,oven,18490,24000,5510,1,00498,India
520776,2024-01-25,507,washing machine,6990,16490,9500,1,00498,India
520776,2024-01-25,503,mixer,1349,3249,1900,1,00498,India
520776,2024-01-25,506,monitor,3249,8000,4751,1,00498,India
520776,2024-01-25,504,iron,449,879,430,1,00498,India
932363,2024-01-25,504,iron,449,879,430,1,00471,India
932363,2024-01-25,503,mixer,1349,3249,1900,1,00471,India
728626,2024-01-25,502,iphone 15 pro max,100000,135000,35000,1,00067,India
728626,2024-01-25,503,mixer,1349,3249,1900,1,00067,India
520331,2024-01-25,505,oven,18490,24000,5510,1,00154,India
520331,2024-01-25,502,iphone 15 pro max,100000,135000,35000,1,00154,India
813352,2024-01-25,502,iphone 15 pro max,100000,135000,35000,1,00126,India
813352,2024-01-25,505,oven,18490,24000,5510,1,00126,India
105513,2024-01-25,505,oven,18490,24000,5510,1,00278,India
105513,2024-01-25,504,iron,449,879,430,1,00278,India
105513,2024-01-25,506,monitor,3249,8000,4751,1,00278,India
105513,2024-01-25,507,washing machine,6990,16490,9500,1,00278,India
320525,2024-01-25,505,oven,18490,24000,5510,1,00350,India
618304,2024-01-25,502,iphone 15 pro max,100000,135000,35000,1,00349,India
639667,2024-01-25,506,monitor,3249,8000,4751,1,00376,India
639667,2024-01-25,502,iphone 15 pro max,100000,135000,35000,1,00376,India
994823,2024-01-25,504,iron,449,879,430,1,00049,India
994823,2024-01-25,502,iphone 15 pro max,100000,135000,35000,1,00049,India
994823,2024-01-25,507,washing machine,6990,16490,9500,1,00049,India
841241,2024-01-25,502,iphone 15 pro max,100000,135000,35000,1,00146,India
841241,2024-01-25,504,iron,449,879,430,1,00146,India
410690,2024-01-25,507,washing machine,6990,16490,9500,1,00222,India
219558,2024-01-25,506,monitor,3249,8000,4751,1,00475,India
177726,2024-01-25,501,iphone 15,60000,80000,20000,1,00070,India
956217,2024-01-25,502,iphone 15 pro max,100000,135000,35000,1,00153,India
956217,2024-01-25,503,mixer,1349,3249,1900,1,00153,India
956217,2024-01-25,505,oven,18490,24000,5510,1,00153,India
325597,2024-01-25,503,mixer,1349,3249,1900,1,00313,India
325597,2024-01-25,501,iphone 15,60000,80000,20000,1,00313,India
325597,2024-01-25,507,washing machine,6990,16490,9500,1,00313,India
969453,2024-01-25,501,iphone 15,60000,80000,20000,1,00450,India
969453,2024-01-25,503,mixer,1349,3249,1900,1,00450,India
969453,2024-01-25,504,iron,449,879,430,1,00450,India
156517,2024-01-25,507,washing machine,6990,16490,9500,1,00011,India
134198,2024-01-25,501,iphone 15,60000,80000,20000,1,00013,India
134198,2024-01-25,504,iron,449,879,430,1,00013,India
134198,2024-01-25,505,oven,18490,24000,5510,1,00013,India
595969,2024-01-25,501,iphone 15,60000,80000,20000,1,00165,India
595969,2024-01-25,506,monitor,3249,8000,4751,1,00165,India
595969,2024-01-25,503,mixer,1349,3249,1900,1,00165,India
595969,2024-01-25,504,iron,449,879,430,1,00165,India
190138,2024-01-25,505,oven,18490,24000,5510,1,00298,India
190138,2024-01-25,503,mixer,1349,3249,1900,1,00298,India
190138,2024-01-25,502,iphone 15 pro max,100000,135000,35000,1,00298,India
190138,2024-01-25,504,iron,449,879,430,1,00298,India
244704,2024-01-25,505,oven,18490,24000,5510,1,00215,India
244704,2024-01-25,507,washing machine,6990,16490,9500,1,00215,India
244704,2024-01-25,502,iphone 15 pro max,100000,135000,35000,1,00215,India
579611,2024-01-25,504,iron,449,879,430,1,00108,India
579611,2024-01-25,501,iphone 15,60000,80000,20000,1,00108,India
882669,2024-01-25,505,oven,18490,24000,5510,1,00329,India
882669,2024-01-25,502,iphone 15 pro max,100000,135000,35000,1,00329,India
882669,2024-01-25,507,washing machine,6990,16490,9500,1,00329,India
890729,2024-01-25,503,mixer,1349,3249,1900,1,00464,India
890729,2024-01-25,505,oven,18490,24000,5510,1,00464,India
505530,2024-01-25,501,iphone 15,60000,80000,20000,1,00431,India
505530,2024-01-25,504,iron,449,879,430,1,00431,India
948014,2024-01-25,504,iron,449,879,430,1,00010,India
226440,2024-01-25,502,iphone 15 pro max,100000,135000,35000,1,00097,India
226440,2024-01-25,504,iron,449,879,430,1,00097,India
783337,2024-01-25,505,oven,18490,24000,5510,1,00465,India
706735,2024-01-25,504,iron,449,879,430,1,00300,India
706735,2024-01-25,505,oven,18490,24000,5510,1,00300,India
225387,2024-01-25,506,monitor,3249,8000,4751,1,00170,India
225387,2024-01-25,504,iron,449,879,430,1,00170,India
225387,2024-01-25,507,washing machine,6990,16490,9500,1,00170,India
217880,2024-01-25,505,oven,18490,24000,5510,1,00045,India
217880,2024-01-25,502,iphone 15 pro max,100000,135000,35000,1,00045,India
217880,2024-01-25,501,iphone 15,60000,80000,20000,1,00045,India
217880,2024-01-25,504,iron,449,879,430,1,00045,India
217880,2024-01-25,506,monitor,3249,8000,4751,1,00045,India
114561,2024-01-25,506,monitor,3249,8000,4751,1,00429,India
833969,2024-01-25,505,oven,18490,24000,5510,1,00023,India
833969,2024-01-25,507,washing machine,6990,16490,9500,1,00023,India
833969,2024-01-25,506,monitor,3249,8000,4751,1,00023,India
682115,2024-01-25,502,iphone 15 pro max,100000,135000,35000,1,00299,India
682115,2024-01-25,505,oven,18490,24000,5510,1,00299,India
682115,2024-01-25,507,washing machine,6990,16490,9500,1,00299,India
128677,2024-01-25,503,mixer,1349,3249,1900,1,00316,India
128677,2024-01-25,504,iron,449,879,430,1,00316,India
785345,2024-01-25,504,iron,449,879,430,1,00245,India
785345,2024-01-25,507,washing machine,6990,16490,9500,1,00245,India
785345,2024-01-25,505,oven,18490,24000,5510,1,00245,India
307126,2024-01-25,506,monitor,3249,8000,4751,1,00205,India
307126,2024-01-25,503,mixer,1349,3249,1900,1,00205,India
910542,2024-01-25,501,iphone 15,60000,80000,20000,1,00355,India
910542,2024-01-25,502,iphone 15 pro max,100000,135000,35000,1,00355,India
910542,2024-01-25,506,monitor,3249,8000,4751,1,00355,India
697290,2024-01-25,503,mixer,1349,3249,1900,1,00488,India
697290,2024-01-25,506,monitor,3249,8000,4751,1,00488,India
697290,2024-01-25,507,washing machine,6990,16490,9500,1,00488,India
811522,2024-01-25,507,washing machine,6990,16490,9500,1,00481,India
742141,2024-01-25,507,washing machine,6990,16490,9500,1,00260,India
742141,2024-01-25,505,oven,18490,24000,5510,1,00260,India
742141,2024-01-25,501,iphone 15,60000,80000,20000,1,00260,India
252816,2024-01-25,503,mixer,1349,3249,1900,1,00466,India
888969,2024-01-25,507,washing machine,6990,16490,9500,1,00489,India
453572,2024-01-25,502,iphone 15 pro max,100000,135000,35000,1,00291,India
254452,2024-01-25,504,iron,449,879,430,1,00189,India
254452,2024-01-25,501,iphone 15,60000,80000,20000,1,00189,India
590485,2024-01-25,504,iron,449,879,430,1,00068,India
590485,2024-01-25,501,iphone 15,60000,80000,20000,1,00068,India
130943,2024-01-25,504,iron,449,879,430,1,00290,India
130943,2024-01-25,505,oven,18490,24000,5510,1,00290,India
130943,2024-01-25,506,monitor,3249,8000,4751,1,00290,India
209624,2024-01-25,505,oven,18490,24000,5510,1,00282,India
209624,2024-01-25,502,iphone 15 pro max,100000,135000,35000,1,00282,India
209624,2024-01-25,507,washing machine,6990,16490,9500,1,00282,India
209624,2024-01-25,501,iphone 15,60000,80000,20000,1,00282,India
674253,2024-01-25,502,iphone 15 pro max,100000,135000,35000,1,00148,India
686421,2024-01-25,505,oven,18490,24000,5510,1,00409,India
686421,2024-01-25,506,monitor,3249,8000,4751,1,00409,India
686421,2024-01-25,507,washing machine,6990,16490,9500,1,00409,India
376302,2024-01-25,504,iron,449,879,430,1,00334,India
578233,2024-01-25,501,iphone 15,60000,80000,20000,1,00146,India
578233,2024-01-25,503,mixer,1349,3249,1900,1,00146,India
578233,2024-01-25,502,iphone 15 pro max,100000,135000,35000,1,00146,India
496373,2024-01-25,503,mixer,1349,3249,1900,1,00149,India
496373,2024-01-25,501,iphone 15,60000,80000,20000,1,00149,India
753213,2024-01-25,502,iphone 15 pro max,100000,135000,35000,1,00233,India
909167,2024-01-25,502,iphone 15 pro max,100000,135000,35000,1,00066,India
909167,2024-01-25,501,iphone 15,60000,80000,20000,1,00066,India
179042,2024-01-25,501,iphone 15,60000,80000,20000,1,00032,India
135884,2024-01-25,502,iphone 15 pro max,100000,135000,35000,1,00476,India
135884,2024-01-25,503,mixer,1349,3249,1900,1,00476,India
228406,2024-01-25,506,monitor,3249,8000,4751,1,00154,India
228406,2024-01-25,507,washing machine,6990,16490,9500,1,00154,India
228406,2024-01-25,504,iron,449,879,430,1,00154,India
228406,2024-01-25,505,oven,18490,24000,5510,1,00154,India
797311,2024-01-25,506,monitor,3249,8000,4751,1,00326,India
980482,2024-01-25,506,monitor,3249,8000,4751,1,00016,India
980482,2024-01-25,507,washing machine,6990,16490,9500,1,00016,India
980482,2024-01-25,505,oven,18490,24000,5510,1,00016,India
946408,2024-01-25,504,iron,449,879,430,1,00492,India
602792,2024-01-25,503,mixer,1349,3249,1900,1,00094,India
602792,2024-01-25,501,iphone 15,60000,80000,20000,1,00094,India
602792,2024-01-25,506,monitor,3249,8000,4751,1,00094,India
878999,2024-01-25,505,oven,18490,24000,5510,1,00452,India
878999,2024-01-25,506,monitor,3249,8000,4751,1,00452,India
878999,2024-01-25,503,mixer,1349,3249,1900,1,00452,India
878999,2024-01-25,504,iron,449,879,430,1,00452,India
414439,2024-01-25,504,iron,449,879,430,1,00230,India
414439,2024-01-25,507,washing machine,6990,16490,9500,1,00230,India
922113,2024-01-25,505,oven,18490,24000,5510,1,00230,India
922113,2024-01-25,507,washing machine,6990,16490,9500,1,00230,India
480899,2024-01-25,505,oven,18490,24000,5510,1,00398,India
480899,2024-01-25,503,mixer,1349,3249,1900,1,00398,India
480899,2024-01-25,501,iphone 15,60000,80000,20000,1,00398,India
480899,2024-01-25,507,washing machine,6990,16490,9500,1,00398,India
761789,2024-01-25,505,oven,18490,24000,5510,1,00236,India
761789,2024-01-25,507,washing machine,6990,16490,9500,1,00236,India
761789,2024-01-25,501,iphone 15,60000,80000,20000,1,00236,India
761789,2024-01-25,504,iron,449,879,430,1,00236,India
531657,2024-01-25,507,washing machine,6990,16490,9500,1,00309,India
531657,2024-01-25,503,mixer,1349,3249,1900,1,00309,India
387818,2024-01-25,501,iphone 15,60000,80000,20000,1,00085,India
647157,2024-01-25,505,oven,18490,24000,5510,1,00190,India
647157,2024-01-25,503,mixer,1349,3249,1900,1,00190,India
647157,2024-01-25,501,iphone 15,60000,80000,20000,1,00190,India
427031,2024-01-25,506,monitor,3249,8000,4751,1,00243,India
427031,2024-01-25,504,iron,449,879,430,1,00243,India
427031,2024-01-25,502,iphone 15 pro max,100000,135000,35000,1,00243,India
427031,2024-01-25,507,washing machine,6990,16490,9500,1,00243,India
427031,2024-01-25,501,iphone 15,60000,80000,20000,1,00243,India
139987,2024-01-25,504,iron,449,879,430,1,00470,India
139987,2024-01-25,503,mixer,1349,3249,1900,1,00470,India
278933,2024-01-25,501,iphone 15,60000,80000,20000,1,00060,India
278933,2024-01-25,502,iphone 15 pro max,100000,135000,35000,1,00060,India
278933,2024-01-25,505,oven,18490,24000,5510,1,00060,India
279193,2024-01-25,506,monitor,3249,8000,4751,1,00437,India
279193,2024-01-25,501,iphone 15,60000,80000,20000,1,00437,India
279193,2024-01-25,507,washing machine,6990,16490,9500,1,00437,India
544293,2024-01-25,506,monitor,3249,8000,4751,1,00193,India
544293,2024-01-25,507,washing machine,6990,16490,9500,1,00193,India
544293,2024-01-25,503,mixer,1349,3249,1900,1,00193,India
544293,2024-01-25,502,iphone 15 pro max,100000,135000,35000,1,00193,India
279419,2024-01-25,506,monitor,3249,8000,4751,1,00074,India
279419,2024-01-25,503,mixer,1349,3249,1900,1,00074,India
279419,2024-01-25,507,washing machine,6990,16490,9500,1,00074,India
231000,2024-01-25,506,monitor,3249,8000,4751,1,00340,India
231000,2024-01-25,501,iphone 15,60000,80000,20000,1,00340,India
231000,2024-01-25,503,mixer,1349,3249,1900,1,00340,India
329062,2024-01-25,503,mixer,1349,3249,1900,1,00075,India
329062,2024-01-25,507,washing machine,6990,16490,9500,1,00075,India
329062,2024-01-25,506,monitor,3249,8000,4751,1,00075,India
482833,2024-01-25,505,oven,18490,24000,5510,1,00227,India
482833,2024-01-25,507,washing machine,6990,16490,9500,1,00227,India
482833,2024-01-25,503,mixer,1349,3249,1900,1,00227,India
482833,2024-01-25,501,iphone 15,60000,80000,20000,1,00227,India
482833,2024-01-25,506,monitor,3249,8000,4751,1,00227,India
594591,2024-01-25,505,oven,18490,24000,5510,1,00092,India
594591,2024-01-25,501,iphone 15,60000,80000,20000,1,00092,India
115831,2024-01-25,503,mixer,1349,3249,1900,1,00319,India
115831,2024-01-25,501,iphone 15,60000,80000,20000,1,00319,India
409292,2024-01-25,507,washing machine,6990,16490,9500,1,00363,India
996826,2024-01-25,504,iron,449,879,430,1,00322,India
996826,2024-01-25,506,monitor,3249,8000,4751,1,00322,India
624775,2024-01-25,501,iphone 15,60000,80000,20000,1,00356,India
624775,2024-01-25,502,iphone 15 pro max,100000,135000,35000,1,00356,India
971661,2024-01-25,504,iron,449,879,430,1,00046,India
971661,2024-01-25,501,iphone 15,60000,80000,20000,1,00046,India
971661,2024-01-25,505,oven,18490,24000,5510,1,00046,India
510078,2024-01-25,503,mixer,1349,3249,1900,1,00477,India
510078,2024-01-25,501,iphone 15,60000,80000,20000,1,00477,India
926132,2024-01-25,502,iphone 15 pro max,100000,135000,35000,1,00015,India
926132,2024-01-25,501,iphone 15,60000,80000,20000,1,00015,India
926132,2024-01-25,506,monitor,3249,8000,4751,1,00015,India
779517,2024-01-25,505,oven,18490,24000,5510,1,00399,India
779517,2024-01-25,502,iphone 15 pro max,100000,135000,35000,1,00399,India
779517,2024-01-25,503,mixer,1349,3249,1900,1,00399,India
831677,2024-01-25,503,mixer,1349,3249,1900,1,00392,India
831677,2024-01-25,502,iphone 15 pro max,100000,135000,35000,1,00392,India
657772,2024-01-25,507,washing machine,6990,16490,9500,1,00415,India
657772,2024-01-25,504,iron,449,879,430,1,00415,India
361142,2024-01-25,507,washing machine,6990,16490,9500,1,00230,India
361142,2024-01-25,502,iphone 15 pro max,100000,135000,35000,1,00230,India
361142,2024-01-25,501,iphone 15,60000,80000,20000,1,00230,India
786346,2024-01-25,501,iphone 15,60000,80000,20000,1,00064,India
786346,2024-01-25,504,iron,449,879,430,1,00064,India
786346,2024-01-25,505,oven,18490,24000,5510,1,00064,India
786346,2024-01-25,503,mixer,1349,3249,1900,1,00064,India
801358,2024-01-25,501,iphone 15,60000,80000,20000,1,00174,India
814022,2024-01-25,505,oven,18490,24000,5510,1,00139,India
814022,2024-01-25,506,monitor,3249,8000,4751,1,00139,India
814022,2024-01-25,502,iphone 15 pro max,100000,135000,35000,1,00139,India
814022,2024-01-25,504,iron,449,879,430,1,00139,India
728744,2024-01-26,505,oven,18490,24000,5510,1,00313,India
728744,2024-01-26,502,iphone 15 pro max,100000,135000,35000,1,00313,India
875497,2024-01-26,504,iron,449,879,430,1,00023,India
875497,2024-01-26,507,washing machine,6990,16490,9500,1,00023,India
875497,2024-01-26,505,oven,18490,24000,5510,1,00023,India
875497,2024-01-26,502,iphone 15 pro max,100000,135000,35000,1,00023,India
239438,2024-01-26,504,iron,449,879,430,1,00475,India
773418,2024-01-26,503,mixer,1349,3249,1900,1,00025,India
773418,2024-01-26,506,monitor,3249,8000,4751,1,00025,India
798128,2024-01-26,503,mixer,1349,3249,1900,1,00239,India
798128,2024-01-26,501,iphone 15,60000,80000,20000,1,00239,India
798128,2024-01-26,506,monitor,3249,8000,4751,1,00239,India
798128,2024-01-26,505,oven,18490,24000,5510,1,00239,India
836929,2024-01-26,504,iron,449,879,430,1,00377,India
836929,2024-01-26,506,monitor,3249,8000,4751,1,00377,India
836929,2024-01-26,502,iphone 15 pro max,100000,135000,35000,1,00377,India
591020,2024-01-26,503,mixer,1349,3249,1900,1,00082,India
591020,2024-01-26,501,iphone 15,60000,80000,20000,1,00082,India
582142,2024-01-26,504,iron,449,879,430,1,00421,India
582142,2024-01-26,507,washing machine,6990,16490,9500,1,00421,India
794204,2024-01-26,503,mixer,1349,3249,1900,1,00098,India
794204,2024-01-26,507,washing machine,6990,16490,9500,1,00098,India
794204,2024-01-26,504,iron,449,879,430,1,00098,India
820991,2024-01-26,506,monitor,3249,8000,4751,1,00446,India
582442,2024-01-26,507,washing machine,6990,16490,9500,1,00372,India
570208,2024-01-26,504,iron,449,879,430,1,00319,India
570208,2024-01-26,501,iphone 15,60000,80000,20000,1,00319,India
512903,2024-01-26,507,washing machine,6990,16490,9500,1,00065,India
901979,2024-01-26,503,mixer,1349,3249,1900,1,00380,India
901979,2024-01-26,506,monitor,3249,8000,4751,1,00380,India
901979,2024-01-26,501,iphone 15,60000,80000,20000,1,00380,India
262964,2024-01-26,505,oven,18490,24000,5510,1,00436,India
262964,2024-01-26,501,iphone 15,60000,80000,20000,1,00436,India
262964,2024-01-26,504,iron,449,879,430,1,00436,India
183374,2024-01-26,503,mixer,1349,3249,1900,1,00375,India
183374,2024-01-26,506,monitor,3249,8000,4751,1,00375,India
419552,2024-01-26,503,mixer,1349,3249,1900,1,00045,India
419552,2024-01-26,507,washing machine,6990,16490,9500,1,00045,India
419552,2024-01-26,506,monitor,3249,8000,4751,1,00045,India
419552,2024-01-26,501,iphone 15,60000,80000,20000,1,00045,India
116517,2024-01-26,504,iron,449,879,430,1,00098,India
932809,2024-01-26,505,oven,18490,24000,5510,1,00062,India
932809,2024-01-26,501,iphone 15,60000,80000,20000,1,00062,India
932809,2024-01-26,504,iron,449,879,430,1,00062,India
932809,2024-01-26,503,mixer,1349,3249,1900,1,00062,India
251896,2024-01-26,506,monitor,3249,8000,4751,1,00464,India
373738,2024-01-26,503,mixer,1349,3249,1900,1,00426,India
373738,2024-01-26,505,oven,18490,24000,5510,1,00426,India
373738,2024-01-26,502,iphone 15 pro max,100000,135000,35000,1,00426,India
976751,2024-01-26,502,iphone 15 pro max,100000,135000,35000,1,00151,India
976751,2024-01-26,505,oven,18490,24000,5510,1,00151,India
976751,2024-01-26,506,monitor,3249,8000,4751,1,00151,India
686143,2024-01-26,501,iphone 15,60000,80000,20000,1,00124,India
686143,2024-01-26,502,iphone 15 pro max,100000,135000,35000,1,00124,India
686143,2024-01-26,504,iron,449,879,430,1,00124,India
686143,2024-01-26,505,oven,18490,24000,5510,1,00124,India
544169,2024-01-26,502,iphone 15 pro max,100000,135000,35000,1,00426,India
544169,2024-01-26,503,mixer,1349,3249,1900,1,00426,India
662430,2024-01-26,502,iphone 15 pro max,100000,135000,35000,1,00407,India
662430,2024-01-26,507,washing machine,6990,16490,9500,1,00407,India
662430,2024-01-26,504,iron,449,879,430,1,00407,India
220930,2024-01-26,506,monitor,3249,8000,4751,1,00466,India
697062,2024-01-26,501,iphone 15,60000,80000,20000,1,00297,India
697062,2024-01-26,504,iron,449,879,430,1,00297,India
385324,2024-01-26,503,mixer,1349,3249,1900,1,00075,India
385324,2024-01-26,506,monitor,3249,8000,4751,1,00075,India
914937,2024-01-26,506,monitor,3249,8000,4751,1,00080,India
914937,2024-01-26,502,iphone 15 pro max,100000,135000,35000,1,00080,India
410647,2024-01-26,501,iphone 15,60000,80000,20000,1,00444,India
410647,2024-01-26,505,oven,18490,24000,5510,1,00444,India
906510,2024-01-26,503,mixer,1349,3249,1900,1,00114,India
906510,2024-01-26,505,oven,18490,24000,5510,1,00114,India
227614,2024-01-26,506,monitor,3249,8000,4751,1,00360,India
227614,2024-01-26,501,iphone 15,60000,80000,20000,1,00360,India
227614,2024-01-26,505,oven,18490,24000,5510,1,00360,India
723619,2024-01-26,501,iphone 15,60000,80000,20000,1,00193,India
538508,2024-01-26,505,oven,18490,24000,5510,1,00480,India
461712,2024-01-26,507,washing machine,6990,16490,9500,1,00418,India
461712,2024-01-26,505,oven,18490,24000,5510,1,00418,India
461712,2024-01-26,506,monitor,3249,8000,4751,1,00418,India
461712,2024-01-26,503,mixer,1349,3249,1900,1,00418,India
461712,2024-01-26,504,iron,449,879,430,1,00418,India
526678,2024-01-26,503,mixer,1349,3249,1900,1,00474,India
526678,2024-01-26,504,iron,449,879,430,1,00474,India
526678,2024-01-26,505,oven,18490,24000,5510,1,00474,India
835276,2024-01-26,503,mixer,1349,3249,1900,1,00097,India
835276,2024-01-26,505,oven,18490,24000,5510,1,00097,India
835276,2024-01-26,506,monitor,3249,8000,4751,1,00097,India
476768,2024-01-26,504,iron,449,879,430,1,00325,India
476768,2024-01-26,502,iphone 15 pro max,100000,135000,35000,1,00325,India
476768,2024-01-26,507,washing machine,6990,16490,9500,1,00325,India
787949,2024-01-26,507,washing machine,6990,16490,9500,1,00314,India
787949,2024-01-26,501,iphone 15,60000,80000,20000,1,00314,India
946500,2024-01-26,501,iphone 15,60000,80000,20000,1,00023,India
946500,2024-01-26,503,mixer,1349,3249,1900,1,00023,India
946500,2024-01-26,505,oven,18490,24000,5510,1,00023,India
778520,2024-01-26,503,mixer,1349,3249,1900,1,00109,India
778520,2024-01-26,504,iron,449,879,430,1,00109,India
778520,2024-01-26,506,monitor,3249,8000,4751,1,00109,India
182946,2024-01-26,501,iphone 15,60000,80000,20000,1,00128,India
910080,2024-01-26,502,iphone 15 pro max,100000,135000,35000,1,00330,India
910080,2024-01-26,505,oven,18490,24000,5510,1,00330,India
528700,2024-01-26,502,iphone 15 pro max,100000,135000,35000,1,00134,India
528700,2024-01-26,506,monitor,3249,8000,4751,1,00134,India
373112,2024-01-26,504,iron,449,879,430,1,00365,India
373112,2024-01-26,505,oven,18490,24000,5510,1,00365,India
828430,2024-01-26,506,monitor,3249,8000,4751,1,00250,India
828430,2024-01-26,507,washing machine,6990,16490,9500,1,00250,India
828430,2024-01-26,503,mixer,1349,3249,1900,1,00250,India
828430,2024-01-26,502,iphone 15 pro max,100000,135000,35000,1,00250,India
828430,2024-01-26,504,iron,449,879,430,1,00250,India
809380,2024-01-26,502,iphone 15 pro max,100000,135000,35000,1,00337,India
809380,2024-01-26,503,mixer,1349,3249,1900,1,00337,India
988953,2024-01-26,501,iphone 15,60000,80000,20000,1,00195,India
988953,2024-01-26,504,iron,449,879,430,1,00195,India
208439,2024-01-26,502,iphone 15 pro max,100000,135000,35000,1,00368,India
925591,2024-01-26,506,monitor,3249,8000,4751,1,00094,India
925591,2024-01-26,504,iron,449,879,430,1,00094,India
887750,2024-01-26,502,iphone 15 pro max,100000,135000,35000,1,00215,India
937281,2024-01-26,503,mixer,1349,3249,1900,1,00007,India
937281,2024-01-26,506,monitor,3249,8000,4751,1,00007,India
371373,2024-01-26,501,iphone 15,60000,80000,20000,1,00121,India
371475,2024-01-27,506,monitor,3249,8000,4751,1,00433,India
707082,2024-01-27,503,mixer,1349,3249,1900,1,00264,India
707082,2024-01-27,506,monitor,3249,8000,4751,1,00264,India
707082,2024-01-27,505,oven,18490,24000,5510,1,00264,India
707082,2024-01-27,501,iphone 15,60000,80000,20000,1,00264,India
425984,2024-01-27,503,mixer,1349,3249,1900,1,00218,India
425984,2024-01-27,507,washing machine,6990,16490,9500,1,00218,India
425984,2024-01-27,505,oven,18490,24000,5510,1,00218,India
425984,2024-01-27,504,iron,449,879,430,1,00218,India
688453,2024-01-27,504,iron,449,879,430,1,00169,India
301455,2024-01-27,502,iphone 15 pro max,100000,135000,35000,1,00260,India
301455,2024-01-27,506,monitor,3249,8000,4751,1,00260,India
486113,2024-01-27,505,oven,18490,24000,5510,1,00106,India
486113,2024-01-27,503,mixer,1349,3249,1900,1,00106,India
486113,2024-01-27,506,monitor,3249,8000,4751,1,00106,India
486113,2024-01-27,504,iron,449,879,430,1,00106,India
918018,2024-01-27,507,washing machine,6990,16490,9500,1,00233,India
918018,2024-01-27,506,monitor,3249,8000,4751,1,00233,India
918018,2024-01-27,505,oven,18490,24000,5510,1,00233,India
898450,2024-01-27,505,oven,18490,24000,5510,1,00074,India
898450,2024-01-27,503,mixer,1349,3249,1900,1,00074,India
898450,2024-01-27,502,iphone 15 pro max,100000,135000,35000,1,00074,India
542823,2024-01-27,506,monitor,3249,8000,4751,1,00463,India
542823,2024-01-27,505,oven,18490,24000,5510,1,00463,India
602874,2024-01-27,506,monitor,3249,8000,4751,1,00222,India
602874,2024-01-27,501,iphone 15,60000,80000,20000,1,00222,India
602874,2024-01-27,504,iron,449,879,430,1,00222,India
106591,2024-01-27,504,iron,449,879,430,1,00316,India
106591,2024-01-27,501,iphone 15,60000,80000,20000,1,00316,India
444922,2024-01-27,502,iphone 15 pro max,100000,135000,35000,1,00327,India
444922,2024-01-27,506,monitor,3249,8000,4751,1,00327,India
675427,2024-01-27,501,iphone 15,60000,80000,20000,1,00063,India
675427,2024-01-27,507,washing machine,6990,16490,9500,1,00063,India
368374,2024-01-27,501,iphone 15,60000,80000,20000,1,00236,India
368374,2024-01-27,506,monitor,3249,8000,4751,1,00236,India
368374,2024-01-27,503,mixer,1349,3249,1900,1,00236,India
550029,2024-01-27,503,mixer,1349,3249,1900,1,00136,India
550029,2024-01-27,507,washing machine,6990,16490,9500,1,00136,India
550029,2024-01-27,504,iron,449,879,430,1,00136,India
550029,2024-01-27,505,oven,18490,24000,5510,1,00136,India
355654,2024-01-27,507,washing machine,6990,16490,9500,1,00103,India
355654,2024-01-27,505,oven,18490,24000,5510,1,00103,India
355654,2024-01-27,504,iron,449,879,430,1,00103,India
864440,2024-01-27,502,iphone 15 pro max,100000,135000,35000,1,00151,India
204613,2024-01-27,502,iphone 15 pro max,100000,135000,35000,1,00084,India
204613,2024-01-27,504,iron,449,879,430,1,00084,India
204613,2024-01-27,501,iphone 15,60000,80000,20000,1,00084,India
233880,2024-01-27,504,iron,449,879,430,1,00247,India
233880,2024-01-27,506,monitor,3249,8000,4751,1,00247,India
233880,2024-01-27,505,oven,18490,24000,5510,1,00247,India
961574,2024-01-27,502,iphone 15 pro max,100000,135000,35000,1,00284,India
961574,2024-01-27,506,monitor,3249,8000,4751,1,00284,India
500349,2024-01-27,503,mixer,1349,3249,1900,1,00096,India
614423,2024-01-27,506,monitor,3249,8000,4751,1,00372,India
614423,2024-01-27,504,iron,449,879,430,1,00372,India
614423,2024-01-27,501,iphone 15,60000,80000,20000,1,00372,India
712429,2024-01-27,505,oven,18490,24000,5510,1,00076,India
712429,2024-01-27,504,iron,449,879,430,1,00076,India
528327,2024-01-27,506,monitor,3249,8000,4751,1,00251,India
528327,2024-01-27,504,iron,449,879,430,1,00251,India
528327,2024-01-27,503,mixer,1349,3249,1900,1,00251,India
191404,2024-01-27,501,iphone 15,60000,80000,20000,1,00027,India
191404,2024-01-27,504,iron,449,879,430,1,00027,India
191404,2024-01-27,505,oven,18490,24000,5510,1,00027,India
347932,2024-01-27,504,iron,449,879,430,1,00163,India
347932,2024-01-27,502,iphone 15 pro max,100000,135000,35000,1,00163,India
395985,2024-01-27,506,monitor,3249,8000,4751,1,00077,India
395985,2024-01-27,502,iphone 15 pro max,100000,135000,35000,1,00077,India
395985,2024-01-27,501,iphone 15,60000,80000,20000,1,00077,India
155544,2024-01-27,501,iphone 15,60000,80000,20000,1,00038,India
155544,2024-01-27,504,iron,449,879,430,1,00038,India
155544,2024-01-27,506,monitor,3249,8000,4751,1,00038,India
264664,2024-01-27,507,washing machine,6990,16490,9500,1,00001,India
264664,2024-01-27,504,iron,449,879,430,1,00001,India
449273,2024-01-27,503,mixer,1349,3249,1900,1,00368,India
449273,2024-01-27,505,oven,18490,24000,5510,1,00368,India
375634,2024-01-27,504,iron,449,879,430,1,00383,India
566382,2024-01-27,507,washing machine,6990,16490,9500,1,00443,India
566382,2024-01-27,506,monitor,3249,8000,4751,1,00443,India
566382,2024-01-27,505,oven,18490,24000,5510,1,00443,India
869133,2024-01-27,502,iphone 15 pro max,100000,135000,35000,1,00137,India
869133,2024-01-27,503,mixer,1349,3249,1900,1,00137,India
869133,2024-01-27,507,washing machine,6990,16490,9500,1,00137,India
586040,2024-01-27,503,mixer,1349,3249,1900,1,00177,India
586040,2024-01-27,502,iphone 15 pro max,100000,135000,35000,1,00177,India
704837,2024-01-27,502,iphone 15 pro max,100000,135000,35000,1,00038,India
704837,2024-01-27,501,iphone 15,60000,80000,20000,1,00038,India
704837,2024-01-27,507,washing machine,6990,16490,9500,1,00038,India
714927,2024-01-27,501,iphone 15,60000,80000,20000,1,00170,India
714927,2024-01-27,506,monitor,3249,8000,4751,1,00170,India
714927,2024-01-27,503,mixer,1349,3249,1900,1,00170,India
714927,2024-01-27,505,oven,18490,24000,5510,1,00170,India
714927,2024-01-27,507,washing machine,6990,16490,9500,1,00170,India
890839,2024-01-27,502,iphone 15 pro max,100000,135000,35000,1,00423,India
920212,2024-01-27,503,mixer,1349,3249,1900,1,00311,India
713290,2024-01-27,505,oven,18490,24000,5510,1,00028,India
713290,2024-01-27,502,iphone 15 pro max,100000,135000,35000,1,00028,India
190163,2024-01-27,501,iphone 15,60000,80000,20000,1,00036,India
705906,2024-01-27,505,oven,18490,24000,5510,1,00156,India
705906,2024-01-27,501,iphone 15,60000,80000,20000,1,00156,India
288076,2024-01-27,505,oven,18490,24000,5510,1,00366,India
288076,2024-01-27,502,iphone 15 pro max,100000,135000,35000,1,00366,India
288076,2024-01-27,501,iphone 15,60000,80000,20000,1,00366,India
930101,2024-01-27,502,iphone 15 pro max,100000,135000,35000,1,00469,India
188298,2024-01-27,502,iphone 15 pro max,100000,135000,35000,1,00459,India
188298,2024-01-27,505,oven,18490,24000,5510,1,00459,India
188298,2024-01-27,501,iphone 15,60000,80000,20000,1,00459,India
385915,2024-01-27,507,washing machine,6990,16490,9500,1,00363,India
385915,2024-01-27,502,iphone 15 pro max,100000,135000,35000,1,00363,India
385915,2024-01-27,501,iphone 15,60000,80000,20000,1,00363,India
151317,2024-01-27,504,iron,449,879,430,1,00365,India
432201,2024-01-27,502,iphone 15 pro max,100000,135000,35000,1,00271,India
888497,2024-01-27,505,oven,18490,24000,5510,1,00222,India
156995,2024-01-27,502,iphone 15 pro max,100000,135000,35000,1,00110,India
156995,2024-01-27,507,washing machine,6990,16490,9500,1,00110,India
156995,2024-01-27,505,oven,18490,24000,5510,1,00110,India
371532,2024-01-27,503,mixer,1349,3249,1900,1,00095,India
371532,2024-01-27,504,iron,449,879,430,1,00095,India
371532,2024-01-27,502,iphone 15 pro max,100000,135000,35000,1,00095,India
354122,2024-01-27,506,monitor,3249,8000,4751,1,00464,India
448410,2024-01-27,504,iron,449,879,430,1,00051,India
448410,2024-01-27,501,iphone 15,60000,80000,20000,1,00051,India
546614,2024-01-27,501,iphone 15,60000,80000,20000,1,00011,India
546614,2024-01-27,506,monitor,3249,8000,4751,1,00011,India
546614,2024-01-27,504,iron,449,879,430,1,00011,India
166949,2024-01-27,503,mixer,1349,3249,1900,1,00108,India
166949,2024-01-27,505,oven,18490,24000,5510,1,00108,India
166949,2024-01-27,504,iron,449,879,430,1,00108,India
166949,2024-01-27,506,monitor,3249,8000,4751,1,00108,India
923205,2024-01-27,504,iron,449,879,430,1,00019,India
561197,2024-01-27,502,iphone 15 pro max,100000,135000,35000,1,00030,India
561197,2024-01-27,503,mixer,1349,3249,1900,1,00030,India
561197,2024-01-27,505,oven,18490,24000,5510,1,00030,India
685610,2024-01-27,505,oven,18490,24000,5510,1,00185,India
685610,2024-01-27,503,mixer,1349,3249,1900,1,00185,India
685610,2024-01-27,506,monitor,3249,8000,4751,1,00185,India
685610,2024-01-27,504,iron,449,879,430,1,00185,India
676849,2024-01-27,507,washing machine,6990,16490,9500,1,00387,India
676849,2024-01-27,504,iron,449,879,430,1,00387,India
676849,2024-01-27,501,iphone 15,60000,80000,20000,1,00387,India
676849,2024-01-27,503,mixer,1349,3249,1900,1,00387,India
737925,2024-01-27,506,monitor,3249,8000,4751,1,00135,India
737925,2024-01-27,507,washing machine,6990,16490,9500,1,00135,India
737925,2024-01-27,501,iphone 15,60000,80000,20000,1,00135,India
700732,2024-01-27,504,iron,449,879,430,1,00128,India
700732,2024-01-27,507,washing machine,6990,16490,9500,1,00128,India
700732,2024-01-27,505,oven,18490,24000,5510,1,00128,India
700732,2024-01-27,502,iphone 15 pro max,100000,135000,35000,1,00128,India
949125,2024-01-27,507,washing machine,6990,16490,9500,1,00156,India
732125,2024-01-27,504,iron,449,879,430,1,00325,India
732125,2024-01-27,502,iphone 15 pro max,100000,135000,35000,1,00325,India
263737,2024-01-27,507,washing machine,6990,16490,9500,1,00436,India
263737,2024-01-27,503,mixer,1349,3249,1900,1,00436,India
420375,2024-01-27,505,oven,18490,24000,5510,1,00417,India
937099,2024-01-27,507,washing machine,6990,16490,9500,1,00062,India
937099,2024-01-27,506,monitor,3249,8000,4751,1,00062,India
937099,2024-01-27,502,iphone 15 pro max,100000,135000,35000,1,00062,India
101308,2024-01-27,505,oven,18490,24000,5510,1,00042,India
101308,2024-01-27,501,iphone 15,60000,80000,20000,1,00042,India
101308,2024-01-27,504,iron,449,879,430,1,00042,India
101308,2024-01-27,503,mixer,1349,3249,1900,1,00042,India
108795,2024-01-27,506,monitor,3249,8000,4751,1,00412,India
108795,2024-01-27,503,mixer,1349,3249,1900,1,00412,India
441712,2024-01-27,506,monitor,3249,8000,4751,1,00026,India
441712,2024-01-27,503,mixer,1349,3249,1900,1,00026,India
441712,2024-01-27,504,iron,449,879,430,1,00026,India
636341,2024-01-27,504,iron,449,879,430,1,00442,India
636341,2024-01-27,505,oven,18490,24000,5510,1,00442,India
636341,2024-01-27,502,iphone 15 pro max,100000,135000,35000,1,00442,India
459324,2024-01-27,501,iphone 15,60000,80000,20000,1,00494,India
459324,2024-01-27,506,monitor,3249,8000,4751,1,00494,India
147037,2024-01-27,505,oven,18490,24000,5510,1,00094,India
544643,2024-01-27,507,washing machine,6990,16490,9500,1,00294,India
544643,2024-01-27,506,monitor,3249,8000,4751,1,00294,India
809266,2024-01-27,505,oven,18490,24000,5510,1,00375,India
809266,2024-01-27,506,monitor,3249,8000,4751,1,00375,India
529728,2024-01-27,504,iron,449,879,430,1,00460,India
529728,2024-01-27,503,mixer,1349,3249,1900,1,00460,India
615174,2024-01-27,506,monitor,3249,8000,4751,1,00228,India
615174,2024-01-27,502,iphone 15 pro max,100000,135000,35000,1,00228,India
407344,2024-01-27,507,washing machine,6990,16490,9500,1,00080,India
407344,2024-01-27,502,iphone 15 pro max,100000,135000,35000,1,00080,India
407344,2024-01-27,505,oven,18490,24000,5510,1,00080,India
207378,2024-01-27,507,washing machine,6990,16490,9500,1,00392,India
207378,2024-01-27,504,iron,449,879,430,1,00392,India
760345,2024-01-27,507,washing machine,6990,16490,9500,1,00127,India
760345,2024-01-27,506,monitor,3249,8000,4751,1,00127,India
626063,2024-01-27,501,iphone 15,60000,80000,20000,1,00099,India
162339,2024-01-27,505,oven,18490,24000,5510,1,00290,India
162339,2024-01-27,504,iron,449,879,430,1,00290,India
162339,2024-01-27,506,monitor,3249,8000,4751,1,00290,India
162339,2024-01-27,501,iphone 15,60000,80000,20000,1,00290,India
628972,2024-01-27,506,monitor,3249,8000,4751,1,00410,India
628972,2024-01-27,503,mixer,1349,3249,1900,1,00410,India
628972,2024-01-27,504,iron,449,879,430,1,00410,India
833029,2024-01-27,506,monitor,3249,8000,4751,1,00264,India
914090,2024-01-27,502,iphone 15 pro max,100000,135000,35000,1,00377,India
914090,2024-01-27,504,iron,449,879,430,1,00377,India
914090,2024-01-27,501,iphone 15,60000,80000,20000,1,00377,India
446611,2024-01-27,502,iphone 15 pro max,100000,135000,35000,1,00101,India
446611,2024-01-27,507,washing machine,6990,16490,9500,1,00101,India
473695,2024-01-27,505,oven,18490,24000,5510,1,00399,India
473695,2024-01-27,503,mixer,1349,3249,1900,1,00399,India
655261,2024-01-27,505,oven,18490,24000,5510,1,00413,India
654413,2024-01-27,506,monitor,3249,8000,4751,1,00033,India
654413,2024-01-27,507,washing machine,6990,16490,9500,1,00033,India
654413,2024-01-27,501,iphone 15,60000,80000,20000,1,00033,India
654413,2024-01-27,505,oven,18490,24000,5510,1,00033,India
790745,2024-01-27,506,monitor,3249,8000,4751,1,00004,India
153918,2024-01-27,503,mixer,1349,3249,1900,1,00081,India
900267,2024-01-27,501,iphone 15,60000,80000,20000,1,00417,India
900267,2024-01-27,504,iron,449,879,430,1,00417,India
900267,2024-01-27,502,iphone 15 pro max,100000,135000,35000,1,00417,India
596671,2024-01-27,503,mixer,1349,3249,1900,1,00340,India
596671,2024-01-27,507,washing machine,6990,16490,9500,1,00340,India
596671,2024-01-27,501,iphone 15,60000,80000,20000,1,00340,India
596671,2024-01-27,502,iphone 15 pro max,100000,135000,35000,1,00340,India
476370,2024-01-28,507,washing machine,6990,16490,9500,1,00111,India
476370,2024-01-28,505,oven,18490,24000,5510,1,00111,India
476370,2024-01-28,501,iphone 15,60000,80000,20000,1,00111,India
390065,2024-01-28,503,mixer,1349,3249,1900,1,00445,India
771358,2024-01-28,501,iphone 15,60000,80000,20000,1,00064,India
771358,2024-01-28,505,oven,18490,24000,5510,1,00064,India
771358,2024-01-28,504,iron,449,879,430,1,00064,India
208778,2024-01-28,504,iron,449,879,430,1,00460,India
208778,2024-01-28,502,iphone 15 pro max,100000,135000,35000,1,00460,India
208778,2024-01-28,503,mixer,1349,3249,1900,1,00460,India
653457,2024-01-28,502,iphone 15 pro max,100000,135000,35000,1,00213,India
653457,2024-01-28,501,iphone 15,60000,80000,20000,1,00213,India
653457,2024-01-28,507,washing machine,6990,16490,9500,1,00213,India
538938,2024-01-28,501,iphone 15,60000,80000,20000,1,00418,India
538938,2024-01-28,506,monitor,3249,8000,4751,1,00418,India
843144,2024-01-28,504,iron,449,879,430,1,00224,India
843144,2024-01-28,507,washing machine,6990,16490,9500,1,00224,India
843144,2024-01-28,502,iphone 15 pro max,100000,135000,35000,1,00224,India
843144,2024-01-28,506,monitor,3249,8000,4751,1,00224,India
732040,2024-01-28,502,iphone 15 pro max,100000,135000,35000,1,00030,India
474702,2024-01-28,502,iphone 15 pro max,100000,135000,35000,1,00108,India
474702,2024-01-28,506,monitor,3249,8000,4751,1,00108,India
772020,2024-01-28,501,iphone 15,60000,80000,20000,1,00245,India
772020,2024-01-28,506,monitor,3249,8000,4751,1,00245,India
865527,2024-01-28,502,iphone 15 pro max,100000,135000,35000,1,00203,India
828566,2024-01-28,504,iron,449,879,430,1,00336,India
973904,2024-01-28,506,monitor,3249,8000,4751,1,00244,India
973904,2024-01-28,501,iphone 15,60000,80000,20000,1,00244,India
973904,2024-01-28,507,washing machine,6990,16490,9500,1,00244,India
973904,2024-01-28,503,mixer,1349,3249,1900,1,00244,India
844233,2024-01-28,501,iphone 15,60000,80000,20000,1,00488,India
844233,2024-01-28,502,iphone 15 pro max,100000,135000,35000,1,00488,India
688724,2024-01-28,504,iron,449,879,430,1,00301,India
688724,2024-01-28,507,washing machine,6990,16490,9500,1,00301,India
860983,2024-01-28,502,iphone 15 pro max,100000,135000,35000,1,00238,India
860983,2024-01-28,501,iphone 15,60000,80000,20000,1,00238,India
860983,2024-01-28,505,oven,18490,24000,5510,1,00238,India
860983,2024-01-28,503,mixer,1349,3249,1900,1,00238,India
763011,2024-01-28,501,iphone 15,60000,80000,20000,1,00074,India
763011,2024-01-28,506,monitor,3249,8000,4751,1,00074,India
763011,2024-01-28,503,mixer,1349,3249,1900,1,00074,India
763011,2024-01-28,507,washing machine,6990,16490,9500,1,00074,India
812259,2024-01-28,503,mixer,1349,3249,1900,1,00320,India
656154,2024-01-28,504,iron,449,879,430,1,00310,India
656154,2024-01-28,505,oven,18490,24000,5510,1,00310,India
656154,2024-01-28,502,iphone 15 pro max,100000,135000,35000,1,00310,India
970601,2024-01-28,501,iphone 15,60000,80000,20000,1,00246,India
970601,2024-01-28,503,mixer,1349,3249,1900,1,00246,India
922738,2024-01-28,506,monitor,3249,8000,4751,1,00130,India
922738,2024-01-28,505,oven,18490,24000,5510,1,00130,India
922738,2024-01-28,501,iphone 15,60000,80000,20000,1,00130,India
353339,2024-01-28,501,iphone 15,60000,80000,20000,1,00206,India
353339,2024-01-28,504,iron,449,879,430,1,00206,India
353339,2024-01-28,506,monitor,3249,8000,4751,1,00206,India
391118,2024-01-28,503,mixer,1349,3249,1900,1,00336,India
391118,2024-01-28,501,iphone 15,60000,80000,20000,1,00336,India
391118,2024-01-28,507,washing machine,6990,16490,9500,1,00336,India
391118,2024-01-28,504,iron,449,879,430,1,00336,India
581561,2024-01-28,507,washing machine,6990,16490,9500,1,00270,India
581561,2024-01-28,501,iphone 15,60000,80000,20000,1,00270,India
416741,2024-01-28,502,iphone 15 pro max,100000,135000,35000,1,00133,India
168801,2024-01-28,501,iphone 15,60000,80000,20000,1,00059,India
168801,2024-01-28,503,mixer,1349,3249,1900,1,00059,India
168801,2024-01-28,505,oven,18490,24000,5510,1,00059,India
684128,2024-01-28,503,mixer,1349,3249,1900,1,00114,India
684128,2024-01-28,506,monitor,3249,8000,4751,1,00114,India
560399,2024-01-28,504,iron,449,879,430,1,00050,India
560399,2024-01-28,507,washing machine,6990,16490,9500,1,00050,India
560399,2024-01-28,506,monitor,3249,8000,4751,1,00050,India
685542,2024-01-28,506,monitor,3249,8000,4751,1,00490,India
685542,2024-01-28,501,iphone 15,60000,80000,20000,1,00490,India
685542,2024-01-28,502,iphone 15 pro max,100000,135000,35000,1,00490,India
685542,2024-01-28,504,iron,449,879,430,1,00490,India
131288,2024-01-28,507,washing machine,6990,16490,9500,1,00143,India
243297,2024-01-28,506,monitor,3249,8000,4751,1,00152,India
243297,2024-01-28,504,iron,449,879,430,1,00152,India
136120,2024-01-28,507,washing machine,6990,16490,9500,1,00300,India
321009,2024-01-28,505,oven,18490,24000,5510,1,00073,India
321009,2024-01-28,507,washing machine,6990,16490,9500,1,00073,India
321009,2024-01-28,506,monitor,3249,8000,4751,1,00073,India
564643,2024-01-28,501,iphone 15,60000,80000,20000,1,00369,India
564643,2024-01-28,507,washing machine,6990,16490,9500,1,00369,India
564643,2024-01-28,503,mixer,1349,3249,1900,1,00369,India
698826,2024-01-28,501,iphone 15,60000,80000,20000,1,00310,India
698826,2024-01-28,506,monitor,3249,8000,4751,1,00310,India
733890,2024-01-28,504,iron,449,879,430,1,00082,India
345548,2024-01-28,503,mixer,1349,3249,1900,1,00388,India
345548,2024-01-28,501,iphone 15,60000,80000,20000,1,00388,India
185162,2024-01-28,506,monitor,3249,8000,4751,1,00129,India
359077,2024-01-28,506,monitor,3249,8000,4751,1,00399,India
359077,2024-01-28,502,iphone 15 pro max,100000,135000,35000,1,00399,India
359077,2024-01-28,505,oven,18490,24000,5510,1,00399,India
631417,2024-01-28,503,mixer,1349,3249,1900,1,00426,India
631417,2024-01-28,506,monitor,3249,8000,4751,1,00426,India
631417,2024-01-28,507,washing machine,6990,16490,9500,1,00426,India
483346,2024-01-28,507,washing machine,6990,16490,9500,1,00009,India
302779,2024-01-28,502,iphone 15 pro max,100000,135000,35000,1,00427,India
302779,2024-01-28,505,oven,18490,24000,5510,1,00427,India
302779,2024-01-28,503,mixer,1349,3249,1900,1,00427,India
465239,2024-01-28,503,mixer,1349,3249,1900,1,00172,India
465239,2024-01-28,502,iphone 15 pro max,100000,135000,35000,1,00172,India
465239,2024-01-28,507,washing machine,6990,16490,9500,1,00172,India
437801,2024-01-28,503,mixer,1349,3249,1900,1,00460,India
692004,2024-01-28,503,mixer,1349,3249,1900,1,00337,India
692004,2024-01-28,502,iphone 15 pro max,100000,135000,35000,1,00337,India
692004,2024-01-28,501,iphone 15,60000,80000,20000,1,00337,India
255034,2024-01-28,507,washing machine,6990,16490,9500,1,00323,India
255034,2024-01-28,505,oven,18490,24000,5510,1,00323,India
255034,2024-01-28,501,iphone 15,60000,80000,20000,1,00323,India
687146,2024-01-28,501,iphone 15,60000,80000,20000,1,00249,India
687146,2024-01-28,506,monitor,3249,8000,4751,1,00249,India
687146,2024-01-28,505,oven,18490,24000,5510,1,00249,India
687146,2024-01-28,502,iphone 15 pro max,100000,135000,35000,1,00249,India
218458,2024-01-28,501,iphone 15,60000,80000,20000,1,00445,India
218458,2024-01-28,503,mixer,1349,3249,1900,1,00445,India
193565,2024-01-28,507,washing machine,6990,16490,9500,1,00152,India
193565,2024-01-28,504,iron,449,879,430,1,00152,India
193565,2024-01-28,505,oven,18490,24000,5510,1,00152,India
193565,2024-01-28,503,mixer,1349,3249,1900,1,00152,India
914746,2024-01-28,501,iphone 15,60000,80000,20000,1,00420,India
914746,2024-01-28,503,mixer,1349,3249,1900,1,00420,India
914746,2024-01-28,506,monitor,3249,8000,4751,1,00420,India
845385,2024-01-28,501,iphone 15,60000,80000,20000,1,00182,India
845385,2024-01-28,503,mixer,1349,3249,1900,1,00182,India
229714,2024-01-28,503,mixer,1349,3249,1900,1,00022,India
229714,2024-01-28,501,iphone 15,60000,80000,20000,1,00022,India
229714,2024-01-28,507,washing machine,6990,16490,9500,1,00022,India
229714,2024-01-28,502,iphone 15 pro max,100000,135000,35000,1,00022,India
229714,2024-01-28,505,oven,18490,24000,5510,1,00022,India
512157,2024-01-28,504,iron,449,879,430,1,00221,India
512157,2024-01-28,501,iphone 15,60000,80000,20000,1,00221,India
512157,2024-01-28,503,mixer,1349,3249,1900,1,00221,India
512157,2024-01-28,502,iphone 15 pro max,100000,135000,35000,1,00221,India
354397,2024-01-28,507,washing machine,6990,16490,9500,1,00009,India
354397,2024-01-28,505,oven,18490,24000,5510,1,00009,India
354397,2024-01-28,501,iphone 15,60000,80000,20000,1,00009,India
516382,2024-01-28,503,mixer,1349,3249,1900,1,00499,India
516382,2024-01-28,506,monitor,3249,8000,4751,1,00499,India
146412,2024-01-28,503,mixer,1349,3249,1900,1,00498,India
146412,2024-01-28,505,oven,18490,24000,5510,1,00498,India
146412,2024-01-28,504,iron,449,879,430,1,00498,India
146412,2024-01-28,507,washing machine,6990,16490,9500,1,00498,India
978098,2024-01-28,504,iron,449,879,430,1,00443,India
978098,2024-01-28,502,iphone 15 pro max,100000,135000,35000,1,00443,India
978098,2024-01-28,506,monitor,3249,8000,4751,1,00443,India
350996,2024-01-28,507,washing machine,6990,16490,9500,1,00148,India
350996,2024-01-28,502,iphone 15 pro max,100000,135000,35000,1,00148,India
858350,2024-01-28,503,mixer,1349,3249,1900,1,00110,India
858350,2024-01-28,501,iphone 15,60000,80000,20000,1,00110,India
906833,2024-01-28,501,iphone 15,60000,80000,20000,1,00425,India
906833,2024-01-28,505,oven,18490,24000,5510,1,00425,India
419296,2024-01-28,505,oven,18490,24000,5510,1,00231,India
749185,2024-01-28,507,washing machine,6990,16490,9500,1,00073,India
201156,2024-01-28,501,iphone 15,60000,80000,20000,1,00058,India
201156,2024-01-28,506,monitor,3249,8000,4751,1,00058,India
201156,2024-01-28,505,oven,18490,24000,5510,1,00058,India
177243,2024-01-28,501,iphone 15,60000,80000,20000,1,00061,India
177243,2024-01-28,506,monitor,3249,8000,4751,1,00061,India
177243,2024-01-28,503,mixer,1349,3249,1900,1,00061,India
690240,2024-01-28,504,iron,449,879,430,1,00026,India
690240,2024-01-28,506,monitor,3249,8000,4751,1,00026,India
690240,2024-01-28,502,iphone 15 pro max,100000,135000,35000,1,00026,India
882700,2024-01-28,501,iphone 15,60000,80000,20000,1,00019,India
882700,2024-01-28,504,iron,449,879,430,1,00019,India
117220,2024-01-28,507,washing machine,6990,16490,9500,1,00331,India
924578,2024-01-28,501,iphone 15,60000,80000,20000,1,00359,India
924578,2024-01-28,507,washing machine,6990,16490,9500,1,00359,India
924578,2024-01-28,506,monitor,3249,8000,4751,1,00359,India
551006,2024-01-28,506,monitor,3249,8000,4751,1,00135,India
551006,2024-01-28,504,iron,449,879,430,1,00135,India
551006,2024-01-28,503,mixer,1349,3249,1900,1,00135,India
140685,2024-01-28,502,iphone 15 pro max,100000,135000,35000,1,00314,India
140685,2024-01-28,504,iron,449,879,430,1,00314,India
140685,2024-01-28,503,mixer,1349,3249,1900,1,00314,India
849398,2024-01-28,507,washing machine,6990,16490,9500,1,00094,India
921935,2024-01-28,503,mixer,1349,3249,1900,1,00089,India
921935,2024-01-28,502,iphone 15 pro max,100000,135000,35000,1,00089,India
207740,2024-01-28,503,mixer,1349,3249,1900,1,00455,India
207740,2024-01-28,506,monitor,3249,8000,4751,1,00455,India
207740,2024-01-28,507,washing machine,6990,16490,9500,1,00455,India
797847,2024-01-28,507,washing machine,6990,16490,9500,1,00463,India
805552,2024-01-28,503,mixer,1349,3249,1900,1,00201,India
805552,2024-01-28,506,monitor,3249,8000,4751,1,00201,India
805552,2024-01-28,501,iphone 15,60000,80000,20000,1,00201,India
384755,2024-01-28,503,mixer,1349,3249,1900,1,00388,India
933457,2024-01-28,507,washing machine,6990,16490,9500,1,00384,India
469749,2024-01-28,502,iphone 15 pro max,100000,135000,35000,1,00411,India
469749,2024-01-28,503,mixer,1349,3249,1900,1,00411,India
616614,2024-01-28,501,iphone 15,60000,80000,20000,1,00444,India
616614,2024-01-28,505,oven,18490,24000,5510,1,00444,India
616614,2024-01-28,504,iron,449,879,430,1,00444,India
905519,2024-01-28,501,iphone 15,60000,80000,20000,1,00202,India
905519,2024-01-28,507,washing machine,6990,16490,9500,1,00202,India
905519,2024-01-28,506,monitor,3249,8000,4751,1,00202,India
835403,2024-01-28,506,monitor,3249,8000,4751,1,00367,India
835403,2024-01-28,505,oven,18490,24000,5510,1,00367,India
225562,2024-01-28,501,iphone 15,60000,80000,20000,1,00378,India
225562,2024-01-28,503,mixer,1349,3249,1900,1,00378,India
541341,2024-01-28,503,mixer,1349,3249,1900,1,00039,India
541341,2024-01-28,502,iphone 15 pro max,100000,135000,35000,1,00039,India
541341,2024-01-28,504,iron,449,879,430,1,00039,India
541341,2024-01-28,501,iphone 15,60000,80000,20000,1,00039,India
449646,2024-01-28,501,iphone 15,60000,80000,20000,1,00196,India
449646,2024-01-28,504,iron,449,879,430,1,00196,India
206540,2024-01-28,501,iphone 15,60000,80000,20000,1,00408,India
206540,2024-01-28,503,mixer,1349,3249,1900,1,00408,India
206540,2024-01-28,505,oven,18490,24000,5510,1,00408,India
206540,2024-01-28,504,iron,449,879,430,1,00408,India
206540,2024-01-28,506,monitor,3249,8000,4751,1,00408,India
299737,2024-01-28,505,oven,18490,24000,5510,1,00198,India
148164,2024-01-28,501,iphone 15,60000,80000,20000,1,00242,India
148164,2024-01-28,502,iphone 15 pro max,100000,135000,35000,1,00242,India
157015,2024-01-28,505,oven,18490,24000,5510,1,00356,India
465249,2024-01-28,506,monitor,3249,8000,4751,1,00212,India
465249,2024-01-28,503,mixer,1349,3249,1900,1,00212,India
465249,2024-01-28,502,iphone 15 pro max,100000,135000,35000,1,00212,India
653269,2024-01-28,502,iphone 15 pro max,100000,135000,35000,1,00100,India
653269,2024-01-28,507,washing machine,6990,16490,9500,1,00100,India
653269,2024-01-28,506,monitor,3249,8000,4751,1,00100,India
422638,2024-01-29,505,oven,18490,24000,5510,1,00183,India
422638,2024-01-29,504,iron,449,879,430,1,00183,India
422638,2024-01-29,507,washing machine,6990,16490,9500,1,00183,India
557392,2024-01-29,502,iphone 15 pro max,100000,135000,35000,1,00461,India
557392,2024-01-29,504,iron,449,879,430,1,00461,India
557392,2024-01-29,505,oven,18490,24000,5510,1,00461,India
364200,2024-01-29,506,monitor,3249,8000,4751,1,00301,India
342083,2024-01-29,507,washing machine,6990,16490,9500,1,00140,India
342083,2024-01-29,501,iphone 15,60000,80000,20000,1,00140,India
342083,2024-01-29,506,monitor,3249,8000,4751,1,00140,India
342083,2024-01-29,504,iron,449,879,430,1,00140,India
732925,2024-01-29,503,mixer,1349,3249,1900,1,00341,India
732925,2024-01-29,507,washing machine,6990,16490,9500,1,00341,India
732925,2024-01-29,502,iphone 15 pro max,100000,135000,35000,1,00341,India
537562,2024-01-29,505,oven,18490,24000,5510,1,00139,India
710706,2024-01-29,504,iron,449,879,430,1,00276,India
710706,2024-01-29,507,washing machine,6990,16490,9500,1,00276,India
710706,2024-01-29,501,iphone 15,60000,80000,20000,1,00276,India
905320,2024-01-29,505,oven,18490,24000,5510,1,00133,India
905320,2024-01-29,503,mixer,1349,3249,1900,1,00133,India
875990,2024-01-29,503,mixer,1349,3249,1900,1,00122,India
875990,2024-01-29,507,washing machine,6990,16490,9500,1,00122,India
875990,2024-01-29,505,oven,18490,24000,5510,1,00122,India
972363,2024-01-29,501,iphone 15,60000,80000,20000,1,00178,India
972363,2024-01-29,502,iphone 15 pro max,100000,135000,35000,1,00178,India
972363,2024-01-29,503,mixer,1349,3249,1900,1,00178,India
878768,2024-01-29,503,mixer,1349,3249,1900,1,00138,India
878768,2024-01-29,502,iphone 15 pro max,100000,135000,35000,1,00138,India
878768,2024-01-29,504,iron,449,879,430,1,00138,India
878768,2024-01-29,505,oven,18490,24000,5510,1,00138,India
515982,2024-01-29,502,iphone 15 pro max,100000,135000,35000,1,00449,India
515982,2024-01-29,505,oven,18490,24000,5510,1,00449,India
515982,2024-01-29,501,iphone 15,60000,80000,20000,1,00449,India
794262,2024-01-29,503,mixer,1349,3249,1900,1,00123,India
794262,2024-01-29,507,washing machine,6990,16490,9500,1,00123,India
794262,2024-01-29,505,oven,18490,24000,5510,1,00123,India
794262,2024-01-29,501,iphone 15,60000,80000,20000,1,00123,India
320402,2024-01-29,502,iphone 15 pro max,100000,135000,35000,1,00031,India
320402,2024-01-29,505,oven,18490,24000,5510,1,00031,India
435459,2024-01-29,501,iphone 15,60000,80000,20000,1,00202,India
435459,2024-01-29,507,washing machine,6990,16490,9500,1,00202,India
435459,2024-01-29,505,oven,18490,24000,5510,1,00202,India
435459,2024-01-29,504,iron,449,879,430,1,00202,India
374436,2024-01-29,507,washing machine,6990,16490,9500,1,00153,India
923769,2024-01-29,501,iphone 15,60000,80000,20000,1,00001,India
923769,2024-01-29,502,iphone 15 pro max,100000,135000,35000,1,00001,India
913892,2024-01-29,505,oven,18490,24000,5510,1,00182,India
913892,2024-01-29,504,iron,449,879,430,1,00182,India
143120,2024-01-29,507,washing machine,6990,16490,9500,1,00304,India
225915,2024-01-29,503,mixer,1349,3249,1900,1,00228,India
225915,2024-01-29,501,iphone 15,60000,80000,20000,1,00228,India
225915,2024-01-29,505,oven,18490,24000,5510,1,00228,India
456976,2024-01-29,505,oven,18490,24000,5510,1,00016,India
108804,2024-01-29,505,oven,18490,24000,5510,1,00365,India
108804,2024-01-29,501,iphone 15,60000,80000,20000,1,00365,India
108804,2024-01-29,502,iphone 15 pro max,100000,135000,35000,1,00365,India
668625,2024-01-29,504,iron,449,879,430,1,00292,India
668625,2024-01-29,502,iphone 15 pro max,100000,135000,35000,1,00292,India
544417,2024-01-29,505,oven,18490,24000,5510,1,00172,India
688757,2024-01-29,501,iphone 15,60000,80000,20000,1,00319,India
688757,2024-01-29,505,oven,18490,24000,5510,1,00319,India
688757,2024-01-29,503,mixer,1349,3249,1900,1,00319,India
289925,2024-01-29,506,monitor,3249,8000,4751,1,00170,India
289925,2024-01-29,501,iphone 15,60000,80000,20000,1,00170,India
968962,2024-01-29,506,monitor,3249,8000,4751,1,00037,India
968962,2024-01-29,501,iphone 15,60000,80000,20000,1,00037,India
968962,2024-01-29,507,washing machine,6990,16490,9500,1,00037,India
434847,2024-01-29,501,iphone 15,60000,80000,20000,1,00321,India
434847,2024-01-29,506,monitor,3249,8000,4751,1,00321,India
434847,2024-01-29,502,iphone 15 pro max,100000,135000,35000,1,00321,India
664679,2024-01-29,501,iphone 15,60000,80000,20000,1,00456,India
229728,2024-01-29,502,iphone 15 pro max,100000,135000,35000,1,00018,India
229728,2024-01-29,504,iron,449,879,430,1,00018,India
229728,2024-01-29,505,oven,18490,24000,5510,1,00018,India
229728,2024-01-29,506,monitor,3249,8000,4751,1,00018,India
229728,2024-01-29,501,iphone 15,60000,80000,20000,1,00018,India
373516,2024-01-29,501,iphone 15,60000,80000,20000,1,00169,India
373516,2024-01-29,506,monitor,3249,8000,4751,1,00169,India
373516,2024-01-29,503,mixer,1349,3249,1900,1,00169,India
111467,2024-01-29,504,iron,449,879,430,1,00333,India
111467,2024-01-29,506,monitor,3249,8000,4751,1,00333,India
463461,2024-01-29,504,iron,449,879,430,1,00179,India
463461,2024-01-29,507,washing machine,6990,16490,9500,1,00179,India
974957,2024-01-29,502,iphone 15 pro max,100000,135000,35000,1,00461,India
974957,2024-01-29,503,mixer,1349,3249,1900,1,00461,India
974957,2024-01-29,501,iphone 15,60000,80000,20000,1,00461,India
974957,2024-01-29,505,oven,18490,24000,5510,1,00461,India
974957,2024-01-29,506,monitor,3249,8000,4751,1,00461,India
291224,2024-01-29,507,washing machine,6990,16490,9500,1,00125,India
291224,2024-01-29,505,oven,18490,24000,5510,1,00125,India
501670,2024-01-29,506,monitor,3249,8000,4751,1,00080,India
501670,2024-01-29,507,washing machine,6990,16490,9500,1,00080,India
501670,2024-01-29,505,oven,18490,24000,5510,1,00080,India
522113,2024-01-29,502,iphone 15 pro max,100000,135000,35000,1,00113,India
236152,2024-01-29,506,monitor,3249,8000,4751,1,00320,India
236152,2024-01-29,504,iron,449,879,430,1,00320,India
735395,2024-01-29,502,iphone 15 pro max,100000,135000,35000,1,00215,India
735395,2024-01-29,503,mixer,1349,3249,1900,1,00215,India
735395,2024-01-29,507,washing machine,6990,16490,9500,1,00215,India
662901,2024-01-29,501,iphone 15,60000,80000,20000,1,00007,India
662901,2024-01-29,506,monitor,3249,8000,4751,1,00007,India
829708,2024-01-29,506,monitor,3249,8000,4751,1,00413,India
829708,2024-01-29,502,iphone 15 pro max,100000,135000,35000,1,00413,India
829708,2024-01-29,501,iphone 15,60000,80000,20000,1,00413,India
441932,2024-01-29,502,iphone 15 pro max,100000,135000,35000,1,00385,India
441932,2024-01-29,504,iron,449,879,430,1,00385,India
441932,2024-01-29,507,washing machine,6990,16490,9500,1,00385,India
257495,2024-01-29,506,monitor,3249,8000,4751,1,00174,India
257495,2024-01-29,504,iron,449,879,430,1,00174,India
257495,2024-01-29,501,iphone 15,60000,80000,20000,1,00174,India
959364,2024-01-29,507,washing machine,6990,16490,9500,1,00354,India
959364,2024-01-29,503,mixer,1349,3249,1900,1,00354,India
959364,2024-01-29,506,monitor,3249,8000,4751,1,00354,India
959364,2024-01-29,502,iphone 15 pro max,100000,135000,35000,1,00354,India
131451,2024-01-29,503,mixer,1349,3249,1900,1,00103,India
131451,2024-01-29,507,washing machine,6990,16490,9500,1,00103,India
121918,2024-01-29,502,iphone 15 pro max,100000,135000,35000,1,00143,India
121918,2024-01-29,507,washing machine,6990,16490,9500,1,00143,India
141493,2024-01-29,504,iron,449,879,430,1,00377,India
833094,2024-01-29,506,monitor,3249,8000,4751,1,00380,India
833094,2024-01-29,507,washing machine,6990,16490,9500,1,00380,India
540333,2024-01-29,504,iron,449,879,430,1,00119,India
561949,2024-01-29,505,oven,18490,24000,5510,1,00340,India
561949,2024-01-29,507,washing machine,6990,16490,9500,1,00340,India
561949,2024-01-29,506,monitor,3249,8000,4751,1,00340,India
283475,2024-01-29,504,iron,449,879,430,1,00292,India
283475,2024-01-29,501,iphone 15,60000,80000,20000,1,00292,India
283475,2024-01-29,507,washing machine,6990,16490,9500,1,00292,India
191599,2024-01-29,501,iphone 15,60000,80000,20000,1,00444,India
191599,2024-01-29,505,oven,18490,24000,5510,1,00444,India
603362,2024-01-29,504,iron,449,879,430,1,00180,India
603362,2024-01-29,507,washing machine,6990,16490,9500,1,00180,India
603362,2024-01-29,506,monitor,3249,8000,4751,1,00180,India
403175,2024-01-29,503,mixer,1349,3249,1900,1,00004,India
782965,2024-01-29,501,iphone 15,60000,80000,20000,1,00412,India
782965,2024-01-29,503,mixer,1349,3249,1900,1,00412,India
782965,2024-01-29,507,washing machine,6990,16490,9500,1,00412,India
782965,2024-01-29,502,iphone 15 pro max,100000,135000,35000,1,00412,India
597178,2024-01-29,504,iron,449,879,430,1,00451,India
597178,2024-01-29,501,iphone 15,60000,80000,20000,1,00451,India
597178,2024-01-29,505,oven,18490,24000,5510,1,00451,India
597178,2024-01-29,502,iphone 15 pro max,100000,135000,35000,1,00451,India
329213,2024-01-29,506,monitor,3249,8000,4751,1,00061,India
329213,2024-01-29,507,washing machine,6990,16490,9500,1,00061,India
623708,2024-01-29,507,washing machine,6990,16490,9500,1,00229,India
405633,2024-01-29,507,washing machine,6990,16490,9500,1,00175,India
405633,2024-01-29,504,iron,449,879,430,1,00175,India
405633,2024-01-29,503,mixer,1349,3249,1900,1,00175,India
571761,2024-01-30,504,iron,449,879,430,1,00475,India
571761,2024-01-30,501,iphone 15,60000,80000,20000,1,00475,India
571761,2024-01-30,502,iphone 15 pro max,100000,135000,35000,1,00475,India
571761,2024-01-30,505,oven,18490,24000,5510,1,00475,India
238229,2024-01-30,502,iphone 15 pro max,100000,135000,35000,1,00046,India
238229,2024-01-30,503,mixer,1349,3249,1900,1,00046,India
238229,2024-01-30,505,oven,18490,24000,5510,1,00046,India
238229,2024-01-30,504,iron,449,879,430,1,00046,India
744604,2024-01-30,501,iphone 15,60000,80000,20000,1,00364,India
475589,2024-01-30,506,monitor,3249,8000,4751,1,00053,India
475589,2024-01-30,505,oven,18490,24000,5510,1,00053,India
475589,2024-01-30,503,mixer,1349,3249,1900,1,00053,India
475589,2024-01-30,501,iphone 15,60000,80000,20000,1,00053,India
475589,2024-01-30,504,iron,449,879,430,1,00053,India
588673,2024-01-30,507,washing machine,6990,16490,9500,1,00204,India
588673,2024-01-30,502,iphone 15 pro max,100000,135000,35000,1,00204,India
481536,2024-01-30,507,washing machine,6990,16490,9500,1,00286,India
481536,2024-01-30,503,mixer,1349,3249,1900,1,00286,India
906607,2024-01-30,507,washing machine,6990,16490,9500,1,00498,India
906607,2024-01-30,501,iphone 15,60000,80000,20000,1,00498,India
906607,2024-01-30,505,oven,18490,24000,5510,1,00498,India
154246,2024-01-30,507,washing machine,6990,16490,9500,1,00026,India
154246,2024-01-30,506,monitor,3249,8000,4751,1,00026,India
639559,2024-01-30,505,oven,18490,24000,5510,1,00237,India
639559,2024-01-30,502,iphone 15 pro max,100000,135000,35000,1,00237,India
639559,2024-01-30,501,iphone 15,60000,80000,20000,1,00237,India
639559,2024-01-30,504,iron,449,879,430,1,00237,India
119809,2024-01-30,507,washing machine,6990,16490,9500,1,00128,India
119809,2024-01-30,503,mixer,1349,3249,1900,1,00128,India
847692,2024-01-30,501,iphone 15,60000,80000,20000,1,00462,India
502012,2024-01-30,507,washing machine,6990,16490,9500,1,00374,India
502012,2024-01-30,502,iphone 15 pro max,100000,135000,35000,1,00374,India
473030,2024-01-30,504,iron,449,879,430,1,00326,India
473030,2024-01-30,506,monitor,3249,8000,4751,1,00326,India
473030,2024-01-30,502,iphone 15 pro max,100000,135000,35000,1,00326,India
473030,2024-01-30,505,oven,18490,24000,5510,1,00326,India
779446,2024-01-30,501,iphone 15,60000,80000,20000,1,00437,India
164683,2024-01-30,503,mixer,1349,3249,1900,1,00359,India
164683,2024-01-30,501,iphone 15,60000,80000,20000,1,00359,India
987123,2024-01-30,507,washing machine,6990,16490,9500,1,00006,India
987123,2024-01-30,502,iphone 15 pro max,100000,135000,35000,1,00006,India
995889,2024-01-30,504,iron,449,879,430,1,00318,India
995889,2024-01-30,506,monitor,3249,8000,4751,1,00318,India
188794,2024-01-30,501,iphone 15,60000,80000,20000,1,00476,India
188794,2024-01-30,507,washing machine,6990,16490,9500,1,00476,India
188794,2024-01-30,506,monitor,3249,8000,4751,1,00476,India
654847,2024-01-30,503,mixer,1349,3249,1900,1,00352,India
654847,2024-01-30,502,iphone 15 pro max,100000,135000,35000,1,00352,India
654847,2024-01-30,506,monitor,3249,8000,4751,1,00352,India
654847,2024-01-30,507,washing machine,6990,16490,9500,1,00352,India
315066,2024-01-30,502,iphone 15 pro max,100000,135000,35000,1,00152,India
295992,2024-01-30,507,washing machine,6990,16490,9500,1,00286,India
515414,2024-01-30,503,mixer,1349,3249,1900,1,00471,India
515414,2024-01-30,502,iphone 15 pro max,100000,135000,35000,1,00471,India
515414,2024-01-30,505,oven,18490,24000,5510,1,00471,India
515414,2024-01-30,507,washing machine,6990,16490,9500,1,00471,India
267248,2024-01-30,506,monitor,3249,8000,4751,1,00300,India
267248,2024-01-30,503,mixer,1349,3249,1900,1,00300,India
267248,2024-01-30,501,iphone 15,60000,80000,20000,1,00300,India
267248,2024-01-30,502,iphone 15 pro max,100000,135000,35000,1,00300,India
363257,2024-01-30,507,washing machine,6990,16490,9500,1,00415,India
363257,2024-01-30,505,oven,18490,24000,5510,1,00415,India
363257,2024-01-30,501,iphone 15,60000,80000,20000,1,00415,India
363257,2024-01-30,506,monitor,3249,8000,4751,1,00415,India
264271,2024-01-30,503,mixer,1349,3249,1900,1,00221,India
266848,2024-01-30,503,mixer,1349,3249,1900,1,00302,India
266848,2024-01-30,501,iphone 15,60000,80000,20000,1,00302,India
266848,2024-01-30,506,monitor,3249,8000,4751,1,00302,India
838477,2024-01-30,501,iphone 15,60000,80000,20000,1,00261,India
838477,2024-01-30,506,monitor,3249,8000,4751,1,00261,India
700319,2024-01-30,502,iphone 15 pro max,100000,135000,35000,1,00015,India
700319,2024-01-30,503,mixer,1349,3249,1900,1,00015,India
700319,2024-01-30,507,washing machine,6990,16490,9500,1,00015,India
700319,2024-01-30,501,iphone 15,60000,80000,20000,1,00015,India
700319,2024-01-30,506,monitor,3249,8000,4751,1,00015,India
478518,2024-01-30,505,oven,18490,24000,5510,1,00069,India
478518,2024-01-30,501,iphone 15,60000,80000,20000,1,00069,India
478518,2024-01-30,503,mixer,1349,3249,1900,1,00069,India
291504,2024-01-30,506,monitor,3249,8000,4751,1,00444,India
291504,2024-01-30,507,washing machine,6990,16490,9500,1,00444,India
291504,2024-01-30,503,mixer,1349,3249,1900,1,00444,India
141604,2024-01-30,507,washing machine,6990,16490,9500,1,00321,India
141604,2024-01-30,505,oven,18490,24000,5510,1,00321,India
141604,2024-01-30,504,iron,449,879,430,1,00321,India
141604,2024-01-30,506,monitor,3249,8000,4751,1,00321,India
141604,2024-01-30,501,iphone 15,60000,80000,20000,1,00321,India
146874,2024-01-30,506,monitor,3249,8000,4751,1,00219,India
146874,2024-01-30,501,iphone 15,60000,80000,20000,1,00219,India
146874,2024-01-30,503,mixer,1349,3249,1900,1,00219,India
165620,2024-01-30,501,iphone 15,60000,80000,20000,1,00074,India
165620,2024-01-30,503,mixer,1349,3249,1900,1,00074,India
165620,2024-01-30,507,washing machine,6990,16490,9500,1,00074,India
165620,2024-01-30,506,monitor,3249,8000,4751,1,00074,India
879865,2024-01-30,506,monitor,3249,8000,4751,1,00212,India
879865,2024-01-30,501,iphone 15,60000,80000,20000,1,00212,India
670757,2024-01-30,501,iphone 15,60000,80000,20000,1,00314,India
231654,2024-01-30,503,mixer,1349,3249,1900,1,00497,India
231654,2024-01-30,501,iphone 15,60000,80000,20000,1,00497,India
231654,2024-01-30,507,washing machine,6990,16490,9500,1,00497,India
395473,2024-01-30,507,washing machine,6990,16490,9500,1,00343,India
395473,2024-01-30,505,oven,18490,24000,5510,1,00343,India
456431,2024-01-30,501,iphone 15,60000,80000,20000,1,00045,India
682541,2024-01-30,501,iphone 15,60000,80000,20000,1,00058,India
682541,2024-01-30,506,monitor,3249,8000,4751,1,00058,India
370924,2024-01-30,504,iron,449,879,430,1,00103,India
370924,2024-01-30,506,monitor,3249,8000,4751,1,00103,India
370924,2024-01-30,502,iphone 15 pro max,100000,135000,35000,1,00103,India
442621,2024-01-30,503,mixer,1349,3249,1900,1,00268,India
442621,2024-01-30,507,washing machine,6990,16490,9500,1,00268,India
442621,2024-01-30,504,iron,449,879,430,1,00268,India
442621,2024-01-30,501,iphone 15,60000,80000,20000,1,00268,India
488521,2024-01-30,503,mixer,1349,3249,1900,1,00256,India
488521,2024-01-30,502,iphone 15 pro max,100000,135000,35000,1,00256,India
488521,2024-01-30,506,monitor,3249,8000,4751,1,00256,India
975540,2024-01-30,502,iphone 15 pro max,100000,135000,35000,1,00341,India
975540,2024-01-30,505,oven,18490,24000,5510,1,00341,India
914689,2024-01-30,501,iphone 15,60000,80000,20000,1,00284,India
914689,2024-01-30,503,mixer,1349,3249,1900,1,00284,India
547492,2024-01-30,507,washing machine,6990,16490,9500,1,00234,India
234945,2024-01-30,504,iron,449,879,430,1,00224,India
234945,2024-01-30,507,washing machine,6990,16490,9500,1,00224,India
234945,2024-01-30,501,iphone 15,60000,80000,20000,1,00224,India
234945,2024-01-30,505,oven,18490,24000,5510,1,00224,India
660814,2024-01-30,506,monitor,3249,8000,4751,1,00228,India
660814,2024-01-30,505,oven,18490,24000,5510,1,00228,India
660814,2024-01-30,507,washing machine,6990,16490,9500,1,00228,India
814985,2024-01-30,506,monitor,3249,8000,4751,1,00076,India
656740,2024-01-30,505,oven,18490,24000,5510,1,00433,India
656740,2024-01-30,502,iphone 15 pro max,100000,135000,35000,1,00433,India
656740,2024-01-30,501,iphone 15,60000,80000,20000,1,00433,India
950686,2024-01-30,507,washing machine,6990,16490,9500,1,00439,India
950686,2024-01-30,501,iphone 15,60000,80000,20000,1,00439,India
950686,2024-01-30,506,monitor,3249,8000,4751,1,00439,India
717624,2024-01-30,505,oven,18490,24000,5510,1,00213,India
717624,2024-01-30,504,iron,449,879,430,1,00213,India
782109,2024-01-30,507,washing machine,6990,16490,9500,1,00132,India
782109,2024-01-30,505,oven,18490,24000,5510,1,00132,India
782109,2024-01-30,503,mixer,1349,3249,1900,1,00132,India
589905,2024-01-30,503,mixer,1349,3249,1900,1,00088,India
589905,2024-01-30,501,iphone 15,60000,80000,20000,1,00088,India
290234,2024-01-30,501,iphone 15,60000,80000,20000,1,00149,India
290234,2024-01-30,505,oven,18490,24000,5510,1,00149,India
290234,2024-01-30,507,washing machine,6990,16490,9500,1,00149,India
652092,2024-01-30,506,monitor,3249,8000,4751,1,00088,India
652092,2024-01-30,504,iron,449,879,430,1,00088,India
652092,2024-01-30,507,washing machine,6990,16490,9500,1,00088,India
713375,2024-01-30,504,iron,449,879,430,1,00492,India
713375,2024-01-30,502,iphone 15 pro max,100000,135000,35000,1,00492,India
748327,2024-01-30,503,mixer,1349,3249,1900,1,00090,India
748327,2024-01-30,505,oven,18490,24000,5510,1,00090,India
369290,2024-01-30,503,mixer,1349,3249,1900,1,00296,India
369290,2024-01-30,504,iron,449,879,430,1,00296,India
638344,2024-01-30,503,mixer,1349,3249,1900,1,00244,India
638344,2024-01-30,504,iron,449,879,430,1,00244,India
638344,2024-01-30,501,iphone 15,60000,80000,20000,1,00244,India
638344,2024-01-30,506,monitor,3249,8000,4751,1,00244,India
944046,2024-01-30,504,iron,449,879,430,1,00268,India
944046,2024-01-30,506,monitor,3249,8000,4751,1,00268,India
944046,2024-01-30,502,iphone 15 pro max,100000,135000,35000,1,00268,India
922583,2024-01-30,502,iphone 15 pro max,100000,135000,35000,1,00190,India
124849,2024-01-30,503,mixer,1349,3249,1900,1,00164,India
124849,2024-01-30,502,iphone 15 pro max,100000,135000,35000,1,00164,India
124849,2024-01-30,505,oven,18490,24000,5510,1,00164,India
124849,2024-01-30,501,iphone 15,60000,80000,20000,1,00164,India
996083,2024-01-30,505,oven,18490,24000,5510,1,00156,India
996083,2024-01-30,503,mixer,1349,3249,1900,1,00156,India
996083,2024-01-30,502,iphone 15 pro max,100000,135000,35000,1,00156,India
636562,2024-01-30,502,iphone 15 pro max,100000,135000,35000,1,00339,India
636562,2024-01-30,505,oven,18490,24000,5510,1,00339,India
636562,2024-01-30,503,mixer,1349,3249,1900,1,00339,India
636562,2024-01-30,504,iron,449,879,430,1,00339,India
636562,2024-01-30,507,washing machine,6990,16490,9500,1,00339,India
556546,2024-01-30,506,monitor,3249,8000,4751,1,00448,India
556546,2024-01-30,503,mixer,1349,3249,1900,1,00448,India
556546,2024-01-30,507,washing machine,6990,16490,9500,1,00448,India
556546,2024-01-30,504,iron,449,879,430,1,00448,India
719999,2024-01-30,507,washing machine,6990,16490,9500,1,00137,India
719999,2024-01-30,506,monitor,3249,8000,4751,1,00137,India
719999,2024-01-30,501,iphone 15,60000,80000,20000,1,00137,India
137773,2024-01-30,501,iphone 15,60000,80000,20000,1,00339,India
546009,2024-01-30,501,iphone 15,60000,80000,20000,1,00408,India
546009,2024-01-30,502,iphone 15 pro max,100000,135000,35000,1,00408,India
679072,2024-01-30,502,iphone 15 pro max,100000,135000,35000,1,00320,India
679072,2024-01-30,506,monitor,3249,8000,4751,1,00320,India
679072,2024-01-30,505,oven,18490,24000,5510,1,00320,India
435941,2024-01-30,502,iphone 15 pro max,100000,135000,35000,1,00356,India
380434,2024-01-30,502,iphone 15 pro max,100000,135000,35000,1,00317,India
380434,2024-01-30,507,washing machine,6990,16490,9500,1,00317,India
515681,2024-01-31,504,iron,449,879,430,1,00493,India
515681,2024-01-31,502,iphone 15 pro max,100000,135000,35000,1,00493,India
515681,2024-01-31,503,mixer,1349,3249,1900,1,00493,India
515681,2024-01-31,505,oven,18490,24000,5510,1,00493,India
277587,2024-01-31,502,iphone 15 pro max,100000,135000,35000,1,00474,India
277587,2024-01-31,504,iron,449,879,430,1,00474,India
615190,2024-01-31,502,iphone 15 pro max,100000,135000,35000,1,00176,India
454429,2024-01-31,501,iphone 15,60000,80000,20000,1,00088,India
454429,2024-01-31,504,iron,449,879,430,1,00088,India
201878,2024-01-31,502,iphone 15 pro max,100000,135000,35000,1,00451,India
221248,2024-01-31,503,mixer,1349,3249,1900,1,00444,India
226525,2024-01-31,506,monitor,3249,8000,4751,1,00486,India
226525,2024-01-31,507,washing machine,6990,16490,9500,1,00486,India
226525,2024-01-31,504,iron,449,879,430,1,00486,India
524605,2024-01-31,506,monitor,3249,8000,4751,1,00309,India
524605,2024-01-31,507,washing machine,6990,16490,9500,1,00309,India
106623,2024-01-31,501,iphone 15,60000,80000,20000,1,00360,India
106623,2024-01-31,507,washing machine,6990,16490,9500,1,00360,India
309765,2024-01-31,503,mixer,1349,3249,1900,1,00413,India
309765,2024-01-31,504,iron,449,879,430,1,00413,India
309765,2024-01-31,507,washing machine,6990,16490,9500,1,00413,India
108161,2024-01-31,502,iphone 15 pro max,100000,135000,35000,1,00046,India
108161,2024-01-31,506,monitor,3249,8000,4751,1,00046,India
108161,2024-01-31,504,iron,449,879,430,1,00046,India
108161,2024-01-31,503,mixer,1349,3249,1900,1,00046,India
926972,2024-01-31,501,iphone 15,60000,80000,20000,1,00186,India
651046,2024-01-31,506,monitor,3249,8000,4751,1,00108,India
651046,2024-01-31,503,mixer,1349,3249,1900,1,00108,India
199237,2024-01-31,501,iphone 15,60000,80000,20000,1,00119,India
199237,2024-01-31,506,monitor,3249,8000,4751,1,00119,India
199237,2024-01-31,504,iron,449,879,430,1,00119,India
788976,2024-01-31,504,iron,449,879,430,1,00390,India
788976,2024-01-31,503,mixer,1349,3249,1900,1,00390,India
988212,2024-01-31,505,oven,18490,24000,5510,1,00252,India
988212,2024-01-31,504,iron,449,879,430,1,00252,India
289322,2024-01-31,506,monitor,3249,8000,4751,1,00377,India
289322,2024-01-31,501,iphone 15,60000,80000,20000,1,00377,India
116989,2024-01-31,507,washing machine,6990,16490,9500,1,00344,India
778928,2024-01-31,501,iphone 15,60000,80000,20000,1,00072,India
778928,2024-01-31,507,washing machine,6990,16490,9500,1,00072,India
778928,2024-01-31,506,monitor,3249,8000,4751,1,00072,India
778928,2024-01-31,502,iphone 15 pro max,100000,135000,35000,1,00072,India
891169,2024-01-31,502,iphone 15 pro max,100000,135000,35000,1,00359,India
891169,2024-01-31,505,oven,18490,24000,5510,1,00359,India
891169,2024-01-31,507,washing machine,6990,16490,9500,1,00359,India
302472,2024-01-31,503,mixer,1349,3249,1900,1,00335,India
302472,2024-01-31,505,oven,18490,24000,5510,1,00335,India
828959,2024-01-31,502,iphone 15 pro max,100000,135000,35000,1,00056,India
828959,2024-01-31,501,iphone 15,60000,80000,20000,1,00056,India
828959,2024-01-31,505,oven,18490,24000,5510,1,00056,India
284091,2024-01-31,501,iphone 15,60000,80000,20000,1,00108,India
284091,2024-01-31,504,iron,449,879,430,1,00108,India
284091,2024-01-31,503,mixer,1349,3249,1900,1,00108,India
206971,2024-01-31,506,monitor,3249,8000,4751,1,00424,India
206971,2024-01-31,504,iron,449,879,430,1,00424,India
206971,2024-01-31,503,mixer,1349,3249,1900,1,00424,India
144780,2024-01-31,505,oven,18490,24000,5510,1,00173,India
144780,2024-01-31,506,monitor,3249,8000,4751,1,00173,India
144780,2024-01-31,501,iphone 15,60000,80000,20000,1,00173,India
768904,2024-01-31,506,monitor,3249,8000,4751,1,00407,India
768904,2024-01-31,507,washing machine,6990,16490,9500,1,00407,India
235391,2024-01-31,507,washing machine,6990,16490,9500,1,00370,India
102857,2024-01-31,502,iphone 15 pro max,100000,135000,35000,1,00334,India
778005,2024-01-31,507,washing machine,6990,16490,9500,1,00193,India
778005,2024-01-31,502,iphone 15 pro max,100000,135000,35000,1,00193,India
185886,2024-01-31,506,monitor,3249,8000,4751,1,00330,India
185886,2024-01-31,502,iphone 15 pro max,100000,135000,35000,1,00330,India
185886,2024-01-31,501,iphone 15,60000,80000,20000,1,00330,India
185886,2024-01-31,505,oven,18490,24000,5510,1,00330,India
792805,2024-01-31,501,iphone 15,60000,80000,20000,1,00379,India
792805,2024-01-31,505,oven,18490,24000,5510,1,00379,India
792805,2024-01-31,504,iron,449,879,430,1,00379,India
792805,2024-01-31,506,monitor,3249,8000,4751,1,00379,India
407468,2024-01-31,504,iron,449,879,430,1,00341,India
407468,2024-01-31,506,monitor,3249,8000,4751,1,00341,India
407468,2024-01-31,503,mixer,1349,3249,1900,1,00341,India
407468,2024-01-31,502,iphone 15 pro max,100000,135000,35000,1,00341,India
816369,2024-01-31,503,mixer,1349,3249,1900,1,00293,India
816369,2024-01-31,504,iron,449,879,430,1,00293,India
832756,2024-01-31,504,iron,449,879,430,1,00152,India
613025,2024-01-31,506,monitor,3249,8000,4751,1,00080,India
613025,2024-01-31,505,oven,18490,24000,5510,1,00080,India
954789,2024-01-31,506,monitor,3249,8000,4751,1,00158,India
954789,2024-01-31,503,mixer,1349,3249,1900,1,00158,India
327243,2024-01-31,503,mixer,1349,3249,1900,1,00101,India
327243,2024-01-31,502,iphone 15 pro max,100000,135000,35000,1,00101,India
327243,2024-01-31,507,washing machine,6990,16490,9500,1,00101,India
665955,2024-01-31,505,oven,18490,24000,5510,1,00056,India
447680,2024-01-31,505,oven,18490,24000,5510,1,00017,India
447680,2024-01-31,503,mixer,1349,3249,1900,1,00017,India
447680,2024-01-31,502,iphone 15 pro max,100000,135000,35000,1,00017,India
447680,2024-01-31,501,iphone 15,60000,80000,20000,1,00017,India
499116,2024-01-31,505,oven,18490,24000,5510,1,00452,India
788356,2024-01-31,506,monitor,3249,8000,4751,1,00004,India
788356,2024-01-31,505,oven,18490,24000,5510,1,00004,India
788356,2024-01-31,502,iphone 15 pro max,100000,135000,35000,1,00004,India
478409,2024-01-31,504,iron,449,879,430,1,00412,India
544993,2024-01-31,507,washing machine,6990,16490,9500,1,00086,India
544993,2024-01-31,503,mixer,1349,3249,1900,1,00086,India
236626,2024-01-31,503,mixer,1349,3249,1900,1,00202,India
236626,2024-01-31,505,oven,18490,24000,5510,1,00202,India
863525,2024-01-31,507,washing machine,6990,16490,9500,1,00343,India
426782,2024-01-31,503,mixer,1349,3249,1900,1,00404,India
426782,2024-01-31,505,oven,18490,24000,5510,1,00404,India
426782,2024-01-31,504,iron,449,879,430,1,00404,India
506700,2024-01-31,507,washing machine,6990,16490,9500,1,00077,India
506700,2024-01-31,504,iron,449,879,430,1,00077,India
506700,2024-01-31,505,oven,18490,24000,5510,1,00077,India
361709,2024-01-31,502,iphone 15 pro max,100000,135000,35000,1,00236,India
361709,2024-01-31,506,monitor,3249,8000,4751,1,00236,India
673022,2024-01-31,504,iron,449,879,430,1,00094,India
673022,2024-01-31,502,iphone 15 pro max,100000,135000,35000,1,00094,India
853194,2024-01-31,503,mixer,1349,3249,1900,1,00336,India
853194,2024-01-31,505,oven,18490,24000,5510,1,00336,India
635196,2024-01-31,502,iphone 15 pro max,100000,135000,35000,1,00394,India
741893,2024-01-31,507,washing machine,6990,16490,9500,1,00010,India
741893,2024-01-31,505,oven,18490,24000,5510,1,00010,India
741893,2024-01-31,501,iphone 15,60000,80000,20000,1,00010,India
741893,2024-01-31,503,mixer,1349,3249,1900,1,00010,India
331562,2024-01-31,505,oven,18490,24000,5510,1,00453,India
331562,2024-01-31,507,washing machine,6990,16490,9500,1,00453,India
331562,2024-01-31,506,monitor,3249,8000,4751,1,00453,India
331562,2024-01-31,504,iron,449,879,430,1,00453,India
320889,2024-01-31,504,iron,449,879,430,1,00136,India
320889,2024-01-31,503,mixer,1349,3249,1900,1,00136,India
320889,2024-01-31,506,monitor,3249,8000,4751,1,00136,India
320889,2024-01-31,501,iphone 15,60000,80000,20000,1,00136,India
320889,2024-01-31,502,iphone 15 pro max,100000,135000,35000,1,00136,India
463166,2024-01-31,503,mixer,1349,3249,1900,1,00068,India
463166,2024-01-31,504,iron,449,879,430,1,00068,India
463166,2024-01-31,506,monitor,3249,8000,4751,1,00068,India
463166,2024-01-31,501,iphone 15,60000,80000,20000,1,00068,India
443375,2024-01-31,507,washing machine,6990,16490,9500,1,00455,India
443375,2024-01-31,503,mixer,1349,3249,1900,1,00455,India
443375,2024-01-31,501,iphone 15,60000,80000,20000,1,00455,India
378428,2024-01-31,506,monitor,3249,8000,4751,1,00121,India
378428,2024-01-31,501,iphone 15,60000,80000,20000,1,00121,India
298914,2024-01-31,502,iphone 15 pro max,100000,135000,35000,1,00491,India
298914,2024-01-31,507,washing machine,6990,16490,9500,1,00491,India
311407,2024-01-31,505,oven,18490,24000,5510,1,00220,India
311407,2024-01-31,503,mixer,1349,3249,1900,1,00220,India
411659,2024-01-31,505,oven,18490,24000,5510,1,00217,India
411659,2024-01-31,504,iron,449,879,430,1,00217,India
411659,2024-01-31,502,iphone 15 pro max,100000,135000,35000,1,00217,India
411659,2024-01-31,501,iphone 15,60000,80000,20000,1,00217,India
845533,2024-01-31,502,iphone 15 pro max,100000,135000,35000,1,00290,India
199064,2024-01-31,507,washing machine,6990,16490,9500,1,00457,India
199064,2024-01-31,505,oven,18490,24000,5510,1,00457,India
199064,2024-01-31,504,iron,449,879,430,1,00457,India
199064,2024-01-31,502,iphone 15 pro max,100000,135000,35000,1,00457,India
723667,2024-01-31,505,oven,18490,24000,5510,1,00369,India
723667,2024-01-31,503,mixer,1349,3249,1900,1,00369,India
723667,2024-01-31,504,iron,449,879,430,1,00369,India
723667,2024-01-31,507,washing machine,6990,16490,9500,1,00369,India
884106,2024-01-31,503,mixer,1349,3249,1900,1,00210,India
884106,2024-01-31,501,iphone 15,60000,80000,20000,1,00210,India
884106,2024-01-31,504,iron,449,879,430,1,00210,India
884106,2024-01-31,506,monitor,3249,8000,4751,1,00210,India
884106,2024-01-31,502,iphone 15 pro max,100000,135000,35000,1,00210,India
747993,2024-01-31,505,oven,18490,24000,5510,1,00278,India
747993,2024-01-31,504,iron,449,879,430,1,00278,India
859650,2024-01-31,504,iron,449,879,430,1,00371,India
569164,2024-01-31,501,iphone 15,60000,80000,20000,1,00135,India
569164,2024-01-31,507,washing machine,6990,16490,9500,1,00135,India
730686,2024-01-31,506,monitor,3249,8000,4751,1,00352,India
730686,2024-01-31,503,mixer,1349,3249,1900,1,00352,India
730686,2024-01-31,504,iron,449,879,430,1,00352,India
730686,2024-01-31,505,oven,18490,24000,5510,1,00352,India
413909,2024-01-31,504,iron,449,879,430,1,00053,India
413909,2024-01-31,506,monitor,3249,8000,4751,1,00053,India
413909,2024-01-31,501,iphone 15,60000,80000,20000,1,00053,India
359285,2024-01-31,504,iron,449,879,430,1,00487,India
359285,2024-01-31,502,iphone 15 pro max,100000,135000,35000,1,00487,India
770419,2024-01-31,506,monitor,3249,8000,4751,1,00209,India
770419,2024-01-31,503,mixer,1349,3249,1900,1,00209,India
770419,2024-01-31,504,iron,449,879,430,1,00209,India
161535,2024-01-31,505,oven,18490,24000,5510,1,00489,India
161535,2024-01-31,507,washing machine,6990,16490,9500,1,00489,India
209925,2024-01-31,503,mixer,1349,3249,1900,1,00081,India
209925,2024-01-31,501,iphone 15,60000,80000,20000,1,00081,India
209925,2024-01-31,507,washing machine,6990,16490,9500,1,00081,India
840976,2024-01-31,501,iphone 15,60000,80000,20000,1,00172,India
840976,2024-01-31,504,iron,449,879,430,1,00172,India
840976,2024-01-31,507,washing machine,6990,16490,9500,1,00172,India
685192,2024-01-31,505,oven,18490,24000,5510,1,00198,India
685192,2024-01-31,501,iphone 15,60000,80000,20000,1,00198,India
685192,2024-01-31,503,mixer,1349,3249,1900,1,00198,India
685192,2024-01-31,507,washing machine,6990,16490,9500,1,00198,India
351736,2024-01-31,504,iron,449,879,430,1,00414,India
351736,2024-01-31,507,washing machine,6990,16490,9500,1,00414,India
476637,2024-01-31,501,iphone 15,60000,80000,20000,1,00035,India
476637,2024-01-31,504,iron,449,879,430,1,00035,India
476637,2024-01-31,502,iphone 15 pro max,100000,135000,35000,1,00035,India
476637,2024-01-31,505,oven,18490,24000,5510,1,00035,India
476637,2024-01-31,503,mixer,1349,3249,1900,1,00035,India
445743,2024-01-31,501,iphone 15,60000,80000,20000,1,00412,India
445743,2024-01-31,502,iphone 15 pro max,100000,135000,35000,1,00412,India
642586,2024-01-31,502,iphone 15 pro max,100000,135000,35000,1,00151,India
642586,2024-01-31,503,mixer,1349,3249,1900,1,00151,India
642586,2024-01-31,507,washing machine,6990,16490,9500,1,00151,India
642586,2024-01-31,501,iphone 15,60000,80000,20000,1,00151,India
642586,2024-01-31,506,monitor,3249,8000,4751,1,00151,India
896570,2024-01-31,501,iphone 15,60000,80000,20000,1,00453,India
499113,2024-01-31,504,iron,449,879,430,1,00129,India
499113,2024-01-31,501,iphone 15,60000,80000,20000,1,00129,India
499113,2024-01-31,502,iphone 15 pro max,100000,135000,35000,1,00129,India
812650,2024-01-31,507,washing machine,6990,16490,9500,1,00351,India
812650,2024-01-31,503,mixer,1349,3249,1900,1,00351,India
812650,2024-01-31,501,iphone 15,60000,80000,20000,1,00351,India
812650,2024-01-31,505,oven,18490,24000,5510,1,00351,India
815416,2024-01-31,507,washing machine,6990,16490,9500,1,00315,India
815416,2024-01-31,502,iphone 15 pro max,100000,135000,35000,1,00315,India
608030,2024-01-31,504,iron,449,879,430,1,00107,India
608030,2024-01-31,502,iphone 15 pro max,100000,135000,35000,1,00107,India
147628,2024-01-31,505,oven,18490,24000,5510,1,00378,India
147628,2024-01-31,502,iphone 15 pro max,100000,135000,35000,1,00378,India
147628,2024-01-31,504,iron,449,879,430,1,00378,India
147628,2024-01-31,507,washing machine,6990,16490,9500,1,00378,India
578067,2024-01-31,506,monitor,3249,8000,4751,1,00256,India
578067,2024-01-31,501,iphone 15,60000,80000,20000,1,00256,India
578067,2024-01-31,503,mixer,1349,3249,1900,1,00256,India
532197,2024-01-31,504,iron,449,879,430,1,00012,India
532197,2024-01-31,503,mixer,1349,3249,1900,1,00012,India
479987,2024-01-31,504,iron,449,879,430,1,00421,India
479987,2024-01-31,503,mixer,1349,3249,1900,1,00421,India
793708,2024-01-31,506,monitor,3249,8000,4751,1,00446,India
793708,2024-01-31,502,iphone 15 pro max,100000,135000,35000,1,00446,India
793708,2024-01-31,503,mixer,1349,3249,1900,1,00446,India
836115,2024-01-31,507,washing machine,6990,16490,9500,1,00260,India
900603,2024-01-31,504,iron,449,879,430,1,00030,India
900603,2024-01-31,507,washing machine,6990,16490,9500,1,00030,India
900603,2024-01-31,501,iphone 15,60000,80000,20000,1,00030,India
731989,2024-01-31,505,oven,18490,24000,5510,1,00259,India
731989,2024-01-31,501,iphone 15,60000,80000,20000,1,00259,India
731989,2024-01-31,506,monitor,3249,8000,4751,1,00259,India
473511,2024-02-01,504,iron,449,879,430,1,00322,India
473511,2024-02-01,505,oven,18490,24000,5510,1,00322,India
298150,2024-02-01,507,washing machine,6990,16490,9500,1,00311,India
298150,2024-02-01,501,iphone 15,60000,80000,20000,1,00311,India
298150,2024-02-01,503,mixer,1349,3249,1900,1,00311,India
852310,2024-02-01,504,iron,449,879,430,1,00207,India
852310,2024-02-01,505,oven,18490,24000,5510,1,00207,India
852310,2024-02-01,503,mixer,1349,3249,1900,1,00207,India
796253,2024-02-01,507,washing machine,6990,16490,9500,1,00189,India
796253,2024-02-01,503,mixer,1349,3249,1900,1,00189,India
181376,2024-02-01,507,washing machine,6990,16490,9500,1,00424,India
872880,2024-02-01,503,mixer,1349,3249,1900,1,00084,India
872880,2024-02-01,507,washing machine,6990,16490,9500,1,00084,India
470481,2024-02-01,506,monitor,3249,8000,4751,1,00072,India
470481,2024-02-01,501,iphone 15,60000,80000,20000,1,00072,India
836382,2024-02-01,504,iron,449,879,430,1,00408,India
836382,2024-02-01,507,washing machine,6990,16490,9500,1,00408,India
836382,2024-02-01,506,monitor,3249,8000,4751,1,00408,India
559843,2024-02-01,505,oven,18490,24000,5510,1,00149,India
559843,2024-02-01,507,washing machine,6990,16490,9500,1,00149,India
559843,2024-02-01,501,iphone 15,60000,80000,20000,1,00149,India
559843,2024-02-01,502,iphone 15 pro max,100000,135000,35000,1,00149,India
559843,2024-02-01,503,mixer,1349,3249,1900,1,00149,India
135509,2024-02-01,501,iphone 15,60000,80000,20000,1,00066,India
135509,2024-02-01,506,monitor,3249,8000,4751,1,00066,India
135509,2024-02-01,502,iphone 15 pro max,100000,135000,35000,1,00066,India
135509,2024-02-01,505,oven,18490,24000,5510,1,00066,India
620002,2024-02-01,502,iphone 15 pro max,100000,135000,35000,1,00111,India
620002,2024-02-01,503,mixer,1349,3249,1900,1,00111,India
347896,2024-02-01,502,iphone 15 pro max,100000,135000,35000,1,00080,India
791275,2024-02-01,506,monitor,3249,8000,4751,1,00411,India
791275,2024-02-01,505,oven,18490,24000,5510,1,00411,India
791275,2024-02-01,503,mixer,1349,3249,1900,1,00411,India
133933,2024-02-01,505,oven,18490,24000,5510,1,00009,India
399572,2024-02-01,503,mixer,1349,3249,1900,1,00250,India
399572,2024-02-01,507,washing machine,6990,16490,9500,1,00250,India
574980,2024-02-01,501,iphone 15,60000,80000,20000,1,00130,India
574980,2024-02-01,504,iron,449,879,430,1,00130,India
574980,2024-02-01,506,monitor,3249,8000,4751,1,00130,India
577865,2024-02-01,506,monitor,3249,8000,4751,1,00404,India
577865,2024-02-01,507,washing machine,6990,16490,9500,1,00404,India
458058,2024-02-01,502,iphone 15 pro max,100000,135000,35000,1,00036,India
458058,2024-02-01,505,oven,18490,24000,5510,1,00036,India
458058,2024-02-01,501,iphone 15,60000,80000,20000,1,00036,India
458058,2024-02-01,503,mixer,1349,3249,1900,1,00036,India
931629,2024-02-01,507,washing machine,6990,16490,9500,1,00478,India
931629,2024-02-01,501,iphone 15,60000,80000,20000,1,00478,India
586901,2024-02-01,506,monitor,3249,8000,4751,1,00200,India
586901,2024-02-01,504,iron,449,879,430,1,00200,India
586901,2024-02-01,502,iphone 15 pro max,100000,135000,35000,1,00200,India
890641,2024-02-01,505,oven,18490,24000,5510,1,00287,India
890641,2024-02-01,504,iron,449,879,430,1,00287,India
890641,2024-02-01,506,monitor,3249,8000,4751,1,00287,India
899049,2024-02-01,501,iphone 15,60000,80000,20000,1,00386,India
268651,2024-02-01,504,iron,449,879,430,1,00164,India
339155,2024-02-01,503,mixer,1349,3249,1900,1,00129,India
136094,2024-02-01,504,iron,449,879,430,1,00436,India
136094,2024-02-01,503,mixer,1349,3249,1900,1,00436,India
113076,2024-02-01,506,monitor,3249,8000,4751,1,00269,India
113076,2024-02-01,502,iphone 15 pro max,100000,135000,35000,1,00269,India
113076,2024-02-01,507,washing machine,6990,16490,9500,1,00269,India
557003,2024-02-01,501,iphone 15,60000,80000,20000,1,00268,India
557003,2024-02-01,506,monitor,3249,8000,4751,1,00268,India
127760,2024-02-01,504,iron,449,879,430,1,00430,India
127760,2024-02-01,502,iphone 15 pro max,100000,135000,35000,1,00430,India
503443,2024-02-01,506,monitor,3249,8000,4751,1,00452,India
234933,2024-02-01,505,oven,18490,24000,5510,1,00367,India
234933,2024-02-01,506,monitor,3249,8000,4751,1,00367,India
234933,2024-02-01,502,iphone 15 pro max,100000,135000,35000,1,00367,India
938384,2024-02-01,505,oven,18490,24000,5510,1,00322,India
938384,2024-02-01,503,mixer,1349,3249,1900,1,00322,India
938384,2024-02-01,502,iphone 15 pro max,100000,135000,35000,1,00322,India
938384,2024-02-01,506,monitor,3249,8000,4751,1,00322,India
171861,2024-02-01,501,iphone 15,60000,80000,20000,1,00206,India
171861,2024-02-01,503,mixer,1349,3249,1900,1,00206,India
171861,2024-02-01,507,washing machine,6990,16490,9500,1,00206,India
171861,2024-02-01,502,iphone 15 pro max,100000,135000,35000,1,00206,India
871660,2024-02-01,501,iphone 15,60000,80000,20000,1,00395,India
871660,2024-02-01,506,monitor,3249,8000,4751,1,00395,India
871660,2024-02-01,502,iphone 15 pro max,100000,135000,35000,1,00395,India
247351,2024-02-01,507,washing machine,6990,16490,9500,1,00303,India
575707,2024-02-01,503,mixer,1349,3249,1900,1,00276,India
575707,2024-02-01,502,iphone 15 pro max,100000,135000,35000,1,00276,India
575707,2024-02-01,507,washing machine,6990,16490,9500,1,00276,India
720325,2024-02-01,505,oven,18490,24000,5510,1,00289,India
424697,2024-02-01,504,iron,449,879,430,1,00228,India
464864,2024-02-01,506,monitor,3249,8000,4751,1,00498,India
464864,2024-02-01,507,washing machine,6990,16490,9500,1,00498,India
220671,2024-02-01,507,washing machine,6990,16490,9500,1,00121,India
220671,2024-02-01,506,monitor,3249,8000,4751,1,00121,India
220671,2024-02-01,503,mixer,1349,3249,1900,1,00121,India
220671,2024-02-01,502,iphone 15 pro max,100000,135000,35000,1,00121,India
473894,2024-02-01,502,iphone 15 pro max,100000,135000,35000,1,00466,India
473894,2024-02-01,501,iphone 15,60000,80000,20000,1,00466,India
473894,2024-02-01,506,monitor,3249,8000,4751,1,00466,India
964024,2024-02-01,502,iphone 15 pro max,100000,135000,35000,1,00446,India
964024,2024-02-01,506,monitor,3249,8000,4751,1,00446,India
964024,2024-02-01,504,iron,449,879,430,1,00446,India
964024,2024-02-01,507,washing machine,6990,16490,9500,1,00446,India
160780,2024-02-01,502,iphone 15 pro max,100000,135000,35000,1,00423,India
160780,2024-02-01,505,oven,18490,24000,5510,1,00423,India
160780,2024-02-01,504,iron,449,879,430,1,00423,India
160780,2024-02-01,506,monitor,3249,8000,4751,1,00423,India
556085,2024-02-01,506,monitor,3249,8000,4751,1,00457,India
556085,2024-02-01,504,iron,449,879,430,1,00457,India
266100,2024-02-01,504,iron,449,879,430,1,00163,India
266100,2024-02-01,503,mixer,1349,3249,1900,1,00163,India
266100,2024-02-01,507,washing machine,6990,16490,9500,1,00163,India
266100,2024-02-01,506,monitor,3249,8000,4751,1,00163,India
894411,2024-02-01,503,mixer,1349,3249,1900,1,00302,India
894411,2024-02-01,504,iron,449,879,430,1,00302,India
894411,2024-02-01,507,washing machine,6990,16490,9500,1,00302,India
206483,2024-02-01,501,iphone 15,60000,80000,20000,1,00055,India
206483,2024-02-01,503,mixer,1349,3249,1900,1,00055,India
206483,2024-02-01,502,iphone 15 pro max,100000,135000,35000,1,00055,India
206483,2024-02-01,506,monitor,3249,8000,4751,1,00055,India
144525,2024-02-01,505,oven,18490,24000,5510,1,00359,India
495324,2024-02-01,506,monitor,3249,8000,4751,1,00114,India
495324,2024-02-01,503,mixer,1349,3249,1900,1,00114,India
495324,2024-02-01,501,iphone 15,60000,80000,20000,1,00114,India
495324,2024-02-01,505,oven,18490,24000,5510,1,00114,India
430069,2024-02-01,507,washing machine,6990,16490,9500,1,00455,India
211544,2024-02-01,506,monitor,3249,8000,4751,1,00252,India
321600,2024-02-02,506,monitor,3249,8000,4751,1,00354,India
498332,2024-02-02,502,iphone 15 pro max,100000,135000,35000,1,00317,India
498332,2024-02-02,507,washing machine,6990,16490,9500,1,00317,India
246570,2024-02-02,504,iron,449,879,430,1,00400,India
246570,2024-02-02,501,iphone 15,60000,80000,20000,1,00400,India
246570,2024-02-02,503,mixer,1349,3249,1900,1,00400,India
556619,2024-02-02,502,iphone 15 pro max,100000,135000,35000,1,00118,India
556619,2024-02-02,505,oven,18490,24000,5510,1,00118,India
556619,2024-02-02,507,washing machine,6990,16490,9500,1,00118,India
848205,2024-02-02,502,iphone 15 pro max,100000,135000,35000,1,00002,India
848205,2024-02-02,505,oven,18490,24000,5510,1,00002,India
848205,2024-02-02,504,iron,449,879,430,1,00002,India
910860,2024-02-02,501,iphone 15,60000,80000,20000,1,00447,India
910860,2024-02-02,506,monitor,3249,8000,4751,1,00447,India
910860,2024-02-02,502,iphone 15 pro max,100000,135000,35000,1,00447,India
527478,2024-02-02,504,iron,449,879,430,1,00233,India
527478,2024-02-02,507,washing machine,6990,16490,9500,1,00233,India
315897,2024-02-02,507,washing machine,6990,16490,9500,1,00159,India
315897,2024-02-02,505,oven,18490,24000,5510,1,00159,India
315897,2024-02-02,502,iphone 15 pro max,100000,135000,35000,1,00159,India
995742,2024-02-02,503,mixer,1349,3249,1900,1,00356,India
871636,2024-02-02,501,iphone 15,60000,80000,20000,1,00290,India
871636,2024-02-02,504,iron,449,879,430,1,00290,India
969630,2024-02-02,506,monitor,3249,8000,4751,1,00085,India
969630,2024-02-02,503,mixer,1349,3249,1900,1,00085,India
341207,2024-02-02,506,monitor,3249,8000,4751,1,00167,India
341207,2024-02-02,501,iphone 15,60000,80000,20000,1,00167,India
597964,2024-02-02,502,iphone 15 pro max,100000,135000,35000,1,00353,India
597964,2024-02-02,503,mixer,1349,3249,1900,1,00353,India
597964,2024-02-02,504,iron,449,879,430,1,00353,India
597964,2024-02-02,506,monitor,3249,8000,4751,1,00353,India
800169,2024-02-02,504,iron,449,879,430,1,00185,India
800169,2024-02-02,505,oven,18490,24000,5510,1,00185,India
670713,2024-02-02,502,iphone 15 pro max,100000,135000,35000,1,00203,India
259243,2024-02-02,501,iphone 15,60000,80000,20000,1,00344,India
259243,2024-02-02,504,iron,449,879,430,1,00344,India
259243,2024-02-02,507,washing machine,6990,16490,9500,1,00344,India
600270,2024-02-02,507,washing machine,6990,16490,9500,1,00318,India
131288,2024-02-02,507,washing machine,6990,16490,9500,1,00143,India
131288,2024-02-02,503,mixer,1349,3249,1900,1,00143,India
131288,2024-02-02,504,iron,449,879,430,1,00143,India
131288,2024-02-02,506,monitor,3249,8000,4751,1,00143,India
682123,2024-02-02,501,iphone 15,60000,80000,20000,1,00251,India
961981,2024-02-02,501,iphone 15,60000,80000,20000,1,00167,India
172103,2024-02-02,504,iron,449,879,430,1,00393,India
172103,2024-02-02,503,mixer,1349,3249,1900,1,00393,India
172103,2024-02-02,506,monitor,3249,8000,4751,1,00393,India
374120,2024-02-02,507,washing machine,6990,16490,9500,1,00488,India
374120,2024-02-02,501,iphone 15,60000,80000,20000,1,00488,India
374120,2024-02-02,504,iron,449,879,430,1,00488,India
374120,2024-02-02,502,iphone 15 pro max,100000,135000,35000,1,00488,India
861482,2024-02-02,507,washing machine,6990,16490,9500,1,00274,India
727619,2024-02-02,502,iphone 15 pro max,100000,135000,35000,1,00130,India
620170,2024-02-02,505,oven,18490,24000,5510,1,00055,India
620170,2024-02-02,504,iron,449,879,430,1,00055,India
371809,2024-02-02,505,oven,18490,24000,5510,1,00021,India
371809,2024-02-02,501,iphone 15,60000,80000,20000,1,00021,India
371809,2024-02-02,504,iron,449,879,430,1,00021,India
371809,2024-02-02,507,washing machine,6990,16490,9500,1,00021,India
994552,2024-02-02,503,mixer,1349,3249,1900,1,00448,India
367811,2024-02-02,504,iron,449,879,430,1,00070,India
367811,2024-02-02,505,oven,18490,24000,5510,1,00070,India
367811,2024-02-02,502,iphone 15 pro max,100000,135000,35000,1,00070,India
447423,2024-02-02,502,iphone 15 pro max,100000,135000,35000,1,00038,India
447423,2024-02-02,503,mixer,1349,3249,1900,1,00038,India
447423,2024-02-02,504,iron,449,879,430,1,00038,India
447423,2024-02-02,501,iphone 15,60000,80000,20000,1,00038,India
255298,2024-02-02,501,iphone 15,60000,80000,20000,1,00384,India
255298,2024-02-02,507,washing machine,6990,16490,9500,1,00384,India
255298,2024-02-02,506,monitor,3249,8000,4751,1,00384,India
255298,2024-02-02,504,iron,449,879,430,1,00384,India
787349,2024-02-02,504,iron,449,879,430,1,00154,India
787349,2024-02-02,502,iphone 15 pro max,100000,135000,35000,1,00154,India
209583,2024-02-02,506,monitor,3249,8000,4751,1,00372,India
900255,2024-02-02,505,oven,18490,24000,5510,1,00055,India
900255,2024-02-02,507,washing machine,6990,16490,9500,1,00055,India
900255,2024-02-02,502,iphone 15 pro max,100000,135000,35000,1,00055,India
900255,2024-02-02,504,iron,449,879,430,1,00055,India
541792,2024-02-02,506,monitor,3249,8000,4751,1,00178,India
541792,2024-02-02,505,oven,18490,24000,5510,1,00178,India
541792,2024-02-02,501,iphone 15,60000,80000,20000,1,00178,India
541792,2024-02-02,507,washing machine,6990,16490,9500,1,00178,India
422618,2024-02-02,507,washing machine,6990,16490,9500,1,00188,India
422618,2024-02-02,503,mixer,1349,3249,1900,1,00188,India
422618,2024-02-02,502,iphone 15 pro max,100000,135000,35000,1,00188,India
422618,2024-02-02,506,monitor,3249,8000,4751,1,00188,India
102053,2024-02-02,507,washing machine,6990,16490,9500,1,00272,India
102053,2024-02-02,503,mixer,1349,3249,1900,1,00272,India
102053,2024-02-02,506,monitor,3249,8000,4751,1,00272,India
671749,2024-02-02,507,washing machine,6990,16490,9500,1,00077,India
671749,2024-02-02,501,iphone 15,60000,80000,20000,1,00077,India
671749,2024-02-02,505,oven,18490,24000,5510,1,00077,India
671749,2024-02-02,504,iron,449,879,430,1,00077,India
289243,2024-02-02,506,monitor,3249,8000,4751,1,00258,India
289243,2024-02-02,501,iphone 15,60000,80000,20000,1,00258,India
289243,2024-02-02,507,washing machine,6990,16490,9500,1,00258,India
355555,2024-02-02,506,monitor,3249,8000,4751,1,00346,India
355555,2024-02-02,501,iphone 15,60000,80000,20000,1,00346,India
355555,2024-02-02,504,iron,449,879,430,1,00346,India
271590,2024-02-02,504,iron,449,879,430,1,00346,India
271590,2024-02-02,502,iphone 15 pro max,100000,135000,35000,1,00346,India
271590,2024-02-02,506,monitor,3249,8000,4751,1,00346,India
356236,2024-02-02,505,oven,18490,24000,5510,1,00247,India
356236,2024-02-02,504,iron,449,879,430,1,00247,India
356236,2024-02-02,501,iphone 15,60000,80000,20000,1,00247,India
812846,2024-02-02,506,monitor,3249,8000,4751,1,00181,India
812846,2024-02-02,503,mixer,1349,3249,1900,1,00181,India
812846,2024-02-02,504,iron,449,879,430,1,00181,India
915560,2024-02-02,503,mixer,1349,3249,1900,1,00051,India
915560,2024-02-02,506,monitor,3249,8000,4751,1,00051,India
915560,2024-02-02,504,iron,449,879,430,1,00051,India
915560,2024-02-02,501,iphone 15,60000,80000,20000,1,00051,India
504200,2024-02-02,501,iphone 15,60000,80000,20000,1,00035,India
504200,2024-02-02,504,iron,449,879,430,1,00035,India
370770,2024-02-02,501,iphone 15,60000,80000,20000,1,00062,India
982687,2024-02-02,507,washing machine,6990,16490,9500,1,00277,India
982687,2024-02-02,504,iron,449,879,430,1,00277,India
433829,2024-02-02,502,iphone 15 pro max,100000,135000,35000,1,00234,India
433829,2024-02-02,501,iphone 15,60000,80000,20000,1,00234,India
433829,2024-02-02,505,oven,18490,24000,5510,1,00234,India
340075,2024-02-02,502,iphone 15 pro max,100000,135000,35000,1,00115,India
340075,2024-02-02,503,mixer,1349,3249,1900,1,00115,India
340075,2024-02-02,501,iphone 15,60000,80000,20000,1,00115,India
340075,2024-02-02,507,washing machine,6990,16490,9500,1,00115,India
434869,2024-02-02,503,mixer,1349,3249,1900,1,00455,India
434869,2024-02-02,502,iphone 15 pro max,100000,135000,35000,1,00455,India
481680,2024-02-02,507,washing machine,6990,16490,9500,1,00178,India
481680,2024-02-02,506,monitor,3249,8000,4751,1,00178,India
536171,2024-02-02,504,iron,449,879,430,1,00017,India
536171,2024-02-02,502,iphone 15 pro max,100000,135000,35000,1,00017,India
536171,2024-02-02,507,washing machine,6990,16490,9500,1,00017,India
840501,2024-02-02,501,iphone 15,60000,80000,20000,1,00268,India
723469,2024-02-02,504,iron,449,879,430,1,00349,India
956691,2024-02-02,504,iron,449,879,430,1,00200,India
956691,2024-02-02,502,iphone 15 pro max,100000,135000,35000,1,00200,India
956691,2024-02-02,503,mixer,1349,3249,1900,1,00200,India
390823,2024-02-02,504,iron,449,879,430,1,00461,India
390823,2024-02-02,503,mixer,1349,3249,1900,1,00461,India
390823,2024-02-02,505,oven,18490,24000,5510,1,00461,India
143743,2024-02-02,503,mixer,1349,3249,1900,1,00108,India
918656,2024-02-02,506,monitor,3249,8000,4751,1,00152,India
451243,2024-02-02,506,monitor,3249,8000,4751,1,00234,India
451243,2024-02-02,505,oven,18490,24000,5510,1,00234,India
451243,2024-02-02,507,washing machine,6990,16490,9500,1,00234,India
169639,2024-02-03,503,mixer,1349,3249,1900,1,00086,India
169639,2024-02-03,502,iphone 15 pro max,100000,135000,35000,1,00086,India
169639,2024-02-03,504,iron,449,879,430,1,00086,India
594562,2024-02-03,507,washing machine,6990,16490,9500,1,00144,India
594562,2024-02-03,502,iphone 15 pro max,100000,135000,35000,1,00144,India
254233,2024-02-03,504,iron,449,879,430,1,00036,India
665020,2024-02-03,501,iphone 15,60000,80000,20000,1,00051,India
238635,2024-02-03,506,monitor,3249,8000,4751,1,00039,India
445162,2024-02-03,502,iphone 15 pro max,100000,135000,35000,1,00266,India
975251,2024-02-03,501,iphone 15,60000,80000,20000,1,00484,India
975251,2024-02-03,502,iphone 15 pro max,100000,135000,35000,1,00484,India
637665,2024-02-03,507,washing machine,6990,16490,9500,1,00175,India
637665,2024-02-03,503,mixer,1349,3249,1900,1,00175,India
696468,2024-02-03,501,iphone 15,60000,80000,20000,1,00322,India
696468,2024-02-03,505,oven,18490,24000,5510,1,00322,India
696468,2024-02-03,507,washing machine,6990,16490,9500,1,00322,India
696468,2024-02-03,503,mixer,1349,3249,1900,1,00322,India
696468,2024-02-03,502,iphone 15 pro max,100000,135000,35000,1,00322,India
378531,2024-02-03,502,iphone 15 pro max,100000,135000,35000,1,00015,India
948641,2024-02-03,501,iphone 15,60000,80000,20000,1,00099,India
995559,2024-02-03,502,iphone 15 pro max,100000,135000,35000,1,00079,India
995559,2024-02-03,505,oven,18490,24000,5510,1,00079,India
995559,2024-02-03,503,mixer,1349,3249,1900,1,00079,India
490326,2024-02-03,501,iphone 15,60000,80000,20000,1,00496,India
490326,2024-02-03,506,monitor,3249,8000,4751,1,00496,India
490326,2024-02-03,504,iron,449,879,430,1,00496,India
835434,2024-02-03,503,mixer,1349,3249,1900,1,00130,India
891845,2024-02-03,507,washing machine,6990,16490,9500,1,00145,India
891845,2024-02-03,503,mixer,1349,3249,1900,1,00145,India
891845,2024-02-03,504,iron,449,879,430,1,00145,India
641391,2024-02-03,504,iron,449,879,430,1,00058,India
829584,2024-02-03,506,monitor,3249,8000,4751,1,00223,India
829584,2024-02-03,507,washing machine,6990,16490,9500,1,00223,India
687627,2024-02-03,503,mixer,1349,3249,1900,1,00157,India
687627,2024-02-03,504,iron,449,879,430,1,00157,India
687627,2024-02-03,506,monitor,3249,8000,4751,1,00157,India
834628,2024-02-03,505,oven,18490,24000,5510,1,00188,India
834628,2024-02-03,501,iphone 15,60000,80000,20000,1,00188,India
834628,2024-02-03,504,iron,449,879,430,1,00188,India
834628,2024-02-03,503,mixer,1349,3249,1900,1,00188,India
498863,2024-02-03,507,washing machine,6990,16490,9500,1,00170,India
498863,2024-02-03,502,iphone 15 pro max,100000,135000,35000,1,00170,India
498863,2024-02-03,503,mixer,1349,3249,1900,1,00170,India
974487,2024-02-03,501,iphone 15,60000,80000,20000,1,00278,India
974487,2024-02-03,507,washing machine,6990,16490,9500,1,00278,India
974487,2024-02-03,505,oven,18490,24000,5510,1,00278,India
974487,2024-02-03,503,mixer,1349,3249,1900,1,00278,India
284003,2024-02-03,507,washing machine,6990,16490,9500,1,00313,India
284003,2024-02-03,502,iphone 15 pro max,100000,135000,35000,1,00313,India
605785,2024-02-03,505,oven,18490,24000,5510,1,00014,India
605785,2024-02-03,503,mixer,1349,3249,1900,1,00014,India
605785,2024-02-03,506,monitor,3249,8000,4751,1,00014,India
804052,2024-02-03,503,mixer,1349,3249,1900,1,00185,India
804052,2024-02-03,505,oven,18490,24000,5510,1,00185,India
804052,2024-02-03,506,monitor,3249,8000,4751,1,00185,India
155157,2024-02-03,501,iphone 15,60000,80000,20000,1,00229,India
377827,2024-02-03,504,iron,449,879,430,1,00447,India
596663,2024-02-03,502,iphone 15 pro max,100000,135000,35000,1,00214,India
596663,2024-02-03,504,iron,449,879,430,1,00214,India
596663,2024-02-03,505,oven,18490,24000,5510,1,00214,India
596663,2024-02-03,503,mixer,1349,3249,1900,1,00214,India
278277,2024-02-03,502,iphone 15 pro max,100000,135000,35000,1,00031,India
278277,2024-02-03,501,iphone 15,60000,80000,20000,1,00031,India
278277,2024-02-03,506,monitor,3249,8000,4751,1,00031,India
278277,2024-02-03,503,mixer,1349,3249,1900,1,00031,India
207697,2024-02-03,503,mixer,1349,3249,1900,1,00065,India
591543,2024-02-03,503,mixer,1349,3249,1900,1,00342,India
591543,2024-02-03,505,oven,18490,24000,5510,1,00342,India
591543,2024-02-03,504,iron,449,879,430,1,00342,India
591543,2024-02-03,502,iphone 15 pro max,100000,135000,35000,1,00342,India
753333,2024-02-03,501,iphone 15,60000,80000,20000,1,00310,India
610648,2024-02-03,505,oven,18490,24000,5510,1,00035,India
610648,2024-02-03,503,mixer,1349,3249,1900,1,00035,India
610648,2024-02-03,507,washing machine,6990,16490,9500,1,00035,India
610648,2024-02-03,501,iphone 15,60000,80000,20000,1,00035,India
517012,2024-02-03,505,oven,18490,24000,5510,1,00121,India
517012,2024-02-03,506,monitor,3249,8000,4751,1,00121,India
517012,2024-02-03,503,mixer,1349,3249,1900,1,00121,India
214479,2024-02-03,501,iphone 15,60000,80000,20000,1,00312,India
214479,2024-02-03,505,oven,18490,24000,5510,1,00312,India
214479,2024-02-03,507,washing machine,6990,16490,9500,1,00312,India
723239,2024-02-03,507,washing machine,6990,16490,9500,1,00146,India
723239,2024-02-03,506,monitor,3249,8000,4751,1,00146,India
723239,2024-02-03,502,iphone 15 pro max,100000,135000,35000,1,00146,India
723239,2024-02-03,501,iphone 15,60000,80000,20000,1,00146,India
660123,2024-02-03,504,iron,449,879,430,1,00429,India
660123,2024-02-03,505,oven,18490,24000,5510,1,00429,India
497368,2024-02-03,504,iron,449,879,430,1,00404,India
302710,2024-02-03,507,washing machine,6990,16490,9500,1,00202,India
302710,2024-02-03,501,iphone 15,60000,80000,20000,1,00202,India
174219,2024-02-03,503,mixer,1349,3249,1900,1,00019,India
142771,2024-02-03,502,iphone 15 pro max,100000,135000,35000,1,00079,India
142771,2024-02-03,507,washing machine,6990,16490,9500,1,00079,India
742314,2024-02-03,504,iron,449,879,430,1,00186,India
742314,2024-02-03,505,oven,18490,24000,5510,1,00186,India
742314,2024-02-03,503,mixer,1349,3249,1900,1,00186,India
402627,2024-02-03,504,iron,449,879,430,1,00472,India
402627,2024-02-03,506,monitor,3249,8000,4751,1,00472,India
968335,2024-02-03,504,iron,449,879,430,1,00183,India
968335,2024-02-03,501,iphone 15,60000,80000,20000,1,00183,India
968335,2024-02-03,505,oven,18490,24000,5510,1,00183,India
968335,2024-02-03,507,washing machine,6990,16490,9500,1,00183,India
159009,2024-02-03,507,washing machine,6990,16490,9500,1,00140,India
159009,2024-02-03,502,iphone 15 pro max,100000,135000,35000,1,00140,India
604330,2024-02-03,505,oven,18490,24000,5510,1,00257,India
604330,2024-02-03,504,iron,449,879,430,1,00257,India
871991,2024-02-03,502,iphone 15 pro max,100000,135000,35000,1,00485,India
871991,2024-02-03,506,monitor,3249,8000,4751,1,00485,India
871991,2024-02-03,501,iphone 15,60000,80000,20000,1,00485,India
607455,2024-02-03,506,monitor,3249,8000,4751,1,00236,India
607455,2024-02-03,505,oven,18490,24000,5510,1,00236,India
607455,2024-02-03,504,iron,449,879,430,1,00236,India
614549,2024-02-03,507,washing machine,6990,16490,9500,1,00337,India
614549,2024-02-03,505,oven,18490,24000,5510,1,00337,India
273894,2024-02-03,501,iphone 15,60000,80000,20000,1,00188,India
273894,2024-02-03,506,monitor,3249,8000,4751,1,00188,India
273894,2024-02-03,502,iphone 15 pro max,100000,135000,35000,1,00188,India
273894,2024-02-03,504,iron,449,879,430,1,00188,India
273894,2024-02-03,503,mixer,1349,3249,1900,1,00188,India
273966,2024-02-03,501,iphone 15,60000,80000,20000,1,00272,India
273966,2024-02-03,507,washing machine,6990,16490,9500,1,00272,India
273966,2024-02-03,503,mixer,1349,3249,1900,1,00272,India
654491,2024-02-03,506,monitor,3249,8000,4751,1,00094,India
751223,2024-02-03,506,monitor,3249,8000,4751,1,00214,India
751223,2024-02-03,505,oven,18490,24000,5510,1,00214,India
751223,2024-02-03,504,iron,449,879,430,1,00214,India
945705,2024-02-03,501,iphone 15,60000,80000,20000,1,00070,India
945705,2024-02-03,507,washing machine,6990,16490,9500,1,00070,India
945705,2024-02-03,506,monitor,3249,8000,4751,1,00070,India
945705,2024-02-03,503,mixer,1349,3249,1900,1,00070,India
793917,2024-02-03,505,oven,18490,24000,5510,1,00175,India
793917,2024-02-03,506,monitor,3249,8000,4751,1,00175,India
793917,2024-02-03,503,mixer,1349,3249,1900,1,00175,India
671176,2024-02-04,504,iron,449,879,430,1,00226,India
165553,2024-02-04,504,iron,449,879,430,1,00262,India
165553,2024-02-04,505,oven,18490,24000,5510,1,00262,India
165553,2024-02-04,503,mixer,1349,3249,1900,1,00262,India
165553,2024-02-04,506,monitor,3249,8000,4751,1,00262,India
165553,2024-02-04,501,iphone 15,60000,80000,20000,1,00262,India
503066,2024-02-04,501,iphone 15,60000,80000,20000,1,00369,India
503066,2024-02-04,502,iphone 15 pro max,100000,135000,35000,1,00369,India
989150,2024-02-04,507,washing machine,6990,16490,9500,1,00357,India
348416,2024-02-04,505,oven,18490,24000,5510,1,00075,India
348416,2024-02-04,501,iphone 15,60000,80000,20000,1,00075,India
348416,2024-02-04,504,iron,449,879,430,1,00075,India
529168,2024-02-04,507,washing machine,6990,16490,9500,1,00144,India
655015,2024-02-04,506,monitor,3249,8000,4751,1,00033,India
655015,2024-02-04,504,iron,449,879,430,1,00033,India
456165,2024-02-04,502,iphone 15 pro max,100000,135000,35000,1,00384,India
456165,2024-02-04,505,oven,18490,24000,5510,1,00384,India
520677,2024-02-04,506,monitor,3249,8000,4751,1,00163,India
520677,2024-02-04,503,mixer,1349,3249,1900,1,00163,India
520677,2024-02-04,505,oven,18490,24000,5510,1,00163,India
520677,2024-02-04,501,iphone 15,60000,80000,20000,1,00163,India
167610,2024-02-04,503,mixer,1349,3249,1900,1,00240,India
382685,2024-02-04,501,iphone 15,60000,80000,20000,1,00386,India
382685,2024-02-04,505,oven,18490,24000,5510,1,00386,India
382685,2024-02-04,506,monitor,3249,8000,4751,1,00386,India
830959,2024-02-04,502,iphone 15 pro max,100000,135000,35000,1,00286,India
830959,2024-02-04,506,monitor,3249,8000,4751,1,00286,India
926878,2024-02-04,507,washing machine,6990,16490,9500,1,00151,India
926878,2024-02-04,505,oven,18490,24000,5510,1,00151,India
926878,2024-02-04,504,iron,449,879,430,1,00151,India
926878,2024-02-04,506,monitor,3249,8000,4751,1,00151,India
882789,2024-02-04,505,oven,18490,24000,5510,1,00234,India
882789,2024-02-04,506,monitor,3249,8000,4751,1,00234,India
882789,2024-02-04,502,iphone 15 pro max,100000,135000,35000,1,00234,India
882789,2024-02-04,503,mixer,1349,3249,1900,1,00234,India
882789,2024-02-04,504,iron,449,879,430,1,00234,India
157648,2024-02-04,506,monitor,3249,8000,4751,1,00341,India
157648,2024-02-04,504,iron,449,879,430,1,00341,India
138813,2024-02-04,505,oven,18490,24000,5510,1,00449,India
138813,2024-02-04,507,washing machine,6990,16490,9500,1,00449,India
907081,2024-02-04,503,mixer,1349,3249,1900,1,00230,India
357115,2024-02-04,505,oven,18490,24000,5510,1,00295,India
357115,2024-02-04,506,monitor,3249,8000,4751,1,00295,India
331679,2024-02-04,507,washing machine,6990,16490,9500,1,00025,India
634137,2024-02-04,505,oven,18490,24000,5510,1,00038,India
144070,2024-02-04,507,washing machine,6990,16490,9500,1,00144,India
573169,2024-02-04,506,monitor,3249,8000,4751,1,00079,India
573169,2024-02-04,507,washing machine,6990,16490,9500,1,00079,India
322133,2024-02-04,507,washing machine,6990,16490,9500,1,00306,India
322133,2024-02-04,505,oven,18490,24000,5510,1,00306,India
322133,2024-02-04,503,mixer,1349,3249,1900,1,00306,India
322133,2024-02-04,506,monitor,3249,8000,4751,1,00306,India
601929,2024-02-04,505,oven,18490,24000,5510,1,00117,India
121702,2024-02-04,507,washing machine,6990,16490,9500,1,00309,India
121702,2024-02-04,503,mixer,1349,3249,1900,1,00309,India
121702,2024-02-04,505,oven,18490,24000,5510,1,00309,India
601787,2024-02-04,505,oven,18490,24000,5510,1,00496,India
601787,2024-02-04,507,washing machine,6990,16490,9500,1,00496,India
601787,2024-02-04,503,mixer,1349,3249,1900,1,00496,India
622495,2024-02-04,503,mixer,1349,3249,1900,1,00295,India
113394,2024-02-04,502,iphone 15 pro max,100000,135000,35000,1,00059,India
113394,2024-02-04,504,iron,449,879,430,1,00059,India
113394,2024-02-04,506,monitor,3249,8000,4751,1,00059,India
719799,2024-02-04,501,iphone 15,60000,80000,20000,1,00155,India
719799,2024-02-04,505,oven,18490,24000,5510,1,00155,India
719799,2024-02-04,506,monitor,3249,8000,4751,1,00155,India
111222,2024-02-04,503,mixer,1349,3249,1900,1,00480,India
111222,2024-02-04,507,washing machine,6990,16490,9500,1,00480,India
111222,2024-02-04,506,monitor,3249,8000,4751,1,00480,India
961445,2024-02-04,506,monitor,3249,8000,4751,1,00025,India
802256,2024-02-04,504,iron,449,879,430,1,00339,India
802256,2024-02-04,506,monitor,3249,8000,4751,1,00339,India
802256,2024-02-04,507,washing machine,6990,16490,9500,1,00339,India
698457,2024-02-04,502,iphone 15 pro max,100000,135000,35000,1,00252,India
698457,2024-02-04,506,monitor,3249,8000,4751,1,00252,India
977203,2024-02-04,504,iron,449,879,430,1,00219,India
977203,2024-02-04,505,oven,18490,24000,5510,1,00219,India
898673,2024-02-04,504,iron,449,879,430,1,00206,India
898673,2024-02-04,505,oven,18490,24000,5510,1,00206,India
898673,2024-02-04,507,washing machine,6990,16490,9500,1,00206,India
898673,2024-02-04,501,iphone 15,60000,80000,20000,1,00206,India
839777,2024-02-04,502,iphone 15 pro max,100000,135000,35000,1,00296,India
839777,2024-02-04,505,oven,18490,24000,5510,1,00296,India
839777,2024-02-04,501,iphone 15,60000,80000,20000,1,00296,India
590081,2024-02-04,503,mixer,1349,3249,1900,1,00384,India
590081,2024-02-04,507,washing machine,6990,16490,9500,1,00384,India
180235,2024-02-04,504,iron,449,879,430,1,00148,India
180235,2024-02-04,502,iphone 15 pro max,100000,135000,35000,1,00148,India
180235,2024-02-04,506,monitor,3249,8000,4751,1,00148,India
967461,2024-02-04,504,iron,449,879,430,1,00270,India
967461,2024-02-04,506,monitor,3249,8000,4751,1,00270,India
217696,2024-02-04,505,oven,18490,24000,5510,1,00445,India
217696,2024-02-04,501,iphone 15,60000,80000,20000,1,00445,India
487256,2024-02-04,502,iphone 15 pro max,100000,135000,35000,1,00063,India
487256,2024-02-04,503,mixer,1349,3249,1900,1,00063,India
487256,2024-02-04,506,monitor,3249,8000,4751,1,00063,India
937976,2024-02-04,501,iphone 15,60000,80000,20000,1,00058,India
937976,2024-02-04,506,monitor,3249,8000,4751,1,00058,India
937976,2024-02-04,504,iron,449,879,430,1,00058,India
937976,2024-02-04,505,oven,18490,24000,5510,1,00058,India
864750,2024-02-04,504,iron,449,879,430,1,00356,India
864750,2024-02-04,503,mixer,1349,3249,1900,1,00356,India
727149,2024-02-04,505,oven,18490,24000,5510,1,00136,India
727149,2024-02-04,503,mixer,1349,3249,1900,1,00136,India
163570,2024-02-04,506,monitor,3249,8000,4751,1,00415,India
163570,2024-02-04,504,iron,449,879,430,1,00415,India
683273,2024-02-04,503,mixer,1349,3249,1900,1,00221,India
683273,2024-02-04,504,iron,449,879,430,1,00221,India
686676,2024-02-04,507,washing machine,6990,16490,9500,1,00381,India
686676,2024-02-04,504,iron,449,879,430,1,00381,India
686676,2024-02-04,506,monitor,3249,8000,4751,1,00381,India
686676,2024-02-04,505,oven,18490,24000,5510,1,00381,India
184150,2024-02-04,507,washing machine,6990,16490,9500,1,00135,India
184150,2024-02-04,502,iphone 15 pro max,100000,135000,35000,1,00135,India
184150,2024-02-04,506,monitor,3249,8000,4751,1,00135,India
785597,2024-02-04,506,monitor,3249,8000,4751,1,00224,India
785597,2024-02-04,505,oven,18490,24000,5510,1,00224,India
219014,2024-02-04,505,oven,18490,24000,5510,1,00145,India
558041,2024-02-04,505,oven,18490,24000,5510,1,00386,India
558041,2024-02-04,507,washing machine,6990,16490,9500,1,00386,India
558041,2024-02-04,501,iphone 15,60000,80000,20000,1,00386,India
872210,2024-02-04,502,iphone 15 pro max,100000,135000,35000,1,00328,India
331816,2024-02-04,502,iphone 15 pro max,100000,135000,35000,1,00268,India
331816,2024-02-04,504,iron,449,879,430,1,00268,India
459060,2024-02-04,506,monitor,3249,8000,4751,1,00182,India
459060,2024-02-04,504,iron,449,879,430,1,00182,India
459060,2024-02-04,502,iphone 15 pro max,100000,135000,35000,1,00182,India
459060,2024-02-04,507,washing machine,6990,16490,9500,1,00182,India
171804,2024-02-04,504,iron,449,879,430,1,00259,India
171804,2024-02-04,501,iphone 15,60000,80000,20000,1,00259,India
171804,2024-02-04,506,monitor,3249,8000,4751,1,00259,India
171804,2024-02-04,503,mixer,1349,3249,1900,1,00259,India
424011,2024-02-05,505,oven,18490,24000,5510,1,00182,India
424011,2024-02-05,507,washing machine,6990,16490,9500,1,00182,India
424011,2024-02-05,506,monitor,3249,8000,4751,1,00182,India
424011,2024-02-05,501,iphone 15,60000,80000,20000,1,00182,India
410018,2024-02-05,501,iphone 15,60000,80000,20000,1,00422,India
410018,2024-02-05,507,washing machine,6990,16490,9500,1,00422,India
410018,2024-02-05,505,oven,18490,24000,5510,1,00422,India
171221,2024-02-05,506,monitor,3249,8000,4751,1,00087,India
171221,2024-02-05,503,mixer,1349,3249,1900,1,00087,India
324367,2024-02-05,506,monitor,3249,8000,4751,1,00419,India
801490,2024-02-05,507,washing machine,6990,16490,9500,1,00370,India
801490,2024-02-05,501,iphone 15,60000,80000,20000,1,00370,India
801490,2024-02-05,505,oven,18490,24000,5510,1,00370,India
801490,2024-02-05,502,iphone 15 pro max,100000,135000,35000,1,00370,India
664831,2024-02-05,502,iphone 15 pro max,100000,135000,35000,1,00198,India
664831,2024-02-05,503,mixer,1349,3249,1900,1,00198,India
432787,2024-02-05,501,iphone 15,60000,80000,20000,1,00213,India
432787,2024-02-05,507,washing machine,6990,16490,9500,1,00213,India
263178,2024-02-05,504,iron,449,879,430,1,00043,India
263178,2024-02-05,506,monitor,3249,8000,4751,1,00043,India
263178,2024-02-05,505,oven,18490,24000,5510,1,00043,India
411597,2024-02-05,502,iphone 15 pro max,100000,135000,35000,1,00189,India
140308,2024-02-05,506,monitor,3249,8000,4751,1,00452,India
140308,2024-02-05,501,iphone 15,60000,80000,20000,1,00452,India
140308,2024-02-05,504,iron,449,879,430,1,00452,India
140308,2024-02-05,507,washing machine,6990,16490,9500,1,00452,India
439991,2024-02-05,506,monitor,3249,8000,4751,1,00241,India
439991,2024-02-05,504,iron,449,879,430,1,00241,India
439991,2024-02-05,507,washing machine,6990,16490,9500,1,00241,India
759756,2024-02-05,506,monitor,3249,8000,4751,1,00323,India
937753,2024-02-05,503,mixer,1349,3249,1900,1,00294,India
937753,2024-02-05,507,washing machine,6990,16490,9500,1,00294,India
327650,2024-02-05,504,iron,449,879,430,1,00144,India
327650,2024-02-05,501,iphone 15,60000,80000,20000,1,00144,India
327650,2024-02-05,503,mixer,1349,3249,1900,1,00144,India
180994,2024-02-05,503,mixer,1349,3249,1900,1,00435,India
180994,2024-02-05,504,iron,449,879,430,1,00435,India
180994,2024-02-05,502,iphone 15 pro max,100000,135000,35000,1,00435,India
790855,2024-02-05,502,iphone 15 pro max,100000,135000,35000,1,00370,India
790855,2024-02-05,503,mixer,1349,3249,1900,1,00370,India
790855,2024-02-05,504,iron,449,879,430,1,00370,India
662441,2024-02-05,507,washing machine,6990,16490,9500,1,00187,India
285518,2024-02-05,505,oven,18490,24000,5510,1,00443,India
283689,2024-02-05,507,washing machine,6990,16490,9500,1,00075,India
283689,2024-02-05,503,mixer,1349,3249,1900,1,00075,India
283689,2024-02-05,501,iphone 15,60000,80000,20000,1,00075,India
468246,2024-02-05,507,washing machine,6990,16490,9500,1,00088,India
468246,2024-02-05,501,iphone 15,60000,80000,20000,1,00088,India
468246,2024-02-05,502,iphone 15 pro max,100000,135000,35000,1,00088,India
372808,2024-02-05,502,iphone 15 pro max,100000,135000,35000,1,00108,India
611096,2024-02-05,505,oven,18490,24000,5510,1,00483,India
611096,2024-02-05,503,mixer,1349,3249,1900,1,00483,India
918080,2024-02-05,505,oven,18490,24000,5510,1,00157,India
126238,2024-02-05,505,oven,18490,24000,5510,1,00495,India
126238,2024-02-05,501,iphone 15,60000,80000,20000,1,00495,India
126238,2024-02-05,506,monitor,3249,8000,4751,1,00495,India
126238,2024-02-05,503,mixer,1349,3249,1900,1,00495,India
126238,2024-02-05,507,washing machine,6990,16490,9500,1,00495,India
812614,2024-02-05,502,iphone 15 pro max,100000,135000,35000,1,00050,India
812614,2024-02-05,506,monitor,3249,8000,4751,1,00050,India
812614,2024-02-05,507,washing machine,6990,16490,9500,1,00050,India
111170,2024-02-05,503,mixer,1349,3249,1900,1,00197,India
847208,2024-02-05,505,oven,18490,24000,5510,1,00332,India
847208,2024-02-05,507,washing machine,6990,16490,9500,1,00332,India
534755,2024-02-05,507,washing machine,6990,16490,9500,1,00478,India
680164,2024-02-05,505,oven,18490,24000,5510,1,00026,India
701063,2024-02-05,507,washing machine,6990,16490,9500,1,00248,India
701063,2024-02-05,506,monitor,3249,8000,4751,1,00248,India
701063,2024-02-05,501,iphone 15,60000,80000,20000,1,00248,India
701063,2024-02-05,503,mixer,1349,3249,1900,1,00248,India
690030,2024-02-05,501,iphone 15,60000,80000,20000,1,00499,India
690030,2024-02-05,504,iron,449,879,430,1,00499,India
471302,2024-02-05,501,iphone 15,60000,80000,20000,1,00326,India
471302,2024-02-05,507,washing machine,6990,16490,9500,1,00326,India
471302,2024-02-05,502,iphone 15 pro max,100000,135000,35000,1,00326,India
471302,2024-02-05,506,monitor,3249,8000,4751,1,00326,India
363960,2024-02-05,502,iphone 15 pro max,100000,135000,35000,1,00009,India
363960,2024-02-05,504,iron,449,879,430,1,00009,India
363960,2024-02-05,503,mixer,1349,3249,1900,1,00009,India
363960,2024-02-05,505,oven,18490,24000,5510,1,00009,India
482108,2024-02-05,505,oven,18490,24000,5510,1,00333,India
714857,2024-02-05,506,monitor,3249,8000,4751,1,00412,India
714857,2024-02-05,507,washing machine,6990,16490,9500,1,00412,India
714857,2024-02-05,504,iron,449,879,430,1,00412,India
714857,2024-02-05,505,oven,18490,24000,5510,1,00412,India
447936,2024-02-05,504,iron,449,879,430,1,00132,India
193316,2024-02-05,503,mixer,1349,3249,1900,1,00497,India
193316,2024-02-05,507,washing machine,6990,16490,9500,1,00497,India
193316,2024-02-05,505,oven,18490,24000,5510,1,00497,India
193316,2024-02-05,506,monitor,3249,8000,4751,1,00497,India
684527,2024-02-05,504,iron,449,879,430,1,00202,India
684527,2024-02-05,502,iphone 15 pro max,100000,135000,35000,1,00202,India
684527,2024-02-05,505,oven,18490,24000,5510,1,00202,India
684527,2024-02-05,507,washing machine,6990,16490,9500,1,00202,India
144991,2024-02-05,505,oven,18490,24000,5510,1,00468,India
144991,2024-02-05,502,iphone 15 pro max,100000,135000,35000,1,00468,India
344421,2024-02-05,506,monitor,3249,8000,4751,1,00027,India
344421,2024-02-05,502,iphone 15 pro max,100000,135000,35000,1,00027,India
643125,2024-02-05,501,iphone 15,60000,80000,20000,1,00240,India
643125,2024-02-05,504,iron,449,879,430,1,00240,India
643125,2024-02-05,502,iphone 15 pro max,100000,135000,35000,1,00240,India
786318,2024-02-05,501,iphone 15,60000,80000,20000,1,00189,India
786318,2024-02-05,507,washing machine,6990,16490,9500,1,00189,India
786318,2024-02-05,502,iphone 15 pro max,100000,135000,35000,1,00189,India
786318,2024-02-05,503,mixer,1349,3249,1900,1,00189,India
786318,2024-02-05,504,iron,449,879,430,1,00189,India
141306,2024-02-05,507,washing machine,6990,16490,9500,1,00486,India
141306,2024-02-05,505,oven,18490,24000,5510,1,00486,India
141306,2024-02-05,502,iphone 15 pro max,100000,135000,35000,1,00486,India
141306,2024-02-05,501,iphone 15,60000,80000,20000,1,00486,India
141306,2024-02-05,504,iron,449,879,430,1,00486,India
703174,2024-02-05,505,oven,18490,24000,5510,1,00112,India
703174,2024-02-05,507,washing machine,6990,16490,9500,1,00112,India
703174,2024-02-05,506,monitor,3249,8000,4751,1,00112,India
887186,2024-02-05,501,iphone 15,60000,80000,20000,1,00224,India
887186,2024-02-05,502,iphone 15 pro max,100000,135000,35000,1,00224,India
594441,2024-02-05,501,iphone 15,60000,80000,20000,1,00372,India
701731,2024-02-05,505,oven,18490,24000,5510,1,00049,India
701731,2024-02-05,502,iphone 15 pro max,100000,135000,35000,1,00049,India
701731,2024-02-05,504,iron,449,879,430,1,00049,India
172215,2024-02-05,501,iphone 15,60000,80000,20000,1,00064,India
172215,2024-02-05,507,washing machine,6990,16490,9500,1,00064,India
172215,2024-02-05,503,mixer,1349,3249,1900,1,00064,India
172215,2024-02-05,504,iron,449,879,430,1,00064,India
439289,2024-02-05,505,oven,18490,24000,5510,1,00254,India
311180,2024-02-05,501,iphone 15,60000,80000,20000,1,00408,India
311180,2024-02-05,507,washing machine,6990,16490,9500,1,00408,India
830455,2024-02-05,502,iphone 15 pro max,100000,135000,35000,1,00015,India
271541,2024-02-05,507,washing machine,6990,16490,9500,1,00334,India
536871,2024-02-05,505,oven,18490,24000,5510,1,00433,India
536871,2024-02-05,506,monitor,3249,8000,4751,1,00433,India
157217,2024-02-05,506,monitor,3249,8000,4751,1,00352,India
157217,2024-02-05,502,iphone 15 pro max,100000,135000,35000,1,00352,India
747020,2024-02-05,502,iphone 15 pro max,100000,135000,35000,1,00225,India
747020,2024-02-05,504,iron,449,879,430,1,00225,India
747020,2024-02-05,501,iphone 15,60000,80000,20000,1,00225,India
807349,2024-02-05,507,washing machine,6990,16490,9500,1,00102,India
199991,2024-02-05,503,mixer,1349,3249,1900,1,00354,India
199991,2024-02-05,504,iron,449,879,430,1,00354,India
224900,2024-02-05,505,oven,18490,24000,5510,1,00311,India
224900,2024-02-05,507,washing machine,6990,16490,9500,1,00311,India
224900,2024-02-05,506,monitor,3249,8000,4751,1,00311,India
224900,2024-02-05,504,iron,449,879,430,1,00311,India
314565,2024-02-05,503,mixer,1349,3249,1900,1,00457,India
384668,2024-02-05,507,washing machine,6990,16490,9500,1,00457,India
384668,2024-02-05,502,iphone 15 pro max,100000,135000,35000,1,00457,India
384668,2024-02-05,503,mixer,1349,3249,1900,1,00457,India
917046,2024-02-05,507,washing machine,6990,16490,9500,1,00187,India
917046,2024-02-05,504,iron,449,879,430,1,00187,India
917046,2024-02-05,503,mixer,1349,3249,1900,1,00187,India
277773,2024-02-05,506,monitor,3249,8000,4751,1,00442,India
962025,2024-02-05,505,oven,18490,24000,5510,1,00125,India
962025,2024-02-05,503,mixer,1349,3249,1900,1,00125,India
962025,2024-02-05,506,monitor,3249,8000,4751,1,00125,India
810596,2024-02-05,501,iphone 15,60000,80000,20000,1,00013,India
810596,2024-02-05,503,mixer,1349,3249,1900,1,00013,India
849258,2024-02-05,506,monitor,3249,8000,4751,1,00074,India
849258,2024-02-05,502,iphone 15 pro max,100000,135000,35000,1,00074,India
849258,2024-02-05,505,oven,18490,24000,5510,1,00074,India
849258,2024-02-05,503,mixer,1349,3249,1900,1,00074,India
601188,2024-02-05,503,mixer,1349,3249,1900,1,00116,India
601188,2024-02-05,502,iphone 15 pro max,100000,135000,35000,1,00116,India
505478,2024-02-05,507,washing machine,6990,16490,9500,1,00286,India
505478,2024-02-05,505,oven,18490,24000,5510,1,00286,India
116086,2024-02-05,505,oven,18490,24000,5510,1,00353,India
116086,2024-02-05,501,iphone 15,60000,80000,20000,1,00353,India
116086,2024-02-05,506,monitor,3249,8000,4751,1,00353,India
116086,2024-02-05,504,iron,449,879,430,1,00353,India
893130,2024-02-05,506,monitor,3249,8000,4751,1,00217,India
697605,2024-02-05,502,iphone 15 pro max,100000,135000,35000,1,00178,India
697605,2024-02-05,504,iron,449,879,430,1,00178,India
983745,2024-02-05,501,iphone 15,60000,80000,20000,1,00010,India
595541,2024-02-05,501,iphone 15,60000,80000,20000,1,00249,India
402015,2024-02-05,501,iphone 15,60000,80000,20000,1,00368,India
402015,2024-02-05,507,washing machine,6990,16490,9500,1,00368,India
534488,2024-02-05,503,mixer,1349,3249,1900,1,00224,India
534488,2024-02-05,502,iphone 15 pro max,100000,135000,35000,1,00224,India
534488,2024-02-05,505,oven,18490,24000,5510,1,00224,India
548850,2024-02-05,507,washing machine,6990,16490,9500,1,00346,India
548850,2024-02-05,504,iron,449,879,430,1,00346,India
548850,2024-02-05,505,oven,18490,24000,5510,1,00346,India
433170,2024-02-05,507,washing machine,6990,16490,9500,1,00264,India
866683,2024-02-05,506,monitor,3249,8000,4751,1,00378,India
213153,2024-02-05,507,washing machine,6990,16490,9500,1,00285,India
213153,2024-02-05,503,mixer,1349,3249,1900,1,00285,India
213153,2024-02-05,502,iphone 15 pro max,100000,135000,35000,1,00285,India
238516,2024-02-05,503,mixer,1349,3249,1900,1,00308,India
477806,2024-02-05,507,washing machine,6990,16490,9500,1,00488,India
477806,2024-02-05,504,iron,449,879,430,1,00488,India
477806,2024-02-05,505,oven,18490,24000,5510,1,00488,India
477806,2024-02-05,506,monitor,3249,8000,4751,1,00488,India
986853,2024-02-05,505,oven,18490,24000,5510,1,00124,India
986853,2024-02-05,504,iron,449,879,430,1,00124,India
986853,2024-02-05,502,iphone 15 pro max,100000,135000,35000,1,00124,India
986853,2024-02-05,506,monitor,3249,8000,4751,1,00124,India
647697,2024-02-05,505,oven,18490,24000,5510,1,00270,India
647697,2024-02-05,504,iron,449,879,430,1,00270,India
647697,2024-02-05,507,washing machine,6990,16490,9500,1,00270,India
647697,2024-02-05,503,mixer,1349,3249,1900,1,00270,India
469690,2024-02-05,502,iphone 15 pro max,100000,135000,35000,1,00291,India
469690,2024-02-05,501,iphone 15,60000,80000,20000,1,00291,India
445600,2024-02-05,506,monitor,3249,8000,4751,1,00262,India
457467,2024-02-05,507,washing machine,6990,16490,9500,1,00324,India
457467,2024-02-05,505,oven,18490,24000,5510,1,00324,India
457467,2024-02-05,506,monitor,3249,8000,4751,1,00324,India
457467,2024-02-05,503,mixer,1349,3249,1900,1,00324,India
719887,2024-02-05,505,oven,18490,24000,5510,1,00113,India
719887,2024-02-05,501,iphone 15,60000,80000,20000,1,00113,India
233221,2024-02-05,502,iphone 15 pro max,100000,135000,35000,1,00464,India
233221,2024-02-05,504,iron,449,879,430,1,00464,India
233221,2024-02-05,503,mixer,1349,3249,1900,1,00464,India
233221,2024-02-05,501,iphone 15,60000,80000,20000,1,00464,India
739857,2024-02-05,505,oven,18490,24000,5510,1,00097,India
739857,2024-02-05,502,iphone 15 pro max,100000,135000,35000,1,00097,India
698478,2024-02-05,503,mixer,1349,3249,1900,1,00223,India
698478,2024-02-05,507,washing machine,6990,16490,9500,1,00223,India
974007,2024-02-05,501,iphone 15,60000,80000,20000,1,00152,India
397995,2024-02-05,507,washing machine,6990,16490,9500,1,00063,India
397995,2024-02-05,503,mixer,1349,3249,1900,1,00063,India
397995,2024-02-05,504,iron,449,879,430,1,00063,India
397995,2024-02-05,505,oven,18490,24000,5510,1,00063,India
383249,2024-02-05,504,iron,449,879,430,1,00346,India
383249,2024-02-05,506,monitor,3249,8000,4751,1,00346,India
383249,2024-02-05,503,mixer,1349,3249,1900,1,00346,India
597840,2024-02-06,507,washing machine,6990,16490,9500,1,00068,India
201069,2024-02-06,504,iron,449,879,430,1,00280,India
201069,2024-02-06,506,monitor,3249,8000,4751,1,00280,India
201069,2024-02-06,502,iphone 15 pro max,100000,135000,35000,1,00280,India
201069,2024-02-06,505,oven,18490,24000,5510,1,00280,India
201069,2024-02-06,507,washing machine,6990,16490,9500,1,00280,India
195024,2024-02-06,504,iron,449,879,430,1,00224,India
195024,2024-02-06,506,monitor,3249,8000,4751,1,00224,India
694478,2024-02-06,502,iphone 15 pro max,100000,135000,35000,1,00249,India
694478,2024-02-06,506,monitor,3249,8000,4751,1,00249,India
492550,2024-02-06,502,iphone 15 pro max,100000,135000,35000,1,00045,India
492550,2024-02-06,505,oven,18490,24000,5510,1,00045,India
102435,2024-02-06,506,monitor,3249,8000,4751,1,00227,India
102435,2024-02-06,501,iphone 15,60000,80000,20000,1,00227,India
102435,2024-02-06,503,mixer,1349,3249,1900,1,00227,India
870841,2024-02-06,505,oven,18490,24000,5510,1,00302,India
870841,2024-02-06,501,iphone 15,60000,80000,20000,1,00302,India
420111,2024-02-06,504,iron,449,879,430,1,00469,India
420111,2024-02-06,505,oven,18490,24000,5510,1,00469,India
420111,2024-02-06,502,iphone 15 pro max,100000,135000,35000,1,00469,India
355054,2024-02-06,504,iron,449,879,430,1,00067,India
355054,2024-02-06,505,oven,18490,24000,5510,1,00067,India
355054,2024-02-06,501,iphone 15,60000,80000,20000,1,00067,India
902635,2024-02-06,504,iron,449,879,430,1,00338,India
902635,2024-02-06,502,iphone 15 pro max,100000,135000,35000,1,00338,India
902635,2024-02-06,505,oven,18490,24000,5510,1,00338,India
902635,2024-02-06,503,mixer,1349,3249,1900,1,00338,India
902635,2024-02-06,501,iphone 15,60000,80000,20000,1,00338,India
816932,2024-02-06,507,washing machine,6990,16490,9500,1,00341,India
715768,2024-02-06,504,iron,449,879,430,1,00463,India
715768,2024-02-06,501,iphone 15,60000,80000,20000,1,00463,India
715768,2024-02-06,502,iphone 15 pro max,100000,135000,35000,1,00463,India
568694,2024-02-06,507,washing machine,6990,16490,9500,1,00031,India
568694,2024-02-06,502,iphone 15 pro max,100000,135000,35000,1,00031,India
568694,2024-02-06,505,oven,18490,24000,5510,1,00031,India
568694,2024-02-06,506,monitor,3249,8000,4751,1,00031,India
403693,2024-02-06,502,iphone 15 pro max,100000,135000,35000,1,00008,India
403693,2024-02-06,504,iron,449,879,430,1,00008,India
403693,2024-02-06,505,oven,18490,24000,5510,1,00008,India
815768,2024-02-06,503,mixer,1349,3249,1900,1,00409,India
815768,2024-02-06,505,oven,18490,24000,5510,1,00409,India
815768,2024-02-06,501,iphone 15,60000,80000,20000,1,00409,India
815768,2024-02-06,507,washing machine,6990,16490,9500,1,00409,India
420661,2024-02-06,505,oven,18490,24000,5510,1,00103,India
850640,2024-02-06,502,iphone 15 pro max,100000,135000,35000,1,00252,India
850640,2024-02-06,501,iphone 15,60000,80000,20000,1,00252,India
715200,2024-02-06,505,oven,18490,24000,5510,1,00006,India
715200,2024-02-06,503,mixer,1349,3249,1900,1,00006,India
492696,2024-02-06,506,monitor,3249,8000,4751,1,00320,India
492696,2024-02-06,503,mixer,1349,3249,1900,1,00320,India
492696,2024-02-06,502,iphone 15 pro max,100000,135000,35000,1,00320,India
831610,2024-02-06,505,oven,18490,24000,5510,1,00367,India
831610,2024-02-06,501,iphone 15,60000,80000,20000,1,00367,India
831610,2024-02-06,502,iphone 15 pro max,100000,135000,35000,1,00367,India
800518,2024-02-06,501,iphone 15,60000,80000,20000,1,00082,India
800518,2024-02-06,507,washing machine,6990,16490,9500,1,00082,India
800518,2024-02-06,505,oven,18490,24000,5510,1,00082,India
800518,2024-02-06,502,iphone 15 pro max,100000,135000,35000,1,00082,India
482528,2024-02-06,506,monitor,3249,8000,4751,1,00234,India
482528,2024-02-06,504,iron,449,879,430,1,00234,India
482528,2024-02-06,502,iphone 15 pro max,100000,135000,35000,1,00234,India
482528,2024-02-06,501,iphone 15,60000,80000,20000,1,00234,India
571336,2024-02-06,505,oven,18490,24000,5510,1,00039,India
571336,2024-02-06,501,iphone 15,60000,80000,20000,1,00039,India
120990,2024-02-06,502,iphone 15 pro max,100000,135000,35000,1,00193,India
890890,2024-02-06,503,mixer,1349,3249,1900,1,00076,India
890890,2024-02-06,505,oven,18490,24000,5510,1,00076,India
890890,2024-02-06,501,iphone 15,60000,80000,20000,1,00076,India
890890,2024-02-06,507,washing machine,6990,16490,9500,1,00076,India
349045,2024-02-06,504,iron,449,879,430,1,00329,India
349045,2024-02-06,503,mixer,1349,3249,1900,1,00329,India
552440,2024-02-06,504,iron,449,879,430,1,00208,India
552440,2024-02-06,507,washing machine,6990,16490,9500,1,00208,India
754996,2024-02-06,505,oven,18490,24000,5510,1,00121,India
754996,2024-02-06,502,iphone 15 pro max,100000,135000,35000,1,00121,India
771581,2024-02-06,502,iphone 15 pro max,100000,135000,35000,1,00044,India
771581,2024-02-06,505,oven,18490,24000,5510,1,00044,India
771581,2024-02-06,506,monitor,3249,8000,4751,1,00044,India
922707,2024-02-06,506,monitor,3249,8000,4751,1,00137,India
922707,2024-02-06,507,washing machine,6990,16490,9500,1,00137,India
796825,2024-02-06,507,washing machine,6990,16490,9500,1,00261,India
376187,2024-02-06,505,oven,18490,24000,5510,1,00391,India
258042,2024-02-06,504,iron,449,879,430,1,00177,India
258042,2024-02-06,502,iphone 15 pro max,100000,135000,35000,1,00177,India
169341,2024-02-06,506,monitor,3249,8000,4751,1,00107,India
169341,2024-02-06,505,oven,18490,24000,5510,1,00107,India
598788,2024-02-06,504,iron,449,879,430,1,00421,India
598788,2024-02-06,502,iphone 15 pro max,100000,135000,35000,1,00421,India
598788,2024-02-06,507,washing machine,6990,16490,9500,1,00421,India
598788,2024-02-06,506,monitor,3249,8000,4751,1,00421,India
598788,2024-02-06,503,mixer,1349,3249,1900,1,00421,India
353903,2024-02-06,504,iron,449,879,430,1,00367,India
863310,2024-02-06,504,iron,449,879,430,1,00478,India
818679,2024-02-06,506,monitor,3249,8000,4751,1,00282,India
419633,2024-02-06,505,oven,18490,24000,5510,1,00471,India
295540,2024-02-06,503,mixer,1349,3249,1900,1,00112,India
543918,2024-02-06,507,washing machine,6990,16490,9500,1,00163,India
943134,2024-02-06,506,monitor,3249,8000,4751,1,00036,India
943134,2024-02-06,505,oven,18490,24000,5510,1,00036,India
943134,2024-02-06,501,iphone 15,60000,80000,20000,1,00036,India
943134,2024-02-06,504,iron,449,879,430,1,00036,India
943134,2024-02-06,503,mixer,1349,3249,1900,1,00036,India
461266,2024-02-06,504,iron,449,879,430,1,00199,India
461266,2024-02-06,505,oven,18490,24000,5510,1,00199,India
177242,2024-02-06,503,mixer,1349,3249,1900,1,00323,India
506205,2024-02-06,501,iphone 15,60000,80000,20000,1,00371,India
506205,2024-02-06,507,washing machine,6990,16490,9500,1,00371,India
222107,2024-02-06,507,washing machine,6990,16490,9500,1,00229,India
222107,2024-02-06,502,iphone 15 pro max,100000,135000,35000,1,00229,India
222107,2024-02-06,503,mixer,1349,3249,1900,1,00229,India
222107,2024-02-06,506,monitor,3249,8000,4751,1,00229,India
396072,2024-02-06,503,mixer,1349,3249,1900,1,00068,India
396072,2024-02-06,504,iron,449,879,430,1,00068,India
396072,2024-02-06,501,iphone 15,60000,80000,20000,1,00068,India
912855,2024-02-06,501,iphone 15,60000,80000,20000,1,00320,India
841339,2024-02-06,507,washing machine,6990,16490,9500,1,00337,India
841339,2024-02-06,505,oven,18490,24000,5510,1,00337,India
841339,2024-02-06,506,monitor,3249,8000,4751,1,00337,India
841339,2024-02-06,503,mixer,1349,3249,1900,1,00337,India
260726,2024-02-06,507,washing machine,6990,16490,9500,1,00429,India
260726,2024-02-06,506,monitor,3249,8000,4751,1,00429,India
555084,2024-02-06,502,iphone 15 pro max,100000,135000,35000,1,00386,India
555084,2024-02-06,501,iphone 15,60000,80000,20000,1,00386,India
555084,2024-02-06,506,monitor,3249,8000,4751,1,00386,India
555084,2024-02-06,504,iron,449,879,430,1,00386,India
130497,2024-02-06,502,iphone 15 pro max,100000,135000,35000,1,00311,India
130497,2024-02-06,504,iron,449,879,430,1,00311,India
130497,2024-02-06,501,iphone 15,60000,80000,20000,1,00311,India
130497,2024-02-06,506,monitor,3249,8000,4751,1,00311,India
827463,2024-02-06,503,mixer,1349,3249,1900,1,00232,India
827463,2024-02-06,501,iphone 15,60000,80000,20000,1,00232,India
827463,2024-02-06,502,iphone 15 pro max,100000,135000,35000,1,00232,India
827463,2024-02-06,505,oven,18490,24000,5510,1,00232,India
250853,2024-02-06,501,iphone 15,60000,80000,20000,1,00241,India
250853,2024-02-06,505,oven,18490,24000,5510,1,00241,India
250853,2024-02-06,507,washing machine,6990,16490,9500,1,00241,India
250853,2024-02-06,506,monitor,3249,8000,4751,1,00241,India
250853,2024-02-06,503,mixer,1349,3249,1900,1,00241,India
474590,2024-02-06,504,iron,449,879,430,1,00351,India
579531,2024-02-06,507,washing machine,6990,16490,9500,1,00134,India
579531,2024-02-06,501,iphone 15,60000,80000,20000,1,00134,India
675852,2024-02-06,504,iron,449,879,430,1,00142,India
675852,2024-02-06,501,iphone 15,60000,80000,20000,1,00142,India
128093,2024-02-06,504,iron,449,879,430,1,00075,India
128093,2024-02-06,503,mixer,1349,3249,1900,1,00075,India
230029,2024-02-06,507,washing machine,6990,16490,9500,1,00115,India
230029,2024-02-06,503,mixer,1349,3249,1900,1,00115,India
867376,2024-02-06,502,iphone 15 pro max,100000,135000,35000,1,00034,India
487303,2024-02-06,503,mixer,1349,3249,1900,1,00071,India
487303,2024-02-06,507,washing machine,6990,16490,9500,1,00071,India
487303,2024-02-06,501,iphone 15,60000,80000,20000,1,00071,India
492632,2024-02-06,501,iphone 15,60000,80000,20000,1,00020,India
492632,2024-02-06,504,iron,449,879,430,1,00020,India
492632,2024-02-06,505,oven,18490,24000,5510,1,00020,India
492632,2024-02-06,507,washing machine,6990,16490,9500,1,00020,India
352921,2024-02-06,505,oven,18490,24000,5510,1,00398,India
352921,2024-02-06,506,monitor,3249,8000,4751,1,00398,India
949389,2024-02-06,505,oven,18490,24000,5510,1,00045,India
949389,2024-02-06,502,iphone 15 pro max,100000,135000,35000,1,00045,India
669980,2024-02-06,506,monitor,3249,8000,4751,1,00070,India
669980,2024-02-06,503,mixer,1349,3249,1900,1,00070,India
807207,2024-02-06,506,monitor,3249,8000,4751,1,00101,India
807207,2024-02-06,507,washing machine,6990,16490,9500,1,00101,India
840008,2024-02-06,504,iron,449,879,430,1,00057,India
840008,2024-02-06,502,iphone 15 pro max,100000,135000,35000,1,00057,India
840008,2024-02-06,506,monitor,3249,8000,4751,1,00057,India
235470,2024-02-06,502,iphone 15 pro max,100000,135000,35000,1,00076,India
235470,2024-02-06,503,mixer,1349,3249,1900,1,00076,India
235470,2024-02-06,505,oven,18490,24000,5510,1,00076,India
235470,2024-02-06,506,monitor,3249,8000,4751,1,00076,India
911986,2024-02-06,502,iphone 15 pro max,100000,135000,35000,1,00224,India
779264,2024-02-06,504,iron,449,879,430,1,00058,India
148246,2024-02-06,502,iphone 15 pro max,100000,135000,35000,1,00220,India
148246,2024-02-06,504,iron,449,879,430,1,00220,India
148652,2024-02-06,507,washing machine,6990,16490,9500,1,00232,India
148652,2024-02-06,502,iphone 15 pro max,100000,135000,35000,1,00232,India
889955,2024-02-06,501,iphone 15,60000,80000,20000,1,00442,India
889955,2024-02-06,503,mixer,1349,3249,1900,1,00442,India
889955,2024-02-06,507,washing machine,6990,16490,9500,1,00442,India
889955,2024-02-06,504,iron,449,879,430,1,00442,India
408770,2024-02-06,504,iron,449,879,430,1,00208,India
408770,2024-02-06,505,oven,18490,24000,5510,1,00208,India
408770,2024-02-06,503,mixer,1349,3249,1900,1,00208,India
413791,2024-02-06,507,washing machine,6990,16490,9500,1,00280,India
413791,2024-02-06,501,iphone 15,60000,80000,20000,1,00280,India
413791,2024-02-06,505,oven,18490,24000,5510,1,00280,India
413791,2024-02-06,503,mixer,1349,3249,1900,1,00280,India
798092,2024-02-06,506,monitor,3249,8000,4751,1,00462,India
454719,2024-02-06,502,iphone 15 pro max,100000,135000,35000,1,00355,India
454719,2024-02-06,505,oven,18490,24000,5510,1,00355,India
454719,2024-02-06,506,monitor,3249,8000,4751,1,00355,India
454719,2024-02-06,504,iron,449,879,430,1,00355,India
409364,2024-02-06,504,iron,449,879,430,1,00045,India
409364,2024-02-06,505,oven,18490,24000,5510,1,00045,India
969605,2024-02-06,501,iphone 15,60000,80000,20000,1,00224,India
969605,2024-02-06,503,mixer,1349,3249,1900,1,00224,India
969605,2024-02-06,507,washing machine,6990,16490,9500,1,00224,India
914409,2024-02-06,503,mixer,1349,3249,1900,1,00494,India
914409,2024-02-06,507,washing machine,6990,16490,9500,1,00494,India
506981,2024-02-06,506,monitor,3249,8000,4751,1,00137,India
506981,2024-02-06,503,mixer,1349,3249,1900,1,00137,India
932587,2024-02-06,503,mixer,1349,3249,1900,1,00288,India
927442,2024-02-06,506,monitor,3249,8000,4751,1,00307,India
927442,2024-02-06,507,washing machine,6990,16490,9500,1,00307,India
927442,2024-02-06,503,mixer,1349,3249,1900,1,00307,India
920714,2024-02-06,505,oven,18490,24000,5510,1,00491,India
573721,2024-02-06,507,washing machine,6990,16490,9500,1,00305,India
573721,2024-02-06,502,iphone 15 pro max,100000,135000,35000,1,00305,India
573721,2024-02-06,505,oven,18490,24000,5510,1,00305,India
573721,2024-02-06,503,mixer,1349,3249,1900,1,00305,India
370718,2024-02-06,506,monitor,3249,8000,4751,1,00091,India
370718,2024-02-06,504,iron,449,879,430,1,00091,India
370718,2024-02-06,503,mixer,1349,3249,1900,1,00091,India
370718,2024-02-06,501,iphone 15,60000,80000,20000,1,00091,India
358760,2024-02-06,503,mixer,1349,3249,1900,1,00251,India
294854,2024-02-06,506,monitor,3249,8000,4751,1,00418,India
294854,2024-02-06,502,iphone 15 pro max,100000,135000,35000,1,00418,India
294854,2024-02-06,507,washing machine,6990,16490,9500,1,00418,India
771508,2024-02-06,507,washing machine,6990,16490,9500,1,00268,India
771508,2024-02-06,505,oven,18490,24000,5510,1,00268,India
301491,2024-02-06,504,iron,449,879,430,1,00074,India
301491,2024-02-06,505,oven,18490,24000,5510,1,00074,India
301491,2024-02-06,502,iphone 15 pro max,100000,135000,35000,1,00074,India
301491,2024-02-06,501,iphone 15,60000,80000,20000,1,00074,India
301491,2024-02-06,507,washing machine,6990,16490,9500,1,00074,India
341825,2024-02-06,507,washing machine,6990,16490,9500,1,00123,India
341825,2024-02-06,506,monitor,3249,8000,4751,1,00123,India
341825,2024-02-06,501,iphone 15,60000,80000,20000,1,00123,India
341825,2024-02-06,502,iphone 15 pro max,100000,135000,35000,1,00123,India
745423,2024-02-06,504,iron,449,879,430,1,00157,India
745423,2024-02-06,501,iphone 15,60000,80000,20000,1,00157,India
745423,2024-02-06,506,monitor,3249,8000,4751,1,00157,India
157599,2024-02-06,506,monitor,3249,8000,4751,1,00179,India
157599,2024-02-06,505,oven,18490,24000,5510,1,00179,India
199087,2024-02-06,505,oven,18490,24000,5510,1,00102,India
164581,2024-02-06,507,washing machine,6990,16490,9500,1,00486,India
164581,2024-02-06,504,iron,449,879,430,1,00486,India
164581,2024-02-06,503,mixer,1349,3249,1900,1,00486,India
164581,2024-02-06,506,monitor,3249,8000,4751,1,00486,India
475235,2024-02-06,502,iphone 15 pro max,100000,135000,35000,1,00482,India
475235,2024-02-06,504,iron,449,879,430,1,00482,India
571906,2024-02-06,506,monitor,3249,8000,4751,1,00237,India
571906,2024-02-06,504,iron,449,879,430,1,00237,India
571906,2024-02-06,501,iphone 15,60000,80000,20000,1,00237,India
571906,2024-02-06,507,washing machine,6990,16490,9500,1,00237,India
748591,2024-02-06,505,oven,18490,24000,5510,1,00482,India
748591,2024-02-06,502,iphone 15 pro max,100000,135000,35000,1,00482,India
748591,2024-02-06,506,monitor,3249,8000,4751,1,00482,India
748591,2024-02-06,501,iphone 15,60000,80000,20000,1,00482,India
378886,2024-02-06,505,oven,18490,24000,5510,1,00192,India
378886,2024-02-06,507,washing machine,6990,16490,9500,1,00192,India
378886,2024-02-06,501,iphone 15,60000,80000,20000,1,00192,India
378886,2024-02-06,506,monitor,3249,8000,4751,1,00192,India
636809,2024-02-07,504,iron,449,879,430,1,00233,India
636809,2024-02-07,506,monitor,3249,8000,4751,1,00233,India
636809,2024-02-07,501,iphone 15,60000,80000,20000,1,00233,India
911159,2024-02-07,506,monitor,3249,8000,4751,1,00356,India
744678,2024-02-07,505,oven,18490,24000,5510,1,00070,India
744678,2024-02-07,507,washing machine,6990,16490,9500,1,00070,India
744678,2024-02-07,506,monitor,3249,8000,4751,1,00070,India
904582,2024-02-07,503,mixer,1349,3249,1900,1,00475,India
904582,2024-02-07,501,iphone 15,60000,80000,20000,1,00475,India
904582,2024-02-07,505,oven,18490,24000,5510,1,00475,India
217007,2024-02-07,503,mixer,1349,3249,1900,1,00404,India
825567,2024-02-07,505,oven,18490,24000,5510,1,00454,India
825567,2024-02-07,501,iphone 15,60000,80000,20000,1,00454,India
825567,2024-02-07,504,iron,449,879,430,1,00454,India
606069,2024-02-07,507,washing machine,6990,16490,9500,1,00050,India
606069,2024-02-07,502,iphone 15 pro max,100000,135000,35000,1,00050,India
606069,2024-02-07,505,oven,18490,24000,5510,1,00050,India
264158,2024-02-07,504,iron,449,879,430,1,00080,India
264158,2024-02-07,506,monitor,3249,8000,4751,1,00080,India
264158,2024-02-07,505,oven,18490,24000,5510,1,00080,India
709072,2024-02-07,507,washing machine,6990,16490,9500,1,00142,India
709072,2024-02-07,505,oven,18490,24000,5510,1,00142,India
709072,2024-02-07,503,mixer,1349,3249,1900,1,00142,India
709072,2024-02-07,502,iphone 15 pro max,100000,135000,35000,1,00142,India
938728,2024-02-07,501,iphone 15,60000,80000,20000,1,00377,India
938728,2024-02-07,506,monitor,3249,8000,4751,1,00377,India
539120,2024-02-07,504,iron,449,879,430,1,00459,India
539120,2024-02-07,507,washing machine,6990,16490,9500,1,00459,India
736222,2024-02-07,502,iphone 15 pro max,100000,135000,35000,1,00321,India
736222,2024-02-07,507,washing machine,6990,16490,9500,1,00321,India
736222,2024-02-07,506,monitor,3249,8000,4751,1,00321,India
487649,2024-02-07,503,mixer,1349,3249,1900,1,00248,India
275632,2024-02-07,507,washing machine,6990,16490,9500,1,00233,India
275632,2024-02-07,501,iphone 15,60000,80000,20000,1,00233,India
802461,2024-02-07,506,monitor,3249,8000,4751,1,00228,India
433392,2024-02-07,503,mixer,1349,3249,1900,1,00274,India
433392,2024-02-07,505,oven,18490,24000,5510,1,00274,India
648673,2024-02-07,506,monitor,3249,8000,4751,1,00269,India
884636,2024-02-07,501,iphone 15,60000,80000,20000,1,00334,India
884636,2024-02-07,504,iron,449,879,430,1,00334,India
872640,2024-02-07,504,iron,449,879,430,1,00455,India
872640,2024-02-07,502,iphone 15 pro max,100000,135000,35000,1,00455,India
872640,2024-02-07,503,mixer,1349,3249,1900,1,00455,India
872640,2024-02-07,501,iphone 15,60000,80000,20000,1,00455,India
826414,2024-02-07,502,iphone 15 pro max,100000,135000,35000,1,00370,India
826414,2024-02-07,507,washing machine,6990,16490,9500,1,00370,India
715734,2024-02-07,501,iphone 15,60000,80000,20000,1,00293,India
653807,2024-02-07,506,monitor,3249,8000,4751,1,00068,India
653807,2024-02-07,503,mixer,1349,3249,1900,1,00068,India
653807,2024-02-07,505,oven,18490,24000,5510,1,00068,India
160893,2024-02-07,503,mixer,1349,3249,1900,1,00219,India
160893,2024-02-07,507,washing machine,6990,16490,9500,1,00219,India
160893,2024-02-07,506,monitor,3249,8000,4751,1,00219,India
817812,2024-02-07,502,iphone 15 pro max,100000,135000,35000,1,00409,India
817812,2024-02-07,505,oven,18490,24000,5510,1,00409,India
817812,2024-02-07,503,mixer,1349,3249,1900,1,00409,India
817812,2024-02-07,501,iphone 15,60000,80000,20000,1,00409,India
817812,2024-02-07,504,iron,449,879,430,1,00409,India
835914,2024-02-07,506,monitor,3249,8000,4751,1,00124,India
835914,2024-02-07,501,iphone 15,60000,80000,20000,1,00124,India
835914,2024-02-07,503,mixer,1349,3249,1900,1,00124,India
737333,2024-02-07,507,washing machine,6990,16490,9500,1,00148,India
737333,2024-02-07,503,mixer,1349,3249,1900,1,00148,India
737333,2024-02-07,506,monitor,3249,8000,4751,1,00148,India
105316,2024-02-07,502,iphone 15 pro max,100000,135000,35000,1,00313,India
105316,2024-02-07,504,iron,449,879,430,1,00313,India
305489,2024-02-07,505,oven,18490,24000,5510,1,00247,India
305489,2024-02-07,502,iphone 15 pro max,100000,135000,35000,1,00247,India
554841,2024-02-07,503,mixer,1349,3249,1900,1,00200,India
554841,2024-02-07,502,iphone 15 pro max,100000,135000,35000,1,00200,India
554841,2024-02-07,507,washing machine,6990,16490,9500,1,00200,India
991976,2024-02-07,506,monitor,3249,8000,4751,1,00386,India
991976,2024-02-07,507,washing machine,6990,16490,9500,1,00386,India
259515,2024-02-07,505,oven,18490,24000,5510,1,00087,India
532670,2024-02-07,507,washing machine,6990,16490,9500,1,00416,India
532670,2024-02-07,505,oven,18490,24000,5510,1,00416,India
532670,2024-02-07,502,iphone 15 pro max,100000,135000,35000,1,00416,India
532670,2024-02-07,504,iron,449,879,430,1,00416,India
358486,2024-02-07,501,iphone 15,60000,80000,20000,1,00304,India
358486,2024-02-07,503,mixer,1349,3249,1900,1,00304,India
358486,2024-02-07,507,washing machine,6990,16490,9500,1,00304,India
715020,2024-02-07,506,monitor,3249,8000,4751,1,00356,India
571649,2024-02-07,506,monitor,3249,8000,4751,1,00472,India
571649,2024-02-07,503,mixer,1349,3249,1900,1,00472,India
571649,2024-02-07,505,oven,18490,24000,5510,1,00472,India
525509,2024-02-07,506,monitor,3249,8000,4751,1,00445,India
525509,2024-02-07,501,iphone 15,60000,80000,20000,1,00445,India
943956,2024-02-07,501,iphone 15,60000,80000,20000,1,00392,India
943956,2024-02-07,507,washing machine,6990,16490,9500,1,00392,India
467263,2024-02-07,505,oven,18490,24000,5510,1,00432,India
467263,2024-02-07,503,mixer,1349,3249,1900,1,00432,India
654210,2024-02-07,507,washing machine,6990,16490,9500,1,00068,India
654210,2024-02-07,504,iron,449,879,430,1,00068,India
654210,2024-02-07,505,oven,18490,24000,5510,1,00068,India
654210,2024-02-07,502,iphone 15 pro max,100000,135000,35000,1,00068,India
414900,2024-02-07,504,iron,449,879,430,1,00350,India
414900,2024-02-07,503,mixer,1349,3249,1900,1,00350,India
414900,2024-02-07,505,oven,18490,24000,5510,1,00350,India
414900,2024-02-07,501,iphone 15,60000,80000,20000,1,00350,India
414900,2024-02-07,507,washing machine,6990,16490,9500,1,00350,India
623640,2024-02-07,502,iphone 15 pro max,100000,135000,35000,1,00368,India
623640,2024-02-07,501,iphone 15,60000,80000,20000,1,00368,India
623640,2024-02-07,503,mixer,1349,3249,1900,1,00368,India
942357,2024-02-07,507,washing machine,6990,16490,9500,1,00474,India
942357,2024-02-07,505,oven,18490,24000,5510,1,00474,India
942357,2024-02-07,503,mixer,1349,3249,1900,1,00474,India
675853,2024-02-07,505,oven,18490,24000,5510,1,00113,India
675853,2024-02-07,501,iphone 15,60000,80000,20000,1,00113,India
675853,2024-02-07,504,iron,449,879,430,1,00113,India
201878,2024-02-07,501,iphone 15,60000,80000,20000,1,00451,India
201878,2024-02-07,504,iron,449,879,430,1,00451,India
467233,2024-02-07,502,iphone 15 pro max,100000,135000,35000,1,00457,India
467233,2024-02-07,506,monitor,3249,8000,4751,1,00457,India
467233,2024-02-07,501,iphone 15,60000,80000,20000,1,00457,India
467233,2024-02-07,505,oven,18490,24000,5510,1,00457,India
443503,2024-02-07,502,iphone 15 pro max,100000,135000,35000,1,00393,India
443503,2024-02-07,507,washing machine,6990,16490,9500,1,00393,India
443503,2024-02-07,505,oven,18490,24000,5510,1,00393,India
443503,2024-02-07,501,iphone 15,60000,80000,20000,1,00393,India
437734,2024-02-07,504,iron,449,879,430,1,00005,India
437734,2024-02-07,505,oven,18490,24000,5510,1,00005,India
489772,2024-02-07,502,iphone 15 pro max,100000,135000,35000,1,00481,India
489772,2024-02-07,507,washing machine,6990,16490,9500,1,00481,India
756582,2024-02-07,502,iphone 15 pro max,100000,135000,35000,1,00473,India
756582,2024-02-07,505,oven,18490,24000,5510,1,00473,India
756582,2024-02-07,506,monitor,3249,8000,4751,1,00473,India
155198,2024-02-07,506,monitor,3249,8000,4751,1,00080,India
155198,2024-02-07,504,iron,449,879,430,1,00080,India
155198,2024-02-07,503,mixer,1349,3249,1900,1,00080,India
876106,2024-02-07,503,mixer,1349,3249,1900,1,00059,India
694521,2024-02-07,505,oven,18490,24000,5510,1,00446,India
694521,2024-02-07,502,iphone 15 pro max,100000,135000,35000,1,00446,India
694521,2024-02-07,504,iron,449,879,430,1,00446,India
694521,2024-02-07,501,iphone 15,60000,80000,20000,1,00446,India
102590,2024-02-07,507,washing machine,6990,16490,9500,1,00183,India
102590,2024-02-07,506,monitor,3249,8000,4751,1,00183,India
102590,2024-02-07,505,oven,18490,24000,5510,1,00183,India
878888,2024-02-07,501,iphone 15,60000,80000,20000,1,00005,India
878888,2024-02-07,506,monitor,3249,8000,4751,1,00005,India
878888,2024-02-07,505,oven,18490,24000,5510,1,00005,India
955950,2024-02-07,506,monitor,3249,8000,4751,1,00365,India
955950,2024-02-07,504,iron,449,879,430,1,00365,India
955950,2024-02-07,502,iphone 15 pro max,100000,135000,35000,1,00365,India
540782,2024-02-07,504,iron,449,879,430,1,00435,India
540782,2024-02-07,501,iphone 15,60000,80000,20000,1,00435,India
540782,2024-02-07,505,oven,18490,24000,5510,1,00435,India
540782,2024-02-07,503,mixer,1349,3249,1900,1,00435,India
176234,2024-02-07,501,iphone 15,60000,80000,20000,1,00022,India
176234,2024-02-07,505,oven,18490,24000,5510,1,00022,India
182107,2024-02-07,506,monitor,3249,8000,4751,1,00496,India
850165,2024-02-07,504,iron,449,879,430,1,00279,India
850165,2024-02-07,503,mixer,1349,3249,1900,1,00279,India
850165,2024-02-07,506,monitor,3249,8000,4751,1,00279,India
850165,2024-02-07,505,oven,18490,24000,5510,1,230,India
125643,2024-02-07,503,mixer,1349,3249,1900,1,118,India
125643,2024-02-07,501,iphone 15,60000,80000,20000,1,118,India
125643,2024-02-07,506,monitor,3249,8000,4751,1,118,India
125643,2024-02-07,502,iphone 15 pro max,100000,135000,35000,1,118,India
788179,2024-02-07,507,washing machine,6990,16490,9500,1,164,India
470318,2024-02-07,504,iron,449,879,430,1,302,India
470318,2024-02-07,503,mixer,1349,3249,1900,1,302,India
264779,2024-02-07,505,oven,18490,24000,5510,1,383,India
264779,2024-02-07,507,washing machine,6990,16490,9500,1,383,India
264779,2024-02-07,504,iron,449,879,430,1,383,India
264779,2024-02-07,502,iphone 15 pro max,100000,135000,35000,1,383,India
497260,2024-02-07,504,iron,449,879,430,1,101,India
497260,2024-02-07,503,mixer,1349,3249,1900,1,101,India
497260,2024-02-07,501,iphone 15,60000,80000,20000,1,101,India
296922,2024-02-07,507,washing machine,6990,16490,9500,1,421,India
486542,2024-02-07,505,oven,18490,24000,5510,1,115,India
202461,2024-02-07,506,monitor,3249,8000,4751,1,406,India
202461,2024-02-07,504,iron,449,879,430,1,406,India
202461,2024-02-07,503,mixer,1349,3249,1900,1,406,India
121743,2024-02-08,501,iphone 15,60000,80000,20000,1,179,India
121743,2024-02-08,504,iron,449,879,430,1,179,India
121743,2024-02-08,506,monitor,3249,8000,4751,1,179,India
865020,2024-02-08,506,monitor,3249,8000,4751,1,50,India
865020,2024-02-08,507,washing machine,6990,16490,9500,1,50,India
865020,2024-02-08,501,iphone 15,60000,80000,20000,1,50,India
865020,2024-02-08,505,oven,18490,24000,5510,1,50,India
993979,2024-02-08,504,iron,449,879,430,1,260,India
814251,2024-02-08,503,mixer,1349,3249,1900,1,175,India
394991,2024-02-08,505,oven,18490,24000,5510,1,349,India
394991,2024-02-08,501,iphone 15,60000,80000,20000,1,349,India
467671,2024-02-08,505,oven,18490,24000,5510,1,468,India
467671,2024-02-08,502,iphone 15 pro max,100000,135000,35000,1,468,India
601175,2024-02-08,504,iron,449,879,430,1,176,India
106185,2024-02-08,501,iphone 15,60000,80000,20000,1,297,India
106185,2024-02-08,506,monitor,3249,8000,4751,1,297,India
329631,2024-02-08,506,monitor,3249,8000,4751,1,68,India
329631,2024-02-08,503,mixer,1349,3249,1900,1,68,India
231884,2024-02-08,503,mixer,1349,3249,1900,1,35,India
231884,2024-02-08,504,iron,449,879,430,1,35,India
613606,2024-02-08,506,monitor,3249,8000,4751,1,385,India
613606,2024-02-08,505,oven,18490,24000,5510,1,385,India
613606,2024-02-08,501,iphone 15,60000,80000,20000,1,385,India
370448,2024-02-08,503,mixer,1349,3249,1900,1,490,India
370448,2024-02-08,501,iphone 15,60000,80000,20000,1,490,India
370448,2024-02-08,502,iphone 15 pro max,100000,135000,35000,1,490,India
826323,2024-02-08,503,mixer,1349,3249,1900,1,413,India
826323,2024-02-08,502,iphone 15 pro max,100000,135000,35000,1,413,India
409996,2024-02-08,507,washing machine,6990,16490,9500,1,152,India
605710,2024-02-08,507,washing machine,6990,16490,9500,1,179,India
605710,2024-02-08,506,monitor,3249,8000,4751,1,179,India
992735,2024-02-08,502,iphone 15 pro max,100000,135000,35000,1,291,India
601731,2024-02-08,503,mixer,1349,3249,1900,1,309,India
696860,2024-02-08,506,monitor,3249,8000,4751,1,492,India
696860,2024-02-08,501,iphone 15,60000,80000,20000,1,492,India
696860,2024-02-08,502,iphone 15 pro max,100000,135000,35000,1,492,India
470753,2024-02-08,506,monitor,3249,8000,4751,1,66,India
527735,2024-02-08,506,monitor,3249,8000,4751,1,178,India
527735,2024-02-08,503,mixer,1349,3249,1900,1,178,India
116125,2024-02-08,506,monitor,3249,8000,4751,1,202,India
116125,2024-02-08,505,oven,18490,24000,5510,1,202,India
159403,2024-02-08,502,iphone 15 pro max,100000,135000,35000,1,424,India
159403,2024-02-08,501,iphone 15,60000,80000,20000,1,424,India
159403,2024-02-08,506,monitor,3249,8000,4751,1,424,India
993726,2024-02-08,501,iphone 15,60000,80000,20000,1,264,India
747852,2024-02-08,502,iphone 15 pro max,100000,135000,35000,1,361,India
847124,2024-02-08,506,monitor,3249,8000,4751,1,343,India
847124,2024-02-08,507,washing machine,6990,16490,9500,1,343,India
847124,2024-02-08,504,iron,449,879,430,1,343,India
847124,2024-02-08,503,mixer,1349,3249,1900,1,343,India
714990,2024-02-08,507,washing machine,6990,16490,9500,1,80,India
979736,2024-02-08,503,mixer,1349,3249,1900,1,258,India
979736,2024-02-08,507,washing machine,6990,16490,9500,1,258,India
979736,2024-02-08,502,iphone 15 pro max,100000,135000,35000,1,258,India
390590,2024-02-08,503,mixer,1349,3249,1900,1,250,India
390590,2024-02-08,505,oven,18490,24000,5510,1,250,India
390590,2024-02-08,501,iphone 15,60000,80000,20000,1,250,India
835449,2024-02-08,504,iron,449,879,430,1,365,India
835449,2024-02-08,503,mixer,1349,3249,1900,1,365,India
835449,2024-02-08,507,washing machine,6990,16490,9500,1,365,India
351457,2024-02-08,505,oven,18490,24000,5510,1,464,India
351457,2024-02-08,507,washing machine,6990,16490,9500,1,464,India
351457,2024-02-08,502,iphone 15 pro max,100000,135000,35000,1,464,India
351457,2024-02-08,501,iphone 15,60000,80000,20000,1,464,India
589818,2024-02-08,503,mixer,1349,3249,1900,1,297,India
373657,2024-02-08,502,iphone 15 pro max,100000,135000,35000,1,101,India
373657,2024-02-08,505,oven,18490,24000,5510,1,101,India
578626,2024-02-08,503,mixer,1349,3249,1900,1,355,India
578626,2024-02-08,506,monitor,3249,8000,4751,1,355,India
578626,2024-02-08,501,iphone 15,60000,80000,20000,1,355,India
578626,2024-02-08,502,iphone 15 pro max,100000,135000,35000,1,355,India
463846,2024-02-08,502,iphone 15 pro max,100000,135000,35000,1,160,India
463846,2024-02-08,501,iphone 15,60000,80000,20000,1,160,India
463846,2024-02-08,506,monitor,3249,8000,4751,1,160,India
145308,2024-02-08,505,oven,18490,24000,5510,1,248,India
145308,2024-02-08,503,mixer,1349,3249,1900,1,248,India
145308,2024-02-08,506,monitor,3249,8000,4751,1,248,India
145308,2024-02-08,501,iphone 15,60000,80000,20000,1,248,India
145308,2024-02-08,502,iphone 15 pro max,100000,135000,35000,1,248,India
269389,2024-02-08,501,iphone 15,60000,80000,20000,1,95,India
267511,2024-02-08,504,iron,449,879,430,1,179,India
267511,2024-02-08,505,oven,18490,24000,5510,1,179,India
267511,2024-02-08,503,mixer,1349,3249,1900,1,179,India
962611,2024-02-08,501,iphone 15,60000,80000,20000,1,483,India
962611,2024-02-08,502,iphone 15 pro max,100000,135000,35000,1,483,India
962611,2024-02-08,507,washing machine,6990,16490,9500,1,483,India
178210,2024-02-08,505,oven,18490,24000,5510,1,63,India
178210,2024-02-08,506,monitor,3249,8000,4751,1,63,India
531322,2024-02-08,504,iron,449,879,430,1,117,India
721842,2024-02-08,506,monitor,3249,8000,4751,1,273,India
721842,2024-02-08,501,iphone 15,60000,80000,20000,1,273,India
721842,2024-02-08,503,mixer,1349,3249,1900,1,273,India
702733,2024-02-08,502,iphone 15 pro max,100000,135000,35000,1,236,India
702733,2024-02-08,501,iphone 15,60000,80000,20000,1,236,India
409744,2024-02-08,504,iron,449,879,430,1,346,India
409744,2024-02-08,502,iphone 15 pro max,100000,135000,35000,1,346,India
409744,2024-02-08,501,iphone 15,60000,80000,20000,1,346,India
409744,2024-02-08,503,mixer,1349,3249,1900,1,346,India
359216,2024-02-08,501,iphone 15,60000,80000,20000,1,439,India
359216,2024-02-08,502,iphone 15 pro max,100000,135000,35000,1,439,India
663569,2024-02-08,501,iphone 15,60000,80000,20000,1,311,India
663569,2024-02-08,506,monitor,3249,8000,4751,1,311,India
663569,2024-02-08,504,iron,449,879,430,1,311,India
663569,2024-02-08,507,washing machine,6990,16490,9500,1,311,India
790607,2024-02-08,506,monitor,3249,8000,4751,1,411,India
790607,2024-02-08,507,washing machine,6990,16490,9500,1,411,India
790607,2024-02-08,504,iron,449,879,430,1,411,India
790607,2024-02-08,505,oven,18490,24000,5510,1,411,India
123564,2024-02-08,505,oven,18490,24000,5510,1,82,India
123564,2024-02-08,501,iphone 15,60000,80000,20000,1,82,India
700568,2024-02-08,507,washing machine,6990,16490,9500,1,322,India
700568,2024-02-08,502,iphone 15 pro max,100000,135000,35000,1,322,India
179122,2024-02-08,504,iron,449,879,430,1,306,India
179122,2024-02-08,506,monitor,3249,8000,4751,1,306,India
184026,2024-02-08,507,washing machine,6990,16490,9500,1,215,India
315598,2024-02-08,507,washing machine,6990,16490,9500,1,296,India
315598,2024-02-08,502,iphone 15 pro max,100000,135000,35000,1,296,India
933942,2024-02-08,502,iphone 15 pro max,100000,135000,35000,1,48,India
933942,2024-02-08,501,iphone 15,60000,80000,20000,1,48,India
933942,2024-02-08,506,monitor,3249,8000,4751,1,48,India
933942,2024-02-08,503,mixer,1349,3249,1900,1,48,India
863248,2024-02-08,503,mixer,1349,3249,1900,1,144,India
330975,2024-02-08,501,iphone 15,60000,80000,20000,1,299,India
330975,2024-02-08,505,oven,18490,24000,5510,1,299,India
281727,2024-02-08,506,monitor,3249,8000,4751,1,128,India
281727,2024-02-08,504,iron,449,879,430,1,128,India
281727,2024-02-08,503,mixer,1349,3249,1900,1,128,India
281727,2024-02-08,501,iphone 15,60000,80000,20000,1,128,India
281727,2024-02-08,505,oven,18490,24000,5510,1,128,India
406647,2024-02-08,501,iphone 15,60000,80000,20000,1,166,India
406647,2024-02-08,502,iphone 15 pro max,100000,135000,35000,1,166,India
406647,2024-02-08,505,oven,18490,24000,5510,1,166,India
406647,2024-02-08,507,washing machine,6990,16490,9500,1,166,India
101380,2024-02-08,506,monitor,3249,8000,4751,1,186,India
101380,2024-02-08,504,iron,449,879,430,1,186,India
101380,2024-02-08,503,mixer,1349,3249,1900,1,186,India
209697,2024-02-08,504,iron,449,879,430,1,363,India
719210,2024-02-08,504,iron,449,879,430,1,369,India
719210,2024-02-08,503,mixer,1349,3249,1900,1,369,India
719210,2024-02-08,501,iphone 15,60000,80000,20000,1,369,India
719210,2024-02-08,507,washing machine,6990,16490,9500,1,369,India
562535,2024-02-08,501,iphone 15,60000,80000,20000,1,381,India
562535,2024-02-08,505,oven,18490,24000,5510,1,381,India
562535,2024-02-08,507,washing machine,6990,16490,9500,1,381,India
191038,2024-02-08,507,washing machine,6990,16490,9500,1,324,India
191038,2024-02-08,506,monitor,3249,8000,4751,1,324,India
191038,2024-02-08,503,mixer,1349,3249,1900,1,324,India
191038,2024-02-08,504,iron,449,879,430,1,324,India
820003,2024-02-08,505,oven,18490,24000,5510,1,78,India
852178,2024-02-09,501,iphone 15,60000,80000,20000,1,247,India
914505,2024-02-09,505,oven,18490,24000,5510,1,281,India
233436,2024-02-09,506,monitor,3249,8000,4751,1,381,India
414440,2024-02-09,507,washing machine,6990,16490,9500,1,76,India
602690,2024-02-09,507,washing machine,6990,16490,9500,1,380,India
983295,2024-02-09,506,monitor,3249,8000,4751,1,355,India
874933,2024-02-09,503,mixer,1349,3249,1900,1,186,India
683485,2024-02-09,506,monitor,3249,8000,4751,1,347,India
683485,2024-02-09,507,washing machine,6990,16490,9500,1,347,India
473495,2024-02-09,501,iphone 15,60000,80000,20000,1,230,India
467841,2024-02-09,504,iron,449,879,430,1,84,India
467841,2024-02-09,507,washing machine,6990,16490,9500,1,84,India
455521,2024-02-09,507,washing machine,6990,16490,9500,1,26,India
377722,2024-02-09,507,washing machine,6990,16490,9500,1,52,India
377722,2024-02-09,501,iphone 15,60000,80000,20000,1,52,India
377722,2024-02-09,504,iron,449,879,430,1,52,India
377722,2024-02-09,503,mixer,1349,3249,1900,1,52,India
377722,2024-02-09,505,oven,18490,24000,5510,1,52,India
719848,2024-02-09,505,oven,18490,24000,5510,1,338,India
710718,2024-02-09,505,oven,18490,24000,5510,1,389,India
710718,2024-02-09,507,washing machine,6990,16490,9500,1,389,India
710718,2024-02-09,502,iphone 15 pro max,100000,135000,35000,1,389,India
570280,2024-02-09,507,washing machine,6990,16490,9500,1,146,India
570280,2024-02-09,501,iphone 15,60000,80000,20000,1,146,India
570280,2024-02-09,503,mixer,1349,3249,1900,1,146,India
174299,2024-02-09,502,iphone 15 pro max,100000,135000,35000,1,19,India
174299,2024-02-09,507,washing machine,6990,16490,9500,1,19,India
174299,2024-02-09,505,oven,18490,24000,5510,1,19,India
174299,2024-02-09,504,iron,449,879,430,1,19,India
174299,2024-02-09,501,iphone 15,60000,80000,20000,1,19,India
514066,2024-02-09,505,oven,18490,24000,5510,1,71,India
514066,2024-02-09,504,iron,449,879,430,1,71,India
514066,2024-02-09,507,washing machine,6990,16490,9500,1,71,India
344883,2024-02-09,502,iphone 15 pro max,100000,135000,35000,1,151,India
344883,2024-02-09,503,mixer,1349,3249,1900,1,151,India
539520,2024-02-09,505,oven,18490,24000,5510,1,57,India
809364,2024-02-09,507,washing machine,6990,16490,9500,1,223,India
861702,2024-02-09,505,oven,18490,24000,5510,1,159,India
861702,2024-02-09,502,iphone 15 pro max,100000,135000,35000,1,159,India
163003,2024-02-09,502,iphone 15 pro max,100000,135000,35000,1,500,India
163003,2024-02-09,505,oven,18490,24000,5510,1,500,India
145536,2024-02-09,506,monitor,3249,8000,4751,1,96,India
145536,2024-02-09,507,washing machine,6990,16490,9500,1,96,India
145536,2024-02-09,505,oven,18490,24000,5510,1,96,India
903377,2024-02-09,507,washing machine,6990,16490,9500,1,21,India
903377,2024-02-09,502,iphone 15 pro max,100000,135000,35000,1,21,India
903377,2024-02-09,504,iron,449,879,430,1,21,India
188097,2024-02-09,506,monitor,3249,8000,4751,1,107,India
188097,2024-02-09,503,mixer,1349,3249,1900,1,107,India
188097,2024-02-09,504,iron,449,879,430,1,107,India
188097,2024-02-09,507,washing machine,6990,16490,9500,1,107,India
844112,2024-02-09,502,iphone 15 pro max,100000,135000,35000,1,333,India
844112,2024-02-09,505,oven,18490,24000,5510,1,333,India
844112,2024-02-09,504,iron,449,879,430,1,333,India
844112,2024-02-09,501,iphone 15,60000,80000,20000,1,333,India
844112,2024-02-09,507,washing machine,6990,16490,9500,1,333,India
688772,2024-02-09,505,oven,18490,24000,5510,1,406,India
688772,2024-02-09,501,iphone 15,60000,80000,20000,1,406,India
688772,2024-02-09,504,iron,449,879,430,1,406,India
688772,2024-02-09,507,washing machine,6990,16490,9500,1,406,India
772706,2024-02-09,502,iphone 15 pro max,100000,135000,35000,1,477,India
772706,2024-02-09,506,monitor,3249,8000,4751,1,477,India
772706,2024-02-09,507,washing machine,6990,16490,9500,1,477,India
772706,2024-02-09,503,mixer,1349,3249,1900,1,477,India
523160,2024-02-09,501,iphone 15,60000,80000,20000,1,295,India
975338,2024-02-09,506,monitor,3249,8000,4751,1,267,India
145712,2024-02-09,503,mixer,1349,3249,1900,1,77,India
145712,2024-02-09,507,washing machine,6990,16490,9500,1,77,India
485799,2024-02-09,501,iphone 15,60000,80000,20000,1,307,India
499250,2024-02-09,501,iphone 15,60000,80000,20000,1,431,India
821407,2024-02-09,506,monitor,3249,8000,4751,1,456,India
821407,2024-02-09,504,iron,449,879,430,1,456,India
821407,2024-02-09,501,iphone 15,60000,80000,20000,1,456,India
821407,2024-02-09,505,oven,18490,24000,5510,1,456,India
957088,2024-02-09,504,iron,449,879,430,1,397,India
957088,2024-02-09,502,iphone 15 pro max,100000,135000,35000,1,397,India
593622,2024-02-09,501,iphone 15,60000,80000,20000,1,410,India
593622,2024-02-09,505,oven,18490,24000,5510,1,410,India
593622,2024-02-09,502,iphone 15 pro max,100000,135000,35000,1,410,India
823213,2024-02-09,501,iphone 15,60000,80000,20000,1,414,India
823213,2024-02-09,505,oven,18490,24000,5510,1,414,India
130442,2024-02-09,501,iphone 15,60000,80000,20000,1,88,India
130442,2024-02-09,507,washing machine,6990,16490,9500,1,88,India
435281,2024-02-09,506,monitor,3249,8000,4751,1,299,India
435281,2024-02-09,501,iphone 15,60000,80000,20000,1,299,India
435281,2024-02-09,507,washing machine,6990,16490,9500,1,299,India
701140,2024-02-09,502,iphone 15 pro max,100000,135000,35000,1,39,India
389330,2024-02-09,505,oven,18490,24000,5510,1,151,India
641088,2024-02-09,502,iphone 15 pro max,100000,135000,35000,1,263,India
775571,2024-02-09,505,oven,18490,24000,5510,1,60,India
775571,2024-02-09,502,iphone 15 pro max,100000,135000,35000,1,60,India
357293,2024-02-09,505,oven,18490,24000,5510,1,364,India
357293,2024-02-09,501,iphone 15,60000,80000,20000,1,364,India
302673,2024-02-09,502,iphone 15 pro max,100000,135000,35000,1,260,India
302673,2024-02-09,507,washing machine,6990,16490,9500,1,260,India
805326,2024-02-09,506,monitor,3249,8000,4751,1,180,India
805326,2024-02-09,501,iphone 15,60000,80000,20000,1,180,India
805326,2024-02-09,504,iron,449,879,430,1,180,India
148065,2024-02-09,507,washing machine,6990,16490,9500,1,95,India
148065,2024-02-09,501,iphone 15,60000,80000,20000,1,95,India
224543,2024-02-09,501,iphone 15,60000,80000,20000,1,333,India
224543,2024-02-09,506,monitor,3249,8000,4751,1,333,India
224543,2024-02-09,504,iron,449,879,430,1,333,India
224543,2024-02-09,503,mixer,1349,3249,1900,1,333,India
667417,2024-02-09,501,iphone 15,60000,80000,20000,1,273,India
667417,2024-02-09,506,monitor,3249,8000,4751,1,273,India
667417,2024-02-09,503,mixer,1349,3249,1900,1,273,India
104438,2024-02-09,506,monitor,3249,8000,4751,1,410,India
104438,2024-02-09,502,iphone 15 pro max,100000,135000,35000,1,410,India
104438,2024-02-09,501,iphone 15,60000,80000,20000,1,410,India
802746,2024-02-09,503,mixer,1349,3249,1900,1,63,India
802746,2024-02-09,505,oven,18490,24000,5510,1,63,India
802746,2024-02-09,504,iron,449,879,430,1,63,India
826657,2024-02-09,506,monitor,3249,8000,4751,1,482,India
826657,2024-02-09,502,iphone 15 pro max,100000,135000,35000,1,482,India
826657,2024-02-09,501,iphone 15,60000,80000,20000,1,482,India
353026,2024-02-09,502,iphone 15 pro max,100000,135000,35000,1,335,India
353026,2024-02-09,501,iphone 15,60000,80000,20000,1,335,India
353026,2024-02-09,505,oven,18490,24000,5510,1,335,India
375057,2024-02-09,504,iron,449,879,430,1,341,India
375057,2024-02-09,506,monitor,3249,8000,4751,1,341,India
375057,2024-02-09,505,oven,18490,24000,5510,1,341,India
375057,2024-02-09,507,washing machine,6990,16490,9500,1,341,India
827288,2024-02-09,502,iphone 15 pro max,100000,135000,35000,1,454,India
827288,2024-02-09,505,oven,18490,24000,5510,1,454,India
453960,2024-02-09,501,iphone 15,60000,80000,20000,1,126,India
453960,2024-02-09,502,iphone 15 pro max,100000,135000,35000,1,126,India
453960,2024-02-09,505,oven,18490,24000,5510,1,126,India
776337,2024-02-09,507,washing machine,6990,16490,9500,1,491,India
776337,2024-02-09,506,monitor,3249,8000,4751,1,491,India
776337,2024-02-09,503,mixer,1349,3249,1900,1,491,India
476908,2024-02-09,506,monitor,3249,8000,4751,1,422,India
476908,2024-02-09,505,oven,18490,24000,5510,1,422,India
476908,2024-02-09,507,washing machine,6990,16490,9500,1,422,India
476908,2024-02-09,501,iphone 15,60000,80000,20000,1,422,India
128206,2024-02-09,506,monitor,3249,8000,4751,1,281,India
128206,2024-02-09,504,iron,449,879,430,1,281,India
128206,2024-02-09,505,oven,18490,24000,5510,1,281,India
128206,2024-02-09,507,washing machine,6990,16490,9500,1,281,India
128206,2024-02-09,502,iphone 15 pro max,100000,135000,35000,1,281,India
491110,2024-02-09,506,monitor,3249,8000,4751,1,76,India
491110,2024-02-09,501,iphone 15,60000,80000,20000,1,76,India
491110,2024-02-09,502,iphone 15 pro max,100000,135000,35000,1,76,India
463844,2024-02-09,502,iphone 15 pro max,100000,135000,35000,1,238,India
463844,2024-02-09,507,washing machine,6990,16490,9500,1,238,India
463844,2024-02-09,504,iron,449,879,430,1,238,India
791621,2024-02-09,501,iphone 15,60000,80000,20000,1,137,India
966488,2024-02-09,507,washing machine,6990,16490,9500,1,87,India
698422,2024-02-09,506,monitor,3249,8000,4751,1,417,India
698422,2024-02-09,503,mixer,1349,3249,1900,1,417,India
698810,2024-02-09,503,mixer,1349,3249,1900,1,116,India
698810,2024-02-09,504,iron,449,879,430,1,116,India
698810,2024-02-09,506,monitor,3249,8000,4751,1,116,India
698810,2024-02-09,507,washing machine,6990,16490,9500,1,116,India
548919,2024-02-09,505,oven,18490,24000,5510,1,117,India
548919,2024-02-09,503,mixer,1349,3249,1900,1,117,India
548919,2024-02-09,507,washing machine,6990,16490,9500,1,117,India
548919,2024-02-09,506,monitor,3249,8000,4751,1,117,India
164132,2024-02-09,502,iphone 15 pro max,100000,135000,35000,1,488,India
966877,2024-02-09,504,iron,449,879,430,1,314,India
966877,2024-02-09,506,monitor,3249,8000,4751,1,314,India
189331,2024-02-09,506,monitor,3249,8000,4751,1,121,India
189331,2024-02-09,505,oven,18490,24000,5510,1,121,India
102240,2024-02-09,505,oven,18490,24000,5510,1,340,India
575661,2024-02-09,507,washing machine,6990,16490,9500,1,81,India
575661,2024-02-09,501,iphone 15,60000,80000,20000,1,81,India
575661,2024-02-09,502,iphone 15 pro max,100000,135000,35000,1,81,India
252260,2024-02-09,506,monitor,3249,8000,4751,1,430,India
483116,2024-02-09,501,iphone 15,60000,80000,20000,1,212,India
483116,2024-02-09,505,oven,18490,24000,5510,1,212,India
288678,2024-02-09,501,iphone 15,60000,80000,20000,1,379,India
288678,2024-02-09,506,monitor,3249,8000,4751,1,379,India
329812,2024-02-09,502,iphone 15 pro max,100000,135000,35000,1,126,India
329812,2024-02-09,505,oven,18490,24000,5510,1,126,India
329812,2024-02-09,504,iron,449,879,430,1,126,India
127273,2024-02-09,506,monitor,3249,8000,4751,1,382,India
127273,2024-02-09,502,iphone 15 pro max,100000,135000,35000,1,382,India
127273,2024-02-09,507,washing machine,6990,16490,9500,1,382,India
127273,2024-02-09,501,iphone 15,60000,80000,20000,1,382,India
905016,2024-02-09,501,iphone 15,60000,80000,20000,1,251,India
905016,2024-02-09,502,iphone 15 pro max,100000,135000,35000,1,251,India
905016,2024-02-09,506,monitor,3249,8000,4751,1,251,India
680350,2024-02-09,502,iphone 15 pro max,100000,135000,35000,1,184,India
680350,2024-02-09,506,monitor,3249,8000,4751,1,184,India
697602,2024-02-09,506,monitor,3249,8000,4751,1,259,India
697602,2024-02-09,502,iphone 15 pro max,100000,135000,35000,1,259,India
697602,2024-02-09,505,oven,18490,24000,5510,1,259,India
697602,2024-02-09,503,mixer,1349,3249,1900,1,259,India
338678,2024-02-09,502,iphone 15 pro max,100000,135000,35000,1,449,India
375602,2024-02-09,507,washing machine,6990,16490,9500,1,298,India
289951,2024-02-09,505,oven,18490,24000,5510,1,286,India
747249,2024-02-09,504,iron,449,879,430,1,4,India
747249,2024-02-09,501,iphone 15,60000,80000,20000,1,4,India
669251,2024-02-09,501,iphone 15,60000,80000,20000,1,493,India
669251,2024-02-09,504,iron,449,879,430,1,493,India
669251,2024-02-09,507,washing machine,6990,16490,9500,1,493,India
669251,2024-02-09,505,oven,18490,24000,5510,1,493,India
156995,2024-02-09,504,iron,449,879,430,1,16,India
156995,2024-02-09,507,washing machine,6990,16490,9500,1,16,India
156995,2024-02-09,502,iphone 15 pro max,100000,135000,35000,1,16,India
386863,2024-02-09,505,oven,18490,24000,5510,1,368,India
386863,2024-02-09,502,iphone 15 pro max,100000,135000,35000,1,368,India
994497,2024-02-09,504,iron,449,879,430,1,449,India
858784,2024-02-09,506,monitor,3249,8000,4751,1,450,India
858784,2024-02-09,502,iphone 15 pro max,100000,135000,35000,1,450,India
369599,2024-02-09,502,iphone 15 pro max,100000,135000,35000,1,308,India
369599,2024-02-09,507,washing machine,6990,16490,9500,1,308,India
369599,2024-02-09,501,iphone 15,60000,80000,20000,1,308,India
293143,2024-02-09,506,monitor,3249,8000,4751,1,393,India
293143,2024-02-09,503,mixer,1349,3249,1900,1,393,India
293143,2024-02-09,501,iphone 15,60000,80000,20000,1,393,India
468973,2024-02-09,502,iphone 15 pro max,100000,135000,35000,1,323,India
418630,2024-02-09,505,oven,18490,24000,5510,1,460,India
418630,2024-02-09,507,washing machine,6990,16490,9500,1,460,India
884259,2024-02-09,503,mixer,1349,3249,1900,1,277,India
433749,2024-02-09,503,mixer,1349,3249,1900,1,377,India
433749,2024-02-09,504,iron,449,879,430,1,377,India
870991,2024-02-09,503,mixer,1349,3249,1900,1,441,India
870991,2024-02-09,506,monitor,3249,8000,4751,1,441,India
957387,2024-02-10,504,iron,449,879,430,1,134,India
957387,2024-02-10,503,mixer,1349,3249,1900,1,134,India
957387,2024-02-10,502,iphone 15 pro max,100000,135000,35000,1,134,India
957387,2024-02-10,501,iphone 15,60000,80000,20000,1,134,India
419955,2024-02-10,505,oven,18490,24000,5510,1,467,India
419955,2024-02-10,503,mixer,1349,3249,1900,1,467,India
419955,2024-02-10,506,monitor,3249,8000,4751,1,467,India
419955,2024-02-10,507,washing machine,6990,16490,9500,1,467,India
443059,2024-02-10,507,washing machine,6990,16490,9500,1,250,India
443059,2024-02-10,502,iphone 15 pro max,100000,135000,35000,1,250,India
443059,2024-02-10,506,monitor,3249,8000,4751,1,250,India
938159,2024-02-10,507,washing machine,6990,16490,9500,1,487,India
938159,2024-02-10,506,monitor,3249,8000,4751,1,487,India
938159,2024-02-10,504,iron,449,879,430,1,487,India
938159,2024-02-10,505,oven,18490,24000,5510,1,487,India
206085,2024-02-10,505,oven,18490,24000,5510,1,432,India
206085,2024-02-10,507,washing machine,6990,16490,9500,1,432,India
206085,2024-02-10,504,iron,449,879,430,1,432,India
972865,2024-02-10,501,iphone 15,60000,80000,20000,1,385,India
972865,2024-02-10,506,monitor,3249,8000,4751,1,385,India
458133,2024-02-10,506,monitor,3249,8000,4751,1,245,India
458133,2024-02-10,507,washing machine,6990,16490,9500,1,245,India
458133,2024-02-10,503,mixer,1349,3249,1900,1,245,India
458133,2024-02-10,505,oven,18490,24000,5510,1,245,India
527483,2024-02-10,504,iron,449,879,430,1,408,India
105692,2024-02-10,505,oven,18490,24000,5510,1,487,India
105692,2024-02-10,506,monitor,3249,8000,4751,1,487,India
105692,2024-02-10,502,iphone 15 pro max,100000,135000,35000,1,487,India
167827,2024-02-10,507,washing machine,6990,16490,9500,1,377,India
167827,2024-02-10,504,iron,449,879,430,1,377,India
167827,2024-02-10,501,iphone 15,60000,80000,20000,1,377,India
170524,2024-02-10,506,monitor,3249,8000,4751,1,441,India
170524,2024-02-10,501,iphone 15,60000,80000,20000,1,441,India
170524,2024-02-10,504,iron,449,879,430,1,441,India
455246,2024-02-10,501,iphone 15,60000,80000,20000,1,491,India
455246,2024-02-10,505,oven,18490,24000,5510,1,491,India
392138,2024-02-10,507,washing machine,6990,16490,9500,1,169,India
392138,2024-02-10,505,oven,18490,24000,5510,1,169,India
174985,2024-02-10,506,monitor,3249,8000,4751,1,184,India
174985,2024-02-10,504,iron,449,879,430,1,184,India
174985,2024-02-10,507,washing machine,6990,16490,9500,1,184,India
519368,2024-02-10,506,monitor,3249,8000,4751,1,144,India
519368,2024-02-10,504,iron,449,879,430,1,144,India
519368,2024-02-10,505,oven,18490,24000,5510,1,144,India
519368,2024-02-10,507,washing machine,6990,16490,9500,1,144,India
962429,2024-02-10,502,iphone 15 pro max,100000,135000,35000,1,367,India
962429,2024-02-10,503,mixer,1349,3249,1900,1,367,India
962429,2024-02-10,505,oven,18490,24000,5510,1,367,India
857194,2024-02-10,507,washing machine,6990,16490,9500,1,467,India
857194,2024-02-10,503,mixer,1349,3249,1900,1,467,India
831403,2024-02-10,506,monitor,3249,8000,4751,1,281,India
831403,2024-02-10,505,oven,18490,24000,5510,1,281,India
831403,2024-02-10,503,mixer,1349,3249,1900,1,281,India
831403,2024-02-10,507,washing machine,6990,16490,9500,1,281,India
751933,2024-02-10,503,mixer,1349,3249,1900,1,402,India
751933,2024-02-10,507,washing machine,6990,16490,9500,1,402,India
751933,2024-02-10,502,iphone 15 pro max,100000,135000,35000,1,402,India
727016,2024-02-10,504,iron,449,879,430,1,351,India
727016,2024-02-10,505,oven,18490,24000,5510,1,351,India
301712,2024-02-10,505,oven,18490,24000,5510,1,43,India
301712,2024-02-10,503,mixer,1349,3249,1900,1,43,India
301712,2024-02-10,504,iron,449,879,430,1,43,India
887288,2024-02-10,502,iphone 15 pro max,100000,135000,35000,1,113,India
189550,2024-02-10,502,iphone 15 pro max,100000,135000,35000,1,273,India
189550,2024-02-10,505,oven,18490,24000,5510,1,273,India
501015,2024-02-10,506,monitor,3249,8000,4751,1,464,India
501015,2024-02-10,502,iphone 15 pro max,100000,135000,35000,1,464,India
556963,2024-02-10,503,mixer,1349,3249,1900,1,177,India
556963,2024-02-10,507,washing machine,6990,16490,9500,1,177,India
556963,2024-02-10,501,iphone 15,60000,80000,20000,1,177,India
795164,2024-02-10,503,mixer,1349,3249,1900,1,354,India
673531,2024-02-10,507,washing machine,6990,16490,9500,1,476,India
267090,2024-02-10,503,mixer,1349,3249,1900,1,383,India
401138,2024-02-10,501,iphone 15,60000,80000,20000,1,279,India
401138,2024-02-10,504,iron,449,879,430,1,279,India
401138,2024-02-10,503,mixer,1349,3249,1900,1,279,India
401138,2024-02-10,505,oven,18490,24000,5510,1,279,India
656479,2024-02-10,506,monitor,3249,8000,4751,1,293,India
656479,2024-02-10,507,washing machine,6990,16490,9500,1,293,India
128533,2024-02-10,503,mixer,1349,3249,1900,1,154,India
128533,2024-02-10,504,iron,449,879,430,1,154,India
441899,2024-02-10,505,oven,18490,24000,5510,1,436,India
441899,2024-02-10,506,monitor,3249,8000,4751,1,436,India
728216,2024-02-10,502,iphone 15 pro max,100000,135000,35000,1,469,India
331316,2024-02-10,504,iron,449,879,430,1,251,India
331316,2024-02-10,502,iphone 15 pro max,100000,135000,35000,1,251,India
331316,2024-02-10,507,washing machine,6990,16490,9500,1,251,India
331316,2024-02-10,503,mixer,1349,3249,1900,1,251,India
331316,2024-02-10,501,iphone 15,60000,80000,20000,1,251,India
421693,2024-02-10,505,oven,18490,24000,5510,1,200,India
421693,2024-02-10,507,washing machine,6990,16490,9500,1,200,India
428270,2024-02-10,504,iron,449,879,430,1,376,India
428270,2024-02-10,502,iphone 15 pro max,100000,135000,35000,1,376,India
428270,2024-02-10,505,oven,18490,24000,5510,1,376,India
371928,2024-02-10,503,mixer,1349,3249,1900,1,467,India
371928,2024-02-10,502,iphone 15 pro max,100000,135000,35000,1,467,India
371928,2024-02-10,504,iron,449,879,430,1,467,India
269108,2024-02-10,501,iphone 15,60000,80000,20000,1,363,India
269108,2024-02-10,505,oven,18490,24000,5510,1,363,India
899231,2024-02-10,505,oven,18490,24000,5510,1,67,India
361061,2024-02-10,501,iphone 15,60000,80000,20000,1,254,India
361061,2024-02-10,507,washing machine,6990,16490,9500,1,254,India
361061,2024-02-10,504,iron,449,879,430,1,254,India
186424,2024-02-10,507,washing machine,6990,16490,9500,1,464,India
186424,2024-02-10,503,mixer,1349,3249,1900,1,464,India
186424,2024-02-10,501,iphone 15,60000,80000,20000,1,464,India
158277,2024-02-10,504,iron,449,879,430,1,194,India
158277,2024-02-10,502,iphone 15 pro max,100000,135000,35000,1,194,India
473262,2024-02-10,507,washing machine,6990,16490,9500,1,54,India
473262,2024-02-10,502,iphone 15 pro max,100000,135000,35000,1,54,India
473262,2024-02-10,505,oven,18490,24000,5510,1,54,India
473262,2024-02-10,504,iron,449,879,430,1,54,India
267901,2024-02-10,501,iphone 15,60000,80000,20000,1,163,India
267901,2024-02-10,507,washing machine,6990,16490,9500,1,163,India
267901,2024-02-10,503,mixer,1349,3249,1900,1,163,India
267901,2024-02-10,502,iphone 15 pro max,100000,135000,35000,1,163,India
546809,2024-02-10,506,monitor,3249,8000,4751,1,58,India
546809,2024-02-10,503,mixer,1349,3249,1900,1,58,India
546809,2024-02-10,505,oven,18490,24000,5510,1,58,India
546809,2024-02-10,501,iphone 15,60000,80000,20000,1,58,India
189423,2024-02-10,502,iphone 15 pro max,100000,135000,35000,1,208,India
312018,2024-02-10,506,monitor,3249,8000,4751,1,34,India
312018,2024-02-10,505,oven,18490,24000,5510,1,34,India
312018,2024-02-10,502,iphone 15 pro max,100000,135000,35000,1,34,India
312018,2024-02-10,503,mixer,1349,3249,1900,1,34,India
859461,2024-02-10,502,iphone 15 pro max,100000,135000,35000,1,201,India
859461,2024-02-10,505,oven,18490,24000,5510,1,201,India
859461,2024-02-10,501,iphone 15,60000,80000,20000,1,201,India
440684,2024-02-10,504,iron,449,879,430,1,156,India
440684,2024-02-10,503,mixer,1349,3249,1900,1,156,India
889714,2024-02-10,504,iron,449,879,430,1,229,India
889714,2024-02-10,506,monitor,3249,8000,4751,1,229,India
320055,2024-02-10,503,mixer,1349,3249,1900,1,93,India
320055,2024-02-10,507,washing machine,6990,16490,9500,1,93,India
320055,2024-02-10,504,iron,449,879,430,1,93,India
614660,2024-02-10,504,iron,449,879,430,1,351,India
614660,2024-02-10,503,mixer,1349,3249,1900,1,351,India
403928,2024-02-10,501,iphone 15,60000,80000,20000,1,44,India
403928,2024-02-10,506,monitor,3249,8000,4751,1,44,India
616896,2024-02-10,502,iphone 15 pro max,100000,135000,35000,1,17,India
616896,2024-02-10,506,monitor,3249,8000,4751,1,17,India
616896,2024-02-10,507,washing machine,6990,16490,9500,1,17,India
616896,2024-02-10,501,iphone 15,60000,80000,20000,1,17,India
616896,2024-02-10,504,iron,449,879,430,1,17,India
605353,2024-02-10,506,monitor,3249,8000,4751,1,39,India
500783,2024-02-10,501,iphone 15,60000,80000,20000,1,221,India
500783,2024-02-10,505,oven,18490,24000,5510,1,221,India
500783,2024-02-10,503,mixer,1349,3249,1900,1,221,India
198732,2024-02-10,501,iphone 15,60000,80000,20000,1,481,India
198732,2024-02-10,507,washing machine,6990,16490,9500,1,481,India
240614,2024-02-10,503,mixer,1349,3249,1900,1,304,India
446673,2024-02-10,506,monitor,3249,8000,4751,1,332,India
446673,2024-02-10,501,iphone 15,60000,80000,20000,1,332,India
446673,2024-02-10,502,iphone 15 pro max,100000,135000,35000,1,332,India
821383,2024-02-10,505,oven,18490,24000,5510,1,376,India
203302,2024-02-10,504,iron,449,879,430,1,424,India
278229,2024-02-10,502,iphone 15 pro max,100000,135000,35000,1,316,India
278229,2024-02-10,505,oven,18490,24000,5510,1,316,India
278229,2024-02-10,506,monitor,3249,8000,4751,1,316,India
492945,2024-02-10,504,iron,449,879,430,1,476,India
856069,2024-02-10,505,oven,18490,24000,5510,1,313,India
856069,2024-02-10,501,iphone 15,60000,80000,20000,1,313,India
856069,2024-02-10,502,iphone 15 pro max,100000,135000,35000,1,313,India
856069,2024-02-10,504,iron,449,879,430,1,313,India
520835,2024-02-10,504,iron,449,879,430,1,374,India
106898,2024-02-10,505,oven,18490,24000,5510,1,302,India
106898,2024-02-10,507,washing machine,6990,16490,9500,1,302,India
166147,2024-02-10,506,monitor,3249,8000,4751,1,262,India
166147,2024-02-10,501,iphone 15,60000,80000,20000,1,262,India
166147,2024-02-10,503,mixer,1349,3249,1900,1,262,India
166147,2024-02-10,507,washing machine,6990,16490,9500,1,262,India
166147,2024-02-10,504,iron,449,879,430,1,262,India
317671,2024-02-10,502,iphone 15 pro max,100000,135000,35000,1,376,India
317671,2024-02-10,504,iron,449,879,430,1,376,India
598690,2024-02-10,503,mixer,1349,3249,1900,1,17,India
598690,2024-02-10,505,oven,18490,24000,5510,1,17,India
598690,2024-02-10,506,monitor,3249,8000,4751,1,17,India
336752,2024-02-10,505,oven,18490,24000,5510,1,47,India
525909,2024-02-10,502,iphone 15 pro max,100000,135000,35000,1,252,India
525909,2024-02-10,507,washing machine,6990,16490,9500,1,252,India
525909,2024-02-10,504,iron,449,879,430,1,252,India
525909,2024-02-10,501,iphone 15,60000,80000,20000,1,252,India
328877,2024-02-10,507,washing machine,6990,16490,9500,1,428,India
328877,2024-02-10,502,iphone 15 pro max,100000,135000,35000,1,428,India
328877,2024-02-10,501,iphone 15,60000,80000,20000,1,428,India
585800,2024-02-10,506,monitor,3249,8000,4751,1,193,India
585800,2024-02-10,505,oven,18490,24000,5510,1,193,India
239849,2024-02-10,503,mixer,1349,3249,1900,1,304,India
239849,2024-02-10,506,monitor,3249,8000,4751,1,304,India
239849,2024-02-10,501,iphone 15,60000,80000,20000,1,304,India
239849,2024-02-10,504,iron,449,879,430,1,304,India
632350,2024-02-10,504,iron,449,879,430,1,57,India
632350,2024-02-10,506,monitor,3249,8000,4751,1,57,India
238071,2024-02-10,502,iphone 15 pro max,100000,135000,35000,1,294,India
238071,2024-02-10,501,iphone 15,60000,80000,20000,1,294,India
238071,2024-02-10,506,monitor,3249,8000,4751,1,294,India
884490,2024-02-10,507,washing machine,6990,16490,9500,1,362,India
496155,2024-02-10,502,iphone 15 pro max,100000,135000,35000,1,390,India
496155,2024-02-10,507,washing machine,6990,16490,9500,1,390,India
496155,2024-02-10,501,iphone 15,60000,80000,20000,1,390,India
496155,2024-02-10,506,monitor,3249,8000,4751,1,390,India
615209,2024-02-10,502,iphone 15 pro max,100000,135000,35000,1,35,India
615209,2024-02-10,501,iphone 15,60000,80000,20000,1,35,India
615209,2024-02-10,503,mixer,1349,3249,1900,1,35,India
309631,2024-02-10,504,iron,449,879,430,1,451,India
949282,2024-02-10,507,washing machine,6990,16490,9500,1,145,India
182435,2024-02-10,504,iron,449,879,430,1,212,India
182435,2024-02-10,502,iphone 15 pro max,100000,135000,35000,1,212,India
182435,2024-02-10,501,iphone 15,60000,80000,20000,1,212,India
922994,2024-02-10,504,iron,449,879,430,1,195,India
922994,2024-02-10,501,iphone 15,60000,80000,20000,1,195,India
922994,2024-02-10,503,mixer,1349,3249,1900,1,195,India
858048,2024-02-10,505,oven,18490,24000,5510,1,261,India
858048,2024-02-10,502,iphone 15 pro max,100000,135000,35000,1,261,India
858048,2024-02-10,506,monitor,3249,8000,4751,1,261,India
858048,2024-02-10,501,iphone 15,60000,80000,20000,1,261,India
858048,2024-02-10,503,mixer,1349,3249,1900,1,261,India
739633,2024-02-10,501,iphone 15,60000,80000,20000,1,305,India
739633,2024-02-10,503,mixer,1349,3249,1900,1,305,India
739633,2024-02-10,505,oven,18490,24000,5510,1,305,India
739633,2024-02-10,506,monitor,3249,8000,4751,1,305,India
583884,2024-02-10,506,monitor,3249,8000,4751,1,378,India
583884,2024-02-10,507,washing machine,6990,16490,9500,1,378,India
767163,2024-02-10,503,mixer,1349,3249,1900,1,257,India
767163,2024-02-10,504,iron,449,879,430,1,257,India
767163,2024-02-10,507,washing machine,6990,16490,9500,1,257,India
518847,2024-02-10,506,monitor,3249,8000,4751,1,306,India
388467,2024-02-10,503,mixer,1349,3249,1900,1,467,India
388467,2024-02-10,505,oven,18490,24000,5510,1,467,India
388467,2024-02-10,502,iphone 15 pro max,100000,135000,35000,1,467,India
388467,2024-02-10,507,washing machine,6990,16490,9500,1,467,India
831302,2024-02-10,505,oven,18490,24000,5510,1,264,India
670853,2024-02-10,501,iphone 15,60000,80000,20000,1,447,India
670853,2024-02-10,504,iron,449,879,430,1,447,India
348040,2024-02-10,507,washing machine,6990,16490,9500,1,111,India
348040,2024-02-10,505,oven,18490,24000,5510,1,111,India
348040,2024-02-10,501,iphone 15,60000,80000,20000,1,111,India
798369,2024-02-10,507,washing machine,6990,16490,9500,1,103,India
798369,2024-02-10,506,monitor,3249,8000,4751,1,103,India
559104,2024-02-10,505,oven,18490,24000,5510,1,351,India
559104,2024-02-10,503,mixer,1349,3249,1900,1,351,India
488383,2024-02-11,503,mixer,1349,3249,1900,1,20,India
328525,2024-02-11,504,iron,449,879,430,1,366,India
328525,2024-02-11,502,iphone 15 pro max,100000,135000,35000,1,366,India
570188,2024-02-11,501,iphone 15,60000,80000,20000,1,485,India
570188,2024-02-11,507,washing machine,6990,16490,9500,1,485,India
570188,2024-02-11,503,mixer,1349,3249,1900,1,485,India
246399,2024-02-11,505,oven,18490,24000,5510,1,74,India
246399,2024-02-11,506,monitor,3249,8000,4751,1,74,India
154629,2024-02-11,505,oven,18490,24000,5510,1,188,India
644963,2024-02-11,501,iphone 15,60000,80000,20000,1,111,India
644963,2024-02-11,504,iron,449,879,430,1,111,India
644963,2024-02-11,503,mixer,1349,3249,1900,1,111,India
644963,2024-02-11,506,monitor,3249,8000,4751,1,111,India
738584,2024-02-11,504,iron,449,879,430,1,493,India
424106,2024-02-11,501,iphone 15,60000,80000,20000,1,382,India
109712,2024-02-11,501,iphone 15,60000,80000,20000,1,463,India
109712,2024-02-11,503,mixer,1349,3249,1900,1,463,India
109712,2024-02-11,505,oven,18490,24000,5510,1,463,India
109712,2024-02-11,504,iron,449,879,430,1,463,India
109712,2024-02-11,507,washing machine,6990,16490,9500,1,463,India
394796,2024-02-11,505,oven,18490,24000,5510,1,259,India
394796,2024-02-11,503,mixer,1349,3249,1900,1,259,India
394796,2024-02-11,506,monitor,3249,8000,4751,1,259,India
597543,2024-02-11,505,oven,18490,24000,5510,1,172,India
597543,2024-02-11,506,monitor,3249,8000,4751,1,172,India
421571,2024-02-11,501,iphone 15,60000,80000,20000,1,243,India
421571,2024-02-11,505,oven,18490,24000,5510,1,243,India
421571,2024-02-11,503,mixer,1349,3249,1900,1,243,India
539492,2024-02-11,501,iphone 15,60000,80000,20000,1,196,India
539492,2024-02-11,505,oven,18490,24000,5510,1,196,India
539492,2024-02-11,503,mixer,1349,3249,1900,1,196,India
539492,2024-02-11,507,washing machine,6990,16490,9500,1,196,India
300519,2024-02-11,506,monitor,3249,8000,4751,1,80,India
300519,2024-02-11,503,mixer,1349,3249,1900,1,80,India
300519,2024-02-11,504,iron,449,879,430,1,80,India
971093,2024-02-11,503,mixer,1349,3249,1900,1,221,India
971093,2024-02-11,506,monitor,3249,8000,4751,1,221,India
925523,2024-02-11,507,washing machine,6990,16490,9500,1,180,India
209126,2024-02-11,506,monitor,3249,8000,4751,1,491,India
707035,2024-02-11,506,monitor,3249,8000,4751,1,78,India
707035,2024-02-11,505,oven,18490,24000,5510,1,78,India
707035,2024-02-11,503,mixer,1349,3249,1900,1,78,India
707035,2024-02-11,507,washing machine,6990,16490,9500,1,78,India
967352,2024-02-11,505,oven,18490,24000,5510,1,401,India
967352,2024-02-11,502,iphone 15 pro max,100000,135000,35000,1,401,India
701392,2024-02-11,505,oven,18490,24000,5510,1,291,India
701392,2024-02-11,501,iphone 15,60000,80000,20000,1,291,India
880481,2024-02-11,504,iron,449,879,430,1,126,India
880481,2024-02-11,507,washing machine,6990,16490,9500,1,126,India
880481,2024-02-11,506,monitor,3249,8000,4751,1,126,India
880481,2024-02-11,505,oven,18490,24000,5510,1,126,India
588133,2024-02-11,504,iron,449,879,430,1,402,India
588133,2024-02-11,503,mixer,1349,3249,1900,1,402,India
588133,2024-02-11,506,monitor,3249,8000,4751,1,402,India
588133,2024-02-11,501,iphone 15,60000,80000,20000,1,402,India
905193,2024-02-11,505,oven,18490,24000,5510,1,393,India
145774,2024-02-11,505,oven,18490,24000,5510,1,247,India
662027,2024-02-11,507,washing machine,6990,16490,9500,1,366,India
662027,2024-02-11,504,iron,449,879,430,1,366,India
662027,2024-02-11,506,monitor,3249,8000,4751,1,366,India
315364,2024-02-11,504,iron,449,879,430,1,276,India
315364,2024-02-11,507,washing machine,6990,16490,9500,1,276,India
145616,2024-02-11,505,oven,18490,24000,5510,1,482,India
802703,2024-02-11,501,iphone 15,60000,80000,20000,1,199,India
802703,2024-02-11,504,iron,449,879,430,1,199,India
901508,2024-02-11,507,washing machine,6990,16490,9500,1,38,India
901508,2024-02-11,505,oven,18490,24000,5510,1,38,India
901508,2024-02-11,502,iphone 15 pro max,100000,135000,35000,1,38,India
494579,2024-02-11,504,iron,449,879,430,1,31,India
494579,2024-02-11,501,iphone 15,60000,80000,20000,1,31,India
494579,2024-02-11,507,washing machine,6990,16490,9500,1,31,India
494579,2024-02-11,503,mixer,1349,3249,1900,1,31,India
494579,2024-02-11,505,oven,18490,24000,5510,1,31,India
640030,2024-02-11,502,iphone 15 pro max,100000,135000,35000,1,239,India
640030,2024-02-11,503,mixer,1349,3249,1900,1,239,India
640030,2024-02-11,501,iphone 15,60000,80000,20000,1,239,India
265248,2024-02-11,506,monitor,3249,8000,4751,1,324,India
967937,2024-02-11,503,mixer,1349,3249,1900,1,46,India
967937,2024-02-11,505,oven,18490,24000,5510,1,46,India
967937,2024-02-11,504,iron,449,879,430,1,46,India
967937,2024-02-11,506,monitor,3249,8000,4751,1,46,India
982567,2024-02-11,505,oven,18490,24000,5510,1,264,India
982567,2024-02-11,504,iron,449,879,430,1,264,India
683668,2024-02-11,503,mixer,1349,3249,1900,1,337,India
683668,2024-02-11,504,iron,449,879,430,1,337,India
683668,2024-02-11,505,oven,18490,24000,5510,1,337,India
683668,2024-02-11,507,washing machine,6990,16490,9500,1,337,India
880496,2024-02-11,507,washing machine,6990,16490,9500,1,499,India
880496,2024-02-11,501,iphone 15,60000,80000,20000,1,499,India
125193,2024-02-11,506,monitor,3249,8000,4751,1,78,India
125193,2024-02-11,501,iphone 15,60000,80000,20000,1,78,India
125193,2024-02-11,507,washing machine,6990,16490,9500,1,78,India
125193,2024-02-11,502,iphone 15 pro max,100000,135000,35000,1,78,India
257890,2024-02-11,503,mixer,1349,3249,1900,1,14,India
257890,2024-02-11,507,washing machine,6990,16490,9500,1,14,India
257890,2024-02-11,504,iron,449,879,430,1,14,India
325504,2024-02-11,503,mixer,1349,3249,1900,1,36,India
325504,2024-02-11,504,iron,449,879,430,1,36,India
325504,2024-02-11,502,iphone 15 pro max,100000,135000,35000,1,36,India
325504,2024-02-11,506,monitor,3249,8000,4751,1,36,India
325504,2024-02-11,505,oven,18490,24000,5510,1,36,India
531733,2024-02-11,501,iphone 15,60000,80000,20000,1,404,India
177542,2024-02-11,507,washing machine,6990,16490,9500,1,364,India
177542,2024-02-11,502,iphone 15 pro max,100000,135000,35000,1,364,India
177542,2024-02-11,505,oven,18490,24000,5510,1,364,India
729836,2024-02-11,503,mixer,1349,3249,1900,1,146,India
702905,2024-02-11,503,mixer,1349,3249,1900,1,451,India
702905,2024-02-11,504,iron,449,879,430,1,451,India
824327,2024-02-11,504,iron,449,879,430,1,14,India
561976,2024-02-11,504,iron,449,879,430,1,107,India
561976,2024-02-11,501,iphone 15,60000,80000,20000,1,107,India
561976,2024-02-11,503,mixer,1349,3249,1900,1,107,India
561976,2024-02-11,507,washing machine,6990,16490,9500,1,107,India
157451,2024-02-11,505,oven,18490,24000,5510,1,404,India
157451,2024-02-11,507,washing machine,6990,16490,9500,1,404,India
157451,2024-02-11,501,iphone 15,60000,80000,20000,1,404,India
157451,2024-02-11,504,iron,449,879,430,1,404,India
555837,2024-02-11,502,iphone 15 pro max,100000,135000,35000,1,280,India
637224,2024-02-11,503,mixer,1349,3249,1900,1,253,India
637224,2024-02-11,505,oven,18490,24000,5510,1,253,India
902724,2024-02-11,506,monitor,3249,8000,4751,1,192,India
902724,2024-02-11,505,oven,18490,24000,5510,1,192,India
902724,2024-02-11,501,iphone 15,60000,80000,20000,1,192,India
902724,2024-02-11,503,mixer,1349,3249,1900,1,192,India
486267,2024-02-11,501,iphone 15,60000,80000,20000,1,139,India
486267,2024-02-11,504,iron,449,879,430,1,139,India
486267,2024-02-11,506,monitor,3249,8000,4751,1,139,India
514052,2024-02-11,501,iphone 15,60000,80000,20000,1,246,India
514052,2024-02-11,504,iron,449,879,430,1,246,India
416418,2024-02-11,504,iron,449,879,430,1,171,India
416418,2024-02-11,503,mixer,1349,3249,1900,1,171,India
416418,2024-02-11,502,iphone 15 pro max,100000,135000,35000,1,171,India
416418,2024-02-11,506,monitor,3249,8000,4751,1,171,India
416418,2024-02-11,501,iphone 15,60000,80000,20000,1,171,India
405901,2024-02-11,503,mixer,1349,3249,1900,1,401,India
405901,2024-02-11,506,monitor,3249,8000,4751,1,401,India
510822,2024-02-11,502,iphone 15 pro max,100000,135000,35000,1,322,India
510822,2024-02-11,507,washing machine,6990,16490,9500,1,322,India
510822,2024-02-11,506,monitor,3249,8000,4751,1,322,India
142789,2024-02-11,504,iron,449,879,430,1,142,India
142789,2024-02-11,505,oven,18490,24000,5510,1,142,India
595235,2024-02-11,506,monitor,3249,8000,4751,1,483,India
595235,2024-02-11,504,iron,449,879,430,1,483,India
595235,2024-02-11,501,iphone 15,60000,80000,20000,1,483,India
595235,2024-02-11,507,washing machine,6990,16490,9500,1,483,India
595235,2024-02-11,502,iphone 15 pro max,100000,135000,35000,1,483,India
336735,2024-02-11,505,oven,18490,24000,5510,1,478,India
336735,2024-02-11,503,mixer,1349,3249,1900,1,478,India
336735,2024-02-11,502,iphone 15 pro max,100000,135000,35000,1,478,India
336735,2024-02-11,506,monitor,3249,8000,4751,1,478,India
845770,2024-02-11,502,iphone 15 pro max,100000,135000,35000,1,109,India
845770,2024-02-11,504,iron,449,879,430,1,109,India
672428,2024-02-11,504,iron,449,879,430,1,230,India
672428,2024-02-11,501,iphone 15,60000,80000,20000,1,230,India
672428,2024-02-11,506,monitor,3249,8000,4751,1,230,India
652888,2024-02-11,506,monitor,3249,8000,4751,1,390,India
838464,2024-02-11,507,washing machine,6990,16490,9500,1,433,India
838464,2024-02-11,504,iron,449,879,430,1,433,India
838464,2024-02-11,505,oven,18490,24000,5510,1,433,India
733664,2024-02-11,503,mixer,1349,3249,1900,1,299,India
235035,2024-02-11,502,iphone 15 pro max,100000,135000,35000,1,319,India
235035,2024-02-11,505,oven,18490,24000,5510,1,319,India
235035,2024-02-11,506,monitor,3249,8000,4751,1,319,India
955020,2024-02-11,505,oven,18490,24000,5510,1,402,India
955020,2024-02-11,506,monitor,3249,8000,4751,1,402,India
549913,2024-02-11,503,mixer,1349,3249,1900,1,21,India
549913,2024-02-11,502,iphone 15 pro max,100000,135000,35000,1,21,India
549913,2024-02-11,506,monitor,3249,8000,4751,1,21,India
784082,2024-02-11,501,iphone 15,60000,80000,20000,1,369,India
784082,2024-02-11,503,mixer,1349,3249,1900,1,369,India
784082,2024-02-11,505,oven,18490,24000,5510,1,369,India
458783,2024-02-11,504,iron,449,879,430,1,258,India
458783,2024-02-11,502,iphone 15 pro max,100000,135000,35000,1,258,India
717312,2024-02-11,501,iphone 15,60000,80000,20000,1,148,India
717312,2024-02-11,506,monitor,3249,8000,4751,1,148,India
717312,2024-02-11,502,iphone 15 pro max,100000,135000,35000,1,148,India
524656,2024-02-11,506,monitor,3249,8000,4751,1,191,India
267143,2024-02-11,501,iphone 15,60000,80000,20000,1,12,India
267143,2024-02-11,502,iphone 15 pro max,100000,135000,35000,1,12,India
267143,2024-02-11,504,iron,449,879,430,1,12,India
399577,2024-02-11,507,washing machine,6990,16490,9500,1,373,India
484017,2024-02-12,505,oven,18490,24000,5510,1,476,India
303283,2024-02-12,503,mixer,1349,3249,1900,1,465,India
303283,2024-02-12,501,iphone 15,60000,80000,20000,1,465,India
303283,2024-02-12,506,monitor,3249,8000,4751,1,465,India
949680,2024-02-12,501,iphone 15,60000,80000,20000,1,483,India
949680,2024-02-12,504,iron,449,879,430,1,483,India
949680,2024-02-12,506,monitor,3249,8000,4751,1,483,India
709925,2024-02-12,505,oven,18490,24000,5510,1,121,India
709925,2024-02-12,507,washing machine,6990,16490,9500,1,121,India
709925,2024-02-12,504,iron,449,879,430,1,121,India
641856,2024-02-12,501,iphone 15,60000,80000,20000,1,368,India
641856,2024-02-12,505,oven,18490,24000,5510,1,368,India
641856,2024-02-12,502,iphone 15 pro max,100000,135000,35000,1,368,India
641856,2024-02-12,503,mixer,1349,3249,1900,1,368,India
641856,2024-02-12,507,washing machine,6990,16490,9500,1,368,India
273560,2024-02-12,503,mixer,1349,3249,1900,1,170,India
452794,2024-02-12,506,monitor,3249,8000,4751,1,444,India
452794,2024-02-12,501,iphone 15,60000,80000,20000,1,444,India
452794,2024-02-12,507,washing machine,6990,16490,9500,1,444,India
478408,2024-02-12,506,monitor,3249,8000,4751,1,37,India
478408,2024-02-12,504,iron,449,879,430,1,37,India
478408,2024-02-12,507,washing machine,6990,16490,9500,1,37,India
478408,2024-02-12,502,iphone 15 pro max,100000,135000,35000,1,37,India
298574,2024-02-12,504,iron,449,879,430,1,169,India
298574,2024-02-12,505,oven,18490,24000,5510,1,169,India
298574,2024-02-12,506,monitor,3249,8000,4751,1,169,India
148689,2024-02-12,507,washing machine,6990,16490,9500,1,166,India
148689,2024-02-12,504,iron,449,879,430,1,166,India
148689,2024-02-12,501,iphone 15,60000,80000,20000,1,166,India
460982,2024-02-12,504,iron,449,879,430,1,246,India
460982,2024-02-12,506,monitor,3249,8000,4751,1,246,India
460982,2024-02-12,502,iphone 15 pro max,100000,135000,35000,1,246,India
460982,2024-02-12,505,oven,18490,24000,5510,1,246,India
674828,2024-02-12,505,oven,18490,24000,5510,1,347,India
674828,2024-02-12,502,iphone 15 pro max,100000,135000,35000,1,347,India
674828,2024-02-12,503,mixer,1349,3249,1900,1,347,India
575858,2024-02-12,501,iphone 15,60000,80000,20000,1,86,India
575858,2024-02-12,507,washing machine,6990,16490,9500,1,86,India
232812,2024-02-12,502,iphone 15 pro max,100000,135000,35000,1,446,India
232812,2024-02-12,505,oven,18490,24000,5510,1,446,India
232812,2024-02-12,507,washing machine,6990,16490,9500,1,446,India
232812,2024-02-12,506,monitor,3249,8000,4751,1,446,India
930882,2024-02-12,503,mixer,1349,3249,1900,1,85,India
902317,2024-02-12,502,iphone 15 pro max,100000,135000,35000,1,26,India
902317,2024-02-12,507,washing machine,6990,16490,9500,1,26,India
902317,2024-02-12,501,iphone 15,60000,80000,20000,1,26,India
902317,2024-02-12,505,oven,18490,24000,5510,1,26,India
914642,2024-02-12,506,monitor,3249,8000,4751,1,3,India
914642,2024-02-12,504,iron,449,879,430,1,3,India
914642,2024-02-12,502,iphone 15 pro max,100000,135000,35000,1,3,India
914642,2024-02-12,503,mixer,1349,3249,1900,1,3,India
740599,2024-02-12,503,mixer,1349,3249,1900,1,263,India
740599,2024-02-12,502,iphone 15 pro max,100000,135000,35000,1,263,India
257993,2024-02-12,503,mixer,1349,3249,1900,1,183,India
257993,2024-02-12,501,iphone 15,60000,80000,20000,1,183,India
257993,2024-02-12,506,monitor,3249,8000,4751,1,183,India
894191,2024-02-12,506,monitor,3249,8000,4751,1,397,India
894191,2024-02-12,505,oven,18490,24000,5510,1,397,India
135920,2024-02-12,501,iphone 15,60000,80000,20000,1,395,India
135920,2024-02-12,503,mixer,1349,3249,1900,1,395,India
135920,2024-02-12,506,monitor,3249,8000,4751,1,395,India
135920,2024-02-12,505,oven,18490,24000,5510,1,395,India
135920,2024-02-12,507,washing machine,6990,16490,9500,1,395,India
744347,2024-02-12,502,iphone 15 pro max,100000,135000,35000,1,499,India
744347,2024-02-12,503,mixer,1349,3249,1900,1,499,India
211135,2024-02-12,502,iphone 15 pro max,100000,135000,35000,1,204,India
211135,2024-02-12,503,mixer,1349,3249,1900,1,204,India
211135,2024-02-12,501,iphone 15,60000,80000,20000,1,204,India
211135,2024-02-12,505,oven,18490,24000,5510,1,204,India
981465,2024-02-12,506,monitor,3249,8000,4751,1,188,India
981465,2024-02-12,504,iron,449,879,430,1,188,India
981465,2024-02-12,505,oven,18490,24000,5510,1,188,India
828250,2024-02-12,504,iron,449,879,430,1,461,India
602442,2024-02-12,507,washing machine,6990,16490,9500,1,341,India
602442,2024-02-12,502,iphone 15 pro max,100000,135000,35000,1,341,India
602442,2024-02-12,503,mixer,1349,3249,1900,1,341,India
602442,2024-02-12,506,monitor,3249,8000,4751,1,341,India
443501,2024-02-12,502,iphone 15 pro max,100000,135000,35000,1,481,India
994616,2024-02-12,504,iron,449,879,430,1,271,India
994616,2024-02-12,502,iphone 15 pro max,100000,135000,35000,1,271,India
994616,2024-02-12,503,mixer,1349,3249,1900,1,271,India
755301,2024-02-12,505,oven,18490,24000,5510,1,334,India
533970,2024-02-12,503,mixer,1349,3249,1900,1,67,India
283247,2024-02-12,507,washing machine,6990,16490,9500,1,497,India
283247,2024-02-12,503,mixer,1349,3249,1900,1,497,India
800006,2024-02-12,507,washing machine,6990,16490,9500,1,57,India
800006,2024-02-12,505,oven,18490,24000,5510,1,57,India
800006,2024-02-12,501,iphone 15,60000,80000,20000,1,57,India
893659,2024-02-12,505,oven,18490,24000,5510,1,86,India
321480,2024-02-12,505,oven,18490,24000,5510,1,52,India
884666,2024-02-12,504,iron,449,879,430,1,58,India
884666,2024-02-12,505,oven,18490,24000,5510,1,58,India
884666,2024-02-12,503,mixer,1349,3249,1900,1,58,India
884666,2024-02-12,502,iphone 15 pro max,100000,135000,35000,1,58,India
532491,2024-02-12,506,monitor,3249,8000,4751,1,348,India
532491,2024-02-12,501,iphone 15,60000,80000,20000,1,348,India
211629,2024-02-12,503,mixer,1349,3249,1900,1,383,India
211629,2024-02-12,504,iron,449,879,430,1,383,India
211629,2024-02-12,502,iphone 15 pro max,100000,135000,35000,1,383,India
395521,2024-02-12,504,iron,449,879,430,1,10,India
395521,2024-02-12,503,mixer,1349,3249,1900,1,10,India
395521,2024-02-12,507,washing machine,6990,16490,9500,1,10,India
299632,2024-02-12,502,iphone 15 pro max,100000,135000,35000,1,65,India
299632,2024-02-12,504,iron,449,879,430,1,65,India
299632,2024-02-12,507,washing machine,6990,16490,9500,1,65,India
299632,2024-02-12,501,iphone 15,60000,80000,20000,1,65,India
299632,2024-02-12,505,oven,18490,24000,5510,1,65,India
217332,2024-02-12,507,washing machine,6990,16490,9500,1,1,India
217332,2024-02-12,506,monitor,3249,8000,4751,1,1,India
217332,2024-02-12,501,iphone 15,60000,80000,20000,1,1,India
217332,2024-02-12,504,iron,449,879,430,1,1,India
696434,2024-02-12,501,iphone 15,60000,80000,20000,1,407,India
696434,2024-02-12,503,mixer,1349,3249,1900,1,407,India
696434,2024-02-12,502,iphone 15 pro max,100000,135000,35000,1,407,India
370410,2024-02-12,506,monitor,3249,8000,4751,1,413,India
370410,2024-02-12,501,iphone 15,60000,80000,20000,1,413,India
370410,2024-02-12,504,iron,449,879,430,1,413,India
370410,2024-02-12,507,washing machine,6990,16490,9500,1,413,India
334162,2024-02-12,505,oven,18490,24000,5510,1,424,India
334162,2024-02-12,502,iphone 15 pro max,100000,135000,35000,1,424,India
334162,2024-02-12,501,iphone 15,60000,80000,20000,1,424,India
207721,2024-02-12,505,oven,18490,24000,5510,1,260,India
577690,2024-02-12,506,monitor,3249,8000,4751,1,22,India
577690,2024-02-12,507,washing machine,6990,16490,9500,1,22,India
577690,2024-02-12,504,iron,449,879,430,1,22,India
577690,2024-02-12,505,oven,18490,24000,5510,1,22,India
798328,2024-02-12,504,iron,449,879,430,1,463,India
840917,2024-02-12,506,monitor,3249,8000,4751,1,478,India
840917,2024-02-12,503,mixer,1349,3249,1900,1,478,India
108405,2024-02-12,506,monitor,3249,8000,4751,1,158,India
108405,2024-02-12,505,oven,18490,24000,5510,1,158,India
782762,2024-02-12,503,mixer,1349,3249,1900,1,453,India
782762,2024-02-12,506,monitor,3249,8000,4751,1,453,India
782762,2024-02-12,504,iron,449,879,430,1,453,India
870829,2024-02-12,503,mixer,1349,3249,1900,1,111,India
870829,2024-02-12,501,iphone 15,60000,80000,20000,1,111,India
870829,2024-02-12,504,iron,449,879,430,1,111,India
696850,2024-02-12,502,iphone 15 pro max,100000,135000,35000,1,500,India
696850,2024-02-12,506,monitor,3249,8000,4751,1,500,India
696850,2024-02-12,505,oven,18490,24000,5510,1,500,India
696850,2024-02-12,507,washing machine,6990,16490,9500,1,500,India
380290,2024-02-12,507,washing machine,6990,16490,9500,1,433,India
380290,2024-02-12,506,monitor,3249,8000,4751,1,433,India
160237,2024-02-12,503,mixer,1349,3249,1900,1,393,India
160237,2024-02-12,504,iron,449,879,430,1,393,India
160237,2024-02-12,507,washing machine,6990,16490,9500,1,393,India
160237,2024-02-12,505,oven,18490,24000,5510,1,393,India
160237,2024-02-12,502,iphone 15 pro max,100000,135000,35000,1,393,India
963677,2024-02-12,504,iron,449,879,430,1,421,India
963677,2024-02-12,505,oven,18490,24000,5510,1,421,India
518361,2024-02-12,503,mixer,1349,3249,1900,1,327,India
221987,2024-02-12,504,iron,449,879,430,1,223,India
221987,2024-02-12,502,iphone 15 pro max,100000,135000,35000,1,223,India
221987,2024-02-12,506,monitor,3249,8000,4751,1,223,India
687368,2024-02-12,501,iphone 15,60000,80000,20000,1,325,India
687368,2024-02-12,504,iron,449,879,430,1,325,India
687368,2024-02-12,503,mixer,1349,3249,1900,1,325,India
573308,2024-02-12,504,iron,449,879,430,1,437,India
573308,2024-02-12,507,washing machine,6990,16490,9500,1,437,India
880850,2024-02-12,507,washing machine,6990,16490,9500,1,471,India
880850,2024-02-12,506,monitor,3249,8000,4751,1,471,India
880850,2024-02-12,505,oven,18490,24000,5510,1,471,India
461930,2024-02-13,507,washing machine,6990,16490,9500,1,361,India
461930,2024-02-13,506,monitor,3249,8000,4751,1,361,India
461930,2024-02-13,503,mixer,1349,3249,1900,1,361,India
461930,2024-02-13,504,iron,449,879,430,1,361,India
644667,2024-02-13,503,mixer,1349,3249,1900,1,90,India
644667,2024-02-13,502,iphone 15 pro max,100000,135000,35000,1,90,India
644667,2024-02-13,504,iron,449,879,430,1,90,India
191228,2024-02-13,504,iron,449,879,430,1,174,India
318015,2024-02-13,506,monitor,3249,8000,4751,1,186,India
318015,2024-02-13,501,iphone 15,60000,80000,20000,1,186,India
318015,2024-02-13,505,oven,18490,24000,5510,1,186,India
664276,2024-02-13,504,iron,449,879,430,1,266,India
664276,2024-02-13,502,iphone 15 pro max,100000,135000,35000,1,266,India
845463,2024-02-13,507,washing machine,6990,16490,9500,1,224,India
845463,2024-02-13,501,iphone 15,60000,80000,20000,1,224,India
782805,2024-02-13,506,monitor,3249,8000,4751,1,436,India
782805,2024-02-13,507,washing machine,6990,16490,9500,1,436,India
945469,2024-02-13,501,iphone 15,60000,80000,20000,1,261,India
620949,2024-02-13,504,iron,449,879,430,1,94,India
276809,2024-02-13,503,mixer,1349,3249,1900,1,80,India
276809,2024-02-13,504,iron,449,879,430,1,80,India
882746,2024-02-13,501,iphone 15,60000,80000,20000,1,248,India
510721,2024-02-13,502,iphone 15 pro max,100000,135000,35000,1,54,India
510721,2024-02-13,504,iron,449,879,430,1,54,India
996269,2024-02-13,502,iphone 15 pro max,100000,135000,35000,1,425,India
996269,2024-02-13,506,monitor,3249,8000,4751,1,425,India
996269,2024-02-13,505,oven,18490,24000,5510,1,425,India
996269,2024-02-13,501,iphone 15,60000,80000,20000,1,425,India
284504,2024-02-13,503,mixer,1349,3249,1900,1,231,India
284504,2024-02-13,507,washing machine,6990,16490,9500,1,231,India
294324,2024-02-13,507,washing machine,6990,16490,9500,1,12,India
294324,2024-02-13,503,mixer,1349,3249,1900,1,12,India
294324,2024-02-13,505,oven,18490,24000,5510,1,12,India
489965,2024-02-13,504,iron,449,879,430,1,396,India
489965,2024-02-13,501,iphone 15,60000,80000,20000,1,396,India
489965,2024-02-13,502,iphone 15 pro max,100000,135000,35000,1,396,India
589294,2024-02-13,502,iphone 15 pro max,100000,135000,35000,1,331,India
589294,2024-02-13,507,washing machine,6990,16490,9500,1,331,India
589294,2024-02-13,506,monitor,3249,8000,4751,1,331,India
807198,2024-02-13,503,mixer,1349,3249,1900,1,210,India
805423,2024-02-13,502,iphone 15 pro max,100000,135000,35000,1,34,India
805423,2024-02-13,501,iphone 15,60000,80000,20000,1,34,India
690882,2024-02-13,502,iphone 15 pro max,100000,135000,35000,1,297,India
718004,2024-02-13,504,iron,449,879,430,1,424,India
532069,2024-02-13,503,mixer,1349,3249,1900,1,318,India
532069,2024-02-13,505,oven,18490,24000,5510,1,318,India
532069,2024-02-13,504,iron,449,879,430,1,318,India
532069,2024-02-13,506,monitor,3249,8000,4751,1,318,India
190740,2024-02-13,501,iphone 15,60000,80000,20000,1,244,India
190740,2024-02-13,503,mixer,1349,3249,1900,1,244,India
190740,2024-02-13,504,iron,449,879,430,1,244,India
190740,2024-02-13,506,monitor,3249,8000,4751,1,244,India
727603,2024-02-13,507,washing machine,6990,16490,9500,1,151,India
727603,2024-02-13,504,iron,449,879,430,1,151,India
940352,2024-02-13,504,iron,449,879,430,1,179,India
940352,2024-02-13,507,washing machine,6990,16490,9500,1,179,India
940352,2024-02-13,503,mixer,1349,3249,1900,1,179,India
911240,2024-02-13,501,iphone 15,60000,80000,20000,1,430,India
911240,2024-02-13,506,monitor,3249,8000,4751,1,430,India
801181,2024-02-13,501,iphone 15,60000,80000,20000,1,379,India
801181,2024-02-13,504,iron,449,879,430,1,379,India
372866,2024-02-13,501,iphone 15,60000,80000,20000,1,285,India
285871,2024-02-13,502,iphone 15 pro max,100000,135000,35000,1,71,India
285871,2024-02-13,503,mixer,1349,3249,1900,1,71,India
285871,2024-02-13,501,iphone 15,60000,80000,20000,1,71,India
398457,2024-02-13,504,iron,449,879,430,1,314,India
398457,2024-02-13,503,mixer,1349,3249,1900,1,314,India
945636,2024-02-13,502,iphone 15 pro max,100000,135000,35000,1,473,India
186624,2024-02-13,503,mixer,1349,3249,1900,1,297,India
564552,2024-02-13,504,iron,449,879,430,1,220,India
564552,2024-02-13,501,iphone 15,60000,80000,20000,1,220,India
564552,2024-02-13,507,washing machine,6990,16490,9500,1,220,India
564552,2024-02-13,502,iphone 15 pro max,100000,135000,35000,1,220,India
477115,2024-02-13,503,mixer,1349,3249,1900,1,291,India
561233,2024-02-13,506,monitor,3249,8000,4751,1,258,India
561233,2024-02-13,504,iron,449,879,430,1,258,India
170005,2024-02-13,506,monitor,3249,8000,4751,1,464,India
170005,2024-02-13,504,iron,449,879,430,1,464,India
170005,2024-02-13,507,washing machine,6990,16490,9500,1,464,India
170005,2024-02-13,502,iphone 15 pro max,100000,135000,35000,1,464,India
575018,2024-02-13,503,mixer,1349,3249,1900,1,493,India
575018,2024-02-13,505,oven,18490,24000,5510,1,493,India
910637,2024-02-13,504,iron,449,879,430,1,486,India
137597,2024-02-13,504,iron,449,879,430,1,109,India
907853,2024-02-13,505,oven,18490,24000,5510,1,424,India
907853,2024-02-13,503,mixer,1349,3249,1900,1,424,India
907853,2024-02-13,501,iphone 15,60000,80000,20000,1,424,India
703158,2024-02-13,502,iphone 15 pro max,100000,135000,35000,1,469,India
787293,2024-02-13,507,washing machine,6990,16490,9500,1,319,India
787293,2024-02-13,504,iron,449,879,430,1,319,India
787293,2024-02-13,501,iphone 15,60000,80000,20000,1,319,India
787293,2024-02-13,502,iphone 15 pro max,100000,135000,35000,1,319,India
651476,2024-02-13,502,iphone 15 pro max,100000,135000,35000,1,269,India
651476,2024-02-13,507,washing machine,6990,16490,9500,1,269,India
651476,2024-02-13,503,mixer,1349,3249,1900,1,269,India
452746,2024-02-13,502,iphone 15 pro max,100000,135000,35000,1,87,India
781121,2024-02-13,504,iron,449,879,430,1,24,India
781121,2024-02-13,503,mixer,1349,3249,1900,1,24,India
462736,2024-02-13,505,oven,18490,24000,5510,1,478,India
462736,2024-02-13,506,monitor,3249,8000,4751,1,478,India
990725,2024-02-13,502,iphone 15 pro max,100000,135000,35000,1,193,India
990725,2024-02-13,501,iphone 15,60000,80000,20000,1,193,India
990725,2024-02-13,503,mixer,1349,3249,1900,1,193,India
990725,2024-02-13,504,iron,449,879,430,1,193,India
658032,2024-02-13,502,iphone 15 pro max,100000,135000,35000,1,188,India
857816,2024-02-13,503,mixer,1349,3249,1900,1,212,India
857816,2024-02-13,506,monitor,3249,8000,4751,1,212,India
893059,2024-02-13,507,washing machine,6990,16490,9500,1,182,India
893059,2024-02-13,505,oven,18490,24000,5510,1,182,India
893059,2024-02-13,501,iphone 15,60000,80000,20000,1,182,India
996140,2024-02-13,505,oven,18490,24000,5510,1,224,India
996140,2024-02-13,507,washing machine,6990,16490,9500,1,224,India
364048,2024-02-13,504,iron,449,879,430,1,13,India
364048,2024-02-13,506,monitor,3249,8000,4751,1,13,India
364048,2024-02-13,503,mixer,1349,3249,1900,1,13,India
364048,2024-02-13,507,washing machine,6990,16490,9500,1,13,India
295689,2024-02-13,503,mixer,1349,3249,1900,1,163,India
383846,2024-02-13,505,oven,18490,24000,5510,1,267,India
896395,2024-02-13,501,iphone 15,60000,80000,20000,1,314,India
896395,2024-02-13,502,iphone 15 pro max,100000,135000,35000,1,314,India
896395,2024-02-13,506,monitor,3249,8000,4751,1,314,India
789523,2024-02-13,503,mixer,1349,3249,1900,1,98,India
789523,2024-02-13,504,iron,449,879,430,1,98,India
789523,2024-02-13,501,iphone 15,60000,80000,20000,1,98,India
137727,2024-02-13,505,oven,18490,24000,5510,1,174,India
137727,2024-02-13,507,washing machine,6990,16490,9500,1,174,India
190360,2024-02-13,501,iphone 15,60000,80000,20000,1,270,India
190360,2024-02-13,506,monitor,3249,8000,4751,1,270,India
935649,2024-02-13,504,iron,449,879,430,1,306,India
935649,2024-02-13,507,washing machine,6990,16490,9500,1,306,India
935649,2024-02-13,506,monitor,3249,8000,4751,1,306,India
935649,2024-02-13,503,mixer,1349,3249,1900,1,306,India
789952,2024-02-13,507,washing machine,6990,16490,9500,1,245,India
229756,2024-02-13,505,oven,18490,24000,5510,1,250,India
229756,2024-02-13,501,iphone 15,60000,80000,20000,1,250,India
229756,2024-02-13,503,mixer,1349,3249,1900,1,250,India
776142,2024-02-13,502,iphone 15 pro max,100000,135000,35000,1,302,India
776142,2024-02-13,506,monitor,3249,8000,4751,1,302,India
477939,2024-02-13,506,monitor,3249,8000,4751,1,35,India
477939,2024-02-13,501,iphone 15,60000,80000,20000,1,35,India
782319,2024-02-13,504,iron,449,879,430,1,132,India
782319,2024-02-13,507,washing machine,6990,16490,9500,1,132,India
782319,2024-02-13,502,iphone 15 pro max,100000,135000,35000,1,132,India
605558,2024-02-13,507,washing machine,6990,16490,9500,1,340,India
174740,2024-02-14,504,iron,449,879,430,1,222,India
174740,2024-02-14,503,mixer,1349,3249,1900,1,222,India
148482,2024-02-14,507,washing machine,6990,16490,9500,1,94,India
148482,2024-02-14,502,iphone 15 pro max,100000,135000,35000,1,94,India
618671,2024-02-14,506,monitor,3249,8000,4751,1,57,India
414474,2024-02-14,504,iron,449,879,430,1,163,India
414474,2024-02-14,506,monitor,3249,8000,4751,1,163,India
685917,2024-02-14,505,oven,18490,24000,5510,1,231,India
685917,2024-02-14,507,washing machine,6990,16490,9500,1,231,India
283835,2024-02-14,504,iron,449,879,430,1,463,India
283835,2024-02-14,505,oven,18490,24000,5510,1,463,India
283835,2024-02-14,503,mixer,1349,3249,1900,1,463,India
876247,2024-02-14,502,iphone 15 pro max,100000,135000,35000,1,107,India
876247,2024-02-14,506,monitor,3249,8000,4751,1,107,India
876247,2024-02-14,503,mixer,1349,3249,1900,1,107,India
576480,2024-02-14,507,washing machine,6990,16490,9500,1,10,India
576480,2024-02-14,504,iron,449,879,430,1,10,India
576480,2024-02-14,501,iphone 15,60000,80000,20000,1,10,India
202985,2024-02-14,505,oven,18490,24000,5510,1,140,India
202985,2024-02-14,506,monitor,3249,8000,4751,1,140,India
202985,2024-02-14,507,washing machine,6990,16490,9500,1,140,India
782834,2024-02-14,504,iron,449,879,430,1,131,India
782834,2024-02-14,506,monitor,3249,8000,4751,1,131,India
782834,2024-02-14,507,washing machine,6990,16490,9500,1,131,India
415998,2024-02-14,502,iphone 15 pro max,100000,135000,35000,1,175,India
415998,2024-02-14,506,monitor,3249,8000,4751,1,175,India
798034,2024-02-14,501,iphone 15,60000,80000,20000,1,160,India
798034,2024-02-14,503,mixer,1349,3249,1900,1,160,India
798034,2024-02-14,502,iphone 15 pro max,100000,135000,35000,1,160,India
798034,2024-02-14,506,monitor,3249,8000,4751,1,160,India
431821,2024-02-14,502,iphone 15 pro max,100000,135000,35000,1,291,India
274292,2024-02-14,505,oven,18490,24000,5510,1,304,India
274292,2024-02-14,506,monitor,3249,8000,4751,1,304,India
274292,2024-02-14,502,iphone 15 pro max,100000,135000,35000,1,304,India
677452,2024-02-14,503,mixer,1349,3249,1900,1,211,India
677452,2024-02-14,502,iphone 15 pro max,100000,135000,35000,1,211,India
677452,2024-02-14,504,iron,449,879,430,1,211,India
159865,2024-02-14,502,iphone 15 pro max,100000,135000,35000,1,151,India
604193,2024-02-14,502,iphone 15 pro max,100000,135000,35000,1,110,India
604193,2024-02-14,505,oven,18490,24000,5510,1,110,India
604193,2024-02-14,503,mixer,1349,3249,1900,1,110,India
604193,2024-02-14,506,monitor,3249,8000,4751,1,110,India
302656,2024-02-14,505,oven,18490,24000,5510,1,78,India
302656,2024-02-14,507,washing machine,6990,16490,9500,1,78,India
302656,2024-02-14,504,iron,449,879,430,1,78,India
302656,2024-02-14,501,iphone 15,60000,80000,20000,1,78,India
363890,2024-02-14,503,mixer,1349,3249,1900,1,58,India
363890,2024-02-14,501,iphone 15,60000,80000,20000,1,58,India
363890,2024-02-14,507,washing machine,6990,16490,9500,1,58,India
954840,2024-02-14,503,mixer,1349,3249,1900,1,249,India
705366,2024-02-14,506,monitor,3249,8000,4751,1,426,India
705366,2024-02-14,501,iphone 15,60000,80000,20000,1,426,India
200393,2024-02-14,501,iphone 15,60000,80000,20000,1,324,India
200393,2024-02-14,502,iphone 15 pro max,100000,135000,35000,1,324,India
200393,2024-02-14,503,mixer,1349,3249,1900,1,324,India
732103,2024-02-14,501,iphone 15,60000,80000,20000,1,334,India
732103,2024-02-14,505,oven,18490,24000,5510,1,334,India
605750,2024-02-14,507,washing machine,6990,16490,9500,1,304,India
772008,2024-02-14,506,monitor,3249,8000,4751,1,13,India
127688,2024-02-14,501,iphone 15,60000,80000,20000,1,71,India
750700,2024-02-14,505,oven,18490,24000,5510,1,276,India
997972,2024-02-14,506,monitor,3249,8000,4751,1,447,India
997972,2024-02-14,504,iron,449,879,430,1,447,India
997972,2024-02-14,501,iphone 15,60000,80000,20000,1,447,India
997972,2024-02-14,505,oven,18490,24000,5510,1,447,India
719276,2024-02-14,507,washing machine,6990,16490,9500,1,144,India
719276,2024-02-14,505,oven,18490,24000,5510,1,144,India
719276,2024-02-14,501,iphone 15,60000,80000,20000,1,144,India
719276,2024-02-14,506,monitor,3249,8000,4751,1,144,India
719276,2024-02-14,504,iron,449,879,430,1,144,India
644678,2024-02-14,501,iphone 15,60000,80000,20000,1,476,India
644678,2024-02-14,503,mixer,1349,3249,1900,1,476,India
644678,2024-02-14,506,monitor,3249,8000,4751,1,476,India
594321,2024-02-14,503,mixer,1349,3249,1900,1,492,India
594321,2024-02-14,501,iphone 15,60000,80000,20000,1,492,India
594321,2024-02-14,505,oven,18490,24000,5510,1,492,India
743390,2024-02-14,506,monitor,3249,8000,4751,1,368,India
267751,2024-02-14,502,iphone 15 pro max,100000,135000,35000,1,164,India
267751,2024-02-14,501,iphone 15,60000,80000,20000,1,164,India
739784,2024-02-14,503,mixer,1349,3249,1900,1,459,India
739784,2024-02-14,502,iphone 15 pro max,100000,135000,35000,1,459,India
874616,2024-02-14,501,iphone 15,60000,80000,20000,1,359,India
874616,2024-02-14,506,monitor,3249,8000,4751,1,359,India
874616,2024-02-14,504,iron,449,879,430,1,359,India
806676,2024-02-14,503,mixer,1349,3249,1900,1,58,India
806676,2024-02-14,506,monitor,3249,8000,4751,1,58,India
865934,2024-02-14,504,iron,449,879,430,1,265,India
865934,2024-02-14,506,monitor,3249,8000,4751,1,265,India
865934,2024-02-14,503,mixer,1349,3249,1900,1,265,India
134271,2024-02-14,502,iphone 15 pro max,100000,135000,35000,1,17,India
686062,2024-02-14,504,iron,449,879,430,1,474,India
972270,2024-02-14,504,iron,449,879,430,1,390,India
816419,2024-02-14,507,washing machine,6990,16490,9500,1,173,India
742908,2024-02-14,502,iphone 15 pro max,100000,135000,35000,1,13,India
742908,2024-02-14,504,iron,449,879,430,1,13,India
742908,2024-02-14,507,washing machine,6990,16490,9500,1,13,India
923557,2024-02-14,501,iphone 15,60000,80000,20000,1,281,India
923557,2024-02-14,505,oven,18490,24000,5510,1,281,India
923557,2024-02-14,503,mixer,1349,3249,1900,1,281,India
561482,2024-02-14,504,iron,449,879,430,1,57,India
561482,2024-02-14,505,oven,18490,24000,5510,1,57,India
892330,2024-02-14,507,washing machine,6990,16490,9500,1,333,India
892330,2024-02-14,502,iphone 15 pro max,100000,135000,35000,1,333,India
892330,2024-02-14,501,iphone 15,60000,80000,20000,1,333,India
892330,2024-02-14,504,iron,449,879,430,1,333,India
152884,2024-02-14,502,iphone 15 pro max,100000,135000,35000,1,291,India
735054,2024-02-14,507,washing machine,6990,16490,9500,1,153,India
735054,2024-02-14,501,iphone 15,60000,80000,20000,1,153,India
735054,2024-02-14,502,iphone 15 pro max,100000,135000,35000,1,153,India
735054,2024-02-14,505,oven,18490,24000,5510,1,153,India
116782,2024-02-14,502,iphone 15 pro max,100000,135000,35000,1,8,India
116782,2024-02-14,503,mixer,1349,3249,1900,1,8,India
248175,2024-02-14,506,monitor,3249,8000,4751,1,367,India
248175,2024-02-14,501,iphone 15,60000,80000,20000,1,367,India
361784,2024-02-14,501,iphone 15,60000,80000,20000,1,23,India
361784,2024-02-14,506,monitor,3249,8000,4751,1,23,India
361784,2024-02-14,504,iron,449,879,430,1,23,India
361784,2024-02-14,507,washing machine,6990,16490,9500,1,23,India
232186,2024-02-14,506,monitor,3249,8000,4751,1,208,India
232186,2024-02-14,504,iron,449,879,430,1,208,India
455864,2024-02-14,506,monitor,3249,8000,4751,1,198,India
294781,2024-02-14,504,iron,449,879,430,1,131,India
294781,2024-02-14,503,mixer,1349,3249,1900,1,131,India
445942,2024-02-14,506,monitor,3249,8000,4751,1,497,India
445942,2024-02-14,504,iron,449,879,430,1,497,India
445942,2024-02-14,503,mixer,1349,3249,1900,1,497,India
252496,2024-02-14,506,monitor,3249,8000,4751,1,253,India
252496,2024-02-14,501,iphone 15,60000,80000,20000,1,253,India
418477,2024-02-14,501,iphone 15,60000,80000,20000,1,398,India
418477,2024-02-14,504,iron,449,879,430,1,398,India
518216,2024-02-14,501,iphone 15,60000,80000,20000,1,395,India
271017,2024-02-14,504,iron,449,879,430,1,70,India
176736,2024-02-14,502,iphone 15 pro max,100000,135000,35000,1,489,India
176736,2024-02-14,504,iron,449,879,430,1,489,India
673873,2024-02-14,502,iphone 15 pro max,100000,135000,35000,1,370,India
673873,2024-02-14,504,iron,449,879,430,1,370,India
468474,2024-02-14,505,oven,18490,24000,5510,1,317,India
468474,2024-02-14,502,iphone 15 pro max,100000,135000,35000,1,317,India
217690,2024-02-14,507,washing machine,6990,16490,9500,1,440,India
217690,2024-02-14,502,iphone 15 pro max,100000,135000,35000,1,440,India
217690,2024-02-14,505,oven,18490,24000,5510,1,440,India
940279,2024-02-14,507,washing machine,6990,16490,9500,1,126,India
940279,2024-02-14,501,iphone 15,60000,80000,20000,1,126,India
390944,2024-02-14,505,oven,18490,24000,5510,1,184,India
390944,2024-02-14,504,iron,449,879,430,1,184,India
607515,2024-02-14,504,iron,449,879,430,1,418,India
607515,2024-02-14,505,oven,18490,24000,5510,1,418,India
607515,2024-02-14,501,iphone 15,60000,80000,20000,1,418,India
607515,2024-02-14,503,mixer,1349,3249,1900,1,418,India
607515,2024-02-14,506,monitor,3249,8000,4751,1,418,India
655290,2024-02-14,501,iphone 15,60000,80000,20000,1,49,India
655290,2024-02-14,506,monitor,3249,8000,4751,1,49,India
655290,2024-02-14,505,oven,18490,24000,5510,1,49,India
655290,2024-02-14,503,mixer,1349,3249,1900,1,49,India
297547,2024-02-14,504,iron,449,879,430,1,96,India
297547,2024-02-14,503,mixer,1349,3249,1900,1,96,India
156723,2024-02-14,505,oven,18490,24000,5510,1,421,India
156723,2024-02-14,503,mixer,1349,3249,1900,1,421,India
156723,2024-02-14,501,iphone 15,60000,80000,20000,1,421,India
605692,2024-02-14,505,oven,18490,24000,5510,1,366,India
605692,2024-02-14,507,washing machine,6990,16490,9500,1,366,India
113126,2024-02-14,505,oven,18490,24000,5510,1,6,India
113126,2024-02-14,503,mixer,1349,3249,1900,1,6,India
736667,2024-02-14,501,iphone 15,60000,80000,20000,1,404,India
736667,2024-02-14,503,mixer,1349,3249,1900,1,404,India
736667,2024-02-14,506,monitor,3249,8000,4751,1,404,India
157016,2024-02-14,507,washing machine,6990,16490,9500,1,104,India
157016,2024-02-14,503,mixer,1349,3249,1900,1,104,India
981110,2024-02-14,506,monitor,3249,8000,4751,1,264,India
905910,2024-02-14,505,oven,18490,24000,5510,1,332,India
905910,2024-02-14,501,iphone 15,60000,80000,20000,1,332,India
905910,2024-02-14,506,monitor,3249,8000,4751,1,332,India
905910,2024-02-14,507,washing machine,6990,16490,9500,1,332,India
302824,2024-02-14,506,monitor,3249,8000,4751,1,49,India
302824,2024-02-14,502,iphone 15 pro max,100000,135000,35000,1,49,India
302824,2024-02-14,505,oven,18490,24000,5510,1,49,India
329705,2024-02-14,507,washing machine,6990,16490,9500,1,482,India
329705,2024-02-14,501,iphone 15,60000,80000,20000,1,482,India
329705,2024-02-14,502,iphone 15 pro max,100000,135000,35000,1,482,India
329705,2024-02-14,504,iron,449,879,430,1,482,India
528282,2024-02-14,502,iphone 15 pro max,100000,135000,35000,1,82,India
528282,2024-02-14,503,mixer,1349,3249,1900,1,82,India
975771,2024-02-14,505,oven,18490,24000,5510,1,494,India
258828,2024-02-14,506,monitor,3249,8000,4751,1,396,India
258828,2024-02-14,502,iphone 15 pro max,100000,135000,35000,1,396,India
258828,2024-02-14,507,washing machine,6990,16490,9500,1,396,India
258828,2024-02-14,501,iphone 15,60000,80000,20000,1,396,India
180642,2024-02-14,506,monitor,3249,8000,4751,1,454,India
654395,2024-02-14,501,iphone 15,60000,80000,20000,1,16,India
951032,2024-02-14,502,iphone 15 pro max,100000,135000,35000,1,97,India
594336,2024-02-14,506,monitor,3249,8000,4751,1,21,India
594336,2024-02-14,504,iron,449,879,430,1,21,India
594336,2024-02-14,503,mixer,1349,3249,1900,1,21,India
594336,2024-02-14,507,washing machine,6990,16490,9500,1,21,India
181957,2024-02-14,502,iphone 15 pro max,100000,135000,35000,1,423,India
181957,2024-02-14,503,mixer,1349,3249,1900,1,423,India
586334,2024-02-14,506,monitor,3249,8000,4751,1,8,India
586334,2024-02-14,501,iphone 15,60000,80000,20000,1,8,India
586334,2024-02-14,503,mixer,1349,3249,1900,1,8,India
527004,2024-02-14,506,monitor,3249,8000,4751,1,273,India
527004,2024-02-14,507,washing machine,6990,16490,9500,1,273,India
527004,2024-02-14,502,iphone 15 pro max,100000,135000,35000,1,273,India
324748,2024-02-14,505,oven,18490,24000,5510,1,307,India
324748,2024-02-14,502,iphone 15 pro max,100000,135000,35000,1,307,India
324748,2024-02-14,507,washing machine,6990,16490,9500,1,307,India
556314,2024-02-14,504,iron,449,879,430,1,103,India
449415,2024-02-14,502,iphone 15 pro max,100000,135000,35000,1,289,India
449415,2024-02-14,507,washing machine,6990,16490,9500,1,289,India
449415,2024-02-14,505,oven,18490,24000,5510,1,289,India
449415,2024-02-14,503,mixer,1349,3249,1900,1,289,India
884584,2024-02-14,505,oven,18490,24000,5510,1,135,India
884584,2024-02-14,503,mixer,1349,3249,1900,1,135,India
247938,2024-02-14,505,oven,18490,24000,5510,1,138,India
247938,2024-02-14,506,monitor,3249,8000,4751,1,138,India
247938,2024-02-14,502,iphone 15 pro max,100000,135000,35000,1,138,India
222588,2024-02-15,504,iron,449,879,430,1,412,India
222588,2024-02-15,502,iphone 15 pro max,100000,135000,35000,1,412,India
189981,2024-02-15,501,iphone 15,60000,80000,20000,1,278,India
189981,2024-02-15,502,iphone 15 pro max,100000,135000,35000,1,278,India
189981,2024-02-15,506,monitor,3249,8000,4751,1,278,India
498848,2024-02-15,502,iphone 15 pro max,100000,135000,35000,1,97,India
498848,2024-02-15,504,iron,449,879,430,1,97,India
498848,2024-02-15,501,iphone 15,60000,80000,20000,1,97,India
498848,2024-02-15,505,oven,18490,24000,5510,1,97,India
499099,2024-02-15,506,monitor,3249,8000,4751,1,199,India
499099,2024-02-15,502,iphone 15 pro max,100000,135000,35000,1,199,India
499099,2024-02-15,505,oven,18490,24000,5510,1,199,India
499099,2024-02-15,503,mixer,1349,3249,1900,1,199,India
505760,2024-02-15,502,iphone 15 pro max,100000,135000,35000,1,67,India
505760,2024-02-15,501,iphone 15,60000,80000,20000,1,67,India
505760,2024-02-15,507,washing machine,6990,16490,9500,1,67,India
505760,2024-02-15,505,oven,18490,24000,5510,1,67,India
848750,2024-02-15,506,monitor,3249,8000,4751,1,377,India
848750,2024-02-15,501,iphone 15,60000,80000,20000,1,377,India
848750,2024-02-15,502,iphone 15 pro max,100000,135000,35000,1,377,India
848750,2024-02-15,504,iron,449,879,430,1,377,India
577547,2024-02-15,504,iron,449,879,430,1,89,India
577547,2024-02-15,506,monitor,3249,8000,4751,1,89,India
710609,2024-02-15,502,iphone 15 pro max,100000,135000,35000,1,28,India
246431,2024-02-15,506,monitor,3249,8000,4751,1,128,India
246431,2024-02-15,507,washing machine,6990,16490,9500,1,128,India
682070,2024-02-15,505,oven,18490,24000,5510,1,170,India
682070,2024-02-15,507,washing machine,6990,16490,9500,1,170,India
321815,2024-02-15,505,oven,18490,24000,5510,1,405,India
321815,2024-02-15,504,iron,449,879,430,1,405,India
703680,2024-02-15,505,oven,18490,24000,5510,1,103,India
703680,2024-02-15,503,mixer,1349,3249,1900,1,103,India
219884,2024-02-15,501,iphone 15,60000,80000,20000,1,283,India
219884,2024-02-15,503,mixer,1349,3249,1900,1,283,India
219884,2024-02-15,507,washing machine,6990,16490,9500,1,283,India
196361,2024-02-15,501,iphone 15,60000,80000,20000,1,120,India
196361,2024-02-15,505,oven,18490,24000,5510,1,120,India
196361,2024-02-15,503,mixer,1349,3249,1900,1,120,India
196361,2024-02-15,506,monitor,3249,8000,4751,1,120,India
314807,2024-02-15,506,monitor,3249,8000,4751,1,11,India
314807,2024-02-15,505,oven,18490,24000,5510,1,11,India
507284,2024-02-15,502,iphone 15 pro max,100000,135000,35000,1,76,India
507284,2024-02-15,507,washing machine,6990,16490,9500,1,76,India
507284,2024-02-15,501,iphone 15,60000,80000,20000,1,76,India
442697,2024-02-15,506,monitor,3249,8000,4751,1,219,India
749721,2024-02-15,501,iphone 15,60000,80000,20000,1,232,India
545022,2024-02-15,507,washing machine,6990,16490,9500,1,39,India
888631,2024-02-15,505,oven,18490,24000,5510,1,8,India
888631,2024-02-15,501,iphone 15,60000,80000,20000,1,8,India
329685,2024-02-15,503,mixer,1349,3249,1900,1,76,India
329685,2024-02-15,502,iphone 15 pro max,100000,135000,35000,1,76,India
881045,2024-02-15,504,iron,449,879,430,1,74,India
881045,2024-02-15,502,iphone 15 pro max,100000,135000,35000,1,74,India
881045,2024-02-15,501,iphone 15,60000,80000,20000,1,74,India
881045,2024-02-15,506,monitor,3249,8000,4751,1,74,India
944379,2024-02-15,501,iphone 15,60000,80000,20000,1,149,India
944379,2024-02-15,504,iron,449,879,430,1,149,India
944379,2024-02-15,503,mixer,1349,3249,1900,1,149,India
944379,2024-02-15,506,monitor,3249,8000,4751,1,149,India
418485,2024-02-15,501,iphone 15,60000,80000,20000,1,95,India
418485,2024-02-15,504,iron,449,879,430,1,95,India
418485,2024-02-15,507,washing machine,6990,16490,9500,1,95,India
253734,2024-02-15,504,iron,449,879,430,1,324,India
253734,2024-02-15,505,oven,18490,24000,5510,1,324,India
253734,2024-02-15,501,iphone 15,60000,80000,20000,1,324,India
253734,2024-02-15,506,monitor,3249,8000,4751,1,324,India
448729,2024-02-15,507,washing machine,6990,16490,9500,1,484,India
448729,2024-02-15,502,iphone 15 pro max,100000,135000,35000,1,484,India
280050,2024-02-15,503,mixer,1349,3249,1900,1,111,India
280050,2024-02-15,505,oven,18490,24000,5510,1,111,India
280050,2024-02-15,507,washing machine,6990,16490,9500,1,111,India
759776,2024-02-15,501,iphone 15,60000,80000,20000,1,431,India
759776,2024-02-15,507,washing machine,6990,16490,9500,1,431,India
759776,2024-02-15,503,mixer,1349,3249,1900,1,431,India
688791,2024-02-15,505,oven,18490,24000,5510,1,313,India
830361,2024-02-15,506,monitor,3249,8000,4751,1,273,India
830361,2024-02-15,503,mixer,1349,3249,1900,1,273,India
899254,2024-02-15,504,iron,449,879,430,1,265,India
899254,2024-02-15,505,oven,18490,24000,5510,1,265,India
899254,2024-02-15,501,iphone 15,60000,80000,20000,1,265,India
665204,2024-02-15,504,iron,449,879,430,1,86,India
665204,2024-02-15,503,mixer,1349,3249,1900,1,86,India
665204,2024-02-15,502,iphone 15 pro max,100000,135000,35000,1,86,India
235498,2024-02-15,503,mixer,1349,3249,1900,1,360,India
235498,2024-02-15,507,washing machine,6990,16490,9500,1,360,India
235498,2024-02-15,506,monitor,3249,8000,4751,1,360,India
235498,2024-02-15,501,iphone 15,60000,80000,20000,1,360,India
236782,2024-02-15,506,monitor,3249,8000,4751,1,241,India
236782,2024-02-15,504,iron,449,879,430,1,241,India
715331,2024-02-15,502,iphone 15 pro max,100000,135000,35000,1,252,India
715331,2024-02-15,503,mixer,1349,3249,1900,1,252,India
715331,2024-02-15,506,monitor,3249,8000,4751,1,252,India
253613,2024-02-15,507,washing machine,6990,16490,9500,1,349,India
253613,2024-02-15,501,iphone 15,60000,80000,20000,1,349,India
253613,2024-02-15,505,oven,18490,24000,5510,1,349,India
253613,2024-02-15,506,monitor,3249,8000,4751,1,349,India
758546,2024-02-15,502,iphone 15 pro max,100000,135000,35000,1,345,India
758546,2024-02-15,505,oven,18490,24000,5510,1,345,India
758546,2024-02-15,503,mixer,1349,3249,1900,1,345,India
149647,2024-02-15,501,iphone 15,60000,80000,20000,1,217,India
149647,2024-02-15,502,iphone 15 pro max,100000,135000,35000,1,217,India
149647,2024-02-15,507,washing machine,6990,16490,9500,1,217,India
913557,2024-02-15,504,iron,449,879,430,1,393,India
913557,2024-02-15,503,mixer,1349,3249,1900,1,393,India
324439,2024-02-15,501,iphone 15,60000,80000,20000,1,14,India
863705,2024-02-15,501,iphone 15,60000,80000,20000,1,283,India
863705,2024-02-15,502,iphone 15 pro max,100000,135000,35000,1,283,India
863705,2024-02-15,506,monitor,3249,8000,4751,1,283,India
293530,2024-02-15,501,iphone 15,60000,80000,20000,1,52,India
293530,2024-02-15,506,monitor,3249,8000,4751,1,52,India
293530,2024-02-15,503,mixer,1349,3249,1900,1,52,India
293530,2024-02-15,505,oven,18490,24000,5510,1,52,India
117521,2024-02-15,506,monitor,3249,8000,4751,1,229,India
438681,2024-02-15,505,oven,18490,24000,5510,1,89,India
438681,2024-02-15,501,iphone 15,60000,80000,20000,1,89,India
438681,2024-02-15,507,washing machine,6990,16490,9500,1,89,India
438681,2024-02-15,506,monitor,3249,8000,4751,1,89,India
782079,2024-02-15,506,monitor,3249,8000,4751,1,234,India
142310,2024-02-15,505,oven,18490,24000,5510,1,283,India
142310,2024-02-15,507,washing machine,6990,16490,9500,1,283,India
319330,2024-02-15,505,oven,18490,24000,5510,1,498,India
319330,2024-02-15,504,iron,449,879,430,1,498,India
306058,2024-02-15,502,iphone 15 pro max,100000,135000,35000,1,311,India
306058,2024-02-15,503,mixer,1349,3249,1900,1,311,India
306058,2024-02-15,505,oven,18490,24000,5510,1,311,India
263038,2024-02-15,504,iron,449,879,430,1,158,India
263038,2024-02-15,505,oven,18490,24000,5510,1,158,India
263038,2024-02-15,507,washing machine,6990,16490,9500,1,158,India
463138,2024-02-15,506,monitor,3249,8000,4751,1,499,India
190033,2024-02-15,506,monitor,3249,8000,4751,1,392,India
190033,2024-02-15,507,washing machine,6990,16490,9500,1,392,India
780421,2024-02-15,505,oven,18490,24000,5510,1,61,India
780421,2024-02-15,506,monitor,3249,8000,4751,1,61,India
780421,2024-02-15,507,washing machine,6990,16490,9500,1,61,India
568380,2024-02-15,507,washing machine,6990,16490,9500,1,437,India
568380,2024-02-15,504,iron,449,879,430,1,437,India
568380,2024-02-15,505,oven,18490,24000,5510,1,437,India
155546,2024-02-15,505,oven,18490,24000,5510,1,121,India
155546,2024-02-15,504,iron,449,879,430,1,121,India
155546,2024-02-15,503,mixer,1349,3249,1900,1,121,India
563069,2024-02-15,506,monitor,3249,8000,4751,1,50,India
884508,2024-02-15,502,iphone 15 pro max,100000,135000,35000,1,399,India
884508,2024-02-15,507,washing machine,6990,16490,9500,1,399,India
884508,2024-02-15,506,monitor,3249,8000,4751,1,399,India
600225,2024-02-15,506,monitor,3249,8000,4751,1,341,India
600225,2024-02-15,505,oven,18490,24000,5510,1,341,India
271586,2024-02-15,501,iphone 15,60000,80000,20000,1,309,India
271586,2024-02-15,507,washing machine,6990,16490,9500,1,309,India
271586,2024-02-15,504,iron,449,879,430,1,309,India
805655,2024-02-15,504,iron,449,879,430,1,116,India
719069,2024-02-15,503,mixer,1349,3249,1900,1,351,India
719069,2024-02-15,507,washing machine,6990,16490,9500,1,351,India
312410,2024-02-15,501,iphone 15,60000,80000,20000,1,341,India
312410,2024-02-15,505,oven,18490,24000,5510,1,341,India
138940,2024-02-15,504,iron,449,879,430,1,45,India
138940,2024-02-15,506,monitor,3249,8000,4751,1,45,India
138940,2024-02-15,507,washing machine,6990,16490,9500,1,45,India
826235,2024-02-15,504,iron,449,879,430,1,70,India
826235,2024-02-15,502,iphone 15 pro max,100000,135000,35000,1,70,India
826235,2024-02-15,503,mixer,1349,3249,1900,1,70,India
826235,2024-02-15,501,iphone 15,60000,80000,20000,1,70,India
693801,2024-02-15,506,monitor,3249,8000,4751,1,493,India
693801,2024-02-15,502,iphone 15 pro max,100000,135000,35000,1,493,India
868729,2024-02-15,503,mixer,1349,3249,1900,1,280,India
868729,2024-02-15,507,washing machine,6990,16490,9500,1,280,India
628461,2024-02-15,504,iron,449,879,430,1,488,India
628461,2024-02-15,502,iphone 15 pro max,100000,135000,35000,1,488,India
857408,2024-02-16,504,iron,449,879,430,1,204,India
857408,2024-02-16,505,oven,18490,24000,5510,1,204,India
546161,2024-02-16,505,oven,18490,24000,5510,1,464,India
546161,2024-02-16,501,iphone 15,60000,80000,20000,1,464,India
546161,2024-02-16,507,washing machine,6990,16490,9500,1,464,India
546161,2024-02-16,504,iron,449,879,430,1,464,India
936996,2024-02-16,503,mixer,1349,3249,1900,1,285,India
810360,2024-02-16,501,iphone 15,60000,80000,20000,1,335,India
810360,2024-02-16,503,mixer,1349,3249,1900,1,335,India
810360,2024-02-16,505,oven,18490,24000,5510,1,335,India
349462,2024-02-16,505,oven,18490,24000,5510,1,365,India
349462,2024-02-16,503,mixer,1349,3249,1900,1,365,India
349462,2024-02-16,501,iphone 15,60000,80000,20000,1,365,India
806312,2024-02-16,505,oven,18490,24000,5510,1,67,India
152242,2024-02-16,503,mixer,1349,3249,1900,1,278,India
152242,2024-02-16,506,monitor,3249,8000,4751,1,278,India
832023,2024-02-16,501,iphone 15,60000,80000,20000,1,206,India
832023,2024-02-16,506,monitor,3249,8000,4751,1,206,India
832023,2024-02-16,505,oven,18490,24000,5510,1,206,India
959820,2024-02-16,503,mixer,1349,3249,1900,1,350,India
959820,2024-02-16,501,iphone 15,60000,80000,20000,1,350,India
752432,2024-02-16,503,mixer,1349,3249,1900,1,46,India
752432,2024-02-16,505,oven,18490,24000,5510,1,46,India
331105,2024-02-16,503,mixer,1349,3249,1900,1,108,India
331105,2024-02-16,501,iphone 15,60000,80000,20000,1,108,India
331105,2024-02-16,507,washing machine,6990,16490,9500,1,108,India
833845,2024-02-16,503,mixer,1349,3249,1900,1,26,India
833845,2024-02-16,504,iron,449,879,430,1,26,India
851030,2024-02-16,507,washing machine,6990,16490,9500,1,482,India
851030,2024-02-16,503,mixer,1349,3249,1900,1,482,India
851030,2024-02-16,501,iphone 15,60000,80000,20000,1,482,India
851030,2024-02-16,506,monitor,3249,8000,4751,1,482,India
668024,2024-02-16,506,monitor,3249,8000,4751,1,26,India
668024,2024-02-16,501,iphone 15,60000,80000,20000,1,26,India
646853,2024-02-16,504,iron,449,879,430,1,216,India
646853,2024-02-16,502,iphone 15 pro max,100000,135000,35000,1,216,India
646853,2024-02-16,501,iphone 15,60000,80000,20000,1,216,India
650654,2024-02-16,507,washing machine,6990,16490,9500,1,240,India
650654,2024-02-16,503,mixer,1349,3249,1900,1,240,India
650654,2024-02-16,504,iron,449,879,430,1,240,India
650654,2024-02-16,501,iphone 15,60000,80000,20000,1,240,India
432155,2024-02-16,507,washing machine,6990,16490,9500,1,18,India
275059,2024-02-16,501,iphone 15,60000,80000,20000,1,171,India
275059,2024-02-16,507,washing machine,6990,16490,9500,1,171,India
275059,2024-02-16,506,monitor,3249,8000,4751,1,171,India
897795,2024-02-16,503,mixer,1349,3249,1900,1,451,India
897795,2024-02-16,506,monitor,3249,8000,4751,1,451,India
897795,2024-02-16,502,iphone 15 pro max,100000,135000,35000,1,451,India
897795,2024-02-16,505,oven,18490,24000,5510,1,451,India
602661,2024-02-16,502,iphone 15 pro max,100000,135000,35000,1,204,India
229352,2024-02-16,504,iron,449,879,430,1,245,India
229352,2024-02-16,503,mixer,1349,3249,1900,1,245,India
229352,2024-02-16,507,washing machine,6990,16490,9500,1,245,India
229352,2024-02-16,502,iphone 15 pro max,100000,135000,35000,1,245,India
405720,2024-02-16,503,mixer,1349,3249,1900,1,121,India
890828,2024-02-16,507,washing machine,6990,16490,9500,1,151,India
251680,2024-02-16,504,iron,449,879,430,1,319,India
251680,2024-02-16,506,monitor,3249,8000,4751,1,319,India
251680,2024-02-16,502,iphone 15 pro max,100000,135000,35000,1,319,India
251680,2024-02-16,507,washing machine,6990,16490,9500,1,319,India
267101,2024-02-16,505,oven,18490,24000,5510,1,76,India
267101,2024-02-16,502,iphone 15 pro max,100000,135000,35000,1,76,India
267101,2024-02-16,507,washing machine,6990,16490,9500,1,76,India
595425,2024-02-16,506,monitor,3249,8000,4751,1,107,India
595425,2024-02-16,502,iphone 15 pro max,100000,135000,35000,1,107,India
369554,2024-02-16,503,mixer,1349,3249,1900,1,152,India
770254,2024-02-16,502,iphone 15 pro max,100000,135000,35000,1,220,India
770254,2024-02-16,504,iron,449,879,430,1,220,India
770254,2024-02-16,501,iphone 15,60000,80000,20000,1,220,India
770254,2024-02-16,506,monitor,3249,8000,4751,1,220,India
201339,2024-02-16,506,monitor,3249,8000,4751,1,361,India
201339,2024-02-16,507,washing machine,6990,16490,9500,1,361,India
139308,2024-02-16,503,mixer,1349,3249,1900,1,274,India
139308,2024-02-16,501,iphone 15,60000,80000,20000,1,274,India
423336,2024-02-16,505,oven,18490,24000,5510,1,482,India
423336,2024-02-16,506,monitor,3249,8000,4751,1,482,India
423336,2024-02-16,503,mixer,1349,3249,1900,1,482,India
423336,2024-02-16,504,iron,449,879,430,1,482,India
637350,2024-02-16,505,oven,18490,24000,5510,1,487,India
637350,2024-02-16,504,iron,449,879,430,1,487,India
763530,2024-02-16,503,mixer,1349,3249,1900,1,385,India
763530,2024-02-16,502,iphone 15 pro max,100000,135000,35000,1,385,India
884402,2024-02-16,503,mixer,1349,3249,1900,1,378,India
884402,2024-02-16,506,monitor,3249,8000,4751,1,378,India
884402,2024-02-16,501,iphone 15,60000,80000,20000,1,378,India
129580,2024-02-16,502,iphone 15 pro max,100000,135000,35000,1,390,India
129580,2024-02-16,507,washing machine,6990,16490,9500,1,390,India
129580,2024-02-16,503,mixer,1349,3249,1900,1,390,India
129580,2024-02-16,506,monitor,3249,8000,4751,1,390,India
129580,2024-02-16,504,iron,449,879,430,1,390,India
804535,2024-02-16,503,mixer,1349,3249,1900,1,475,India
804535,2024-02-16,502,iphone 15 pro max,100000,135000,35000,1,475,India
804535,2024-02-16,505,oven,18490,24000,5510,1,475,India
114115,2024-02-16,504,iron,449,879,430,1,138,India
114115,2024-02-16,507,washing machine,6990,16490,9500,1,138,India
114115,2024-02-16,506,monitor,3249,8000,4751,1,138,India
161505,2024-02-16,505,oven,18490,24000,5510,1,321,India
161505,2024-02-16,502,iphone 15 pro max,100000,135000,35000,1,321,India
161505,2024-02-16,506,monitor,3249,8000,4751,1,321,India
161505,2024-02-16,501,iphone 15,60000,80000,20000,1,321,India
161505,2024-02-16,503,mixer,1349,3249,1900,1,321,India
890154,2024-02-16,503,mixer,1349,3249,1900,1,167,India
890154,2024-02-16,501,iphone 15,60000,80000,20000,1,167,India
890154,2024-02-16,505,oven,18490,24000,5510,1,167,India
322760,2024-02-16,505,oven,18490,24000,5510,1,443,India
322760,2024-02-16,503,mixer,1349,3249,1900,1,443,India
858860,2024-02-16,502,iphone 15 pro max,100000,135000,35000,1,65,India
858860,2024-02-16,506,monitor,3249,8000,4751,1,65,India
945790,2024-02-16,504,iron,449,879,430,1,285,India
893532,2024-02-16,506,monitor,3249,8000,4751,1,149,India
893532,2024-02-16,504,iron,449,879,430,1,149,India
695136,2024-02-16,505,oven,18490,24000,5510,1,73,India
695136,2024-02-16,502,iphone 15 pro max,100000,135000,35000,1,73,India
695136,2024-02-16,503,mixer,1349,3249,1900,1,73,India
695136,2024-02-16,507,washing machine,6990,16490,9500,1,73,India
845905,2024-02-16,501,iphone 15,60000,80000,20000,1,420,India
845905,2024-02-16,502,iphone 15 pro max,100000,135000,35000,1,420,India
484285,2024-02-16,502,iphone 15 pro max,100000,135000,35000,1,437,India
484285,2024-02-16,501,iphone 15,60000,80000,20000,1,437,India
425092,2024-02-16,507,washing machine,6990,16490,9500,1,263,India
425092,2024-02-16,504,iron,449,879,430,1,263,India
425092,2024-02-16,505,oven,18490,24000,5510,1,263,India
168622,2024-02-16,502,iphone 15 pro max,100000,135000,35000,1,325,India
168622,2024-02-16,501,iphone 15,60000,80000,20000,1,325,India
392651,2024-02-16,505,oven,18490,24000,5510,1,250,India
929299,2024-02-16,505,oven,18490,24000,5510,1,305,India
929299,2024-02-16,503,mixer,1349,3249,1900,1,305,India
929299,2024-02-16,502,iphone 15 pro max,100000,135000,35000,1,305,India
957376,2024-02-16,506,monitor,3249,8000,4751,1,246,India
622384,2024-02-16,506,monitor,3249,8000,4751,1,285,India
622384,2024-02-16,507,washing machine,6990,16490,9500,1,285,India
424917,2024-02-16,501,iphone 15,60000,80000,20000,1,204,India
424917,2024-02-16,503,mixer,1349,3249,1900,1,204,India
717203,2024-02-16,507,washing machine,6990,16490,9500,1,433,India
717203,2024-02-16,506,monitor,3249,8000,4751,1,433,India
717203,2024-02-16,504,iron,449,879,430,1,433,India
128817,2024-02-16,503,mixer,1349,3249,1900,1,436,India
128817,2024-02-16,502,iphone 15 pro max,100000,135000,35000,1,436,India
128817,2024-02-16,506,monitor,3249,8000,4751,1,436,India
128817,2024-02-16,501,iphone 15,60000,80000,20000,1,436,India
925257,2024-02-16,507,washing machine,6990,16490,9500,1,457,India
925257,2024-02-16,505,oven,18490,24000,5510,1,457,India
404641,2024-02-16,505,oven,18490,24000,5510,1,312,India
404641,2024-02-16,503,mixer,1349,3249,1900,1,312,India
404641,2024-02-16,507,washing machine,6990,16490,9500,1,312,India
246027,2024-02-16,503,mixer,1349,3249,1900,1,410,India
246027,2024-02-16,504,iron,449,879,430,1,410,India
405005,2024-02-16,504,iron,449,879,430,1,313,India
405005,2024-02-16,502,iphone 15 pro max,100000,135000,35000,1,313,India
405005,2024-02-16,503,mixer,1349,3249,1900,1,313,India
406999,2024-02-16,501,iphone 15,60000,80000,20000,1,314,India
406999,2024-02-16,504,iron,449,879,430,1,314,India
406999,2024-02-16,506,monitor,3249,8000,4751,1,314,India
406999,2024-02-16,502,iphone 15 pro max,100000,135000,35000,1,314,India
406999,2024-02-16,507,washing machine,6990,16490,9500,1,314,India
536337,2024-02-16,506,monitor,3249,8000,4751,1,231,India
536337,2024-02-16,502,iphone 15 pro max,100000,135000,35000,1,231,India
849425,2024-02-16,501,iphone 15,60000,80000,20000,1,219,India
196805,2024-02-16,505,oven,18490,24000,5510,1,225,India
196805,2024-02-16,504,iron,449,879,430,1,225,India
838761,2024-02-16,505,oven,18490,24000,5510,1,459,India
838761,2024-02-16,507,washing machine,6990,16490,9500,1,459,India
838761,2024-02-16,501,iphone 15,60000,80000,20000,1,459,India
838761,2024-02-16,504,iron,449,879,430,1,459,India
260137,2024-02-16,501,iphone 15,60000,80000,20000,1,193,India
260137,2024-02-16,503,mixer,1349,3249,1900,1,193,India
260137,2024-02-16,502,iphone 15 pro max,100000,135000,35000,1,193,India
106416,2024-02-16,501,iphone 15,60000,80000,20000,1,384,India
106416,2024-02-16,504,iron,449,879,430,1,384,India
791841,2024-02-16,501,iphone 15,60000,80000,20000,1,201,India
791841,2024-02-16,504,iron,449,879,430,1,201,India
791841,2024-02-16,502,iphone 15 pro max,100000,135000,35000,1,201,India
404660,2024-02-16,502,iphone 15 pro max,100000,135000,35000,1,34,India
404660,2024-02-16,503,mixer,1349,3249,1900,1,34,India
603574,2024-02-16,507,washing machine,6990,16490,9500,1,76,India
603574,2024-02-16,505,oven,18490,24000,5510,1,76,India
603574,2024-02-16,504,iron,449,879,430,1,76,India
235677,2024-02-16,501,iphone 15,60000,80000,20000,1,17,India
235677,2024-02-16,502,iphone 15 pro max,100000,135000,35000,1,17,India
235677,2024-02-16,507,washing machine,6990,16490,9500,1,17,India
235677,2024-02-16,506,monitor,3249,8000,4751,1,17,India
307961,2024-02-16,505,oven,18490,24000,5510,1,171,India
307961,2024-02-16,501,iphone 15,60000,80000,20000,1,171,India
165418,2024-02-16,501,iphone 15,60000,80000,20000,1,63,India
165418,2024-02-16,502,iphone 15 pro max,100000,135000,35000,1,63,India
165418,2024-02-16,506,monitor,3249,8000,4751,1,63,India
165418,2024-02-16,504,iron,449,879,430,1,63,India
967212,2024-02-16,503,mixer,1349,3249,1900,1,300,India
967212,2024-02-16,504,iron,449,879,430,1,300,India
967212,2024-02-16,506,monitor,3249,8000,4751,1,300,India
967212,2024-02-16,505,oven,18490,24000,5510,1,300,India
714031,2024-02-16,501,iphone 15,60000,80000,20000,1,318,India
714031,2024-02-16,503,mixer,1349,3249,1900,1,318,India
714031,2024-02-16,502,iphone 15 pro max,100000,135000,35000,1,318,India
176009,2024-02-16,505,oven,18490,24000,5510,1,390,India
176009,2024-02-16,506,monitor,3249,8000,4751,1,390,India
234876,2024-02-16,505,oven,18490,24000,5510,1,306,India
234876,2024-02-16,504,iron,449,879,430,1,306,India
234876,2024-02-16,501,iphone 15,60000,80000,20000,1,306,India
234876,2024-02-16,506,monitor,3249,8000,4751,1,306,India
234876,2024-02-16,507,washing machine,6990,16490,9500,1,306,India
556980,2024-02-17,501,iphone 15,60000,80000,20000,1,128,India
556980,2024-02-17,505,oven,18490,24000,5510,1,128,India
556980,2024-02-17,502,iphone 15 pro max,100000,135000,35000,1,128,India
418596,2024-02-17,501,iphone 15,60000,80000,20000,1,364,India
418596,2024-02-17,503,mixer,1349,3249,1900,1,364,India
366475,2024-02-17,507,washing machine,6990,16490,9500,1,280,India
366475,2024-02-17,503,mixer,1349,3249,1900,1,280,India
366475,2024-02-17,502,iphone 15 pro max,100000,135000,35000,1,280,India
569416,2024-02-17,506,monitor,3249,8000,4751,1,260,India
475402,2024-02-17,504,iron,449,879,430,1,250,India
475402,2024-02-17,507,washing machine,6990,16490,9500,1,250,India
259493,2024-02-17,504,iron,449,879,430,1,124,India
259493,2024-02-17,507,washing machine,6990,16490,9500,1,124,India
259493,2024-02-17,503,mixer,1349,3249,1900,1,124,India
259493,2024-02-17,505,oven,18490,24000,5510,1,124,India
853815,2024-02-17,501,iphone 15,60000,80000,20000,1,257,India
853815,2024-02-17,504,iron,449,879,430,1,257,India
853815,2024-02-17,505,oven,18490,24000,5510,1,257,India
853815,2024-02-17,502,iphone 15 pro max,100000,135000,35000,1,257,India
559093,2024-02-17,504,iron,449,879,430,1,380,India
559093,2024-02-17,501,iphone 15,60000,80000,20000,1,380,India
559093,2024-02-17,505,oven,18490,24000,5510,1,380,India
628934,2024-02-17,502,iphone 15 pro max,100000,135000,35000,1,396,India
628934,2024-02-17,504,iron,449,879,430,1,396,India
318440,2024-02-17,503,mixer,1349,3249,1900,1,476,India
157271,2024-02-17,501,iphone 15,60000,80000,20000,1,478,India
157271,2024-02-17,504,iron,449,879,430,1,478,India
663530,2024-02-17,505,oven,18490,24000,5510,1,456,India
681333,2024-02-17,505,oven,18490,24000,5510,1,64,India
681333,2024-02-17,503,mixer,1349,3249,1900,1,64,India
681333,2024-02-17,506,monitor,3249,8000,4751,1,64,India
681333,2024-02-17,501,iphone 15,60000,80000,20000,1,64,India
419265,2024-02-17,503,mixer,1349,3249,1900,1,152,India
419265,2024-02-17,502,iphone 15 pro max,100000,135000,35000,1,152,India
419265,2024-02-17,501,iphone 15,60000,80000,20000,1,152,India
756466,2024-02-17,502,iphone 15 pro max,100000,135000,35000,1,242,India
756466,2024-02-17,506,monitor,3249,8000,4751,1,242,India
756466,2024-02-17,501,iphone 15,60000,80000,20000,1,242,India
283216,2024-02-17,506,monitor,3249,8000,4751,1,343,India
989859,2024-02-17,501,iphone 15,60000,80000,20000,1,425,India
989859,2024-02-17,503,mixer,1349,3249,1900,1,425,India
989859,2024-02-17,504,iron,449,879,430,1,425,India
989859,2024-02-17,507,washing machine,6990,16490,9500,1,425,India
269967,2024-02-17,503,mixer,1349,3249,1900,1,268,India
269967,2024-02-17,504,iron,449,879,430,1,268,India
269967,2024-02-17,507,washing machine,6990,16490,9500,1,268,India
269967,2024-02-17,505,oven,18490,24000,5510,1,268,India
980955,2024-02-17,501,iphone 15,60000,80000,20000,1,162,India
917146,2024-02-17,507,washing machine,6990,16490,9500,1,321,India
145877,2024-02-17,502,iphone 15 pro max,100000,135000,35000,1,256,India
145877,2024-02-17,506,monitor,3249,8000,4751,1,256,India
145877,2024-02-17,504,iron,449,879,430,1,256,India
145877,2024-02-17,505,oven,18490,24000,5510,1,256,India
145877,2024-02-17,503,mixer,1349,3249,1900,1,256,India
907702,2024-02-17,507,washing machine,6990,16490,9500,1,76,India
907702,2024-02-17,502,iphone 15 pro max,100000,135000,35000,1,76,India
907702,2024-02-17,506,monitor,3249,8000,4751,1,76,India
995917,2024-02-17,507,washing machine,6990,16490,9500,1,112,India
995917,2024-02-17,505,oven,18490,24000,5510,1,112,India
532848,2024-02-17,502,iphone 15 pro max,100000,135000,35000,1,271,India
532848,2024-02-17,503,mixer,1349,3249,1900,1,271,India
541124,2024-02-17,501,iphone 15,60000,80000,20000,1,410,India
950631,2024-02-17,503,mixer,1349,3249,1900,1,305,India
531682,2024-02-17,502,iphone 15 pro max,100000,135000,35000,1,174,India
531682,2024-02-17,505,oven,18490,24000,5510,1,174,India
696263,2024-02-17,507,washing machine,6990,16490,9500,1,117,India
696263,2024-02-17,504,iron,449,879,430,1,117,India
696263,2024-02-17,501,iphone 15,60000,80000,20000,1,117,India
696263,2024-02-17,502,iphone 15 pro max,100000,135000,35000,1,117,India
300807,2024-02-17,503,mixer,1349,3249,1900,1,249,India
300807,2024-02-17,502,iphone 15 pro max,100000,135000,35000,1,249,India
300807,2024-02-17,501,iphone 15,60000,80000,20000,1,249,India
577110,2024-02-17,501,iphone 15,60000,80000,20000,1,64,India
577110,2024-02-17,505,oven,18490,24000,5510,1,64,India
972655,2024-02-17,501,iphone 15,60000,80000,20000,1,1,India
972655,2024-02-17,502,iphone 15 pro max,100000,135000,35000,1,1,India
564138,2024-02-17,507,washing machine,6990,16490,9500,1,21,India
811917,2024-02-17,505,oven,18490,24000,5510,1,357,India
811917,2024-02-17,507,washing machine,6990,16490,9500,1,357,India
844995,2024-02-17,506,monitor,3249,8000,4751,1,148,India
844995,2024-02-17,505,oven,18490,24000,5510,1,148,India
844995,2024-02-17,504,iron,449,879,430,1,148,India
844995,2024-02-17,502,iphone 15 pro max,100000,135000,35000,1,148,India
479662,2024-02-17,507,washing machine,6990,16490,9500,1,176,India
479662,2024-02-17,501,iphone 15,60000,80000,20000,1,176,India
479662,2024-02-17,506,monitor,3249,8000,4751,1,176,India
479662,2024-02-17,505,oven,18490,24000,5510,1,176,India
479662,2024-02-17,503,mixer,1349,3249,1900,1,176,India
933487,2024-02-17,506,monitor,3249,8000,4751,1,483,India
772402,2024-02-17,507,washing machine,6990,16490,9500,1,21,India
629130,2024-02-17,504,iron,449,879,430,1,195,India
629130,2024-02-17,502,iphone 15 pro max,100000,135000,35000,1,195,India
629130,2024-02-17,506,monitor,3249,8000,4751,1,195,India
433434,2024-02-17,502,iphone 15 pro max,100000,135000,35000,1,188,India
433434,2024-02-17,505,oven,18490,24000,5510,1,188,India
433434,2024-02-17,506,monitor,3249,8000,4751,1,188,India
302050,2024-02-17,504,iron,449,879,430,1,30,India
302050,2024-02-17,507,washing machine,6990,16490,9500,1,30,India
699658,2024-02-17,502,iphone 15 pro max,100000,135000,35000,1,33,India
699658,2024-02-17,507,washing machine,6990,16490,9500,1,33,India
858848,2024-02-17,502,iphone 15 pro max,100000,135000,35000,1,113,India
858848,2024-02-17,504,iron,449,879,430,1,113,India
858848,2024-02-17,503,mixer,1349,3249,1900,1,113,India
428446,2024-02-17,502,iphone 15 pro max,100000,135000,35000,1,27,India
428446,2024-02-17,506,monitor,3249,8000,4751,1,27,India
438080,2024-02-17,505,oven,18490,24000,5510,1,410,India
438080,2024-02-17,507,washing machine,6990,16490,9500,1,410,India
438080,2024-02-17,502,iphone 15 pro max,100000,135000,35000,1,410,India
438080,2024-02-17,506,monitor,3249,8000,4751,1,410,India
473244,2024-02-17,502,iphone 15 pro max,100000,135000,35000,1,218,India
643074,2024-02-17,506,monitor,3249,8000,4751,1,290,India
643074,2024-02-17,504,iron,449,879,430,1,290,India
431665,2024-02-17,503,mixer,1349,3249,1900,1,473,India
431665,2024-02-17,501,iphone 15,60000,80000,20000,1,473,India
525336,2024-02-17,503,mixer,1349,3249,1900,1,34,India
525336,2024-02-17,504,iron,449,879,430,1,34,India
675594,2024-02-17,502,iphone 15 pro max,100000,135000,35000,1,41,India
675594,2024-02-17,507,washing machine,6990,16490,9500,1,41,India
675594,2024-02-17,506,monitor,3249,8000,4751,1,41,India
727268,2024-02-17,503,mixer,1349,3249,1900,1,443,India
727268,2024-02-17,501,iphone 15,60000,80000,20000,1,443,India
727268,2024-02-17,505,oven,18490,24000,5510,1,443,India
727268,2024-02-17,502,iphone 15 pro max,100000,135000,35000,1,443,India
552110,2024-02-17,504,iron,449,879,430,1,361,India
894254,2024-02-17,505,oven,18490,24000,5510,1,164,India
942462,2024-02-17,505,oven,18490,24000,5510,1,186,India
942462,2024-02-17,501,iphone 15,60000,80000,20000,1,186,India
687503,2024-02-17,506,monitor,3249,8000,4751,1,258,India
687503,2024-02-17,503,mixer,1349,3249,1900,1,258,India
687503,2024-02-17,502,iphone 15 pro max,100000,135000,35000,1,258,India
687503,2024-02-17,507,washing machine,6990,16490,9500,1,258,India
231796,2024-02-17,507,washing machine,6990,16490,9500,1,147,India
231796,2024-02-17,505,oven,18490,24000,5510,1,147,India
231796,2024-02-17,506,monitor,3249,8000,4751,1,147,India
195779,2024-02-17,503,mixer,1349,3249,1900,1,338,India
550673,2024-02-17,505,oven,18490,24000,5510,1,385,India
550673,2024-02-17,501,iphone 15,60000,80000,20000,1,385,India
550673,2024-02-17,502,iphone 15 pro max,100000,135000,35000,1,385,India
543574,2024-02-17,504,iron,449,879,430,1,323,India
543574,2024-02-17,503,mixer,1349,3249,1900,1,323,India
206410,2024-02-17,505,oven,18490,24000,5510,1,365,India
206410,2024-02-17,504,iron,449,879,430,1,365,India
206410,2024-02-17,502,iphone 15 pro max,100000,135000,35000,1,365,India
695474,2024-02-17,507,washing machine,6990,16490,9500,1,424,India
695474,2024-02-17,503,mixer,1349,3249,1900,1,424,India
695474,2024-02-17,506,monitor,3249,8000,4751,1,424,India
593122,2024-02-17,504,iron,449,879,430,1,226,India
593122,2024-02-17,506,monitor,3249,8000,4751,1,226,India
593122,2024-02-17,502,iphone 15 pro max,100000,135000,35000,1,226,India
593122,2024-02-17,501,iphone 15,60000,80000,20000,1,226,India
686050,2024-02-17,506,monitor,3249,8000,4751,1,349,India
686050,2024-02-17,505,oven,18490,24000,5510,1,349,India
358784,2024-02-17,502,iphone 15 pro max,100000,135000,35000,1,390,India
358784,2024-02-17,501,iphone 15,60000,80000,20000,1,390,India
358784,2024-02-17,507,washing machine,6990,16490,9500,1,390,India
706753,2024-02-17,503,mixer,1349,3249,1900,1,136,India
243999,2024-02-17,503,mixer,1349,3249,1900,1,468,India
243999,2024-02-17,504,iron,449,879,430,1,468,India
266801,2024-02-17,505,oven,18490,24000,5510,1,211,India
266801,2024-02-17,503,mixer,1349,3249,1900,1,211,India
499342,2024-02-17,506,monitor,3249,8000,4751,1,351,India
309119,2024-02-17,501,iphone 15,60000,80000,20000,1,361,India
101730,2024-02-17,501,iphone 15,60000,80000,20000,1,332,India
583253,2024-02-17,503,mixer,1349,3249,1900,1,330,India
583253,2024-02-17,505,oven,18490,24000,5510,1,330,India
583253,2024-02-17,501,iphone 15,60000,80000,20000,1,330,India
583253,2024-02-17,507,washing machine,6990,16490,9500,1,330,India
169808,2024-02-17,507,washing machine,6990,16490,9500,1,214,India
169808,2024-02-17,502,iphone 15 pro max,100000,135000,35000,1,214,India
169808,2024-02-17,501,iphone 15,60000,80000,20000,1,214,India
169808,2024-02-17,506,monitor,3249,8000,4751,1,214,India
169808,2024-02-17,503,mixer,1349,3249,1900,1,214,India
178273,2024-02-17,506,monitor,3249,8000,4751,1,259,India
178273,2024-02-17,505,oven,18490,24000,5510,1,259,India
178273,2024-02-17,507,washing machine,6990,16490,9500,1,259,India
543708,2024-02-17,502,iphone 15 pro max,100000,135000,35000,1,96,India
543708,2024-02-17,506,monitor,3249,8000,4751,1,96,India
543708,2024-02-17,507,washing machine,6990,16490,9500,1,96,India
543708,2024-02-17,505,oven,18490,24000,5510,1,96,India
636750,2024-02-18,503,mixer,1349,3249,1900,1,470,India
636750,2024-02-18,505,oven,18490,24000,5510,1,470,India
636750,2024-02-18,502,iphone 15 pro max,100000,135000,35000,1,470,India
657668,2024-02-18,506,monitor,3249,8000,4751,1,190,India
657668,2024-02-18,504,iron,449,879,430,1,190,India
503576,2024-02-18,507,washing machine,6990,16490,9500,1,37,India
503576,2024-02-18,506,monitor,3249,8000,4751,1,37,India
503576,2024-02-18,504,iron,449,879,430,1,37,India
503576,2024-02-18,505,oven,18490,24000,5510,1,37,India
604704,2024-02-18,505,oven,18490,24000,5510,1,267,India
604704,2024-02-18,506,monitor,3249,8000,4751,1,267,India
604704,2024-02-18,502,iphone 15 pro max,100000,135000,35000,1,267,India
604704,2024-02-18,501,iphone 15,60000,80000,20000,1,267,India
783838,2024-02-18,502,iphone 15 pro max,100000,135000,35000,1,16,India
783838,2024-02-18,504,iron,449,879,430,1,16,India
783838,2024-02-18,503,mixer,1349,3249,1900,1,16,India
261728,2024-02-18,506,monitor,3249,8000,4751,1,210,India
261728,2024-02-18,501,iphone 15,60000,80000,20000,1,210,India
399353,2024-02-18,503,mixer,1349,3249,1900,1,225,India
399353,2024-02-18,505,oven,18490,24000,5510,1,225,India
399353,2024-02-18,507,washing machine,6990,16490,9500,1,225,India
399353,2024-02-18,506,monitor,3249,8000,4751,1,225,India
807334,2024-02-18,506,monitor,3249,8000,4751,1,403,India
807334,2024-02-18,503,mixer,1349,3249,1900,1,403,India
807334,2024-02-18,505,oven,18490,24000,5510,1,403,India
996367,2024-02-18,503,mixer,1349,3249,1900,1,147,India
996367,2024-02-18,504,iron,449,879,430,1,147,India
996367,2024-02-18,507,washing machine,6990,16490,9500,1,147,India
762842,2024-02-18,503,mixer,1349,3249,1900,1,275,India
762842,2024-02-18,507,washing machine,6990,16490,9500,1,275,India
762842,2024-02-18,501,iphone 15,60000,80000,20000,1,275,India
141993,2024-02-18,501,iphone 15,60000,80000,20000,1,352,India
131379,2024-02-18,507,washing machine,6990,16490,9500,1,458,India
131379,2024-02-18,506,monitor,3249,8000,4751,1,458,India
943549,2024-02-18,502,iphone 15 pro max,100000,135000,35000,1,358,India
680766,2024-02-18,501,iphone 15,60000,80000,20000,1,410,India
680766,2024-02-18,504,iron,449,879,430,1,410,India
372593,2024-02-18,505,oven,18490,24000,5510,1,210,India
372593,2024-02-18,503,mixer,1349,3249,1900,1,210,India
372593,2024-02-18,502,iphone 15 pro max,100000,135000,35000,1,210,India
436701,2024-02-18,501,iphone 15,60000,80000,20000,1,465,India
556191,2024-02-18,506,monitor,3249,8000,4751,1,284,India
556191,2024-02-18,504,iron,449,879,430,1,284,India
556191,2024-02-18,505,oven,18490,24000,5510,1,284,India
939933,2024-02-18,501,iphone 15,60000,80000,20000,1,15,India
939933,2024-02-18,502,iphone 15 pro max,100000,135000,35000,1,15,India
939933,2024-02-18,503,mixer,1349,3249,1900,1,15,India
633864,2024-02-18,506,monitor,3249,8000,4751,1,497,India
633864,2024-02-18,507,washing machine,6990,16490,9500,1,497,India
312729,2024-02-18,507,washing machine,6990,16490,9500,1,146,India
358972,2024-02-18,506,monitor,3249,8000,4751,1,417,India
358972,2024-02-18,505,oven,18490,24000,5510,1,417,India
358972,2024-02-18,507,washing machine,6990,16490,9500,1,417,India
190168,2024-02-18,503,mixer,1349,3249,1900,1,400,India
190168,2024-02-18,506,monitor,3249,8000,4751,1,400,India
190168,2024-02-18,507,washing machine,6990,16490,9500,1,400,India
190168,2024-02-18,501,iphone 15,60000,80000,20000,1,400,India
445158,2024-02-18,502,iphone 15 pro max,100000,135000,35000,1,67,India
445158,2024-02-18,507,washing machine,6990,16490,9500,1,67,India
781074,2024-02-18,507,washing machine,6990,16490,9500,1,81,India
781788,2024-02-18,507,washing machine,6990,16490,9500,1,215,India
781788,2024-02-18,504,iron,449,879,430,1,215,India
540182,2024-02-18,507,washing machine,6990,16490,9500,1,189,India
540182,2024-02-18,503,mixer,1349,3249,1900,1,189,India
540182,2024-02-18,506,monitor,3249,8000,4751,1,189,India
687306,2024-02-18,507,washing machine,6990,16490,9500,1,432,India
687306,2024-02-18,506,monitor,3249,8000,4751,1,432,India
687306,2024-02-18,504,iron,449,879,430,1,432,India
687306,2024-02-18,505,oven,18490,24000,5510,1,432,India
687306,2024-02-18,503,mixer,1349,3249,1900,1,432,India
201617,2024-02-18,505,oven,18490,24000,5510,1,82,India
201617,2024-02-18,501,iphone 15,60000,80000,20000,1,82,India
201617,2024-02-18,506,monitor,3249,8000,4751,1,82,India
998488,2024-02-18,507,washing machine,6990,16490,9500,1,19,India
998488,2024-02-18,504,iron,449,879,430,1,19,India
998488,2024-02-18,503,mixer,1349,3249,1900,1,19,India
998488,2024-02-18,505,oven,18490,24000,5510,1,19,India
441846,2024-02-18,504,iron,449,879,430,1,38,India
441846,2024-02-18,501,iphone 15,60000,80000,20000,1,38,India
441846,2024-02-18,505,oven,18490,24000,5510,1,38,India
441846,2024-02-18,503,mixer,1349,3249,1900,1,38,India
387637,2024-02-18,502,iphone 15 pro max,100000,135000,35000,1,354,India
387637,2024-02-18,507,washing machine,6990,16490,9500,1,354,India
685732,2024-02-18,502,iphone 15 pro max,100000,135000,35000,1,353,India
685732,2024-02-18,507,washing machine,6990,16490,9500,1,353,India
685732,2024-02-18,501,iphone 15,60000,80000,20000,1,353,India
685732,2024-02-18,506,monitor,3249,8000,4751,1,353,India
582656,2024-02-18,506,monitor,3249,8000,4751,1,293,India
582656,2024-02-18,501,iphone 15,60000,80000,20000,1,293,India
506335,2024-02-18,506,monitor,3249,8000,4751,1,287,India
506335,2024-02-18,507,washing machine,6990,16490,9500,1,287,India
506335,2024-02-18,502,iphone 15 pro max,100000,135000,35000,1,287,India
832656,2024-02-18,506,monitor,3249,8000,4751,1,100,India
832656,2024-02-18,505,oven,18490,24000,5510,1,100,India
125771,2024-02-18,506,monitor,3249,8000,4751,1,194,India
414401,2024-02-18,505,oven,18490,24000,5510,1,241,India
414401,2024-02-18,501,iphone 15,60000,80000,20000,1,241,India
414401,2024-02-18,507,washing machine,6990,16490,9500,1,241,India
982645,2024-02-18,503,mixer,1349,3249,1900,1,418,India
982645,2024-02-18,502,iphone 15 pro max,100000,135000,35000,1,418,India
760510,2024-02-18,501,iphone 15,60000,80000,20000,1,428,India
760510,2024-02-18,506,monitor,3249,8000,4751,1,428,India
834200,2024-02-18,505,oven,18490,24000,5510,1,11,India
906788,2024-02-18,504,iron,449,879,430,1,270,India
906788,2024-02-18,503,mixer,1349,3249,1900,1,270,India
906788,2024-02-18,505,oven,18490,24000,5510,1,270,India
906788,2024-02-18,502,iphone 15 pro max,100000,135000,35000,1,270,India
379025,2024-02-18,503,mixer,1349,3249,1900,1,443,India
379025,2024-02-18,505,oven,18490,24000,5510,1,443,India
379025,2024-02-18,502,iphone 15 pro max,100000,135000,35000,1,443,India
275015,2024-02-18,504,iron,449,879,430,1,316,India
275015,2024-02-18,503,mixer,1349,3249,1900,1,316,India
275015,2024-02-18,505,oven,18490,24000,5510,1,316,India
275015,2024-02-18,506,monitor,3249,8000,4751,1,316,India
540198,2024-02-18,506,monitor,3249,8000,4751,1,429,India
540198,2024-02-18,503,mixer,1349,3249,1900,1,429,India
540198,2024-02-18,502,iphone 15 pro max,100000,135000,35000,1,429,India
540198,2024-02-18,505,oven,18490,24000,5510,1,429,India
392100,2024-02-18,503,mixer,1349,3249,1900,1,46,India
392100,2024-02-18,502,iphone 15 pro max,100000,135000,35000,1,46,India
392100,2024-02-18,504,iron,449,879,430,1,46,India
994913,2024-02-18,506,monitor,3249,8000,4751,1,397,India
367650,2024-02-18,504,iron,449,879,430,1,444,India
367650,2024-02-18,503,mixer,1349,3249,1900,1,444,India
367650,2024-02-18,501,iphone 15,60000,80000,20000,1,444,India
367650,2024-02-18,505,oven,18490,24000,5510,1,444,India
473458,2024-02-18,502,iphone 15 pro max,100000,135000,35000,1,90,India
359485,2024-02-18,506,monitor,3249,8000,4751,1,296,India
901267,2024-02-18,507,washing machine,6990,16490,9500,1,38,India
901267,2024-02-18,501,iphone 15,60000,80000,20000,1,38,India
901267,2024-02-18,503,mixer,1349,3249,1900,1,38,India
901267,2024-02-18,502,iphone 15 pro max,100000,135000,35000,1,38,India
393246,2024-02-18,501,iphone 15,60000,80000,20000,1,435,India
393246,2024-02-18,507,washing machine,6990,16490,9500,1,435,India
393246,2024-02-18,505,oven,18490,24000,5510,1,435,India
196064,2024-02-18,507,washing machine,6990,16490,9500,1,96,India
196064,2024-02-18,503,mixer,1349,3249,1900,1,96,India
196064,2024-02-18,502,iphone 15 pro max,100000,135000,35000,1,96,India
623068,2024-02-18,506,monitor,3249,8000,4751,1,239,India
623068,2024-02-18,505,oven,18490,24000,5510,1,239,India
623068,2024-02-18,503,mixer,1349,3249,1900,1,239,India
623068,2024-02-18,501,iphone 15,60000,80000,20000,1,239,India
623068,2024-02-18,507,washing machine,6990,16490,9500,1,239,India
505692,2024-02-18,503,mixer,1349,3249,1900,1,14,India
505692,2024-02-18,506,monitor,3249,8000,4751,1,14,India
505692,2024-02-18,505,oven,18490,24000,5510,1,14,India
900838,2024-02-18,504,iron,449,879,430,1,164,India
900838,2024-02-18,502,iphone 15 pro max,100000,135000,35000,1,164,India
900838,2024-02-18,507,washing machine,6990,16490,9500,1,164,India
509980,2024-02-18,505,oven,18490,24000,5510,1,357,India
509980,2024-02-18,503,mixer,1349,3249,1900,1,357,India
591536,2024-02-18,506,monitor,3249,8000,4751,1,160,India
591536,2024-02-18,504,iron,449,879,430,1,160,India
591536,2024-02-18,505,oven,18490,24000,5510,1,160,India
591536,2024-02-18,507,washing machine,6990,16490,9500,1,160,India
886047,2024-02-18,502,iphone 15 pro max,100000,135000,35000,1,166,India
886047,2024-02-18,506,monitor,3249,8000,4751,1,166,India
496280,2024-02-18,505,oven,18490,24000,5510,1,347,India
291804,2024-02-18,504,iron,449,879,430,1,359,India
291804,2024-02-18,506,monitor,3249,8000,4751,1,359,India
291804,2024-02-18,501,iphone 15,60000,80000,20000,1,359,India
291804,2024-02-18,502,iphone 15 pro max,100000,135000,35000,1,359,India
554130,2024-02-18,506,monitor,3249,8000,4751,1,429,India
554130,2024-02-18,501,iphone 15,60000,80000,20000,1,429,India
428232,2024-02-18,507,washing machine,6990,16490,9500,1,388,India
428232,2024-02-18,501,iphone 15,60000,80000,20000,1,388,India
428232,2024-02-18,504,iron,449,879,430,1,388,India
428232,2024-02-18,503,mixer,1349,3249,1900,1,388,India
688654,2024-02-18,507,washing machine,6990,16490,9500,1,417,India
688654,2024-02-18,501,iphone 15,60000,80000,20000,1,417,India
489420,2024-02-18,501,iphone 15,60000,80000,20000,1,340,India
765923,2024-02-18,501,iphone 15,60000,80000,20000,1,3,India
387391,2024-02-18,507,washing machine,6990,16490,9500,1,340,India
799016,2024-02-18,507,washing machine,6990,16490,9500,1,314,India
799016,2024-02-18,501,iphone 15,60000,80000,20000,1,314,India
799016,2024-02-18,503,mixer,1349,3249,1900,1,314,India
751328,2024-02-18,504,iron,449,879,430,1,409,India
751328,2024-02-18,503,mixer,1349,3249,1900,1,409,India
751328,2024-02-18,507,washing machine,6990,16490,9500,1,409,India
836947,2024-02-18,507,washing machine,6990,16490,9500,1,101,India
980666,2024-02-18,502,iphone 15 pro max,100000,135000,35000,1,3,India
980666,2024-02-18,501,iphone 15,60000,80000,20000,1,3,India
980666,2024-02-18,507,washing machine,6990,16490,9500,1,3,India
174934,2024-02-19,506,monitor,3249,8000,4751,1,418,India
764240,2024-02-19,503,mixer,1349,3249,1900,1,264,India
764240,2024-02-19,506,monitor,3249,8000,4751,1,264,India
764240,2024-02-19,505,oven,18490,24000,5510,1,264,India
573784,2024-02-19,507,washing machine,6990,16490,9500,1,16,India
573784,2024-02-19,503,mixer,1349,3249,1900,1,16,India
573784,2024-02-19,501,iphone 15,60000,80000,20000,1,16,India
113257,2024-02-19,507,washing machine,6990,16490,9500,1,217,India
113257,2024-02-19,505,oven,18490,24000,5510,1,217,India
113257,2024-02-19,506,monitor,3249,8000,4751,1,217,India
877607,2024-02-19,506,monitor,3249,8000,4751,1,363,India
877607,2024-02-19,503,mixer,1349,3249,1900,1,363,India
303264,2024-02-19,506,monitor,3249,8000,4751,1,64,India
303264,2024-02-19,502,iphone 15 pro max,100000,135000,35000,1,64,India
303264,2024-02-19,501,iphone 15,60000,80000,20000,1,64,India
804925,2024-02-19,502,iphone 15 pro max,100000,135000,35000,1,194,India
295381,2024-02-19,503,mixer,1349,3249,1900,1,6,India
295381,2024-02-19,501,iphone 15,60000,80000,20000,1,6,India
542025,2024-02-19,503,mixer,1349,3249,1900,1,471,India
253364,2024-02-19,507,washing machine,6990,16490,9500,1,318,India
253364,2024-02-19,501,iphone 15,60000,80000,20000,1,318,India
253364,2024-02-19,504,iron,449,879,430,1,318,India
499656,2024-02-19,502,iphone 15 pro max,100000,135000,35000,1,36,India
781252,2024-02-19,506,monitor,3249,8000,4751,1,196,India
781252,2024-02-19,504,iron,449,879,430,1,196,India
977362,2024-02-19,505,oven,18490,24000,5510,1,227,India
977362,2024-02-19,501,iphone 15,60000,80000,20000,1,227,India
977362,2024-02-19,507,washing machine,6990,16490,9500,1,227,India
922877,2024-02-19,503,mixer,1349,3249,1900,1,10,India
922877,2024-02-19,506,monitor,3249,8000,4751,1,10,India
452010,2024-02-19,501,iphone 15,60000,80000,20000,1,142,India
452010,2024-02-19,502,iphone 15 pro max,100000,135000,35000,1,142,India
452010,2024-02-19,507,washing machine,6990,16490,9500,1,142,India
303721,2024-02-19,502,iphone 15 pro max,100000,135000,35000,1,434,India
385847,2024-02-19,507,washing machine,6990,16490,9500,1,138,India
385847,2024-02-19,505,oven,18490,24000,5510,1,138,India
385847,2024-02-19,502,iphone 15 pro max,100000,135000,35000,1,138,India
979029,2024-02-19,505,oven,18490,24000,5510,1,169,India
979029,2024-02-19,502,iphone 15 pro max,100000,135000,35000,1,169,India
186101,2024-02-19,504,iron,449,879,430,1,212,India
186101,2024-02-19,507,washing machine,6990,16490,9500,1,212,India
563914,2024-02-19,501,iphone 15,60000,80000,20000,1,158,India
804683,2024-02-19,501,iphone 15,60000,80000,20000,1,168,India
804683,2024-02-19,507,washing machine,6990,16490,9500,1,168,India
804683,2024-02-19,505,oven,18490,24000,5510,1,168,India
804683,2024-02-19,506,monitor,3249,8000,4751,1,168,India
924129,2024-02-19,504,iron,449,879,430,1,11,India
924129,2024-02-19,505,oven,18490,24000,5510,1,11,India
924129,2024-02-19,506,monitor,3249,8000,4751,1,11,India
628719,2024-02-19,504,iron,449,879,430,1,328,India
628719,2024-02-19,506,monitor,3249,8000,4751,1,328,India
800412,2024-02-19,504,iron,449,879,430,1,244,India
800412,2024-02-19,506,monitor,3249,8000,4751,1,244,India
800412,2024-02-19,502,iphone 15 pro max,100000,135000,35000,1,244,India
800412,2024-02-19,507,washing machine,6990,16490,9500,1,244,India
394706,2024-02-19,506,monitor,3249,8000,4751,1,331,India
502233,2024-02-19,503,mixer,1349,3249,1900,1,325,India
502233,2024-02-19,507,washing machine,6990,16490,9500,1,325,India
502233,2024-02-19,506,monitor,3249,8000,4751,1,325,India
783845,2024-02-19,505,oven,18490,24000,5510,1,133,India
545604,2024-02-19,504,iron,449,879,430,1,141,India
545604,2024-02-19,501,iphone 15,60000,80000,20000,1,141,India
545604,2024-02-19,507,washing machine,6990,16490,9500,1,141,India
129907,2024-02-19,505,oven,18490,24000,5510,1,497,India
129907,2024-02-19,501,iphone 15,60000,80000,20000,1,497,India
129907,2024-02-19,507,washing machine,6990,16490,9500,1,497,India
791531,2024-02-19,502,iphone 15 pro max,100000,135000,35000,1,212,India
791531,2024-02-19,504,iron,449,879,430,1,212,India
952980,2024-02-19,504,iron,449,879,430,1,272,India
952980,2024-02-19,505,oven,18490,24000,5510,1,272,India
326039,2024-02-19,505,oven,18490,24000,5510,1,130,India
511638,2024-02-19,506,monitor,3249,8000,4751,1,248,India
511638,2024-02-19,502,iphone 15 pro max,100000,135000,35000,1,248,India
526819,2024-02-19,503,mixer,1349,3249,1900,1,400,India
526819,2024-02-19,507,washing machine,6990,16490,9500,1,400,India
526819,2024-02-19,506,monitor,3249,8000,4751,1,400,India
526819,2024-02-19,505,oven,18490,24000,5510,1,400,India
725437,2024-02-19,506,monitor,3249,8000,4751,1,223,India
725437,2024-02-19,502,iphone 15 pro max,100000,135000,35000,1,223,India
725437,2024-02-19,501,iphone 15,60000,80000,20000,1,223,India
416865,2024-02-19,501,iphone 15,60000,80000,20000,1,206,India
943021,2024-02-19,505,oven,18490,24000,5510,1,106,India
943021,2024-02-19,502,iphone 15 pro max,100000,135000,35000,1,106,India
581011,2024-02-19,504,iron,449,879,430,1,225,India
581011,2024-02-19,503,mixer,1349,3249,1900,1,225,India
559350,2024-02-19,501,iphone 15,60000,80000,20000,1,279,India
559350,2024-02-19,507,washing machine,6990,16490,9500,1,279,India
559350,2024-02-19,506,monitor,3249,8000,4751,1,279,India
559350,2024-02-19,505,oven,18490,24000,5510,1,279,India
765182,2024-02-19,501,iphone 15,60000,80000,20000,1,183,India
765182,2024-02-19,502,iphone 15 pro max,100000,135000,35000,1,183,India
765182,2024-02-19,504,iron,449,879,430,1,183,India
765182,2024-02-19,503,mixer,1349,3249,1900,1,183,India
155617,2024-02-19,504,iron,449,879,430,1,186,India
123693,2024-02-19,505,oven,18490,24000,5510,1,412,India
516443,2024-02-19,506,monitor,3249,8000,4751,1,311,India
516443,2024-02-19,502,iphone 15 pro max,100000,135000,35000,1,311,India
536766,2024-02-19,503,mixer,1349,3249,1900,1,218,India
536766,2024-02-19,507,washing machine,6990,16490,9500,1,218,India
865107,2024-02-19,505,oven,18490,24000,5510,1,10,India
780703,2024-02-19,506,monitor,3249,8000,4751,1,116,India
780703,2024-02-19,504,iron,449,879,430,1,116,India
214883,2024-02-19,507,washing machine,6990,16490,9500,1,449,India
214883,2024-02-19,503,mixer,1349,3249,1900,1,449,India
214883,2024-02-19,502,iphone 15 pro max,100000,135000,35000,1,449,India
647016,2024-02-19,507,washing machine,6990,16490,9500,1,405,India
647016,2024-02-19,506,monitor,3249,8000,4751,1,405,India
647016,2024-02-19,502,iphone 15 pro max,100000,135000,35000,1,405,India
440261,2024-02-19,501,iphone 15,60000,80000,20000,1,434,India
440261,2024-02-19,502,iphone 15 pro max,100000,135000,35000,1,434,India
871298,2024-02-19,503,mixer,1349,3249,1900,1,36,India
871298,2024-02-19,501,iphone 15,60000,80000,20000,1,36,India
871298,2024-02-19,507,washing machine,6990,16490,9500,1,36,India
643127,2024-02-19,505,oven,18490,24000,5510,1,5,India
643127,2024-02-19,502,iphone 15 pro max,100000,135000,35000,1,5,India
770592,2024-02-19,501,iphone 15,60000,80000,20000,1,86,India
765846,2024-02-19,503,mixer,1349,3249,1900,1,35,India
765846,2024-02-19,504,iron,449,879,430,1,35,India
765846,2024-02-19,502,iphone 15 pro max,100000,135000,35000,1,35,India
702599,2024-02-19,503,mixer,1349,3249,1900,1,71,India
702599,2024-02-19,507,washing machine,6990,16490,9500,1,71,India
697934,2024-02-19,507,washing machine,6990,16490,9500,1,286,India
347955,2024-02-20,502,iphone 15 pro max,100000,135000,35000,1,380,India
347955,2024-02-20,503,mixer,1349,3249,1900,1,380,India
252017,2024-02-20,501,iphone 15,60000,80000,20000,1,269,India
252017,2024-02-20,506,monitor,3249,8000,4751,1,269,India
252017,2024-02-20,503,mixer,1349,3249,1900,1,269,India
140678,2024-02-20,506,monitor,3249,8000,4751,1,282,India
140678,2024-02-20,507,washing machine,6990,16490,9500,1,282,India
140678,2024-02-20,504,iron,449,879,430,1,282,India
140678,2024-02-20,501,iphone 15,60000,80000,20000,1,282,India
666027,2024-02-20,507,washing machine,6990,16490,9500,1,68,India
405297,2024-02-20,501,iphone 15,60000,80000,20000,1,457,India
199162,2024-02-20,505,oven,18490,24000,5510,1,82,India
199162,2024-02-20,506,monitor,3249,8000,4751,1,82,India
199162,2024-02-20,504,iron,449,879,430,1,82,India
238690,2024-02-20,503,mixer,1349,3249,1900,1,27,India
238690,2024-02-20,504,iron,449,879,430,1,27,India
484092,2024-02-20,502,iphone 15 pro max,100000,135000,35000,1,318,India
484092,2024-02-20,503,mixer,1349,3249,1900,1,318,India
484092,2024-02-20,501,iphone 15,60000,80000,20000,1,318,India
230731,2024-02-20,507,washing machine,6990,16490,9500,1,109,India
230731,2024-02-20,502,iphone 15 pro max,100000,135000,35000,1,109,India
606357,2024-02-20,503,mixer,1349,3249,1900,1,1,India
537742,2024-02-20,502,iphone 15 pro max,100000,135000,35000,1,320,India
537742,2024-02-20,504,iron,449,879,430,1,320,India
183937,2024-02-20,505,oven,18490,24000,5510,1,487,India
183937,2024-02-20,503,mixer,1349,3249,1900,1,487,India
819674,2024-02-20,506,monitor,3249,8000,4751,1,401,India
819674,2024-02-20,502,iphone 15 pro max,100000,135000,35000,1,401,India
819674,2024-02-20,503,mixer,1349,3249,1900,1,401,India
299635,2024-02-20,501,iphone 15,60000,80000,20000,1,500,India
299635,2024-02-20,505,oven,18490,24000,5510,1,500,India
299635,2024-02-20,507,washing machine,6990,16490,9500,1,500,India
589789,2024-02-20,506,monitor,3249,8000,4751,1,79,India
589789,2024-02-20,502,iphone 15 pro max,100000,135000,35000,1,79,India
981702,2024-02-20,501,iphone 15,60000,80000,20000,1,336,India
981702,2024-02-20,505,oven,18490,24000,5510,1,336,India
981702,2024-02-20,506,monitor,3249,8000,4751,1,336,India
981702,2024-02-20,504,iron,449,879,430,1,336,India
780753,2024-02-20,501,iphone 15,60000,80000,20000,1,478,India
780753,2024-02-20,504,iron,449,879,430,1,478,India
780753,2024-02-20,502,iphone 15 pro max,100000,135000,35000,1,478,India
918493,2024-02-20,504,iron,449,879,430,1,145,India
918493,2024-02-20,507,washing machine,6990,16490,9500,1,145,India
918493,2024-02-20,505,oven,18490,24000,5510,1,145,India
918493,2024-02-20,503,mixer,1349,3249,1900,1,145,India
765681,2024-02-20,505,oven,18490,24000,5510,1,75,India
765681,2024-02-20,502,iphone 15 pro max,100000,135000,35000,1,75,India
367856,2024-02-20,507,washing machine,6990,16490,9500,1,144,India
367856,2024-02-20,501,iphone 15,60000,80000,20000,1,144,India
232660,2024-02-20,506,monitor,3249,8000,4751,1,350,India
232660,2024-02-20,507,washing machine,6990,16490,9500,1,350,India
232660,2024-02-20,505,oven,18490,24000,5510,1,350,India
707604,2024-02-20,507,washing machine,6990,16490,9500,1,26,India
203049,2024-02-20,502,iphone 15 pro max,100000,135000,35000,1,283,India
203049,2024-02-20,506,monitor,3249,8000,4751,1,283,India
203049,2024-02-20,505,oven,18490,24000,5510,1,283,India
730799,2024-02-20,503,mixer,1349,3249,1900,1,47,India
730799,2024-02-20,507,washing machine,6990,16490,9500,1,47,India
730799,2024-02-20,505,oven,18490,24000,5510,1,47,India
921013,2024-02-20,505,oven,18490,24000,5510,1,238,India
875800,2024-02-20,505,oven,18490,24000,5510,1,190,India
875800,2024-02-20,504,iron,449,879,430,1,190,India
875800,2024-02-20,506,monitor,3249,8000,4751,1,190,India
131694,2024-02-20,501,iphone 15,60000,80000,20000,1,195,India
158170,2024-02-20,504,iron,449,879,430,1,450,India
240262,2024-02-20,503,mixer,1349,3249,1900,1,119,India
524821,2024-02-20,506,monitor,3249,8000,4751,1,198,India
524821,2024-02-20,502,iphone 15 pro max,100000,135000,35000,1,198,India
524821,2024-02-20,504,iron,449,879,430,1,198,India
524821,2024-02-20,507,washing machine,6990,16490,9500,1,198,India
331072,2024-02-20,507,washing machine,6990,16490,9500,1,117,India
331072,2024-02-20,506,monitor,3249,8000,4751,1,117,India
225119,2024-02-20,504,iron,449,879,430,1,107,India
634640,2024-02-20,505,oven,18490,24000,5510,1,364,India
634640,2024-02-20,503,mixer,1349,3249,1900,1,364,India
634640,2024-02-20,504,iron,449,879,430,1,364,India
592978,2024-02-20,502,iphone 15 pro max,100000,135000,35000,1,131,India
592978,2024-02-20,501,iphone 15,60000,80000,20000,1,131,India
592978,2024-02-20,507,washing machine,6990,16490,9500,1,131,India
592978,2024-02-20,506,monitor,3249,8000,4751,1,131,India
887071,2024-02-20,506,monitor,3249,8000,4751,1,323,India
887071,2024-02-20,504,iron,449,879,430,1,323,India
887071,2024-02-20,507,washing machine,6990,16490,9500,1,323,India
887071,2024-02-20,502,iphone 15 pro max,100000,135000,35000,1,323,India
887071,2024-02-20,505,oven,18490,24000,5510,1,323,India
996339,2024-02-20,502,iphone 15 pro max,100000,135000,35000,1,242,India
996339,2024-02-20,506,monitor,3249,8000,4751,1,242,India
996339,2024-02-20,505,oven,18490,24000,5510,1,242,India
996339,2024-02-20,504,iron,449,879,430,1,242,India
996339,2024-02-20,507,washing machine,6990,16490,9500,1,242,India
886266,2024-02-20,506,monitor,3249,8000,4751,1,367,India
929445,2024-02-20,501,iphone 15,60000,80000,20000,1,248,India
929445,2024-02-20,504,iron,449,879,430,1,248,India
401959,2024-02-20,506,monitor,3249,8000,4751,1,367,India
401959,2024-02-20,505,oven,18490,24000,5510,1,367,India
839102,2024-02-20,501,iphone 15,60000,80000,20000,1,275,India
839102,2024-02-20,502,iphone 15 pro max,100000,135000,35000,1,275,India
839102,2024-02-20,504,iron,449,879,430,1,275,India
983309,2024-02-20,504,iron,449,879,430,1,258,India
983309,2024-02-20,505,oven,18490,24000,5510,1,258,India
983309,2024-02-20,507,washing machine,6990,16490,9500,1,258,India
983309,2024-02-20,502,iphone 15 pro max,100000,135000,35000,1,258,India
999255,2024-02-20,504,iron,449,879,430,1,419,India
999255,2024-02-20,507,washing machine,6990,16490,9500,1,419,India
999255,2024-02-20,505,oven,18490,24000,5510,1,419,India
512263,2024-02-20,506,monitor,3249,8000,4751,1,75,India
428743,2024-02-20,503,mixer,1349,3249,1900,1,268,India
428743,2024-02-20,502,iphone 15 pro max,100000,135000,35000,1,268,India
428743,2024-02-20,505,oven,18490,24000,5510,1,268,India
428743,2024-02-20,506,monitor,3249,8000,4751,1,268,India
395703,2024-02-20,504,iron,449,879,430,1,168,India
898843,2024-02-20,503,mixer,1349,3249,1900,1,404,India
622611,2024-02-20,501,iphone 15,60000,80000,20000,1,283,India
622611,2024-02-20,505,oven,18490,24000,5510,1,283,India
622611,2024-02-20,506,monitor,3249,8000,4751,1,283,India
622611,2024-02-20,504,iron,449,879,430,1,283,India
155738,2024-02-20,506,monitor,3249,8000,4751,1,349,India
155738,2024-02-20,504,iron,449,879,430,1,349,India
385769,2024-02-20,505,oven,18490,24000,5510,1,304,India
490927,2024-02-20,504,iron,449,879,430,1,226,India
444159,2024-02-20,502,iphone 15 pro max,100000,135000,35000,1,304,India
444159,2024-02-20,506,monitor,3249,8000,4751,1,304,India
444159,2024-02-20,503,mixer,1349,3249,1900,1,304,India
326595,2024-02-20,507,washing machine,6990,16490,9500,1,146,India
326595,2024-02-20,502,iphone 15 pro max,100000,135000,35000,1,146,India
326595,2024-02-20,506,monitor,3249,8000,4751,1,146,India
676515,2024-02-20,504,iron,449,879,430,1,9,India
676515,2024-02-20,507,washing machine,6990,16490,9500,1,9,India
676515,2024-02-20,505,oven,18490,24000,5510,1,9,India
963357,2024-02-20,504,iron,449,879,430,1,271,India
963357,2024-02-20,505,oven,18490,24000,5510,1,271,India
963357,2024-02-20,503,mixer,1349,3249,1900,1,271,India
963357,2024-02-20,506,monitor,3249,8000,4751,1,271,India
559509,2024-02-20,501,iphone 15,60000,80000,20000,1,434,India
559509,2024-02-20,506,monitor,3249,8000,4751,1,434,India
559509,2024-02-20,507,washing machine,6990,16490,9500,1,434,India
559509,2024-02-20,505,oven,18490,24000,5510,1,434,India
853999,2024-02-20,505,oven,18490,24000,5510,1,183,India
853999,2024-02-20,506,monitor,3249,8000,4751,1,183,India
853999,2024-02-20,504,iron,449,879,430,1,183,India
837633,2024-02-20,503,mixer,1349,3249,1900,1,44,India
837633,2024-02-20,504,iron,449,879,430,1,44,India
837633,2024-02-20,501,iphone 15,60000,80000,20000,1,44,India
837633,2024-02-20,505,oven,18490,24000,5510,1,44,India
837633,2024-02-20,506,monitor,3249,8000,4751,1,44,India
404672,2024-02-20,502,iphone 15 pro max,100000,135000,35000,1,29,India
407355,2024-02-20,505,oven,18490,24000,5510,1,41,India
407355,2024-02-20,504,iron,449,879,430,1,41,India
235997,2024-02-20,507,washing machine,6990,16490,9500,1,134,India
235997,2024-02-20,501,iphone 15,60000,80000,20000,1,134,India
413617,2024-02-20,507,washing machine,6990,16490,9500,1,284,India
869162,2024-02-20,507,washing machine,6990,16490,9500,1,189,India
869162,2024-02-20,504,iron,449,879,430,1,189,India
163990,2024-02-20,502,iphone 15 pro max,100000,135000,35000,1,390,India
163990,2024-02-20,503,mixer,1349,3249,1900,1,390,India
163990,2024-02-20,505,oven,18490,24000,5510,1,390,India
163990,2024-02-20,506,monitor,3249,8000,4751,1,390,India
894736,2024-02-20,504,iron,449,879,430,1,115,India