InvoiceNo,InvoiceDate,StockCode,Description,Cost_Price,UnitPrice,Profit,Quantity,CustomerID,Country
975092,2023-02-20,401,couch,15000,25000,10000,1,00001,India
975092,2023-02-20,407,bedsheet,500,1000,500,1,00001,India
724424,2023-02-20,417,door knob,200,400,200,1,00002,India
724424,2023-02-20,401,couch,15000,25000,10000,1,00002,India
724424,2023-02-20,416,door,5000,10000,5000,1,00002,India
724424,2023-02-20,408,cupboard,5000,15000,10000,1,00002,India
724424,2023-02-20,415,yard chair,1500,3000,1500,1,00002,India
307245,2023-02-20,401,couch,15000,25000,10000,1,00003,India
307245,2023-02-20,402,lamp,500,750,250,1,00003,India
849498,2023-02-20,416,door,5000,10000,5000,1,00004,India
849498,2023-02-20,413,dining table,20000,40000,20000,1,00004,India
849498,2023-02-20,411,side table,1500,3000,1500,1,00004,India
957148,2023-02-20,418,tiles,50,100,50,1,00005,India
957148,2023-02-20,406,pillow,200,400,200,1,00005,India
957148,2023-02-20,404,queen bed,29000,45000,16000,1,00005,India
957148,2023-02-20,403,tube light,450,600,150,1,00005,India
957148,2023-02-20,402,lamp,500,750,250,1,00005,India
872401,2023-02-21,404,queen bed,29000,45000,16000,1,00006,India
872401,2023-02-21,408,cupboard,5000,15000,10000,1,00006,India
872401,2023-02-21,409,shelf,500,1000,500,1,00006,India
872401,2023-02-21,406,pillow,200,400,200,1,00006,India
872401,2023-02-21,419,paint,2000,4000,2000,1,00006,India
818376,2023-02-22,401,couch,15000,25000,10000,1,00007,India
386178,2023-02-22,419,paint,2000,4000,2000,1,00008,India
386178,2023-02-22,413,dining table,20000,40000,20000,1,00008,India
386178,2023-02-22,407,bedsheet,500,1000,500,1,00008,India
386178,2023-02-22,408,cupboard,5000,15000,10000,1,00008,India
845689,2023-02-22,411,side table,1500,3000,1500,1,00009,India
845689,2023-02-22,406,pillow,200,400,200,1,00009,India
845689,2023-02-22,413,dining table,20000,40000,20000,1,00009,India
845689,2023-02-22,414,chair,1000,2000,1000,1,00009,India
903525,2023-02-22,413,dining table,20000,40000,20000,1,00010,India
903525,2023-02-22,403,tube light,450,600,150,1,00010,India
388807,2023-02-23,414,chair,1000,2000,1000,1,00011,India
388807,2023-02-23,407,bedsheet,500,1000,500,1,00011,India
388807,2023-02-23,405,carpet,2000,4000,2000,1,00011,India
388807,2023-02-23,404,queen bed,29000,45000,16000,1,00011,India
701861,2023-02-23,401,couch,15000,25000,10000,1,00012,India
701861,2023-02-23,415,yard chair,1500,3000,1500,1,00012,India
701861,2023-02-23,410,curtain,1000,2000,1000,1,00012,India
701861,2023-02-23,411,side table,1500,3000,1500,1,00012,India
278940,2023-02-24,401,couch,15000,25000,10000,1,00013,India
692988,2023-02-24,411,side table,1500,3000,1500,1,00014,India
692988,2023-02-24,416,door,5000,10000,5000,1,00014,India
692988,2023-02-24,417,door knob,200,400,200,1,00014,India
692988,2023-02-24,418,tiles,50,100,50,1,00014,India
638200,2023-02-24,409,shelf,500,1000,500,1,00015,India
638200,2023-02-24,412,area rug,3000,6000,3000,1,00015,India
638200,2023-02-24,402,lamp,500,750,250,1,00015,India
459984,2023-02-26,402,lamp,500,750,250,1,00016,India
459984,2023-02-26,419,paint,2000,4000,2000,1,00016,India
459984,2023-02-26,409,shelf,500,1000,500,1,00016,India
418124,2023-02-26,419,paint,2000,4000,2000,1,00017,India
418124,2023-02-26,417,door knob,200,400,200,1,00017,India
418124,2023-02-26,408,cupboard,5000,15000,10000,1,00017,India
418124,2023-02-26,407,bedsheet,500,1000,500,1,00017,India
639747,2023-02-26,402,lamp,500,750,250,1,00018,India
639747,2023-02-26,408,cupboard,5000,15000,10000,1,00018,India
639747,2023-02-26,412,area rug,3000,6000,3000,1,00018,India
639747,2023-02-26,417,door knob,200,400,200,1,00018,India
639747,2023-02-26,414,chair,1000,2000,1000,1,00018,India
765769,2023-02-26,411,side table,1500,3000,1500,1,00019,India
765769,2023-02-26,419,paint,2000,4000,2000,1,00019,India
765769,2023-02-26,416,door,5000,10000,5000,1,00019,India
614742,2023-02-26,409,shelf,500,1000,500,1,00020,India
614742,2023-02-26,407,bedsheet,500,1000,500,1,00020,India
614742,2023-02-26,402,lamp,500,750,250,1,00020,India
614742,2023-02-26,412,area rug,3000,6000,3000,1,00020,India
614742,2023-02-26,415,yard chair,1500,3000,1500,1,00020,India
831975,2023-02-27,404,queen bed,29000,45000,16000,1,00021,India
831975,2023-02-27,410,curtain,1000,2000,1000,1,00021,India
831975,2023-02-27,412,area rug,3000,6000,3000,1,00021,India
831975,2023-02-27,405,carpet,2000,4000,2000,1,00021,India
831975,2023-02-27,418,tiles,50,100,50,1,00021,India
182571,2023-02-27,410,curtain,1000,2000,1000,1,00022,India
182571,2023-02-27,403,tube light,450,600,150,1,00022,India
182571,2023-02-27,416,door,5000,10000,5000,1,00022,India
574066,2023-02-27,415,yard chair,1500,3000,1500,1,00023,India
253457,2023-02-27,406,pillow,200,400,200,1,00024,India
253457,2023-02-27,411,side table,1500,3000,1500,1,00024,India
349627,2023-02-28,419,paint,2000,4000,2000,1,00025,India
349627,2023-02-28,411,side table,1500,3000,1500,1,00025,India
647955,2023-02-28,408,cupboard,5000,15000,10000,1,00026,India
647955,2023-02-28,416,door,5000,10000,5000,1,00026,India
414735,2023-03-01,419,paint,2000,4000,2000,1,00027,India
383439,2023-03-01,404,queen bed,29000,45000,16000,1,00028,India
383439,2023-03-01,408,cupboard,5000,15000,10000,1,00028,India
383439,2023-03-01,402,lamp,500,750,250,1,00028,India
961657,2023-03-01,410,curtain,1000,2000,1000,1,00029,India
961657,2023-03-01,403,tube light,450,600,150,1,00029,India
682827,2023-03-04,411,side table,1500,3000,1500,1,00030,India
682827,2023-03-04,402,lamp,500,750,250,1,00030,India
405822,2023-03-04,419,paint,2000,4000,2000,1,00031,India
405822,2023-03-04,414,chair,1000,2000,1000,1,00031,India
405822,2023-03-04,413,dining table,20000,40000,20000,1,00031,India
405822,2023-03-04,404,queen bed,29000,45000,16000,1,00031,India
405822,2023-03-04,408,cupboard,5000,15000,10000,1,00031,India
537630,2023-03-04,415,yard chair,1500,3000,1500,1,00032,India
527802,2023-03-04,401,couch,15000,25000,10000,1,00033,India
184857,2023-03-04,408,cupboard,5000,15000,10000,1,00034,India
184857,2023-03-04,410,curtain,1000,2000,1000,1,00034,India
937153,2023-03-05,402,lamp,500,750,250,1,00035,India
937153,2023-03-05,405,carpet,2000,4000,2000,1,00035,India
937153,2023-03-05,407,bedsheet,500,1000,500,1,00035,India
937153,2023-03-05,410,curtain,1000,2000,1000,1,00035,India
635963,2023-03-05,402,lamp,500,750,250,1,00036,India
635963,2023-03-05,411,side table,1500,3000,1500,1,00036,India
635963,2023-03-05,412,area rug,3000,6000,3000,1,00036,India
773716,2023-03-05,404,queen bed,29000,45000,16000,1,00037,India
121873,2023-03-05,415,yard chair,1500,3000,1500,1,00038,India
121873,2023-03-05,419,paint,2000,4000,2000,1,00038,India
271647,2023-03-07,416,door,5000,10000,5000,1,00039,India
271647,2023-03-07,409,shelf,500,1000,500,1,00039,India
271647,2023-03-07,411,side table,1500,3000,1500,1,00039,India
493551,2023-03-07,408,cupboard,5000,15000,10000,1,00040,India
493551,2023-03-07,404,queen bed,29000,45000,16000,1,00040,India
493551,2023-03-07,414,chair,1000,2000,1000,1,00040,India
493551,2023-03-07,401,couch,15000,25000,10000,1,00040,India
616607,2023-03-08,405,carpet,2000,4000,2000,1,00041,India
616607,2023-03-08,414,chair,1000,2000,1000,1,00041,India
299574,2023-03-08,419,paint,2000,4000,2000,1,00042,India
299574,2023-03-08,408,cupboard,5000,15000,10000,1,00042,India
299574,2023-03-08,404,queen bed,29000,45000,16000,1,00042,India
299574,2023-03-08,415,yard chair,1500,3000,1500,1,00042,India
639414,2023-03-08,411,side table,1500,3000,1500,1,00043,India
817723,2023-03-08,414,chair,1000,2000,1000,1,00044,India
445932,2023-03-08,412,area rug,3000,6000,3000,1,00045,India
445932,2023-03-08,414,chair,1000,2000,1000,1,00045,India
445932,2023-03-08,403,tube light,450,600,150,1,00045,India
445932,2023-03-08,419,paint,2000,4000,2000,1,00045,India
614918,2023-03-09,412,area rug,3000,6000,3000,1,00046,India
614918,2023-03-09,418,tiles,50,100,50,1,00046,India
614918,2023-03-09,416,door,5000,10000,5000,1,00046,India
614918,2023-03-09,414,chair,1000,2000,1000,1,00046,India
247507,2023-03-09,416,door,5000,10000,5000,1,00047,India
247507,2023-03-09,413,dining table,20000,40000,20000,1,00047,India
247507,2023-03-09,417,door knob,200,400,200,1,00047,India
247507,2023-03-09,401,couch,15000,25000,10000,1,00047,India
738950,2023-03-10,415,yard chair,1500,3000,1500,1,00048,India
738950,2023-03-10,416,door,5000,10000,5000,1,00048,India
738950,2023-03-10,404,queen bed,29000,45000,16000,1,00048,India
738950,2023-03-10,409,shelf,500,1000,500,1,00048,India
519611,2023-03-10,410,curtain,1000,2000,1000,1,00049,India
519611,2023-03-10,404,queen bed,29000,45000,16000,1,00049,India
519611,2023-03-10,408,cupboard,5000,15000,10000,1,00049,India
987108,2023-03-12,418,tiles,50,100,50,1,00050,India
987108,2023-03-12,410,curtain,1000,2000,1000,1,00050,India
149334,2023-03-12,404,queen bed,29000,45000,16000,1,00051,India
149334,2023-03-12,417,door knob,200,400,200,1,00051,India
316379,2023-03-12,403,tube light,450,600,150,1,00052,India
899590,2023-03-12,401,couch,15000,25000,10000,1,00053,India
899590,2023-03-12,416,door,5000,10000,5000,1,00053,India
534037,2023-03-12,417,door knob,200,400,200,1,00054,India
534037,2023-03-12,412,area rug,3000,6000,3000,1,00054,India
723950,2023-03-15,410,curtain,1000,2000,1000,1,00055,India
152412,2023-03-15,412,area rug,3000,6000,3000,1,00056,India
152412,2023-03-15,410,curtain,1000,2000,1000,1,00056,India
152412,2023-03-15,411,side table,1500,3000,1500,1,00056,India
520233,2023-03-15,415,yard chair,1500,3000,1500,1,00057,India
245455,2023-03-15,414,chair,1000,2000,1000,1,00058,India
245455,2023-03-15,407,bedsheet,500,1000,500,1,00058,India
245455,2023-03-15,403,tube light,450,600,150,1,00058,India
245455,2023-03-15,413,dining table,20000,40000,20000,1,00058,India
245455,2023-03-15,415,yard chair,1500,3000,1500,1,00058,India
361936,2023-03-16,413,dining table,20000,40000,20000,1,00059,India
361936,2023-03-16,411,side table,1500,3000,1500,1,00059,India
361936,2023-03-16,409,shelf,500,1000,500,1,00059,India
361936,2023-03-16,405,carpet,2000,4000,2000,1,00059,India
124594,2023-03-16,408,cupboard,5000,15000,10000,1,00060,India
124594,2023-03-16,418,tiles,50,100,50,1,00060,India
628527,2023-03-16,405,carpet,2000,4000,2000,1,00061,India
702438,2023-03-16,409,shelf,500,1000,500,1,00062,India
702438,2023-03-16,401,couch,15000,25000,10000,1,00062,India
349813,2023-03-16,406,pillow,200,400,200,1,00063,India
349813,2023-03-16,401,couch,15000,25000,10000,1,00063,India
169939,2023-03-17,406,pillow,200,400,200,1,00064,India
310007,2023-03-19,418,tiles,50,100,50,1,00065,India
310007,2023-03-19,408,cupboard,5000,15000,10000,1,00065,India
310007,2023-03-19,404,queen bed,29000,45000,16000,1,00065,India
110693,2023-03-19,416,door,5000,10000,5000,1,00066,India
110693,2023-03-19,405,carpet,2000,4000,2000,1,00066,India
326461,2023-03-20,408,cupboard,5000,15000,10000,1,00067,India
326461,2023-03-20,406,pillow,200,400,200,1,00067,India
326461,2023-03-20,401,couch,15000,25000,10000,1,00067,India
326461,2023-03-20,416,door,5000,10000,5000,1,00067,India
326461,2023-03-20,405,carpet,2000,4000,2000,1,00067,India
834034,2023-03-21,418,tiles,50,100,50,1,00068,India
834034,2023-03-21,419,paint,2000,4000,2000,1,00068,India
834034,2023-03-21,417,door knob,200,400,200,1,00068,India
501023,2023-03-21,411,side table,1500,3000,1500,1,00069,India
501023,2023-03-21,418,tiles,50,100,50,1,00069,India
939582,2023-03-22,417,door knob,200,400,200,1,00070,India
939582,2023-03-22,407,bedsheet,500,1000,500,1,00070,India
939582,2023-03-22,408,cupboard,5000,15000,10000,1,00070,India
939582,2023-03-22,401,couch,15000,25000,10000,1,00070,India
458068,2023-03-22,411,side table,1500,3000,1500,1,00071,India
475548,2023-03-22,403,tube light,450,600,150,1,00072,India
475548,2023-03-22,419,paint,2000,4000,2000,1,00072,India
475548,2023-03-22,402,lamp,500,750,250,1,00072,India
475548,2023-03-22,414,chair,1000,2000,1000,1,00072,India
475548,2023-03-22,411,side table,1500,3000,1500,1,00072,India
549261,2023-03-22,412,area rug,3000,6000,3000,1,00073,India
549261,2023-03-22,413,dining table,20000,40000,20000,1,00073,India
549261,2023-03-22,411,side table,1500,3000,1500,1,00073,India
549261,2023-03-22,416,door,5000,10000,5000,1,00073,India
193767,2023-03-23,401,couch,15000,25000,10000,1,00074,India
193767,2023-03-23,402,lamp,500,750,250,1,00074,India
193767,2023-03-23,416,door,5000,10000,5000,1,00074,India
893365,2023-03-24,406,pillow,200,400,200,1,00075,India
893365,2023-03-24,414,chair,1000,2000,1000,1,00075,India
893365,2023-03-24,419,paint,2000,4000,2000,1,00075,India
893365,2023-03-24,404,queen bed,29000,45000,16000,1,00075,India
452134,2023-03-25,405,carpet,2000,4000,2000,1,00076,India
452134,2023-03-25,404,queen bed,29000,45000,16000,1,00076,India
701958,2023-03-25,403,tube light,450,600,150,1,00077,India
701958,2023-03-25,417,door knob,200,400,200,1,00077,India
678008,2023-03-25,418,tiles,50,100,50,1,00078,India
678008,2023-03-25,407,bedsheet,500,1000,500,1,00078,India
422767,2023-03-25,415,yard chair,1500,3000,1500,1,00079,India
422767,2023-03-25,413,dining table,20000,40000,20000,1,00079,India
320363,2023-03-25,402,lamp,500,750,250,1,00080,India
320363,2023-03-25,405,carpet,2000,4000,2000,1,00080,India
320363,2023-03-25,408,cupboard,5000,15000,10000,1,00080,India
320363,2023-03-25,419,paint,2000,4000,2000,1,00080,India
137963,2023-03-26,411,side table,1500,3000,1500,1,00081,India
137963,2023-03-26,415,yard chair,1500,3000,1500,1,00081,India
137963,2023-03-26,410,curtain,1000,2000,1000,1,00081,India
183846,2023-03-26,401,couch,15000,25000,10000,1,00082,India
139571,2023-03-26,410,curtain,1000,2000,1000,1,00083,India
933239,2023-03-27,413,dining table,20000,40000,20000,1,00084,India
842442,2023-03-27,415,yard chair,1500,3000,1500,1,00085,India
842442,2023-03-27,416,door,5000,10000,5000,1,00085,India
842442,2023-03-27,410,curtain,1000,2000,1000,1,00085,India
667389,2023-03-27,419,paint,2000,4000,2000,1,00086,India
639498,2023-03-28,404,queen bed,29000,45000,16000,1,00087,India
639498,2023-03-28,401,couch,15000,25000,10000,1,00087,India
811241,2023-03-28,418,tiles,50,100,50,1,00088,India
811241,2023-03-28,416,door,5000,10000,5000,1,00088,India
137426,2023-03-28,412,area rug,3000,6000,3000,1,00089,India
137426,2023-03-28,414,chair,1000,2000,1000,1,00089,India
137426,2023-03-28,403,tube light,450,600,150,1,00089,India
137426,2023-03-28,417,door knob,200,400,200,1,00089,India
743646,2023-03-28,414,chair,1000,2000,1000,1,00090,India
743646,2023-03-28,403,tube light,450,600,150,1,00090,India
852308,2023-03-29,404,queen bed,29000,45000,16000,1,00091,India
852308,2023-03-29,405,carpet,2000,4000,2000,1,00091,India
852308,2023-03-29,406,pillow,200,400,200,1,00091,India
852308,2023-03-29,417,door knob,200,400,200,1,00091,India
132624,2023-03-30,409,shelf,500,1000,500,1,00092,India
132624,2023-03-30,414,chair,1000,2000,1000,1,00092,India
132624,2023-03-30,408,cupboard,5000,15000,10000,1,00092,India
132624,2023-03-30,407,bedsheet,500,1000,500,1,00092,India
113434,2023-03-30,412,area rug,3000,6000,3000,1,00093,India
113434,2023-03-30,414,chair,1000,2000,1000,1,00093,India
113434,2023-03-30,410,curtain,1000,2000,1000,1,00093,India
304434,2023-03-30,408,cupboard,5000,15000,10000,1,00094,India
304434,2023-03-30,410,curtain,1000,2000,1000,1,00094,India
304434,2023-03-30,418,tiles,50,100,50,1,00094,India
304434,2023-03-30,414,chair,1000,2000,1000,1,00094,India
512943,2023-03-31,406,pillow,200,400,200,1,00095,India
512943,2023-03-31,414,chair,1000,2000,1000,1,00095,India
512943,2023-03-31,402,lamp,500,750,250,1,00095,India
512943,2023-03-31,405,carpet,2000,4000,2000,1,00095,India
214545,2023-03-31,410,curtain,1000,2000,1000,1,00096,India
214545,2023-03-31,403,tube light,450,600,150,1,00096,India
214545,2023-03-31,414,chair,1000,2000,1000,1,00096,India
214545,2023-03-31,419,paint,2000,4000,2000,1,00096,India
404769,2023-03-31,414,chair,1000,2000,1000,1,00097,India
404769,2023-03-31,408,cupboard,5000,15000,10000,1,00097,India
185924,2023-03-31,405,carpet,2000,4000,2000,1,00098,India
185924,2023-03-31,408,cupboard,5000,15000,10000,1,00098,India
185924,2023-03-31,418,tiles,50,100,50,1,00098,India
984497,2023-04-02,417,door knob,200,400,200,2,00099,India
507716,2023-04-03,402,lamp,500,750,250,2,00100,India
507716,2023-04-03,412,area rug,3000,6000,3000,2,00100,India
507716,2023-04-03,414,chair,1000,2000,1000,2,00100,India
184898,2023-04-04,414,chair,1000,2000,1000,2,00101,India
184898,2023-04-04,404,queen bed,29000,45000,16000,2,00101,India
184898,2023-04-04,415,yard chair,1500,3000,1500,2,00101,India
184898,2023-04-04,401,couch,15000,25000,10000,2,00101,India
184898,2023-04-04,402,lamp,500,750,250,2,00101,India
309485,2023-04-04,405,carpet,2000,4000,2000,2,00102,India
309485,2023-04-04,408,cupboard,5000,15000,10000,2,00102,India
309485,2023-04-04,403,tube light,450,600,150,2,00102,India
309485,2023-04-04,412,area rug,3000,6000,3000,2,00102,India
994154,2023-04-04,419,paint,2000,4000,2000,2,00103,India
994154,2023-04-04,410,curtain,1000,2000,1000,2,00103,India
994154,2023-04-04,406,pillow,200,400,200,2,00103,India
409451,2023-04-05,406,pillow,200,400,200,2,00104,India
409451,2023-04-05,416,door,5000,10000,5000,2,00104,India
409451,2023-04-05,405,carpet,2000,4000,2000,2,00104,India
922522,2023-04-05,405,carpet,2000,4000,2000,2,00105,India
226941,2023-04-06,408,cupboard,5000,15000,10000,2,00106,India
226941,2023-04-06,411,side table,1500,3000,1500,2,00106,India
226941,2023-04-06,418,tiles,50,100,50,2,00106,India
226941,2023-04-06,405,carpet,2000,4000,2000,2,00106,India
438235,2023-04-06,408,cupboard,5000,15000,10000,2,00107,India
402064,2023-04-06,412,area rug,3000,6000,3000,2,00108,India
402064,2023-04-06,410,curtain,1000,2000,1000,2,00108,India
402064,2023-04-06,416,door,5000,10000,5000,2,00108,India
402064,2023-04-06,403,tube light,450,600,150,2,00108,India
470630,2023-04-06,419,paint,2000,4000,2000,2,00109,India
470630,2023-04-06,418,tiles,50,100,50,2,00109,India
470630,2023-04-06,402,lamp,500,750,250,2,00109,India
467361,2023-04-07,401,couch,15000,25000,10000,2,00110,India
467361,2023-04-07,417,door knob,200,400,200,2,00110,India
929142,2023-04-08,407,bedsheet,500,1000,500,2,00111,India
894897,2023-04-08,412,area rug,3000,6000,3000,2,00112,India
982734,2023-04-10,413,dining table,20000,40000,20000,2,00113,India
982734,2023-04-10,417,door knob,200,400,200,2,00113,India
638834,2023-04-10,405,carpet,2000,4000,2000,2,00114,India
638834,2023-04-10,409,shelf,500,1000,500,2,00114,India
253361,2023-04-11,409,shelf,500,1000,500,2,00115,India
253361,2023-04-11,413,dining table,20000,40000,20000,2,00115,India
253361,2023-04-11,416,door,5000,10000,5000,2,00115,India
253361,2023-04-11,402,lamp,500,750,250,2,00115,India
735697,2023-04-11,415,yard chair,1500,3000,1500,2,00116,India
735697,2023-04-11,409,shelf,500,1000,500,2,00116,India
735697,2023-04-11,411,side table,1500,3000,1500,2,00116,India
161716,2023-04-12,414,chair,1000,2000,1000,2,00117,India
161716,2023-04-12,401,couch,15000,25000,10000,2,00117,India
545114,2023-04-12,418,tiles,50,100,50,2,00118,India
545114,2023-04-12,404,queen bed,29000,45000,16000,2,00118,India
545114,2023-04-12,415,yard chair,1500,3000,1500,2,00118,India
307241,2023-04-12,410,curtain,1000,2000,1000,2,00119,India
307241,2023-04-12,405,carpet,2000,4000,2000,2,00119,India
307241,2023-04-12,408,cupboard,5000,15000,10000,2,00119,India
307241,2023-04-12,401,couch,15000,25000,10000,2,00119,India
307241,2023-04-12,417,door knob,200,400,200,2,00119,India
389094,2023-04-12,408,cupboard,5000,15000,10000,2,00120,India
389094,2023-04-12,410,curtain,1000,2000,1000,2,00120,India
389094,2023-04-12,404,queen bed,29000,45000,16000,2,00120,India
471974,2023-04-13,419,paint,2000,4000,2000,2,00121,India
471974,2023-04-13,414,chair,1000,2000,1000,2,00121,India
848956,2023-04-13,411,side table,1500,3000,1500,2,00122,India
848956,2023-04-13,410,curtain,1000,2000,1000,2,00122,India
848956,2023-04-13,403,tube light,450,600,150,2,00122,India
861645,2023-04-13,403,tube light,450,600,150,2,00123,India
771245,2023-04-13,402,lamp,500,750,250,2,00124,India
771245,2023-04-13,414,chair,1000,2000,1000,2,00124,India
132387,2023-04-13,407,bedsheet,500,1000,500,2,00125,India
132387,2023-04-13,401,couch,15000,25000,10000,2,00125,India
963472,2023-04-14,402,lamp,500,750,250,2,00126,India
963472,2023-04-14,406,pillow,200,400,200,2,00126,India
963472,2023-04-14,407,bedsheet,500,1000,500,2,00126,India
963472,2023-04-14,417,door knob,200,400,200,2,00126,India
496922,2023-04-15,409,shelf,500,1000,500,2,00127,India
775417,2023-04-15,409,shelf,500,1000,500,2,00128,India
775417,2023-04-15,401,couch,15000,25000,10000,2,00128,India
775417,2023-04-15,404,queen bed,29000,45000,16000,2,00128,India
775417,2023-04-15,416,door,5000,10000,5000,2,00128,India
775417,2023-04-15,415,yard chair,1500,3000,1500,2,00128,India
110509,2023-04-15,416,door,5000,10000,5000,2,00129,India
110509,2023-04-15,419,paint,2000,4000,2000,2,00129,India
110509,2023-04-15,407,bedsheet,500,1000,500,2,00129,India
337731,2023-04-15,402,lamp,500,750,250,2,00130,India
337731,2023-04-15,411,side table,1500,3000,1500,2,00130,India
337731,2023-04-15,403,tube light,450,600,150,2,00130,India
337731,2023-04-15,412,area rug,3000,6000,3000,2,00130,India
490123,2023-04-15,407,bedsheet,500,1000,500,2,00131,India
490123,2023-04-15,409,shelf,500,1000,500,2,00131,India
490123,2023-04-15,411,side table,1500,3000,1500,2,00131,India
490123,2023-04-15,413,dining table,20000,40000,20000,2,00131,India
183535,2023-04-16,409,shelf,500,1000,500,2,00132,India
183535,2023-04-16,401,couch,15000,25000,10000,2,00132,India
183535,2023-04-16,402,lamp,500,750,250,2,00132,India
421170,2023-04-16,410,curtain,1000,2000,1000,2,00133,India
421170,2023-04-16,419,paint,2000,4000,2000,2,00133,India
421170,2023-04-16,406,pillow,200,400,200,2,00133,India
385810,2023-04-16,415,yard chair,1500,3000,1500,2,00134,India
385810,2023-04-16,412,area rug,3000,6000,3000,2,00134,India
836483,2023-04-16,416,door,5000,10000,5000,2,00135,India
750051,2023-04-17,401,couch,15000,25000,10000,2,00136,India
750051,2023-04-17,409,shelf,500,1000,500,2,00136,India
750051,2023-04-17,405,carpet,2000,4000,2000,2,00136,India
750051,2023-04-17,407,bedsheet,500,1000,500,2,00136,India
750051,2023-04-17,416,door,5000,10000,5000,2,00136,India
125575,2023-04-18,409,shelf,500,1000,500,2,00137,India
125575,2023-04-18,404,queen bed,29000,45000,16000,2,00137,India
125575,2023-04-18,401,couch,15000,25000,10000,2,00137,India
125575,2023-04-18,415,yard chair,1500,3000,1500,2,00137,India
125575,2023-04-18,410,curtain,1000,2000,1000,2,00137,India
670849,2023-04-18,403,tube light,450,600,150,2,00138,India
670849,2023-04-18,418,tiles,50,100,50,2,00138,India
670849,2023-04-18,405,carpet,2000,4000,2000,2,00138,India
670849,2023-04-18,417,door knob,200,400,200,2,00138,India
641997,2023-04-20,405,carpet,2000,4000,2000,2,00139,India
641997,2023-04-20,407,bedsheet,500,1000,500,2,00139,India
641997,2023-04-20,411,side table,1500,3000,1500,2,00139,India
641997,2023-04-20,408,cupboard,5000,15000,10000,2,00139,India
641997,2023-04-20,404,queen bed,29000,45000,16000,2,00139,India
122052,2023-04-20,413,dining table,20000,40000,20000,2,00140,India
230151,2023-04-20,411,side table,1500,3000,1500,2,00141,India
230151,2023-04-20,419,paint,2000,4000,2000,2,00141,India
230151,2023-04-20,417,door knob,200,400,200,2,00141,India
230151,2023-04-20,415,yard chair,1500,3000,1500,2,00141,India
890642,2023-04-20,417,door knob,200,400,200,2,00142,India
503352,2023-04-20,410,curtain,1000,2000,1000,2,00143,India
409851,2023-04-21,406,pillow,200,400,200,2,00144,India
409851,2023-04-21,419,paint,2000,4000,2000,2,00144,India
409851,2023-04-21,413,dining table,20000,40000,20000,2,00144,India
409851,2023-04-21,408,cupboard,5000,15000,10000,2,00144,India
473596,2023-04-21,409,shelf,500,1000,500,2,00145,India
473596,2023-04-21,405,carpet,2000,4000,2000,2,00145,India
473596,2023-04-21,403,tube light,450,600,150,2,00145,India
361342,2023-04-23,417,door knob,200,400,200,2,00146,India
361342,2023-04-23,402,lamp,500,750,250,2,00146,India
361342,2023-04-23,415,yard chair,1500,3000,1500,2,00146,India
770897,2023-04-23,410,curtain,1000,2000,1000,2,00147,India
770897,2023-04-23,408,cupboard,5000,15000,10000,2,00147,India
770897,2023-04-23,413,dining table,20000,40000,20000,2,00147,India
770897,2023-04-23,404,queen bed,29000,45000,16000,2,00147,India
852947,2023-04-23,408,cupboard,5000,15000,10000,2,00148,India
852947,2023-04-23,401,couch,15000,25000,10000,2,00148,India
852947,2023-04-23,410,curtain,1000,2000,1000,2,00148,India
852947,2023-04-23,407,bedsheet,500,1000,500,2,00148,India
577782,2023-04-23,404,queen bed,29000,45000,16000,2,00149,India
126094,2023-04-23,419,paint,2000,4000,2000,2,00150,India
126094,2023-04-23,406,pillow,200,400,200,2,00150,India
126094,2023-04-23,409,shelf,500,1000,500,2,00150,India
945995,2023-04-24,413,dining table,20000,40000,20000,2,00151,India
945995,2023-04-24,411,side table,1500,3000,1500,2,00151,India
945995,2023-04-24,412,area rug,3000,6000,3000,2,00151,India
822774,2023-04-25,419,paint,2000,4000,2000,2,00152,India
929728,2023-04-25,403,tube light,450,600,150,2,00153,India
929728,2023-04-25,408,cupboard,5000,15000,10000,2,00153,India
929728,2023-04-25,411,side table,1500,3000,1500,2,00153,India
929728,2023-04-25,414,chair,1000,2000,1000,2,00153,India
258831,2023-04-26,417,door knob,200,400,200,2,00154,India
258831,2023-04-26,408,cupboard,5000,15000,10000,2,00154,India
258831,2023-04-26,414,chair,1000,2000,1000,2,00154,India
258831,2023-04-26,407,bedsheet,500,1000,500,2,00154,India
258831,2023-04-26,401,couch,15000,25000,10000,2,00154,India
201018,2023-04-26,411,side table,1500,3000,1500,2,00155,India
201018,2023-04-26,415,yard chair,1500,3000,1500,2,00155,India
201018,2023-04-26,410,curtain,1000,2000,1000,2,00155,India
525384,2023-04-26,411,side table,1500,3000,1500,2,00156,India
525384,2023-04-26,402,lamp,500,750,250,2,00156,India
525384,2023-04-26,418,tiles,50,100,50,2,00156,India
525384,2023-04-26,406,pillow,200,400,200,2,00156,India
936183,2023-04-26,419,paint,2000,4000,2000,2,00157,India
936183,2023-04-26,402,lamp,500,750,250,2,00157,India
936183,2023-04-26,406,pillow,200,400,200,2,00157,India
936183,2023-04-26,414,chair,1000,2000,1000,2,00157,India
936183,2023-04-26,408,cupboard,5000,15000,10000,2,00157,India
491544,2023-04-28,419,paint,2000,4000,2000,2,00158,India
491544,2023-04-28,416,door,5000,10000,5000,2,00158,India
491544,2023-04-28,402,lamp,500,750,250,2,00158,India
562053,2023-04-28,419,paint,2000,4000,2000,2,00159,India
562053,2023-04-28,405,carpet,2000,4000,2000,2,00159,India
562053,2023-04-28,417,door knob,200,400,200,2,00159,India
555712,2023-04-28,414,chair,1000,2000,1000,2,00160,India
555712,2023-04-28,413,dining table,20000,40000,20000,2,00160,India
555712,2023-04-28,405,carpet,2000,4000,2000,2,00160,India
555712,2023-04-28,417,door knob,200,400,200,2,00160,India
448044,2023-04-28,418,tiles,50,100,50,2,00161,India
448044,2023-04-28,419,paint,2000,4000,2000,2,00161,India
448044,2023-04-28,416,door,5000,10000,5000,2,00161,India
448044,2023-04-28,412,area rug,3000,6000,3000,2,00161,India
444305,2023-04-28,402,lamp,500,750,250,2,00162,India
863747,2023-04-29,403,tube light,450,600,150,2,00163,India
863747,2023-04-29,406,pillow,200,400,200,2,00163,India
863747,2023-04-29,418,tiles,50,100,50,2,00163,India
863747,2023-04-29,413,dining table,20000,40000,20000,2,00163,India
634200,2023-04-30,407,bedsheet,500,1000,500,2,00164,India
333751,2023-04-30,405,carpet,2000,4000,2000,2,00165,India
145966,2023-05-01,401,couch,15000,25000,10000,2,00166,India
145966,2023-05-01,410,curtain,1000,2000,1000,2,00166,India
145966,2023-05-01,414,chair,1000,2000,1000,2,00166,India
145966,2023-05-01,404,queen bed,29000,45000,16000,2,00166,India
530908,2023-05-01,414,chair,1000,2000,1000,2,00167,India
530908,2023-05-01,409,shelf,500,1000,500,2,00167,India
655622,2023-05-01,417,door knob,200,400,200,2,00168,India
655622,2023-05-01,416,door,5000,10000,5000,2,00168,India
705649,2023-05-02,415,yard chair,1500,3000,1500,2,00169,India
705649,2023-05-02,404,queen bed,29000,45000,16000,2,00169,India
728580,2023-05-02,416,door,5000,10000,5000,2,00170,India
728580,2023-05-02,411,side table,1500,3000,1500,2,00170,India
272019,2023-05-02,414,chair,1000,2000,1000,2,00171,India
272019,2023-05-02,415,yard chair,1500,3000,1500,2,00171,India
272019,2023-05-02,409,shelf,500,1000,500,2,00171,India
272019,2023-05-02,413,dining table,20000,40000,20000,2,00171,India
272019,2023-05-02,418,tiles,50,100,50,2,00171,India
790505,2023-05-02,414,chair,1000,2000,1000,2,00172,India
790505,2023-05-02,412,area rug,3000,6000,3000,2,00172,India
790505,2023-05-02,401,couch,15000,25000,10000,2,00172,India
790505,2023-05-02,403,tube light,450,600,150,2,00172,India
655259,2023-05-02,415,yard chair,1500,3000,1500,2,00173,India
655259,2023-05-02,402,lamp,500,750,250,2,00173,India
655259,2023-05-02,401,couch,15000,25000,10000,2,00173,India
182584,2023-05-03,405,carpet,2000,4000,2000,2,00174,India
182584,2023-05-03,408,cupboard,5000,15000,10000,2,00174,India
182584,2023-05-03,406,pillow,200,400,200,2,00174,India
525116,2023-05-03,418,tiles,50,100,50,2,00175,India
525116,2023-05-03,409,shelf,500,1000,500,2,00175,India
342424,2023-05-03,404,queen bed,29000,45000,16000,2,00176,India
342424,2023-05-03,418,tiles,50,100,50,2,00176,India
342424,2023-05-03,403,tube light,450,600,150,2,00176,India
939668,2023-05-03,404,queen bed,29000,45000,16000,2,00177,India
939668,2023-05-03,407,bedsheet,500,1000,500,2,00177,India
478690,2023-05-03,416,door,5000,10000,5000,2,00178,India
478690,2023-05-03,412,area rug,3000,6000,3000,2,00178,India
325004,2023-05-04,409,shelf,500,1000,500,2,00179,India
325004,2023-05-04,406,pillow,200,400,200,2,00179,India
325004,2023-05-04,402,lamp,500,750,250,2,00179,India
325004,2023-05-04,403,tube light,450,600,150,2,00179,India
281288,2023-05-04,413,dining table,20000,40000,20000,2,00180,India
281288,2023-05-04,405,carpet,2000,4000,2000,2,00180,India
281288,2023-05-04,418,tiles,50,100,50,2,00180,India
281288,2023-05-04,409,shelf,500,1000,500,2,00180,India
664015,2023-05-04,412,area rug,3000,6000,3000,2,00181,India
439625,2023-05-04,414,chair,1000,2000,1000,2,00182,India
439625,2023-05-04,407,bedsheet,500,1000,500,2,00182,India
439625,2023-05-04,412,area rug,3000,6000,3000,2,00182,India
529138,2023-05-05,412,area rug,3000,6000,3000,2,00183,India
529138,2023-05-05,407,bedsheet,500,1000,500,2,00183,India
157522,2023-05-05,414,chair,1000,2000,1000,2,00184,India
157522,2023-05-05,412,area rug,3000,6000,3000,2,00184,India
157522,2023-05-05,402,lamp,500,750,250,2,00184,India
157522,2023-05-05,410,curtain,1000,2000,1000,2,00184,India
157522,2023-05-05,417,door knob,200,400,200,2,00184,India
744132,2023-05-06,402,lamp,500,750,250,2,00185,India
744132,2023-05-06,403,tube light,450,600,150,2,00185,India
744132,2023-05-06,409,shelf,500,1000,500,2,00185,India
413391,2023-05-06,417,door knob,200,400,200,2,00186,India
460172,2023-05-06,415,yard chair,1500,3000,1500,2,00187,India
460172,2023-05-06,408,cupboard,5000,15000,10000,2,00187,India
460172,2023-05-06,407,bedsheet,500,1000,500,2,00187,India
460172,2023-05-06,403,tube light,450,600,150,2,00187,India
571979,2023-05-07,419,paint,2000,4000,2000,2,00188,India
571979,2023-05-07,407,bedsheet,500,1000,500,2,00188,India
571979,2023-05-07,418,tiles,50,100,50,2,00188,India
571979,2023-05-07,402,lamp,500,750,250,2,00188,India
571979,2023-05-07,411,side table,1500,3000,1500,2,00188,India
316755,2023-05-07,410,curtain,1000,2000,1000,2,00189,India
316755,2023-05-07,401,couch,15000,25000,10000,2,00189,India
666657,2023-05-07,412,area rug,3000,6000,3000,2,00190,India
666657,2023-05-07,407,bedsheet,500,1000,500,2,00190,India
666657,2023-05-07,418,tiles,50,100,50,2,00190,India
666657,2023-05-07,416,door,5000,10000,5000,2,00190,India
825281,2023-05-07,416,door,5000,10000,5000,2,00191,India
869182,2023-05-07,408,cupboard,5000,15000,10000,2,00192,India
361518,2023-05-08,405,carpet,2000,4000,2000,2,00193,India
361518,2023-05-08,410,curtain,1000,2000,1000,2,00193,India
783939,2023-05-08,403,tube light,450,600,150,2,00194,India
783939,2023-05-08,402,lamp,500,750,250,2,00194,India
783939,2023-05-08,413,dining table,20000,40000,20000,2,00194,India
214845,2023-05-08,407,bedsheet,500,1000,500,2,00195,India
760931,2023-05-08,404,queen bed,29000,45000,16000,2,00196,India
760931,2023-05-08,408,cupboard,5000,15000,10000,2,00196,India
760931,2023-05-08,412,area rug,3000,6000,3000,2,00196,India
337297,2023-05-09,405,carpet,2000,4000,2000,2,00197,India
337297,2023-05-09,418,tiles,50,100,50,2,00197,India
215178,2023-05-09,409,shelf,500,1000,500,2,00198,India
215178,2023-05-09,411,side table,1500,3000,1500,2,00198,India
697028,2023-05-09,417,door knob,200,400,200,2,00199,India
697028,2023-05-09,418,tiles,50,100,50,2,00199,India
697028,2023-05-09,407,bedsheet,500,1000,500,2,00199,India
697028,2023-05-09,415,yard chair,1500,3000,1500,2,00199,India
392271,2023-05-09,402,lamp,500,750,250,2,00200,India
742817,2023-05-09,409,shelf,500,1000,500,2,00201,India
452003,2023-05-10,403,tube light,450,600,150,2,00202,India
452003,2023-05-10,413,dining table,20000,40000,20000,2,00202,India
757891,2023-05-10,405,carpet,2000,4000,2000,2,00203,India
757891,2023-05-10,411,side table,1500,3000,1500,2,00203,India
757891,2023-05-10,407,bedsheet,500,1000,500,2,00203,India
212754,2023-05-10,405,carpet,2000,4000,2000,2,00204,India
212754,2023-05-10,403,tube light,450,600,150,2,00204,India
212754,2023-05-10,408,cupboard,5000,15000,10000,2,00204,India
212754,2023-05-10,414,chair,1000,2000,1000,2,00204,India
819961,2023-05-10,410,curtain,1000,2000,1000,2,00205,India
246028,2023-05-10,410,curtain,1000,2000,1000,2,00206,India
246028,2023-05-10,406,pillow,200,400,200,2,00206,India
899212,2023-05-11,405,carpet,2000,4000,2000,2,00207,India
899212,2023-05-11,401,couch,15000,25000,10000,2,00207,India
899212,2023-05-11,404,queen bed,29000,45000,16000,2,00207,India
330316,2023-05-11,408,cupboard,5000,15000,10000,2,00208,India
330316,2023-05-11,417,door knob,200,400,200,2,00208,India
330316,2023-05-11,406,pillow,200,400,200,2,00208,India
330316,2023-05-11,415,yard chair,1500,3000,1500,2,00208,India
330316,2023-05-11,413,dining table,20000,40000,20000,2,00208,India
123406,2023-05-12,417,door knob,200,400,200,2,00209,India
123406,2023-05-12,414,chair,1000,2000,1000,2,00209,India
123406,2023-05-12,413,dining table,20000,40000,20000,2,00209,India
123406,2023-05-12,412,area rug,3000,6000,3000,2,00209,India
123406,2023-05-12,402,lamp,500,750,250,2,00209,India
191516,2023-05-12,402,lamp,500,750,250,2,00210,India
191516,2023-05-12,418,tiles,50,100,50,2,00210,India
891985,2023-05-13,415,yard chair,1500,3000,1500,2,00211,India
891985,2023-05-13,410,curtain,1000,2000,1000,2,00211,India
891985,2023-05-13,413,dining table,20000,40000,20000,2,00211,India
493613,2023-05-13,417,door knob,200,400,200,2,00212,India
493613,2023-05-13,416,door,5000,10000,5000,2,00212,India
493613,2023-05-13,410,curtain,1000,2000,1000,2,00212,India
493613,2023-05-13,415,yard chair,1500,3000,1500,2,00212,India
722631,2023-05-14,404,queen bed,29000,45000,16000,2,00213,India
722631,2023-05-14,407,bedsheet,500,1000,500,2,00213,India
722631,2023-05-14,417,door knob,200,400,200,2,00213,India
771065,2023-05-14,406,pillow,200,400,200,2,00214,India
771065,2023-05-14,409,shelf,500,1000,500,2,00214,India
568594,2023-05-14,401,couch,15000,25000,10000,2,00215,India
650708,2023-05-14,418,tiles,50,100,50,2,00216,India
425158,2023-05-14,418,tiles,50,100,50,2,00217,India
425158,2023-05-14,408,cupboard,5000,15000,10000,2,00217,India
425158,2023-05-14,414,chair,1000,2000,1000,2,00217,India
703516,2023-05-15,403,tube light,450,600,150,2,00218,India
703516,2023-05-15,413,dining table,20000,40000,20000,2,00218,India
703516,2023-05-15,408,cupboard,5000,15000,10000,2,00218,India
703516,2023-05-15,411,side table,1500,3000,1500,2,00218,India
703516,2023-05-15,402,lamp,500,750,250,2,00218,India
301402,2023-05-15,414,chair,1000,2000,1000,2,00219,India
418850,2023-05-15,408,cupboard,5000,15000,10000,2,00220,India
990444,2023-05-15,414,chair,1000,2000,1000,2,00221,India
990444,2023-05-15,406,pillow,200,400,200,2,00221,India
990444,2023-05-15,402,lamp,500,750,250,2,00221,India
990444,2023-05-15,419,paint,2000,4000,2000,2,00221,India
369733,2023-05-16,419,paint,2000,4000,2000,2,00222,India
369733,2023-05-16,401,couch,15000,25000,10000,2,00222,India
369733,2023-05-16,406,pillow,200,400,200,2,00222,India
369733,2023-05-16,410,curtain,1000,2000,1000,2,00222,India
518162,2023-05-16,419,paint,2000,4000,2000,2,00223,India
518162,2023-05-16,410,curtain,1000,2000,1000,2,00223,India
805889,2023-05-18,402,lamp,500,750,250,2,00224,India
805889,2023-05-18,416,door,5000,10000,5000,2,00224,India
805889,2023-05-18,414,chair,1000,2000,1000,2,00224,India
805889,2023-05-18,411,side table,1500,3000,1500,2,00224,India
652800,2023-05-20,412,area rug,3000,6000,3000,2,00225,India
693138,2023-05-21,402,lamp,500,750,250,2,00226,India
693138,2023-05-21,407,bedsheet,500,1000,500,2,00226,India
693138,2023-05-21,405,carpet,2000,4000,2000,2,00226,India
714246,2023-05-22,416,door,5000,10000,5000,2,00227,India
714246,2023-05-22,404,queen bed,29000,45000,16000,2,00227,India
273452,2023-05-22,411,side table,1500,3000,1500,2,00228,India
273452,2023-05-22,404,queen bed,29000,45000,16000,2,00228,India
273452,2023-05-22,407,bedsheet,500,1000,500,2,00228,India
273452,2023-05-22,410,curtain,1000,2000,1000,2,00228,India
532819,2023-05-22,411,side table,1500,3000,1500,2,00229,India
532819,2023-05-22,416,door,5000,10000,5000,2,00229,India
532819,2023-05-22,402,lamp,500,750,250,2,00229,India
532819,2023-05-22,403,tube light,450,600,150,2,00229,India
532819,2023-05-22,406,pillow,200,400,200,2,00229,India
493738,2023-05-23,406,pillow,200,400,200,2,00230,India
493738,2023-05-23,417,door knob,200,400,200,2,00230,India
493738,2023-05-23,403,tube light,450,600,150,2,00230,India
116602,2023-05-23,409,shelf,500,1000,500,2,00231,India
116602,2023-05-23,419,paint,2000,4000,2000,2,00231,India
116602,2023-05-23,406,pillow,200,400,200,2,00231,India
116602,2023-05-23,414,chair,1000,2000,1000,2,00231,India
484435,2023-05-24,419,paint,2000,4000,2000,2,00232,India
484435,2023-05-24,402,lamp,500,750,250,2,00232,India
198695,2023-05-24,417,door knob,200,400,200,2,00233,India
198695,2023-05-24,402,lamp,500,750,250,2,00233,India
194394,2023-05-24,404,queen bed,29000,45000,16000,2,00234,India
194394,2023-05-24,413,dining table,20000,40000,20000,2,00234,India
194394,2023-05-24,406,pillow,200,400,200,2,00234,India
194394,2023-05-24,419,paint,2000,4000,2000,2,00234,India
951273,2023-05-26,419,paint,2000,4000,2000,2,00235,India
951273,2023-05-26,417,door knob,200,400,200,2,00235,India
951273,2023-05-26,410,curtain,1000,2000,1000,2,00235,India
951273,2023-05-26,412,area rug,3000,6000,3000,2,00235,India
141855,2023-05-27,409,shelf,500,1000,500,2,00236,India
141855,2023-05-27,404,queen bed,29000,45000,16000,2,00236,India
520893,2023-05-29,418,tiles,50,100,50,2,00237,India
520893,2023-05-29,403,tube light,450,600,150,2,00237,India
520893,2023-05-29,405,carpet,2000,4000,2000,2,00237,India
520893,2023-05-29,415,yard chair,1500,3000,1500,2,00237,India
409511,2023-05-29,407,bedsheet,500,1000,500,2,00238,India
409511,2023-05-29,413,dining table,20000,40000,20000,2,00238,India
409511,2023-05-29,410,curtain,1000,2000,1000,2,00238,India
284670,2023-05-30,409,shelf,500,1000,500,2,00239,India
284670,2023-05-30,415,yard chair,1500,3000,1500,2,00239,India
429273,2023-05-31,414,chair,1000,2000,1000,2,00240,India
305948,2023-05-31,406,pillow,200,400,200,2,00241,India
305948,2023-05-31,415,yard chair,1500,3000,1500,2,00241,India
232424,2023-05-31,402,lamp,500,750,250,2,00242,India
232424,2023-05-31,403,tube light,450,600,150,2,00242,India
232424,2023-05-31,415,yard chair,1500,3000,1500,2,00242,India
232424,2023-05-31,412,area rug,3000,6000,3000,2,00242,India
232424,2023-05-31,405,carpet,2000,4000,2000,2,00242,India
556560,2023-05-31,403,tube light,450,600,150,2,00243,India
556560,2023-05-31,402,lamp,500,750,250,2,00243,India
556560,2023-05-31,406,pillow,200,400,200,2,00243,India
556560,2023-05-31,401,couch,15000,25000,10000,2,00243,India
160517,2023-05-31,418,tiles,50,100,50,2,00244,India
160517,2023-05-31,417,door knob,200,400,200,2,00244,India
160517,2023-05-31,411,side table,1500,3000,1500,2,00244,India
907553,2023-06-02,406,pillow,200,400,200,1,00245,India
136392,2023-06-02,403,tube light,450,600,150,1,00246,India
136392,2023-06-02,404,queen bed,29000,45000,16000,1,00246,India
136392,2023-06-02,407,bedsheet,500,1000,500,1,00246,India
136392,2023-06-02,417,door knob,200,400,200,1,00246,India
136392,2023-06-02,411,side table,1500,3000,1500,1,00246,India
212590,2023-06-02,406,pillow,200,400,200,1,00247,India
212590,2023-06-02,403,tube light,450,600,150,1,00247,India
212590,2023-06-02,411,side table,1500,3000,1500,1,00247,India
212590,2023-06-02,407,bedsheet,500,1000,500,1,00247,India
359610,2023-06-03,403,tube light,450,600,150,1,00248,India
933794,2023-06-03,407,bedsheet,500,1000,500,1,00249,India
933794,2023-06-03,412,area rug,3000,6000,3000,1,00249,India
933794,2023-06-03,404,queen bed,29000,45000,16000,1,00249,India
709103,2023-06-03,412,area rug,3000,6000,3000,1,00250,India
709103,2023-06-03,409,shelf,500,1000,500,1,00250,India
531016,2023-06-03,401,couch,15000,25000,10000,1,00251,India
531016,2023-06-03,405,carpet,2000,4000,2000,1,00251,India
531016,2023-06-03,407,bedsheet,500,1000,500,1,00251,India
104326,2023-06-03,419,paint,2000,4000,2000,1,00252,India
966992,2023-06-04,407,bedsheet,500,1000,500,1,00253,India
966992,2023-06-04,405,carpet,2000,4000,2000,1,00253,India
966992,2023-06-04,410,curtain,1000,2000,1000,1,00253,India
966992,2023-06-04,414,chair,1000,2000,1000,1,00253,India
966992,2023-06-04,419,paint,2000,4000,2000,1,00253,India
833338,2023-06-05,407,bedsheet,500,1000,500,1,00254,India
833338,2023-06-05,416,door,5000,10000,5000,1,00254,India
362887,2023-06-05,408,cupboard,5000,15000,10000,1,00255,India
362887,2023-06-05,411,side table,1500,3000,1500,1,00255,India
362887,2023-06-05,414,chair,1000,2000,1000,1,00255,India
362887,2023-06-05,402,lamp,500,750,250,1,00255,India
184426,2023-06-06,417,door knob,200,400,200,1,00256,India
135661,2023-06-06,410,curtain,1000,2000,1000,1,00257,India
135661,2023-06-06,402,lamp,500,750,250,1,00257,India
135661,2023-06-06,415,yard chair,1500,3000,1500,1,00257,India
370467,2023-06-06,407,bedsheet,500,1000,500,1,00258,India
370467,2023-06-06,404,queen bed,29000,45000,16000,1,00258,India
370467,2023-06-06,409,shelf,500,1000,500,1,00258,India
876138,2023-06-07,414,chair,1000,2000,1000,1,00259,India
279456,2023-06-07,414,chair,1000,2000,1000,1,00260,India
279456,2023-06-07,417,door knob,200,400,200,1,00260,India
279456,2023-06-07,418,tiles,50,100,50,1,00260,India
279456,2023-06-07,404,queen bed,29000,45000,16000,1,00260,India
451638,2023-06-07,413,dining table,20000,40000,20000,1,00261,India
821200,2023-06-07,407,bedsheet,500,1000,500,1,00262,India
821200,2023-06-07,412,area rug,3000,6000,3000,1,00262,India
821200,2023-06-07,409,shelf,500,1000,500,1,00262,India
912239,2023-06-08,415,yard chair,1500,3000,1500,1,00263,India
912239,2023-06-08,402,lamp,500,750,250,1,00263,India
141183,2023-06-08,408,cupboard,5000,15000,10000,1,00264,India
141183,2023-06-08,404,queen bed,29000,45000,16000,1,00264,India
524274,2023-06-08,417,door knob,200,400,200,1,00265,India
524274,2023-06-08,410,curtain,1000,2000,1000,1,00265,India
524274,2023-06-08,404,queen bed,29000,45000,16000,1,00265,India
524274,2023-06-08,406,pillow,200,400,200,1,00265,India
232924,2023-06-09,402,lamp,500,750,250,1,00266,India
232924,2023-06-09,404,queen bed,29000,45000,16000,1,00266,India
232924,2023-06-09,408,cupboard,5000,15000,10000,1,00266,India
232924,2023-06-09,410,curtain,1000,2000,1000,1,00266,India
232924,2023-06-09,411,side table,1500,3000,1500,1,00266,India
210621,2023-06-10,410,curtain,1000,2000,1000,1,00267,India
210621,2023-06-10,411,side table,1500,3000,1500,1,00267,India
210621,2023-06-10,418,tiles,50,100,50,1,00267,India
210621,2023-06-10,407,bedsheet,500,1000,500,1,00267,India
210621,2023-06-10,403,tube light,450,600,150,1,00267,India
305706,2023-06-10,410,curtain,1000,2000,1000,1,00268,India
305706,2023-06-10,408,cupboard,5000,15000,10000,1,00268,India
944697,2023-06-11,404,queen bed,29000,45000,16000,1,00269,India
944697,2023-06-11,417,door knob,200,400,200,1,00269,India
919004,2023-06-13,403,tube light,450,600,150,1,00270,India
919004,2023-06-13,416,door,5000,10000,5000,1,00270,India
919004,2023-06-13,412,area rug,3000,6000,3000,1,00270,India
719217,2023-06-13,404,queen bed,29000,45000,16000,1,00271,India
719217,2023-06-13,417,door knob,200,400,200,1,00271,India
719217,2023-06-13,407,bedsheet,500,1000,500,1,00271,India
484959,2023-06-15,404,queen bed,29000,45000,16000,1,00272,India
623344,2023-06-15,419,paint,2000,4000,2000,1,00273,India
623344,2023-06-15,404,queen bed,29000,45000,16000,1,00273,India
623344,2023-06-15,410,curtain,1000,2000,1000,1,00273,India
623344,2023-06-15,416,door,5000,10000,5000,1,00273,India
266002,2023-06-15,407,bedsheet,500,1000,500,1,00274,India
266002,2023-06-15,401,couch,15000,25000,10000,1,00274,India
285198,2023-06-15,408,cupboard,5000,15000,10000,1,00275,India
285198,2023-06-15,406,pillow,200,400,200,1,00275,India
285198,2023-06-15,412,area rug,3000,6000,3000,1,00275,India
892265,2023-06-15,417,door knob,200,400,200,1,00276,India
892265,2023-06-15,415,yard chair,1500,3000,1500,1,00276,India
892265,2023-06-15,407,bedsheet,500,1000,500,1,00276,India
892265,2023-06-15,410,curtain,1000,2000,1000,1,00276,India
867884,2023-06-16,418,tiles,50,100,50,1,00277,India
120940,2023-06-16,404,queen bed,29000,45000,16000,1,00278,India
120940,2023-06-16,415,yard chair,1500,3000,1500,1,00278,India
823310,2023-06-16,408,cupboard,5000,15000,10000,1,00279,India
823310,2023-06-16,414,chair,1000,2000,1000,1,00279,India
823310,2023-06-16,404,queen bed,29000,45000,16000,1,00279,India
823310,2023-06-16,410,curtain,1000,2000,1000,1,00279,India
877532,2023-06-16,411,side table,1500,3000,1500,1,00280,India
646316,2023-06-16,402,lamp,500,750,250,1,00281,India
646316,2023-06-16,405,carpet,2000,4000,2000,1,00281,India
646316,2023-06-16,412,area rug,3000,6000,3000,1,00281,India
646316,2023-06-16,410,curtain,1000,2000,1000,1,00281,India
646316,2023-06-16,418,tiles,50,100,50,1,00281,India
918437,2023-06-17,412,area rug,3000,6000,3000,1,00282,India
918437,2023-06-17,415,yard chair,1500,3000,1500,1,00282,India
803426,2023-06-17,415,yard chair,1500,3000,1500,1,00283,India
989810,2023-06-17,403,tube light,450,600,150,1,00284,India
106661,2023-06-17,414,chair,1000,2000,1000,1,00285,India
106661,2023-06-17,404,queen bed,29000,45000,16000,1,00285,India
106661,2023-06-17,405,carpet,2000,4000,2000,1,00285,India
282754,2023-06-18,402,lamp,500,750,250,1,00286,India
292303,2023-06-18,414,chair,1000,2000,1000,1,00287,India
292303,2023-06-18,406,pillow,200,400,200,1,00287,India
221300,2023-06-18,403,tube light,450,600,150,1,00288,India
388686,2023-06-18,409,shelf,500,1000,500,1,00289,India
388686,2023-06-18,405,carpet,2000,4000,2000,1,00289,India
388686,2023-06-18,413,dining table,20000,40000,20000,1,00289,India
388686,2023-06-18,417,door knob,200,400,200,1,00289,India
388686,2023-06-18,402,lamp,500,750,250,1,00289,India
586689,2023-06-18,417,door knob,200,400,200,1,00290,India
586689,2023-06-18,411,side table,1500,3000,1500,1,00290,India
501947,2023-06-19,403,tube light,450,600,150,1,00291,India
501947,2023-06-19,417,door knob,200,400,200,1,00291,India
501947,2023-06-19,414,chair,1000,2000,1000,1,00291,India
752080,2023-06-19,418,tiles,50,100,50,1,00292,India
752080,2023-06-19,411,side table,1500,3000,1500,1,00292,India
180545,2023-06-21,415,yard chair,1500,3000,1500,1,00293,India
180545,2023-06-21,419,paint,2000,4000,2000,1,00293,India
180545,2023-06-21,410,curtain,1000,2000,1000,1,00293,India
180545,2023-06-21,409,shelf,500,1000,500,1,00293,India
276002,2023-06-21,404,queen bed,29000,45000,16000,1,00294,India
237499,2023-06-21,405,carpet,2000,4000,2000,1,00295,India
237499,2023-06-21,410,curtain,1000,2000,1000,1,00295,India
237499,2023-06-21,406,pillow,200,400,200,1,00295,India
696255,2023-06-21,402,lamp,500,750,250,1,00296,India
696255,2023-06-21,414,chair,1000,2000,1000,1,00296,India
174390,2023-06-21,409,shelf,500,1000,500,1,00297,India
174390,2023-06-21,410,curtain,1000,2000,1000,1,00297,India
174390,2023-06-21,407,bedsheet,500,1000,500,1,00297,India
500098,2023-06-22,410,curtain,1000,2000,1000,1,00298,India
706395,2023-06-22,418,tiles,50,100,50,1,00299,India
706395,2023-06-22,401,couch,15000,25000,10000,1,00299,India
706395,2023-06-22,417,door knob,200,400,200,1,00299,India
286957,2023-06-23,411,side table,1500,3000,1500,1,00300,India
286957,2023-06-23,414,chair,1000,2000,1000,1,00300,India
286957,2023-06-23,417,door knob,200,400,200,1,00300,India
409365,2023-06-23,402,lamp,500,750,250,1,00301,India
409365,2023-06-23,418,tiles,50,100,50,1,00301,India
409365,2023-06-23,407,bedsheet,500,1000,500,1,00301,India
409365,2023-06-23,404,queen bed,29000,45000,16000,1,00301,India
465806,2023-06-24,414,chair,1000,2000,1000,1,00302,India
162434,2023-06-24,407,bedsheet,500,1000,500,1,00303,India
162434,2023-06-24,414,chair,1000,2000,1000,1,00303,India
737104,2023-06-25,407,bedsheet,500,1000,500,1,00304,India
737104,2023-06-25,411,side table,1500,3000,1500,1,00304,India
737104,2023-06-25,412,area rug,3000,6000,3000,1,00304,India
559189,2023-06-25,418,tiles,50,100,50,1,00305,India
559189,2023-06-25,417,door knob,200,400,200,1,00305,India
834012,2023-06-25,419,paint,2000,4000,2000,1,00306,India
834012,2023-06-25,417,door knob,200,400,200,1,00306,India
834012,2023-06-25,416,door,5000,10000,5000,1,00306,India
834012,2023-06-25,402,lamp,500,750,250,1,00306,India
118238,2023-06-26,416,door,5000,10000,5000,1,00307,India
118238,2023-06-26,406,pillow,200,400,200,1,00307,India
118238,2023-06-26,407,bedsheet,500,1000,500,1,00307,India
155614,2023-06-26,402,lamp,500,750,250,1,00308,India
155614,2023-06-26,412,area rug,3000,6000,3000,1,00308,India
316126,2023-06-28,402,lamp,500,750,250,1,00309,India
316126,2023-06-28,407,bedsheet,500,1000,500,1,00309,India
812973,2023-06-28,408,cupboard,5000,15000,10000,1,00310,India
812973,2023-06-28,402,lamp,500,750,250,1,00310,India
822866,2023-06-28,414,chair,1000,2000,1000,1,00311,India
822866,2023-06-28,411,side table,1500,3000,1500,1,00311,India
171095,2023-06-28,406,pillow,200,400,200,1,00312,India
171095,2023-06-28,415,yard chair,1500,3000,1500,1,00312,India
171095,2023-06-28,402,lamp,500,750,250,1,00312,India
171095,2023-06-28,405,carpet,2000,4000,2000,1,00312,India
171095,2023-06-28,410,curtain,1000,2000,1000,1,00312,India
383393,2023-06-30,409,shelf,500,1000,500,1,00313,India
383393,2023-06-30,417,door knob,200,400,200,1,00313,India
383393,2023-06-30,408,cupboard,5000,15000,10000,1,00313,India
383393,2023-06-30,402,lamp,500,750,250,1,00313,India
463958,2023-07-01,405,carpet,2000,4000,2000,1,00314,India
463958,2023-07-01,418,tiles,50,100,50,1,00314,India
463958,2023-07-01,408,cupboard,5000,15000,10000,1,00314,India
105478,2023-07-01,402,lamp,500,750,250,1,00315,India
105478,2023-07-01,419,paint,2000,4000,2000,1,00315,India
426837,2023-07-02,415,yard chair,1500,3000,1500,1,00316,India
426837,2023-07-02,403,tube light,450,600,150,1,00316,India
303988,2023-07-02,401,couch,15000,25000,10000,1,00317,India
303988,2023-07-02,417,door knob,200,400,200,1,00317,India
303988,2023-07-02,418,tiles,50,100,50,1,00317,India
583169,2023-07-03,406,pillow,200,400,200,1,00318,India
583169,2023-07-03,407,bedsheet,500,1000,500,1,00318,India
583169,2023-07-03,415,yard chair,1500,3000,1500,1,00318,India
956211,2023-07-04,416,door,5000,10000,5000,1,00319,India
956211,2023-07-04,403,tube light,450,600,150,1,00319,India
956211,2023-07-04,419,paint,2000,4000,2000,1,00319,India
956211,2023-07-04,407,bedsheet,500,1000,500,1,00319,India
405727,2023-07-05,404,queen bed,29000,45000,16000,1,00320,India
405727,2023-07-05,413,dining table,20000,40000,20000,1,00320,India
405727,2023-07-05,401,couch,15000,25000,10000,1,00320,India
405727,2023-07-05,415,yard chair,1500,3000,1500,1,00320,India
405727,2023-07-05,403,tube light,450,600,150,1,00320,India
680958,2023-07-05,408,cupboard,5000,15000,10000,1,00321,India
680958,2023-07-05,414,chair,1000,2000,1000,1,00321,India
976273,2023-07-05,407,bedsheet,500,1000,500,1,00322,India
976273,2023-07-05,418,tiles,50,100,50,1,00322,India
817295,2023-07-05,414,chair,1000,2000,1000,1,00323,India
817295,2023-07-05,408,cupboard,5000,15000,10000,1,00323,India
817295,2023-07-05,416,door,5000,10000,5000,1,00323,India
817295,2023-07-05,411,side table,1500,3000,1500,1,00323,India
645010,2023-07-05,412,area rug,3000,6000,3000,1,00324,India
645010,2023-07-05,418,tiles,50,100,50,1,00324,India
159333,2023-07-06,401,couch,15000,25000,10000,1,00325,India
159333,2023-07-06,403,tube light,450,600,150,1,00325,India
159333,2023-07-06,407,bedsheet,500,1000,500,1,00325,India
698599,2023-07-06,405,carpet,2000,4000,2000,1,00326,India
698599,2023-07-06,407,bedsheet,500,1000,500,1,00326,India
698599,2023-07-06,417,door knob,200,400,200,1,00326,India
698599,2023-07-06,409,shelf,500,1000,500,1,00326,India
552747,2023-07-06,403,tube light,450,600,150,1,00327,India
552747,2023-07-06,405,carpet,2000,4000,2000,1,00327,India
959374,2023-07-06,414,chair,1000,2000,1000,1,00328,India
959374,2023-07-06,419,paint,2000,4000,2000,1,00328,India
491046,2023-07-07,415,yard chair,1500,3000,1500,1,00329,India
491046,2023-07-07,410,curtain,1000,2000,1000,1,00329,India
924253,2023-07-08,403,tube light,450,600,150,1,00330,India
924253,2023-07-08,404,queen bed,29000,45000,16000,1,00330,India
924253,2023-07-08,417,door knob,200,400,200,1,00330,India
924253,2023-07-08,412,area rug,3000,6000,3000,1,00330,India
924253,2023-07-08,413,dining table,20000,40000,20000,1,00330,India
384719,2023-07-08,411,side table,1500,3000,1500,1,00331,India
384719,2023-07-08,401,couch,15000,25000,10000,1,00331,India
958719,2023-07-09,402,lamp,500,750,250,1,00332,India
656928,2023-07-09,406,pillow,200,400,200,1,00333,India
656928,2023-07-09,418,tiles,50,100,50,1,00333,India
656928,2023-07-09,415,yard chair,1500,3000,1500,1,00333,India
388229,2023-07-10,415,yard chair,1500,3000,1500,1,00334,India
388229,2023-07-10,418,tiles,50,100,50,1,00334,India
388229,2023-07-10,419,paint,2000,4000,2000,1,00334,India
388229,2023-07-10,416,door,5000,10000,5000,1,00334,India
629957,2023-07-11,405,carpet,2000,4000,2000,1,00335,India
629957,2023-07-11,417,door knob,200,400,200,1,00335,India
907522,2023-07-11,419,paint,2000,4000,2000,1,00336,India
713829,2023-07-11,415,yard chair,1500,3000,1500,1,00337,India
713829,2023-07-11,414,chair,1000,2000,1000,1,00337,India
713829,2023-07-11,406,pillow,200,400,200,1,00337,India
713829,2023-07-11,416,door,5000,10000,5000,1,00337,India
445534,2023-07-11,409,shelf,500,1000,500,1,00338,India
924449,2023-07-11,416,door,5000,10000,5000,1,00339,India
924449,2023-07-11,405,carpet,2000,4000,2000,1,00339,India
636573,2023-07-12,406,pillow,200,400,200,1,00340,India
636573,2023-07-12,417,door knob,200,400,200,1,00340,India
636573,2023-07-12,410,curtain,1000,2000,1000,1,00340,India
971377,2023-07-13,416,door,5000,10000,5000,1,00341,India
971377,2023-07-13,404,queen bed,29000,45000,16000,1,00341,India
971377,2023-07-13,407,bedsheet,500,1000,500,1,00341,India
971377,2023-07-13,411,side table,1500,3000,1500,1,00341,India
537057,2023-07-13,402,lamp,500,750,250,1,00342,India
547927,2023-07-13,418,tiles,50,100,50,1,00343,India
547927,2023-07-13,410,curtain,1000,2000,1000,1,00343,India
547927,2023-07-13,404,queen bed,29000,45000,16000,1,00343,India
529104,2023-07-13,407,bedsheet,500,1000,500,1,00344,India
529104,2023-07-13,404,queen bed,29000,45000,16000,1,00344,India
460751,2023-07-13,418,tiles,50,100,50,1,00345,India
201035,2023-07-14,417,door knob,200,400,200,1,00346,India
201035,2023-07-14,408,cupboard,5000,15000,10000,1,00346,India
201035,2023-07-14,409,shelf,500,1000,500,1,00346,India
201035,2023-07-14,405,carpet,2000,4000,2000,1,00346,India
961350,2023-07-14,411,side table,1500,3000,1500,1,00347,India
961350,2023-07-14,405,carpet,2000,4000,2000,1,00347,India
176567,2023-07-14,414,chair,1000,2000,1000,1,00348,India
176567,2023-07-14,403,tube light,450,600,150,1,00348,India
176567,2023-07-14,404,queen bed,29000,45000,16000,1,00348,India
176567,2023-07-14,402,lamp,500,750,250,1,00348,India
648337,2023-07-15,417,door knob,200,400,200,1,00349,India
648337,2023-07-15,419,paint,2000,4000,2000,1,00349,India
648337,2023-07-15,414,chair,1000,2000,1000,1,00349,India
211748,2023-07-15,406,pillow,200,400,200,1,00350,India
211748,2023-07-15,402,lamp,500,750,250,1,00350,India
902543,2023-07-15,403,tube light,450,600,150,1,00351,India
666424,2023-07-15,418,tiles,50,100,50,1,00352,India
666424,2023-07-15,412,area rug,3000,6000,3000,1,00352,India
612640,2023-07-17,405,carpet,2000,4000,2000,1,00353,India
612640,2023-07-17,402,lamp,500,750,250,1,00353,India
612640,2023-07-17,411,side table,1500,3000,1500,1,00353,India
809446,2023-07-17,403,tube light,450,600,150,1,00354,India
809446,2023-07-17,416,door,5000,10000,5000,1,00354,India
554308,2023-07-17,416,door,5000,10000,5000,1,00355,India
554308,2023-07-17,415,yard chair,1500,3000,1500,1,00355,India
660769,2023-07-17,403,tube light,450,600,150,1,00356,India
660769,2023-07-17,404,queen bed,29000,45000,16000,1,00356,India
511679,2023-07-17,417,door knob,200,400,200,1,00357,India
428098,2023-07-18,411,side table,1500,3000,1500,1,00358,India
342408,2023-07-18,408,cupboard,5000,15000,10000,1,00359,India
342408,2023-07-18,409,shelf,500,1000,500,1,00359,India
837664,2023-07-18,412,area rug,3000,6000,3000,1,00360,India
837664,2023-07-18,408,cupboard,5000,15000,10000,1,00360,India
672891,2023-07-19,414,chair,1000,2000,1000,1,00361,India
672891,2023-07-19,402,lamp,500,750,250,1,00361,India
672891,2023-07-19,401,couch,15000,25000,10000,1,00361,India
862266,2023-07-19,404,queen bed,29000,45000,16000,1,00362,India
862266,2023-07-19,405,carpet,2000,4000,2000,1,00362,India
862266,2023-07-19,418,tiles,50,100,50,1,00362,India
862266,2023-07-19,403,tube light,450,600,150,1,00362,India
312014,2023-07-19,402,lamp,500,750,250,1,00363,India
312014,2023-07-19,413,dining table,20000,40000,20000,1,00363,India
312014,2023-07-19,412,area rug,3000,6000,3000,1,00363,India
312014,2023-07-19,404,queen bed,29000,45000,16000,1,00363,India
522571,2023-07-21,417,door knob,200,400,200,1,00364,India
522571,2023-07-21,409,shelf,500,1000,500,1,00364,India
237445,2023-07-21,402,lamp,500,750,250,1,00365,India
237445,2023-07-21,401,couch,15000,25000,10000,1,00365,India
237445,2023-07-21,416,door,5000,10000,5000,1,00365,India
237445,2023-07-21,413,dining table,20000,40000,20000,1,00365,India
798194,2023-07-21,404,queen bed,29000,45000,16000,1,00366,India
798194,2023-07-21,407,bedsheet,500,1000,500,1,00366,India
798194,2023-07-21,414,chair,1000,2000,1000,1,00366,India
798194,2023-07-21,403,tube light,450,600,150,1,00366,India
507278,2023-07-22,406,pillow,200,400,200,1,00367,India
507278,2023-07-22,404,queen bed,29000,45000,16000,1,00367,India
746833,2023-07-22,410,curtain,1000,2000,1000,1,00368,India
746833,2023-07-22,401,couch,15000,25000,10000,1,00368,India
746833,2023-07-22,408,cupboard,5000,15000,10000,1,00368,India
746833,2023-07-22,409,shelf,500,1000,500,1,00368,India
659489,2023-07-22,411,side table,1500,3000,1500,1,00369,India
659489,2023-07-22,414,chair,1000,2000,1000,1,00369,India
659489,2023-07-22,410,curtain,1000,2000,1000,1,00369,India
659489,2023-07-22,419,paint,2000,4000,2000,1,00369,India
534706,2023-07-22,402,lamp,500,750,250,1,00370,India
739290,2023-07-22,417,door knob,200,400,200,1,00371,India
774613,2023-07-23,406,pillow,200,400,200,1,00372,India
774613,2023-07-23,413,dining table,20000,40000,20000,1,00372,India
397958,2023-07-23,412,area rug,3000,6000,3000,1,00373,India
479294,2023-07-24,411,side table,1500,3000,1500,1,00374,India
479294,2023-07-24,406,pillow,200,400,200,1,00374,India
585898,2023-07-24,412,area rug,3000,6000,3000,1,00375,India
585898,2023-07-24,403,tube light,450,600,150,1,00375,India
585898,2023-07-24,404,queen bed,29000,45000,16000,1,00375,India
585898,2023-07-24,405,carpet,2000,4000,2000,1,00375,India
585898,2023-07-24,410,curtain,1000,2000,1000,1,00375,India
591740,2023-07-24,405,carpet,2000,4000,2000,1,00376,India
242919,2023-07-24,417,door knob,200,400,200,1,00377,India
242919,2023-07-24,418,tiles,50,100,50,1,00377,India
242919,2023-07-24,416,door,5000,10000,5000,1,00377,India
242919,2023-07-24,402,lamp,500,750,250,1,00377,India
242919,2023-07-24,408,cupboard,5000,15000,10000,1,00377,India
898252,2023-07-24,405,carpet,2000,4000,2000,1,00378,India
601102,2023-07-25,415,yard chair,1500,3000,1500,1,00379,India
601102,2023-07-25,409,shelf,500,1000,500,1,00379,India
601102,2023-07-25,418,tiles,50,100,50,1,00379,India
601102,2023-07-25,412,area rug,3000,6000,3000,1,00379,India
782941,2023-07-25,410,curtain,1000,2000,1000,1,00380,India
782941,2023-07-25,403,tube light,450,600,150,1,00380,India
782941,2023-07-25,414,chair,1000,2000,1000,1,00380,India
782941,2023-07-25,402,lamp,500,750,250,1,00380,India
718569,2023-07-25,405,carpet,2000,4000,2000,1,00381,India
718569,2023-07-25,411,side table,1500,3000,1500,1,00381,India
718569,2023-07-25,414,chair,1000,2000,1000,1,00381,India
527190,2023-07-25,401,couch,15000,25000,10000,1,00382,India
527190,2023-07-25,412,area rug,3000,6000,3000,1,00382,India
392068,2023-07-27,411,side table,1500,3000,1500,1,00383,India
392068,2023-07-27,405,carpet,2000,4000,2000,1,00383,India
392068,2023-07-27,409,shelf,500,1000,500,1,00383,India
341717,2023-07-27,407,bedsheet,500,1000,500,1,00384,India
341717,2023-07-27,414,chair,1000,2000,1000,1,00384,India
341717,2023-07-27,410,curtain,1000,2000,1000,1,00384,India
338027,2023-07-27,401,couch,15000,25000,10000,1,00385,India
338027,2023-07-27,413,dining table,20000,40000,20000,1,00385,India
338027,2023-07-27,407,bedsheet,500,1000,500,1,00385,India
666586,2023-07-28,415,yard chair,1500,3000,1500,1,00386,India
929589,2023-07-28,409,shelf,500,1000,500,1,00387,India
929589,2023-07-28,412,area rug,3000,6000,3000,1,00387,India
929589,2023-07-28,418,tiles,50,100,50,1,00387,India
709536,2023-07-29,411,side table,1500,3000,1500,1,00388,India
792618,2023-07-29,406,pillow,200,400,200,1,00389,India
792618,2023-07-29,415,yard chair,1500,3000,1500,1,00389,India
792618,2023-07-29,403,tube light,450,600,150,1,00389,India
589086,2023-07-29,415,yard chair,1500,3000,1500,1,00390,India
589086,2023-07-29,417,door knob,200,400,200,1,00390,India
589086,2023-07-29,410,curtain,1000,2000,1000,1,00390,India
738805,2023-07-31,402,lamp,500,750,250,1,00391,India
738805,2023-07-31,419,paint,2000,4000,2000,1,00391,India
758511,2023-07-31,419,paint,2000,4000,2000,1,00392,India
758511,2023-07-31,404,queen bed,29000,45000,16000,1,00392,India
797838,2023-07-31,413,dining table,20000,40000,20000,1,00393,India
296855,2023-07-31,407,bedsheet,500,1000,500,1,00394,India
296855,2023-07-31,408,cupboard,5000,15000,10000,1,00394,India
359573,2023-07-31,416,door,5000,10000,5000,1,00395,India
359573,2023-07-31,419,paint,2000,4000,2000,1,00395,India
561716,2023-08-01,413,dining table,20000,40000,20000,1,00396,India
561716,2023-08-01,419,paint,2000,4000,2000,1,00396,India
559891,2023-08-01,413,dining table,20000,40000,20000,1,00397,India
559891,2023-08-01,411,side table,1500,3000,1500,1,00397,India
559891,2023-08-01,410,curtain,1000,2000,1000,1,00397,India
559891,2023-08-01,403,tube light,450,600,150,1,00397,India
559891,2023-08-01,408,cupboard,5000,15000,10000,1,00397,India
329973,2023-08-02,401,couch,15000,25000,10000,1,00398,India
329973,2023-08-02,407,bedsheet,500,1000,500,1,00398,India
329973,2023-08-02,412,area rug,3000,6000,3000,1,00398,India
534556,2023-08-02,404,queen bed,29000,45000,16000,1,00399,India
534556,2023-08-02,412,area rug,3000,6000,3000,1,00399,India
164509,2023-08-02,403,tube light,450,600,150,1,00400,India
164509,2023-08-02,416,door,5000,10000,5000,1,00400,India
164509,2023-08-02,419,paint,2000,4000,2000,1,00400,India
164509,2023-08-02,407,bedsheet,500,1000,500,1,00400,India
319159,2023-08-05,408,cupboard,5000,15000,10000,1,00401,India
319159,2023-08-05,410,curtain,1000,2000,1000,1,00401,India
319159,2023-08-05,401,couch,15000,25000,10000,1,00401,India
115359,2023-08-05,404,queen bed,29000,45000,16000,1,00402,India
115359,2023-08-05,411,side table,1500,3000,1500,1,00402,India
305911,2023-08-06,406,pillow,200,400,200,1,00403,India
305911,2023-08-06,402,lamp,500,750,250,1,00403,India
305911,2023-08-06,401,couch,15000,25000,10000,1,00403,India
305911,2023-08-06,403,tube light,450,600,150,1,00403,India
289399,2023-08-06,409,shelf,500,1000,500,1,00404,India
707117,2023-08-06,416,door,5000,10000,5000,1,00405,India
707117,2023-08-06,413,dining table,20000,40000,20000,1,00405,India
339062,2023-08-06,419,paint,2000,4000,2000,1,00406,India
339062,2023-08-06,403,tube light,450,600,150,1,00406,India
339062,2023-08-06,405,carpet,2000,4000,2000,1,00406,India
339062,2023-08-06,406,pillow,200,400,200,1,00406,India
339062,2023-08-06,410,curtain,1000,2000,1000,1,00406,India
576484,2023-08-08,418,tiles,50,100,50,1,00407,India
576484,2023-08-08,417,door knob,200,400,200,1,00407,India
576484,2023-08-08,409,shelf,500,1000,500,1,00407,India
294883,2023-08-09,405,carpet,2000,4000,2000,1,00408,India
294883,2023-08-09,416,door,5000,10000,5000,1,00408,India
178123,2023-08-10,401,couch,15000,25000,10000,1,00409,India
178123,2023-08-10,415,yard chair,1500,3000,1500,1,00409,India
178123,2023-08-10,408,cupboard,5000,15000,10000,1,00409,India
178123,2023-08-10,414,chair,1000,2000,1000,1,00409,India
726107,2023-08-10,404,queen bed,29000,45000,16000,1,00410,India
726107,2023-08-10,419,paint,2000,4000,2000,1,00410,India
726107,2023-08-10,402,lamp,500,750,250,1,00410,India
726107,2023-08-10,408,cupboard,5000,15000,10000,1,00410,India
167751,2023-08-10,401,couch,15000,25000,10000,1,00411,India
167751,2023-08-10,413,dining table,20000,40000,20000,1,00411,India
167751,2023-08-10,410,curtain,1000,2000,1000,1,00411,India
269811,2023-08-10,418,tiles,50,100,50,1,00412,India
269811,2023-08-10,402,lamp,500,750,250,1,00412,India
269811,2023-08-10,413,dining table,20000,40000,20000,1,00412,India
890835,2023-08-11,419,paint,2000,4000,2000,1,00413,India
890835,2023-08-11,414,chair,1000,2000,1000,1,00413,India
890835,2023-08-11,411,side table,1500,3000,1500,1,00413,India
370241,2023-08-11,418,tiles,50,100,50,1,00414,India
370241,2023-08-11,416,door,5000,10000,5000,1,00414,India
370241,2023-08-11,401,couch,15000,25000,10000,1,00414,India
370241,2023-08-11,417,door knob,200,400,200,1,00414,India
792141,2023-08-11,406,pillow,200,400,200,1,00415,India
792141,2023-08-11,405,carpet,2000,4000,2000,1,00415,India
792141,2023-08-11,412,area rug,3000,6000,3000,1,00415,India
411231,2023-08-11,410,curtain,1000,2000,1000,1,00416,India
411231,2023-08-11,405,carpet,2000,4000,2000,1,00416,India
411231,2023-08-11,404,queen bed,29000,45000,16000,1,00416,India
411231,2023-08-11,408,cupboard,5000,15000,10000,1,00416,India
411231,2023-08-11,406,pillow,200,400,200,1,00416,India
116626,2023-08-11,402,lamp,500,750,250,1,00417,India
116626,2023-08-11,404,queen bed,29000,45000,16000,1,00417,India
116626,2023-08-11,407,bedsheet,500,1000,500,1,00417,India
116626,2023-08-11,411,side table,1500,3000,1500,1,00417,India
449533,2023-08-12,405,carpet,2000,4000,2000,1,00418,India
391807,2023-08-13,417,door knob,200,400,200,1,00419,India
391807,2023-08-13,416,door,5000,10000,5000,1,00419,India
692679,2023-08-13,407,bedsheet,500,1000,500,1,00420,India
692679,2023-08-13,418,tiles,50,100,50,1,00420,India
692679,2023-08-13,416,door,5000,10000,5000,1,00420,India
692679,2023-08-13,406,pillow,200,400,200,1,00420,India
704950,2023-08-13,406,pillow,200,400,200,1,00421,India
404159,2023-08-13,402,lamp,500,750,250,1,00422,India
404159,2023-08-13,406,pillow,200,400,200,1,00422,India
404159,2023-08-13,416,door,5000,10000,5000,1,00422,India
781389,2023-08-14,409,shelf,500,1000,500,1,00423,India
781389,2023-08-14,411,side table,1500,3000,1500,1,00423,India
634189,2023-08-14,410,curtain,1000,2000,1000,1,00424,India
634189,2023-08-14,419,paint,2000,4000,2000,1,00424,India
779740,2023-08-15,411,side table,1500,3000,1500,1,00425,India
600255,2023-08-15,418,tiles,50,100,50,1,00426,India
600255,2023-08-15,408,cupboard,5000,15000,10000,1,00426,India
600255,2023-08-15,411,side table,1500,3000,1500,1,00426,India
600255,2023-08-15,415,yard chair,1500,3000,1500,1,00426,India
600255,2023-08-15,414,chair,1000,2000,1000,1,00426,India
234661,2023-08-15,404,queen bed,29000,45000,16000,1,00427,India
234661,2023-08-15,411,side table,1500,3000,1500,1,00427,India
275503,2023-08-15,409,shelf,500,1000,500,1,00428,India
275503,2023-08-15,413,dining table,20000,40000,20000,1,00428,India
275503,2023-08-15,410,curtain,1000,2000,1000,1,00428,India
275503,2023-08-15,417,door knob,200,400,200,1,00428,India
275503,2023-08-15,402,lamp,500,750,250,1,00428,India
340044,2023-08-15,409,shelf,500,1000,500,1,00429,India
340044,2023-08-15,404,queen bed,29000,45000,16000,1,00429,India
340044,2023-08-15,406,pillow,200,400,200,1,00429,India
340044,2023-08-15,402,lamp,500,750,250,1,00429,India
919978,2023-08-16,403,tube light,450,600,150,1,00430,India
919978,2023-08-16,419,paint,2000,4000,2000,1,00430,India
919978,2023-08-16,417,door knob,200,400,200,1,00430,India
974077,2023-08-16,412,area rug,3000,6000,3000,1,00431,India
974077,2023-08-16,415,yard chair,1500,3000,1500,1,00431,India
974077,2023-08-16,416,door,5000,10000,5000,1,00431,India
974077,2023-08-16,413,dining table,20000,40000,20000,1,00431,India
118391,2023-08-18,404,queen bed,29000,45000,16000,1,00432,India
118391,2023-08-18,418,tiles,50,100,50,1,00432,India
118391,2023-08-18,415,yard chair,1500,3000,1500,1,00432,India
143163,2023-08-18,406,pillow,200,400,200,1,00433,India
143163,2023-08-18,412,area rug,3000,6000,3000,1,00433,India
100450,2023-08-18,412,area rug,3000,6000,3000,1,00434,India
100450,2023-08-18,403,tube light,450,600,150,1,00434,India
100450,2023-08-18,413,dining table,20000,40000,20000,1,00434,India
687726,2023-08-18,403,tube light,450,600,150,1,00435,India
687726,2023-08-18,405,carpet,2000,4000,2000,1,00435,India
407742,2023-08-19,407,bedsheet,500,1000,500,1,00436,India
407742,2023-08-19,415,yard chair,1500,3000,1500,1,00436,India
407742,2023-08-19,418,tiles,50,100,50,1,00436,India
400736,2023-08-19,407,bedsheet,500,1000,500,1,00437,India
400736,2023-08-19,419,paint,2000,4000,2000,1,00437,India
400736,2023-08-19,410,curtain,1000,2000,1000,1,00437,India
400736,2023-08-19,403,tube light,450,600,150,1,00437,India
400736,2023-08-19,415,yard chair,1500,3000,1500,1,00437,India
130817,2023-08-19,413,dining table,20000,40000,20000,1,00438,India
130817,2023-08-19,403,tube light,450,600,150,1,00438,India
130817,2023-08-19,416,door,5000,10000,5000,1,00438,India
130817,2023-08-19,410,curtain,1000,2000,1000,1,00438,India
130817,2023-08-19,412,area rug,3000,6000,3000,1,00438,India
138858,2023-08-20,410,curtain,1000,2000,1000,1,00439,India
138858,2023-08-20,404,queen bed,29000,45000,16000,1,00439,India
138858,2023-08-20,408,cupboard,5000,15000,10000,1,00439,India
567802,2023-08-20,406,pillow,200,400,200,1,00440,India
567802,2023-08-20,401,couch,15000,25000,10000,1,00440,India
567802,2023-08-20,412,area rug,3000,6000,3000,1,00440,India
879563,2023-08-22,409,shelf,500,1000,500,1,00441,India
676514,2023-08-22,412,area rug,3000,6000,3000,1,00442,India
676514,2023-08-22,416,door,5000,10000,5000,1,00442,India
269950,2023-08-22,406,pillow,200,400,200,1,00443,India
269950,2023-08-22,417,door knob,200,400,200,1,00443,India
687949,2023-08-22,410,curtain,1000,2000,1000,1,00444,India
687949,2023-08-22,405,carpet,2000,4000,2000,1,00444,India
823162,2023-08-22,413,dining table,20000,40000,20000,1,00445,India
823162,2023-08-22,402,lamp,500,750,250,1,00445,India
826468,2023-08-23,417,door knob,200,400,200,1,00446,India
569320,2023-08-23,419,paint,2000,4000,2000,1,00447,India
471583,2023-08-23,410,curtain,1000,2000,1000,1,00448,India
471583,2023-08-23,408,cupboard,5000,15000,10000,1,00448,India
151862,2023-08-23,419,paint,2000,4000,2000,1,00449,India
151862,2023-08-23,408,cupboard,5000,15000,10000,1,00449,India
264315,2023-08-23,419,paint,2000,4000,2000,1,00450,India
290493,2023-08-24,419,paint,2000,4000,2000,1,00451,India
290493,2023-08-24,406,pillow,200,400,200,1,00451,India
290493,2023-08-24,408,cupboard,5000,15000,10000,1,00451,India
290493,2023-08-24,415,yard chair,1500,3000,1500,1,00451,India
172187,2023-08-24,407,bedsheet,500,1000,500,1,00452,India
332454,2023-08-24,402,lamp,500,750,250,1,00453,India
332454,2023-08-24,404,queen bed,29000,45000,16000,1,00453,India
647402,2023-08-25,412,area rug,3000,6000,3000,1,00454,India
647402,2023-08-25,419,paint,2000,4000,2000,1,00454,India
647402,2023-08-25,403,tube light,450,600,150,1,00454,India
647402,2023-08-25,405,carpet,2000,4000,2000,1,00454,India
647402,2023-08-25,410,curtain,1000,2000,1000,1,00454,India
541172,2023-08-25,417,door knob,200,400,200,1,00455,India
366074,2023-08-26,415,yard chair,1500,3000,1500,1,00456,India
366074,2023-08-26,412,area rug,3000,6000,3000,1,00456,India
366074,2023-08-26,414,chair,1000,2000,1000,1,00456,India
366074,2023-08-26,417,door knob,200,400,200,1,00456,India
366074,2023-08-26,401,couch,15000,25000,10000,1,00456,India
716255,2023-08-28,415,yard chair,1500,3000,1500,1,00457,India
716255,2023-08-28,404,queen bed,29000,45000,16000,1,00457,India
716255,2023-08-28,407,bedsheet,500,1000,500,1,00457,India
806423,2023-08-29,415,yard chair,1500,3000,1500,1,00458,India
643787,2023-08-29,406,pillow,200,400,200,1,00459,India
643787,2023-08-29,418,tiles,50,100,50,1,00459,India
897933,2023-08-29,417,door knob,200,400,200,1,00460,India
897933,2023-08-29,406,pillow,200,400,200,1,00460,India
897933,2023-08-29,411,side table,1500,3000,1500,1,00460,India
897933,2023-08-29,402,lamp,500,750,250,1,00460,India
964939,2023-08-29,406,pillow,200,400,200,1,00461,India
964939,2023-08-29,407,bedsheet,500,1000,500,1,00461,India
857626,2023-08-30,417,door knob,200,400,200,1,00462,India
857626,2023-08-30,405,carpet,2000,4000,2000,1,00462,India
857626,2023-08-30,414,chair,1000,2000,1000,1,00462,India
114274,2023-08-30,413,dining table,20000,40000,20000,1,00463,India
114274,2023-08-30,409,shelf,500,1000,500,1,00463,India
114274,2023-08-30,402,lamp,500,750,250,1,00463,India
116190,2023-08-30,409,shelf,500,1000,500,1,00464,India
116190,2023-08-30,407,bedsheet,500,1000,500,1,00464,India
116190,2023-08-30,415,yard chair,1500,3000,1500,1,00464,India
116190,2023-08-30,410,curtain,1000,2000,1000,1,00464,India
478003,2023-08-30,403,tube light,450,600,150,1,00465,India
478003,2023-08-30,406,pillow,200,400,200,1,00465,India
478003,2023-08-30,419,paint,2000,4000,2000,1,00465,India
478003,2023-08-30,411,side table,1500,3000,1500,1,00465,India
478003,2023-08-30,408,cupboard,5000,15000,10000,1,00465,India
269152,2023-08-31,401,couch,15000,25000,10000,1,00466,India
269152,2023-08-31,414,chair,1000,2000,1000,1,00466,India
970455,2023-08-31,418,tiles,50,100,50,1,00467,India
970455,2023-08-31,415,yard chair,1500,3000,1500,1,00467,India
970455,2023-08-31,403,tube light,450,600,150,1,00467,India
970455,2023-08-31,404,queen bed,29000,45000,16000,1,00467,India
463840,2023-08-31,406,pillow,200,400,200,1,00468,India
463840,2023-08-31,418,tiles,50,100,50,1,00468,India
463840,2023-08-31,409,shelf,500,1000,500,1,00468,India
569945,2023-08-31,403,tube light,450,600,150,1,00469,India
569945,2023-08-31,408,cupboard,5000,15000,10000,1,00469,India
569945,2023-08-31,415,yard chair,1500,3000,1500,1,00469,India
569945,2023-08-31,405,carpet,2000,4000,2000,1,00469,India
569945,2023-08-31,410,curtain,1000,2000,1000,1,00469,India
639467,2023-09-02,416,door,5000,10000,5000,1,00470,India
639467,2023-09-02,412,area rug,3000,6000,3000,1,00470,India
639467,2023-09-02,411,side table,1500,3000,1500,1,00470,India
904324,2023-09-02,408,cupboard,5000,15000,10000,1,00471,India
557288,2023-09-02,418,tiles,50,100,50,1,00472,India
557288,2023-09-02,413,dining table,20000,40000,20000,1,00472,India
557288,2023-09-02,417,door knob,200,400,200,1,00472,India
557288,2023-09-02,405,carpet,2000,4000,2000,1,00472,India
185201,2023-09-03,407,bedsheet,500,1000,500,1,00473,India
185201,2023-09-03,415,yard chair,1500,3000,1500,1,00473,India
185201,2023-09-03,413,dining table,20000,40000,20000,1,00473,India
290470,2023-09-03,406,pillow,200,400,200,1,00474,India
290470,2023-09-03,403,tube light,450,600,150,1,00474,India
290470,2023-09-03,417,door knob,200,400,200,1,00474,India
652779,2023-09-03,410,curtain,1000,2000,1000,1,00475,India
652779,2023-09-03,416,door,5000,10000,5000,1,00475,India
652779,2023-09-03,406,pillow,200,400,200,1,00475,India
652779,2023-09-03,415,yard chair,1500,3000,1500,1,00475,India
482017,2023-09-03,401,couch,15000,25000,10000,1,00476,India
482017,2023-09-03,407,bedsheet,500,1000,500,1,00476,India
482017,2023-09-03,408,cupboard,5000,15000,10000,1,00476,India
482017,2023-09-03,413,dining table,20000,40000,20000,1,00476,India
673899,2023-09-04,408,cupboard,5000,15000,10000,1,00477,India
617222,2023-09-05,412,area rug,3000,6000,3000,1,00478,India
138120,2023-09-05,403,tube light,450,600,150,1,00479,India
138120,2023-09-05,417,door knob,200,400,200,1,00479,India
138120,2023-09-05,401,couch,15000,25000,10000,1,00479,India
138120,2023-09-05,414,chair,1000,2000,1000,1,00479,India
942074,2023-09-05,412,area rug,3000,6000,3000,1,00480,India
942074,2023-09-05,401,couch,15000,25000,10000,1,00480,India
942074,2023-09-05,415,yard chair,1500,3000,1500,1,00480,India
942074,2023-09-05,411,side table,1500,3000,1500,1,00480,India
353070,2023-09-05,410,curtain,1000,2000,1000,1,00481,India
353070,2023-09-05,418,tiles,50,100,50,1,00481,India
353070,2023-09-05,417,door knob,200,400,200,1,00481,India
154003,2023-09-06,408,cupboard,5000,15000,10000,1,00482,India
749902,2023-09-06,407,bedsheet,500,1000,500,1,00483,India
749902,2023-09-06,401,couch,15000,25000,10000,1,00483,India
805590,2023-09-06,408,cupboard,5000,15000,10000,1,00484,India
815710,2023-09-06,418,tiles,50,100,50,1,00485,India
815710,2023-09-06,415,yard chair,1500,3000,1500,1,00485,India
663872,2023-09-07,413,dining table,20000,40000,20000,1,00486,India
663872,2023-09-07,405,carpet,2000,4000,2000,1,00486,India
663872,2023-09-07,411,side table,1500,3000,1500,1,00486,India
325266,2023-09-07,404,queen bed,29000,45000,16000,1,00487,India
325266,2023-09-07,402,lamp,500,750,250,1,00487,India
747148,2023-09-07,404,queen bed,29000,45000,16000,1,00488,India
747148,2023-09-07,417,door knob,200,400,200,1,00488,India
747148,2023-09-07,413,dining table,20000,40000,20000,1,00488,India
747148,2023-09-07,403,tube light,450,600,150,1,00488,India
695638,2023-09-07,407,bedsheet,500,1000,500,1,00489,India
695638,2023-09-07,405,carpet,2000,4000,2000,1,00489,India
695638,2023-09-07,415,yard chair,1500,3000,1500,1,00489,India
149944,2023-09-07,416,door,5000,10000,5000,1,00490,India
149944,2023-09-07,417,door knob,200,400,200,1,00490,India
149944,2023-09-07,415,yard chair,1500,3000,1500,1,00490,India
835412,2023-09-10,401,couch,15000,25000,10000,1,00491,India
199432,2023-09-12,402,lamp,500,750,250,1,00492,India
199432,2023-09-12,410,curtain,1000,2000,1000,1,00492,India
344734,2023-09-12,405,carpet,2000,4000,2000,1,00493,India
344734,2023-09-12,414,chair,1000,2000,1000,1,00493,India
344734,2023-09-12,408,cupboard,5000,15000,10000,1,00493,India
645165,2023-09-13,403,tube light,450,600,150,1,00494,India
929134,2023-09-13,416,door,5000,10000,5000,1,00495,India
929134,2023-09-13,418,tiles,50,100,50,1,00495,India
929134,2023-09-13,409,shelf,500,1000,500,1,00495,India
929134,2023-09-13,414,chair,1000,2000,1000,1,00495,India
379718,2023-09-13,406,pillow,200,400,200,1,00496,India
379718,2023-09-13,417,door knob,200,400,200,1,00496,India
379718,2023-09-13,405,carpet,2000,4000,2000,1,00496,India
379718,2023-09-13,403,tube light,450,600,150,1,00496,India
379718,2023-09-13,416,door,5000,10000,5000,1,00496,India
950935,2023-09-13,404,queen bed,29000,45000,16000,1,00497,India
950935,2023-09-13,416,door,5000,10000,5000,1,00497,India
950935,2023-09-13,405,carpet,2000,4000,2000,1,00497,India
950935,2023-09-13,402,lamp,500,750,250,1,00497,India
392673,2023-09-13,418,tiles,50,100,50,1,00498,India
392673,2023-09-13,404,queen bed,29000,45000,16000,1,00498,India
392673,2023-09-13,419,paint,2000,4000,2000,1,00498,India
253477,2023-09-14,404,queen bed,29000,45000,16000,1,00499,India
253477,2023-09-14,410,curtain,1000,2000,1000,1,00499,India
102060,2023-09-14,416,door,5000,10000,5000,1,00500,India
102060,2023-09-14,404,queen bed,29000,45000,16000,1,00500,India
102060,2023-09-14,412,area rug,3000,6000,3000,1,00500,India
102060,2023-09-14,402,lamp,500,750,250,1,00500,India
555292,2023-09-14,409,shelf,500,1000,500,1,00238,India
555292,2023-09-14,411,side table,1500,3000,1500,1,00238,India
555292,2023-09-14,404,queen bed,29000,45000,16000,1,00238,India
555292,2023-09-14,403,tube light,450,600,150,1,00238,India
413333,2023-09-14,412,area rug,3000,6000,3000,1,00162,India
413333,2023-09-14,401,couch,15000,25000,10000,1,00162,India
413333,2023-09-14,416,door,5000,10000,5000,1,00162,India
413333,2023-09-14,413,dining table,20000,40000,20000,1,00162,India
272359,2023-09-14,408,cupboard,5000,15000,10000,1,00367,India
272359,2023-09-14,406,pillow,200,400,200,1,00367,India
272359,2023-09-14,409,shelf,500,1000,500,1,00367,India
272359,2023-09-14,412,area rug,3000,6000,3000,1,00367,India
680933,2023-09-15,413,dining table,20000,40000,20000,1,00444,India
680933,2023-09-15,408,cupboard,5000,15000,10000,1,00444,India
680933,2023-09-15,419,paint,2000,4000,2000,1,00444,India
402571,2023-09-15,402,lamp,500,750,250,1,00053,India
402571,2023-09-15,401,couch,15000,25000,10000,1,00053,India
536011,2023-09-15,404,queen bed,29000,45000,16000,1,00053,India
536011,2023-09-15,415,yard chair,1500,3000,1500,1,00053,India
558824,2023-09-15,402,lamp,500,750,250,1,00104,India
558824,2023-09-15,417,door knob,200,400,200,1,00104,India
558824,2023-09-15,405,carpet,2000,4000,2000,1,00104,India
558824,2023-09-15,411,side table,1500,3000,1500,1,00104,India
959666,2023-09-16,402,lamp,500,750,250,1,00232,India
959666,2023-09-16,417,door knob,200,400,200,1,00232,India
959666,2023-09-16,418,tiles,50,100,50,1,00232,India
191591,2023-09-16,407,bedsheet,500,1000,500,1,00032,India
191591,2023-09-16,402,lamp,500,750,250,1,00032,India
191591,2023-09-16,414,chair,1000,2000,1000,1,00032,India
804452,2023-09-16,408,cupboard,5000,15000,10000,1,00427,India
804452,2023-09-16,404,queen bed,29000,45000,16000,1,00427,India
874566,2023-09-16,416,door,5000,10000,5000,1,00251,India
874566,2023-09-16,411,side table,1500,3000,1500,1,00251,India
874566,2023-09-16,408,cupboard,5000,15000,10000,1,00251,India
874566,2023-09-16,405,carpet,2000,4000,2000,1,00251,India
512694,2023-09-16,418,tiles,50,100,50,1,00161,India
839959,2023-09-17,419,paint,2000,4000,2000,1,00439,India
839959,2023-09-17,405,carpet,2000,4000,2000,1,00439,India
839959,2023-09-17,411,side table,1500,3000,1500,1,00439,India
839959,2023-09-17,403,tube light,450,600,150,1,00439,India
565411,2023-09-21,404,queen bed,29000,45000,16000,1,00366,India
565411,2023-09-21,418,tiles,50,100,50,1,00366,India
565411,2023-09-21,415,yard chair,1500,3000,1500,1,00366,India
882942,2023-09-21,416,door,5000,10000,5000,1,00195,India
882942,2023-09-21,401,couch,15000,25000,10000,1,00195,India
882942,2023-09-21,404,queen bed,29000,45000,16000,1,00195,India
882942,2023-09-21,415,yard chair,1500,3000,1500,1,00195,India
882942,2023-09-21,413,dining table,20000,40000,20000,1,00195,India
320267,2023-09-21,416,door,5000,10000,5000,1,00140,India
210527,2023-09-21,414,chair,1000,2000,1000,1,00232,India
210527,2023-09-21,413,dining table,20000,40000,20000,1,00232,India
210527,2023-09-21,407,bedsheet,500,1000,500,1,00232,India
827638,2023-09-21,408,cupboard,5000,15000,10000,1,00231,India
827638,2023-09-21,413,dining table,20000,40000,20000,1,00231,India
827638,2023-09-21,406,pillow,200,400,200,1,00231,India
600659,2023-09-22,412,area rug,3000,6000,3000,1,00232,India
124772,2023-09-22,402,lamp,500,750,250,1,00108,India
304914,2023-09-22,404,queen bed,29000,45000,16000,1,00133,India
772333,2023-09-22,413,dining table,20000,40000,20000,1,00168,India
704656,2023-09-22,417,door knob,200,400,200,1,00445,India
704656,2023-09-22,418,tiles,50,100,50,1,00445,India
704656,2023-09-22,404,queen bed,29000,45000,16000,1,00445,India
704656,2023-09-22,402,lamp,500,750,250,1,00445,India
704656,2023-09-22,407,bedsheet,500,1000,500,1,00445,India
415165,2023-09-23,412,area rug,3000,6000,3000,1,00397,India
415165,2023-09-23,418,tiles,50,100,50,1,00397,India
207756,2023-09-23,408,cupboard,5000,15000,10000,1,00147,India
207756,2023-09-23,411,side table,1500,3000,1500,1,00147,India
207756,2023-09-23,414,chair,1000,2000,1000,1,00147,India
368436,2023-09-23,414,chair,1000,2000,1000,1,00234,India
368436,2023-09-23,415,yard chair,1500,3000,1500,1,00234,India
368436,2023-09-23,411,side table,1500,3000,1500,1,00234,India
368436,2023-09-23,407,bedsheet,500,1000,500,1,00234,India
946439,2023-09-23,403,tube light,450,600,150,1,00361,India
946439,2023-09-23,404,queen bed,29000,45000,16000,1,00361,India
946439,2023-09-23,409,shelf,500,1000,500,1,00361,India
404753,2023-09-23,418,tiles,50,100,50,1,00259,India
404753,2023-09-23,412,area rug,3000,6000,3000,1,00259,India
404753,2023-09-23,408,cupboard,5000,15000,10000,1,00259,India
404753,2023-09-23,414,chair,1000,2000,1000,1,00259,India
314430,2023-09-24,413,dining table,20000,40000,20000,1,00022,India
314430,2023-09-24,417,door knob,200,400,200,1,00022,India
314430,2023-09-24,406,pillow,200,400,200,1,00022,India
253199,2023-09-24,407,bedsheet,500,1000,500,1,00460,India
253199,2023-09-24,401,couch,15000,25000,10000,1,00460,India
253199,2023-09-24,419,paint,2000,4000,2000,1,00460,India
740014,2023-09-25,414,chair,1000,2000,1000,1,00013,India
806998,2023-09-25,404,queen bed,29000,45000,16000,1,00414,India
806998,2023-09-25,415,yard chair,1500,3000,1500,1,00414,India
806998,2023-09-25,408,cupboard,5000,15000,10000,1,00414,India
806998,2023-09-25,413,dining table,20000,40000,20000,1,00414,India
976699,2023-09-25,411,side table,1500,3000,1500,1,00170,India
976699,2023-09-25,402,lamp,500,750,250,1,00170,India
976699,2023-09-25,410,curtain,1000,2000,1000,1,00170,India
869525,2023-09-25,410,curtain,1000,2000,1000,1,00208,India
869525,2023-09-25,411,side table,1500,3000,1500,1,00208,India
940821,2023-09-25,412,area rug,3000,6000,3000,1,00152,India
940821,2023-09-25,401,couch,15000,25000,10000,1,00152,India
940821,2023-09-25,402,lamp,500,750,250,1,00152,India
562446,2023-09-26,410,curtain,1000,2000,1000,1,00071,India
562446,2023-09-26,402,lamp,500,750,250,1,00071,India
878563,2023-09-26,410,curtain,1000,2000,1000,1,00208,India
910379,2023-09-26,414,chair,1000,2000,1000,1,00037,India
910379,2023-09-26,412,area rug,3000,6000,3000,1,00037,India
910379,2023-09-26,406,pillow,200,400,200,1,00037,India
910379,2023-09-26,417,door knob,200,400,200,1,00037,India
910379,2023-09-26,419,paint,2000,4000,2000,1,00037,India
356336,2023-09-26,416,door,5000,10000,5000,1,00438,India
356336,2023-09-26,405,carpet,2000,4000,2000,1,00438,India
356336,2023-09-26,403,tube light,450,600,150,1,00438,India
356336,2023-09-26,407,bedsheet,500,1000,500,1,00438,India
933745,2023-09-26,417,door knob,200,400,200,1,00415,India
933745,2023-09-26,419,paint,2000,4000,2000,1,00415,India
933745,2023-09-26,409,shelf,500,1000,500,1,00415,India
795739,2023-09-27,402,lamp,500,750,250,1,00301,India
795739,2023-09-27,415,yard chair,1500,3000,1500,1,00301,India
795739,2023-09-27,407,bedsheet,500,1000,500,1,00301,India
795739,2023-09-27,406,pillow,200,400,200,1,00301,India
802240,2023-09-28,401,couch,15000,25000,10000,1,00190,India
802240,2023-09-28,415,yard chair,1500,3000,1500,1,00190,India
802240,2023-09-28,407,bedsheet,500,1000,500,1,00190,India
802240,2023-09-28,410,curtain,1000,2000,1000,1,00190,India
698462,2023-09-28,414,chair,1000,2000,1000,1,00158,India
698462,2023-09-28,418,tiles,50,100,50,1,00158,India
698462,2023-09-28,401,couch,15000,25000,10000,1,00158,India
698462,2023-09-28,408,cupboard,5000,15000,10000,1,00158,India
892516,2023-09-28,404,queen bed,29000,45000,16000,1,00115,India
892516,2023-09-28,411,side table,1500,3000,1500,1,00115,India
892516,2023-09-28,407,bedsheet,500,1000,500,1,00115,India
438782,2023-09-28,407,bedsheet,500,1000,500,1,00052,India
438782,2023-09-28,411,side table,1500,3000,1500,1,00052,India
438782,2023-09-28,408,cupboard,5000,15000,10000,1,00052,India
438782,2023-09-28,402,lamp,500,750,250,1,00052,India
438782,2023-09-28,413,dining table,20000,40000,20000,1,00052,India
387977,2023-09-29,409,shelf,500,1000,500,1,00444,India
192133,2023-09-29,413,dining table,20000,40000,20000,1,00118,India
192133,2023-09-29,402,lamp,500,750,250,1,00118,India
192133,2023-09-29,407,bedsheet,500,1000,500,1,00118,India
192133,2023-09-29,416,door,5000,10000,5000,1,00118,India
915353,2023-09-29,415,yard chair,1500,3000,1500,1,00379,India
915353,2023-09-29,401,couch,15000,25000,10000,1,00379,India
915353,2023-09-29,412,area rug,3000,6000,3000,1,00379,India
915353,2023-09-29,404,queen bed,29000,45000,16000,1,00379,India
965598,2023-09-29,409,shelf,500,1000,500,1,00493,India
965598,2023-09-29,407,bedsheet,500,1000,500,1,00493,India
753828,2023-09-29,410,curtain,1000,2000,1000,1,00471,India
753828,2023-09-29,402,lamp,500,750,250,1,00471,India
753828,2023-09-29,407,bedsheet,500,1000,500,1,00471,India
753828,2023-09-29,403,tube light,450,600,150,1,00471,India
753828,2023-09-29,401,couch,15000,25000,10000,1,00471,India
886533,2023-09-30,412,area rug,3000,6000,3000,1,00466,India
886533,2023-09-30,402,lamp,500,750,250,1,00466,India
886533,2023-09-30,403,tube light,450,600,150,1,00466,India
886533,2023-09-30,409,shelf,500,1000,500,1,00466,India
886533,2023-09-30,407,bedsheet,500,1000,500,1,00466,India
103612,2023-09-30,409,shelf,500,1000,500,1,00232,India
629326,2023-09-30,414,chair,1000,2000,1000,1,00450,India
629326,2023-09-30,416,door,5000,10000,5000,1,00450,India
629326,2023-09-30,415,yard chair,1500,3000,1500,1,00450,India
629326,2023-09-30,401,couch,15000,25000,10000,1,00450,India
695358,2023-09-30,401,couch,15000,25000,10000,1,00052,India
695358,2023-09-30,409,shelf,500,1000,500,1,00052,India
695358,2023-09-30,418,tiles,50,100,50,1,00052,India
543059,2023-10-01,414,chair,1000,2000,1000,1,00420,India
543059,2023-10-01,401,couch,15000,25000,10000,1,00420,India
543059,2023-10-01,403,tube light,450,600,150,1,00420,India
543059,2023-10-01,404,queen bed,29000,45000,16000,1,00420,India
809025,2023-10-01,402,lamp,500,750,250,1,00412,India
809025,2023-10-01,414,chair,1000,2000,1000,1,00412,India
640101,2023-10-01,405,carpet,2000,4000,2000,1,00342,India
640101,2023-10-01,418,tiles,50,100,50,1,00342,India
640101,2023-10-01,412,area rug,3000,6000,3000,1,00342,India
640101,2023-10-01,413,dining table,20000,40000,20000,1,00342,India
640101,2023-10-01,417,door knob,200,400,200,1,00342,India
269421,2023-10-01,417,door knob,200,400,200,1,00225,India
269421,2023-10-01,402,lamp,500,750,250,1,00225,India
269421,2023-10-01,401,couch,15000,25000,10000,1,00225,India
269421,2023-10-01,405,carpet,2000,4000,2000,1,00225,India
269421,2023-10-01,409,shelf,500,1000,500,1,00225,India
272824,2023-10-03,410,curtain,1000,2000,1000,1,00307,India
272824,2023-10-03,406,pillow,200,400,200,1,00307,India
272824,2023-10-03,403,tube light,450,600,150,1,00307,India
272824,2023-10-03,411,side table,1500,3000,1500,1,00307,India
272824,2023-10-03,404,queen bed,29000,45000,16000,1,00307,India
447281,2023-10-03,407,bedsheet,500,1000,500,1,00221,India
447281,2023-10-03,401,couch,15000,25000,10000,1,00221,India
161398,2023-10-03,401,couch,15000,25000,10000,1,00291,India
161398,2023-10-03,419,paint,2000,4000,2000,1,00291,India
161398,2023-10-03,404,queen bed,29000,45000,16000,1,00291,India
151114,2023-10-03,418,tiles,50,100,50,1,00153,India
151114,2023-10-03,403,tube light,450,600,150,1,00153,India
811812,2023-10-03,407,bedsheet,500,1000,500,1,00207,India
811812,2023-10-03,404,queen bed,29000,45000,16000,1,00207,India
811812,2023-10-03,403,tube light,450,600,150,1,00207,India
383243,2023-10-04,415,yard chair,1500,3000,1500,1,00086,India
383243,2023-10-04,404,queen bed,29000,45000,16000,1,00086,India
383243,2023-10-04,412,area rug,3000,6000,3000,1,00086,India
383243,2023-10-04,406,pillow,200,400,200,1,00086,India
383243,2023-10-04,402,lamp,500,750,250,1,00086,India
745100,2023-10-06,403,tube light,450,600,150,1,00225,India
898745,2023-10-06,406,pillow,200,400,200,1,00104,India
898745,2023-10-06,402,lamp,500,750,250,1,00104,India
898745,2023-10-06,405,carpet,2000,4000,2000,1,00104,India
898745,2023-10-06,401,couch,15000,25000,10000,1,00104,India
898745,2023-10-06,418,tiles,50,100,50,1,00104,India
641934,2023-10-08,404,queen bed,29000,45000,16000,1,00488,India
641934,2023-10-08,412,area rug,3000,6000,3000,1,00488,India
775039,2023-10-08,410,curtain,1000,2000,1000,1,00227,India
775039,2023-10-08,401,couch,15000,25000,10000,1,00227,India
352332,2023-10-09,418,tiles,50,100,50,1,00004,India
352332,2023-10-09,402,lamp,500,750,250,1,00004,India
352332,2023-10-09,415,yard chair,1500,3000,1500,1,00004,India
352332,2023-10-09,409,shelf,500,1000,500,1,00004,India
352332,2023-10-09,404,queen bed,29000,45000,16000,1,00004,India
699973,2023-10-10,412,area rug,3000,6000,3000,1,00408,India
699973,2023-10-10,407,bedsheet,500,1000,500,1,00408,India
699973,2023-10-10,417,door knob,200,400,200,1,00408,India
927536,2023-10-10,418,tiles,50,100,50,1,00180,India
927536,2023-10-10,402,lamp,500,750,250,1,00180,India
477112,2023-10-10,410,curtain,1000,2000,1000,1,00378,India
477112,2023-10-10,408,cupboard,5000,15000,10000,1,00378,India
477112,2023-10-10,407,bedsheet,500,1000,500,1,00378,India
477112,2023-10-10,404,queen bed,29000,45000,16000,1,00378,India
766237,2023-10-11,408,cupboard,5000,15000,10000,1,00314,India
766237,2023-10-11,405,carpet,2000,4000,2000,1,00314,India
766237,2023-10-11,418,tiles,50,100,50,1,00314,India
766237,2023-10-11,404,queen bed,29000,45000,16000,1,00314,India
766237,2023-10-11,411,side table,1500,3000,1500,1,00314,India
124062,2023-10-11,416,door,5000,10000,5000,1,00414,India
130075,2023-10-11,403,tube light,450,600,150,1,00497,India
697968,2023-10-12,419,paint,2000,4000,2000,1,00042,India
697968,2023-10-12,415,yard chair,1500,3000,1500,1,00042,India
697968,2023-10-12,412,area rug,3000,6000,3000,1,00042,India
697968,2023-10-12,404,queen bed,29000,45000,16000,1,00042,India
596119,2023-10-12,413,dining table,20000,40000,20000,1,00293,India
596119,2023-10-12,406,pillow,200,400,200,1,00293,India
596119,2023-10-12,411,side table,1500,3000,1500,1,00293,India
496697,2023-10-13,405,carpet,2000,4000,2000,1,00291,India
496697,2023-10-13,408,cupboard,5000,15000,10000,1,00291,India
796355,2023-10-14,415,yard chair,1500,3000,1500,1,00300,India
796355,2023-10-14,407,bedsheet,500,1000,500,1,00300,India
756801,2023-10-15,414,chair,1000,2000,1000,1,00162,India
756801,2023-10-15,405,carpet,2000,4000,2000,1,00162,India
281434,2023-10-17,417,door knob,200,400,200,1,00440,India
281434,2023-10-17,408,cupboard,5000,15000,10000,1,00440,India
281434,2023-10-17,419,paint,2000,4000,2000,1,00440,India
424599,2023-10-17,401,couch,15000,25000,10000,1,00296,India
264250,2023-10-17,404,queen bed,29000,45000,16000,1,00191,India
264250,2023-10-17,402,lamp,500,750,250,1,00191,India
340829,2023-10-17,414,chair,1000,2000,1000,1,00052,India
167186,2023-10-17,407,bedsheet,500,1000,500,1,00445,India
167186,2023-10-17,405,carpet,2000,4000,2000,1,00445,India
167186,2023-10-17,408,cupboard,5000,15000,10000,1,00445,India
167186,2023-10-17,402,lamp,500,750,250,1,00445,India
167186,2023-10-17,418,tiles,50,100,50,1,00445,India
492050,2023-10-18,402,lamp,500,750,250,1,00320,India
774696,2023-10-18,416,door,5000,10000,5000,1,00095,India
774696,2023-10-18,415,yard chair,1500,3000,1500,1,00095,India
774696,2023-10-18,418,tiles,50,100,50,1,00095,India
774696,2023-10-18,409,shelf,500,1000,500,1,00095,India
820195,2023-10-19,411,side table,1500,3000,1500,1,00200,India
642858,2023-10-19,414,chair,1000,2000,1000,1,00385,India
642858,2023-10-19,418,tiles,50,100,50,1,00385,India
642858,2023-10-19,402,lamp,500,750,250,1,00385,India
772631,2023-10-19,411,side table,1500,3000,1500,1,00470,India
772631,2023-10-19,419,paint,2000,4000,2000,1,00470,India
772631,2023-10-19,418,tiles,50,100,50,1,00470,India
772631,2023-10-19,402,lamp,500,750,250,1,00470,India
542946,2023-10-19,414,chair,1000,2000,1000,1,00343,India
667635,2023-10-19,404,queen bed,29000,45000,16000,1,00142,India
103051,2023-10-20,410,curtain,1000,2000,1000,1,00270,India
103051,2023-10-20,413,dining table,20000,40000,20000,1,00270,India
174151,2023-10-21,413,dining table,20000,40000,20000,1,00157,India
174151,2023-10-21,408,cupboard,5000,15000,10000,1,00157,India
174151,2023-10-21,411,side table,1500,3000,1500,1,00157,India
174151,2023-10-21,412,area rug,3000,6000,3000,1,00157,India
174151,2023-10-21,409,shelf,500,1000,500,1,00157,India
829459,2023-10-21,405,carpet,2000,4000,2000,1,00450,India
829459,2023-10-21,410,curtain,1000,2000,1000,1,00450,India
829459,2023-10-21,403,tube light,450,600,150,1,00450,India
579108,2023-10-22,411,side table,1500,3000,1500,1,00269,India
579108,2023-10-22,401,couch,15000,25000,10000,1,00269,India
141015,2023-10-22,407,bedsheet,500,1000,500,1,00272,India
141015,2023-10-22,402,lamp,500,750,250,1,00272,India
141015,2023-10-22,411,side table,1500,3000,1500,1,00272,India
902127,2023-10-22,402,lamp,500,750,250,1,00206,India
902127,2023-10-22,416,door,5000,10000,5000,1,00206,India
902127,2023-10-22,413,dining table,20000,40000,20000,1,00206,India
882829,2023-10-23,416,door,5000,10000,5000,1,00175,India
882829,2023-10-23,404,queen bed,29000,45000,16000,1,00175,India
882829,2023-10-23,413,dining table,20000,40000,20000,1,00175,India
473340,2023-10-24,417,door knob,200,400,200,1,00262,India
473340,2023-10-24,405,carpet,2000,4000,2000,1,00262,India
473340,2023-10-24,401,couch,15000,25000,10000,1,00262,India
473340,2023-10-24,416,door,5000,10000,5000,1,00262,India
851531,2023-10-24,404,queen bed,29000,45000,16000,1,00214,India
851531,2023-10-24,412,area rug,3000,6000,3000,1,00214,India
851531,2023-10-24,408,cupboard,5000,15000,10000,1,00214,India
851531,2023-10-24,413,dining table,20000,40000,20000,1,00214,India
851531,2023-10-24,417,door knob,200,400,200,1,00214,India
404857,2023-10-24,408,cupboard,5000,15000,10000,1,00187,India
917543,2023-10-24,402,lamp,500,750,250,1,00168,India
917543,2023-10-24,405,carpet,2000,4000,2000,1,00168,India
917543,2023-10-24,412,area rug,3000,6000,3000,1,00168,India
917543,2023-10-24,418,tiles,50,100,50,1,00168,India
978606,2023-10-24,406,pillow,200,400,200,1,00269,India
978606,2023-10-24,405,carpet,2000,4000,2000,1,00269,India
978606,2023-10-24,409,shelf,500,1000,500,1,00269,India
856850,2023-10-26,404,queen bed,29000,45000,16000,1,00018,India
567824,2023-10-26,419,paint,2000,4000,2000,1,00342,India
567824,2023-10-26,416,door,5000,10000,5000,1,00342,India
567824,2023-10-26,410,curtain,1000,2000,1000,1,00342,India
567824,2023-10-26,412,area rug,3000,6000,3000,1,00342,India
567824,2023-10-26,415,yard chair,1500,3000,1500,1,00342,India
552958,2023-10-26,419,paint,2000,4000,2000,1,00277,India
552958,2023-10-26,417,door knob,200,400,200,1,00277,India
552958,2023-10-26,407,bedsheet,500,1000,500,1,00277,India
552958,2023-10-26,410,curtain,1000,2000,1000,1,00277,India
552958,2023-10-26,415,yard chair,1500,3000,1500,1,00277,India
498028,2023-10-27,411,side table,1500,3000,1500,1,00311,India
835998,2023-10-28,403,tube light,450,600,150,1,00207,India
835998,2023-10-28,401,couch,15000,25000,10000,1,00207,India
835998,2023-10-28,412,area rug,3000,6000,3000,1,00207,India
835998,2023-10-28,410,curtain,1000,2000,1000,1,00207,India
835998,2023-10-28,402,lamp,500,750,250,1,00207,India
265599,2023-10-28,413,dining table,20000,40000,20000,1,00379,India
265599,2023-10-28,415,yard chair,1500,3000,1500,1,00379,India
473512,2023-10-28,406,pillow,200,400,200,1,00427,India
473512,2023-10-28,404,queen bed,29000,45000,16000,1,00427,India
473512,2023-10-28,401,couch,15000,25000,10000,1,00427,India
121959,2023-10-29,418,tiles,50,100,50,1,00125,India
353157,2023-11-01,414,chair,1000,2000,1000,2,00421,India
353157,2023-11-01,411,side table,1500,3000,1500,2,00421,India
434491,2023-11-01,410,curtain,1000,2000,1000,2,00306,India
434491,2023-11-01,406,pillow,200,400,200,2,00306,India
434491,2023-11-01,415,yard chair,1500,3000,1500,2,00306,India
434491,2023-11-01,412,area rug,3000,6000,3000,2,00306,India
909526,2023-11-02,410,curtain,1000,2000,1000,2,00295,India
787773,2023-11-02,408,cupboard,5000,15000,10000,2,00018,India
950591,2023-11-02,403,tube light,450,600,150,2,00340,India
950591,2023-11-02,416,door,5000,10000,5000,2,00340,India
950591,2023-11-02,404,queen bed,29000,45000,16000,2,00340,India
950591,2023-11-02,401,couch,15000,25000,10000,2,00340,India
723392,2023-11-02,413,dining table,20000,40000,20000,2,00329,India
723392,2023-11-02,416,door,5000,10000,5000,2,00329,India
723392,2023-11-02,401,couch,15000,25000,10000,2,00329,India
723392,2023-11-02,412,area rug,3000,6000,3000,2,00329,India
776649,2023-11-03,402,lamp,500,750,250,2,00297,India
610778,2023-11-04,407,bedsheet,500,1000,500,2,00296,India
610778,2023-11-04,415,yard chair,1500,3000,1500,2,00296,India
610778,2023-11-04,405,carpet,2000,4000,2000,2,00296,India
610778,2023-11-04,401,couch,15000,25000,10000,2,00296,India
610778,2023-11-04,411,side table,1500,3000,1500,2,00296,India
430827,2023-11-04,413,dining table,20000,40000,20000,2,00417,India
430827,2023-11-04,408,cupboard,5000,15000,10000,2,00417,India
430827,2023-11-04,415,yard chair,1500,3000,1500,2,00417,India
430827,2023-11-04,411,side table,1500,3000,1500,2,00417,India
304839,2023-11-04,407,bedsheet,500,1000,500,2,00053,India
254233,2023-11-05,407,bedsheet,500,1000,500,2,00203,India
254233,2023-11-05,419,paint,2000,4000,2000,2,00203,India
254233,2023-11-05,414,chair,1000,2000,1000,2,00203,India
254233,2023-11-05,416,door,5000,10000,5000,2,00203,India
336206,2023-11-05,402,lamp,500,750,250,2,00039,India
336206,2023-11-05,406,pillow,200,400,200,2,00039,India
336206,2023-11-05,410,curtain,1000,2000,1000,2,00039,India
336206,2023-11-05,416,door,5000,10000,5000,2,00039,India
336206,2023-11-05,408,cupboard,5000,15000,10000,2,00039,India
995412,2023-11-05,403,tube light,450,600,150,2,00021,India
995412,2023-11-05,406,pillow,200,400,200,2,00021,India
995412,2023-11-05,411,side table,1500,3000,1500,2,00021,India
995412,2023-11-05,401,couch,15000,25000,10000,2,00021,India
995412,2023-11-05,404,queen bed,29000,45000,16000,2,00021,India
907397,2023-11-06,404,queen bed,29000,45000,16000,2,00136,India
705806,2023-11-06,412,area rug,3000,6000,3000,2,00443,India
272075,2023-11-07,417,door knob,200,400,200,2,00001,India
272075,2023-11-07,406,pillow,200,400,200,2,00001,India
272075,2023-11-07,412,area rug,3000,6000,3000,2,00001,India
272075,2023-11-07,403,tube light,450,600,150,2,00001,India
337016,2023-11-07,411,side table,1500,3000,1500,2,00150,India
337016,2023-11-07,405,carpet,2000,4000,2000,2,00150,India
337016,2023-11-07,416,door,5000,10000,5000,2,00150,India
603156,2023-11-07,412,area rug,3000,6000,3000,2,00054,India
603156,2023-11-07,413,dining table,20000,40000,20000,2,00054,India
958251,2023-11-07,408,cupboard,5000,15000,10000,2,00401,India
265998,2023-11-08,403,tube light,450,600,150,2,00360,India
622765,2023-11-08,413,dining table,20000,40000,20000,2,00040,India
622765,2023-11-08,419,paint,2000,4000,2000,2,00040,India
622765,2023-11-08,406,pillow,200,400,200,2,00040,India
622765,2023-11-08,417,door knob,200,400,200,2,00040,India
622765,2023-11-08,408,cupboard,5000,15000,10000,2,00040,India
400541,2023-11-08,410,curtain,1000,2000,1000,2,00210,India
318076,2023-11-08,411,side table,1500,3000,1500,2,00038,India
273117,2023-11-08,401,couch,15000,25000,10000,2,00237,India
273117,2023-11-08,402,lamp,500,750,250,2,00237,India
273117,2023-11-08,416,door,5000,10000,5000,2,00237,India
273117,2023-11-08,410,curtain,1000,2000,1000,2,00237,India
409243,2023-11-09,415,yard chair,1500,3000,1500,2,00010,India
184637,2023-11-11,402,lamp,500,750,250,2,00043,India
184637,2023-11-11,403,tube light,450,600,150,2,00043,India
184637,2023-11-11,415,yard chair,1500,3000,1500,2,00043,India
286790,2023-11-11,404,queen bed,29000,45000,16000,2,00110,India
286790,2023-11-11,409,shelf,500,1000,500,2,00110,India
449215,2023-11-11,401,couch,15000,25000,10000,2,00174,India
296446,2023-11-12,410,curtain,1000,2000,1000,2,00272,India
104511,2023-11-12,407,bedsheet,500,1000,500,2,00423,India
104511,2023-11-12,417,door knob,200,400,200,2,00423,India
104511,2023-11-12,403,tube light,450,600,150,2,00423,India
488438,2023-11-12,408,cupboard,5000,15000,10000,2,00382,India
488438,2023-11-12,405,carpet,2000,4000,2000,2,00382,India
829320,2023-11-12,406,pillow,200,400,200,2,00342,India
916983,2023-11-12,410,curtain,1000,2000,1000,2,00466,India
916983,2023-11-12,418,tiles,50,100,50,2,00466,India
916983,2023-11-12,406,pillow,200,400,200,2,00466,India
916983,2023-11-12,409,shelf,500,1000,500,2,00466,India
916983,2023-11-12,402,lamp,500,750,250,2,00466,India
134982,2023-11-14,417,door knob,200,400,200,2,00232,India
134982,2023-11-14,408,cupboard,5000,15000,10000,2,00232,India
134982,2023-11-14,401,couch,15000,25000,10000,2,00232,India
134982,2023-11-14,407,bedsheet,500,1000,500,2,00232,India
457910,2023-11-14,406,pillow,200,400,200,2,00050,India
457910,2023-11-14,412,area rug,3000,6000,3000,2,00050,India
457910,2023-11-14,404,queen bed,29000,45000,16000,2,00050,India
457910,2023-11-14,410,curtain,1000,2000,1000,2,00050,India
494307,2023-11-15,417,door knob,200,400,200,2,00096,India
494307,2023-11-15,403,tube light,450,600,150,2,00096,India
716823,2023-11-15,417,door knob,200,400,200,2,00462,India
716823,2023-11-15,401,couch,15000,25000,10000,2,00462,India
716823,2023-11-15,414,chair,1000,2000,1000,2,00462,India
716823,2023-11-15,407,bedsheet,500,1000,500,2,00462,India
716823,2023-11-15,418,tiles,50,100,50,2,00462,India
132441,2023-11-16,419,paint,2000,4000,2000,2,00489,India
650997,2023-11-16,416,door,5000,10000,5000,2,00006,India
650997,2023-11-16,401,couch,15000,25000,10000,2,00006,India
650997,2023-11-16,402,lamp,500,750,250,2,00006,India
650997,2023-11-16,405,carpet,2000,4000,2000,2,00006,India
650997,2023-11-16,414,chair,1000,2000,1000,2,00006,India
548064,2023-11-16,409,shelf,500,1000,500,2,00496,India
321158,2023-11-16,413,dining table,20000,40000,20000,2,00224,India
321158,2023-11-16,410,curtain,1000,2000,1000,2,00224,India
938126,2023-11-17,410,curtain,1000,2000,1000,2,00001,India
938126,2023-11-17,407,bedsheet,500,1000,500,2,00001,India
345339,2023-11-17,402,lamp,500,750,250,2,00032,India
345339,2023-11-17,407,bedsheet,500,1000,500,2,00032,India
165060,2023-11-18,407,bedsheet,500,1000,500,2,00321,India
876579,2023-11-18,403,tube light,450,600,150,2,00187,India
876579,2023-11-18,414,chair,1000,2000,1000,2,00187,India
405607,2023-11-19,413,dining table,20000,40000,20000,2,00229,India
405607,2023-11-19,417,door knob,200,400,200,2,00229,India
405607,2023-11-19,408,cupboard,5000,15000,10000,2,00229,India
125379,2023-11-19,402,lamp,500,750,250,2,00224,India
125379,2023-11-19,417,door knob,200,400,200,2,00224,India
985508,2023-11-19,414,chair,1000,2000,1000,2,00193,India
985508,2023-11-19,405,carpet,2000,4000,2000,2,00193,India
985508,2023-11-19,409,shelf,500,1000,500,2,00193,India
985508,2023-11-19,401,couch,15000,25000,10000,2,00193,India
985508,2023-11-19,411,side table,1500,3000,1500,2,00193,India
312817,2023-11-19,414,chair,1000,2000,1000,2,00015,India
312817,2023-11-19,410,curtain,1000,2000,1000,2,00015,India
312817,2023-11-19,405,carpet,2000,4000,2000,2,00015,India
312817,2023-11-19,411,side table,1500,3000,1500,2,00015,India
898273,2023-11-19,408,cupboard,5000,15000,10000,2,00460,India
898273,2023-11-19,412,area rug,3000,6000,3000,2,00460,India
898273,2023-11-19,403,tube light,450,600,150,2,00460,India
898273,2023-11-19,402,lamp,500,750,250,2,00460,India
316716,2023-11-20,411,side table,1500,3000,1500,2,00333,India
316716,2023-11-20,408,cupboard,5000,15000,10000,2,00333,India
316716,2023-11-20,406,pillow,200,400,200,2,00333,India
450320,2023-11-20,406,pillow,200,400,200,2,00408,India
450320,2023-11-20,411,side table,1500,3000,1500,2,00408,India
450320,2023-11-20,415,yard chair,1500,3000,1500,2,00408,India
450320,2023-11-20,405,carpet,2000,4000,2000,2,00408,India
866028,2023-11-20,417,door knob,200,400,200,2,00460,India
866028,2023-11-20,418,tiles,50,100,50,2,00460,India
866028,2023-11-20,408,cupboard,5000,15000,10000,2,00460,India
815120,2023-11-20,417,door knob,200,400,200,2,00276,India
512977,2023-11-20,417,door knob,200,400,200,2,00146,India
512977,2023-11-20,414,chair,1000,2000,1000,2,00146,India
838169,2023-11-21,417,door knob,200,400,200,2,00121,India
838169,2023-11-21,418,tiles,50,100,50,2,00121,India
402583,2023-11-21,405,carpet,2000,4000,2000,2,00210,India
402583,2023-11-21,414,chair,1000,2000,1000,2,00210,India
402583,2023-11-21,407,bedsheet,500,1000,500,2,00210,India
402583,2023-11-21,413,dining table,20000,40000,20000,2,00210,India
402583,2023-11-21,402,lamp,500,750,250,2,00210,India
769075,2023-11-21,417,door knob,200,400,200,2,00110,India
769075,2023-11-21,404,queen bed,29000,45000,16000,2,00110,India
196704,2023-11-21,415,yard chair,1500,3000,1500,2,00090,India
724849,2023-11-24,410,curtain,1000,2000,1000,2,00412,India
724849,2023-11-24,416,door,5000,10000,5000,2,00412,India
724849,2023-11-24,406,pillow,200,400,200,2,00412,India
724849,2023-11-24,417,door knob,200,400,200,2,00412,India
566515,2023-11-24,404,queen bed,29000,45000,16000,2,00054,India
910497,2023-11-25,413,dining table,20000,40000,20000,2,00156,India
381099,2023-11-26,402,lamp,500,750,250,2,00296,India
381099,2023-11-26,419,paint,2000,4000,2000,2,00296,India
381099,2023-11-26,417,door knob,200,400,200,2,00296,India
177997,2023-11-26,419,paint,2000,4000,2000,2,00126,India
177997,2023-11-26,410,curtain,1000,2000,1000,2,00126,India
177997,2023-11-26,405,carpet,2000,4000,2000,2,00126,India
473903,2023-11-26,409,shelf,500,1000,500,2,00005,India
473903,2023-11-26,406,pillow,200,400,200,2,00005,India
473903,2023-11-26,411,side table,1500,3000,1500,2,00005,India
473903,2023-11-26,408,cupboard,5000,15000,10000,2,00005,India
473903,2023-11-26,416,door,5000,10000,5000,2,00005,India
921260,2023-11-26,412,area rug,3000,6000,3000,2,00240,India
921260,2023-11-26,419,paint,2000,4000,2000,2,00240,India
656559,2023-11-26,412,area rug,3000,6000,3000,2,00427,India
656559,2023-11-26,411,side table,1500,3000,1500,2,00427,India
656559,2023-11-26,401,couch,15000,25000,10000,2,00427,India
656559,2023-11-26,419,paint,2000,4000,2000,2,00427,India
332555,2023-11-28,418,tiles,50,100,50,2,00130,India
332555,2023-11-28,406,pillow,200,400,200,2,00130,India
619101,2023-11-29,406,pillow,200,400,200,2,00388,India
619101,2023-11-29,401,couch,15000,25000,10000,2,00388,India
619101,2023-11-29,403,tube light,450,600,150,2,00388,India
196774,2023-11-29,407,bedsheet,500,1000,500,2,00115,India
196774,2023-11-29,406,pillow,200,400,200,2,00115,India
196774,2023-11-29,408,cupboard,5000,15000,10000,2,00115,India
196774,2023-11-29,403,tube light,450,600,150,2,00115,India
427497,2023-11-29,418,tiles,50,100,50,2,00182,India
427497,2023-11-29,401,couch,15000,25000,10000,2,00182,India
427497,2023-11-29,409,shelf,500,1000,500,2,00182,India
566070,2023-11-29,401,couch,15000,25000,10000,2,00468,India
566070,2023-11-29,408,cupboard,5000,15000,10000,2,00468,India
332502,2023-11-29,417,door knob,200,400,200,2,00335,India
332502,2023-11-29,415,yard chair,1500,3000,1500,2,00335,India
755727,2023-11-30,408,cupboard,5000,15000,10000,2,00067,India
755727,2023-11-30,410,curtain,1000,2000,1000,2,00067,India
755727,2023-11-30,418,tiles,50,100,50,2,00067,India
206141,2023-11-30,418,tiles,50,100,50,2,00123,India
206141,2023-11-30,417,door knob,200,400,200,2,00123,India
206141,2023-11-30,410,curtain,1000,2000,1000,2,00123,India
206141,2023-11-30,413,dining table,20000,40000,20000,2,00123,India
913491,2023-11-30,404,queen bed,29000,45000,16000,2,00453,India
913491,2023-11-30,407,bedsheet,500,1000,500,2,00453,India
799230,2023-11-30,414,chair,1000,2000,1000,2,00234,India
799230,2023-11-30,419,paint,2000,4000,2000,2,00234,India
611361,2023-11-30,418,tiles,50,100,50,2,00500,India
611361,2023-11-30,407,bedsheet,500,1000,500,2,00500,India
611361,2023-11-30,413,dining table,20000,40000,20000,2,00500,India
108787,2023-12-01,406,pillow,200,400,200,2,00025,India
108787,2023-12-01,414,chair,1000,2000,1000,2,00025,India
108787,2023-12-01,402,lamp,500,750,250,2,00025,India
108787,2023-12-01,419,paint,2000,4000,2000,2,00025,India
108787,2023-12-01,418,tiles,50,100,50,2,00025,India
345647,2023-12-03,410,curtain,1000,2000,1000,2,00121,India
306848,2023-12-03,413,dining table,20000,40000,20000,2,00252,India
306848,2023-12-03,418,tiles,50,100,50,2,00252,India
306848,2023-12-03,409,shelf,500,1000,500,2,00252,India
863267,2023-12-03,410,curtain,1000,2000,1000,2,00274,India
863267,2023-12-03,413,dining table,20000,40000,20000,2,00274,India
863267,2023-12-03,414,chair,1000,2000,1000,2,00274,India
863267,2023-12-03,419,paint,2000,4000,2000,2,00274,India
416960,2023-12-03,402,lamp,500,750,250,2,00168,India
416960,2023-12-03,412,area rug,3000,6000,3000,2,00168,India
416960,2023-12-03,403,tube light,450,600,150,2,00168,India
416960,2023-12-03,411,side table,1500,3000,1500,2,00168,India
871216,2023-12-04,413,dining table,20000,40000,20000,2,00087,India
871216,2023-12-04,403,tube light,450,600,150,2,00087,India
559620,2023-12-05,412,area rug,3000,6000,3000,2,00069,India
559620,2023-12-05,417,door knob,200,400,200,2,00069,India
559620,2023-12-05,418,tiles,50,100,50,2,00069,India
760385,2023-12-05,418,tiles,50,100,50,2,00481,India
185921,2023-12-06,406,pillow,200,400,200,2,00225,India
185921,2023-12-06,417,door knob,200,400,200,2,00225,India
185921,2023-12-06,413,dining table,20000,40000,20000,2,00225,India
606050,2023-12-06,405,carpet,2000,4000,2000,2,00284,India
606050,2023-12-06,409,shelf,500,1000,500,2,00284,India
529553,2023-12-06,417,door knob,200,400,200,2,00342,India
529553,2023-12-06,415,yard chair,1500,3000,1500,2,00342,India
529553,2023-12-06,414,chair,1000,2000,1000,2,00342,India
179836,2023-12-06,416,door,5000,10000,5000,2,00418,India
179836,2023-12-06,401,couch,15000,25000,10000,2,00418,India
179836,2023-12-06,417,door knob,200,400,200,2,00418,India
528956,2023-12-08,406,pillow,200,400,200,2,00044,India
528956,2023-12-08,418,tiles,50,100,50,2,00044,India
528956,2023-12-08,417,door knob,200,400,200,2,00044,India
140644,2023-12-08,417,door knob,200,400,200,2,00228,India
272143,2023-12-09,413,dining table,20000,40000,20000,2,00309,India
233493,2023-12-09,413,dining table,20000,40000,20000,2,00457,India
308087,2023-12-10,419,paint,2000,4000,2000,2,00330,India
308087,2023-12-10,407,bedsheet,500,1000,500,2,00330,India
323145,2023-12-10,407,bedsheet,500,1000,500,2,00151,India
554045,2023-12-10,407,bedsheet,500,1000,500,2,00466,India
554045,2023-12-10,411,side table,1500,3000,1500,2,00466,India
554045,2023-12-10,413,dining table,20000,40000,20000,2,00466,India
554045,2023-12-10,416,door,5000,10000,5000,2,00466,India
544159,2023-12-10,406,pillow,200,400,200,2,00411,India
544159,2023-12-10,418,tiles,50,100,50,2,00411,India
544159,2023-12-10,403,tube light,450,600,150,2,00411,India
544159,2023-12-10,408,cupboard,5000,15000,10000,2,00411,India
890098,2023-12-10,413,dining table,20000,40000,20000,2,00235,India
890098,2023-12-10,409,shelf,500,1000,500,2,00235,India
890098,2023-12-10,406,pillow,200,400,200,2,00235,India
794498,2023-12-11,417,door knob,200,400,200,2,00139,India
794498,2023-12-11,401,couch,15000,25000,10000,2,00139,India
794498,2023-12-11,408,cupboard,5000,15000,10000,2,00139,India
794498,2023-12-11,402,lamp,500,750,250,2,00139,India
724697,2023-12-11,412,area rug,3000,6000,3000,2,00281,India
901969,2023-12-12,412,area rug,3000,6000,3000,2,00224,India
901969,2023-12-12,409,shelf,500,1000,500,2,00224,India
901969,2023-12-12,405,carpet,2000,4000,2000,2,00224,India
946996,2023-12-12,405,carpet,2000,4000,2000,2,00367,India
272908,2023-12-13,405,carpet,2000,4000,2000,2,00303,India
272908,2023-12-13,402,lamp,500,750,250,2,00303,India
272908,2023-12-13,403,tube light,450,600,150,2,00303,India
272908,2023-12-13,404,queen bed,29000,45000,16000,2,00303,India
272908,2023-12-13,410,curtain,1000,2000,1000,2,00303,India
637400,2023-12-13,419,paint,2000,4000,2000,2,00252,India
637400,2023-12-13,406,pillow,200,400,200,2,00252,India
717610,2023-12-14,405,carpet,2000,4000,2000,2,00164,India
466647,2023-12-14,415,yard chair,1500,3000,1500,2,00057,India
466647,2023-12-14,404,queen bed,29000,45000,16000,2,00057,India
466647,2023-12-14,411,side table,1500,3000,1500,2,00057,India
511565,2023-12-14,412,area rug,3000,6000,3000,2,00036,India
511565,2023-12-14,403,tube light,450,600,150,2,00036,India
511565,2023-12-14,414,chair,1000,2000,1000,2,00036,India
511565,2023-12-14,409,shelf,500,1000,500,2,00036,India
992302,2023-12-15,410,curtain,1000,2000,1000,2,00059,India
992302,2023-12-15,416,door,5000,10000,5000,2,00059,India
992302,2023-12-15,411,side table,1500,3000,1500,2,00059,India
967602,2023-12-16,402,lamp,500,750,250,2,00393,India
967602,2023-12-16,413,dining table,20000,40000,20000,2,00393,India
234381,2023-12-16,404,queen bed,29000,45000,16000,2,00437,India
234381,2023-12-16,412,area rug,3000,6000,3000,2,00437,India
234381,2023-12-16,405,carpet,2000,4000,2000,2,00437,India
234381,2023-12-16,419,paint,2000,4000,2000,2,00437,India
234381,2023-12-16,417,door knob,200,400,200,2,00437,India
975012,2023-12-16,419,paint,2000,4000,2000,2,00098,India
975012,2023-12-16,407,bedsheet,500,1000,500,2,00098,India
127190,2023-12-17,413,dining table,20000,40000,20000,2,00014,India
127190,2023-12-17,402,lamp,500,750,250,2,00014,India
127190,2023-12-17,411,side table,1500,3000,1500,2,00014,India
624300,2023-12-17,417,door knob,200,400,200,2,00380,India
624300,2023-12-17,405,carpet,2000,4000,2000,2,00380,India
624300,2023-12-17,419,paint,2000,4000,2000,2,00380,India
624300,2023-12-17,407,bedsheet,500,1000,500,2,00380,India
820658,2023-12-17,410,curtain,1000,2000,1000,2,00379,India
496259,2023-12-18,418,tiles,50,100,50,2,00182,India
496259,2023-12-18,405,carpet,2000,4000,2000,2,00182,India
496259,2023-12-18,416,door,5000,10000,5000,2,00182,India
702373,2023-12-18,406,pillow,200,400,200,2,00421,India
702373,2023-12-18,404,queen bed,29000,45000,16000,2,00421,India
702373,2023-12-18,412,area rug,3000,6000,3000,2,00421,India
702373,2023-12-18,419,paint,2000,4000,2000,2,00421,India
859967,2023-12-20,409,shelf,500,1000,500,2,00396,India
859967,2023-12-20,416,door,5000,10000,5000,2,00396,India
859967,2023-12-20,407,bedsheet,500,1000,500,2,00396,India
859967,2023-12-20,417,door knob,200,400,200,2,00396,India
859967,2023-12-20,419,paint,2000,4000,2000,2,00396,India
197813,2023-12-20,418,tiles,50,100,50,2,00392,India
197813,2023-12-20,405,carpet,2000,4000,2000,2,00392,India
197813,2023-12-20,409,shelf,500,1000,500,2,00392,India
197813,2023-12-20,419,paint,2000,4000,2000,2,00392,India
197813,2023-12-20,414,chair,1000,2000,1000,2,00392,India
592319,2023-12-20,405,carpet,2000,4000,2000,2,00006,India
592319,2023-12-20,416,door,5000,10000,5000,2,00006,India
817603,2023-12-21,411,side table,1500,3000,1500,2,00276,India
817603,2023-12-21,412,area rug,3000,6000,3000,2,00276,India
953599,2023-12-22,410,curtain,1000,2000,1000,2,00248,India
953599,2023-12-22,402,lamp,500,750,250,2,00248,India
953599,2023-12-22,407,bedsheet,500,1000,500,2,00248,India
692272,2023-12-22,411,side table,1500,3000,1500,2,00251,India
692272,2023-12-22,413,dining table,20000,40000,20000,2,00251,India
692272,2023-12-22,402,lamp,500,750,250,2,00251,India
478872,2023-12-22,418,tiles,50,100,50,2,00217,India
173788,2023-12-22,409,shelf,500,1000,500,2,00043,India
173788,2023-12-22,418,tiles,50,100,50,2,00043,India
173788,2023-12-22,413,dining table,20000,40000,20000,2,00043,India
173788,2023-12-22,417,door knob,200,400,200,2,00043,India
268971,2023-12-22,414,chair,1000,2000,1000,2,00018,India
268971,2023-12-22,401,couch,15000,25000,10000,2,00018,India
268971,2023-12-22,412,area rug,3000,6000,3000,2,00018,India
268971,2023-12-22,406,pillow,200,400,200,2,00018,India
764008,2023-12-23,403,tube light,450,600,150,2,00283,India
764008,2023-12-23,419,paint,2000,4000,2000,2,00283,India
764008,2023-12-23,402,lamp,500,750,250,2,00283,India
270656,2023-12-23,402,lamp,500,750,250,2,00015,India
270656,2023-12-23,418,tiles,50,100,50,2,00015,India
270656,2023-12-23,401,couch,15000,25000,10000,2,00015,India
403394,2023-12-23,415,yard chair,1500,3000,1500,2,00162,India
403394,2023-12-23,417,door knob,200,400,200,2,00162,India
403394,2023-12-23,408,cupboard,5000,15000,10000,2,00162,India
861117,2023-12-23,413,dining table,20000,40000,20000,2,00275,India
861117,2023-12-23,404,queen bed,29000,45000,16000,2,00275,India
861117,2023-12-23,405,carpet,2000,4000,2000,2,00275,India
861117,2023-12-23,417,door knob,200,400,200,2,00275,India
861117,2023-12-23,419,paint,2000,4000,2000,2,00275,India
280146,2023-12-24,402,lamp,500,750,250,2,00273,India
280146,2023-12-24,417,door knob,200,400,200,2,00273,India
130234,2023-12-24,419,paint,2000,4000,2000,2,00057,India
130234,2023-12-24,416,door,5000,10000,5000,2,00057,India
130234,2023-12-24,406,pillow,200,400,200,2,00057,India
130234,2023-12-24,407,bedsheet,500,1000,500,2,00057,India
518362,2023-12-24,409,shelf,500,1000,500,2,00459,India
518362,2023-12-24,416,door,5000,10000,5000,2,00459,India
518362,2023-12-24,412,area rug,3000,6000,3000,2,00459,India
518362,2023-12-24,407,bedsheet,500,1000,500,2,00459,India
518362,2023-12-24,418,tiles,50,100,50,2,00459,India
284040,2023-12-24,417,door knob,200,400,200,2,00362,India
284040,2023-12-24,401,couch,15000,25000,10000,2,00362,India
533408,2023-12-24,415,yard chair,1500,3000,1500,2,00363,India
533408,2023-12-24,410,curtain,1000,2000,1000,2,00363,India
533408,2023-12-24,406,pillow,200,400,200,2,00363,India
533408,2023-12-24,419,paint,2000,4000,2000,2,00363,India
533408,2023-12-24,418,tiles,50,100,50,2,00363,India
961254,2023-12-26,402,lamp,500,750,250,2,00231,India
905833,2023-12-26,404,queen bed,29000,45000,16000,2,00159,India
905833,2023-12-26,415,yard chair,1500,3000,1500,2,00159,India
905833,2023-12-26,406,pillow,200,400,200,2,00159,India
957196,2023-12-26,409,shelf,500,1000,500,2,00060,India
957196,2023-12-26,406,pillow,200,400,200,2,00060,India
957196,2023-12-26,408,cupboard,5000,15000,10000,2,00060,India
115801,2023-12-26,402,lamp,500,750,250,2,00097,India
115801,2023-12-26,401,couch,15000,25000,10000,2,00097,India
115801,2023-12-26,412,area rug,3000,6000,3000,2,00097,India
115801,2023-12-26,408,cupboard,5000,15000,10000,2,00097,India
818431,2023-12-27,406,pillow,200,400,200,2,00444,India
569267,2023-12-27,419,paint,2000,4000,2000,2,00264,India
569267,2023-12-27,414,chair,1000,2000,1000,2,00264,India
569267,2023-12-27,406,pillow,200,400,200,2,00264,India
569267,2023-12-27,412,area rug,3000,6000,3000,2,00264,India
569267,2023-12-27,401,couch,15000,25000,10000,2,00264,India
231296,2023-12-28,418,tiles,50,100,50,2,00022,India
231296,2023-12-28,412,area rug,3000,6000,3000,2,00022,India
231296,2023-12-28,417,door knob,200,400,200,2,00022,India
142890,2023-12-28,404,queen bed,29000,45000,16000,2,00025,India
142890,2023-12-28,419,paint,2000,4000,2000,2,00025,India
142890,2023-12-28,409,shelf,500,1000,500,2,00025,India
142890,2023-12-28,402,lamp,500,750,250,2,00025,India
990773,2023-12-28,405,carpet,2000,4000,2000,2,00362,India
990773,2023-12-28,402,lamp,500,750,250,2,00362,India
990773,2023-12-28,403,tube light,450,600,150,2,00362,India
990773,2023-12-28,417,door knob,200,400,200,2,00362,India
990773,2023-12-28,413,dining table,20000,40000,20000,2,00362,India
516038,2023-12-29,418,tiles,50,100,50,2,00327,India
516038,2023-12-29,409,shelf,500,1000,500,2,00327,India
397703,2023-12-30,414,chair,1000,2000,1000,2,00087,India
871541,2023-12-30,407,bedsheet,500,1000,500,2,00327,India
871541,2023-12-30,409,shelf,500,1000,500,2,00327,India
871541,2023-12-30,417,door knob,200,400,200,2,00327,India
871541,2023-12-30,414,chair,1000,2000,1000,2,00327,India
963390,2023-12-30,414,chair,1000,2000,1000,2,00077,India
963390,2023-12-30,412,area rug,3000,6000,3000,2,00077,India
963390,2023-12-30,416,door,5000,10000,5000,2,00077,India
924101,2023-12-31,416,door,5000,10000,5000,2,00140,India
924101,2023-12-31,404,queen bed,29000,45000,16000,2,00140,India
844125,2023-12-31,402,lamp,500,750,250,2,00456,India
844125,2023-12-31,404,queen bed,29000,45000,16000,2,00456,India
844125,2023-12-31,401,couch,15000,25000,10000,2,00456,India
844125,2023-12-31,418,tiles,50,100,50,2,00456,India
844125,2023-12-31,406,pillow,200,400,200,2,00456,India
870954,2023-12-31,401,couch,15000,25000,10000,2,00249,India
870954,2023-12-31,410,curtain,1000,2000,1000,2,00249,India
870954,2023-12-31,412,area rug,3000,6000,3000,2,00249,India
650003,2024-01-01,409,shelf,500,1000,500,2,00496,India
650003,2024-01-01,415,yard chair,1500,3000,1500,2,00496,India
650003,2024-01-01,411,side table,1500,3000,1500,2,00496,India
963788,2024-01-01,411,side table,1500,3000,1500,2,00004,India
963788,2024-01-01,409,shelf,500,1000,500,2,00004,India
819877,2024-01-01,404,queen bed,29000,45000,16000,2,00221,India
988788,2024-01-02,411,side table,1500,3000,1500,2,00135,India
988788,2024-01-02,407,bedsheet,500,1000,500,2,00135,India
549257,2024-01-02,404,queen bed,29000,45000,16000,2,00445,India
549257,2024-01-02,409,shelf,500,1000,500,2,00445,India
549257,2024-01-02,412,area rug,3000,6000,3000,2,00445,India
549257,2024-01-02,402,lamp,500,750,250,2,00445,India
549257,2024-01-02,416,door,5000,10000,5000,2,00445,India
977181,2024-01-02,415,yard chair,1500,3000,1500,2,00318,India
977181,2024-01-02,404,queen bed,29000,45000,16000,2,00318,India
977181,2024-01-02,406,pillow,200,400,200,2,00318,India
157768,2024-01-04,402,lamp,500,750,250,2,00190,India
157768,2024-01-04,418,tiles,50,100,50,2,00190,India
652543,2024-01-04,409,shelf,500,1000,500,2,00042,India
635502,2024-01-04,415,yard chair,1500,3000,1500,2,00354,India
635502,2024-01-04,417,door knob,200,400,200,2,00354,India
635502,2024-01-04,410,curtain,1000,2000,1000,2,00354,India
635502,2024-01-04,402,lamp,500,750,250,2,00354,India
373774,2024-01-04,402,lamp,500,750,250,2,00351,India
373774,2024-01-04,416,door,5000,10000,5000,2,00351,India
373774,2024-01-04,417,door knob,200,400,200,2,00351,India
373774,2024-01-04,412,area rug,3000,6000,3000,2,00351,India
537403,2024-01-04,407,bedsheet,500,1000,500,2,00285,India
537403,2024-01-04,417,door knob,200,400,200,2,00285,India
576368,2024-01-05,404,queen bed,29000,45000,16000,2,00082,India
148306,2024-01-05,410,curtain,1000,2000,1000,2,00378,India
148306,2024-01-05,407,bedsheet,500,1000,500,2,00378,India
148306,2024-01-05,402,lamp,500,750,250,2,00378,India
148306,2024-01-05,401,couch,15000,25000,10000,2,00378,India
148306,2024-01-05,409,shelf,500,1000,500,2,00378,India
137817,2024-01-05,413,dining table,20000,40000,20000,2,00390,India
137817,2024-01-05,418,tiles,50,100,50,2,00390,India
137817,2024-01-05,412,area rug,3000,6000,3000,2,00390,India
137817,2024-01-05,415,yard chair,1500,3000,1500,2,00390,India
137817,2024-01-05,403,tube light,450,600,150,2,00390,India
658315,2024-01-06,403,tube light,450,600,150,2,00046,India
658315,2024-01-06,411,side table,1500,3000,1500,2,00046,India
959861,2024-01-06,402,lamp,500,750,250,2,00223,India
959861,2024-01-06,409,shelf,500,1000,500,2,00223,India
959861,2024-01-06,415,yard chair,1500,3000,1500,2,00223,India
683920,2024-01-06,417,door knob,200,400,200,2,00078,India
683920,2024-01-06,401,couch,15000,25000,10000,2,00078,India
683920,2024-01-06,416,door,5000,10000,5000,2,00078,India
535677,2024-01-06,406,pillow,200,400,200,2,00183,India
535677,2024-01-06,414,chair,1000,2000,1000,2,00183,India
535677,2024-01-06,418,tiles,50,100,50,2,00183,India
535677,2024-01-06,401,couch,15000,25000,10000,2,00183,India
535677,2024-01-06,405,carpet,2000,4000,2000,2,00183,India
483213,2024-01-07,414,chair,1000,2000,1000,2,00499,India
483213,2024-01-07,407,bedsheet,500,1000,500,2,00499,India
594433,2024-01-08,412,area rug,3000,6000,3000,2,00115,India
594433,2024-01-08,409,shelf,500,1000,500,2,00115,India
594433,2024-01-08,403,tube light,450,600,150,2,00115,India
355842,2024-01-08,405,carpet,2000,4000,2000,2,00397,India
355842,2024-01-08,402,lamp,500,750,250,2,00397,India
476629,2024-01-08,405,carpet,2000,4000,2000,2,00367,India
476629,2024-01-08,412,area rug,3000,6000,3000,2,00367,India
524627,2024-01-08,405,carpet,2000,4000,2000,2,00253,India
524627,2024-01-08,401,couch,15000,25000,10000,2,00253,India
524627,2024-01-08,412,area rug,3000,6000,3000,2,00253,India
524627,2024-01-08,415,yard chair,1500,3000,1500,2,00253,India
524627,2024-01-08,411,side table,1500,3000,1500,2,00253,India
182765,2024-01-10,418,tiles,50,100,50,2,00060,India
182765,2024-01-10,415,yard chair,1500,3000,1500,2,00060,India
881821,2024-01-10,407,bedsheet,500,1000,500,2,00408,India
881821,2024-01-10,410,curtain,1000,2000,1000,2,00408,India
881821,2024-01-10,416,door,5000,10000,5000,2,00408,India
523121,2024-01-10,411,side table,1500,3000,1500,2,00441,India
523121,2024-01-10,415,yard chair,1500,3000,1500,2,00441,India
342372,2024-01-10,403,tube light,450,600,150,2,00405,India
342372,2024-01-10,404,queen bed,29000,45000,16000,2,00405,India
342372,2024-01-10,408,cupboard,5000,15000,10000,2,00405,India
313722,2024-01-13,404,queen bed,29000,45000,16000,2,00201,India
313722,2024-01-13,405,carpet,2000,4000,2000,2,00201,India
313722,2024-01-13,403,tube light,450,600,150,2,00201,India
313722,2024-01-13,418,tiles,50,100,50,2,00201,India
313722,2024-01-13,415,yard chair,1500,3000,1500,2,00201,India
132249,2024-01-13,411,side table,1500,3000,1500,2,00404,India
132249,2024-01-13,410,curtain,1000,2000,1000,2,00404,India
881210,2024-01-13,416,door,5000,10000,5000,2,00124,India
881210,2024-01-13,411,side table,1500,3000,1500,2,00124,India
881210,2024-01-13,414,chair,1000,2000,1000,2,00124,India
881210,2024-01-13,412,area rug,3000,6000,3000,2,00124,India
393275,2024-01-14,407,bedsheet,500,1000,500,2,00012,India
393275,2024-01-14,406,pillow,200,400,200,2,00012,India
393275,2024-01-14,416,door,5000,10000,5000,2,00012,India
393275,2024-01-14,409,shelf,500,1000,500,2,00012,India
629034,2024-01-14,408,cupboard,5000,15000,10000,2,00124,India
629034,2024-01-14,414,chair,1000,2000,1000,2,00124,India
629034,2024-01-14,412,area rug,3000,6000,3000,2,00124,India
713083,2024-01-14,410,curtain,1000,2000,1000,2,00008,India
713083,2024-01-14,415,yard chair,1500,3000,1500,2,00008,India
713083,2024-01-14,413,dining table,20000,40000,20000,2,00008,India
713083,2024-01-14,414,chair,1000,2000,1000,2,00008,India
196901,2024-01-15,417,door knob,200,400,200,2,00323,India
196901,2024-01-15,407,bedsheet,500,1000,500,2,00323,India
196901,2024-01-15,412,area rug,3000,6000,3000,2,00323,India
372949,2024-01-15,414,chair,1000,2000,1000,2,00479,India
372949,2024-01-15,410,curtain,1000,2000,1000,2,00479,India
372949,2024-01-15,406,pillow,200,400,200,2,00479,India
372949,2024-01-15,413,dining table,20000,40000,20000,2,00479,India
623180,2024-01-16,411,side table,1500,3000,1500,2,00155,India
623180,2024-01-16,406,pillow,200,400,200,2,00155,India
623180,2024-01-16,403,tube light,450,600,150,2,00155,India
623180,2024-01-16,416,door,5000,10000,5000,2,00155,India
306865,2024-01-16,403,tube light,450,600,150,2,00156,India
958736,2024-01-16,406,pillow,200,400,200,2,00436,India
958736,2024-01-16,414,chair,1000,2000,1000,2,00436,India
140226,2024-01-16,407,bedsheet,500,1000,500,2,00443,India
140226,2024-01-16,409,shelf,500,1000,500,2,00443,India
140226,2024-01-16,419,paint,2000,4000,2000,2,00443,India
140226,2024-01-16,415,yard chair,1500,3000,1500,2,00443,India
140226,2024-01-16,408,cupboard,5000,15000,10000,2,00443,India
238588,2024-01-18,402,lamp,500,750,250,2,00050,India
238588,2024-01-18,408,cupboard,5000,15000,10000,2,00050,India
238588,2024-01-18,406,pillow,200,400,200,2,00050,India
582321,2024-01-18,411,side table,1500,3000,1500,2,00171,India
582321,2024-01-18,417,door knob,200,400,200,2,00171,India
582321,2024-01-18,412,area rug,3000,6000,3000,2,00171,India
429028,2024-01-18,412,area rug,3000,6000,3000,2,00196,India
429028,2024-01-18,414,chair,1000,2000,1000,2,00196,India
429028,2024-01-18,416,door,5000,10000,5000,2,00196,India
429028,2024-01-18,409,shelf,500,1000,500,2,00196,India
627316,2024-01-18,405,carpet,2000,4000,2000,2,00497,India
627316,2024-01-18,415,yard chair,1500,3000,1500,2,00497,India
171774,2024-01-18,407,bedsheet,500,1000,500,2,00478,India
956483,2024-01-19,408,cupboard,5000,15000,10000,2,00452,India
956483,2024-01-19,414,chair,1000,2000,1000,2,00452,India
107260,2024-01-19,415,yard chair,1500,3000,1500,2,00480,India
107260,2024-01-19,403,tube light,450,600,150,2,00480,India
107260,2024-01-19,419,paint,2000,4000,2000,2,00480,India
107260,2024-01-19,412,area rug,3000,6000,3000,2,00480,India
107260,2024-01-19,407,bedsheet,500,1000,500,2,00480,India
186756,2024-01-19,410,curtain,1000,2000,1000,2,00026,India
186756,2024-01-19,407,bedsheet,500,1000,500,2,00026,India
186756,2024-01-19,418,tiles,50,100,50,2,00026,India
186756,2024-01-19,408,cupboard,5000,15000,10000,2,00026,India
186756,2024-01-19,413,dining table,20000,40000,20000,2,00026,India
184242,2024-01-19,418,tiles,50,100,50,2,00443,India
184242,2024-01-19,412,area rug,3000,6000,3000,2,00443,India
252352,2024-01-19,401,couch,15000,25000,10000,2,00217,India
252352,2024-01-19,411,side table,1500,3000,1500,2,00217,India
252352,2024-01-19,405,carpet,2000,4000,2000,2,00217,India
252352,2024-01-19,404,queen bed,29000,45000,16000,2,00217,India
252352,2024-01-19,409,shelf,500,1000,500,2,00217,India
756038,2024-01-20,413,dining table,20000,40000,20000,2,00308,India
756038,2024-01-20,418,tiles,50,100,50,2,00308,India
756038,2024-01-20,408,cupboard,5000,15000,10000,2,00308,India
756038,2024-01-20,411,side table,1500,3000,1500,2,00308,India
756038,2024-01-20,404,queen bed,29000,45000,16000,2,00308,India
494935,2024-01-22,403,tube light,450,600,150,2,00412,India
494935,2024-01-22,411,side table,1500,3000,1500,2,00412,India
494935,2024-01-22,405,carpet,2000,4000,2000,2,00412,India
494935,2024-01-22,415,yard chair,1500,3000,1500,2,00412,India
188974,2024-01-22,415,yard chair,1500,3000,1500,2,00043,India
188974,2024-01-22,417,door knob,200,400,200,2,00043,India
188974,2024-01-22,418,tiles,50,100,50,2,00043,India
188974,2024-01-22,403,tube light,450,600,150,2,00043,India
670750,2024-01-22,416,door,5000,10000,5000,2,00200,India
670750,2024-01-22,407,bedsheet,500,1000,500,2,00200,India
670750,2024-01-22,402,lamp,500,750,250,2,00200,India
670750,2024-01-22,411,side table,1500,3000,1500,2,00200,India
946352,2024-01-22,403,tube light,450,600,150,2,00310,India
946352,2024-01-22,407,bedsheet,500,1000,500,2,00310,India
946352,2024-01-22,402,lamp,500,750,250,2,00310,India
946352,2024-01-22,405,carpet,2000,4000,2000,2,00310,India
946352,2024-01-22,414,chair,1000,2000,1000,2,00310,India
996334,2024-01-23,401,couch,15000,25000,10000,2,00360,India
996334,2024-01-23,402,lamp,500,750,250,2,00360,India
495502,2024-01-25,405,carpet,2000,4000,2000,2,00271,India
495502,2024-01-25,407,bedsheet,500,1000,500,2,00271,India
495502,2024-01-25,403,tube light,450,600,150,2,00271,India
495502,2024-01-25,410,curtain,1000,2000,1000,2,00271,India
563566,2024-01-25,416,door,5000,10000,5000,2,00242,India
563566,2024-01-25,405,carpet,2000,4000,2000,2,00242,India
606768,2024-01-26,416,door,5000,10000,5000,2,00490,India
606768,2024-01-26,408,cupboard,5000,15000,10000,2,00490,India
172115,2024-01-26,415,yard chair,1500,3000,1500,2,00237,India
668730,2024-01-26,411,side table,1500,3000,1500,2,00194,India
482734,2024-01-26,411,side table,1500,3000,1500,2,00470,India
482734,2024-01-26,416,door,5000,10000,5000,2,00470,India
923473,2024-01-26,417,door knob,200,400,200,2,00176,India
923473,2024-01-26,402,lamp,500,750,250,2,00176,India
923473,2024-01-26,415,yard chair,1500,3000,1500,2,00176,India
551127,2024-01-27,414,chair,1000,2000,1000,2,00277,India
551127,2024-01-27,405,carpet,2000,4000,2000,2,00277,India
551127,2024-01-27,413,dining table,20000,40000,20000,2,00277,India
534830,2024-01-27,414,chair,1000,2000,1000,2,00383,India
803321,2024-01-27,402,lamp,500,750,250,2,00404,India
803321,2024-01-27,411,side table,1500,3000,1500,2,00404,India
803321,2024-01-27,417,door knob,200,400,200,2,00404,India
803321,2024-01-27,413,dining table,20000,40000,20000,2,00404,India
200965,2024-01-27,411,side table,1500,3000,1500,2,00245,India
200965,2024-01-27,404,queen bed,29000,45000,16000,2,00245,India
200965,2024-01-27,415,yard chair,1500,3000,1500,2,00245,India
200965,2024-01-27,410,curtain,1000,2000,1000,2,00245,India
200965,2024-01-27,405,carpet,2000,4000,2000,2,00245,India
955255,2024-01-28,412,area rug,3000,6000,3000,2,00228,India
955255,2024-01-28,403,tube light,450,600,150,2,00228,India
955255,2024-01-28,408,cupboard,5000,15000,10000,2,00228,India
955255,2024-01-28,411,side table,1500,3000,1500,2,00228,India
955255,2024-01-28,405,carpet,2000,4000,2000,2,00228,India
228460,2024-01-28,409,shelf,500,1000,500,2,00054,India
209688,2024-01-28,405,carpet,2000,4000,2000,2,00107,India
209688,2024-01-28,407,bedsheet,500,1000,500,2,00107,India
344363,2024-01-28,405,carpet,2000,4000,2000,2,00200,India
344363,2024-01-28,401,couch,15000,25000,10000,2,00200,India
344363,2024-01-28,412,area rug,3000,6000,3000,2,00200,India
195570,2024-01-29,412,area rug,3000,6000,3000,2,00146,India
195570,2024-01-29,401,couch,15000,25000,10000,2,00146,India
195570,2024-01-29,415,yard chair,1500,3000,1500,2,00146,India
195570,2024-01-29,418,tiles,50,100,50,2,00146,India
374672,2024-01-29,401,couch,15000,25000,10000,2,00499,India
374672,2024-01-29,405,carpet,2000,4000,2000,2,00499,India
374672,2024-01-29,419,paint,2000,4000,2000,2,00499,India
374672,2024-01-29,417,door knob,200,400,200,2,00499,India
507093,2024-01-30,406,pillow,200,400,200,2,00049,India
507093,2024-01-30,419,paint,2000,4000,2000,2,00049,India
507093,2024-01-30,411,side table,1500,3000,1500,2,00049,India
335161,2024-01-30,403,tube light,450,600,150,2,00298,India
335161,2024-01-30,411,side table,1500,3000,1500,2,00298,India
335161,2024-01-30,407,bedsheet,500,1000,500,2,00298,India
335161,2024-01-30,409,shelf,500,1000,500,2,00298,India
171693,2024-01-31,413,dining table,20000,40000,20000,2,00440,India
171693,2024-01-31,417,door knob,200,400,200,2,00440,India
171693,2024-01-31,407,bedsheet,500,1000,500,2,00440,India
121398,2024-01-31,405,carpet,2000,4000,2000,2,00161,India
121398,2024-01-31,414,chair,1000,2000,1000,2,00161,India
803993,2024-02-01,416,door,5000,10000,5000,1,00451,India
803993,2024-02-01,410,curtain,1000,2000,1000,1,00451,India
803993,2024-02-01,402,lamp,500,750,250,1,00451,India
803993,2024-02-01,414,chair,1000,2000,1000,1,00451,India
803993,2024-02-01,404,queen bed,29000,45000,16000,1,00451,India
545074,2024-02-01,412,area rug,3000,6000,3000,1,00226,India
545074,2024-02-01,410,curtain,1000,2000,1000,1,00226,India
545074,2024-02-01,408,cupboard,5000,15000,10000,1,00226,India
163842,2024-02-01,418,tiles,50,100,50,1,00409,India
163842,2024-02-01,409,shelf,500,1000,500,1,00409,India
163842,2024-02-01,417,door knob,200,400,200,1,00409,India
163842,2024-02-01,419,paint,2000,4000,2000,1,00409,India
335534,2024-02-02,401,couch,15000,25000,10000,1,00446,India
335534,2024-02-02,417,door knob,200,400,200,1,00446,India
335534,2024-02-02,419,paint,2000,4000,2000,1,00446,India
335534,2024-02-02,416,door,5000,10000,5000,1,00446,India
170460,2024-02-02,404,queen bed,29000,45000,16000,1,00430,India
170460,2024-02-02,408,cupboard,5000,15000,10000,1,00430,India
170460,2024-02-02,414,chair,1000,2000,1000,1,00430,India
170460,2024-02-02,419,paint,2000,4000,2000,1,00430,India
170460,2024-02-02,418,tiles,50,100,50,1,00430,India
398779,2024-02-02,407,bedsheet,500,1000,500,1,00361,India
398779,2024-02-02,418,tiles,50,100,50,1,00361,India
980148,2024-02-03,416,door,5000,10000,5000,1,00018,India
980148,2024-02-03,409,shelf,500,1000,500,1,00018,India
980148,2024-02-03,402,lamp,500,750,250,1,00018,India
917917,2024-02-03,410,curtain,1000,2000,1000,1,00330,India
917917,2024-02-03,408,cupboard,5000,15000,10000,1,00330,India
917917,2024-02-03,404,queen bed,29000,45000,16000,1,00330,India
917917,2024-02-03,405,carpet,2000,4000,2000,1,00330,India
917917,2024-02-03,415,yard chair,1500,3000,1500,1,00330,India
167206,2024-02-03,401,couch,15000,25000,10000,1,00458,India
202148,2024-02-03,410,curtain,1000,2000,1000,1,00061,India
202148,2024-02-03,416,door,5000,10000,5000,1,00061,India
202148,2024-02-03,406,pillow,200,400,200,1,00061,India
202148,2024-02-03,413,dining table,20000,40000,20000,1,00061,India
202148,2024-02-03,401,couch,15000,25000,10000,1,00061,India
626545,2024-02-04,407,bedsheet,500,1000,500,1,00218,India
626545,2024-02-04,406,pillow,200,400,200,1,00218,India
626545,2024-02-04,414,chair,1000,2000,1000,1,00218,India
626545,2024-02-04,415,yard chair,1500,3000,1500,1,00218,India
626545,2024-02-04,413,dining table,20000,40000,20000,1,00218,India
704119,2024-02-04,417,door knob,200,400,200,1,00200,India
704119,2024-02-04,402,lamp,500,750,250,1,00200,India
704119,2024-02-04,405,carpet,2000,4000,2000,1,00200,India
704119,2024-02-04,418,tiles,50,100,50,1,00200,India
704119,2024-02-04,411,side table,1500,3000,1500,1,00200,India
415921,2024-02-04,412,area rug,3000,6000,3000,1,00383,India
596278,2024-02-05,417,door knob,200,400,200,1,00195,India
596278,2024-02-05,418,tiles,50,100,50,1,00195,India
957800,2024-02-05,404,queen bed,29000,45000,16000,1,00207,India
957800,2024-02-05,401,couch,15000,25000,10000,1,00207,India
957800,2024-02-05,409,shelf,500,1000,500,1,00207,India
289175,2024-02-05,411,side table,1500,3000,1500,1,00178,India
289175,2024-02-05,404,queen bed,29000,45000,16000,1,00178,India
289175,2024-02-05,410,curtain,1000,2000,1000,1,00178,India
289175,2024-02-05,415,yard chair,1500,3000,1500,1,00178,India
174052,2024-02-06,418,tiles,50,100,50,1,00437,India
543256,2024-02-06,402,lamp,500,750,250,1,00112,India
543256,2024-02-06,419,paint,2000,4000,2000,1,00112,India
543256,2024-02-06,404,queen bed,29000,45000,16000,1,00112,India
240947,2024-02-06,416,door,5000,10000,5000,1,00066,India
240947,2024-02-06,403,tube light,450,600,150,1,00066,India
240947,2024-02-06,401,couch,15000,25000,10000,1,00066,India
945071,2024-02-06,415,yard chair,1500,3000,1500,1,00020,India
945071,2024-02-06,416,door,5000,10000,5000,1,00020,India
945071,2024-02-06,406,pillow,200,400,200,1,00020,India
372038,2024-02-06,405,carpet,2000,4000,2000,1,00314,India
372038,2024-02-06,409,shelf,500,1000,500,1,00314,India
551511,2024-02-07,412,area rug,3000,6000,3000,1,00246,India
551511,2024-02-07,407,bedsheet,500,1000,500,1,00246,India
551511,2024-02-07,414,chair,1000,2000,1000,1,00246,India
551511,2024-02-07,406,pillow,200,400,200,1,00246,India
395366,2024-02-08,413,dining table,20000,40000,20000,1,00281,India
395366,2024-02-08,403,tube light,450,600,150,1,00281,India
373884,2024-02-08,409,shelf,500,1000,500,1,00373,India
892465,2024-02-08,419,paint,2000,4000,2000,1,00337,India
892465,2024-02-08,417,door knob,200,400,200,1,00337,India
892465,2024-02-08,407,bedsheet,500,1000,500,1,00337,India
892465,2024-02-08,411,side table,1500,3000,1500,1,00337,India
892465,2024-02-08,404,queen bed,29000,45000,16000,1,00337,India
277191,2024-02-08,416,door,5000,10000,5000,1,00385,India
277191,2024-02-08,414,chair,1000,2000,1000,1,00385,India
511020,2024-02-08,419,paint,2000,4000,2000,1,00146,India
511020,2024-02-08,413,dining table,20000,40000,20000,1,00146,India
511020,2024-02-08,416,door,5000,10000,5000,1,00146,India
511020,2024-02-08,406,pillow,200,400,200,1,00146,India
487419,2024-02-09,413,dining table,20000,40000,20000,1,00031,India
487419,2024-02-09,412,area rug,3000,6000,3000,1,00031,India
487419,2024-02-09,409,shelf,500,1000,500,1,00031,India
946364,2024-02-09,403,tube light,450,600,150,1,00085,India
946364,2024-02-09,406,pillow,200,400,200,1,00085,India
593366,2024-02-09,414,chair,1000,2000,1000,1,00495,India
593366,2024-02-09,401,couch,15000,25000,10000,1,00495,India
672174,2024-02-10,417,door knob,200,400,200,1,00304,India
475221,2024-02-10,405,carpet,2000,4000,2000,1,00179,India
475221,2024-02-10,403,tube light,450,600,150,1,00179,India
475221,2024-02-10,408,cupboard,5000,15000,10000,1,00179,India
475221,2024-02-10,404,queen bed,29000,45000,16000,1,00179,India
317615,2024-02-10,411,side table,1500,3000,1500,1,00170,India
317615,2024-02-10,407,bedsheet,500,1000,500,1,00170,India
403481,2024-02-10,412,area rug,3000,6000,3000,1,00038,India
403481,2024-02-10,410,curtain,1000,2000,1000,1,00038,India
379116,2024-02-10,405,carpet,2000,4000,2000,1,00181,India
517741,2024-02-11,413,dining table,20000,40000,20000,1,00197,India
517741,2024-02-11,402,lamp,500,750,250,1,00197,India
517741,2024-02-11,405,carpet,2000,4000,2000,1,00197,India
645942,2024-02-11,408,cupboard,5000,15000,10000,1,00241,India
645942,2024-02-11,403,tube light,450,600,150,1,00241,India
431190,2024-02-13,406,pillow,200,400,200,1,00415,India
431190,2024-02-13,415,yard chair,1500,3000,1500,1,00415,India
396444,2024-02-13,414,chair,1000,2000,1000,1,00104,India
396444,2024-02-13,412,area rug,3000,6000,3000,1,00104,India
981272,2024-02-13,404,queen bed,29000,45000,16000,1,00031,India
981272,2024-02-13,407,bedsheet,500,1000,500,1,00031,India
208419,2024-02-13,416,door,5000,10000,5000,1,00388,India
208419,2024-02-13,417,door knob,200,400,200,1,00388,India
865360,2024-02-15,414,chair,1000,2000,1000,1,00189,India
865360,2024-02-15,403,tube light,450,600,150,1,00189,India
865360,2024-02-15,412,area rug,3000,6000,3000,1,00189,India
865360,2024-02-15,401,couch,15000,25000,10000,1,00189,India
678121,2024-02-15,401,couch,15000,25000,10000,1,00476,India
678121,2024-02-15,409,shelf,500,1000,500,1,00476,India
678121,2024-02-15,407,bedsheet,500,1000,500,1,00476,India
803715,2024-02-15,413,dining table,20000,40000,20000,1,00471,India
803715,2024-02-15,407,bedsheet,500,1000,500,1,00471,India
802023,2024-02-15,407,bedsheet,500,1000,500,1,00003,India
802023,2024-02-15,415,yard chair,1500,3000,1500,1,00003,India
802023,2024-02-15,411,side table,1500,3000,1500,1,00003,India
802023,2024-02-15,406,pillow,200,400,200,1,00003,India
143541,2024-02-15,414,chair,1000,2000,1000,1,00394,India
143541,2024-02-15,419,paint,2000,4000,2000,1,00394,India
143541,2024-02-15,401,couch,15000,25000,10000,1,00394,India
143541,2024-02-15,415,yard chair,1500,3000,1500,1,00394,India
418881,2024-02-16,416,door,5000,10000,5000,1,00471,India
418881,2024-02-16,413,dining table,20000,40000,20000,1,00471,India
418881,2024-02-16,412,area rug,3000,6000,3000,1,00471,India
488409,2024-02-16,408,cupboard,5000,15000,10000,1,00333,India
488409,2024-02-16,404,queen bed,29000,45000,16000,1,00333,India
488409,2024-02-16,411,side table,1500,3000,1500,1,00333,India
441965,2024-02-16,417,door knob,200,400,200,1,00476,India
441965,2024-02-16,416,door,5000,10000,5000,1,00476,India
441965,2024-02-16,404,queen bed,29000,45000,16000,1,00476,India
794051,2024-02-16,410,curtain,1000,2000,1000,1,00204,India
794051,2024-02-16,403,tube light,450,600,150,1,00204,India
247882,2024-02-16,409,shelf,500,1000,500,1,00086,India
900583,2024-02-17,417,door knob,200,400,200,1,00242,India
720736,2024-02-17,411,side table,1500,3000,1500,1,00187,India
720736,2024-02-17,409,shelf,500,1000,500,1,00187,India
720736,2024-02-17,406,pillow,200,400,200,1,00187,India
905113,2024-02-17,411,side table,1500,3000,1500,1,00304,India
905113,2024-02-17,419,paint,2000,4000,2000,1,00304,India
905113,2024-02-17,406,pillow,200,400,200,1,00304,India
905113,2024-02-17,418,tiles,50,100,50,1,00304,India
905113,2024-02-17,405,carpet,2000,4000,2000,1,00304,India
586528,2024-02-17,405,carpet,2000,4000,2000,1,00253,India
586528,2024-02-17,410,curtain,1000,2000,1000,1,00253,India
586528,2024-02-17,402,lamp,500,750,250,1,00253,India
586528,2024-02-17,415,yard chair,1500,3000,1500,1,00253,India
470981,2024-02-17,407,bedsheet,500,1000,500,1,00422,India
470981,2024-02-17,408,cupboard,5000,15000,10000,1,00422,India
864505,2024-02-18,407,bedsheet,500,1000,500,1,00196,India
308866,2024-02-18,413,dining table,20000,40000,20000,1,00235,India
308866,2024-02-18,416,door,5000,10000,5000,1,00235,India
308866,2024-02-18,417,door knob,200,400,200,1,00235,India
470932,2024-02-18,410,curtain,1000,2000,1000,1,00010,India
999264,2024-02-18,405,carpet,2000,4000,2000,1,00277,India
999264,2024-02-18,402,lamp,500,750,250,1,00277,India
999264,2024-02-18,413,dining table,20000,40000,20000,1,00277,India
999264,2024-02-18,401,couch,15000,25000,10000,1,00277,India
197399,2024-02-18,411,side table,1500,3000,1500,1,00218,India
197399,2024-02-18,409,shelf,500,1000,500,1,00218,India
197399,2024-02-18,404,queen bed,29000,45000,16000,1,00218,India
197399,2024-02-18,415,yard chair,1500,3000,1500,1,00218,India
197399,2024-02-18,401,couch,15000,25000,10000,1,00218,India
542899,2024-02-19,403,tube light,450,600,150,1,00119,India
542899,2024-02-19,419,paint,2000,4000,2000,1,00119,India
542899,2024-02-19,410,curtain,1000,2000,1000,1,00119,India
781997,2024-02-19,403,tube light,450,600,150,1,00404,India
149536,2024-02-20,413,dining table,20000,40000,20000,1,00261,India
149536,2024-02-20,417,door knob,200,400,200,1,00261,India
149536,2024-02-20,414,chair,1000,2000,1000,1,00261,India
149536,2024-02-20,403,tube light,450,600,150,1,00261,India
149536,2024-02-20,409,shelf,500,1000,500,1,00261,India
837372,2024-02-20,415,yard chair,1500,3000,1500,1,00421,India
837372,2024-02-20,403,tube light,450,600,150,1,00421,India
591706,2024-02-20,415,yard chair,1500,3000,1500,1,00279,India
591706,2024-02-20,413,dining table,20000,40000,20000,1,00279,India
